cell_site,calling,called,startdate,enddate,duration
10659,3511206717,3624307518,1672538749,1672541595,2846
11380,3389069291,3938398160,1672573406,1672576407,3001
10121,3517797610,3609644043,1672646644,1672647811,1167
10121,3202740652,3663353552,1672581454,1672582108,654
10397,3513802404,3500595432,1672543006,1672545487,2481
11673,3423147369,3854229296,1672657485,1672657934,449
10259,3500356342,3834311054,1672580424,1672581801,1377
11299,3205687719,3711852131,1672634052,1672636307,2255
11366,3235578852,3517949586,1672598711,1672602192,3481
9895,3909220912,3902548260,1672688421,1672689170,749
9878,3519724388,3438818153,1672651542,1672652921,1379
11659,3368176107,3437286595,1672587784,1672591106,3322
10166,3559123082,3512133625,1672662786,1672665818,3032
10186,3294326116,3738160394,1672597566,1672597646,80
11179,3452175941,3358211034,1672662368,1672664490,2122
10441,3817038422,3509701363,1672625332,1672627646,2314
11145,3715622084,3715441786,1672600881,1672603715,2834
10829,3779561601,3887030182,1672631890,1672632990,1100
10946,3737738751,3774652449,1672650278,1672651857,1579
11749,3451757423,3505164060,1672563235,1672564542,1307
11103,3715622084,3509382404,1672594426,1672595664,1238
11395,3445355677,3512072679,1672558566,1672558828,262
10763,3509544691,3293579860,1672683453,1672686771,3318
11267,3201573194,3825526565,1672618858,1672620737,1879
10873,3926065090,3919719755,1672562587,1672565408,2821
9934,3225356349,3533627473,1672537623,1672539428,1805
10274,3410788026,3669427589,1672652744,1672653452,708
10703,3513859809,3304235700,1672689546,1672691610,2064
11619,3716647407,3716468783,1672594650,1672594975,325
11040,3770273966,3500073824,1672589729,1672591717,1988
9880,3930727474,3927202773,1672564970,1672567410,2440
11695,3313298164,3791409441,1672643463,1672646780,3317
10494,3710807030,3512784888,1672639211,1672641107,1896
10355,3774939922,3821082558,1672689261,1672690226,965
10765,3236512807,3603682643,1672626259,1672628715,2456
10324,3738160394,3793949077,1672537185,1672537538,353
9954,3600171014,3246395239,1672664047,1672667114,3067
10494,3458432407,3760731595,1672609863,1672612443,2580
10322,3311449914,3497138014,1672596602,1672599625,3023
10762,3301489209,3487231844,1672623865,1672627386,3521
10999,3701567668,3887030182,1672698119,1672698347,228
10512,3279851026,3780921044,1672697698,1672699000,1302
10185,3885674996,3711196962,1672567669,1672568677,1008
11078,3772683155,3519046342,1672692759,1672692993,234
10964,3772569860,3773636983,1672690293,1672691559,1266
11456,3238056215,3534812391,1672647614,1672649468,1854
10314,3226913558,3793920312,1672661452,1672664558,3106
10913,3534499421,3909220912,1672682469,1672682995,526
10985,3240877710,3711179193,1672653294,1672654042,748
10345,3302416197,3510775046,1672673359,1672676110,2751
11745,3488399075,3793081195,1672618492,1672621672,3180
10138,3715106566,3887918622,1672608972,1672611011,2039
9956,3854229296,3903065952,1672632457,1672635728,3271
10437,3534190196,3447267291,1672620363,1672620647,284
10237,3777569538,3816184951,1672659531,1672662625,3094
11112,3519924982,3791547827,1672566614,1672567613,999
11347,3505190512,3783043346,1672594594,1672595990,1396
10445,3684199077,3446810761,1672673560,1672674009,449
10629,3367299721,3533976217,1672701646,1672702784,1138
10112,3909504515,3361952532,1672568541,1672570042,1501
10132,3519730914,3701453343,1672654382,1672657318,2936
11568,3829358750,3738873928,1672536090,1672539499,3409
9892,3388774559,3516444589,1672693919,1672695030,1111
11389,3760274119,3520925688,1672696890,1672700163,3273
11246,3777909822,3757150421,1672539043,1672542138,3095
9944,3510795808,3509626590,1672693000,1672693764,764
11760,3755924094,3732090606,1672546158,1672549533,3375
11268,3419648004,3757212744,1672600418,1672604001,3583
11715,3613703906,3281970147,1672541017,1672541484,467
11771,3516026189,3454924050,1672559797,1672559917,120
11171,3757584114,3516965624,1672602883,1672605502,2619
9923,3511286390,3757032266,1672685485,1672687356,1871
11194,3491758029,3319529422,1672631062,1672634599,3537
11574,3352044245,3738873928,1672616284,1672616869,585
11164,3713923960,3509508477,1672589473,1672592806,3333
10353,3509073025,3715881104,1672627343,1672628055,712
10141,3291446384,3895944547,1672689931,1672691995,2064
10350,3894495222,3791532324,1672624480,1672626428,1948
11676,3858497718,3934564437,1672674750,1672675975,1225
11502,3452982957,3756991235,1672690967,1672692962,1995
11542,3514673213,3511615015,1672652961,1672653111,150
10076,3715622084,3891272544,1672595256,1672598129,2873
10467,3513894659,3793704155,1672676958,1672680416,3458
11573,3357097510,3284407073,1672569920,1672572010,2090
11161,3452677710,3710783759,1672667328,1672669003,1675
10098,3660980656,3714453773,1672536399,1672537828,1429
11052,3490008012,3511615015,1672679989,1672680093,104
10376,3703351452,3387706541,1672538724,1672539197,473
11108,3710051427,3505709407,1672593463,1672594356,893
10657,3371497614,3772291207,1672622119,1672624892,2773
11646,3703419800,3701925712,1672553975,1672554398,423
10214,3500429731,3231963246,1672605434,1672608790,3356
11094,3479910993,3783967375,1672548063,1672550959,2896
11709,3501557463,3760737203,1672633635,1672635057,1422
11237,3833520635,3756079870,1672580297,1672580774,477
11140,3518058151,3791974273,1672700668,1672701920,1252
11533,3773161055,3682241594,1672549064,1672551623,2559
11099,3420664407,3516034245,1672696282,1672699425,3143
10378,3505853594,3778842400,1672693920,1672694911,991
11256,3333505404,3511867383,1672673105,1672675417,2312
10861,3636927297,3714806574,1672697525,1672700292,2767
10191,3480270940,3552309108,1672669610,1672670338,728
10505,3732846295,3783967375,1672569476,1672570581,1105
9943,3783679478,3492728794,1672557791,1672557886,95
10265,3736010012,3452175941,1672630791,1672633581,2790
11198,3275171954,3301332095,1672535234,1672535455,221
10999,3471996194,3611832288,1672618233,1672618784,551
11014,3423353911,3513186622,1672563026,1672566171,3145
10597,3500051606,3399726243,1672601160,1672604580,3420
10134,3380218091,3510826414,1672564300,1672567877,3577
9889,3319660530,3513186622,1672560879,1672564180,3301
11235,3479452888,3680075399,1672622624,1672624063,1439
10921,3757607649,3367262509,1672619963,1672622050,2087
10024,3457249798,3283106998,1672550558,1672551582,1024
10774,3518058151,3621812406,1672687864,1672689263,1399
10814,3780500764,3517426473,1672585842,1672588034,2192
10853,3397527886,3444881567,1672692061,1672693363,1302
11778,3509382404,3516200419,1672676182,1672679070,2888
11161,3739567072,3487231844,1672608725,1672611633,2908
10649,3457249798,3755630085,1672582342,1672585286,2944
11503,3735197034,3922409420,1672571368,1672572679,1311
11458,3220987526,3517253559,1672572455,1672575052,2597
11070,3792578118,3447591143,1672672536,1672675291,2755
10145,3735056027,3314965818,1672598867,1672598932,65
10384,3500145103,3509556649,1672618266,1672618894,628
11314,3715441786,3818570577,1672569408,1672572840,3432
10177,3432466467,3404395454,1672610222,1672610633,411
10830,3299743638,3500442370,1672693205,1672693920,715
10020,3689386663,3220123678,1672660635,1672663803,3168
11618,3777074709,3351949206,1672551815,1672555323,3508
11129,3666561358,3480185839,1672688265,1672689241,976
10113,3793899166,3760997159,1672598730,1672599367,637
9943,3884369346,3755374000,1672595266,1672595773,507
11441,3899756737,3927805949,1672579746,1672579833,87
11597,3500145103,3713906305,1672568179,1672569950,1771
11266,3331228758,3330188769,1672584205,1672587796,3591
10788,3833993674,3624872714,1672552266,1672553629,1363
10422,3505007498,3928508375,1672610751,1672612398,1647
10336,3780964089,3274739459,1672553128,1672554516,1388
10814,3515577866,3933106901,1672696363,1672699405,3042
10941,3311177439,3492064037,1672593015,1672595792,2777
11533,3505867821,3793029132,1672635555,1672635993,438
9863,3851810349,3903088144,1672564541,1672564640,99
10220,3972653129,3793375825,1672643929,1672646061,2132
11454,3316406470,3770480149,1672620872,1672622462,1590
10072,3935256825,3772689657,1672659975,1672661613,1638
11271,3935520819,3756297396,1672652782,1672655910,3128
11784,3501600785,3888409038,1672608382,1672609950,1568
9936,3756675909,3776867553,1672600698,1672603446,2748
11315,3755129708,3774744663,1672562351,1672564050,1699
11667,3680939042,3760979523,1672572457,1672575760,3303
11306,3361952532,3738429905,1672608488,1672611067,2579
11114,3515378306,3791574640,1672696500,1672698015,1515
10239,3757513651,3713878219,1672556956,1672560182,3226
11149,3600871715,3513859809,1672570152,1672572996,2844
11291,3776304080,3370512945,1672569113,1672570475,1362
11031,3341985886,3437934509,1672585571,1672585862,291
10974,3479452888,3516472352,1672547906,1672551081,3175
11700,3701668745,3934991640,1672695483,1672696590,1107
10375,3533859712,3711076751,1672610890,1672611896,1006
10529,3286862903,3757592622,1672689411,1672690026,615
10835,3887069914,3559759778,1672532192,1672534573,2381
10839,3906075386,3302929858,1672582666,1672584678,2012
10868,3520057139,3783408469,1672670176,1672671088,912
10387,3361926328,3516257130,1672602194,1672603844,1650
10656,3519703964,3793987483,1672678092,1672680615,2523
10669,3714116241,3713416106,1672701243,1672702824,1581
10103,3511526885,3780050328,1672578597,1672579126,529
11170,3772882440,3810818108,1672578036,1672581439,3403
10799,3687183789,3497138014,1672655176,1672658345,3169
11752,3737738751,3351949206,1672658433,1672659407,974
9957,3814770073,3793899166,1672624538,1672625109,571
10023,3792012147,3319862687,1672666763,1672667634,871
10725,3230612965,3516731917,1672538384,1672538483,99
11344,3770671714,3773378103,1672697883,1672699489,1606
11283,3713728777,3736621212,1672647305,1672648627,1322
10938,3711404205,3509208005,1672685973,1672687045,1072
10515,3520305100,3881012415,1672592996,1672595893,2897
10125,3600171014,3779665641,1672625728,1672626069,341
10003,3395565040,3274239253,1672673620,1672677070,3450
10151,3611832288,3220123678,1672586144,1672589358,3214
11067,3479910993,3511341866,1672671008,1672671329,321
9804,3313392810,3772609551,1672665652,1672668132,2480
10015,3605905645,3514244308,1672667013,1672667972,959
11675,3688845298,3505560793,1672646845,1672650420,3575
10847,3534775239,3389069291,1672533465,1672533958,493
11164,3512527440,3931495845,1672582797,1672585429,2632
10662,3295748489,3558264627,1672669089,1672671944,2855
11519,3897003751,3352044245,1672639918,1672642562,2644
10403,3514628916,3772980989,1672604971,1672606705,1734
10548,3275661834,3509382404,1672689044,1672689208,164
11369,3779561601,3514329209,1672672442,1672675600,3158
10586,3511415786,3509252934,1672543114,1672543679,565
10654,3783879023,3757713457,1672691455,1672694047,2592
10349,3230250213,3714640103,1672647273,1672649198,1925
10467,3512769522,3615447269,1672680699,1672682306,1607
10893,3638035545,3713224986,1672562626,1672565773,3147
11700,3898965585,3791542842,1672673393,1672674562,1169
10018,3756536476,3780050146,1672651254,1672654788,3534
10537,3714250543,3533974355,1672627695,1672629402,1707
11078,3308481706,3773891827,1672637228,1672638495,1267
10229,3467232654,3739395381,1672681210,1672682011,801
10145,3783067048,3832289185,1672612548,1672612862,314
9990,3780423516,3517530943,1672683755,1672686522,2767
11278,3680832669,3634766042,1672678266,1672678360,94
10097,3244495586,3485898181,1672578630,1672581718,3088
9816,3909822999,3361926328,1672605713,1672609129,3416
11555,3778909412,3505129296,1672581391,1672582628,1237
9957,3505449070,3505547832,1672647292,1672650532,3240
11684,3415228763,3505331014,1672651074,1672651859,785
10689,3427049290,3533974355,1672605466,1672607704,2238
11446,3347760784,3713141087,1672667755,1672669917,2162
10820,3855209450,3534204885,1672556400,1672557572,1172
10426,3776407517,3714688409,1672605734,1672607528,1794
11437,3621960662,3663505156,1672679217,1672682580,3363
11298,3756345026,3777041132,1672541754,1672542582,828
10998,3816184951,3505032644,1672640704,1672641595,891
10002,3777992576,3715790104,1672696503,1672700019,3516
10501,3511729562,3669427589,1672559093,1672559200,107
10193,3778605154,3660163550,1672679194,1672682133,2939
10053,3757607649,3716467469,1672660068,1672663025,2957
10278,3669475165,3629869834,1672644797,1672647983,3186
10304,3856147380,3701065296,1672648986,1672650714,1728
10725,3711287751,3487278983,1672697520,1672700908,3388
11213,3755942724,3333505404,1672549906,1672551689,1783
9969,3925792265,3911821258,1672698038,1672699197,1159
11285,3497904539,3444397804,1672672167,1672673536,1369
10256,3465690527,3776732532,1672633993,1672637037,3044
10504,3413236071,3701291994,1672680774,1672683159,2385
10727,3714455496,3432762943,1672693196,1672693334,138
10178,3660176760,3337675386,1672683991,1672687436,3445
10235,3385006834,3275975921,1672701032,1672702723,1691
10388,3393909269,3757823215,1672686115,1672688192,2077
11213,3938129916,3755767856,1672564804,1672565521,717
10324,3247193800,3688845298,1672638604,1672642123,3519
10840,3783594729,3452389513,1672559739,1672561118,1379
11378,3499622352,3278443807,1672652642,1672655669,3027
10427,3791332226,3896200048,1672616142,1672618557,2415
11638,3514776568,3516378356,1672676968,1672679982,3014
11684,3291617477,3606804618,1672556696,1672557266,570
10890,3773603836,3927763819,1672568838,1672569936,1098
11135,3238310644,3757001552,1672672169,1672673636,1467
9995,3500793739,3500928990,1672585058,1672588168,3110
10554,3517469005,3621629499,1672666448,1672668485,2037
11584,3757201138,3714919471,1672658773,1672661886,3113
11493,3755729826,3774539067,1672691060,1672694123,3063
11108,3505148522,3884191432,1672700269,1672703510,3241
11646,3804707712,3278805844,1672667056,1672670385,3329
10011,3778604070,3667654673,1672542597,1672544869,2272
11110,3517991042,3443191792,1672684419,1672687646,3227
11513,3438470128,3819024145,1672629893,1672631973,2080
9801,3223512565,3487278983,1672599000,1672600000,1000
11514,3516585063,3351728355,1672610131,1672611715,1584
9850,3559125467,3461743188,1672565313,1672565904,591
10714,3511078598,3701893620,1672536992,1672538435,1443
11187,3779723939,3917243005,1672597451,1672598478,1027
10885,3516792348,3793704155,1672573708,1672576588,2880
9804,3601214648,3916656185,1672678505,1672681128,2623
10572,3519908593,3447202943,1672553667,1672554504,837
10283,3903065952,3501515425,1672676979,1672677605,626
10591,3367262509,3783277159,1672692862,1672695041,2179
10401,3509355477,3512504247,1672577608,1672578283,675
11049,3520553959,3737571883,1672631893,1672634260,2367
10068,3685645561,3495482863,1672565918,1672567786,1868
9868,3200372897,3665478011,1672632470,1672634901,2431
9932,3300238532,3757713457,1672625255,1672627061,1806
9902,3773041843,3517960157,1672606340,1672607335,995
11128,3701971784,3931917809,1672577127,1672580326,3199
10178,3933106901,3555954355,1672699823,1672702072,2249
11353,3220987526,3714101349,1672552694,1672554829,2135
10260,3820922991,3755107521,1672583435,1672584912,1477
10239,3732440502,3830962592,1672533547,1672537091,3544
10764,3500589560,3333477908,1672574631,1672575932,1301
11520,3791664049,3793949077,1672532041,1672532188,147
10807,3663505156,3368848936,1672668550,1672671333,2783
9839,3818236682,3516026189,1672679320,1672682402,3082
10910,3247545468,3701519251,1672622393,1672622537,144
10408,3220798451,3501126057,1672666308,1672668836,2528
9975,3500018566,3756991235,1672644639,1672647913,3274
10444,3714377201,3510278533,1672536848,1672538776,1928
11102,3472173212,3517632796,1672565477,1672568973,3496
10325,3520012007,3501977123,1672628617,1672631735,3118
11773,3760382349,3760397450,1672600130,1672603378,3248
10888,3836090778,3509208005,1672625108,1672626725,1617
11099,3925208102,3665603628,1672682209,1672682808,599
10234,3701769970,3770424941,1672570773,1672572081,1308
10637,3478206139,3355899481,1672654379,1672657016,2637
10344,3713031958,3499343927,1672662769,1672664946,2177
10598,3772282008,3776791436,1672531922,1672534883,2961
11256,3714101349,3340321384,1672601763,1672601910,147
9941,3936486724,3512087090,1672594030,1672597097,3067
10632,3711219767,3520515739,1672557989,1672559725,1736
11501,3772893815,3701265238,1672563247,1672563926,679
11058,3501583486,3471131277,1672613378,1672616399,3021
9922,3701534043,3427527462,1672640587,1672640707,120
10435,3791332061,3938059867,1672607896,1672608872,976
9820,3520471156,3485521840,1672622106,1672625202,3096
11399,3622654885,3669283586,1672538057,1672539429,1372
10196,3304030474,3505491969,1672644338,1672645376,1038
11074,3340897079,3930727474,1672595392,1672596476,1084
10444,3441840658,3409078869,1672555514,1672558068,2554
10214,3772659062,3510244209,1672540832,1672541189,357
10623,3311264420,3515939841,1672583433,1672586303,2870
11659,3233917789,3372778334,1672596869,1672599133,2264
11048,3927763819,3283295213,1672603037,1672605121,2084
10367,3514216460,3505359060,1672661484,1672661878,394
11228,3893932944,3516378356,1672677975,1672679729,1754
10780,3420881591,3793081195,1672557968,1672559591,1623
10706,3439532406,3519260216,1672658910,1672660922,2012
9813,3793407883,3447554599,1672681955,1672683634,1679
11609,3247193800,3668063289,1672573007,1672575223,2216
11034,3363549860,3618895679,1672668466,1672671020,2554
11209,3520779124,3520339198,1672644075,1672644436,361
11087,3402774497,3279726491,1672541463,1672543138,1675
9908,3929923442,3428198021,1672624588,1672626137,1549
9806,3341985886,3277061226,1672675380,1672677883,2503
10813,3920890008,3340897079,1672636672,1672639873,3201
10407,3373018943,3430296808,1672591813,1672593530,1717
10376,3755989680,3776001441,1672570913,1672574408,3495
10491,3450342110,3222357355,1672563162,1672565502,2340
10067,3235373942,3236563828,1672655362,1672655790,428
11102,3934280144,3614112171,1672651427,1672655011,3584
10792,3791031227,3773848111,1672630851,1672631468,617
10682,3510781595,3604569804,1672599324,1672601894,2570
11509,3227339675,3403150349,1672646218,1672647694,1476
10525,3302879906,3701865589,1672673973,1672676645,2672
9908,3311015817,3249771731,1672643088,1672645894,2806
9887,3816184951,3773411968,1672648526,1672651186,2660
10359,3487278983,3334936138,1672676835,1672678744,1909
11029,3501711464,3637522163,1672565890,1672567926,2036
11729,3512768285,3278251248,1672601783,1672601906,123
11290,3515548696,3277061226,1672540025,1672543072,3047
10521,3776468503,3857389270,1672588372,1672588911,539
11762,3856316719,3491239350,1672647790,1672650800,3010
9889,3500536897,3513996288,1672603071,1672603466,395
10943,3387621912,3509297453,1672630618,1672633943,3325
11139,3857909328,3852161626,1672549919,1672552908,2989
10994,3791088014,3514926921,1672632336,1672634879,2543
10685,3505416534,3375905193,1672702903,1672706150,3247
11716,3890278838,3519924982,1672578248,1672580797,2549
10879,3272581469,3778479297,1672557328,1672558124,796
10444,3516819320,3713954144,1672670415,1672670544,129
10500,3755075988,3756363182,1672627298,1672628446,1148
10206,3371759126,3454343398,1672616488,1672619693,3205
10783,3435715962,3517632796,1672588967,1672590641,1674
10280,3895944547,3299847117,1672649900,1672650010,110
11278,3823307824,3513563152,1672557425,1672558808,1383
10741,3558349840,3520009158,1672673486,1672676556,3070
10461,3511867383,3609335008,1672541094,1672542970,1876
10136,3688870751,3505155858,1672543906,1672546735,2829
10537,3393001196,3505816624,1672532452,1672535512,3060
10820,3500536897,3779478448,1672701946,1672703439,1493
11526,3408408584,3809871495,1672559250,1672560364,1114
10039,3236563828,3514980025,1672607651,1672607878,227
11602,3776867553,3979366845,1672578168,1672578707,539
11182,3406029706,3757713457,1672562468,1672563941,1473
11426,3778741325,3554317844,1672663106,1672664450,1344
10277,3534506090,3916463490,1672575051,1672575938,887
10522,3711287751,3793949077,1672672303,1672673199,896
10649,3273242177,3832312129,1672579085,1672582464,3379
10820,3511199555,3902300755,1672618205,1672620630,2425
9818,3462985379,3714525519,1672686932,1672687041,109
11610,3444881567,3203630241,1672675494,1672676753,1259
11772,3906874577,3511245705,1672628830,1672630276,1446
10482,3770972037,3514145752,1672553210,1672555981,2771
10677,3552261072,3511650296,1672684186,1672685294,1108
10822,3550405857,3915195160,1672623707,1672623995,288
11436,3792337863,3776901443,1672604928,1672607765,2837
10006,3755119166,3513092056,1672538566,1672540520,1954
11278,3505416534,3450511428,1672646075,1672647115,1040
10659,3619676231,3774029494,1672671473,1672673079,1606
10765,3311569360,3716341323,1672545325,1672546681,1356
10449,3279726491,3425260097,1672559577,1672561734,2157
10513,3341985886,3701028092,1672652506,1672653954,1448
10607,3793783685,3442403264,1672585385,1672586945,1560
11338,3853182912,3776440009,1672585406,1672586129,723
10384,3711367577,3510680251,1672554621,1672558084,3463
10005,3755922811,3520515739,1672651336,1672653003,1667
11170,3246971044,3933562725,1672688848,1672690108,1260
11385,3757064623,3404375908,1672632425,1672634109,1684
11076,3347205332,3533929043,1672540778,1672542768,1990
9856,3517440258,3776125503,1672564278,1672566270,1992
11791,3901169230,3511580693,1672689706,1672691050,1344
11034,3510864325,3783679478,1672559934,1672562406,2472
9860,3376842515,3387870683,1672693904,1672696676,2772
11732,3828906027,3713694278,1672700838,1672700942,104
10318,3517816581,3398021818,1672557958,1672560071,2113
11445,3780941637,3774946684,1672540005,1672542005,2000
11780,3377250778,3931028233,1672585148,1672586077,929
10212,3914740937,3710107905,1672580114,1672581113,999
10828,3822496670,3509457543,1672614862,1672616347,1485
10148,3776407517,3755670258,1672555378,1672557015,1637
11143,3779706467,3783730769,1672543352,1672545166,1814
11751,3630462406,3915652382,1672691161,1672692667,1506
11207,3776249160,3783563043,1672703540,1672706580,3040
11621,3714453773,3243651036,1672692931,1672693093,162
10840,3511864772,3389069291,1672696497,1672698164,1667
10712,3883640904,3517810375,1672584907,1672586592,1685
11046,3636857871,3778817220,1672620241,1672623750,3509
11076,3505148522,3777112124,1672629754,1672632211,2457
9859,3776841808,3395610742,1672646385,1672647431,1046
10881,3715700639,3513545735,1672665992,1672669083,3091
11792,3276231633,3356972733,1672648490,1672649003,513
11157,3517632796,3774145748,1672539210,1672539899,689
10815,3480270940,3463564410,1672643361,1672644667,1306
9844,3701448521,3459694275,1672669129,1672671679,2550
10586,3733836732,3756437169,1672533728,1672536222,2494
9809,3776316903,3518209090,1672646416,1672649235,2819
10523,3779255367,3774401596,1672627617,1672630548,2931
10741,3601214648,3440401725,1672644450,1672646731,2281
11697,3505234868,3432466467,1672649106,1672651657,2551
10401,3342056927,3776953418,1672554463,1672557560,3097
10673,3730052916,3715602742,1672634404,1672634500,96
9941,3776732532,3519448648,1672662059,1672662434,375
10222,3417969824,3499998389,1672539831,1672542966,3135
11288,3773738817,3305612422,1672597744,1672598196,452
10455,3773376762,3514455363,1672630074,1672630951,877
11017,3509651954,3906260966,1672581435,1672582128,693
11362,3612042508,3520925688,1672698879,1672701036,2157
10457,3283847934,3882580580,1672547922,1672551505,3583
11293,3773697080,3295710494,1672556229,1672556448,219
10311,3519924982,3338642026,1672700054,1672700770,716
10907,3735497729,3246381831,1672631706,1672632080,374
11649,3916924978,3701284535,1672599252,1672602419,3167
11317,3660257653,3505653701,1672616701,1672618530,1829
10332,3791121243,3760737203,1672559257,1672562226,2969
10061,3510373076,3755154460,1672609763,1672612288,2525
10060,3550887623,3632720032,1672673147,1672675284,2137
10478,3534081527,3710695372,1672548089,1672549758,1669
11624,3373135211,3517960740,1672606919,1672607686,767
11127,3220987526,3304028109,1672693704,1672695610,1906
10938,3500590302,3516969689,1672561350,1672562957,1607
11505,3638035545,3394394262,1672670024,1672670904,880
11710,3639465750,3500776597,1672672420,1672672805,385
10565,3711076751,3285201542,1672631507,1672634628,3121
10666,3411355804,3492064037,1672662293,1672664102,1809
10409,3519997661,3682241594,1672614084,1672614165,81
11503,3774035405,3505351253,1672680781,1672683447,2666
11003,3415803494,3777200549,1672658043,1672658774,731
9819,3770530739,3793407883,1672600060,1672600293,233
9988,3772683155,3510801769,1672557561,1672560268,2707
11173,3248061684,3513840186,1672560533,1672562552,2019
10656,3791796190,3730414796,1672542709,1672544364,1655
10673,3364683368,3625931630,1672661644,1672661813,169
11184,3317989975,3856601074,1672585831,1672588675,2844
9857,3249614888,3387413950,1672702296,1672702512,216
10904,3500624846,3855077502,1672667669,1672668705,1036
10536,3439651226,3380167818,1672614880,1672617915,3035
9894,3500640854,3600871715,1672533437,1672536415,2978
10322,3971422524,3513250976,1672702586,1672703933,1347
11108,3711349327,3783368855,1672700507,1672702724,2217
11374,3780482864,3501137133,1672555768,1672556777,1009
9942,3552444228,3305093237,1672679682,1672681841,2159
10094,3515577866,3440991826,1672637330,1672639905,2575
11169,3711029952,3231227362,1672554053,1672554483,430
11487,3777932581,3476958001,1672582262,1672584125,1863
10613,3780749789,3515803462,1672610447,1672612245,1798
11340,3510335069,3343616490,1672609106,1672612222,3116
9949,3777060250,3509562377,1672592594,1672593225,631
11739,3407734098,3772164469,1672661467,1672663089,1622
10713,3778253021,3710783759,1672679220,1672681457,2237
9936,3306475287,3896200048,1672631787,1672634011,2224
10116,3372236721,3774401596,1672620911,1672623805,2894
10175,3299845453,3495482863,1672636102,1672637155,1053
10393,3505245692,3351728355,1672679423,1672682366,2943
10843,3511729562,3682086200,1672549034,1672552487,3453
10334,3404187438,3661359073,1672613779,1672615211,1432
11490,3467232654,3779282072,1672599287,1672600388,1101
11360,3773768643,3793497672,1672625040,1672626912,1872
10364,3777387533,3884192843,1672578272,1672581166,2894
10196,3774965463,3310712221,1672584754,1672587593,2839
9919,3778695895,3311410533,1672604961,1672606139,1178
10963,3714806574,3389367628,1672577947,1672580891,2944
9957,3913847876,3711852131,1672686494,1672687613,1119
10103,3343859998,3414841458,1672682347,1672685731,3384
11780,3713170867,3311015817,1672589884,1672592101,2217
10247,3772659062,3359929534,1672593470,1672596683,3213
10698,3511750850,3533473206,1672572086,1672574751,2665
11005,3457249798,3360837082,1672563483,1672564566,1083
10163,3454554552,3309455369,1672692873,1672695440,2567
10302,3900793652,3516067011,1672579531,1672581851,2320
10619,3625952981,3888523259,1672578958,1672580065,1107
10566,3776581518,3515577866,1672681669,1672682913,1244
9958,3827981800,3606804618,1672619480,1672621731,2251
10095,3519435459,3793689267,1672638314,1672641893,3579
9999,3713444403,3760481622,1672653222,1672654532,1310
10509,3760529327,3489340327,1672548801,1672551564,2763
10724,3233712975,3552922094,1672655032,1672656140,1108
10129,3224053840,3773798215,1672549945,1672550637,692
11189,3500018566,3293673220,1672685065,1672685424,359
11503,3505804611,3812880543,1672600341,1672602163,1822
11059,3533340292,3713170867,1672666057,1672668178,2121
10166,3711755596,3757446082,1672604788,1672607893,3105
11314,3711404205,3395565040,1672680433,1672680746,313
10197,3519174861,3393376416,1672603675,1672606192,2517
9973,3501843187,3755229631,1672585959,1672586358,399
10799,3467415939,3318590083,1672615982,1672618382,2400
10946,3755170743,3810818108,1672699138,1672699683,545
10895,3714595459,3807111856,1672632234,1672633843,1609
11393,3312733562,3683047199,1672602359,1672604784,2425
9836,3777564559,3505121295,1672646730,1672648568,1838
10614,3916924978,3534589501,1672610144,1672613487,3343
11409,3311200541,3710125627,1672602908,1672605256,2348
10940,3911821258,3855629383,1672599963,1672600548,585
10358,3918126468,3312612693,1672570324,1672573863,3539
10628,3618895679,3520182275,1672546303,1672548170,1867
10343,3515100211,3773636983,1672630371,1672631175,804
10935,3519712497,3812261241,1672565613,1672569105,3492
11083,3447267291,3701512498,1672602323,1672603644,1321
10356,3512371853,3346755179,1672672369,1672674797,2428
10613,3534589501,3360949039,1672545593,1672547958,2365
11043,3770276815,3318220119,1672558913,1672561274,2361
10251,3885545415,3282240901,1672655046,1672657076,2030
11056,3373135211,3739395381,1672654186,1672656967,2781
11787,3475033290,3355880028,1672598431,1672600021,1590
10748,3776468503,3275735969,1672626937,1672628578,1641
11128,3773161055,3732540636,1672623399,1672624024,625
10123,3500854711,3362706073,1672618229,1672620248,2019
10372,3891586951,3710223875,1672558547,1672561938,3391
10006,3406238754,3533113740,1672633789,1672636455,2666
10538,3792440162,3505709407,1672622393,1672623965,1572
11187,3500049870,3919345990,1672655076,1672655217,141
11766,3360837082,3736941123,1672628900,1672629808,908
10400,3783879023,3304030474,1672628892,1672631228,2336
11550,3340321384,3512343029,1672537683,1672538521,838
10288,3518511124,3287403291,1672670299,1672672034,1735
11791,3806471413,3779382417,1672653420,1672655043,1623
11238,3662794240,3514005973,1672596020,1672599007,2987
11256,3610806770,3701529552,1672624142,1672626646,2504
9851,3440582836,3680832669,1672627342,1672628470,1128
10114,3392482187,3505839395,1672674728,1672677918,3190
9923,3857609616,3716285196,1672556502,1672558766,2264
10890,3776193847,3628423403,1672625548,1672629143,3595
10045,3519948471,3793814153,1672555420,1672555863,443
11563,3505653701,3311583437,1672682297,1672682458,161
10460,3488988274,3517652011,1672597497,1672600154,2657
11566,3516651799,3756157377,1672540141,1672543120,2979
9838,3627377299,3519730914,1672638484,1672638978,494
10188,3276499910,3344710271,1672611467,1672613600,2133
10383,3776447604,3818570577,1672656259,1672657216,957
10238,3773636983,3772980989,1672649511,1672652803,3292
11613,3515838621,3825932442,1672563443,1672564396,953
10089,3927805949,3780482864,1672579551,1672580567,1016
11557,3732871856,3603452936,1672638374,1672638750,376
10444,3392010033,3792267993,1672695627,1672696418,791
9857,3505155858,3617135064,1672593078,1672595374,2296
10057,3412605548,3301403047,1672570119,1672573271,3152
10445,3783730769,3447312353,1672567515,1672567655,140
11426,3890211161,3408408584,1672678979,1672680201,1222
9941,3780900318,3357074700,1672598816,1672601479,2663
10760,3432050858,3637105495,1672674939,1672676793,1854
11286,3756536512,3600842635,1672606388,1672608379,1991
11112,3838748301,3756843139,1672536051,1672536560,509
9898,3772169046,3346755179,1672569069,1672572242,3173
10796,3899970524,3393128259,1672600744,1672601632,888
10147,3534984243,3814770073,1672621029,1672624372,3343
10766,3500654356,3517766135,1672658314,1672659913,1599
9795,3440770466,3274223335,1672532609,1672534563,1954
11117,3358262975,3921138062,1672658280,1672659001,721
10841,3514737648,3830962592,1672600355,1672601292,937
11345,3770966950,3314965818,1672685082,1672687051,1969
10114,3777405860,3783651407,1672689787,1672693266,3479
11551,3701534043,3534543864,1672605010,1672606839,1829
11479,3517440258,3757060033,1672550815,1672552963,2148
10679,3773475506,3420854927,1672608249,1672609849,1600
11276,3500596577,3445406685,1672540525,1672541817,1292
9969,3884192843,3780749789,1672557400,1672557614,214
10761,3336501403,3227206772,1672693929,1672696994,3065
11495,3780050146,3850904092,1672633600,1672634361,761
11191,3466655775,3902682060,1672551195,1672554227,3032
11540,3369270860,3662522808,1672554142,1672556421,2279
11426,3622218289,3734233216,1672552194,1672555736,3542
10244,3400903513,3407403080,1672618645,1672619843,1198
11666,3414510793,3500741005,1672598800,1672599390,590
11745,3341129425,3555763674,1672667231,1672670126,2895
10108,3614484939,3343859998,1672702275,1672702986,711
9925,3634670780,3299052917,1672635582,1672636109,527
9923,3475560058,3509445318,1672536010,1672538795,2785
11050,3714658474,3757855416,1672647463,1672649359,1896
11028,3512596743,3933872044,1672587011,1672589700,2689
9968,3660163550,3774325486,1672700966,1672702032,1066
10421,3826068495,3792597493,1672559958,1672560118,160
11620,3680988889,3757823215,1672535876,1672537961,2085
11176,3519260216,3701296091,1672560533,1672560615,82
11457,3701519251,3772844451,1672555833,1672559258,3425
10964,3778924002,3510218188,1672552616,1672555844,3228
10381,3373851012,3501407804,1672681374,1672683670,2296
10065,3711404205,3505828210,1672613104,1672616568,3464
10747,3477248170,3513215373,1672554719,1672556988,2269
10642,3735422623,3480259863,1672570662,1672573002,2340
10024,3713283029,3514801709,1672575162,1672575436,274
10187,3517132086,3393376416,1672561402,1672562434,1032
10799,3770981604,3770544738,1672652367,1672654177,1810
11788,3297100323,3342368576,1672658030,1672660347,2317
9841,3715602742,3880882684,1672611060,1672611798,738
10516,3710125627,3600699873,1672567402,1672570995,3593
11191,3793274957,3806034626,1672656362,1672656689,327
10651,3713606829,3773024346,1672667719,1672668517,798
11251,3500833053,3774205060,1672639217,1672642405,3188
11434,3853275529,3406937294,1672605301,1672608287,2986
10349,3446066492,3388774559,1672640484,1672643940,3456
11734,3381254180,3714453773,1672583030,1672585523,2493
11595,3622152515,3825795004,1672699350,1672700167,817
10914,3501628472,3500793739,1672660402,1672663519,3117
10662,3534111498,3516257130,1672684258,1672685441,1183
11783,3792578118,3396472026,1672568531,1672571504,2973
10325,3439036305,3311514075,1672625162,1672627748,2586
10525,3711844574,3415228763,1672687379,1672689445,2066
10570,3971282455,3477248170,1672648781,1672652274,3493
9918,3807717766,3777569538,1672693799,1672697025,3226
11634,3453538201,3899903158,1672677245,1672680551,3306
10682,3299052917,3733411026,1672578213,1672581029,2816
10665,3822634862,3279726491,1672572878,1672575298,2420
10899,3480259863,3925792265,1672638943,1672641904,2961
11230,3731905251,3396472026,1672605994,1672607808,1814
11537,3686644062,3505140123,1672700583,1672704029,3446
10473,3511671476,3938409715,1672534809,1672536287,1478
11080,3406029706,3533841983,1672630171,1672633215,3044
10648,3780982229,3855077502,1672539699,1672541288,1589
10590,3710397477,3513186578,1672611544,1672614673,3129
9901,3783238023,3416225867,1672629213,1672630314,1101
11061,3713416106,3505032773,1672609300,1672611353,2053
10549,3714787207,3533440294,1672666244,1672666469,225
10802,3703849264,3340321384,1672580960,1672583001,2041
11535,3905955166,3854202447,1672533058,1672533685,627
10084,3510484107,3665603628,1672534740,1672537325,2585
11571,3516819320,3510233949,1672548700,1672548943,243
11149,3533365834,3296970170,1672587515,1672589708,2193
11078,3518335611,3857389270,1672654933,1672657002,2069
11271,3755361692,3925098136,1672581912,1672584336,2424
10506,3971051020,3352295704,1672689187,1672690439,1252
10550,3614944981,3397527886,1672599784,1672601239,1455
11465,3515100211,3609925909,1672677569,1672679642,2073
9847,3500555856,3666655293,1672690135,1672692374,2239
9827,3808849597,3512417028,1672695672,1672698857,3185
11063,3638050763,3760080378,1672653536,1672655853,2317
11644,3517499844,3368339963,1672607247,1672608554,1307
10663,3516153301,3334824744,1672672658,1672673993,1335
11073,3703336988,3977880564,1672646935,1672647612,677
10655,3444598583,3893527651,1672540926,1672541138,212
11304,3465672238,3534499421,1672659539,1672660691,1152
10205,3300238532,3534328311,1672616053,1672616472,419
10094,3614484939,3716633983,1672597629,1672600030,2401
10396,3893932944,3837435907,1672599622,1672602163,2541
9833,3312959324,3500444748,1672577086,1672579466,2380
10972,3906075386,3426207439,1672552923,1672553825,902
11421,3205948776,3518117078,1672696671,1672697225,554
10092,3851877325,3783967375,1672631344,1672634171,2827
10020,3461630842,3880549316,1672604052,1672605338,1286
11246,3710046567,3805268739,1672660423,1672662330,1907
10638,3394959062,3285515107,1672583810,1672584919,1109
11298,3772019557,3513186622,1672622606,1672623049,443
10644,3730600658,3686081254,1672583279,1672585105,1826
10216,3684108920,3714806574,1672650876,1672651160,284
10465,3440671139,3791522832,1672553986,1672555999,2013
9810,3312733562,3895507040,1672566104,1672569327,3223
10047,3714525519,3500589560,1672657221,1672660413,3192
10808,3618672178,3922409420,1672666751,1672669874,3123
11155,3755989680,3276231633,1672655009,1672658213,3204
10573,3500221079,3417223898,1672662404,1672664822,2418
10914,3776193847,3716492409,1672544912,1672545570,658
11375,3669918958,3279851026,1672668844,1672671350,2506
11641,3476416072,3773378103,1672534141,1672535571,1430
9967,3737738751,3811354125,1672543686,1672546807,3121
10113,3491250381,3770457058,1672701522,1672704399,2877
10012,3226761201,3714919471,1672564785,1672566331,1546
11669,3334633634,3685396470,1672693805,1672695010,1205
10287,3773161055,3512288503,1672538217,1672541092,2875
9870,3500096103,3701060732,1672545544,1672548395,2851
11293,3736621212,3909822999,1672633397,1672635933,2536
10524,3510869438,3778318250,1672594639,1672597350,2711
11315,3330466913,3772489471,1672595031,1672598287,3256
11380,3880562532,3474074188,1672532504,1672535880,3376
9841,3334482021,3445733121,1672566978,1672570019,3041
9872,3776732532,3772164469,1672547698,1672548706,1008
10789,3701284535,3774539067,1672611854,1672614359,2505
10975,3610806770,3534562354,1672594303,1672595955,1652
10887,3221736756,3445896667,1672571131,1672572167,1036
10149,3434052463,3476144563,1672609241,1672611544,2303
11578,3895944547,3501759031,1672629037,1672631645,2608
10607,3856129522,3856316719,1672582095,1672582785,690
11228,3434581257,3472561941,1672608982,1672610355,1373
10157,3837885956,3368441333,1672575632,1672577902,2270
11523,3496407500,3922786716,1672650087,1672652187,2100
11164,3710271021,3739297004,1672539061,1672542237,3176
10738,3772262649,3557129226,1672623707,1672625367,1660
11049,3921138062,3370401047,1672628214,1672630955,2741
10678,3837435907,3517380144,1672628148,1672631373,3225
10818,3773032706,3890194669,1672605299,1672608160,2861
11714,3825082811,3772869013,1672533604,1672536629,3025
10324,3714645218,3512490032,1672687624,1672688368,744
10868,3701978422,3779478448,1672573027,1672575608,2581
9879,3894756677,3780942505,1672600020,1672603413,3393
9954,3341432459,3498857406,1672569538,1672571403,1865
10061,3382696725,3663353552,1672667668,1672667951,283
11560,3778741325,3783730769,1672691760,1672692793,1033
10288,3428325402,3757732853,1672689061,1672689471,410
11315,3224040894,3311200541,1672623554,1672623897,343
9868,3737738751,3777149336,1672652513,1672655254,2741
11770,3534372899,3380628097,1672604352,1672605856,1504
10325,3793902476,3461630842,1672545486,1672547292,1806
11728,3534812391,3509701363,1672616487,1672618234,1747
10457,3317190427,3792455305,1672532449,1672532837,388
10783,3715284599,3316821313,1672615191,1672618416,3225
10015,3738526914,3779212271,1672648629,1672649582,953
10814,3906260966,3778738044,1672653627,1672656319,2692
10535,3513624915,3791532324,1672654850,1672658404,3554
10309,3757032266,3669497617,1672616797,1672617804,1007
10866,3516335333,3509651954,1672606121,1672608009,1888
10931,3711223297,3792337863,1672622772,1672624346,1574
10499,3511095300,3773134128,1672699614,1672699976,362
10312,3853182912,3804075198,1672641215,1672643978,2763
10978,3371759126,3760731595,1672618848,1672619272,424
11094,3272838634,3893527651,1672534113,1672534680,567
10830,3971996397,3730459093,1672544906,1672545607,701
10211,3779723939,3509445318,1672651254,1672652030,776
11260,3778731000,3385124073,1672664442,1672667865,3423
11362,3517380144,3757513651,1672614588,1672615046,458
10770,3713416756,3701459978,1672567010,1672570560,3550
11386,3408828584,3428076194,1672657312,1672657584,272
11303,3777758203,3777641081,1672534973,1672535173,200
10655,3602680347,3209958726,1672666741,1672669904,3163
10867,3713875941,3510254698,1672666608,1672668048,1440
10307,3772648837,3223177147,1672584498,1672585834,1336
11735,3450503086,3533841983,1672607836,1672608091,255
11389,3479207976,3804075198,1672550806,1672551986,1180
11086,3623512088,3316121649,1672660308,1672663075,2767
11242,3817029483,3420854927,1672644378,1672644690,312
10990,3559759778,3780900318,1672592835,1672593251,416
10856,3500814753,3739297004,1672601344,1672601526,182
10196,3515047288,3779689733,1672575229,1672576569,1340
9813,3516472352,3716492409,1672669780,1672671835,2055
10528,3246062632,3554174421,1672625222,1672627224,2002
11578,3512504247,3520763492,1672662192,1672663655,1463
10760,3804840997,3516067011,1672669602,1672672167,2565
11306,3807584987,3713476192,1672585228,1672586814,1586
11383,3760679372,3505816624,1672570174,1672573224,3050
11453,3466655775,3482519872,1672572413,1672574921,2508
10003,3730226545,3497562878,1672578450,1672579711,1261
9909,3913847876,3791574640,1672533140,1672533523,383
10846,3714870496,3755374000,1672562702,1672565537,2835
10822,3371184929,3273758330,1672676875,1672677387,512
10012,3281970147,3760390822,1672615515,1672617501,1986
10995,3772234939,3908878965,1672608031,1672608767,736
9859,3516777819,3244397548,1672536509,1672540053,3544
11314,3509912164,3622729771,1672658833,1672662146,3313
11138,3938398160,3772070986,1672646058,1672646922,864
11448,3519000878,3890638402,1672653427,1672656121,2694
11040,3977209952,3430296808,1672572962,1672576421,3459
10772,3777304517,3520189871,1672606671,1672609899,3228
10797,3553321027,3518794921,1672547568,1672550295,2727
9805,3756998113,3481019442,1672700030,1672701106,1076
11476,3907039612,3505697295,1672682409,1672685609,3200
10642,3311231911,3500049870,1672531854,1672535120,3266
11620,3511218261,3739567072,1672625545,1672626845,1300
11241,3515753241,3304030474,1672661302,1672663937,2635
11449,3880882684,3756525103,1672652648,1672653771,1123
9977,3500785888,3830291558,1672617901,1672620469,2568
10901,3390368796,3772425253,1672702129,1672705413,3284
11301,3701265238,3791205793,1672608474,1672610667,2193
9843,3713475356,3715923089,1672609402,1672610772,1370
11528,3774296721,3501612813,1672693412,1672696786,3374
10780,3715114417,3893932944,1672647340,1672649546,2206
11180,3774663639,3513140146,1672615782,1672617399,1617
10690,3505560793,3278430820,1672561175,1672564579,3404
11267,3779255367,3380628097,1672541477,1672541566,89
11255,3855222429,3514776568,1672634798,1672638157,3359
10849,3477582923,3613828705,1672640266,1672640629,363
11236,3855977674,3716595760,1672689481,1672691407,1926
11275,3409098014,3780213684,1672670299,1672673399,3100
10478,3779748270,3285587972,1672626801,1672627354,553
10505,3773161055,3361926328,1672657226,1672659584,2358
10965,3270502801,3491390365,1672670048,1672670571,523
10781,3236886943,3829412384,1672676434,1672678683,2249
10408,3408111327,3333355914,1672582938,1672586309,3371
10076,3285515107,3514145752,1672627626,1672631059,3433
10626,3418367752,3832333115,1672571801,1672572456,655
10809,3928508375,3519621901,1672583262,1672585700,2438
9887,3518408734,3896622009,1672634501,1672635487,986
11095,3668063289,3779478448,1672665046,1672666486,1440
10131,3418997135,3500096103,1672645134,1672648227,3093
11354,3471585513,3733953055,1672557831,1672559588,1757
10057,3772708314,3919211457,1672663648,1672667175,3527
10312,3774606418,3817076003,1672647170,1672648310,1140
10845,3516429380,3760541837,1672696530,1672699410,2880
11579,3777499535,3903115138,1672593028,1672594456,1428
11633,3242082716,3361952532,1672664394,1672665140,746
10231,3309651238,3516965624,1672599789,1672600167,378
10189,3667814788,3534937492,1672630673,1672631591,918
10058,3773432494,3929446196,1672668270,1672670248,1978
11445,3551833298,3512802259,1672662718,1672664432,1714
11369,3512794667,3733870816,1672595926,1672598613,2687
11713,3520273299,3778702093,1672625115,1672627308,2193
10765,3518989186,3928076270,1672680444,1672682173,1729
10123,3305612422,3447267291,1672678653,1672681916,3263
10312,3374147279,3403035480,1672573338,1672575077,1739
11321,3760525465,3920606331,1672621679,1672622120,441
10075,3398021818,3294821709,1672659134,1672662228,3094
10535,3515939841,3445355677,1672691438,1672693589,2151
11005,3733423371,3791532324,1672548863,1672551470,2607
11072,3703104365,3757501067,1672665763,1672667009,1246
9855,3972729768,3445558740,1672676403,1672679086,2683
11505,3714435747,3434452046,1672673704,1672674666,962
10502,3792173463,3817076003,1672657493,1672660726,3233
10303,3791332061,3313795594,1672688224,1672690274,2050
9828,3778382224,3711349327,1672690709,1672690995,286
11373,3271282663,3520145112,1672549532,1672551768,2236
11069,3534278019,3636852764,1672649831,1672650252,421
11385,3770630937,3909399636,1672550152,1672550971,819
11090,3392482187,3773953689,1672578863,1672581675,2812
11199,3501205057,3414841458,1672620699,1672622841,2142
10091,3375905193,3395610742,1672659277,1672661386,2109
10620,3461931154,3603740088,1672692087,1672693023,936
11290,3358959807,3757199889,1672634547,1672634628,81
10599,3825082811,3791070926,1672542065,1672543546,1481
10085,3777439655,3919494952,1672688192,1672691628,3436
11712,3773344258,3738547113,1672537342,1672540583,3241
11145,3462985379,3710316008,1672546295,1672547900,1605
11720,3505248368,3772556646,1672571248,1672572015,767
10745,3388774559,3516321814,1672571269,1672571992,723
11667,3399726243,3519297683,1672628497,1672630369,1872
10350,3239779992,3291446384,1672674610,1672676919,2309
11739,3923910914,3713566527,1672549160,1672552054,2894
11269,3406492167,3783238023,1672678900,1672681935,3035
10845,3716841469,3500356342,1672639200,1672641063,1863
11202,3534562354,3755769731,1672597340,1672598307,967
10740,3738547113,3793569914,1672585718,1672589250,3532
10436,3316406470,3915195160,1672586253,1672589737,3484
10911,3379666159,3701374160,1672546340,1672546896,556
10960,3494748808,3512625661,1672613292,1672613502,210
10408,3779427180,3755769254,1672640867,1672644245,3378
9898,3624872714,3518368900,1672645064,1672646432,1368
10678,3368951504,3518335611,1672616544,1672620058,3514
11654,3534506090,3505825767,1672638249,1672640891,2642
10536,3505853594,3778819352,1672539314,1672541555,2241
10022,3311188620,3772282008,1672574039,1672574717,678
10573,3715844082,3684108920,1672625522,1672625904,382
11161,3716423829,3509433155,1672559572,1672562582,3010
10554,3373802545,3710125627,1672532250,1672532449,199
9994,3774965463,3735679000,1672610090,1672612698,2608
10228,3514515499,3209280342,1672566268,1672569838,3570
11531,3716976932,3439045964,1672610875,1672611628,753
10729,3881785069,3515838621,1672627302,1672629492,2190
10277,3776249160,3352044245,1672581955,1672583014,1059
11406,3229734741,3534372899,1672609777,1672612791,3014
10702,3621812406,3517902505,1672669338,1672672466,3128
10957,3770715115,3509828883,1672582423,1672585472,3049
11100,3242082716,3714142299,1672648611,1672651932,3321
11775,3939422411,3607288879,1672576391,1672579187,2796
11184,3757732853,3487988841,1672658216,1672658865,649
10923,3760385591,3770391782,1672661690,1672664485,2795
11079,3701493094,3776841808,1672608713,1672611167,2454
10480,3293540333,3437108337,1672681835,1672685048,3213
10286,3443041059,3497138014,1672659964,1672661131,1167
11702,3930501172,3302988745,1672535554,1672538343,2789
10105,3923910914,3534562354,1672583165,1672585654,2489
10759,3835509670,3902292032,1672563912,1672566610,2698
10795,3828906027,3440770466,1672603094,1672603409,315
10245,3519689906,3433196933,1672591721,1672595313,3592
11550,3837887478,3534758256,1672607633,1672610654,3021
11425,3295787354,3533593766,1672614060,1672614481,421
11167,3241567995,3310702648,1672550739,1672551450,711
10865,3415562576,3348343425,1672623706,1672626131,2425
10029,3353194923,3519341916,1672575978,1672578251,2273
9947,3939422411,3778924002,1672618907,1672620942,2035
10191,3929002318,3837378340,1672633283,1672634556,1273
10638,3478052226,3770630937,1672651573,1672653657,2084
9930,3512495325,3445558740,1672585580,1672588814,3234
11670,3711810268,3853275529,1672539793,1672539918,125
10092,3435715962,3773523569,1672551010,1672554321,3311
10512,3774394000,3773024346,1672616127,1672619444,3317
11036,3284829602,3701770921,1672638659,1672639468,809
11769,3774652449,3710852576,1672693132,1672693354,222
11638,3558349840,3275975921,1672566186,1672569782,3596
10539,3517652011,3271389160,1672698664,1672701004,2340
11437,3917811545,3773202954,1672631056,1672633193,2137
10043,3772569860,3393128259,1672564903,1672567982,3079
11234,3714287902,3461877104,1672603910,1672607396,3486
10941,3337903727,3714377201,1672605744,1672608306,2562
9968,3354015456,3341985886,1672590863,1672592370,1507
10319,3518335611,3520145112,1672652185,1672654993,2808
9906,3855977674,3500356342,1672680245,1672682222,1977
10329,3311231911,3512490032,1672538570,1672541916,3346
11760,3602054754,3774251051,1672673970,1672675465,1495
11287,3755378125,3773736248,1672584518,1672586334,1816
9821,3511908639,3714690161,1672580705,1672582159,1454
11468,3773475506,3612042508,1672701500,1672704809,3309
10067,3780786276,3779505358,1672534302,1672534596,294
10115,3227956115,3533037906,1672669800,1672672138,2338
10516,3501261089,3534537581,1672600768,1672601927,1159
10330,3499142934,3393543588,1672547784,1672548519,735
11580,3497138014,3422314045,1672666806,1672669556,2750
9898,3807584987,3635433296,1672697938,1672698278,340
10461,3505887814,3285201542,1672598390,1672601584,3194
10601,3602570831,3710891331,1672680541,1672683355,2814
10145,3500096103,3710082615,1672633511,1672634918,1407
10980,3834949242,3534168768,1672671199,1672672282,1083
10532,3682906048,3773202954,1672555888,1672558927,3039
10265,3509186338,3516378356,1672555012,1672558305,3293
11715,3933469838,3233993993,1672579888,1672583433,3545
10326,3615245840,3285136057,1672583429,1672584752,1323
10627,3710147457,3714424237,1672675397,1672677091,1694
10021,3473562779,3778713526,1672692100,1672692650,550
11393,3313579674,3793442891,1672659781,1672660779,998
11198,3220987526,3772569860,1672557431,1672559283,1852
11061,3755729826,3227874229,1672536679,1672536868,189
11380,3701529552,3925792265,1672679698,1672681887,2189
10430,3971282455,3500909455,1672644243,1672646034,1791
9839,3610723722,3274239253,1672674253,1672674805,552
11506,3669475165,3703818358,1672662711,1672665192,2481
9865,3772343750,3515681585,1672579064,1672580550,1486
11774,3886957097,3510206323,1672592358,1672593720,1362
11273,3703423962,3772343750,1672588459,1672590049,1590
11013,3533726421,3773041843,1672595672,1672596462,790
10737,3926065090,3733915784,1672634142,1672634548,406
11755,3701171318,3909067335,1672613983,1672614467,484
11763,3783563043,3479207976,1672550632,1672553993,3361
11653,3715852330,3369810091,1672542848,1672546134,3286
10379,3309528048,3240683148,1672539729,1672542139,2410
11482,3516517348,3777370601,1672615431,1672617301,1870
10013,3515726910,3349475873,1672632476,1672634845,2369
11648,3600171014,3519015940,1672697748,1672700598,2850
10461,3778182724,3500096103,1672670535,1672671656,1121
11695,3510111365,3733796228,1672659734,1672661514,1780
11315,3520182275,3638071975,1672631660,1672633032,1372
10634,3774355339,3311260898,1672564129,1672567228,3099
10106,3931495845,3756759239,1672560372,1672561825,1453
10226,3757311529,3713906305,1672549529,1672553108,3579
11315,3770424892,3483078667,1672565687,1672568532,2845
11344,3342426430,3714179543,1672673919,1672676365,2446
10866,3619494735,3239279744,1672696017,1672697154,1137
10374,3288791629,3334381941,1672547978,1672549671,1693
11513,3366566029,3449020351,1672683215,1672683370,155
10861,3780308809,3519015940,1672626003,1672628044,2041
11219,3701449715,3516103646,1672656835,1672658434,1599
10310,3313795594,3909067335,1672597279,1672600542,3263
9942,3760656396,3732871856,1672567471,1672570778,3307
10812,3703168159,3811503860,1672613281,1672615640,2359
11447,3610517436,3276393542,1672687613,1672689427,1814
11554,3338016147,3633622298,1672536779,1672540262,3483
11335,3444168914,3300238532,1672640991,1672642450,1459
11706,3621629499,3511286390,1672627289,1672629288,1999
10013,3404375908,3275057862,1672551621,1672554552,2931
10083,3229570647,3858330969,1672542293,1672542370,77
10096,3818570577,3403218814,1672554379,1672557242,2863
11496,3386323728,3623113240,1672659395,1672662935,3540
10210,3205113625,3334461288,1672606930,1672609508,2578
10786,3510869438,3335055096,1672616575,1672618481,1906
11166,3850181934,3221736756,1672693280,1672696044,2764
9978,3760274119,3295787354,1672617313,1672620566,3253
10117,3776867553,3757944870,1672668228,1672671363,3135
11313,3510484107,3387700451,1672618740,1672620123,1383
11341,3505853594,3510826414,1672628930,1672631596,2666
11762,3701127475,3853188285,1672562029,1672565612,3583
11691,3783095041,3851810349,1672573034,1672576517,3483
10643,3776791436,3463564410,1672703707,1672706537,2830
11579,3510781595,3311569360,1672544383,1672545531,1148
9803,3628556590,3517627003,1672532764,1672535858,3094
11313,3880562532,3285587972,1672631870,1672632282,412
10586,3792277399,3701475090,1672563491,1672565749,2258
10918,3934280144,3793375825,1672580139,1672581355,1216
10550,3281970147,3509503263,1672648698,1672650413,1715
11454,3792411831,3514576083,1672552908,1672556344,3436
10432,3379400553,3809871495,1672576577,1672578430,1853
9870,3516932899,3466655775,1672579235,1672579719,484
11460,3513250976,3445733121,1672538936,1672541146,2210
10088,3714731729,3414387263,1672539620,1672540883,1263
10187,3308481706,3711223297,1672609437,1672612035,2598
11112,3371184929,3417360319,1672614689,1672616541,1852
11509,3510547682,3760096466,1672563168,1672563520,352
11326,3701534043,3514941815,1672674400,1672675137,737
11145,3792021895,3488931357,1672596540,1672596817,277
11016,3685396470,3778124514,1672670433,1672673063,2630
11255,3681504869,3517151644,1672694067,1672697666,3599
11715,3793375825,3772227820,1672667957,1672670866,2909
10370,3505117019,3666022373,1672545049,1672548324,3275
11089,3470997293,3756113624,1672630961,1672631846,885
10177,3288346356,3772648837,1672635946,1672637978,2032
9808,3500654356,3783357035,1672598815,1672601592,2777
11332,3637566026,3278430820,1672651909,1672654988,3079
10469,3221736756,3778370462,1672591952,1672594568,2616
10853,3399726243,3701779683,1672560614,1672561247,633
11772,3715566511,3388463477,1672548058,1672550926,2868
10675,3509431396,3221736756,1672638714,1672639964,1250
11242,3613216900,3363549860,1672592061,1672595120,3059
10892,3517949586,3501843187,1672630101,1672633404,3303
10159,3774782065,3791351852,1672626442,1672628372,1930
11047,3458130310,3772169046,1672680743,1672684004,3261
10333,3810818108,3755865626,1672581273,1672584106,2833
11058,3514107131,3714903456,1672579811,1672580755,944
10534,3777932225,3407734098,1672599712,1672600453,741
10780,3774359137,3710515351,1672535776,1672538332,2556
10229,3777112124,3665478011,1672681486,1672682838,1352
10116,3927675706,3779393140,1672576355,1672578779,2424
11418,3614112171,3435342362,1672556939,1672557933,994
11775,3399726243,3236512807,1672544294,1672546123,1829
11161,3387700451,3533628528,1672664807,1672667322,2515
10809,3815700240,3776440009,1672694409,1672697360,2951
10534,3236512807,3509018337,1672698920,1672699377,457
11012,3449020351,3501192566,1672572440,1672575155,2715
10835,3687445224,3273758330,1672579448,1672582180,2732
11705,3501548163,3294164983,1672700098,1672700286,188
10907,3534168768,3488749569,1672698835,1672700257,1422
10151,3557129226,3554437212,1672538269,1672539897,1628
10725,3335974305,3733953055,1672628185,1672628975,790
11298,3240683148,3434452046,1672630863,1672631261,398
11429,3714455496,3347172556,1672662678,1672665577,2899
10852,3515597467,3520273299,1672612638,1672616089,3451
10614,3436401020,3500799617,1672651933,1672653854,1921
10300,3918981936,3714312797,1672632543,1672635017,2474
10459,3701663839,3880030249,1672631001,1672631768,767
11224,3519015940,3773876312,1672680291,1672683786,3495
10245,3282053097,3520189871,1672603873,1672605193,1320
11005,3467415939,3372617110,1672536139,1672538055,1916
10362,3303772923,3330318282,1672635277,1672638741,3464
10188,3703896751,3500342408,1672540211,1672543562,3351
10260,3481700413,3510335069,1672603512,1672604062,550
11286,3452802329,3783947742,1672581381,1672584443,3062
11707,3519341916,3710260848,1672667793,1672670406,2613
11173,3791617239,3792824886,1672534394,1672535283,889
11334,3791716170,3510278533,1672591814,1672591948,134
10703,3439045964,3500726347,1672678570,1672682157,3587
10830,3427049290,3556684272,1672560895,1672564058,3163
10936,3756536512,3701663839,1672680315,1672683085,2770
11271,3500093945,3926724515,1672660744,1672663929,3185
11429,3509562377,3701412729,1672554157,1672555155,998
11575,3467944159,3667814788,1672677307,1672677416,109
11670,3275274182,3518157683,1672599354,1672600701,1347
11267,3513171472,3701291994,1672678847,1672681760,2913
11347,3428325402,3419829238,1672679002,1672680002,1000
11581,3334708091,3660246433,1672672675,1672675325,2650
10779,3394986304,3777706200,1672668382,1672669437,1055
9869,3273758330,3622729771,1672639110,1672642308,3198
10161,3971996397,3510535683,1672624384,1672627759,3375
9796,3519228207,3387621912,1672667253,1672667392,139
10621,3422205569,3275735969,1672638874,1672639851,977
10758,3703697059,3735152111,1672699708,1672700572,864
11483,3358473096,3770715115,1672703936,1672706396,2460
11206,3713224986,3714287902,1672658289,1672661120,2831
9874,3853783593,3779689733,1672534005,1672536127,2122
9823,3430399931,3805718871,1672573947,1672575174,1227
9910,3341432459,3236206821,1672620042,1672622213,2171
11549,3463564410,3609103278,1672604776,1672605299,523
10554,3282240901,3500814753,1672540771,1672543142,2371
11345,3505825767,3883640454,1672591699,1672593926,2227
10939,3777672363,3774946684,1672626768,1672627750,982
11515,3200372897,3637522163,1672629471,1672631116,1645
9811,3491390365,3916656185,1672554821,1672556878,2057
9846,3226761201,3505502819,1672564209,1672565345,1136
11541,3481019442,3770972037,1672602446,1672603201,755
9880,3317989975,3770533675,1672593191,1672594330,1139
10951,3907245259,3933106901,1672549278,1672551646,2368
9967,3714142299,3811354125,1672578746,1672580025,1279
11564,3902292032,3855209450,1672551807,1672554697,2890
11700,3770424941,3516668203,1672671579,1672673237,1658
11031,3760416450,3284483177,1672631734,1672633883,2149
10406,3520779124,3783594246,1672617080,1672619979,2899
10354,3362706073,3714645218,1672556091,1672559102,3011
10653,3310961923,3512750313,1672551462,1672553310,1848
9884,3510836047,3509274030,1672651769,1672652404,635
10387,3778695017,3777387533,1672596604,1672598290,1686
10001,3776407517,3512555384,1672575728,1672578241,2513
11424,3971447562,3505500523,1672599867,1672601669,1802
10992,3362368123,3359418136,1672537450,1672539175,1725
10782,3358385652,3206241691,1672629167,1672629396,229
11235,3505119470,3520515739,1672686610,1672687334,724
10379,3819400315,3606688595,1672682689,1672684348,1659
10903,3780733404,3681737865,1672601534,1672604051,2517
10111,3505998260,3387322545,1672651274,1672653363,2089
10309,3366961580,3554174421,1672634247,1672634838,591
11512,3514673213,3756680289,1672619985,1672621363,1378
10324,3835262447,3605760561,1672669617,1672671618,2001
11686,3971447562,3533427742,1672551563,1672554631,3068
10567,3447591143,3505011956,1672546795,1672548311,1516
10463,3505359060,3973582279,1672611113,1672613988,2875
10760,3369558911,3925208102,1672559287,1672560324,1037
10736,3829698950,3534578428,1672703850,1672705803,1953
11020,3337715675,3793899166,1672587834,1672588375,541
10878,3516429380,3533077580,1672542249,1672543675,1426
10832,3302348002,3896200048,1672534883,1672535377,494
10979,3285587972,3838039092,1672664278,1672667014,2736
11747,3714690161,3512527440,1672620124,1672620432,308
10379,3534459983,3716595760,1672580553,1672583944,3391
10720,3757393413,3603167427,1672632260,1672633565,1305
10140,3714892312,3518511124,1672649713,1672652897,3184
11340,3520763492,3510206323,1672648403,1672648869,466
11075,3318224774,3505811269,1672691065,1672692382,1317
9884,3505980138,3447267291,1672626883,1672627054,171
10487,3857590978,3688845298,1672598419,1672600405,1986
10871,3500974385,3716160006,1672625313,1672626608,1295
11249,3519059808,3495637721,1672579526,1672580290,764
11349,3248061684,3520473111,1672670608,1672672316,1708
11028,3779561601,3793860209,1672620825,1672623436,2611
11616,3808849597,3238779889,1672561831,1672564597,2766
11222,3738760498,3701377471,1672549418,1672552655,3237
10048,3406101720,3829761380,1672599176,1672599256,80
11382,3515893948,3970851830,1672681788,1672684391,2603
10988,3501828287,3380357490,1672541989,1672544973,2984
11581,3793569914,3853182912,1672654674,1672658241,3567
10232,3713566527,3395505794,1672677033,1672677287,254
11685,3618895679,3622152515,1672702761,1672706276,3515
11606,3335139032,3378534521,1672657956,1672659264,1308
11257,3520273299,3533960602,1672577509,1672580172,2663
10106,3887918622,3470962222,1672608187,1672611168,2981
10930,3927202773,3277634944,1672616615,1672618744,2129
10609,3227339675,3774702364,1672690645,1672691298,653
11088,3334461288,3516867729,1672564952,1672565526,574
9981,3770408300,3710397477,1672561809,1672562734,925
11301,3311472321,3419829238,1672581759,1672584570,2811
10732,3558203963,3900766525,1672682234,1672682737,503
10049,3447696555,3497904539,1672700300,1672700734,434
10061,3513740840,3778695895,1672536582,1672537476,894
10517,3689223632,3639465750,1672567758,1672568595,837
11356,3736621212,3737467358,1672586005,1672586631,626
10325,3443004958,3757501067,1672605376,1672606559,1183
11685,3317190427,3805616707,1672544545,1672547466,2921
11732,3638126174,3388923880,1672548450,1672550899,2449
10248,3519059808,3779706467,1672677347,1672678020,673
11255,3305093237,3854202447,1672556400,1672557144,744
10420,3411626917,3440991826,1672596604,1672597674,1070
10922,3552922094,3227059650,1672636668,1672636768,100
10335,3307535495,3776811587,1672687558,1672689043,1485
11147,3857244486,3272827860,1672590786,1672591952,1166
10311,3757869138,3756119976,1672554632,1672555833,1201
10219,3477951091,3899205452,1672619258,1672622590,3332
10514,3772648837,3976742903,1672653943,1672656697,2754
11174,3496407500,3462645981,1672677977,1672680337,2360
11201,3776053981,3505936495,1672621171,1672622888,1717
11792,3856699097,3737946004,1672684041,1672684513,472
10012,3519319233,3313392810,1672647185,1672648178,993
11706,3510882576,3330799389,1672692563,1672693354,791
11138,3478937459,3611832288,1672611412,1672614968,3556
10522,3488988274,3625400710,1672623591,1672625658,2067
9829,3294949958,3791906680,1672561095,1672563222,2127
11439,3780942505,3886837151,1672679855,1672681861,2006
10854,3760749218,3897003751,1672702485,1672705317,2832
11509,3703725221,3233712975,1672651050,1672653500,2450
10704,3666022373,3830771832,1672640232,1672643515,3283
10021,3515970536,3778706119,1672613682,1672617079,3397
10820,3689420679,3387700451,1672640266,1672640771,505
10863,3922786716,3711613085,1672626531,1672628519,1988
10709,3703443664,3505547832,1672675012,1672677050,2038
11354,3971447562,3208894215,1672692207,1672694727,2520
10133,3505994703,3685083275,1672550927,1672552045,1118
10230,3713514933,3669140241,1672658733,1672660525,1792
11532,3760107540,3249380931,1672554858,1672555990,1132
11703,3703502114,3487231844,1672534080,1672534158,78
10709,3555763674,3500421940,1672596409,1672597704,1295
11621,3510143850,3825877848,1672683597,1672684266,669
10258,3520558137,3501657158,1672698035,1672699057,1022
11454,3472272792,3927675706,1672596980,1672599344,2364
11216,3519886257,3273242177,1672663803,1672666363,2560
10690,3777767907,3731644240,1672611625,1672613075,1450
11553,3289258397,3505032644,1672669701,1672671809,2108
10549,3368848936,3511615015,1672598376,1672601830,3454
11244,3380628097,3792578118,1672631912,1672635252,3340
10831,3347520239,3515939841,1672633375,1672634354,979
10789,3403120725,3780435349,1672584188,1672584595,407
10626,3668154066,3760080378,1672571160,1672572658,1498
11271,3429047448,3715700639,1672543654,1672544305,651
11111,3373851012,3735197034,1672595586,1672596525,939
10102,3682241594,3776122272,1672602772,1672603271,499
10338,3903115138,3505482210,1672693955,1672697446,3491
10936,3757855416,3934564437,1672610088,1672610905,817
10908,3238997746,3301431129,1672590430,1672592038,1608
10051,3897851509,3344710271,1672584191,1672585493,1302
10070,3923133978,3711187791,1672591661,1672595245,3584
10870,3713139039,3473520701,1672541682,1672543961,2279
9867,3305093237,3791382196,1672688828,1672692299,3471
10851,3779468781,3533976217,1672588898,1672592031,3133
10225,3668063289,3416225867,1672693035,1672695950,2915
10388,3505234868,3516378356,1672536708,1672538591,1883
10459,3715622084,3505438826,1672583762,1672584747,985
10213,3515655024,3792283334,1672592863,1672595239,2376
11719,3305656670,3735152111,1672635241,1672636025,784
9893,3774304163,3311774510,1672691915,1672694700,2785
10049,3621960662,3517325365,1672538676,1672540267,1591
10714,3885545415,3559125467,1672626528,1672628425,1897
10034,3387413950,3500342408,1672577621,1672579708,2087
10424,3780680252,3793783685,1672531524,1672533043,1519
11493,3509556649,3272328752,1672536089,1672538691,2602
11145,3903065952,3209075485,1672542218,1672545064,2846
10600,3501244753,3397527886,1672649645,1672650391,746
10188,3429587594,3518376262,1672544837,1672548217,3380
10879,3780050328,3227206772,1672692385,1672693623,1238
11738,3888409038,3902292032,1672606827,1672609140,2313
11642,3534122907,3224040894,1672548801,1672551228,2427
9880,3663902064,3466492108,1672596171,1672598090,1919
11716,3513213122,3422915648,1672684212,1672685356,1144
9840,3533859712,3235578121,1672585323,1672587215,1892
10202,3446066492,3792432763,1672624719,1672625635,916
11264,3229465607,3834643026,1672614543,1672616858,2315
10858,3682241594,3716891903,1672551701,1672552853,1152
11474,3898965585,3533473206,1672553264,1672555288,2024
10134,3379400553,3772112976,1672674680,1672675395,715
11715,3772425253,3703849264,1672637105,1672639242,2137
10679,3505769529,3714690161,1672694651,1672695081,430
11162,3514737648,3756363182,1672558244,1672560947,2703
10597,3501628472,3774706478,1672583441,1672584390,949
10074,3510916875,3711179193,1672545875,1672546535,660
10471,3975796415,3312733562,1672594518,1672595136,618
9968,3777686966,3512417724,1672637424,1672637487,63
11272,3780142207,3668720465,1672693852,1672695101,1249
10060,3403150349,3406492167,1672637794,1672640096,2302
11718,3517552930,3715587520,1672638981,1672640723,1742
10068,3303552616,3494748808,1672557262,1672560515,3253
11081,3515939841,3791905743,1672579834,1672582305,2471
11386,3367299721,3774673193,1672691643,1672692338,695
11365,3516706935,3500456339,1672569197,1672569561,364
9903,3666022373,3774436159,1672625980,1672626368,388
10653,3510919509,3505472087,1672598015,1672601357,3342
10007,3305727497,3387388336,1672575934,1672578058,2124
10175,3755465396,3755865626,1672569083,1672569339,256
10414,3931767736,3792255406,1672631230,1672632482,1252
10680,3494157939,3500079479,1672671193,1672671725,532
10884,3312959324,3770671714,1672685149,1672685251,102
10321,3888523259,3791206902,1672535394,1672536657,1263
10056,3661856558,3715490209,1672681630,1672683288,1658
11211,3773603836,3711040761,1672563151,1672566521,3370
11615,3295748489,3444881567,1672594919,1672597592,2673
9801,3894328297,3760416450,1672624606,1672628075,3469
10139,3514498259,3897186782,1672572610,1672573447,837
10161,3519780867,3206262649,1672593041,1672596049,3008
11234,3714281795,3519000878,1672608578,1672611823,3245
9980,3511003541,3392573386,1672644325,1672647822,3497
11649,3519703964,3501976169,1672574525,1672575802,1277
10550,3757796416,3703659324,1672553319,1672553761,442
11553,3500741005,3793003432,1672694382,1672697392,3010
10053,3703476890,3516792348,1672628185,1672631583,3398
11175,3391612879,3902357342,1672644560,1672648114,3554
10903,3533628528,3770966950,1672554113,1672557306,3193
10824,3319862687,3760554453,1672538232,1672540006,1774
10457,3515655024,3500974385,1672549403,1672552557,3154
10556,3776468503,3715790104,1672668997,1672672166,3169
10535,3919719755,3311188620,1672664846,1672667548,2702
11285,3453538201,3520395850,1672574115,1672575850,1735
11378,3611939581,3515259326,1672542727,1672544434,1707
10325,3295710494,3476144563,1672634780,1672637038,2258
11399,3776193847,3923524564,1672591468,1672592304,836
11424,3836136159,3420854927,1672549252,1672551324,2072
10627,3783157469,3459951739,1672621601,1672624549,2948
11677,3783313202,3334633634,1672658480,1672659624,1144
9800,3467663782,3606804618,1672653827,1672655116,1289
10245,3756736726,3533131937,1672666265,1672667978,1713
11094,3312733562,3686853863,1672604391,1672605167,776
11198,3399173821,3454924050,1672575589,1672578971,3382
11700,3684108920,3779340538,1672666947,1672670500,3553
9993,3501174621,3777569538,1672536737,1672539843,3106
11045,3514515499,3660176760,1672671035,1672672220,1185
10172,3360783381,3505164060,1672590103,1672591156,1053
10733,3772234939,3517499844,1672581276,1672581493,217
10627,3490008012,3738526914,1672620880,1672621004,124
10193,3384151770,3558203963,1672576759,1672578553,1794
11169,3791289855,3499622352,1672624912,1672625723,811
9908,3364067937,3305656670,1672674866,1672678092,3226
11661,3437108337,3505839395,1672646058,1672648398,2340
9854,3500688476,3780740477,1672681963,1672683514,1551
9997,3605078841,3777074709,1672663637,1672663891,254
11451,3307791650,3739217535,1672691598,1672695080,3482
10468,3517210356,3793375825,1672614410,1672615764,1354
9988,3246296769,3373018943,1672694922,1672695316,394
10684,3353194923,3509431396,1672670501,1672671139,638
10509,3710316008,3491250381,1672660125,1672660703,578
11598,3373802545,3611832288,1672628667,1672628747,80
11132,3483078667,3495446254,1672664030,1672667345,3315
11539,3621960662,3311583437,1672674718,1672676512,1794
10442,3293579860,3912811715,1672574592,1672574676,84
10781,3310737478,3713139039,1672661611,1672664507,2896
11477,3533620069,3555764822,1672699368,1672702206,2838
10979,3791108593,3505148522,1672556408,1672556774,366
11377,3505266343,3501612813,1672690089,1672693135,3046
10269,3519553933,3420983899,1672548472,1672550080,1608
9878,3510758718,3380418745,1672618276,1672621748,3472
9880,3551972633,3519703964,1672532363,1672534829,2466
11436,3227339675,3760396348,1672555656,1672557371,1715
11158,3206241691,3396472026,1672610351,1672612736,2385
9808,3757378286,3887918622,1672563499,1672564944,1445
10400,3772343750,3806471413,1672667771,1672669293,1522
11471,3501205057,3772425253,1672598979,1672601878,2899
10558,3461137945,3420854927,1672693336,1672695743,2407
11480,3293898029,3395610742,1672648327,1672650120,1793
10293,3668764192,3776440009,1672552886,1672555526,2640
10438,3713954144,3703614781,1672555052,1672557843,2791
10915,3505472087,3468281011,1672553346,1672555733,2387
10660,3447078933,3612705426,1672605099,1672605477,378
11239,3316821313,3245882008,1672676025,1672677741,1716
11037,3500342408,3429047448,1672532860,1672534351,1491
10225,3770631449,3509508477,1672589150,1672591248,2098
10687,3533728729,3466655775,1672534887,1672536523,1636
10797,3810818108,3666655293,1672564245,1672566976,2731
10083,3520625600,3395082458,1672537219,1672537869,650
11005,3221290808,3559619861,1672599803,1672603065,3262
10274,3779835734,3792432763,1672566528,1672566747,219
11422,3483078667,3452389513,1672565928,1672567240,1312
11178,3312733562,3352493805,1672627802,1672629459,1657
10053,3755119166,3971289056,1672565800,1672569186,3386
10589,3714250543,3887918622,1672689537,1672690953,1416
10518,3701311947,3370448531,1672673561,1672675609,2048
11490,3511671476,3248409083,1672571984,1672572049,65
9971,3827836825,3714294005,1672697288,1672700860,3572
9990,3488399075,3791664049,1672622385,1672623715,1330
10856,3730115019,3856699097,1672561284,1672563597,2313
9983,3500251781,3735197034,1672561820,1672563944,2124
10506,3233993993,3791289855,1672548959,1672549987,1028
10721,3501976169,3772234939,1672656794,1672658755,1961
11220,3345896913,3293553295,1672553558,1672555057,1499
11565,3235578121,3514450836,1672622277,1672625538,3261
10208,3661543201,3373018943,1672671103,1672673391,2288
10701,3246567963,3495152069,1672621287,1672622380,1093
11625,3711190257,3533131937,1672539365,1672539441,76
10156,3290097447,3483078667,1672617767,1672619839,2072
10958,3703462221,3500922040,1672635723,1672639219,3496
9881,3513143959,3510244209,1672577189,1672579823,2634
9952,3783313202,3301489209,1672541570,1672544339,2769
10135,3934070285,3304235700,1672690574,1672692596,2022
10936,3772905073,3447078933,1672622858,1672625358,2500
10337,3483347530,3773394570,1672637696,1672638525,829
9855,3512819376,3451757423,1672668064,1672668462,398
11035,3906693728,3371759126,1672650499,1672653334,2835
10936,3853275529,3711349327,1672573465,1672576816,3351
9955,3287821258,3922409420,1672608125,1672608880,755
10069,3233965781,3907225070,1672648824,1672650111,1287
11202,3887382548,3682241594,1672632197,1672633270,1073
10266,3459951739,3755175497,1672683001,1672686442,3441
11701,3511199555,3777672363,1672687661,1672690765,3104
10645,3501711464,3600171014,1672682928,1672683622,694
10560,3780969898,3711844574,1672602285,1672605883,3598
10034,3890278838,3757514745,1672642410,1672643920,1510
11100,3898965585,3492350318,1672542723,1672544819,2096
10219,3613828705,3364683368,1672640634,1672640776,142
11663,3714787207,3517949586,1672577005,1672578518,1513
11693,3668764192,3701385831,1672641476,1672642699,1223
10099,3501843187,3227874229,1672666628,1672667674,1046
10804,3422205569,3517766135,1672632445,1672632876,431
10494,3501628472,3776455762,1672582409,1672585380,2971
11396,3855077502,3357097510,1672689951,1672690036,85
10673,3711430738,3603740088,1672664746,1672667955,3209
11407,3481365330,3559619861,1672578061,1672579366,1305
10948,3666561358,3730052916,1672534309,1672534716,407
11552,3519046342,3513563152,1672689340,1672690704,1364
10433,3621812406,3307521389,1672603069,1672605389,2320
10485,3900766525,3515096959,1672568380,1672571126,2746
10731,3783095041,3510547682,1672538723,1672540376,1653
11497,3511004622,3668369938,1672671197,1672673594,2397
11417,3760144712,3912878303,1672615235,1672615588,353
11284,3305727497,3802101760,1672532555,1672534585,2030
10339,3857609616,3921138062,1672685108,1672687452,2344
10131,3378729459,3485898181,1672668929,1672670744,1815
11648,3814770073,3715737742,1672679596,1672680158,562
10302,3974264211,3703206956,1672580814,1672582998,2184
11279,3664719070,3919258737,1672625019,1672625512,493
10825,3773376762,3500198430,1672576342,1672579357,3015
11504,3228465044,3505173665,1672677264,1672680152,2888
10246,3414841458,3923133978,1672546031,1672547632,1601
11673,3505155858,3518511124,1672661244,1672664290,3046
11148,3301449986,3715282492,1672600643,1672602579,1936
10412,3822315407,3701284535,1672697189,1672700337,3148
10772,3515528947,3818236682,1672696631,1672696732,101
10847,3627431396,3356599815,1672674147,1672676514,2367
10256,3779174993,3444646562,1672610815,1672611647,832
11694,3453464785,3515974881,1672567338,1672568079,741
11461,3934991640,3302879906,1672616609,1672619022,2413
11168,3778738044,3447948483,1672636393,1672638194,1801
11410,3343511947,3533077580,1672681832,1672684930,3098
10980,3435037864,3518534560,1672665602,1672667387,1785
9920,3516932899,3880788853,1672625000,1672627523,2523
10764,3791644831,3517253559,1672606133,1672609078,2945
10966,3439532406,3226913558,1672621632,1672623458,1826
11097,3915195160,3244098077,1672625662,1672628015,2353
11124,3361952532,3207307681,1672600851,1672603283,2432
10628,3780612543,3927365255,1672685119,1672688700,3581
9798,3688410383,3714435747,1672630515,1672633067,2552
11524,3350169064,3550405857,1672618607,1672618674,67
10310,3446066492,3513508737,1672584376,1672584679,303
10534,3624872714,3779503296,1672673342,1672675356,2014
10217,3505037247,3201502111,1672615289,1672617652,2363
11075,3340723781,3511311554,1672663399,1672663518,119
10957,3760346746,3403988682,1672652338,1672653128,790
11113,3248409083,3710228292,1672562664,1672564120,1456
11489,3474350534,3554236075,1672565791,1672566876,1085
11483,3359929534,3500444748,1672577438,1672578597,1159
11672,3852161626,3271719569,1672612711,1672614143,1432
10703,3514107131,3319645922,1672544805,1672545624,819
10131,3476144563,3773554767,1672608108,1672611408,3300
10889,3509370633,3444397804,1672639874,1672639951,77
10926,3972196462,3505472087,1672562174,1672564028,1854
11194,3884934977,3240622654,1672556502,1672557962,1460
10998,3774359137,3777063455,1672690678,1672693006,2328
11039,3713728777,3511580693,1672660511,1672661500,989
11772,3358473096,3454554552,1672586420,1672589247,2827
11317,3516535558,3516585063,1672681369,1672682391,1022
10145,3379400553,3505007498,1672679636,1672681370,1734
10811,3703742071,3418997135,1672541549,1672543380,1831
10797,3413799143,3533427742,1672590712,1672592203,1491
11149,3514628916,3915652382,1672639048,1672642164,3116
9830,3340897079,3391093411,1672557170,1672558754,1584
10875,3856699097,3772802020,1672563549,1672566898,3349
11192,3516026189,3512744657,1672647102,1672649555,2453
11214,3205908584,3619705594,1672609560,1672610415,855
10435,3520558137,3518067857,1672621804,1672625099,3295
9982,3471507117,3353194923,1672696434,1672699277,2843
10535,3929355087,3495446254,1672549422,1672552897,3475
11459,3533960602,3908331271,1672648637,1672650839,2202
10895,3680939042,3894756677,1672672146,1672674882,2736
10024,3517552930,3917243005,1672687485,1672689923,2438
10937,3773411968,3627081426,1672675468,1672676515,1047
11150,3688870751,3776407517,1672647683,1672649760,2077
11262,3418683594,3716460706,1672570470,1672572865,2395
11433,3516319492,3512203553,1672584394,1672586325,1931
10289,3715923089,3638071975,1672659834,1672661587,1753
10624,3404375908,3501980730,1672700679,1672702739,2060
11116,3850735936,3620836520,1672555207,1672558668,3461
10092,3207586072,3777672363,1672698288,1672701209,2921
10448,3772164469,3857344874,1672650701,1672653345,2644
10157,3358385652,3471507117,1672700953,1672702517,1564
10106,3838423363,3311529105,1672684816,1672685143,327
10527,3408111327,3971422524,1672611946,1672613915,1969
10858,3792633495,3458271585,1672661330,1672662102,772
11543,3760107540,3201957157,1672574206,1672575753,1547
11649,3931495845,3772227820,1672555959,1672559537,3578
11083,3780982229,3703415246,1672700988,1672701343,355
11579,3342837214,3335139032,1672688011,1672688221,210
9927,3330466913,3444453261,1672641977,1672643741,1764
10088,3701956841,3513215373,1672645756,1672646171,415
11586,3394976623,3760096466,1672558319,1672558848,529
9900,3859191694,3498803823,1672663656,1672666529,2873
10063,3756948477,3932955949,1672629355,1672631695,2340
10977,3755570137,3711852131,1672637057,1672638220,1163
9812,3711404205,3512638952,1672652149,1672652725,576
11469,3509379617,3757393413,1672594328,1672595849,1521
10612,3505416534,3703818358,1672633206,1672634222,1016
11036,3711131262,3935256825,1672695551,1672698882,3331
10636,3374195945,3792682835,1672660857,1672663273,2416
10130,3811351746,3534543864,1672565821,1672568720,2899
10085,3519521903,3533037906,1672589781,1672592509,2728
11705,3780921044,3303432071,1672652993,1672654673,1680
11619,3760271237,3780982229,1672587699,1672591099,3400
11471,3757199889,3276209319,1672601637,1672602542,905
10771,3793902476,3402105276,1672632445,1672632786,341
11128,3838119022,3294821709,1672652661,1672654188,1527
11236,3820422111,3510178791,1672702532,1672702832,300
11328,3772112976,3342426430,1672578056,1672580286,2230
10464,3516517348,3461743188,1672573270,1672574700,1430
10134,3792255406,3514801709,1672690818,1672693154,2336
10030,3312612693,3519948471,1672618214,1672620317,2103
10815,3925792265,3703779674,1672661505,1672663881,2376
10748,3533986052,3713636175,1672607692,1672608528,836
10005,3378747834,3497562878,1672552942,1672553015,73
11633,3367121615,3909067335,1672641943,1672643590,1647
10522,3432838598,3516340010,1672565713,1672568147,2434
10781,3450679913,3777715675,1672650770,1672651089,319
10948,3736203662,3302929858,1672570040,1672570848,808
11038,3710228292,3663353552,1672557580,1672560376,2796
10020,3713471446,3770408300,1672580810,1672584314,3504
11595,3500087325,3398021818,1672629144,1672630195,1051
11148,3757407184,3714951681,1672672047,1672675529,3482
9964,3227874229,3511078598,1672567824,1672570357,2533
10884,3512527440,3792512768,1672623266,1672626414,3148
10493,3510801769,3793926338,1672558818,1672559350,532
11300,3978643889,3419829238,1672697921,1672700596,2675
11636,3514776568,3425545115,1672590359,1672590899,540
10766,3390537737,3500051606,1672652503,1672654900,2397
10580,3856552205,3777063455,1672600944,1672602700,1756
11025,3756149282,3415562576,1672635108,1672637475,2367
11502,3396453219,3773344258,1672642310,1672645035,2725
11606,3701841013,3273771395,1672626947,1672628308,1361
10064,3757924067,3515378306,1672682848,1672686239,3391
11289,3469778316,3513545735,1672617245,1672618825,1580
10293,3730571757,3685396470,1672646160,1672648538,2378
10762,3373135211,3919211457,1672642358,1672644296,1938
11500,3351949206,3388774559,1672585944,1672586467,523
10333,3756536512,3241682278,1672692167,1672694472,2305
10372,3665841655,3513563152,1672649865,1672651273,1408
9946,3856975623,3342235058,1672615725,1672618332,2607
10756,3517645656,3297684667,1672547370,1672549088,1718
10253,3403870769,3756079870,1672634485,1672637988,3503
10998,3773899531,3780173788,1672632520,1672635322,2802
11485,3305727497,3807717766,1672598338,1672599398,1060
11633,3739395381,3779665641,1672532360,1672533932,1572
10904,3757869138,3492064037,1672637454,1672638311,857
10084,3478937459,3500695402,1672557522,1672557966,444
10503,3338016147,3533593766,1672677696,1672678619,923
10516,3519965717,3516200419,1672597862,1672601332,3470
11521,3820200446,3912811715,1672625009,1672628445,3436
10634,3710622746,3779723939,1672678828,1672680685,1857
10891,3534068874,3391093411,1672634733,1672634946,213
11609,3311904032,3428325402,1672665100,1672665904,804
10693,3773475506,3510111365,1672671538,1672672191,653
10601,3518164450,3850904092,1672558532,1672559973,1441
10178,3837271330,3805268739,1672695647,1672697895,2248
10490,3716178116,3881579907,1672645975,1672648907,2932
10983,3420664407,3390438262,1672554773,1672556798,2025
10378,3792987243,3880788853,1672687456,1672688004,548
10944,3619705594,3235074007,1672628919,1672632344,3425
11354,3505066871,3511883778,1672667324,1672669425,2101
10235,3716647407,3381055770,1672639246,1672642496,3250
11125,3511289729,3229570647,1672661209,1672664705,3496
10188,3446233783,3374195945,1672537678,1672540780,3102
10637,3243763209,3273771395,1672668235,1672669862,1627
11091,3756850160,3773394570,1672691486,1672694544,3058
11269,3809194824,3343193067,1672680481,1672681076,595
9901,3387388336,3438204844,1672617712,1672617958,246
11025,3519780867,3466620548,1672672890,1672676303,3413
11665,3783368855,3557528150,1672582561,1672584203,1642
10990,3755378125,3774090455,1672681968,1672685552,3584
10272,3757150421,3534168768,1672585663,1672585822,159
11694,3243305367,3736010012,1672536382,1672539320,2938
10022,3438470128,3776193847,1672537050,1672538766,1716
9816,3313101243,3618895679,1672587744,1672588568,824
9819,3311774510,3779689733,1672553795,1672555278,1483
10328,3703624327,3770023722,1672654235,1672655588,1353
10674,3301489209,3760997159,1672632136,1672633598,1462
10631,3377250778,3500589560,1672599519,1672600132,613
10026,3773852157,3516792348,1672663201,1672664895,1694
10994,3778824229,3513213122,1672664667,1672665228,561
11519,3512154443,3791905743,1672566715,1672567093,378
10631,3925823748,3930766276,1672614037,1672615270,1233
11262,3812677669,3519947298,1672542356,1672542629,273
11474,3518088154,3471177177,1672575134,1672576688,1554
10081,3454924050,3890813040,1672638830,1672640803,1973
10225,3285587972,3738873928,1672582467,1672585624,3157
10341,3516668203,3924205112,1672614001,1672614255,254
11433,3316821313,3478455812,1672606907,1672609486,2579
10331,3500695402,3309178914,1672690698,1672693104,2406
11340,3373802545,3534284132,1672688082,1672691580,3498
11352,3224824355,3716801088,1672619983,1672623475,3492
11660,3829698950,3791825536,1672543818,1672546538,2720
10293,3772882440,3906075386,1672552327,1672555506,3179
10533,3515715968,3514926921,1672688563,1672690964,2401
11217,3895507040,3780298499,1672551737,1672553926,2189
11634,3384001094,3774355339,1672534066,1672535953,1887
11772,3387706541,3714787207,1672669354,1672671341,1987
10700,3517440258,3776249160,1672538573,1672538850,277
10796,3881785069,3621812406,1672676563,1672678124,1561
10795,3461931154,3227206772,1672645954,1672646375,421
10749,3756763585,3518376262,1672664938,1672667479,2541
11260,3509651954,3777204977,1672628587,1672628660,73
9903,3624872714,3554437212,1672658573,1672660754,2181
10227,3792708936,3437108337,1672542158,1672544635,2477
10399,3773953689,3501657158,1672536413,1672539933,3520
11279,3779382417,3463892928,1672567200,1672567868,668
11383,3558349840,3760390822,1672691444,1672692481,1037
11106,3837378340,3312651192,1672652215,1672655580,3365
10910,3774506868,3770408300,1672610553,1672613389,2836
11777,3278443807,3738547113,1672532948,1672535205,2257
10208,3341738186,3916924978,1672584482,1672587815,3333
9973,3792162098,3701540249,1672608317,1672611860,3543
11596,3342495377,3756113624,1672654306,1672655808,1502
10787,3482639402,3779130507,1672542815,1672543141,326
10961,3774939922,3685645561,1672580501,1672582897,2396
11199,3735056027,3713927376,1672563649,1672564413,764
10794,3533974355,3778695895,1672669260,1672671972,2712
10198,3776304080,3701769970,1672666502,1672667760,1258
11620,3732312480,3444598583,1672570878,1672572236,1358
9981,3783408830,3772943811,1672616735,1672617505,770
11739,3432762943,3505491969,1672642454,1672645257,2803
10838,3369810091,3501619113,1672699943,1672700829,886
11193,3426468199,3737467358,1672674598,1672677530,2932
10743,3662354016,3713373455,1672605833,1672606334,501
11710,3701887470,3440401725,1672678050,1672681599,3549
10473,3500927619,3716445184,1672555415,1672557592,2177
11169,3367242388,3418997135,1672657638,1672659227,1589
10296,3501115299,3757623259,1672671333,1672674755,3422
11575,3422081502,3755230010,1672677379,1672680728,3349
10802,3207307681,3430032005,1672650599,1672652754,2155
10794,3715008501,3778318250,1672687693,1672689525,1832
10492,3511198566,3207586072,1672601151,1672601702,551
10926,3378172464,3514508773,1672695095,1672697844,2749
10704,3613216900,3375906394,1672649128,1672650742,1614
10268,3509370016,3773798215,1672674357,1672676606,2249
9986,3776193847,3756536476,1672575233,1672576433,1200
9880,3519908593,3923524564,1672637597,1672638661,1064
10934,3486824047,3518157683,1672540013,1672542747,2734
10639,3792283334,3831981073,1672654613,1672656839,2226
11511,3533209168,3755729826,1672605725,1672608369,2644
10128,3755502373,3813986705,1672648411,1672650567,2156
9933,3418382025,3778370462,1672604040,1672605020,980
11270,3419648004,3520145112,1672647252,1672650003,2751
11060,3403177609,3550206045,1672571589,1672572985,1396
11789,3492064037,3511744756,1672660371,1672661653,1282
11283,3533929043,3440743218,1672692763,1672694636,1873
11477,3832002939,3736056340,1672626978,1672627663,685
10416,3309455369,3505245692,1672643850,1672644423,573
11228,3235578852,3319529422,1672651275,1672654451,3176
10627,3716233100,3425646356,1672612488,1672613947,1459
10853,3783238023,3773556853,1672555086,1672557766,2680
11756,3514498259,3778706119,1672623425,1672625889,2464
11771,3881785069,3227919286,1672535434,1672536676,1242
11465,3791716170,3419829238,1672617321,1672619968,2647
11522,3442462115,3533473206,1672660617,1672663897,3280
11263,3374652108,3370245766,1672690998,1672692121,1123
11037,3710296607,3772164469,1672558746,1672561506,2760
10107,3900766525,3760481622,1672534888,1672535093,205
9852,3668681400,3519780867,1672538746,1672540221,1475
11722,3430823498,3884191432,1672569137,1672572480,3343
10861,3669497617,3774401596,1672687202,1672688492,1290
11096,3837887478,3701655378,1672698095,1672699612,1517
10996,3713927376,3974668678,1672695226,1672695579,353
11465,3681274982,3793274846,1672579612,1672582186,2574
11377,3505032644,3713139039,1672697124,1672700310,3186
10523,3335139032,3444680955,1672566570,1672569230,2660
10111,3779468781,3792455305,1672550441,1672551630,1189
11200,3358434853,3342426430,1672642484,1672645067,2583
11652,3367202274,3714312797,1672679749,1672681192,1443
10440,3514013999,3755342153,1672547914,1672549687,1773
11090,3500630465,3519730914,1672687223,1672688879,1656
10833,3381244346,3348100657,1672671054,1672674061,3007
10090,3977360666,3534499421,1672645630,1672648438,2808
11203,3791698084,3927675706,1672531606,1672533945,2339
11777,3818904268,3710008760,1672652862,1672654988,2126
11147,3534426696,3792987243,1672666394,1672668781,2387
9875,3855977674,3520558137,1672678518,1672681533,3015
10498,3501271930,3393502004,1672550525,1672552763,2238
10289,3209280342,3804840997,1672694803,1672697587,2784
10081,3293898029,3482786946,1672549213,1672552044,2831
10356,3811503860,3757089924,1672541156,1672542075,919
10869,3908883591,3755192104,1672676003,1672678315,2312
10349,3793497672,3791698084,1672558766,1672559542,776
11516,3773032706,3338115824,1672541679,1672543104,1425
11076,3276393542,3390368796,1672631171,1672632372,1201
10370,3438204844,3513586642,1672572344,1672574277,1933
11790,3715441786,3286862903,1672589048,1672591206,2158
10530,3773041843,3791617239,1672647331,1672649785,2454
9845,3770019143,3783939161,1672594674,1672597038,2364
11467,3463729805,3404187438,1672604512,1672607651,3139
10110,3815700240,3342056927,1672550735,1672552663,1928
10167,3230250213,3505901826,1672658752,1672661892,3140
11511,3908331271,3505593034,1672598510,1672599909,1399
10173,3312800145,3793029132,1672574783,1672575957,1174
10921,3778909412,3711804184,1672643966,1672646196,2230
10160,3792440162,3236254381,1672630633,1672630807,174
11445,3516668203,3756675909,1672572833,1672575082,2249
10484,3509433155,3710819760,1672620809,1672622666,1857
10468,3791106473,3716669659,1672684282,1672686032,1750
9909,3714838100,3516497645,1672691887,1672694504,2617
10921,3716541851,3732871856,1672681261,1672682119,858
11159,3533225084,3294164983,1672609587,1672610482,895
11059,3425260097,3756428507,1672691863,1672693591,1728
10836,3805926853,3533728729,1672566365,1672569280,2915
11196,3890211161,3517227599,1672682174,1672682662,488
10811,3406937294,3614484939,1672661638,1672664207,2569
11270,3912878303,3284829602,1672533083,1672536635,3552
10565,3909399636,3501574882,1672656393,1672658128,1735
11726,3711844574,3605078841,1672680146,1672680568,422
11337,3442403264,3669418238,1672588458,1672591083,2625
11450,3512681214,3928076270,1672575653,1672576350,697
10674,3714806574,3715249954,1672657098,1672658517,1419
10083,3516706121,3922409420,1672646917,1672649835,2918
11055,3333355914,3517530943,1672684412,1672687334,2922
11546,3400186699,3770276815,1672595475,1672596859,1384
11153,3220798451,3418791124,1672642735,1672643754,1019
11753,3292936094,3807486812,1672548589,1672551525,2936
10503,3515699732,3332124606,1672576809,1672579360,2551
9919,3701887470,3605591994,1672679423,1672680019,596
11596,3293673220,3757393413,1672597161,1672597649,488
11262,3932955949,3501225887,1672647423,1672647822,399
11021,3227206772,3553008208,1672608758,1672612091,3333
10434,3773840321,3812677669,1672602991,1672605932,2941
11758,3477951091,3617771673,1672681385,1672683429,2044
9835,3500051606,3475033290,1672541093,1672544342,3249
10668,3444168914,3703206956,1672605423,1672605691,268
10535,3772648837,3760274119,1672616844,1672620193,3349
10735,3500974385,3773085258,1672646166,1672647948,1782
11109,3335974305,3447078933,1672588625,1672589491,866
10577,3711722554,3512337054,1672699866,1672703316,3450
11746,3772489471,3510143850,1672701043,1672703499,2456
11287,3605591994,3793699467,1672672242,1672672525,283
11595,3838119022,3239990061,1672549168,1672552233,3065
9952,3793689267,3442564712,1672651704,1672654644,2940
11335,3807800457,3380167818,1672698519,1672698601,82
9985,3500015630,3703277359,1672635434,1672636561,1127
11263,3519780867,3513186578,1672571561,1672571807,246
11089,3512681214,3311569360,1672606589,1672607815,1226
9980,3288675710,3638071975,1672576378,1672576642,264
10476,3778479297,3350631472,1672558206,1672558284,78
9853,3512087090,3716740576,1672701572,1672703851,2279
10426,3773669001,3420664407,1672605167,1672608117,2950
9938,3288675710,3917467642,1672681193,1672683768,2575
11068,3272838634,3474097405,1672580475,1672581181,706
10371,3779478448,3791072829,1672593706,1672596238,2532
10759,3407403080,3687445224,1672534936,1672535631,695
10712,3511864772,3827889533,1672634679,1672637277,2598
10843,3467415939,3272838634,1672677438,1672678673,1235
11309,3703423962,3468066881,1672542075,1672544255,2180
11361,3393543588,3701675183,1672558545,1672559613,1068
11397,3509651954,3856601074,1672604637,1672604853,216
11032,3770709417,3885422379,1672561003,1672563979,2976
10891,3368079099,3516472352,1672678496,1672680887,2391
9896,3450234157,3467232654,1672534925,1672535703,778
9889,3500688476,3613216900,1672657211,1672659588,2377
10329,3208519320,3514306458,1672636430,1672639664,3234
10555,3471131277,3820422111,1672571688,1672573275,1587
10278,3919984986,3515047288,1672690704,1672693784,3080
10940,3505531432,3887069914,1672692375,1672692666,291
10302,3499998389,3715246385,1672649827,1672651045,1218
11772,3716633983,3684199077,1672703800,1672704406,606
10131,3824657614,3660702754,1672692430,1672693486,1056
9909,3783060739,3777304517,1672606166,1672606791,625
10618,3514361485,3404395454,1672617384,1672617472,88
11577,3475090917,3479402555,1672672519,1672674059,1540
10611,3303747093,3465107990,1672570123,1672573533,3410
10350,3619676231,3619705594,1672677887,1672681289,3402
10840,3209280342,3625779003,1672663363,1672665829,2466
10349,3471996194,3413236071,1672555895,1672558226,2331
10369,3511640720,3316121649,1672550860,1672551808,948
10305,3757513651,3436774112,1672566328,1672569464,3136
10748,3505482210,3500928990,1672547301,1672550529,3228
10649,3760107540,3755218683,1672667630,1672669535,1905
10602,3342252701,3475845921,1672536213,1672538155,1942
11502,3792267993,3501244753,1672681556,1672684256,2700
10909,3446537819,3505490878,1672617039,1672619247,2208
10512,3209958726,3757212744,1672549366,1672551330,1964
11186,3249614888,3365519448,1672603286,1672605638,2352
10779,3713547793,3774965463,1672616965,1672618384,1419
11494,3371564186,3512871568,1672597104,1672598762,1658
10406,3478937459,3852014884,1672549567,1672552775,3208
10655,3511794841,3779255367,1672610217,1672610563,346
11433,3519513219,3783373085,1672597723,1672600827,3104
10416,3471177177,3533620069,1672534060,1672536204,2144
10840,3505547832,3495152069,1672657816,1672661081,3265
9842,3347760784,3713636175,1672698256,1672700504,2248
10409,3701519251,3229890340,1672625133,1672628329,3196
11770,3737467358,3710271021,1672674238,1672677556,3318
11185,3730935770,3338187803,1672702202,1672704553,2351
11111,3972442654,3399943757,1672689618,1672689900,282
10616,3821082558,3973134902,1672646411,1672648502,2091
11522,3505173665,3246804115,1672671996,1672674714,2718
10867,3519965717,3245774173,1672599699,1672600788,1089
9884,3373018943,3733953055,1672623201,1672623880,679
10037,3600171014,3774359137,1672563176,1672566361,3185
10862,3513186622,3836586875,1672564001,1672564169,168
10093,3224824355,3770630937,1672610917,1672612271,1354
10106,3295691964,3313502623,1672593195,1672596363,3168
11560,3756113624,3513800589,1672579838,1672580772,934
10823,3736010012,3311133296,1672688221,1672689243,1022
11255,3414510793,3458130310,1672612562,1672614811,2249
9932,3711804184,3714731729,1672647758,1672649304,1546
11441,3714919471,3505173665,1672537817,1672540960,3143
11605,3776534957,3893950585,1672541663,1672542279,616
10239,3686860179,3505867821,1672692210,1672693708,1498
10282,3665603628,3819400315,1672689951,1672691066,1115
10251,3773041843,3730290851,1672575224,1672576161,937
10862,3341738186,3397783490,1672551989,1672553113,1124
11244,3534168768,3756113624,1672565821,1672567048,1227
10348,3226913558,3519689906,1672663258,1672665218,1960
10696,3916673751,3311037445,1672656813,1672657308,495
10477,3500444748,3453519360,1672688419,1672688668,249
10005,3367299721,3858330969,1672542142,1672544987,2845
11115,3519351747,3429587594,1672660372,1672663582,3210
10802,3461877104,3485521840,1672616906,1672618806,1900
11457,3374552204,3915460293,1672550266,1672553071,2805
10251,3711836873,3919349138,1672578737,1672581186,2449
10293,3238310644,3755342153,1672661700,1672661835,135
10753,3685083275,3516517348,1672618804,1672622065,3261
11150,3359418136,3516454693,1672668639,1672669378,739
11626,3623512088,3227647190,1672556711,1672557556,845
10554,3517151644,3552261072,1672585607,1672586244,637
10369,3334708091,3711947828,1672697432,1672699547,2115
10781,3306475287,3415032547,1672632964,1672633482,518
11570,3978254945,3344710271,1672598361,1672598982,621
10079,3485468650,3343859998,1672578592,1672580140,1548
10345,3287734830,3836586875,1672601443,1672604779,3336
11684,3203172170,3447202943,1672657724,1672658002,278
11227,3807486812,3711187791,1672683257,1672684911,1654
11208,3519621901,3633294415,1672666005,1672668120,2115
10390,3429047448,3511476353,1672575041,1672575228,187
10067,3779382417,3755357292,1672539167,1672540681,1514
10695,3716891903,3505867821,1672584893,1672586748,1855
11276,3520763492,3533365834,1672680684,1672681814,1130
11464,3381244346,3915035136,1672692599,1672693407,808
10460,3774090455,3516497645,1672675694,1672677107,1413
10102,3682673884,3716423829,1672540248,1672540853,605
11625,3773432494,3482519872,1672612060,1672615268,3208
10471,3488399075,3281148858,1672598178,1672601533,3355
11545,3791368349,3773878451,1672585094,1672586672,1578
10184,3757089924,3812261241,1672591552,1672593442,1890
9937,3371564186,3310702648,1672580370,1672580630,260
11768,3688410383,3830962592,1672665521,1672667950,2429
10174,3362706073,3509503263,1672646210,1672649397,3187
10025,3270502801,3916656185,1672690583,1672690984,401
10667,3921736061,3710680073,1672570122,1672570641,519
10990,3791509881,3500726347,1672544528,1672544755,227
9828,3929355087,3777370601,1672583980,1672586989,3009
9865,3903115138,3703737650,1672596696,1672597408,712
11030,3685645561,3714435747,1672537595,1672539460,1865
10860,3534626053,3273242177,1672579393,1672581116,1723
11571,3384170206,3512072679,1672609577,1672611305,1728
10883,3757030923,3517426473,1672625317,1672626952,1635
11386,3400025324,3715602742,1672593254,1672593992,738
10651,3772461583,3311432176,1672678361,1672680150,1789
10805,3713566527,3931319307,1672544680,1672547164,2484
9933,3559125467,3501548163,1672558981,1672560758,1777
11751,3738160394,3279851026,1672634382,1672635291,909
10644,3500595432,3714787207,1672698979,1672700640,1661
10648,3233993993,3713471446,1672617953,1672618503,550
11085,3669140241,3778195766,1672666873,1672666983,110
11545,3890194669,3351856699,1672534436,1672537269,2833
11530,3430823498,3220660616,1672539218,1672540934,1716
10425,3518205307,3624164232,1672551202,1672553916,2714
11749,3757513651,3514306458,1672626546,1672627824,1278
9948,3516340010,3287403291,1672580452,1672580603,151
11693,3397527886,3404461403,1672654205,1672654410,205
9967,3756876537,3756668747,1672680198,1672682522,2324
11515,3711755596,3446537819,1672614218,1672614776,558
10033,3777706200,3915460293,1672662766,1672666320,3554
10159,3397527886,3494157939,1672595063,1672595793,730
11208,3309651238,3283785820,1672542513,1672544932,2419
11112,3343859998,3205687719,1672585907,1672586421,514
10814,3311774510,3619796619,1672668410,1672670106,1696
11513,3509274030,3342426430,1672664341,1672664459,118
10261,3711770773,3776727271,1672616630,1672617439,809
10717,3755170743,3200785194,1672676109,1672677765,1656
10955,3431317400,3755670258,1672694184,1672696795,2611
10848,3667814788,3352295704,1672540210,1672541382,1172
10724,3791106473,3459799131,1672589625,1672590396,771
10432,3429587594,3342252701,1672531754,1672535018,3264
10513,3716197140,3713923960,1672677610,1672679091,1481
10760,3710051427,3311479294,1672571271,1672571601,330
11754,3378747834,3285136057,1672703806,1672706133,2327
11272,3330466913,3222364320,1672599686,1672601818,2132
10929,3756525103,3773394570,1672662614,1672662867,253
11769,3442096275,3554437212,1672618927,1672621510,2583
10697,3770764940,3703462221,1672616745,1672618329,1584
10381,3516249472,3228477490,1672613260,1672613590,330
10530,3279851026,3510856388,1672609482,1672610532,1050
10869,3519621901,3510233949,1672688162,1672689198,1036
10603,3513850048,3934980229,1672689611,1672693024,3413
10452,3715590997,3756668747,1672544704,1672545163,459
10833,3891272544,3777118499,1672703013,1672703286,273
11131,3279731391,3923910914,1672690581,1672692554,1973
11215,3366501813,3515047288,1672593005,1672595069,2064
10931,3791825536,3284829602,1672627021,1672630133,3112
11217,3239423794,3469780362,1672564673,1672565751,1078
11790,3511908639,3440743218,1672635034,1672635835,801
10439,3311472321,3832289185,1672642720,1672642940,220
10344,3891272544,3470997293,1672627621,1672627707,86
11201,3620836520,3636015050,1672675787,1672678133,2346
10462,3393128259,3517469005,1672634357,1672636438,2081
11652,3428198021,3244395841,1672685999,1672689298,3299
11713,3908550561,3514698862,1672684548,1672687955,3407
11199,3319585148,3755075988,1672699048,1672699352,304
10243,3760554453,3513545735,1672647132,1672647799,667
10158,3505173665,3621812406,1672573977,1672576082,2105
11445,3501963428,3520155898,1672653808,1672656425,2617
10287,3394394262,3713728777,1672543676,1672546485,2809
10121,3738734246,3354405535,1672673888,1672677088,3200
11701,3274341934,3229890340,1672632812,1672636105,3293
10186,3516444589,3934980229,1672687202,1672689549,2347
10805,3737467358,3663353552,1672625340,1672627229,1889
10809,3500019810,3361711720,1672540861,1672542789,1928
11099,3902775449,3783651407,1672557444,1672557633,189
10434,3388915945,3317989975,1672630819,1672634305,3486
11283,3501225887,3780482864,1672552609,1672556047,3438
10551,3505811269,3716179251,1672615619,1672618228,2609
11132,3236886943,3977209952,1672556193,1672556808,615
10210,3220798451,3851515560,1672699707,1672703216,3509
11672,3809194824,3555378248,1672611692,1672612338,646
11710,3812677669,3774633364,1672535984,1672537707,1723
9901,3636927297,3428878402,1672553772,1672557131,3359
9922,3512306195,3378430760,1672702940,1672703504,564
9874,3770631449,3510795808,1672548079,1672550302,2223
11031,3901217668,3500630465,1672562213,1672564750,2537
11192,3519448648,3772968080,1672618383,1672621119,2736
11631,3792512768,3881785069,1672687751,1672687924,173
11254,3780942505,3534459983,1672608232,1672610227,1995
11085,3534770827,3365839890,1672657040,1672660311,3271
11230,3517992521,3739395381,1672666592,1672669545,2953
10719,3623953446,3714787207,1672605739,1672606677,938
11664,3485521840,3343193067,1672560876,1672562282,1406
10407,3884934977,3914740937,1672593758,1672594295,537
10233,3484490325,3552261072,1672637280,1672639827,2547
11272,3931495845,3225554956,1672635225,1672636271,1046
10671,3811351746,3341311972,1672588626,1672588690,64
11230,3359351267,3930727474,1672544035,1672544782,747
9824,3776279305,3715101177,1672684655,1672685045,390
9896,3832289185,3739297004,1672553138,1672553207,69
11642,3333355914,3377883705,1672635446,1672635692,246
11593,3971447562,3772569860,1672642437,1672644405,1968
10302,3519357822,3311514075,1672672624,1672675492,2868
10083,3776291254,3609644043,1672685167,1672685403,236
11369,3468201976,3343616490,1672666473,1672669739,3266
11105,3783947742,3228056289,1672654431,1672655380,949
9992,3445406685,3773017746,1672604670,1672607353,2683
11613,3609644043,3791688526,1672624302,1672624861,559
10369,3770441717,3370245766,1672559048,1672561210,2162
11151,3368176107,3913847876,1672657479,1672658701,1222
9950,3510826414,3500909455,1672619608,1672619781,173
10171,3520553959,3713767153,1672644858,1672646111,1253
11088,3227206772,3406390503,1672671680,1672672680,1000
9824,3391612879,3774238066,1672559811,1672561191,1380
11360,3920155862,3807646028,1672565762,1672567741,1979
10813,3304447950,3791245127,1672568966,1672571285,2319
11334,3939882169,3520558137,1672548092,1672550027,1935
10388,3367262509,3682086200,1672567410,1672568104,694
10188,3505140123,3715140418,1672702868,1672704567,1699
10677,3792719263,3792987243,1672615161,1672615573,412
11492,3272096922,3710861700,1672583618,1672583921,303
11568,3391854325,3701519251,1672697906,1672700978,3072
11466,3314363575,3856601074,1672691005,1672691263,258
10944,3341311972,3505653701,1672543216,1672543840,624
10504,3774316305,3714281210,1672668399,1672670914,2515
10314,3757446082,3760069457,1672616108,1672616199,91
11020,3559112196,3409514897,1672659818,1672662831,3013
11526,3231271498,3519924982,1672703880,1672705095,1215
10185,3391854325,3902023467,1672583084,1672586016,2932
11599,3978254945,3406029706,1672668673,1672670305,1632
10113,3804075198,3398021818,1672655530,1672657773,2243
10847,3358675021,3285322570,1672587682,1672588951,1269
11201,3229465607,3447948483,1672685652,1672687435,1783
11604,3467944159,3233965781,1672544502,1672546045,1543
9983,3930501172,3403395712,1672618154,1672618249,95
11687,3616403486,3500674240,1672663223,1672666454,3231
10923,3203172170,3514389188,1672685410,1672686288,878
9960,3533225084,3387700451,1672536585,1672537954,1369
10024,3515893948,3710316008,1672584667,1672587381,2714
11162,3452024572,3710228292,1672702575,1672705818,3243
11232,3519255644,3776348472,1672653045,1672654836,1791
10579,3517797610,3638035545,1672544145,1672547522,3377
10875,3837887478,3756525103,1672611768,1672614966,3198
10193,3755507566,3311264420,1672577212,1672580588,3376
10365,3519065870,3667814788,1672660245,1672662053,1808
10508,3373677765,3509377714,1672606952,1672609631,2679
11190,3770981604,3714806574,1672655208,1672656209,1001
11090,3359880163,3711219767,1672584284,1672585827,1543
10165,3756695502,3454554552,1672671086,1672672535,1449
11709,3533728729,3434452046,1672624970,1672626543,1573
11067,3452982957,3837435907,1672621103,1672624019,2916
11333,3713471446,3281970147,1672628585,1672632112,3527
10688,3501992314,3482519872,1672566918,1672570151,3233
9928,3208594306,3974264211,1672606103,1672606435,332
11618,3774355339,3485898181,1672694337,1672695255,918
9868,3512072679,3772648837,1672543102,1672544029,927
9889,3770715115,3916656185,1672546602,1672548041,1439
10316,3756843139,3517325365,1672558020,1672558560,540
10154,3920155862,3501115299,1672678741,1672681222,2481
11185,3514145752,3779312237,1672621101,1672621266,165
11206,3342235058,3520832066,1672645641,1672647629,1988
10772,3533419409,3244397548,1672560050,1672563490,3440
11725,3770497768,3519924982,1672693392,1672693505,113
9907,3345896913,3710173412,1672573603,1672576545,2942
11726,3491239350,3936851114,1672583788,1672585938,2150
10424,3512641538,3603167427,1672648637,1672651269,2632
11436,3385416697,3519255644,1672641276,1672644872,3596
10282,3710046567,3756897029,1672698288,1672699928,1640
11035,3923524564,3730115019,1672665034,1672666676,1642
10806,3505140123,3367109648,1672580183,1672581593,1410
11275,3836136159,3755779925,1672626910,1672630298,3388
11217,3755942724,3513802404,1672686075,1672687620,1545
10829,3924366353,3711770853,1672679826,1672680169,343
10036,3777263928,3778924002,1672637228,1672640539,3311
10897,3686853863,3832289185,1672602105,1672602529,424
11329,3497732613,3456795601,1672660285,1672660512,227
11370,3334488428,3773697080,1672541623,1672543460,1837
10988,3472173212,3791698084,1672615383,1672617225,1842
10167,3246804115,3520022175,1672654262,1672654648,386
10729,3715712376,3520515739,1672565481,1672567111,1630
11093,3462985379,3850904092,1672702824,1672706054,3230
11198,3793497672,3533822490,1672661740,1672664406,2666
11101,3420881591,3427741923,1672693532,1672695963,2431
11626,3241855333,3851515560,1672549784,1672553182,3398
11604,3791108593,3701284535,1672610662,1672612243,1581
10033,3511364193,3851451801,1672607610,1672608511,901
11622,3515706117,3500209015,1672543058,1672543534,476
10886,3803382101,3711367577,1672579897,1672580804,907
10648,3701291994,3604908372,1672673189,1672676500,3311
10426,3853188285,3971289056,1672616132,1672619155,3023
10899,3773032706,3397527886,1672656962,1672657592,630
10336,3397527886,3534491112,1672609723,1672612971,3248
9937,3779468781,3556684272,1672576957,1672579525,2568
10517,3369482983,3760537855,1672701835,1672703192,1357
11093,3373135211,3637105495,1672696107,1672698481,2374
10130,3393001196,3930501172,1672551510,1672554086,2576
9948,3240877710,3307454562,1672669475,1672672492,3017
11787,3757607649,3682802569,1672592188,1672593486,1298
10191,3632303304,3714268380,1672675451,1672678649,3198
9897,3509317776,3371759044,1672672011,1672672413,402
11297,3830771832,3388923880,1672577984,1672580722,2738
10458,3394959062,3773475506,1672579508,1672581694,2186
10161,3925835590,3600171014,1672576472,1672579220,2748
11082,3534204885,3501612813,1672596996,1672598866,1870
11692,3228477490,3756736726,1672655086,1672655577,491
11648,3812880543,3660496328,1672624378,1672625615,1237
10773,3428878402,3478915403,1672592459,1672593951,1492
9807,3387388336,3299845453,1672546976,1672547382,406
11304,3772648837,3273758330,1672624599,1672627483,2884
10989,3711671702,3970265139,1672552455,1672552664,209
11533,3499142934,3501657158,1672699211,1672700010,799
10198,3444397804,3760416450,1672601717,1672602922,1205
9908,3757598610,3714287902,1672541790,1672543953,2163
10652,3514747345,3714455496,1672624778,1672628039,3261
11432,3500079479,3903115138,1672685053,1672685652,599
11571,3505010941,3516655509,1672628852,1672631573,2721
9805,3791236983,3352044245,1672538281,1672540476,2195
10836,3513432588,3755736024,1672607366,1672608469,1103
11651,3714281210,3311569360,1672555715,1672556870,1155
10763,3206853747,3886957097,1672598234,1672601145,2911
10575,3625779003,3208894215,1672685504,1672686553,1049
9870,3436774112,3515974881,1672564510,1672566311,1801
10871,3379666159,3516819320,1672656182,1672657422,1240
10143,3635433296,3317190427,1672557854,1672558998,1144
11166,3533113740,3510836047,1672680825,1672682988,2163
9819,3613547091,3450511428,1672688601,1672691835,3234
10716,3534491112,3500444748,1672628274,1672630242,1968
10040,3934991640,3380418745,1672682874,1672684020,1146
10756,3441336851,3756066702,1672639544,1672640340,796
9961,3313824913,3609644043,1672629377,1672631057,1680
11489,3519465545,3777498160,1672607613,1672608537,924
10434,3777715675,3397972945,1672639004,1672640058,1054
10681,3703502114,3791716170,1672544240,1672546856,2616
10478,3500741005,3236948071,1672567394,1672570063,2669
9900,3783095041,3505278562,1672650422,1672653549,3127
11415,3450503086,3293540333,1672539360,1672542294,2934
11373,3513293711,3713159131,1672548246,1672551039,2793
11483,3513508737,3770408300,1672645392,1672645824,432
10226,3517227599,3792708936,1672538501,1672539845,1344
11001,3512802259,3922409420,1672641028,1672643691,2663
11551,3661359073,3500251781,1672560940,1672561212,272
11538,3501927452,3713547793,1672559632,1672562929,3297
10224,3777931341,3770991234,1672584027,1672586599,2572
11261,3377446376,3334708091,1672544344,1672545806,1462
11102,3774822697,3793003432,1672550834,1672552719,1885
10653,3513777705,3298831109,1672588515,1672590058,1543
10051,3449233346,3793364952,1672533470,1672533688,218
11140,3510206323,3509274030,1672636495,1672637649,1154
10670,3512504247,3364302157,1672614966,1672616433,1467
11458,3770533675,3777498160,1672556587,1672559870,3283
11150,3779503296,3293579860,1672557634,1672560541,2907
11185,3778738044,3783408469,1672650092,1672651920,1828
10086,3884369346,3444598583,1672583404,1672585393,1989
11176,3431317400,3395565040,1672649102,1672649313,211
11679,3662307789,3510206323,1672626687,1672629802,3115
10241,3757201138,3223796145,1672560935,1672562561,1626
9971,3298113026,3447078933,1672544208,1672547739,3531
10052,3931028233,3518989186,1672606326,1672607533,1207
10383,3854202447,3470997293,1672647119,1672650680,3561
10617,3203151036,3791716170,1672549859,1672551669,1810
10381,3780511388,3737050849,1672661255,1672662020,765
11346,3275171954,3366501813,1672613238,1672614852,1614
11147,3301431129,3663902064,1672554214,1672555973,1759
10230,3436099135,3713566527,1672547077,1672549674,2597
11417,3515753241,3710680073,1672613905,1672614738,833
9944,3438818153,3606688595,1672562210,1672564394,2184
10930,3366433035,3245755569,1672682807,1672683621,814
9999,3514450836,3310702648,1672699103,1672699871,768
11189,3685645561,3668369938,1672575049,1672577144,2095
10465,3420881591,3517960157,1672545395,1672548667,3272
11405,3701529552,3434052463,1672594413,1672596430,2017
11706,3778706119,3735152111,1672660429,1672663988,3559
9813,3715196780,3772659062,1672700487,1672703929,3442
9916,3427741923,3275975921,1672663149,1672666231,3082
10020,3686885442,3715852330,1672675525,1672676841,1316
11024,3277061226,3701377471,1672556640,1672560070,3430
11068,3714516404,3297624618,1672641318,1672644419,3101
10283,3359472956,3793081195,1672552496,1672554949,2453
10754,3500073824,3519780867,1672585661,1672588154,2493
11227,3686081254,3792440162,1672615128,1672615448,320
11254,3713069234,3374195945,1672620650,1672622834,2184
11387,3509663119,3792008302,1672627390,1672628147,757
11716,3493515706,3512072679,1672675715,1672678284,2569
11048,3756149282,3770172119,1672633873,1672635704,1831
10524,3791617239,3505119470,1672541862,1672542127,265
11191,3302416197,3469350379,1672665173,1672666608,1435
10463,3510882475,3425545115,1672695848,1672696198,350
10173,3342252701,3342056927,1672642384,1672643010,626
10696,3773424266,3505164060,1672676504,1672679017,2513
10856,3512251592,3852161626,1672650714,1672653469,2755
11177,3778182724,3311177439,1672691042,1672691616,574
10509,3713996094,3669918958,1672575053,1672576787,1734
10975,3791644831,3977209952,1672599672,1672602124,2452
11127,3818324410,3780500331,1672651000,1672654306,3306
10737,3283295213,3931319307,1672654807,1672656054,1247
11206,3533009565,3887069914,1672573659,1672575942,2283
11268,3301449986,3452024572,1672670012,1672673501,3489
10990,3513563152,3389367628,1672579504,1672580044,540
10824,3413799143,3500726347,1672531820,1672535261,3441
11330,3614484939,3520022175,1672626329,1672626676,347
11562,3516026189,3515939841,1672651545,1672654292,2747
11785,3505887814,3711187791,1672563272,1672563756,484
10070,3441336851,3760801237,1672554076,1672555548,1472
10694,3399943757,3757994002,1672551526,1672553058,1532
10808,3206262649,3519754667,1672634911,1672635313,402
10178,3275735969,3792162098,1672635909,1672636317,408
10678,3703336988,3893950585,1672600890,1672601864,974
10346,3330238204,3930475498,1672577700,1672578722,1022
10567,3453538201,3505117019,1672700924,1672701298,374
10176,3713728777,3511650296,1672682164,1672685240,3076
10029,3347760784,3403257752,1672695459,1672697424,1965
10197,3391612879,3272581469,1672699094,1672700601,1507
10101,3778927933,3284829602,1672592355,1672594635,2280
11178,3380285779,3514761434,1672578416,1672581297,2881
10447,3422915648,3290797257,1672686354,1672687055,701
10834,3792682835,3513890046,1672578788,1672579186,398
10690,3604908372,3519780867,1672679918,1672681324,1406
11568,3922786716,3776968640,1672579722,1672580414,692
9973,3311260898,3783554600,1672677420,1672680004,2584
11035,3714067998,3500234771,1672593977,1672596455,2478
10324,3608973523,3896211741,1672596731,1672599133,2402
11044,3939851140,3337673625,1672625088,1672625696,608
10248,3710173412,3683677062,1672608699,1672610386,1687
10116,3756536476,3716463756,1672696754,1672698801,2047
10541,3223512565,3513384042,1672599039,1672600491,1452
10147,3514306458,3516815069,1672612630,1672613058,428
10874,3755394177,3304697982,1672613956,1672616407,2451
11564,3405303958,3299052917,1672557012,1672557693,681
11780,3495427619,3494748808,1672699788,1672700410,622
10254,3513250976,3353194923,1672573986,1672577314,3328
9969,3513293711,3884394685,1672648781,1672650240,1459
11321,3505756991,3203172170,1672659463,1672660906,1443
10718,3342056927,3837888196,1672567873,1672571227,3354
10117,3600842635,3777118499,1672697928,1672700645,2717
10552,3774663639,3509614126,1672680510,1672683854,3344
10299,3701655378,3379076106,1672557085,1672557155,70
10060,3408982612,3311260898,1672575540,1672575854,314
10170,3894328297,3481019442,1672609378,1672612970,3592
10940,3517645656,3713159131,1672669025,1672672088,3063
10319,3896123242,3903994989,1672643819,1672645099,1280
11513,3554317844,3804075198,1672623842,1672624352,510
9981,3519922921,3505571800,1672550808,1672551443,635
10288,3899156705,3883640904,1672689978,1672692463,2485
11457,3204149913,3519260216,1672679279,1672679767,488
11688,3485151614,3278779955,1672697390,1672699664,2274
11358,3791644831,3807800457,1672534500,1672535464,964
11548,3419829238,3501977123,1672669315,1672672568,3253
10441,3773432494,3429610195,1672565849,1672566916,1067
10350,3703481882,3703614781,1672662466,1672664383,1917
9924,3779130507,3501612813,1672542689,1672545843,3154
11749,3791522832,3208594306,1672671223,1672672570,1347
11064,3838119022,3559123082,1672687883,1672690969,3086
11252,3916673751,3368441333,1672668230,1672669476,1246
11448,3512871568,3737946004,1672608169,1672611098,2929
11106,3770533675,3454554552,1672558341,1672560830,2489
11081,3353326305,3512133625,1672597334,1672597583,249
10775,3461137945,3770544738,1672564541,1672567372,2831
11468,3793899166,3316537706,1672659490,1672661282,1792
10004,3613547091,3905571273,1672556147,1672558245,2098
9969,3791644831,3701296091,1672678861,1672680764,1903
9877,3939882169,3510278533,1672557890,1672559963,2073
9834,3403218814,3520160414,1672613581,1672615630,2049
10074,3335139032,3893629892,1672579269,1672581585,2316
9852,3510486220,3311774510,1672673099,1672674284,1185
10984,3780482864,3735679000,1672626965,1672627506,541
10278,3290060215,3904846341,1672535352,1672536554,1202
11670,3855209450,3814770073,1672678760,1672681921,3161
9846,3711040761,3780733404,1672621721,1672624759,3038
11676,3779393140,3500931474,1672610885,1672611988,1103
11160,3360837082,3710125627,1672607051,1672610072,3021
10371,3514980025,3517358336,1672539813,1672541233,1420
10406,3497904539,3207307681,1672651853,1672653949,2096
10008,3739820448,3275661834,1672634533,1672635559,1026
10902,3884933821,3533816813,1672691886,1672694461,2575
10818,3907390925,3231654754,1672569323,1672569836,513
11594,3715101177,3418791124,1672605077,1672606262,1185
10696,3403395712,3500726347,1672581058,1672584121,3063
10446,3711870537,3517991042,1672537587,1672538811,1224
10867,3497904539,3341311972,1672672795,1672674841,2046
10318,3756784813,3682673884,1672625830,1672626597,767
11676,3505010941,3772751765,1672693214,1672695756,2542
11184,3515715968,3513143959,1672613297,1672615910,2613
10193,3793375825,3851515560,1672671115,1672672915,1800
11579,3319585148,3777290300,1672532938,1672535934,2996
9976,3362127525,3499142934,1672583023,1672583705,682
10227,3500442370,3351856699,1672650936,1672654070,3134
9935,3970851830,3971422524,1672647061,1672648012,951
11426,3501963428,3934280144,1672624728,1672627761,3033
11364,3511864772,3907923381,1672621641,1672624271,2630
9850,3392482187,3910190872,1672656788,1672659651,2863
10090,3444397804,3711518637,1672649485,1672650632,1147
11322,3511883778,3760737203,1672544715,1672545259,544
9962,3517448452,3310712221,1672570645,1672571524,879
11336,3200372897,3516819320,1672562621,1672565671,3050
11454,3714281795,3341311972,1672625867,1672627966,2099
11771,3780680252,3701971784,1672551818,1672554218,2400
9839,3346755179,3368441333,1672673096,1672675986,2890
11500,3915679140,3246381831,1672605882,1672608286,2404
11620,3447938130,3271780525,1672618670,1672621722,3052
11213,3364683368,3735056027,1672567648,1672568819,1171
9857,3516321814,3780466967,1672642408,1672644893,2485
11536,3515528947,3402580733,1672579950,1672582036,2086
11595,3478206139,3505010941,1672620206,1672622691,2485
10276,3733411026,3773636983,1672544333,1672544502,169
9981,3793704155,3497562878,1672656810,1672658235,1425
10167,3272581469,3441683673,1672690499,1672693500,3001
10980,3971280379,3515528947,1672675696,1672677383,1687
10918,3688130094,3370961012,1672589509,1672589933,424
11535,3756113624,3442181067,1672616185,1672619155,2970
11467,3519924982,3793232021,1672538519,1672539545,1026
10313,3907390925,3777992576,1672602503,1672602950,447
10744,3505853594,3488988274,1672661384,1672663743,2359
11758,3517551721,3635433296,1672596009,1672599111,3102
10894,3382308738,3514007122,1672543229,1672545413,2184
11501,3778125688,3447948483,1672664269,1672667110,2841
9947,3312946269,3915679140,1672634035,1672634861,826
10939,3732104286,3757032266,1672562170,1672565019,2849
10517,3433902955,3736203662,1672576962,1672579604,2642
11444,3920890008,3776200012,1672699992,1672701683,1691
11024,3419648004,3778986795,1672559020,1672562418,3398
10185,3711196962,3358473096,1672554124,1672555460,1336
10369,3520339198,3512794667,1672558839,1672562015,3176
10542,3533841983,3907390925,1672699749,1672700663,914
10431,3291617477,3516668203,1672574836,1672575254,418
11294,3342235058,3514801709,1672650164,1672652412,2248
11012,3776279305,3227919286,1672532841,1672535777,2936
10986,3458432407,3311602936,1672571303,1672571964,661
10600,3623067708,3714645218,1672659089,1672660373,1284
10255,3517380144,3755865626,1672599586,1672601442,1856
10914,3776901443,3760748418,1672606754,1672608005,1251
10080,3276231633,3512753567,1672553481,1672554411,930
10529,3515259326,3400186699,1672699105,1672699175,70
11406,3380418745,3296970170,1672665881,1672666784,903
9860,3443580855,3307521389,1672549938,1672552964,3026
11587,3711287751,3311331205,1672647581,1672651014,3433
10560,3638823001,3938409715,1672562583,1672564209,1626
9912,3773899531,3294326116,1672542032,1672545582,3550
11190,3443191792,3779706467,1672545885,1672548446,2561
10995,3501734800,3809871495,1672611792,1672614689,2897
10013,3505531432,3736987749,1672575377,1672575577,200
11641,3714268380,3777686966,1672538435,1672541810,3375
11481,3499343927,3512087090,1672690718,1672691130,412
11448,3819024145,3450735824,1672557822,1672558268,446
11620,3791644831,3555763674,1672675498,1672677487,1989
10567,3713807753,3713191326,1672657862,1672661447,3585
10377,3818324410,3757924067,1672614961,1672618092,3131
10131,3371497614,3829761380,1672538138,1672541140,3002
11631,3770715115,3613936929,1672635274,1672637583,2309
11482,3495152069,3616403486,1672547939,1672548934,995
10254,3777564559,3373018943,1672608821,1672612257,3436
11778,3405200303,3311515179,1672549263,1672551238,1975
10974,3343511947,3505173665,1672676237,1672677893,1656
10315,3500555856,3367526113,1672675052,1672676344,1292
10554,3367299721,3356599815,1672590278,1672590539,261
11213,3511750695,3933106901,1672633564,1672633937,373
10830,3755507566,3533009565,1672701814,1672704476,2662
10489,3760080378,3374348845,1672593133,1672596399,3266
10192,3311602936,3713927376,1672658444,1672659643,1199
10438,3627358016,3500057674,1672554747,1672555951,1204
10434,3372617110,3663353552,1672694723,1672694894,171
9964,3756428507,3534758256,1672607526,1672607787,261
10707,3623953446,3757311529,1672679894,1672679981,87
11203,3241682278,3629869834,1672682195,1672682261,66
10355,3386323728,3501612813,1672634673,1672635637,964
11493,3310737478,3916463490,1672667090,1672670344,3254
11411,3511458926,3513171472,1672580882,1672582129,1247
11505,3441683673,3501253130,1672575358,1672575873,515
10086,3403218814,3661359073,1672573103,1672576124,3021
10374,3511218261,3830962592,1672684549,1672685937,1388
10147,3780050328,3393502004,1672620623,1672622799,2176
11763,3472173212,3534362749,1672688023,1672689356,1333
11741,3505121295,3482639402,1672692255,1672695352,3097
11081,3513802404,3512645289,1672660645,1672661840,1195
10743,3500814753,3666367524,1672612161,1672615265,3104
10606,3810584695,3289771213,1672587306,1672589786,2480
11203,3452677710,3394976623,1672680857,1672681631,774
11164,3686081254,3289258397,1672703543,1672706472,2929
10714,3757201138,3515259326,1672628459,1672629560,1101
11515,3505500523,3701534043,1672599855,1672602616,2761
10357,3226761201,3925823748,1672571991,1672574605,2614
11432,3439283360,3429047448,1672586095,1672589664,3569
11043,3793949077,3777569538,1672539572,1672542258,2686
11304,3906075386,3501612813,1672700540,1672702860,2320
10447,3714377201,3205324639,1672557225,1672558039,814
9985,3776561263,3447253775,1672685806,1672687532,1726
10879,3533976217,3778695895,1672591181,1672592845,1664
11520,3813986705,3755736024,1672689266,1672691606,2340
10691,3411626917,3772291207,1672701426,1672704021,2595
10524,3334936138,3770530739,1672699469,1672700441,972
10395,3515802579,3760997159,1672570761,1672572397,1636
10696,3360972732,3774221318,1672555934,1672557286,1352
10801,3441683673,3550206045,1672601861,1672604553,2692
10018,3520182275,3773376762,1672618114,1672619181,1067
11744,3755286041,3777992576,1672650168,1672650477,309
9905,3665478011,3783313202,1672616972,1672618002,1030
11228,3509186338,3905571273,1672622787,1672625292,2505
11173,3307791650,3509355477,1672622517,1672623777,1260
10614,3505804611,3377446376,1672560184,1672562006,1822
10607,3715320359,3200785194,1672578418,1672579614,1196
9813,3779413388,3274894848,1672592126,1672595300,3174
11154,3304592684,3533822490,1672566917,1672568662,1745
10757,3755570137,3394959062,1672606416,1672608929,2513
11368,3931028233,3927504954,1672539256,1672540684,1428
9858,3779169946,3450621820,1672591859,1672593439,1580
10628,3703168159,3534589501,1672608406,1672611860,3454
10668,3832289185,3783357035,1672692833,1672696064,3231
10771,3511580693,3379076106,1672643871,1672645504,1633
10732,3756740153,3774447975,1672695563,1672696630,1067
10513,3834311054,3884191432,1672666557,1672669085,2528
10278,3710515351,3737946004,1672635668,1672638412,2744
11029,3774506868,3701296091,1672552235,1672554044,1809
10379,3810584695,3206853747,1672625168,1672627875,2707
9999,3770709417,3756695502,1672637806,1672638660,854
11544,3902548260,3783357035,1672549038,1672550468,1430
10068,3497138014,3461877104,1672612974,1672613548,574
9827,3776249160,3756736726,1672572772,1672573132,360
10890,3393543588,3510638085,1672650898,1672651155,257
11160,3515100211,3501271930,1672605150,1672605621,471
10159,3318250647,3772968080,1672557429,1672557954,525
10848,3779393140,3837885956,1672600020,1672602765,2745
9832,3772509599,3774682234,1672583141,1672584230,1089
9993,3919258737,3776249160,1672687089,1672687692,603
11654,3471585513,3510262025,1672559745,1672562809,3064
10938,3912878303,3920526713,1672677830,1672678523,693
10380,3534122907,3311197635,1672605237,1672606056,819
11043,3510680251,3773853619,1672639780,1672641247,1467
11625,3792987243,3510254698,1672548267,1672548920,653
10614,3680278447,3513859809,1672550293,1672550495,202
9934,3777135415,3711367577,1672545264,1672546816,1552
11186,3792785261,3902548260,1672534102,1672536397,2295
10232,3613547091,3472272792,1672635159,1672636017,858
9892,3513111053,3505998260,1672540751,1672543693,2942
11629,3400545490,3613547091,1672672603,1672675927,3324
11701,3452175941,3791698084,1672612499,1672613221,722
11590,3241567995,3977209952,1672658236,1672660349,2113
10537,3517448452,3713139039,1672570591,1672570786,195
10163,3791905743,3515304526,1672666301,1672667975,1674
10476,3793949077,3760443176,1672537648,1672540304,2656
11289,3226172318,3820922991,1672548671,1672552071,3400
10263,3395082458,3713374884,1672592170,1672592538,368
11562,3388463477,3711947828,1672664754,1672665378,624
11304,3710296607,3662821438,1672538852,1672540508,1656
10543,3519034304,3733123020,1672662498,1672663089,591
10819,3220660616,3772648837,1672600749,1672601818,1069
11362,3812277991,3480259863,1672541546,1672543778,2232
10370,3520625600,3772882440,1672568319,1672568691,372
11197,3511458926,3486509752,1672630955,1672633027,2072
10751,3757607649,3514306458,1672576934,1672578858,1924
10952,3880637958,3605078841,1672659186,1672659304,118
11162,3303772923,3667814788,1672673260,1672673702,442
10765,3501976169,3776122272,1672609802,1672613097,3295
10621,3520926977,3774029494,1672643349,1672644731,1382
11183,3830771832,3505007498,1672549651,1672551019,1368
10651,3714951681,3223177147,1672547137,1672547691,554
10917,3511867383,3512371853,1672630668,1672634124,3456
11375,3793081195,3760656396,1672650848,1672653134,2286
11548,3388830370,3772909073,1672658044,1672661329,3285
11679,3716595760,3825877848,1672592794,1672595528,2734
10991,3777118499,3922786716,1672646716,1672647543,827
10136,3308744016,3715246385,1672614902,1672617721,2819
11633,3510301454,3235470567,1672678276,1672678404,128
11324,3855077502,3313298164,1672678714,1672681867,3153
11428,3279851026,3777931341,1672667641,1672668370,729
10776,3682266017,3206926634,1672546732,1672547411,679
9822,3783506190,3279851026,1672693108,1672696053,2945
9835,3338195686,3313502623,1672651316,1672654196,2880
10851,3777118499,3248409083,1672640695,1672642033,1338
9981,3338642026,3714283424,1672548297,1672550609,2312
11410,3738760498,3519228207,1672595755,1672597602,1847
11225,3716801088,3837885956,1672541257,1672543306,2049
10157,3927805949,3509379617,1672620234,1672620537,303
11414,3302348002,3406132280,1672556872,1672558401,1529
11005,3783238023,3353811455,1672612711,1672614223,1512
10116,3373018943,3664523809,1672691758,1672693043,1285
11607,3514776568,3902023467,1672675318,1672676449,1131
10217,3514327931,3774401596,1672536622,1672536924,302
10008,3518572231,3509508477,1672552661,1672555861,3200
10529,3371132167,3338016147,1672545956,1672546489,533
10084,3411355804,3636015050,1672606456,1672608774,2318
11506,3828354855,3485898181,1672703364,1672705624,2260
9852,3500864577,3909067335,1672581487,1672582973,1486
11510,3510939082,3904004824,1672617158,1672618782,1624
10525,3755688231,3716197140,1672542965,1672544610,1645
9868,3509370633,3514776568,1672621652,1672623543,1891
10939,3732846295,3295748489,1672624450,1672625518,1068
10409,3755175497,3660163550,1672558021,1672558367,346
10136,3938409715,3511206717,1672687820,1672689498,1678
11198,3919994216,3275171954,1672605824,1672607789,1965
10235,3380418745,3893527651,1672676570,1672677326,756
10607,3203630241,3478937459,1672676550,1672678794,2244
11457,3683514731,3791368349,1672617101,1672617677,576
10268,3839417558,3886879696,1672537584,1672538399,815
11517,3899156705,3475033290,1672614139,1672614646,507
10458,3352493805,3914740937,1672557586,1672558932,1346
9962,3832289185,3774359137,1672641168,1672642332,1164
10883,3534775239,3300810210,1672577145,1672580071,2926
10285,3773475506,3396453219,1672576126,1672578014,1888
10970,3739618347,3772609551,1672596610,1672600199,3589
11419,3895422995,3710316008,1672659366,1672660454,1088
11689,3627377299,3921736061,1672654950,1672656584,1634
10284,3637566026,3358385652,1672679367,1672682299,2932
10391,3715126587,3972847837,1672535611,1672535969,358
11650,3791863922,3716944983,1672663036,1672664038,1002
10500,3756066702,3534937492,1672603910,1672604489,579
10521,3515984911,3462985379,1672574025,1672576541,2516
11764,3533030343,3776279305,1672674947,1672677578,2631
11563,3667814788,3505826673,1672620897,1672623576,2679
11763,3715441786,3774682234,1672623018,1672623549,531
11578,3772227820,3236206821,1672583966,1672587274,3308
10709,3714838100,3772877723,1672538961,1672539262,301
10841,3500741005,3509663119,1672598324,1672600232,1908
10468,3444646562,3413799143,1672589525,1672590554,1029
11545,3815440588,3907225070,1672588596,1672589464,868
9907,3910049345,3713954144,1672606837,1672609877,3040
11634,3239401337,3829358750,1672665305,1672668133,2828
10298,3757872458,3783021859,1672700775,1672702180,1405
11417,3757514745,3239082508,1672689840,1672692371,2531
11491,3319645922,3319436533,1672645359,1672646603,1244
10527,3355430975,3421524698,1672701336,1672701836,500
9984,3770172119,3449672240,1672677609,1672679105,1496
10693,3411213032,3715140418,1672538414,1672541794,3380
10893,3518425740,3660980656,1672677591,1672680793,3202
11465,3791088014,3621812406,1672640452,1672641075,623
11524,3894495222,3938021614,1672640340,1672643497,3157
10039,3369938668,3928421417,1672649606,1672652059,2453
11654,3906075386,3850108828,1672661188,1672662071,883
10123,3908177413,3351728355,1672563877,1672567188,3311
10265,3311331205,3509379617,1672701612,1672702624,1012
10757,3770715115,3509663119,1672677876,1672681169,3293
11446,3783408469,3533929043,1672603766,1672605574,1808
11067,3780423516,3511750850,1672600984,1672601375,391
10774,3810949170,3683562111,1672548817,1672552032,3215
11312,3908331271,3248061684,1672595384,1672597905,2521
10387,3516167000,3716944983,1672543989,1672544539,550
11388,3447591143,3441336851,1672581853,1672585376,3523
11208,3915652382,3632094087,1672589999,1672590479,480
11337,3505245692,3770391782,1672641974,1672642093,119
11452,3920116284,3384001094,1672533343,1672534346,1003
11604,3339331632,3307454562,1672628045,1672629186,1141
10684,3780982229,3632303304,1672562931,1672564462,1531
10724,3472774606,3921736061,1672677336,1672678500,1164
10052,3853188285,3509167758,1672619842,1672623431,3589
11506,3512101369,3780013266,1672550459,1672550834,375
10409,3776166086,3373802545,1672559392,1672562374,2982
9859,3703104365,3510882576,1672684316,1672684798,482
10374,3304235700,3517797610,1672680818,1672680923,105
9925,3517992521,3925098136,1672616519,1672617297,778
10363,3517756624,3345028045,1672642426,1672644652,2226
9986,3885422379,3711613085,1672557812,1672558370,558
10906,3901217668,3757201138,1672668931,1672670618,1687
11250,3318224774,3518117078,1672551941,1672554664,2723
10290,3518117078,3916924978,1672540034,1672542033,1999
10687,3612705426,3500317923,1672620718,1672621193,475
10931,3713920790,3780626668,1672690862,1672694437,3575
11104,3901217668,3511466117,1672601925,1672605212,3287
11513,3779689733,3779609338,1672575811,1672577693,1882
10747,3402338011,3245642576,1672685613,1672688754,3141
11319,3838748301,3714903253,1672663884,1672665401,1517
11183,3358385652,3302879906,1672580779,1672583994,3215
10845,3713728777,3783313202,1672655864,1672656575,711
10257,3510638085,3225554956,1672635900,1672636187,287
10365,3905358065,3834311054,1672557035,1672559167,2132
9810,3812261241,3793978936,1672589166,1672590213,1047
10763,3939422411,3291617477,1672578042,1672579564,1522
9796,3755129708,3313392810,1672618056,1672619011,955
11492,3772262649,3776348472,1672600499,1672601772,1273
9827,3703048107,3505811269,1672686008,1672688125,2117
11120,3737050849,3469663062,1672618719,1672620927,2208
11413,3512417724,3760748418,1672675847,1672678046,2199
10252,3608214600,3609997804,1672632030,1672632417,387
11242,3711040761,3339649817,1672531591,1672533026,1435
11591,3613781977,3515230715,1672621081,1672623960,2879
10840,3331228758,3716669659,1672617497,1672619991,2494
10537,3533728729,3814770073,1672575805,1672578445,2640
11692,3792432094,3777932581,1672596084,1672599467,3383
11688,3479585868,3274894848,1672670415,1672672163,1748
11170,3686211958,3701925712,1672679517,1672682523,3006
11758,3500536897,3760541837,1672601448,1672604066,2618
10435,3772234939,3236512807,1672689478,1672691402,1924
10638,3394959062,3779415433,1672674703,1672675907,1204
11419,3430296808,3664478769,1672685965,1672686662,697
9810,3505245692,3242149533,1672678566,1672681377,2811
11229,3791688526,3854202447,1672536187,1672537270,1083
11732,3513186578,3516792348,1672695939,1672698468,2529
11509,3805704844,3806720019,1672613486,1672615791,2305
11541,3354877289,3533209168,1672548039,1672549919,1880
10065,3821103640,3509377714,1672702839,1672705279,2440
10779,3820922991,3555764822,1672618840,1672621484,2644
11350,3435159896,3711349327,1672579656,1672582724,3068
9883,3755286041,3275057862,1672698538,1672700312,1774
10914,3403988682,3500057674,1672684106,1672686110,2004
10764,3533777032,3711219767,1672688394,1672689129,735
11642,3756991235,3516249472,1672692517,1672695269,2752
9867,3414510793,3777135415,1672679267,1672679938,671
11259,3422959249,3783594246,1672554751,1672557624,2873
10839,3716609198,3515597467,1672597183,1672598292,1109
11550,3710260848,3777931341,1672685457,1672686490,1033
11582,3715852330,3783368855,1672606113,1672609267,3154
11407,3519165527,3286862903,1672643326,1672646022,2696
10297,3600171014,3853182912,1672698802,1672699971,1169
11736,3776778306,3467232654,1672680397,1672683406,3009
10173,3505129296,3512072679,1672699981,1672700411,430
10185,3713141087,3487231844,1672637279,1672639780,2501
11176,3500120676,3857909328,1672643356,1672646780,3424
9978,3714424237,3367202274,1672656476,1672659611,3135
11395,3220976338,3613940925,1672559362,1672560844,1482
11696,3600171014,3793407883,1672600181,1672603093,2912
10067,3776791436,3807800457,1672612253,1672612698,445
10083,3496352027,3773603836,1672629526,1672632872,3346
10889,3755075988,3429333292,1672602774,1672605751,2977
10020,3518534560,3715566511,1672546464,1672548594,2130
9944,3513996288,3773083407,1672536831,1672537649,818
10772,3777729184,3710147457,1672648159,1672650062,1903
10988,3284865931,3713728777,1672700651,1672701422,771
11671,3510244209,3896211741,1672640569,1672643498,2929
10033,3714294005,3203457161,1672673534,1672674447,913
10745,3777204977,3518794921,1672618261,1672619424,1163
10419,3458432407,3519494023,1672567870,1672568254,384
10546,3908331271,3900766525,1672575272,1672575834,562
11510,3757064623,3773636983,1672627617,1672629189,1572
9880,3777729184,3804707712,1672701480,1672703921,2441
10502,3880788853,3311188620,1672554241,1672555718,1477
10327,3714787207,3500931474,1672551947,1672554820,2873
10378,3533325993,3623113240,1672663319,1672665301,1982
11671,3934991640,3857344874,1672584727,1672585947,1220
10096,3378534521,3348100657,1672646514,1672648699,2185
11299,3297624618,3911376818,1672650410,1672653542,3132
10040,3501027795,3399734748,1672546741,1672549909,3168
11456,3669427589,3534775239,1672619730,1672621354,1624
10233,3772070986,3931164237,1672564328,1672564465,137
10873,3510826414,3906693728,1672631653,1672631785,132
11561,3774394000,3778561231,1672702534,1672705545,3011
11431,3791368349,3701265238,1672582348,1672583806,1458
10945,3711613085,3312733562,1672703245,1672704667,1422
11430,3459951739,3777499535,1672594576,1672595870,1294
9971,3857609616,3600171014,1672612433,1672615063,2630
10210,3501927452,3701459978,1672614679,1672616393,1714
10900,3231859576,3362706073,1672580919,1672582938,2019
10778,3824135033,3515893948,1672600324,1672601410,1086
11037,3713636175,3319529422,1672686661,1672688306,1645
9924,3791382196,3311159418,1672650744,1672651143,399
11472,3353811455,3499622352,1672681423,1672682644,1221
11343,3738547113,3500049870,1672571806,1672574447,2641
10579,3208894215,3534667712,1672687503,1672690635,3132
11681,3928421417,3900540310,1672606004,1672609067,3063
10468,3716841469,3732596503,1672700274,1672700378,104
10205,3281148858,3505547832,1672648670,1672651534,2864
10161,3856316719,3710260848,1672646205,1672647116,911
11278,3533929043,3772070986,1672575715,1672576460,745
10378,3605101443,3374195945,1672539909,1672540236,327
11402,3610517436,3730052916,1672647161,1672648079,918
9821,3519255644,3243305367,1672703211,1672704098,887
10858,3399943757,3474879231,1672609367,1672609878,511
10287,3715790104,3791351852,1672560085,1672563474,3389
9859,3710051427,3389367628,1672577305,1672577677,372
11631,3533816813,3713920790,1672610101,1672613551,3450
11326,3914926436,3514498259,1672547786,1672551150,3364
10055,3638823001,3738547113,1672552504,1672553706,1202
11606,3755170743,3701529552,1672604117,1672605391,1274
10368,3937747312,3444646562,1672572051,1672572284,233
10956,3772844451,3701291994,1672566639,1672569230,2591
11639,3512343029,3791224239,1672591877,1672593634,1757
11317,3770991234,3919814073,1672612329,1672615925,3596
11262,3660257653,3703048107,1672562933,1672563241,308
11092,3927202773,3209958726,1672627326,1672629178,1852
9835,3403177609,3520362238,1672702766,1672704260,1494
11354,3304697982,3914947393,1672687633,1672687791,158
9874,3490804766,3520057139,1672621569,1672622435,866
10462,3912181197,3550887623,1672634943,1672635499,556
10877,3443521234,3600842635,1672615352,1672616695,1343
11152,3710051427,3533440736,1672550005,1672550511,506
11201,3756066765,3337715675,1672692237,1672694415,2178
11538,3755630085,3247845642,1672676186,1672677099,913
10291,3224824355,3370751461,1672687808,1672688921,1113
10858,3516819320,3374195945,1672673392,1672675167,1775
11566,3837435907,3850181934,1672648828,1672652200,3372
11766,3772966919,3453164933,1672556853,1672559589,2736
10037,3710046567,3287821258,1672545276,1672546212,936
10007,3342837214,3221736756,1672678031,1672678482,451
10557,3515944817,3501027795,1672676445,1672678757,2312
11170,3394986304,3932919664,1672535903,1672538208,2305
11683,3770533675,3519059808,1672671437,1672671829,392
10942,3773394570,3619538249,1672654297,1672654429,132
11158,3287683210,3756897029,1672695517,1672697630,2113
10799,3934070285,3270502801,1672645034,1672645885,851
11765,3517149023,3473520701,1672548834,1672550479,1645
9994,3773736248,3223796145,1672587169,1672588930,1761
10983,3505502819,3519352855,1672633247,1672636825,3578
11347,3534543864,3714951681,1672587543,1672587689,146
11137,3501548163,3774627091,1672695704,1672698226,2522
10089,3732540636,3428076194,1672589271,1672590106,835
9842,3510824484,3931917809,1672689238,1672692031,2793
9965,3755154460,3301489209,1672584542,1672586081,1539
10001,3514244308,3832902787,1672542912,1672544722,1810
11393,3703351452,3777909822,1672683792,1672686336,2544
10356,3501554468,3510836047,1672535456,1672535896,440
11717,3370448531,3301765144,1672634571,1672635524,953
11565,3512072679,3668720465,1672622536,1672622923,387
11537,3360783381,3931767736,1672576114,1672579036,2922
10347,3533154906,3770846374,1672541813,1672544644,2831
11444,3303432071,3774238066,1672683547,1672684180,633
11505,3435342362,3710082615,1672615218,1672616319,1101
11554,3756759239,3711613085,1672567479,1672568158,679
11705,3807717766,3416474842,1672650091,1672652557,2466
10425,3760687922,3352295704,1672687646,1672688156,510
11566,3916955566,3298706213,1672651232,1672652647,1415
10792,3287094447,3685083275,1672698405,1672699968,1563
10440,3517992521,3716179251,1672688836,1672691362,2526
11234,3515802579,3401215739,1672622676,1672623089,413
9901,3835509670,3517991042,1672626334,1672627930,1596
10722,3802625412,3334936138,1672558024,1672559000,976
9953,3714731729,3380185102,1672648789,1672652027,3238
9830,3558567160,3716994924,1672700210,1672701737,1527
10461,3713621169,3811351746,1672675442,1672677639,2197
10606,3819024145,3501977123,1672650952,1672651172,220
11740,3236948071,3382746533,1672538531,1672540691,2160
10638,3513563152,3791584994,1672672378,1672675390,3012
9859,3814378625,3793783685,1672650671,1672651506,835
11757,3905571273,3347140733,1672568140,1672571064,2924
11051,3929355087,3783809405,1672683590,1672685111,1521
10043,3716541851,3703572036,1672642656,1672643467,811
11109,3429409539,3515753241,1672600034,1672603554,3520
9905,3533726421,3760390822,1672615053,1672618105,3052
11465,3713996094,3303432071,1672609434,1672610842,1408
11299,3414387263,3501550490,1672664146,1672666714,2568
10876,3515974881,3684108920,1672569652,1672573101,3449
11712,3938409715,3457249798,1672663482,1672664811,1329
11686,3399734748,3756428507,1672683825,1672684453,628
10177,3505183641,3516026189,1672572386,1672574803,2417
10781,3201957157,3226172318,1672614212,1672616727,2515
11226,3792063616,3756781024,1672623772,1672624805,1033
10847,3852014884,3513186578,1672646075,1672646911,836
10028,3309528048,3285515107,1672645477,1672646566,1089
11587,3500405175,3715737742,1672561424,1672564230,2806
11096,3509208005,3510111365,1672655258,1672656890,1632
11626,3715680249,3756642173,1672537732,1672540548,2816
9920,3757623259,3710865678,1672563608,1672564012,404
10330,3760346746,3379666159,1672592008,1672594392,2384
10311,3772556646,3931319307,1672700132,1672703384,3252
10148,3311463998,3519167605,1672672453,1672676035,3582
10590,3896123242,3418367752,1672632625,1672634416,1791
10984,3510335069,3791587717,1672590667,1672590762,95
11128,3804779247,3682673884,1672695131,1672697740,2609
11446,3713566527,3500640854,1672691166,1672693344,2178
11010,3496579251,3519351747,1672648985,1672651285,2300
10862,3294952405,3515607283,1672630770,1672634272,3502
11112,3881785069,3487395357,1672599350,1672602776,3426
10245,3714923092,3756991235,1672687117,1672687179,62
11338,3757001552,3716233100,1672675687,1672677471,1784
11303,3927699036,3735838864,1672671672,1672671943,271
11573,3512411326,3533440736,1672616414,1672617295,881
11376,3442181067,3436099135,1672655405,1672658301,2896
11367,3770709417,3372778334,1672662603,1672662878,275
11263,3713283029,3669497617,1672682193,1672683332,1139
11693,3519102732,3820422111,1672570139,1672571100,961
10319,3916955566,3772943811,1672562664,1672565748,3084
11184,3299847117,3604908372,1672670377,1672672323,1946
10426,3791382196,3275274182,1672569436,1672571459,2023
10621,3297624618,3776778306,1672572194,1672574753,2559
10029,3680988889,3772425253,1672546356,1672548267,1911
11647,3886879696,3683562111,1672601109,1672601318,209
10027,3856552205,3516655509,1672606617,1672609010,2393
9983,3713954144,3424997707,1672700761,1672703746,2985
11671,3517800171,3534081527,1672629624,1672631594,1970
10961,3896859936,3819400315,1672619392,1672620935,1543
10405,3558203963,3511729562,1672577975,1672579490,1515
10001,3388946581,3512700007,1672665010,1672667656,2646
11638,3534102440,3276230295,1672688717,1672691024,2307
11082,3836136159,3920890008,1672683755,1672685223,1468
10877,3205908584,3384713976,1672582920,1672584195,1275
11748,3342031426,3716468783,1672640245,1672643473,3228
9869,3711852131,3897107253,1672584812,1672585977,1165
11011,3489340327,3776001441,1672643509,1672646771,3262
10112,3225356349,3510856388,1672632497,1672635517,3020
10944,3779689733,3444881567,1672674034,1672674114,80
9842,3343767438,3774939922,1672534376,1672536579,2203
11625,3435715962,3378430760,1672658319,1672660876,2557
10044,3897851509,3533201269,1672611968,1672614404,2436
11534,3505482210,3493679801,1672547484,1672547859,375
11473,3701663839,3755942724,1672601562,1672603407,1845
10948,3791617239,3397527886,1672669214,1672670688,1474
11059,3505140123,3455430943,1672554384,1672554668,284
10082,3715249954,3515803462,1672663550,1672664243,693
10444,3224824355,3777686966,1672589313,1672592308,2995
10939,3491527603,3881785069,1672642087,1672644261,2174
11552,3774296721,3779778679,1672606902,1672609687,2785
11496,3510758718,3505500665,1672536459,1672539006,2547
10772,3602054754,3715858201,1672582159,1672582970,811
11402,3685396470,3684199077,1672538070,1672539315,1245
9921,3514980025,3714903253,1672617863,1672618679,816
10109,3338115824,3515726910,1672620339,1672622757,2418
10249,3773083407,3203151036,1672692403,1672694857,2454
10061,3715140418,3425646356,1672588055,1672591227,3172
10204,3770424941,3226913558,1672531874,1672534482,2608
10951,3923910914,3783122313,1672623145,1672623321,176
10654,3514007122,3777569538,1672626814,1672629571,2757
11086,3306475287,3478937459,1672682009,1672682330,321
10907,3686885442,3371759044,1672652200,1672653679,1479
10152,3387870683,3514515499,1672653925,1672655070,1145
11319,3475033290,3893932944,1672627800,1672628681,881
10118,3469780362,3920606331,1672558615,1672560726,2111
11414,3534543864,3513629502,1672564522,1672566983,2461
10676,3337903727,3505010941,1672698433,1672699227,794
10405,3285136057,3600441934,1672550227,1672550963,736
10871,3534984243,3500720752,1672587650,1672591030,3380
11362,3222357355,3513816744,1672575113,1672575771,658
11767,3638018906,3239082508,1672697404,1672697603,199
10452,3391854325,3425260097,1672571473,1672572688,1215
11442,3206262649,3638018906,1672635546,1672635624,78
10068,3209075485,3703415246,1672591306,1672593717,2411
10087,3855977674,3555764822,1672689033,1672690804,1771
10218,3793332600,3372617110,1672686335,1672687015,680
10343,3207307681,3239279744,1672657535,1672660777,3242
11347,3500555856,3387700451,1672625249,1672625560,311
11118,3227206772,3342027511,1672599708,1672602622,2914
11632,3509457543,3773736248,1672565771,1672569163,3392
10174,3409514897,3660246433,1672560714,1672563376,2662
10708,3337715675,3639926564,1672593231,1672596701,3470
10641,3318590083,3338115824,1672533160,1672534636,1476
11616,3311260898,3772943811,1672563396,1672565495,2099
11013,3774238066,3811419378,1672642679,1672645764,3085
10464,3514673213,3384170206,1672637053,1672639959,2906
11708,3509457543,3777041132,1672623076,1672623136,60
11053,3756413374,3686853863,1672567328,1672568270,942
10859,3396472026,3663902064,1672537938,1672538382,444
10844,3756367938,3701824335,1672648298,1672650984,2686
11039,3627081426,3713954144,1672615473,1672615623,150
11091,3757446082,3518534560,1672549648,1672550061,413
11034,3713514933,3533009565,1672551242,1672553779,2537
11338,3632094087,3496407500,1672612701,1672614683,1982
11301,3505117019,3773714494,1672579534,1672580699,1165
11482,3780048608,3914947393,1672692745,1672692880,135
11582,3682150740,3500087325,1672669637,1672671190,1553
11762,3686860179,3735679000,1672583502,1672586177,2675
10119,3555954355,3892487982,1672651014,1672652056,1042
10215,3770441717,3273674596,1672689418,1672691026,1608
9802,3635599307,3711131262,1672696112,1672697083,971
11573,3772131127,3739395381,1672634385,1672634974,589
9915,3518157683,3978417055,1672603421,1672606093,2672
10648,3518794921,3713475356,1672595809,1672596897,1088
11247,3501853868,3534937492,1672662759,1672664997,2238
10303,3285515107,3376487118,1672703659,1672703728,69
11149,3478915403,3770023722,1672572245,1672572808,563
9983,3668764192,3755823805,1672651180,1672652588,1408
10600,3513384042,3628423403,1672561994,1672562413,419
11279,3972729768,3776778306,1672567663,1672568360,697
11103,3778100960,3791574640,1672580052,1672583524,3472
10228,3715261950,3780500331,1672621531,1672623059,1528
11079,3288920399,3534068874,1672669019,1672669519,500
10755,3500688476,3713767153,1672620323,1672621906,1583
10366,3513186622,3716183063,1672571675,1672573903,2228
10228,3517627003,3774236212,1672702505,1672703216,711
10367,3818236682,3713374884,1672551835,1672551968,133
11306,3626631210,3887030182,1672557401,1672560871,3470
10871,3770671714,3479585868,1672541957,1672542273,316
11213,3353194923,3291936679,1672536906,1672537521,615
10551,3509912164,3880030249,1672542640,1672542912,272
11164,3628556590,3464622743,1672558191,1672559289,1098
10450,3922409420,3421524698,1672618715,1672621606,2891
11338,3701919083,3716526314,1672546578,1672548302,1724
10517,3350631472,3710125627,1672561310,1672563282,1972
11313,3738160394,3510535683,1672573219,1672573414,195
10189,3204821370,3505839395,1672553924,1672556516,2592
10496,3221126799,3701567668,1672584677,1672588044,3367
11191,3489205994,3445896667,1672654349,1672654641,292
10591,3505007498,3449672240,1672577804,1672580666,2862
10344,3501004005,3235373942,1672609657,1672609925,268
10208,3461877104,3427741923,1672590004,1672593496,3492
9832,3442181067,3311188620,1672534688,1672536814,2126
11055,3316821313,3907923381,1672656725,1672659484,2759
10119,3517943697,3791644831,1672660660,1672661352,692
10770,3513996288,3880882684,1672698369,1672700946,2577
11774,3534284132,3452104161,1672698876,1672699460,584
10936,3774539067,3369558911,1672623426,1672626394,2968
10676,3513250976,3777552831,1672627642,1672629098,1456
10890,3500741005,3466149998,1672675021,1672677999,2978
11435,3223512565,3772509599,1672624162,1672624226,64
10029,3203172170,3774205060,1672650340,1672651443,1103
11598,3505155858,3444397804,1672534444,1672536748,2304
10514,3311414429,3520165730,1672619408,1672621800,2392
11250,3755209597,3793003432,1672639108,1672641339,2231
11250,3777686966,3803996569,1672549073,1672549700,627
10139,3516932899,3757001552,1672632209,1672633268,1059
10729,3375257546,3533876927,1672552178,1672555623,3445
11626,3900195680,3517136772,1672675409,1672678167,2758
9827,3773768643,3772019557,1672618291,1672620641,2350
9931,3290060215,3773714494,1672582696,1672585265,2569
11270,3791574640,3852992961,1672539127,1672542689,3562
10195,3899970524,3791863922,1672641801,1672644188,2387
11317,3711015176,3897107253,1672659593,1672662864,3271
10213,3669418238,3774946684,1672590758,1672593420,2662
11567,3501759031,3773840321,1672532906,1672534493,1587
10831,3376842515,3533830748,1672674452,1672676609,2157
11757,3520860199,3732846295,1672626767,1672629340,2573
11390,3290797257,3509912164,1672613934,1672616878,2944
10136,3774939922,3515379622,1672633158,1672633664,506
11211,3757201138,3511500932,1672698284,1672700841,2557
11760,3609644043,3511729562,1672633755,1672634683,928
10669,3438028077,3533620069,1672610285,1672610522,237
10356,3757089924,3736987749,1672604954,1672607678,2724
9977,3494157939,3714424237,1672606856,1672607743,887
10011,3779413388,3422915648,1672635834,1672637386,1552
10005,3487395357,3342426430,1672624987,1672627802,2815
10980,3512638952,3534426696,1672635029,1672638429,3400
11520,3757201538,3511206717,1672591450,1672593410,1960
10565,3493515706,3715101177,1672597684,1672600482,2798
11170,3472718723,3510484107,1672548988,1672549184,196
10707,3312651192,3756876537,1672608088,1672608800,712
10514,3756784813,3731905251,1672533387,1672535518,2131
10111,3615245840,3665841655,1672617545,1672620623,3078
9853,3616403486,3491250381,1672593499,1672596185,2686
10574,3319436533,3733915784,1672569302,1672571953,2651
11459,3756297396,3916656185,1672600839,1672603117,2278
10388,3534491112,3311133296,1672592411,1672593240,829
11187,3274894848,3495446254,1672674324,1672677909,3585
10931,3400545490,3831981073,1672653453,1672656866,3413
10148,3310737478,3552922094,1672572079,1672573849,1770
10929,3406169279,3462985379,1672635640,1672635820,180
10328,3534506090,3791644831,1672551413,1672552932,1519
10959,3773432494,3783594729,1672696164,1672698220,2056
11193,3203630241,3208594306,1672572322,1672574517,2195
10665,3756897029,3711836873,1672642612,1672643682,1070
10288,3208594306,3475653510,1672574953,1672577485,2532
10196,3777499535,3828354855,1672661236,1672661405,169
11297,3377446376,3249771731,1672651774,1672651937,163
11205,3716669659,3517552930,1672559445,1672560680,1235
10916,3609103278,3515838621,1672666167,1672667728,1561
10571,3927763819,3791905743,1672547407,1672548440,1033
10703,3815184540,3715140418,1672579229,1672580734,1505
11018,3908883591,3701412729,1672635113,1672637846,2733
11672,3510758718,3976225898,1672620910,1672622558,1648
11467,3403177609,3783506190,1672570294,1672571706,1412
10847,3783122313,3209958726,1672697454,1672699938,2484
11624,3772943811,3884369346,1672598769,1672599598,829
10288,3304672737,3361635547,1672682327,1672683665,1338
9913,3908883591,3713875941,1672701262,1672703057,1795
11281,3783443095,3491239350,1672578467,1672579273,806
10427,3534667712,3559619861,1672686553,1672689424,2871
11316,3510781595,3386323728,1672701125,1672701517,392
10311,3510218188,3772114731,1672557420,1672558040,620
10327,3510869438,3203172170,1672612022,1672615470,3448
10600,3361711720,3373802545,1672589391,1672591590,2199
10660,3236563828,3505175620,1672555003,1672557707,2704
11686,3553229537,3633860380,1672598683,1672601906,3223
11030,3716468783,3407734098,1672683321,1672686371,3050
11268,3834424604,3783368855,1672533503,1672536574,3071
11592,3703031637,3757050615,1672541683,1672545011,3328
10754,3201419050,3201502111,1672578047,1672578383,336
11300,3776348451,3335974305,1672667751,1672670536,2785
10882,3287734830,3638126174,1672644433,1672645330,897
10516,3778605154,3340321384,1672633558,1672634910,1352
11568,3388463477,3791289855,1672688716,1672689065,349
11327,3235578121,3732846295,1672570961,1672573575,2614
10314,3777135415,3774822697,1672674477,1672675938,1461
10835,3375257546,3711591464,1672650442,1672653661,3219
11268,3515893948,3713283029,1672627396,1672630978,3582
11537,3907923381,3228033254,1672606935,1672607243,308
10488,3559759778,3735838864,1672558825,1672561755,2930
11544,3902300755,3636927297,1672643881,1672644571,690
10403,3200372897,3407403080,1672652385,1672653197,812
9896,3500049870,3936871734,1672597015,1672599935,2920
11695,3222357355,3277634944,1672564756,1672565833,1077
10079,3918981936,3500640854,1672607252,1672609730,2478
9796,3684199077,3305093237,1672700769,1672703527,2758
9817,3519297683,3715008501,1672654114,1672656291,2177
11123,3756157377,3500209015,1672566615,1672568424,1809
10690,3373018943,3367202274,1672698424,1672701030,2606
10029,3511364193,3831864108,1672662158,1672665025,2867
11336,3271389160,3520395850,1672644602,1672646115,1513
10176,3221126799,3933731871,1672700866,1672703872,3006
9943,3703048107,3701412729,1672552283,1672555780,3497
11162,3430310785,3711613085,1672578711,1672579174,463
10612,3828568868,3271282663,1672663480,1672664981,1501
10688,3710919244,3716460706,1672687082,1672689835,2753
11395,3221126799,3779815753,1672563069,1672563557,488
11790,3381244346,3510291656,1672559108,1672561760,2652
10738,3533816813,3520763492,1672651092,1672652116,1024
11211,3500555856,3975799349,1672562635,1672562747,112
9929,3513143959,3911821258,1672585579,1672587220,1641
11030,3517645656,3776561263,1672614635,1672617667,3032
10345,3422548081,3772019557,1672656470,1672659479,3009
11113,3668202976,3511199555,1672581632,1672582520,888
10784,3688768189,3887918622,1672614556,1672617617,3061
11367,3511095300,3500833053,1672630341,1672632345,2004
11276,3505491969,3339331632,1672678580,1672680499,1919
9825,3755570137,3334633634,1672610085,1672611866,1781
11101,3534174363,3516359146,1672594900,1672595539,639
10014,3917467642,3516588277,1672679875,1672680978,1103
11028,3887069914,3937747312,1672635211,1672637167,1956
10476,3359880163,3374147279,1672695268,1672698544,3276
9903,3514327931,3475090917,1672562919,1672566296,3377
11403,3685083275,3439283360,1672682291,1672684250,1959
10657,3509562377,3373802545,1672636831,1672638495,1664
10672,3509018337,3618024815,1672584509,1672585965,1456
11208,3225554956,3633860380,1672698883,1672700327,1444
10966,3736056340,3511415786,1672640611,1672642864,2253
10124,3912811715,3303552616,1672569749,1672569901,152
9897,3241567995,3398483531,1672627283,1672630195,2912
10785,3500444748,3520625600,1672658085,1672659639,1554
11425,3701978422,3447554599,1672674348,1672674469,121
11114,3513586642,3533726421,1672665891,1672667921,2030
10559,3501843187,3505502819,1672657750,1672659481,1731
10638,3303432071,3294952405,1672536188,1672536975,787
11067,3449233346,3776279305,1672668480,1672671289,2809
10947,3780168985,3520558137,1672548864,1672552294,3430
9819,3730169449,3520824937,1672656435,1672658451,2016
9860,3600699873,3304697982,1672640944,1672642652,1708
10666,3818324410,3632720032,1672583843,1672585076,1233
10619,3818904268,3499820963,1672611375,1672613673,2298
9901,3280208630,3818532143,1672609322,1672609600,278
11110,3514628916,3271389160,1672604118,1672607220,3102
9955,3733730342,3783809405,1672665709,1672668263,2554
10778,3246971044,3334633634,1672543779,1672546131,2352
10680,3364286028,3760748418,1672651102,1672651478,376
10906,3220987526,3469778316,1672649100,1672652477,3377
11553,3305612422,3685877449,1672546054,1672547610,1556
11609,3970265139,3284407073,1672606358,1672606785,427
10098,3223796145,3856975355,1672667929,1672670399,2470
11579,3499622352,3205113625,1672608196,1672609247,1051
10075,3778927933,3925175853,1672658308,1672660401,2093
10107,3511182297,3733411026,1672573141,1672573396,255
9833,3713224038,3902300755,1672651623,1672652346,723
9957,3358982831,3533017131,1672602167,1672603782,1615
10379,3552261072,3812756400,1672599888,1672602031,2143
11320,3701685828,3490008012,1672581345,1672581736,391
10474,3714658474,3206544535,1672563139,1672564757,1618
10481,3760271237,3372778334,1672595495,1672597828,2333
10782,3272581469,3534328311,1672690031,1672692648,2617
11621,3857590978,3384601925,1672563774,1672565705,1931
11676,3206217657,3888642876,1672532107,1672532835,728
11442,3516585063,3739820448,1672671806,1672673623,1817
10921,3352044245,3770012744,1672600982,1672603929,2947
11032,3519494023,3509394912,1672615536,1672615779,243
9986,3836757034,3247845642,1672559347,1672562922,3575
11458,3610517436,3834311054,1672569704,1672572728,3024
10356,3301449986,3853783593,1672551836,1672552682,846
10807,3442564712,3304252969,1672649301,1672649933,632
10422,3899903158,3711219767,1672643805,1672645601,1796
11321,3442073613,3778182724,1672646743,1672648286,1543
11204,3770630937,3519922921,1672607466,1672609371,1905
10495,3511245705,3701675183,1672569455,1672570407,952
10628,3294952405,3684651755,1672552806,1672554573,1767
11480,3520725149,3519000878,1672675399,1672677908,2509
10085,3500415589,3900766525,1672586721,1672588966,2245
9800,3399173821,3397783490,1672570445,1672571812,1367
10493,3711862792,3238779889,1672646750,1672648956,2206
11722,3439036305,3512750313,1672660566,1672662508,1942
10368,3938021614,3376487118,1672652241,1672653311,1070
10276,3517358336,3930475498,1672560816,1672564166,3350
9991,3512638952,3444168914,1672663186,1672664620,1434
10944,3517448452,3885545415,1672604874,1672607575,2701
10739,3500329674,3714142299,1672593249,1672594610,1361
10488,3632094087,3407398464,1672702905,1672705012,2107
11737,3778195766,3760382349,1672703016,1672703757,741
11228,3825234433,3774652449,1672539860,1672540714,854
10666,3513624915,3703749690,1672554139,1672556996,2857
10822,3513140146,3916656185,1672536725,1672538373,1648
10145,3776309810,3517652011,1672631274,1672633067,1793
10990,3464622743,3778819352,1672615631,1672618118,2487
11395,3515379622,3760144712,1672585279,1672586964,1685
11330,3714067998,3501901313,1672606509,1672609678,3169
9804,3791435852,3511794841,1672636022,1672638034,2012
11594,3405435885,3618672178,1672537242,1672539446,2204
11195,3338195686,3458753033,1672539918,1672540392,474
10564,3773378103,3510836047,1672606535,1672607345,810
10145,3703849264,3685645561,1672668529,1672671337,2808
11314,3622654885,3818904268,1672648361,1672650137,1776
10042,3311904032,3344778261,1672592193,1672594830,2637
10276,3776068937,3703474558,1672582783,1672583588,805
10647,3533867833,3511004622,1672688285,1672690382,2097
11401,3662821438,3509614126,1672626485,1672626600,115
9888,3511218261,3772227820,1672625010,1672625560,550
10638,3602570831,3511476353,1672688984,1672691015,2031
11618,3822786416,3477582923,1672619317,1672622160,2843
10664,3893932944,3362385373,1672549000,1672552321,3321
10723,3715590997,3773523569,1672565698,1672567477,1779
10779,3249771731,3793003432,1672633670,1672636315,2645
9846,3780050328,3662307789,1672548328,1672550330,2002
10882,3779609338,3511004622,1672624135,1672626263,2128
10929,3779340538,3776440009,1672683359,1672685757,2398
10871,3783947742,3405435885,1672603724,1672604583,859
10361,3668369938,3780171640,1672572393,1672575505,3112
10384,3639465750,3310737478,1672630844,1672633824,2980
10320,3445406685,3711947828,1672626772,1672627147,375
11539,3276231633,3622654885,1672645246,1672645987,741
11008,3512371853,3500654356,1672554684,1672556182,1498
9889,3933106901,3922430928,1672541446,1672544231,2785
9857,3505234868,3973134902,1672686308,1672689680,3372
11569,3380167818,3487779363,1672611407,1672613542,2135
10934,3511963020,3557129226,1672661529,1672664439,2910
10685,3534988162,3909457959,1672668641,1672669616,975
11766,3447202943,3443521234,1672636814,1672637113,299
11607,3298706213,3473706746,1672647328,1672649744,2416
10205,3467944159,3770276815,1672653405,1672656108,2703
10462,3287821258,3830291558,1672543381,1672545245,1864
10354,3511286390,3511615015,1672642792,1672643999,1207
11231,3778604070,3662495290,1672621471,1672622340,869
11112,3774251051,3756157377,1672577621,1672578130,509
11555,3387971464,3394394262,1672658954,1672659073,119
11502,3792708936,3534626053,1672671581,1672673365,1784
10007,3520012007,3832902787,1672694104,1672696399,2295
10114,3501573548,3313502623,1672632807,1672635250,2443
11359,3791382196,3825877848,1672656006,1672656501,495
10724,3510291656,3778544203,1672612821,1672616385,3564
10870,3505155858,3777655401,1672643586,1672644066,480
11761,3333505404,3716371766,1672551359,1672554806,3447
11191,3934991640,3424425746,1672593454,1672595473,2019
11782,3776001441,3780680252,1672559621,1672562949,3328
11650,3516019206,3283847934,1672612594,1672616122,3528
10641,3972442654,3475653510,1672665629,1672666335,706
11704,3919984986,3396472026,1672604278,1672604675,397
11210,3772968080,3776122272,1672561509,1672563106,1597
10525,3500019810,3623894390,1672591691,1672594283,2592
11043,3818236682,3311260898,1672574376,1672576731,2355
11611,3205687719,3505804611,1672679203,1672682422,3219
11176,3404461403,3776534957,1672660317,1672662814,2497
10679,3455430943,3681737865,1672621132,1672623200,2068
11261,3452982957,3422460919,1672685264,1672686978,1714
10452,3471585513,3791434207,1672588486,1672590974,2488
11629,3306066522,3730459093,1672671752,1672673034,1282
11101,3774145748,3779174993,1672607099,1672610178,3079
10006,3773523569,3227206772,1672549139,1672549774,635
10844,3382746533,3517949586,1672613526,1672614061,535
11678,3313579674,3534937492,1672541111,1672543803,2692
10482,3810584695,3772019557,1672606313,1672609126,2813
11398,3380357490,3909504515,1672624867,1672625764,897
11230,3519689906,3807111856,1672538953,1672540979,2026
10721,3817376705,3882851213,1672580743,1672581373,630
10625,3349475873,3855077502,1672617571,1672619812,2241
10000,3450735824,3505756991,1672539951,1672542980,3029
10989,3476431618,3710271021,1672698862,1672701705,2843
11486,3420881591,3429333292,1672653999,1672657204,3205
9981,3273771395,3906075386,1672643878,1672645465,1587
11588,3903115138,3519015940,1672680247,1672680355,108
11128,3770180844,3669140241,1672584147,1672585108,961
10203,3342056927,3825526565,1672683974,1672684657,683
11010,3495637721,3624307518,1672624393,1672625032,639
10218,3776291254,3926065090,1672599706,1672599862,156
10041,3512726649,3791863922,1672611810,1672614104,2294
10291,3665478011,3534578428,1672662438,1672663640,1202
10028,3465672238,3381254180,1672685948,1672686748,800
11083,3289017988,3330188769,1672563763,1672565477,1714
11415,3373802545,3881579907,1672599378,1672602203,2825
11026,3338016147,3463892928,1672646268,1672647939,1671
10428,3831981073,3912181197,1672625423,1672625769,346
10482,3534372899,3792008302,1672677646,1672680448,2802
11319,3513508737,3710680073,1672576240,1672579302,3062
10225,3516965624,3791716170,1672533546,1672534198,652
10933,3853386575,3501004005,1672685835,1672687218,1383
10021,3807717766,3852161626,1672635276,1672635785,509
10316,3884191432,3488749569,1672676274,1672678880,2606
11583,3509394912,3909067335,1672604777,1672607431,2654
10082,3779748270,3512072679,1672585107,1672588476,3369
10620,3366164642,3450621820,1672560068,1672561048,980
10204,3290797257,3755273361,1672579454,1672581899,2445
11775,3533154906,3201957157,1672653420,1672656398,2978
11333,3500909455,3600978954,1672627504,1672627924,420
10775,3777290300,3505531432,1672668460,1672671967,3507
11469,3776182849,3760997159,1672613829,1672614254,425
10702,3380418745,3793029132,1672615408,1672617894,2486
11214,3776534957,3732223664,1672546640,1672547609,969
10760,3600699873,3623512088,1672697019,1672697258,239
10529,3516321814,3884001167,1672653340,1672656226,2886
10807,3922480066,3533822490,1672606104,1672607577,1473
11711,3714283424,3716467469,1672573758,1672576940,3182
9943,3760966645,3777931341,1672544229,1672545016,787
11197,3811503860,3304661369,1672619387,1672621074,1687
11530,3518368900,3792432094,1672700308,1672702390,2082
10825,3376842515,3201656220,1672669862,1672670233,371
10269,3224053840,3926065090,1672666168,1672668971,2803
11004,3519165527,3533440294,1672610703,1672612092,1389
10188,3284483177,3776593726,1672586483,1672588303,1820
10956,3489205994,3770991234,1672621513,1672623461,1948
11696,3441683673,3701004302,1672643087,1672645978,2891
11379,3273537848,3897107253,1672606034,1672606814,780
11786,3513215373,3360525513,1672620245,1672622311,2066
10411,3283847934,3711591464,1672557881,1672558231,350
9798,3791351852,3287689454,1672623384,1672626860,3476
10671,3779951373,3780749789,1672627226,1672627344,118
11671,3714718326,3686885442,1672695409,1672696582,1173
10155,3512768285,3972442654,1672576247,1672579040,2793
10761,3894328297,3773848111,1672537499,1672541005,3506
11114,3311197635,3509701363,1672695192,1672696738,1546
10965,3483347530,3701296091,1672537301,1672538384,1083
11745,3428325402,3288920399,1672608411,1672609037,626
10589,3783172505,3295691964,1672678354,1672678851,497
10538,3907225070,3791758175,1672602868,1672605024,2156
10697,3500591274,3899903158,1672678294,1672681494,3200
11164,3805268739,3334482021,1672587626,1672590198,2572
11044,3395610742,3701374160,1672566068,1672566353,285
10392,3792455305,3783176874,1672595431,1672597467,2036
10943,3510368377,3711131262,1672597029,1672599435,2406
10456,3755465396,3440671139,1672679896,1672681406,1510
10083,3459951739,3313502623,1672673950,1672675243,1293
10991,3923524564,3683562111,1672558855,1672562282,3427
10423,3809207482,3388830370,1672548246,1672551408,3162
10460,3520362238,3271282663,1672615844,1672619300,3456
11257,3664478769,3711856534,1672605660,1672605767,107
11553,3783430498,3780964089,1672624313,1672624431,118
10067,3666022373,3342252701,1672565218,1672565470,252
10561,3514564903,3779169946,1672593008,1672595352,2344
11331,3772909073,3776182849,1672640282,1672642054,1772
10490,3757773786,3783939161,1672543776,1672546798,3022
10911,3739567072,3205161801,1672609019,1672612446,3427
10549,3620157388,3500854711,1672677976,1672680623,2647
10439,3390537737,3623113240,1672641052,1672642279,1227
10805,3838748301,3534206917,1672542691,1672545057,2366
10238,3857389270,3334936138,1672667268,1672670540,3272
10249,3447696555,3703206956,1672595665,1672597581,1916
10762,3756493561,3791245127,1672595679,1672596001,322
11170,3514455363,3519322066,1672661230,1672664165,2935
10597,3413799143,3499711458,1672657875,1672660863,2988
11235,3973138649,3711945923,1672540379,1672540617,238
10961,3511500932,3533867833,1672583185,1672585234,2049
10769,3420664407,3312733562,1672590606,1672590794,188
10307,3908331271,3295710494,1672547867,1672549595,1728
10172,3715114417,3714645218,1672638197,1672639104,907
10782,3904004824,3206262649,1672692216,1672694411,2195
10416,3978643889,3333477908,1672556507,1672556934,427
11395,3716976932,3452090950,1672665565,1672668480,2915
11746,3770595035,3625779003,1672659773,1672660405,632
11064,3938059867,3736036532,1672676205,1672676798,593
10643,3711722554,3777932225,1672696622,1672697238,616
11547,3893043842,3780129338,1672633282,1672634310,1028
10709,3779160052,3926724515,1672667944,1672668541,597
11594,3855674398,3792597493,1672633600,1672633827,227
10666,3520725149,3756850160,1672543951,1672545344,1393
11523,3793332600,3517816581,1672581031,1672582436,1405
11038,3311989687,3518335611,1672697856,1672700745,2889
9998,3514761434,3773579644,1672554726,1672555973,1247
9826,3609644043,3514628916,1672623715,1672624212,497
10149,3501901313,3776182849,1672598220,1672600672,2452
11605,3300810210,3510262025,1672615063,1672615821,758
10851,3939422411,3519341916,1672566947,1672567521,574
10193,3701540249,3710119555,1672703212,1672705324,2112
10858,3278805844,3238997746,1672591332,1672591814,482
10918,3423940256,3279851026,1672572732,1672574229,1497
10220,3533566754,3934980229,1672572469,1672572859,390
11530,3406238754,3319645922,1672601021,1672602606,1585
10099,3465690527,3330188769,1672570091,1672570310,219
10599,3428076194,3713336088,1672547556,1672549289,1733
10953,3772695548,3902682060,1672670326,1672673559,3233
10415,3811419378,3682150740,1672604642,1672607613,2971
11358,3777937949,3511415786,1672680222,1672682451,2229
11705,3978254945,3838748301,1672648155,1672648311,156
9942,3517617472,3772070986,1672703688,1672706539,2851
10681,3513215373,3836757034,1672687357,1672689424,2067
10754,3600842635,3446218191,1672602401,1672605683,3282
10474,3783086267,3933872044,1672591379,1672592581,1202
11194,3509556649,3755942724,1672624033,1672624132,99
10065,3850904092,3510254698,1672657488,1672658921,1433
11267,3970775805,3208894215,1672680017,1672682309,2292
10022,3276499910,3979115924,1672675335,1672678125,2790
10614,3444453261,3318220119,1672605066,1672607525,2459
10414,3779561601,3505010941,1672633332,1672636165,2833
11452,3776348451,3490804766,1672533468,1672535123,1655
10945,3447948483,3710919244,1672571940,1672574127,2187
10024,3791359168,3298706213,1672675748,1672676257,509
11087,3372079985,3478455812,1672677539,1672678879,1340
10636,3780482864,3757199889,1672584046,1672586176,2130
10853,3512794667,3517960157,1672574182,1672574521,339
10612,3757732853,3779255367,1672699397,1672699918,521
11756,3624164232,3792107875,1672681403,1672684964,3561
10702,3813853446,3603452936,1672552757,1672553937,1180
10030,3509663119,3240683148,1672563454,1672566501,3047
11749,3925823748,3716733618,1672633064,1672634913,1849
11471,3360525513,3974264211,1672641325,1672642526,1201
10101,3275171954,3336501403,1672534482,1672536822,2340
10879,3276231633,3773523569,1672548885,1672552251,3366
11272,3701663839,3425646356,1672658050,1672661127,3077
11229,3809194824,3497138014,1672543064,1672545137,2073
11776,3311188620,3780294116,1672647146,1672649145,1999
9902,3713923960,3793978936,1672589673,1672590409,736
11016,3511608609,3928076270,1672643353,1672644924,1571
11284,3777149336,3552309108,1672552731,1672555469,2738
9807,3514853709,3780749789,1672606092,1672606670,578
10285,3515284733,3512802259,1672589983,1672591320,1337
10638,3770273459,3684651755,1672625803,1672625899,96
10807,3662507634,3701028092,1672571835,1672572653,818
11120,3825877848,3461137945,1672558134,1672559749,1615
11439,3221736756,3610517436,1672607265,1672610435,3170
10189,3776455762,3442096275,1672608240,1672610063,1823
11419,3711179193,3680075399,1672626169,1672629297,3128
10456,3713920790,3812261241,1672544826,1672548065,3239
10209,3226037966,3505853594,1672674278,1672676553,2275
10002,3773878451,3511908639,1672590568,1672590788,220
10416,3512700007,3355880028,1672610126,1672613410,3284
11176,3382757142,3738132114,1672600460,1672603330,2870
10691,3311231911,3236360179,1672547897,1672551223,3326
10697,3515047288,3662354016,1672632319,1672635866,3547
11339,3817376705,3757032266,1672642281,1672644168,1887
11120,3776791436,3452802329,1672562811,1672563889,1078
11553,3515637968,3701596047,1672693583,1672696798,3215
11457,3485898181,3220976338,1672584390,1672585816,1426
10444,3496579251,3519922921,1672648229,1672650438,2209
11214,3773432494,3619705594,1672594089,1672597417,3328
10172,3716475340,3338642026,1672674545,1672676223,1678
9818,3518572231,3703351452,1672647019,1672647387,368
10193,3437108337,3511245705,1672624259,1672624556,297
11025,3357496255,3634766042,1672677283,1672680302,3019
10471,3791108593,3791205793,1672581044,1672583930,2886
10166,3519848902,3792708936,1672569065,1672569986,921
10955,3716994924,3505502819,1672667818,1672670328,2510
10429,3309528048,3811503860,1672577546,1672578989,1443
11650,3513432588,3513203127,1672690216,1672692342,2126
11703,3814378625,3773826624,1672627645,1672629085,1440
11784,3559221089,3511206717,1672602633,1672603152,519
10643,3518117078,3533131937,1672597931,1672599828,1897
11019,3778695017,3369938668,1672648212,1672650493,2281
10355,3442181067,3311774510,1672665977,1672668776,2799
10866,3520926977,3882851213,1672589186,1672592744,3558
10072,3501253130,3438204844,1672610030,1672611023,993
11173,3287094447,3444295435,1672536941,1672539621,2680
11709,3757732853,3756437169,1672558064,1672560878,2814
10512,3779130507,3755465396,1672569705,1672570408,703
10510,3773852157,3815184540,1672664837,1672665309,472
9965,3518931700,3230612965,1672572528,1672575033,2505
11019,3713878219,3730600658,1672579188,1672580375,1187
11575,3223144610,3779665641,1672555905,1672557052,1147
10422,3893950585,3714377201,1672655851,1672657933,2082
10363,3802757611,3505331014,1672600059,1672600224,165
10749,3478455812,3829358750,1672648354,1672650613,2259
9920,3518511124,3433902955,1672577471,1672579270,1799
10042,3716891903,3472018395,1672576979,1672578105,1126
11435,3701925712,3777041132,1672569007,1672571850,2843
11012,3715111016,3714074120,1672617001,1672619929,2928
10170,3757030923,3972196462,1672690224,1672690542,318
10487,3463892928,3609644043,1672671920,1672674186,2266
10106,3500821475,3515753241,1672700311,1672703870,3559
9960,3756345026,3363549860,1672660386,1672663079,2693
10281,3298706213,3500096103,1672672787,1672676380,3593
10699,3732104286,3715441777,1672601666,1672602833,1167
10088,3780733404,3517210356,1672585446,1672586900,1454
11119,3399430522,3978254945,1672654339,1672656755,2416
10649,3714640103,3701841013,1672544540,1672545101,561
10355,3715140418,3487231844,1672575378,1672577666,2288
10893,3774316305,3512343029,1672647972,1672649785,1813
11324,3388923880,3441944896,1672581140,1672583045,1905
10854,3778479297,3715724166,1672626621,1672626956,335
11536,3438470128,3533154906,1672585928,1672585992,64
10964,3792267993,3510301454,1672575971,1672577318,1347
11060,3710149975,3701925712,1672653255,1672655159,1904
10534,3783594246,3474879231,1672553669,1672556845,3176
10167,3935256825,3505836431,1672688078,1672690469,2391
10892,3685645561,3519754667,1672554270,1672554354,84
11054,3515802579,3772943811,1672689638,1672691756,2118
9839,3368079099,3452090950,1672574610,1672577014,2404
11777,3206241691,3277634944,1672554940,1672556199,1259
11221,3774325486,3519356606,1672658321,1672659685,1364
11388,3780921044,3662507634,1672701042,1672701222,180
10615,3661543201,3519322066,1672636803,1672639754,2951
10692,3736987749,3711810752,1672685591,1672686325,734
11669,3711810752,3774921252,1672587595,1672588749,1154
11363,3491948594,3306491253,1672683692,1672685094,1402
10485,3607288879,3292936094,1672638761,1672641609,2848
11157,3286938590,3368079099,1672642344,1672644078,1734
10469,3311409212,3716445184,1672698510,1672700497,1987
10337,3438470128,3772943811,1672556946,1672557878,932
10044,3757501067,3682266017,1672605576,1672608274,2698
10496,3510206323,3340897079,1672703453,1672706220,2767
11786,3249614888,3907039612,1672578915,1672579076,161
11297,3223177147,3514761434,1672584012,1672587606,3594
10106,3519357822,3898595916,1672638953,1672639482,529
10219,3275274182,3976225898,1672640465,1672643330,2865
11355,3757030923,3713906305,1672702403,1672702683,280
11713,3834311054,3919342147,1672670379,1672670514,135
9805,3468201976,3755229631,1672551128,1672552051,923
9975,3519465545,3208962614,1672595617,1672596193,576
10513,3501977123,3338016147,1672566622,1672567095,473
11342,3884180202,3971422524,1672619283,1672620058,775
10099,3755119166,3811503860,1672662291,1672663463,1172
11757,3555764822,3518209090,1672656446,1672657055,609
10708,3505811269,3500057674,1672571186,1672572818,1632
10011,3302929858,3804840997,1672597105,1672598132,1027
10456,3231963246,3703336988,1672696292,1672699778,3486
11049,3701004302,3533265491,1672613070,1672616106,3036
10145,3682906048,3755170743,1672622332,1672623372,1040
11714,3396453219,3300238532,1672636356,1672636621,265
10521,3467232654,3455430943,1672657339,1672658928,1589
9882,3737946004,3791070926,1672675624,1672677076,1452
11432,3929391979,3772251279,1672604755,1672605747,992
10228,3501574882,3609335008,1672635312,1672638889,3577
11271,3919345990,3555215568,1672650230,1672650773,543
10126,3517991042,3710008760,1672685722,1672686568,846
11541,3634670780,3887502536,1672566492,1672567207,715
9816,3500442370,3501628472,1672640307,1672643688,3381
10696,3756437169,3278805844,1672690656,1672691919,1263
10929,3611570003,3533960602,1672685001,1672686078,1077
10188,3511671476,3505010941,1672572107,1672574013,1906
10801,3756149282,3534426696,1672631242,1672631856,614
10091,3757592622,3778695017,1672586211,1672586480,269
11339,3714951681,3481365330,1672593082,1672594765,1683
11582,3519034304,3500776597,1672533764,1672537052,3288
11572,3899294071,3880562532,1672537718,1672540949,3231
10893,3558349840,3853783593,1672630921,1672633784,2863
10926,3533077580,3454554552,1672651005,1672652419,1414
9981,3911431642,3378172464,1672695174,1672697416,2242
11307,3516472352,3336501403,1672702896,1672704332,1436
11781,3777937949,3534624672,1672604528,1672607172,2644
10528,3756413374,3516019206,1672667443,1672670802,3359
11658,3513740840,3780168985,1672557297,1672559074,1777
11023,3853783593,3398862999,1672615929,1672617464,1535
10171,3602570831,3353811455,1672666137,1672667150,1013
10107,3519102732,3512965991,1672574406,1672577837,3431
11172,3499142934,3783594246,1672606501,1672608071,1570
10195,3773736248,3791351852,1672566424,1672569388,2964
11718,3440305508,3773394570,1672533112,1672536162,3050
11300,3618895679,3713159131,1672645726,1672646071,345
10333,3519260216,3534278019,1672536634,1672539837,3203
10015,3716669659,3308965136,1672668931,1672670540,1609
10772,3755670258,3279851026,1672575446,1672575741,295
11611,3437286595,3519621901,1672689341,1672691366,2025
10660,3559759778,3907245259,1672624199,1672625913,1714
11671,3477582923,3514698862,1672633233,1672634144,911
11359,3519055736,3714287902,1672681343,1672683694,2351
10046,3779665641,3772659062,1672616190,1672616304,114
11232,3770564547,3710919244,1672662950,1672665148,2198
10040,3512343029,3220123678,1672606818,1672607683,865
11776,3519065870,3920155862,1672552342,1672555298,2956
10171,3779382417,3514926921,1672677536,1672678545,1009
11356,3275751794,3200785194,1672658200,1672661425,3225
9978,3713224986,3422081502,1672595266,1672596149,883
11627,3661543201,3287734830,1672645686,1672646639,953
10312,3770273966,3313392810,1672694966,1672698180,3214
10711,3278071998,3911376818,1672648127,1672651163,3036
11246,3318590083,3885339157,1672653679,1672656414,2735
11216,3757199889,3299052917,1672569951,1672570361,410
10462,3375324190,3441840658,1672693009,1672694882,1873
11408,3466655775,3829412384,1672539597,1672542000,2403
10390,3806034626,3311159418,1672571847,1672573100,1253
11013,3377311502,3703031637,1672698970,1672700404,1434
11151,3477951091,3777060250,1672609138,1672609685,547
11249,3516792348,3511476353,1672601089,1672604514,3425
11463,3311037445,3488988274,1672627704,1672631239,3535
10717,3510454018,3480259863,1672583546,1672586666,3120
9924,3474097405,3821087562,1672701104,1672704353,3249
9907,3701459978,3518157683,1672535505,1672535571,66
11576,3701041860,3275975921,1672545736,1672545863,127
10990,3469778316,3703732445,1672615771,1672617867,2096
10689,3505032644,3770480149,1672642493,1672643965,1472
11674,3282240901,3424476995,1672567723,1672570978,3255
10706,3881012415,3701596047,1672537053,1672539986,2933
11040,3368441333,3884862164,1672676223,1672677931,1708
10704,3770533588,3832289185,1672637953,1672640205,2252
10133,3293673220,3715881104,1672560248,1672560468,220
11166,3819315404,3519494023,1672587435,1672588605,1170
10218,3927763819,3500221079,1672637273,1672640550,3277
10999,3352374868,3783611957,1672694153,1672694679,526
11790,3880549316,3776348472,1672548555,1672550915,2360
10545,3885422379,3413799143,1672669372,1672672516,3144
11714,3204149913,3714902042,1672534549,1672535380,831
11025,3513545735,3501619113,1672581620,1672584864,3244
10508,3512072679,3203630241,1672619547,1672623018,3471
11062,3499711458,3388537708,1672584074,1672587128,3054
10571,3687024828,3791206902,1672637461,1672640414,2953
11337,3512700007,3776778306,1672594518,1672597939,3421
11025,3430823498,3929923442,1672543257,1672543537,280
10606,3755630085,3481019442,1672568637,1672569008,371
10709,3791205793,3299052917,1672602287,1672605714,3427
10237,3510022922,3500455935,1672586968,1672589897,2929
11413,3783935976,3430310785,1672533256,1672535356,2100
11452,3512625661,3282240901,1672604670,1672607711,3041
10736,3416474842,3780576351,1672612609,1672616050,3441
10912,3668764192,3238310644,1672698426,1672700693,2267
11503,3977209952,3485521840,1672686449,1672688116,1667
10462,3779212271,3714658474,1672658311,1672659263,952
10427,3757732853,3513629502,1672564048,1672566508,2460
10322,3783368855,3757549235,1672680675,1672680947,272
9799,3738103378,3756680289,1672534577,1672536358,1781
11582,3685877449,3732128078,1672672707,1672672796,89
11449,3513624915,3515970536,1672626742,1672627738,996
10475,3511182297,3736941123,1672665191,1672667995,2804
11634,3282240901,3517132086,1672694199,1672694756,557
10008,3922480066,3661359073,1672577988,1672581588,3600
11535,3760232135,3483347530,1672537076,1672537339,263
9814,3737467358,3823600319,1672535083,1672536823,1740
10820,3377883705,3923910914,1672569684,1672570762,1078
11005,3615846003,3755688231,1672703343,1672705280,1937
11142,3716541851,3711613085,1672559834,1672560892,1058
11357,3201573194,3770019143,1672586426,1672589772,3346
10865,3783095041,3203954795,1672678088,1672678586,498
10908,3395615598,3823600319,1672685634,1672688452,2818
11750,3802625412,3979115924,1672665252,1672665445,193
10645,3208594306,3906260966,1672559909,1672562727,2818
10800,3505155858,3518058151,1672685951,1672687478,1527
11694,3471585513,3370512945,1672684302,1672686913,2611
11289,3501225887,3445406685,1672599329,1672602588,3259
10617,3510916875,3770273966,1672682737,1672683510,773
11121,3378747834,3772966919,1672682538,1672684014,1476
10886,3500544306,3623953446,1672677237,1672680269,3032
10194,3715750580,3299847117,1672583334,1672586171,2837
11319,3301431129,3239990061,1672557570,1672558694,1124
10139,3773032706,3380285779,1672644719,1672647734,3015
11368,3757607649,3669418238,1672556559,1672559794,3235
10886,3281970147,3243651036,1672608588,1672609873,1285
10634,3624164232,3779340538,1672562969,1672565050,2081
10008,3755175497,3500440602,1672673878,1672674054,176
10472,3896840409,3760074281,1672608567,1672612016,3449
10356,3735056027,3633622298,1672680290,1672681429,1139
11682,3620836520,3760024021,1672550020,1672552763,2743
10844,3703277359,3715897627,1672598205,1672599101,896
10315,3898965585,3716976932,1672594108,1672596539,2431
11068,3500421940,3510262025,1672655624,1672657624,2000
10787,3757378286,3850005949,1672688327,1672688800,473
11719,3666823095,3833993674,1672614846,1672615330,484
10062,3520473111,3915679140,1672616460,1672618071,1611
11352,3666958814,3554236075,1672657631,1672660024,2393
11357,3511069449,3422205569,1672596080,1672596473,393
10035,3510335069,3628556590,1672541700,1672544482,2782
11170,3517210356,3514306458,1672620617,1672622407,1790
9826,3625952981,3713726267,1672681764,1672682601,837
11531,3735422623,3435715962,1672614996,1672615348,352
10729,3514145752,3909220912,1672532231,1672533487,1256
11584,3772980989,3931917809,1672640858,1672643312,2454
11705,3511003541,3811503860,1672653056,1672653350,294
10337,3292936094,3684651755,1672545664,1672547698,2034
10375,3710695372,3778195766,1672540691,1672541688,997
11120,3220976338,3319061210,1672578742,1672580469,1727
11298,3380185102,3970265139,1672658658,1672660233,1575
10196,3363549860,3366566029,1672701614,1672705092,3478
9914,3445172440,3825082811,1672561751,1672562930,1179
10074,3307521389,3315432466,1672545154,1672546317,1163
10282,3933731871,3616242727,1672630024,1672631121,1097
10824,3516454693,3714435747,1672644056,1672645321,1265
9950,3609925909,3359351267,1672685166,1672686201,1035
10503,3558264627,3807717766,1672560871,1672562127,1256
11265,3838119022,3776166086,1672534229,1672534309,80
11006,3307997700,3292663993,1672701858,1672704112,2254
11632,3933731871,3792497486,1672610319,1672610623,304
11211,3792972270,3311515179,1672685737,1672687212,1475
10667,3364302157,3517960157,1672682019,1672684512,2493
11749,3512871568,3401215739,1672685182,1672685474,292
10453,3534204885,3501759031,1672667340,1672668791,1451
10787,3776034313,3533209168,1672643486,1672646743,3257
10101,3760385591,3852992961,1672657256,1672659197,1941
10274,3793081195,3235074007,1672585444,1672585653,209
11766,3713434898,3760679372,1672560740,1672563956,3216
11115,3711844574,3374195945,1672565691,1672568038,2347
10612,3551833298,3927202773,1672680523,1672683787,3264
10909,3516668203,3904045870,1672626904,1672628572,1668
11778,3286862903,3505502819,1672602046,1672603192,1146
11483,3505908965,3358675021,1672658645,1672660306,1661
10315,3915460293,3714923092,1672599122,1672601036,1914
10587,3936486724,3772968080,1672604890,1672605243,353
10257,3770533675,3377311502,1672641038,1672643347,2309
10815,3238796398,3207586072,1672608041,1672611048,3007
11644,3883640454,3666823095,1672613238,1672615670,2432
11364,3935444008,3711131262,1672685681,1672688850,3169
10033,3701041860,3770276815,1672701356,1672703617,2261
10672,3511198566,3498803823,1672615985,1672617596,1611
10584,3934280144,3397527886,1672561488,1672564008,2520
11186,3373802545,3932491622,1672605907,1672609341,3434
10031,3510680251,3557528150,1672612394,1672612942,548
10479,3289017988,3311774510,1672611693,1672613793,2100
11761,3465672238,3791644831,1672602016,1672605100,3084
10354,3394357241,3793874490,1672594346,1672594647,301
10995,3408111327,3516034245,1672660177,1672663504,3327
11089,3240443426,3716233100,1672578915,1672580871,1956
11203,3342426430,3479910993,1672609233,1672610132,899
9884,3791224239,3500093945,1672673992,1672675383,1391
11050,3777135415,3513586642,1672645899,1672648564,2665
10614,3701459978,3361711720,1672673385,1672673591,206
11358,3514216460,3810949170,1672669219,1672670048,829
10263,3334824744,3756763585,1672544342,1672544912,570
10751,3519000878,3858429342,1672636048,1672636137,89
10130,3886837151,3668720465,1672586199,1672589654,3455
10558,3427741923,3756066765,1672570332,1672571923,1591
10587,3278629965,3345896913,1672661651,1672662147,496
10891,3236254381,3500018566,1672681559,1672684286,2727
11512,3518157683,3511199555,1672645532,1672648519,2987
11580,3602054754,3432762943,1672695836,1672696946,1110
10080,3814770073,3486824047,1672647312,1672650734,3422
10156,3715737742,3703697059,1672537681,1672539831,2150
10277,3518335611,3209925780,1672585693,1672588949,3256
11217,3756437169,3760416450,1672695399,1672698227,2828
9890,3756525103,3716475340,1672638385,1672641857,3472
9947,3779282072,3285322570,1672603377,1672606966,3589
10405,3516904926,3244098077,1672622536,1672625502,2966
11253,3285515107,3387700451,1672648368,1672650080,1712
11239,3887030182,3770976984,1672687130,1672688773,1643
10008,3714718326,3973582279,1672622591,1672623998,1407
9841,3517552930,3825526565,1672579538,1672581115,1577
10611,3478206139,3757944870,1672593992,1672596718,2726
9911,3518511124,3500356342,1672599625,1672601053,1428
10778,3340321384,3516103646,1672695306,1672696203,897
10373,3510022922,3509167758,1672604675,1672606413,1738
11185,3220798451,3437023385,1672611263,1672612907,1644
10591,3378172464,3715881104,1672701701,1672703534,1833
11232,3825234433,3886896755,1672668794,1672672182,3388
11637,3311602936,3756740153,1672586463,1672587371,908
11083,3249771731,3512395783,1672541767,1672544705,2938
11228,3519228207,3437108337,1672645633,1672649120,3487
11325,3770018912,3533225084,1672599342,1672601920,2578
9973,3474074188,3772708314,1672665883,1672669332,3449
10338,3772659062,3977880564,1672557700,1672560442,2742
10581,3713434898,3776968640,1672535667,1672537583,1916
10947,3821087562,3770019143,1672584968,1672587394,2426
10051,3360837082,3399726243,1672644546,1672645040,494
10065,3776901443,3505936495,1672552985,1672556443,3458
9942,3437023385,3231271498,1672655184,1672658454,3270
9846,3755779925,3770941125,1672566301,1672567586,1285
10458,3500833053,3850108828,1672573849,1672574364,515
11171,3486509752,3505908965,1672563780,1672566954,3174
9871,3511794841,3496352027,1672601018,1672604600,3582
10524,3501734800,3770105006,1672601106,1672603156,2050
10986,3500741534,3829412384,1672632799,1672633075,276
11723,3288791629,3895422995,1672575252,1672576704,1452
10839,3419829238,3660257653,1672696894,1672699281,2387
11703,3285201542,3517149023,1672631423,1672633831,2408
11012,3516429380,3515681585,1672569512,1672571224,1712
11164,3511341866,3760267158,1672653493,1672654201,708
11478,3792283334,3516668203,1672625529,1672627868,2339
11697,3791224239,3228465044,1672605052,1672607180,2128
10669,3295787354,3804075198,1672543900,1672545938,2038
11092,3777439655,3509614126,1672669448,1672672986,3538
10494,3711040761,3732871856,1672650935,1672652384,1449
10189,3716209499,3246804115,1672593478,1672595229,1751
11710,3389069291,3229570647,1672681130,1672682895,1765
11192,3514980025,3500062408,1672554802,1672557158,2356
11511,3777992576,3885674996,1672549683,1672549772,89
11456,3514761434,3756991235,1672688454,1672688693,239
10078,3353335252,3499820963,1672539388,1672542118,2730
10554,3977615973,3505037247,1672570601,1672571905,1304
10032,3505037247,3517652011,1672654439,1672655091,652
10523,3703732445,3348343425,1672700654,1672701395,741
9908,3793920312,3238779889,1672578622,1672580242,1620
11394,3308744016,3639503148,1672619692,1672620586,894
10309,3780626668,3711171132,1672598183,1672600282,2099
10116,3510143850,3246062632,1672531248,1672531378,130
10326,3336501403,3516815069,1672667147,1672670465,3318
11300,3307997700,3792851584,1672689578,1672692305,2727
10045,3760648750,3438204844,1672542009,1672545033,3024
10554,3900195680,3774394000,1672626067,1672629071,3004
10309,3349319959,3519724388,1672542125,1672543543,1418
9952,3616403486,3899903158,1672619197,1672621630,2433
10574,3394986304,3886837151,1672641648,1672644061,2413
11281,3783730769,3760537855,1672693539,1672696549,3010
11585,3914947393,3373677765,1672623966,1672625344,1378
9928,3516827471,3779951373,1672691849,1672693031,1182
10483,3533986052,3600978954,1672652283,1672652939,656
11499,3369270860,3500234771,1672555303,1672557110,1807
11069,3381244346,3605078841,1672664373,1672665955,1582
10637,3501612813,3773440794,1672692283,1672695840,3557
11333,3791974273,3517136772,1672553857,1672555428,1571
10420,3701284535,3483701493,1672682939,1672685445,2506
10419,3505032773,3500833053,1672680648,1672681567,919
10791,3313298164,3625931630,1672598375,1672599795,1420
10398,3774939922,3739844610,1672652208,1672652627,419
11320,3792627762,3791688526,1672683289,1672685538,2249
10931,3791245127,3447312353,1672600605,1672600939,334
10762,3449672240,3387413950,1672533078,1672535355,2277
10255,3555763674,3359418136,1672672817,1672674541,1724
10983,3710515351,3231153513,1672532224,1672533684,1460
10298,3500415589,3505697295,1672549965,1672552139,2174
11050,3669497617,3485468650,1672615800,1672617595,1795
11203,3459951739,3976742903,1672604631,1672607259,2628
10005,3755107521,3919814073,1672666875,1672670442,3567
11327,3757660578,3350631472,1672547723,1672548215,492
11790,3882580580,3456795601,1672536444,1672537928,1484
10651,3510439480,3733796228,1672697074,1672698526,1452
10411,3311188620,3501976169,1672703123,1672705916,2793
11676,3623067708,3533340292,1672533470,1672534711,1241
9826,3922301238,3793978936,1672687379,1672688181,802
9817,3505560793,3776309810,1672609191,1672612552,3361
9913,3305093237,3201957157,1672640053,1672641276,1223
11564,3501657158,3792900315,1672545536,1672545892,356
11674,3738526914,3792337863,1672614678,1672616469,1791
11000,3757446082,3701291994,1672662861,1672664714,1853
11194,3554174421,3468343480,1672561341,1672564412,3071
10416,3519908593,3505593034,1672574646,1672577542,2896
10005,3466655775,3770991234,1672610221,1672610463,242
11131,3512395783,3512638952,1672641136,1672642465,1329
10542,3713726267,3713224986,1672588327,1672591755,3428
11155,3760232135,3519034304,1672615010,1672618051,3041
11174,3703481882,3505066871,1672658062,1672659602,1540
11407,3511750850,3927504954,1672545313,1672545744,431
11497,3340321384,3514244308,1672624901,1672626745,1844
11023,3780680252,3780127017,1672674840,1672676371,1531
9812,3249380931,3500473064,1672693187,1672693332,145
9990,3500776597,3813986705,1672542792,1672545337,2545
10206,3505624416,3500741005,1672594198,1672597602,3404
11322,3756168814,3611533094,1672606954,1672610353,3399
10470,3894756677,3617135064,1672574023,1672577513,3490
10118,3517469005,3490953301,1672588787,1672589052,265
11522,3480405740,3233993993,1672584115,1672587319,3204
11260,3780013266,3427527462,1672622048,1672624035,1987
11158,3827981800,3510795808,1672589007,1672591210,2203
11109,3896200048,3371184929,1672646775,1672647403,628
11744,3492350318,3806720019,1672629189,1672630239,1050
10520,3773714494,3883640454,1672633238,1672633892,654
11308,3778182724,3511382748,1672634767,1672637713,2946
11142,3519730914,3809860102,1672630774,1672633283,2509
10473,3496407500,3515528947,1672645606,1672646897,1291
11649,3931767736,3472774606,1672703273,1672706556,3283
10155,3882851213,3916656185,1672684395,1672685247,852
10971,3309415277,3839308659,1672627207,1672629860,2653
10678,3370245766,3394364348,1672648649,1672651335,2686
10198,3375905193,3377311502,1672614407,1672614965,558
11358,3714658474,3755175497,1672567837,1672570772,2935
10035,3516517348,3711076751,1672648055,1672648839,784
10745,3516429380,3713416106,1672534221,1672535953,1732
9866,3454924050,3276499910,1672552624,1672552974,350
11242,3270607273,3779468781,1672615677,1672617832,2155
11643,3639926564,3398483531,1672578181,1672579123,942
10435,3221126799,3317887374,1672597047,1672600508,3461
10455,3354877289,3703048107,1672701976,1672703383,1407
11594,3534459983,3360949039,1672556308,1672558795,2487
11395,3501004005,3462985379,1672702903,1672705518,2615
10465,3405200303,3509360869,1672539592,1672540304,712
10214,3517377614,3452175941,1672604269,1672604708,439
10582,3520273299,3755989680,1672686367,1672689439,3072
11267,3505697295,3231227362,1672582892,1672585340,2448
11583,3777263928,3776193847,1672640238,1672643107,2869
10172,3491948594,3413799143,1672699932,1672703502,3570
11571,3834980281,3770595035,1672701891,1672703239,1348
10954,3533113740,3899205452,1672542934,1672544071,1137
11665,3757523596,3755411110,1672641336,1672641820,484
9810,3736036532,3622729771,1672607982,1672608478,496
9984,3501115299,3426207439,1672576514,1672577725,1211
11390,3792432763,3770273966,1672635114,1672637213,2099
10469,3757378286,3471555057,1672685072,1672685629,557
10120,3318590083,3912625932,1672601889,1672601981,92
10059,3770941125,3209925780,1672568597,1672570437,1840
11636,3247845642,3303432071,1672629920,1672630110,190
10958,3516517348,3511645260,1672647635,1672647742,107
10613,3511640720,3513143959,1672613909,1672615146,1237
11726,3243763209,3249771731,1672668688,1672669110,422
10668,3533037906,3336225953,1672583917,1672584361,444
11437,3778706119,3510836047,1672535738,1672537697,1959
10609,3512555384,3778182724,1672665386,1672667190,1804
10481,3384601925,3791289855,1672674304,1672675214,910
10427,3388923880,3302929858,1672651240,1672652336,1096
10144,3511245705,3340897079,1672589780,1672590943,1163
10591,3430296808,3512625661,1672600395,1672602109,1714
10512,3756525103,3976400190,1672539673,1672540868,1195
10110,3760997159,3311177439,1672611103,1672612625,1522
11524,3438470128,3200320674,1672678700,1672681359,2659
10216,3714294005,3777387533,1672650854,1672651836,982
9843,3888409038,3316117186,1672669215,1672670236,1021
11145,3358675021,3517113478,1672532061,1672534816,2755
10929,3420664407,3760443176,1672627104,1672628024,920
10107,3534537581,3773475506,1672555564,1672557538,1974
11786,3382670400,3757623259,1672564236,1672565197,961
10839,3713031958,3774447975,1672558191,1672561031,2840
11140,3905955166,3279726491,1672590917,1672593764,2847
9886,3770564547,3683514731,1672617496,1672620469,2973
11300,3311200541,3885422379,1672620979,1672622243,1264
11405,3408408584,3284374600,1672663511,1672663788,277
11405,3714453773,3505624416,1672625424,1672628355,2931
11504,3512495325,3716183063,1672590381,1672591719,1338
11067,3311449914,3778741325,1672692190,1672693274,1084
11232,3905934770,3201419050,1672666824,1672667748,924
9985,3976400190,3716526314,1672677984,1672681488,3504
10042,3714787207,3338195686,1672564546,1672566924,2378
11251,3510680251,3480259863,1672557764,1672561028,3264
10781,3888903181,3505155858,1672544100,1672544850,750
10946,3484490325,3703336988,1672531872,1672535016,3144
9922,3808849597,3703697059,1672666834,1672670028,3194
10264,3394986304,3770630937,1672538085,1672539401,1316
10635,3367299721,3888057649,1672681025,1672681540,515
11009,3711804184,3370245766,1672607066,1672609632,2566
10565,3733423371,3884394685,1672612142,1672613602,1460
11265,3497138014,3757050615,1672701715,1672703988,2273
11635,3793569914,3511003541,1672610497,1672612446,1949
11482,3773738817,3444598583,1672621395,1672623587,2192
10033,3510143850,3975799349,1672666171,1672666430,259
11039,3772251279,3512753567,1672579122,1672582100,2978
11683,3793274957,3238997746,1672592613,1672594574,1961
10738,3904846341,3703849264,1672660656,1672660983,327
10729,3505010941,3701971784,1672550171,1672552699,2528
11772,3518408734,3760979523,1672577142,1672579385,2243
11492,3713728777,3774238066,1672563912,1672567129,3217
11732,3774782065,3793699467,1672647089,1672649205,2116
10427,3519494023,3779818784,1672659770,1672662660,2890
10207,3715680249,3505653701,1672591899,1672593577,1678
10367,3701065296,3793274846,1672558372,1672561478,3106
11429,3552261072,3342252701,1672585137,1672586714,1577
10338,3509614126,3429315500,1672557573,1672560831,3258
9860,3366566029,3226761201,1672541564,1672543323,1759
10246,3791236983,3422460919,1672550137,1672551907,1770
10497,3773878451,3512337054,1672658946,1672659149,203
11360,3911376818,3822634862,1672555965,1672558132,2167
10882,3669427589,3776732532,1672658497,1672659219,722
11087,3510826414,3902300755,1672630802,1672631674,872
11144,3733836732,3520160414,1672540285,1672540654,369
10404,3713159131,3710807030,1672574917,1672577649,2732
11201,3713767153,3703502114,1672643394,1672644690,1296
10961,3505684690,3701459978,1672543999,1672544870,871
10518,3209075485,3353194923,1672606517,1672608351,1834
10250,3711854614,3811351746,1672552286,1672554691,2405
11356,3471585513,3732128078,1672608045,1672609506,1461
10633,3716233100,3778842400,1672603497,1672605726,2229
11473,3371238318,3387388336,1672608216,1672609539,1323
11570,3713767153,3907390925,1672607319,1672608736,1417
10999,3445172440,3298831109,1672558139,1672559120,981
10118,3369270860,3714116241,1672560828,1672563878,3050
10377,3278251248,3716195780,1672579224,1672581573,2349
10407,3732312480,3534374523,1672535991,1672537024,1033
11469,3487395357,3714264759,1672620869,1672623346,2477
10298,3739618347,3885339157,1672542254,1672545168,2914
10837,3756717136,3880637958,1672701295,1672701774,479
10025,3312651192,3505624416,1672703916,1672706954,3038
9871,3772751765,3609644043,1672696149,1672699246,3097
11236,3423800775,3828354855,1672585936,1672587691,1755
9910,3358530225,3354877289,1672615505,1672616005,500
11168,3302929858,3917811545,1672606154,1672609333,3179
11462,3770924034,3736885568,1672533195,1672536413,3218
11544,3381244346,3555954355,1672689796,1672692144,2348
11449,3333477908,3793814153,1672592296,1672595138,2842
10247,3511608609,3774436159,1672639811,1672642134,2323
10144,3519463038,3511069449,1672563283,1672563698,415
10760,3908550561,3915460293,1672564654,1672565644,990
11168,3462153833,3668681400,1672645147,1672645328,181
9945,3278805844,3505011956,1672633895,1672634795,900
11645,3636857871,3512697456,1672600577,1672600688,111
10329,3777200549,3760267158,1672564502,1672564967,465
11754,3774946684,3474074188,1672575383,1672576769,1386
10421,3510824484,3533976217,1672538817,1672540274,1457
10989,3669475165,3601063076,1672671716,1672673695,1979
10870,3520160414,3756363182,1672584301,1672585641,1340
11301,3735152111,3330238204,1672561770,1672562265,495
11205,3242149533,3492350318,1672655246,1672656231,985
10510,3515100211,3710819760,1672590949,1672593367,2418
9807,3520779124,3907039612,1672639396,1672642607,3211
11061,3701978422,3756948477,1672691866,1672692565,699
11687,3714658474,3622654885,1672639771,1672640117,346
10232,3385006834,3823600319,1672623847,1672624751,904
11278,3818570577,3509562377,1672598654,1672601098,2444
10635,3275975921,3783067048,1672650205,1672651994,1789
10012,3757994002,3757378286,1672556329,1672558756,2427
10605,3633949990,3305656670,1672604058,1672604589,531
10367,3939851140,3514306458,1672561003,1672563345,2342
10907,3515607283,3733953055,1672639696,1672639809,113
11331,3516731917,3499142934,1672580330,1672583329,2999
11011,3511671476,3783408469,1672674258,1672675235,977
10644,3703104365,3899970524,1672602364,1672603743,1379
11264,3369938668,3857344874,1672652574,1672654005,1431
11115,3770972037,3450503086,1672586348,1672586517,169
10713,3512700007,3776617627,1672656031,1672658349,2318
10549,3770941125,3774627091,1672552531,1672554724,2193
9963,3620836520,3519046342,1672701213,1672702662,1449
9846,3374348845,3779282072,1672566919,1672570067,3148
11621,3710149975,3367299721,1672541048,1672543681,2633
11156,3389069291,3505121295,1672565513,1672567938,2425
10019,3494157939,3793978936,1672579445,1672581095,1650
10205,3516321814,3505769529,1672640732,1672643434,2702
11201,3976742903,3501583486,1672539531,1672542418,2887
10406,3513740840,3760525465,1672689825,1672691009,1184
11504,3533030343,3387621912,1672683232,1672685730,2498
9933,3505901826,3520558137,1672661330,1672663345,2015
11594,3783947742,3925208102,1672584543,1672587324,2781
10961,3793978936,3443580855,1672664224,1672666896,2672
10900,3772234939,3495637721,1672594336,1672594653,317
11434,3318056480,3342368576,1672622554,1672624521,1967
9794,3736621212,3513894659,1672695178,1672698753,3575
11785,3505521491,3534081527,1672606560,1672607381,821
10818,3301449986,3774539067,1672569969,1672572165,2196
9923,3777387533,3311805161,1672575245,1672577537,2292
11001,3500079479,3505248368,1672552786,1672556033,3247
11588,3637566026,3225371682,1672612147,1672615534,3387
10964,3361635547,3638071975,1672538172,1672539847,1675
11111,3302348002,3793874490,1672680913,1672683186,2273
10425,3425545115,3505449070,1672610056,1672610297,241
10613,3601063076,3757592622,1672666681,1672668305,1624
11050,3501205057,3424476995,1672661141,1672663073,1932
10608,3452090950,3500019810,1672609501,1672610228,727
11307,3413511621,3534506090,1672679490,1672681607,2117
10246,3923910914,3854202447,1672694213,1672694492,279
11617,3625779003,3639503148,1672591429,1672592767,1338
11528,3738873928,3852014884,1672700468,1672703097,2629
10558,3716423829,3362385373,1672691658,1672692352,694
9824,3755107521,3512697456,1672592479,1672595930,3451
11750,3792432094,3515100211,1672544146,1672545682,1536
10563,3777499535,3474074188,1672549655,1672551516,1861
9967,3802101760,3776561263,1672531695,1672532152,457
10466,3822634862,3976400190,1672689305,1672690649,1344
10496,3916656185,3855674398,1672561277,1672562174,897
11390,3760346746,3780213684,1672649935,1672650929,994
11441,3621591266,3205948776,1672582839,1672583734,895
11518,3701359045,3630462406,1672681780,1672683150,1370
11455,3736036532,3533209168,1672640793,1672641483,690
10334,3445558740,3804707712,1672573414,1672577000,3586
11142,3500011591,3732467455,1672629697,1672632374,2677
11310,3715737742,3916924978,1672625077,1672628589,3512
10101,3817076003,3710695372,1672572170,1672573185,1015
10652,3373135211,3777387533,1672550189,1672550635,446
11385,3893043842,3779930476,1672673739,1672673958,219
11335,3974264211,3514013999,1672546611,1672548067,1456
11530,3792512768,3515100211,1672601117,1672604428,3311
10831,3519341916,3774221318,1672638671,1672641399,2728
9996,3291936679,3731905251,1672556673,1672560201,3528
10797,3710852576,3757855416,1672654438,1672657755,3317
11441,3461877104,3793689267,1672644739,1672647425,2686
11467,3533325993,3482519872,1672608639,1672610616,1977
10189,3920606331,3779503296,1672649978,1672652132,2154
10914,3732128078,3519908593,1672629948,1672630301,353
11582,3925823748,3901169230,1672592580,1672595446,2866
9952,3516103646,3711770773,1672531509,1672533923,2414
11621,3783594729,3711029952,1672594532,1672596550,2018
10150,3517617472,3881579907,1672561834,1672565174,3340
9866,3421956717,3519260216,1672676889,1672678002,1113
11037,3343193067,3513111053,1672580597,1672584145,3548
10450,3893043842,3362385373,1672545701,1672546350,649
10025,3715602742,3711076751,1672682790,1672685396,2606
10297,3715680249,3482786946,1672620214,1672620939,725
10120,3478455812,3558567160,1672635278,1672635821,543
10799,3371759044,3611832288,1672535573,1672536281,708
10610,3834456158,3517448452,1672557252,1672559493,2241
10278,3927181190,3713224038,1672585415,1672587770,2355
10747,3452090950,3756168814,1672571839,1672573147,1308
10417,3452175941,3620836520,1672567483,1672570184,2701
10554,3347172556,3852310652,1672671612,1672672971,1359
9805,3515655024,3770275898,1672640594,1672642135,1541
11457,3342368576,3307535495,1672626547,1672628976,2429
11614,3779454060,3881579907,1672645778,1672646134,356
9976,3511794841,3519341916,1672536581,1672538921,2340
11549,3713807459,3773826624,1672596655,1672599877,3222
11383,3453464785,3509167758,1672649082,1672651251,2169
10392,3228575883,3367121615,1672678649,1672678927,278
10986,3755729826,3701956841,1672648544,1672651704,3160
11622,3509508477,3777878462,1672682706,1672684486,1780
11160,3201656220,3730571757,1672570221,1672571221,1000
11716,3359418136,3519228207,1672540187,1672542873,2686
10325,3440991826,3381244346,1672641019,1672643982,2963
10150,3481365330,3627431396,1672651576,1672652690,1114
11284,3481019442,3355880028,1672697687,1672698433,746
11074,3273242177,3395615598,1672653134,1672653403,269
10024,3435652260,3614112171,1672656867,1672659941,3074
10506,3839308659,3757199889,1672687038,1672688701,1663
11661,3714690161,3517960740,1672564440,1672567769,3329
10693,3817478012,3380357490,1672557173,1672558489,1316
11453,3777204977,3500591274,1672594705,1672597211,2506
10203,3334824744,3773017746,1672657507,1672659210,1703
10076,3361635547,3518205307,1672563877,1672564720,843
10125,3227647190,3711722554,1672588893,1672591815,2922
10342,3366501813,3505173665,1672568168,1672571475,3307
10651,3511206717,3792578118,1672631070,1672632932,1862
10985,3710060386,3791584994,1672630665,1672632965,2300
11618,3505593034,3510373076,1672607325,1672609241,1916
11087,3246381831,3512638952,1672598112,1672600949,2837
11754,3288791629,3427049290,1672553011,1672555152,2141
9889,3730935770,3441944896,1672653772,1672656189,2417
10332,3514761434,3760966645,1672631663,1672631840,177
10521,3756843139,3313824913,1672607052,1672607153,101
11539,3818461836,3301332095,1672561958,1672565540,3582
9862,3511069449,3310702648,1672533488,1672535014,1526
11055,3805831563,3776561263,1672562636,1672562847,211
10654,3398075553,3772343750,1672650638,1672652081,1443
10849,3318220119,3319862687,1672700572,1672701708,1136
10445,3462153833,3417223898,1672625287,1672627203,1916
10975,3200320674,3755369666,1672627376,1672628608,1232
11596,3783060739,3406132280,1672641506,1672642473,967
10506,3757639274,3619796619,1672540889,1672544349,3460
11699,3505482210,3280208630,1672687684,1672688331,647
9953,3791072829,3512417028,1672564851,1672568011,3160
10303,3299847117,3444680955,1672659312,1672661435,2123
11202,3921138062,3483078667,1672546599,1672549514,2915
10588,3730459093,3534869444,1672561225,1672561925,700
10157,3977209952,3914740937,1672592749,1672594015,1266
10382,3681737865,3485898181,1672693320,1672693592,272
10707,3510882576,3853182912,1672613150,1672615719,2569
10093,3389367628,3228575883,1672628737,1672631143,2406
10106,3756763585,3279102372,1672626156,1672629124,2968
10444,3513545735,3342368576,1672613258,1672615556,2298
10370,3772055279,3973582279,1672574379,1672576155,1776
11614,3293579860,3710223875,1672671550,1672672583,1033
11665,3791644831,3686860179,1672677343,1672678131,788
10381,3774448657,3813986705,1672588159,1672589419,1260
9961,3703818358,3394357241,1672622797,1672625485,2688
11424,3516321814,3774238066,1672692131,1672695615,3484
10014,3701534043,3711836873,1672628965,1672632374,3409
11542,3208519320,3447202943,1672613404,1672614768,1364
10925,3716371766,3500019810,1672570407,1672571065,658
10642,3713285095,3354877289,1672670663,1672673174,2511
11194,3933731871,3398483531,1672582637,1672583462,825
10063,3294952405,3756850160,1672550257,1672551193,936
11755,3205687719,3501004005,1672628693,1672630757,2064
11563,3472774606,3306491253,1672648640,1672649710,1070
11657,3513186622,3442096275,1672589020,1672590341,1321
9948,3713285095,3715282492,1672683584,1672685188,1604
10548,3445406685,3974400577,1672556829,1672557522,693
11142,3662522808,3385481989,1672606981,1672609074,2093
11132,3755823805,3713606829,1672602694,1672605845,3151
11471,3710173412,3755129708,1672643866,1672646289,2423
10142,3443004958,3772980989,1672604519,1672605587,1068
10601,3714179543,3977360666,1672544112,1672547486,3374
9898,3518759318,3520160414,1672675056,1672677121,2065
10798,3755342153,3399430522,1672700154,1672703556,3402
10918,3623894390,3288675710,1672561324,1672563768,2444
10122,3755865626,3420854927,1672668524,1672670297,1773
10580,3509377714,3519000878,1672670572,1672671488,916
11766,3317989975,3779609338,1672691827,1672693794,1967
10703,3516378356,3239990061,1672575524,1672578276,2752
11460,3505994703,3736621212,1672635740,1672637423,1683
11660,3715858201,3977157565,1672682330,1672684408,2078
11771,3500671218,3756113624,1672696983,1672697136,153
11141,3518088154,3905955166,1672636907,1672638391,1484
10078,3888903181,3791825536,1672619464,1672619586,122
10727,3511341866,3334461288,1672560457,1672561138,681
10606,3515681585,3730169449,1672599486,1672600251,765
10803,3378747834,3689420679,1672599188,1672600199,1011
10595,3783368855,3701663839,1672569877,1672573006,3129
11325,3442096275,3353326305,1672563276,1672565609,2333
10362,3462645981,3711599043,1672564304,1672565246,942
11179,3494748808,3505624416,1672660049,1672662217,2168
10854,3202787155,3512965991,1672657361,1672657888,527
10162,3605905645,3710271021,1672543969,1672544939,970
9986,3511969443,3919349138,1672650956,1672652188,1232
11030,3275975921,3393376416,1672612805,1672613076,271
9923,3738526914,3359472956,1672599285,1672599942,657
11767,3510291656,3638035545,1672641695,1672643427,1732
9889,3607583720,3715897627,1672669141,1672672509,3368
10643,3933872044,3931164237,1672604311,1672606788,2477
11548,3979366845,3669283586,1672697419,1672699896,2477
9795,3241682278,3287821258,1672577601,1672578622,1021
10484,3801379377,3713807753,1672571242,1672574029,2787
11072,3636605690,3516429380,1672621385,1672623481,2096
10600,3518408734,3773953689,1672601212,1672601868,656
9884,3710271021,3755229631,1672676876,1672678427,1551
10064,3249614888,3238997746,1672650626,1672653081,2455
11792,3514107131,3450735824,1672553151,1672553910,759
10387,3304227085,3516257130,1672699032,1672699843,811
9797,3701218904,3311739926,1672563872,1672565955,2083
9921,3501843187,3511640720,1672541079,1672542593,1514
10285,3520824937,3683562111,1672700938,1672703618,2680
11548,3813085701,3515715968,1672600186,1672600636,450
11078,3463883997,3791332226,1672675951,1672678101,2150
10404,3279851026,3362368123,1672632089,1672632869,780
10788,3513432588,3276393542,1672588169,1672590543,2374
11727,3475560058,3770564547,1672675812,1672677657,1845
11705,3774304163,3755670258,1672568055,1672569283,1228
10695,3421674406,3776193847,1672691376,1672694570,3194
10608,3299845453,3207586072,1672624852,1672626580,1728
10903,3293673220,3429409539,1672647364,1672649945,2581
11710,3793814153,3793860209,1672656175,1672658645,2470
10026,3881579907,3779818784,1672640551,1672641736,1185
11140,3779174993,3511864772,1672566446,1672567578,1132
11065,3902682060,3856129522,1672638732,1672640078,1346
11195,3512700007,3519712497,1672540811,1672540929,118
10347,3235470567,3200785194,1672652563,1672654705,2142
11627,3978254945,3534984243,1672612386,1672614374,1988
11116,3779818784,3445733121,1672601931,1672604672,2741
9813,3534426696,3513186578,1672570006,1672573474,3468
11265,3737685967,3427741923,1672615257,1672615593,336
10201,3317190427,3713224038,1672619037,1672619689,652
10279,3239990061,3501027795,1672674105,1672677265,3160
10976,3736885568,3500889287,1672551149,1672552177,1028
10150,3511908639,3791758175,1672675681,1672678214,2533
10795,3701725839,3437286595,1672665856,1672666848,992
11368,3776581518,3832312129,1672674462,1672677155,2693
11648,3330799389,3805926853,1672568853,1672570128,1275
9841,3311989687,3505867821,1672603937,1672605668,1731
11569,3710865678,3246062632,1672625966,1672627043,1077
10959,3334482021,3755670258,1672581631,1672585135,3504
11034,3515726910,3777499535,1672615223,1672616282,1059
11439,3361865467,3884192843,1672589471,1672591404,1933
10308,3772867078,3687445224,1672548749,1672550342,1593
10927,3970265139,3512251592,1672542019,1672544132,2113
9935,3305727497,3533627473,1672584513,1672587827,3314
11463,3361635547,3559619861,1672627880,1672629265,1385
10047,3777498160,3511580693,1672584144,1672587222,3078
11283,3714268380,3814770073,1672593568,1672594116,548
10932,3487622510,3391093411,1672666904,1672667818,914
11349,3245755569,3882580580,1672652648,1672655475,2827
10968,3793996996,3533830748,1672539698,1672541920,2222
9965,3311569360,3610806770,1672587999,1672590414,2415
10438,3760443176,3360309868,1672668613,1672671357,2744
10431,3505007498,3442073613,1672564263,1672567148,2885
10492,3512480125,3715587520,1672582512,1672583444,932
10785,3854957153,3774792696,1672563912,1672567442,3530
11633,3780500764,3755192104,1672547063,1672549257,2194
11375,3393909269,3661543201,1672688591,1672689974,1383
11615,3757924067,3479207976,1672692140,1672694025,1885
11393,3512645289,3510178791,1672694606,1672694695,89
10841,3733411026,3347205332,1672702920,1672704047,1127
10816,3777655401,3621591266,1672586750,1672589124,2374
10844,3714838100,3637105495,1672573869,1672574008,139
9887,3716733618,3777686966,1672562053,1672563095,1042
10565,3496407500,3776455762,1672628553,1672630237,1684
10151,3780500331,3932919664,1672558223,1672558336,113
10756,3715261950,3425260097,1672668614,1672669386,772
10215,3512802259,3313824913,1672637418,1672638104,686
11126,3770273966,3807584987,1672543579,1672543940,361
11235,3899294071,3779212271,1672607852,1672610642,2790
10674,3514926921,3770966950,1672648499,1672650521,2022
10002,3776183353,3977157565,1672645290,1672646653,1363
10342,3927675706,3714074120,1672622511,1672622656,145
11501,3533822490,3533265491,1672695339,1672695587,248
10900,3701887470,3445406685,1672640711,1672642175,1464
11367,3446810761,3792440162,1672679165,1672679365,200
11061,3437023385,3713159131,1672628560,1672629134,574
10469,3924583142,3614112171,1672569044,1672570234,1190
11058,3904045870,3512546783,1672620270,1672621076,806
9997,3755273361,3776867553,1672556046,1672559155,3109
10291,3716647407,3309415277,1672662218,1672664972,2754
10130,3355903597,3780148144,1672682093,1672684041,1948
11182,3511476353,3701956841,1672686039,1672688902,2863
10866,3714883746,3229734741,1672649985,1672651904,1919
10015,3444598583,3518157683,1672686023,1672689562,3539
11359,3732467455,3368951504,1672611446,1672613212,1766
11103,3417223898,3360783381,1672633129,1672634114,985
9979,3519951586,3760382349,1672663853,1672665757,1904
10237,3777552831,3249771731,1672543975,1672547168,3193
10840,3278251248,3509317776,1672632481,1672633740,1259
11586,3206241691,3715790104,1672695994,1672697118,1124
11597,3387700451,3772112976,1672656174,1672658391,2217
11750,3918126468,3387706541,1672557454,1672560438,2984
11573,3505140123,3516932899,1672563288,1672564436,1148
9883,3669427589,3341129425,1672703095,1672705334,2239
10158,3484490325,3514576083,1672579908,1672582060,2152
11374,3316537706,3501843187,1672565435,1672568797,3362
10825,3303552616,3281148858,1672700242,1672703794,3552
10614,3701041860,3760385591,1672575177,1672577998,2821
10757,3936851114,3438204844,1672542246,1672543791,1545
10437,3226761201,3400545490,1672669045,1672669784,739
10806,3760679372,3510209505,1672607121,1672608472,1351
11002,3249380931,3520763492,1672609555,1672611964,2409
10071,3375905193,3734957248,1672642165,1672643835,1670
11734,3517083465,3603682643,1672616283,1672618550,2267
11544,3515100211,3509828883,1672653047,1672653169,122
10023,3774325486,3783730769,1672671812,1672672643,831
11322,3610806770,3391854325,1672632577,1672632973,396
10041,3475090917,3510244209,1672624384,1672625672,1288
10238,3755769254,3773434690,1672685253,1672688031,2778
10731,3783021859,3971051020,1672618342,1672621409,3067
10574,3776053084,3783238023,1672642535,1672644895,2360
11033,3701519251,3519947298,1672564073,1672566711,2638
11764,3516026189,3770530739,1672635598,1672638010,2412
10299,3406492167,3850993995,1672594497,1672597765,3268
10676,3552444228,3512495325,1672588085,1672590508,2423
10366,3624365837,3773714494,1672640144,1672643457,3313
10261,3774238066,3272581469,1672606268,1672608774,2506
10613,3519351747,3682241594,1672544582,1672547278,2696
10742,3534988162,3474350534,1672613769,1672614664,895
11673,3511466117,3469663062,1672588106,1672591364,3258
11264,3772968080,3612705426,1672580988,1672581971,983
11437,3783373085,3202740652,1672644801,1672645751,950
10694,3361926328,3715923089,1672618333,1672618991,658
11281,3774447975,3271389160,1672699613,1672700739,1126
11749,3837378340,3807646028,1672646402,1672647140,738
10120,3779609338,3454151554,1672700272,1672701126,854
10222,3801379377,3735679000,1672672612,1672673877,1265
9851,3811354125,3931164237,1672613980,1672617019,3039
11549,3791688526,3500640854,1672596921,1672600126,3205
9870,3450735824,3408828584,1672579633,1672580158,525
10327,3732846295,3853182912,1672646627,1672647643,1016
11412,3602680347,3304447950,1672598403,1672600868,2465
9935,3856147380,3302929858,1672642316,1672644731,2415
11415,3736010012,3499343927,1672603789,1672606027,2238
9860,3245755569,3304672737,1672533870,1672535231,1361
11305,3284407073,3919494952,1672697668,1672701243,3575
10173,3514455363,3780467276,1672675275,1672678098,2823
10217,3619705594,3513293711,1672533322,1672534151,829
11740,3755769731,3501901313,1672673786,1672675380,1594
10591,3975796415,3757497708,1672545110,1672545652,542
11015,3477248170,3534770827,1672681294,1672682701,1407
10052,3899156705,3367262509,1672691670,1672692892,1222
11226,3783826338,3773378103,1672654333,1672655375,1042
9963,3447696555,3235074007,1672533046,1672534668,1622
11095,3463892928,3703415246,1672683186,1672683268,82
11729,3512768285,3238997746,1672604144,1672607732,3588
10661,3904045870,3500922040,1672654340,1672657348,3008
11246,3811354125,3500909455,1672685625,1672687983,2358
10305,3716209499,3243056734,1672592468,1672594768,2300
11584,3509828883,3511412229,1672573851,1672576805,2954
11538,3885422379,3903994989,1672586658,1672589628,2970
10911,3817076003,3505129296,1672609523,1672610474,951
11506,3422314045,3511412229,1672662676,1672666157,3481
10744,3773770134,3811503860,1672612535,1672613269,734
10186,3495427619,3793719515,1672685387,1672685599,212
10668,3516026189,3406169279,1672614855,1672617216,2361
10862,3510894809,3609644043,1672659086,1672660223,1137
11211,3770941125,3770476738,1672646628,1672648825,2197
11784,3792987243,3791434207,1672675677,1672677844,2167
10479,3633949990,3776968640,1672641966,1672645410,3444
10134,3427527462,3438028077,1672590498,1672591569,1071
10879,3533427742,3907225070,1672564949,1672568384,3435
10686,3288920399,3515548696,1672600520,1672601655,1135
11764,3246381831,3780900318,1672601440,1672602397,957
11284,3792824886,3772695548,1672686938,1672689862,2924
10227,3832002939,3444397804,1672615318,1672618235,2917
11191,3855440101,3804075198,1672666110,1672667468,1358
11224,3439651226,3228477490,1672615318,1672616920,1602
11161,3737946004,3738734246,1672588325,1672590533,2208
9820,3773736248,3509626590,1672645236,1672645569,333
10634,3291617477,3938129916,1672631612,1672633172,1560
10926,3514353133,3756761603,1672671315,1672673971,2656
11547,3516429380,3239779992,1672550910,1672552993,2083
10341,3515715968,3358982831,1672615830,1672616462,632
10384,3512417724,3804707712,1672622058,1672622479,421
11507,3368176107,3887069914,1672693692,1672697075,3383
11202,3391093411,3484483775,1672604084,1672606349,2265
10514,3441336851,3344778261,1672531894,1672535247,3353
11089,3351153781,3505624416,1672643527,1672643874,347
9822,3776791436,3454343398,1672619181,1672619261,80
10113,3304028109,3854229296,1672558307,1672559710,1403
11664,3808849597,3971996397,1672584305,1672585966,1661
10839,3778706119,3737571883,1672600406,1672602905,2499
11003,3910020031,3757497708,1672684512,1672686488,1976
10914,3203457161,3424425746,1672566726,1672570091,3365
10668,3773134128,3510547682,1672537437,1672540159,2722
11714,3710680073,3855629383,1672664045,1672666335,2290
10830,3515804844,3779393140,1672658665,1672659738,1073
11192,3229615214,3505472087,1672678415,1672680488,2073
10100,3929355087,3713547793,1672646965,1672647530,565
11026,3779503296,3493679801,1672614423,1672617939,3516
10035,3488887919,3206241691,1672604415,1672607971,3556
10041,3714142299,3505887814,1672679821,1672683076,3255
9909,3517960740,3518157683,1672589036,1672589976,940
10555,3934564437,3388537708,1672572553,1672574623,2070
9929,3208962614,3516167000,1672626491,1672629364,2873
11738,3303552616,3441737317,1672589035,1672589564,529
11224,3730414796,3415032547,1672589730,1672592410,2680
10372,3793948300,3447267291,1672696038,1672696493,455
10583,3907039612,3505887814,1672616125,1672616333,208
11711,3344710271,3333505404,1672589177,1672591308,2131
11091,3716595760,3509445318,1672652617,1672656117,3500
10375,3730600658,3792824886,1672694533,1672696310,1777
10994,3857590978,3516340010,1672594096,1672595431,1335
11501,3703896751,3779212271,1672571511,1672574325,2814
10678,3316117186,3553321027,1672690770,1672691237,467
11141,3318220119,3509167758,1672637263,1672639996,2733
11522,3472774606,3515838621,1672665949,1672668501,2552
9839,3517358336,3278071998,1672558893,1672560393,1500
10936,3755170743,3346755179,1672650538,1672653915,3377
10619,3246062632,3756675909,1672573195,1672576622,3427
10223,3364067937,3613828705,1672553363,1672555010,1647
11585,3756493561,3429409539,1672539287,1672541938,2651
10363,3777552831,3398021818,1672566551,1672566824,273
11627,3278629965,3408982612,1672607440,1672609702,2262
11682,3476958001,3668369938,1672621033,1672624113,3080
11545,3510373076,3780740477,1672579303,1672582881,3578
10001,3902300755,3533077580,1672644268,1672645294,1026
10640,3791368349,3358434853,1672638917,1672642124,3207
10722,3755823805,3501225887,1672626646,1672629648,3002
11591,3278805844,3730052916,1672661034,1672662379,1345
11625,3472272792,3316121649,1672583862,1672586594,2732
11419,3760416450,3791664049,1672692923,1672694356,1433
10422,3902300755,3311626308,1672577026,1672579371,2345
11257,3770273459,3446575109,1672534431,1672535146,715
10932,3513186578,3701291994,1672536066,1672538366,2300
9810,3371497614,3515838621,1672574666,1672576809,2143
10168,3342495377,3770846374,1672605108,1672608274,3166
11783,3510209505,3511199555,1672630882,1672634050,3168
10276,3533728729,3422314045,1672683043,1672683837,794
9861,3434581257,3369558911,1672642195,1672645381,3186
11654,3780238637,3834456158,1672547509,1672550476,2967
11237,3399173821,3347520239,1672577372,1672580105,2733
10239,3783313202,3920155862,1672561625,1672563369,1744
10588,3497732613,3739297004,1672676523,1672677805,1282
10531,3399430522,3505351253,1672658131,1672658974,843
11402,3772708314,3391854325,1672606239,1672609264,3025
11767,3756525103,3703277359,1672686102,1672688049,1947
10520,3733123020,3668202976,1672663676,1672664846,1170
11277,3500595432,3918126468,1672545317,1672547155,1838
11552,3667950469,3791289855,1672635690,1672639234,3544
10350,3429315500,3406029706,1672567605,1672570204,2599
11034,3757549235,3505836431,1672653899,1672655202,1303
10849,3520553959,3856975623,1672570201,1672573005,2804
11468,3760997159,3919345990,1672571437,1672572409,972
10679,3834980281,3519319233,1672592075,1672592334,259
11619,3513859809,3316537706,1672599240,1672599513,273
10215,3760776967,3313579674,1672659101,1672662466,3365
10587,3406937294,3937854073,1672597916,1672600290,2374
11411,3381244346,3627377299,1672670111,1672673649,3538
11504,3206544535,3770709417,1672598589,1672600789,2200
11165,3332840671,3710008760,1672601650,1672602369,719
9870,3715204544,3711196962,1672651248,1672652363,1115
11063,3341311972,3773770134,1672536555,1672538914,2359
11382,3780173788,3713224986,1672677621,1672679892,2271
11424,3791758175,3777074709,1672573050,1672574220,1170
10895,3780466967,3609997804,1672690163,1672692337,2174
10320,3812677669,3500011591,1672619510,1672620022,512
11767,3715261950,3710397477,1672538211,1672541667,3456
10787,3756991235,3519703964,1672669006,1672672185,3179
10556,3715790104,3387989658,1672594041,1672594281,240
10231,3308744016,3395610742,1672608878,1672611690,2812
10523,3517617472,3491390365,1672637551,1672637794,243
11247,3520926977,3311449914,1672573091,1672575817,2726
11750,3711810268,3715566511,1672610680,1672611399,719
10657,3390368796,3793920312,1672646055,1672646447,392
11230,3342031426,3505414878,1672554119,1672556499,2380
11328,3510775046,3500104976,1672686252,1672689750,3498
10584,3510111365,3510209505,1672597081,1672597713,632
10697,3713858538,3367242388,1672592264,1672595558,3294
11313,3281970147,3621960662,1672554081,1672557637,3556
10892,3884394685,3439283360,1672643767,1672646374,2607
10838,3898989233,3714067998,1672592081,1672595199,3118
10742,3330799389,3291153514,1672575407,1672578030,2623
11441,3770391782,3971280379,1672556006,1672558827,2821
10848,3826542169,3772262649,1672598965,1672600296,1331
11094,3519341916,3435801763,1672640829,1672643720,2891
10578,3516359146,3715897627,1672594353,1672594709,356
10469,3311989687,3680939042,1672581766,1672583439,1673
11739,3716197140,3517992521,1672593465,1672596584,3119
11181,3770764940,3378729459,1672654695,1672657275,2580
10543,3733915784,3832333115,1672604504,1672605399,895
10394,3277634944,3469663062,1672652923,1672653087,164
10088,3732440502,3792063616,1672629888,1672630826,938
10213,3435159896,3618672178,1672552668,1672555139,2471
10214,3607583720,3821103640,1672703874,1672705874,2000
11278,3517551721,3236360179,1672543001,1672543122,121
11486,3487231844,3533325993,1672702874,1672703505,631
11415,3711938229,3482172065,1672555070,1672557991,2921
11078,3713878219,3450735824,1672616659,1672618533,1874
10261,3734957248,3519162582,1672616586,1672619864,3278
10160,3687024828,3249614888,1672595052,1672597628,2576
11417,3927181190,3714903253,1672689291,1672690497,1206
10281,3780576351,3612705426,1672549172,1672550350,1178
9953,3776304080,3361789225,1672591883,1672592148,265
10514,3780900318,3822786416,1672609631,1672610786,1155
9812,3716492409,3935333166,1672582256,1672584404,2148
11279,3398862999,3203837944,1672609491,1672612905,3414
10230,3518947256,3518759318,1672550645,1672551795,1150
10984,3756493561,3500105301,1672616123,1672619034,2911
10268,3516486526,3500776597,1672689678,1672691790,2112
10510,3812277991,3703722212,1672694349,1672695373,1024
11488,3909504515,3295691964,1672566927,1672569327,2400
11171,3791617239,3512784888,1672534836,1672535969,1133
10422,3512625661,3514450836,1672667721,1672668516,795
10451,3934070285,3711844574,1672691853,1672692585,732
10330,3351837521,3800434325,1672557073,1672560319,3246
9891,3807486812,3338016147,1672641130,1672643334,2204
10455,3760854788,3311231911,1672646822,1672647864,1042
10260,3509370633,3447938130,1672542856,1672543557,701
9848,3515944817,3501612813,1672614868,1672616611,1743
11170,3515804844,3500104976,1672559147,1672560136,989
10842,3513850048,3439283360,1672696161,1672699022,2861
10541,3510218188,3398483531,1672531968,1672532803,835
11148,3757050615,3368339963,1672563607,1672565062,1455
9900,3287094447,3783879023,1672614496,1672615709,1213
11579,3683047199,3898592058,1672532381,1672533945,1564
11348,3716195780,3510916875,1672655408,1672657807,2399
10521,3927365255,3334482021,1672581053,1672582631,1578
11528,3435801763,3821103640,1672542918,1672546417,3499
10252,3364302157,3221736756,1672702695,1672702759,64
11496,3909822999,3792432763,1672641351,1672643609,2258
11167,3666022373,3757497708,1672549502,1672550986,1484
10276,3976400190,3273674596,1672664072,1672665165,1093
10986,3487779363,3505248368,1672686488,1672688715,2227
10088,3510919509,3340321384,1672662859,1672665184,2325
9875,3777992576,3512826895,1672622945,1672625202,2257
10431,3711518637,3917811545,1672579679,1672581975,2296
10721,3554317844,3514352989,1672636176,1672636728,552
10852,3378534521,3851737350,1672653105,1672655516,2411
10434,3515558215,3505449070,1672590625,1672594097,3472
10827,3710060386,3208519320,1672703376,1672705736,2360
9999,3716733618,3703476890,1672531962,1672533625,1663
10287,3440991826,3241567995,1672587402,1672590624,3222
11692,3773636983,3793375825,1672628633,1672630539,1906
11115,3559123082,3835982340,1672594804,1672595617,813
11559,3388774559,3515939841,1672650727,1672653129,2402
9885,3339649817,3939851140,1672566966,1672569707,2741
10549,3387706541,3668764192,1672627604,1672629999,2395
10330,3514673213,3287760230,1672576399,1672578532,2133
11122,3359418136,3239082508,1672602257,1672605298,3041
11129,3773738817,3772909073,1672626893,1672626986,93
10937,3512337054,3978643889,1672663746,1672666586,2840
11656,3791332226,3760537855,1672540496,1672541445,949
10820,3935256825,3850904092,1672675423,1672678569,3146
10038,3714838100,3777060250,1672645975,1672648794,2819
10413,3454343398,3520926977,1672643087,1672644020,933
11218,3505624416,3238056215,1672651898,1672652037,139
11037,3208594306,3603740088,1672572386,1672572758,372
10018,3755394177,3313298164,1672701816,1672703215,1399
11137,3780749789,3756675909,1672685940,1672686549,609
10373,3511476353,3517331746,1672594472,1672595353,881
11628,3516200419,3520145112,1672685098,1672687094,1996
10620,3518157683,3422959249,1672570453,1672572231,1778
9865,3732223664,3510209505,1672611453,1672614686,3233
10271,3772905073,3512871568,1672668765,1672669719,954
9808,3910190872,3515528947,1672581276,1672581339,63
9973,3227647190,3755769254,1672538960,1672541082,2122
10983,3500031401,3314363575,1672693394,1672694083,689
11453,3394959062,3779282072,1672621542,1672622513,971
10198,3466149998,3534278019,1672660941,1672661136,195
9977,3204473480,3908177413,1672674650,1672676397,1747
11062,3716095450,3500596577,1672684406,1672687840,3434
10823,3364683368,3510486220,1672533905,1672535700,1795
11611,3308759754,3772114731,1672531234,1672534149,2915
10236,3229570647,3792267993,1672618591,1672620141,1550
10119,3711810268,3511028193,1672569820,1672569988,168
11438,3273242177,3929002318,1672566858,1672569848,2990
10984,3395069149,3534984243,1672559845,1672560416,571
10766,3633294415,3773556853,1672609945,1672613044,3099
11256,3397783490,3513186622,1672633919,1672637292,3373
10482,3701655378,3777751979,1672623063,1672625410,2347
10472,3230612965,3514327931,1672668468,1672669446,978
11319,3770285500,3857847527,1672540032,1672543049,3017
10491,3474097405,3415032547,1672699118,1672699815,697
10638,3772250554,3621439107,1672637910,1672638430,520
10342,3606804618,3772943811,1672631336,1672633773,2437
11669,3346755179,3770424941,1672576563,1672578135,1572
10221,3439532406,3452024572,1672634646,1672636243,1597
10254,3772905073,3780921044,1672651860,1672652833,973
9811,3461743188,3970265139,1672692048,1672695594,3546
11325,3600978954,3773840321,1672634985,1672637510,2525
10571,3404187438,3829698950,1672595736,1672597874,2138
10788,3452389513,3428788958,1672545511,1672548107,2596
10133,3760541837,3711219767,1672585078,1672588466,3388
11518,3770391782,3445558740,1672640596,1672643021,2425
10633,3713476192,3501171785,1672667498,1672670473,2975
10814,3783067048,3281935691,1672653630,1672654986,1356
10115,3447253775,3760420315,1672683495,1672684804,1309
10004,3756493561,3367526113,1672700979,1672703895,2916
11166,3884933821,3925098136,1672668733,1672670568,1835
10368,3519463038,3660496328,1672591933,1672593274,1341
11319,3770019143,3850993995,1672623215,1672624095,880
9906,3755729826,3829412384,1672623807,1672625595,1788
10812,3685396470,3516969689,1672683455,1672686447,2992
10623,3780749789,3783942518,1672545025,1672546524,1499
10954,3519015940,3638035545,1672649374,1672649683,309
10597,3777641081,3361711720,1672654630,1672657036,2406
10521,3404375908,3880562532,1672596901,1672598702,1801
10597,3512490032,3791548838,1672656374,1672656653,279
11051,3622458047,3510486220,1672585561,1672587071,1510
10699,3760554453,3756536476,1672689068,1672692190,3122
11259,3459694275,3701359045,1672581980,1672582626,646
11287,3505392452,3287753579,1672623329,1672626563,3234
11344,3461743188,3423346297,1672600320,1672602404,2084
10860,3489340327,3800434325,1672648860,1672652427,3567
9893,3938398160,3343698137,1672593562,1672595958,2396
11712,3791581138,3791587717,1672534960,1672537183,2223
9980,3514107131,3820922991,1672679199,1672679437,238
9890,3772943811,3783408830,1672696515,1672696776,261
11360,3312959324,3311045951,1672657560,1672659004,1444
10311,3443102414,3510291656,1672568652,1672572216,3564
10313,3770564547,3516585063,1672542065,1672543246,1181
11218,3428198021,3713611960,1672656327,1672657243,916
10549,3513213122,3500342408,1672600353,1672601736,1383
11275,3519322066,3714525519,1672657426,1672659896,2470
11561,3783730769,3402105276,1672679871,1672683282,3411
10331,3793719515,3395082458,1672686530,1672686703,173
10329,3517756624,3516655509,1672661196,1672663234,2038
10754,3278805844,3472272792,1672694393,1672695536,1143
10803,3520395850,3772188086,1672661584,1672663124,1540
11222,3500640854,3701028092,1672673114,1672673516,402
11491,3519165527,3466655775,1672686389,1672687098,709
11525,3711722554,3316537706,1672629462,1672632887,3425
11048,3773848111,3792824886,1672616301,1672619093,2792
9801,3660257653,3757944870,1672638514,1672640166,1652
10261,3780308809,3236360179,1672655985,1672657155,1170
10735,3615447269,3516706935,1672660740,1672660962,222
10146,3287403291,3774627091,1672622137,1672623077,940
10674,3621960662,3713927376,1672569695,1672570187,492
11513,3791108593,3430296808,1672677812,1672678475,663
10774,3432762943,3287821258,1672536718,1672538823,2105
10311,3756149282,3777498160,1672577496,1672578866,1370
11594,3772320856,3513661302,1672538759,1672540047,1288
11706,3302416197,3613703906,1672563273,1672565275,2002
11670,3517227599,3519965717,1672600443,1672602799,2356
9815,3338195686,3533030343,1672602240,1672605826,3586
11342,3711755596,3361711720,1672622673,1672622851,178
11117,3813853446,3500688476,1672611316,1672612354,1038
10529,3519435459,3235578852,1672580053,1672580914,861
10926,3534190196,3559112196,1672549381,1672552935,3554
11070,3513186622,3908177413,1672637266,1672638742,1476
10930,3474852115,3340321384,1672644931,1672647707,2776
10769,3399726243,3855077502,1672651757,1672654466,2709
11677,3374195945,3610806770,1672543350,1672546830,3480
10576,3469370398,3520697518,1672561876,1672564426,2550
11087,3807717766,3713923960,1672635354,1672637240,1886
9899,3811419378,3534174363,1672688882,1672691789,2907
10422,3662307789,3919494952,1672601136,1672603288,2152
11155,3514244308,3334461288,1672692819,1672696090,3271
10488,3711518637,3851451801,1672643619,1672644299,680
11197,3361711720,3825795004,1672666491,1672667647,1156
10747,3358434853,3478052226,1672701767,1672705087,3320
11701,3880562532,3505414878,1672592764,1672593085,321
10330,3393502004,3505811269,1672696106,1672699218,3112
9991,3710891331,3713374884,1672630367,1672633928,3561
11296,3312800145,3884934977,1672584463,1672585831,1368
10253,3534537581,3714787207,1672553226,1672554417,1191
11484,3409098014,3755374000,1672671552,1672673582,2030
11598,3505720915,3509544691,1672616508,1672616849,341
10730,3311414429,3684199077,1672618136,1672620080,1944
11011,3714287902,3271282663,1672543743,1672545916,2173
9878,3515548696,3513850048,1672658481,1672661546,3065
10008,3757407184,3519703964,1672573057,1672575064,2007
10351,3345028045,3342235058,1672605234,1672607426,2192
10012,3273758330,3888903181,1672649116,1672651900,2784
10036,3380357490,3713219299,1672627557,1672628082,525
10375,3512343029,3516019206,1672574937,1672575697,760
10995,3715441786,3488887919,1672675936,1672679256,3320
11353,3662055682,3929002318,1672596624,1672599118,2494
11104,3513816744,3732090606,1672612339,1672614666,2327
11227,3364683368,3791368349,1672658746,1672660265,1519
10176,3338642026,3447554599,1672534067,1672535031,964
10795,3501205057,3830962592,1672577113,1672579702,2589
11456,3435342362,3662307789,1672563649,1672566067,2418
10880,3783594246,3311231911,1672643922,1672647310,3388
10219,3405303958,3311177439,1672642799,1672643411,612
10367,3423346297,3205161801,1672679844,1672682388,2544
11639,3476431618,3500221079,1672607977,1672611485,3508
11147,3289258397,3760396348,1672623139,1672625408,2269
10636,3519848902,3248409083,1672615940,1672618985,3045
11673,3534812391,3313298164,1672657727,1672659157,1430
11183,3447938130,3509167758,1672604888,1672607947,3059
10822,3243763209,3793902476,1672696596,1672698560,1964
11615,3517943697,3455430943,1672564163,1672566271,2108
10221,3701028092,3206262649,1672635728,1672637388,1660
11026,3756740153,3382308738,1672573335,1672576426,3091
10685,3436018575,3351837521,1672649371,1672652058,2687
11641,3373135211,3208594306,1672642604,1672645419,2815
11715,3513894659,3501550490,1672611420,1672613122,1702
10819,3394976623,3774109138,1672556147,1672556987,840
10830,3518989186,3793232021,1672653420,1672655718,2298
11525,3444881567,3896200048,1672664941,1672667449,2508
10713,3901217668,3239423794,1672655723,1672657192,1469
10251,3907245259,3309178914,1672554967,1672556191,1224
11478,3534328311,3736056340,1672551656,1672552071,415
11333,3496591885,3207307681,1672669057,1672670520,1463
10695,3520553959,3390537737,1672600673,1672600844,171
10684,3791269060,3505500665,1672589374,1672591879,2505
11170,3518205307,3207307681,1672638009,1672638168,159
11424,3461630842,3417431173,1672641475,1672643673,2198
10206,3662794240,3711862792,1672574102,1672574396,294
10280,3516167000,3519521903,1672650524,1672651289,765
11694,3209280342,3285136057,1672651162,1672651978,816
11602,3602401154,3519165527,1672659435,1672662409,2974
11366,3617771673,3895944547,1672703195,1672705647,2452
11316,3510864325,3804707712,1672668304,1672669471,1167
10693,3284334297,3518205307,1672558259,1672558995,736
10490,3730935770,3928421417,1672585148,1672585828,680
11532,3426207439,3287683210,1672584141,1672584486,345
10059,3739844610,3779427180,1672588556,1672590594,2038
10578,3514611187,3312612693,1672686129,1672687911,1782
11032,3534562354,3370751461,1672537889,1672540237,2348
10544,3516472352,3850005949,1672586898,1672588387,1489
11745,3970851830,3835982340,1672577349,1672577666,317
11739,3447938130,3898989233,1672657030,1672658826,1796
11496,3509614126,3520273299,1672605458,1672605882,424
10574,3360525513,3669475165,1672542367,1672545738,3371
9862,3713807753,3714281795,1672559580,1672560999,1419
10468,3777931341,3500019810,1672589947,1672590255,308
10086,3510373076,3500093945,1672622677,1672625618,2941
9972,3912915644,3755238321,1672553316,1672555645,2329
9826,3773714494,3478052226,1672560067,1672562710,2643
10706,3247193800,3713694278,1672550017,1672553617,3600
9806,3856897914,3533030343,1672633077,1672633333,256
11688,3224040894,3857609616,1672636246,1672637749,1503
11482,3713219299,3701770921,1672601477,1672602752,1275
11083,3756157377,3387413950,1672692332,1672693958,1626
11525,3701655378,3520625600,1672552929,1672554536,1607
10413,3464622743,3896211741,1672641642,1672642903,1261
11253,3818236682,3501600785,1672573181,1672576622,3441
10705,3500555856,3475090917,1672622827,1672626155,3328
10442,3299845453,3533154906,1672572941,1672576056,3115
11318,3287753579,3779706467,1672591454,1672591700,246
9961,3701596047,3512753567,1672532370,1672532558,188
10571,3780423516,3533009565,1672675597,1672676537,940
10002,3755630085,3515378306,1672549548,1672552030,2482
10940,3442564712,3774296721,1672584307,1672587492,3185
11034,3780308809,3489205994,1672605917,1672606326,409
10580,3711430738,3446764595,1672538146,1672539667,1521
10154,3772980989,3773161055,1672680923,1672682361,1438
9824,3812559393,3341311972,1672580967,1672583921,2954
10206,3515944817,3770564547,1672672259,1672675017,2758
11659,3859191694,3783357035,1672691267,1672691763,496
11574,3791547827,3557653200,1672628758,1672629589,831
11378,3757393413,3778195766,1672568763,1672570333,1570
10149,3424425746,3821082558,1672699055,1672699486,431
10711,3836136159,3308759754,1672588479,1672591337,2858
11728,3714268380,3818532143,1672640379,1672643326,2947
11103,3505531432,3534937492,1672656501,1672658360,1859
11452,3735197034,3208594306,1672673986,1672677438,3452
10769,3792682835,3922480066,1672641493,1672642283,790
10667,3910354786,3374348845,1672586290,1672586957,667
11743,3973138649,3500079479,1672688741,1672691239,2498
10135,3248409083,3517991042,1672546827,1672549720,2893
10957,3330799389,3792824886,1672551872,1672552977,1105
11027,3513186622,3518511124,1672670251,1672670374,123
10492,3905358065,3791698084,1672533167,1672534021,854
11710,3716178116,3716445184,1672669199,1672672671,3472
9817,3227498870,3505867821,1672591197,1672591652,455
10079,3756781024,3394357241,1672555026,1672557088,2062
10333,3701475090,3902292032,1672645687,1672648120,2433
10561,3484483775,3701519251,1672662511,1672666056,3545
9893,3242149533,3400025324,1672565564,1672567438,1874
10645,3517253559,3920890008,1672703836,1672705798,1962
11006,3938409715,3441840658,1672625167,1672627310,2143
10145,3303432071,3311200541,1672640876,1672643900,3024
10749,3442181067,3904184638,1672615470,1672618021,2551
11600,3411626917,3756763585,1672686965,1672689279,2314
11664,3388774559,3312800145,1672693463,1672695685,2222
10863,3779503296,3735197034,1672589108,1672590084,976
11168,3293553295,3415032547,1672537964,1672539086,1122
10580,3271389160,3385124073,1672565678,1672567630,1952
10354,3818324410,3792824886,1672654872,1672656582,1710
11077,3510819040,3887382548,1672671828,1672674221,2393
11505,3770441717,3294326116,1672616716,1672619526,2810
10325,3404461403,3662354016,1672647304,1672648715,1411
10228,3246062632,3838423363,1672703741,1672706095,2354
10785,3303432071,3430032005,1672635291,1672636207,916
11362,3734957248,3613781977,1672665800,1672668151,2351
10511,3534941710,3812559393,1672535911,1672537355,1444
11637,3292663993,3461931154,1672537535,1672540398,2863
11311,3701824335,3608214600,1672684040,1672687215,3175
11337,3311479294,3311260898,1672658111,1672660835,2724
10428,3772251279,3715897627,1672648128,1672648192,64
10160,3856699097,3437023385,1672678565,1672680683,2118
9857,3305612422,3792012147,1672571791,1672572273,482
10214,3509431396,3615742989,1672637625,1672640587,2962
10839,3760979523,3283295213,1672640847,1672641290,443
11684,3792267993,3714838100,1672607954,1672610409,2455
10567,3363549860,3514638555,1672564670,1672565964,1294
10836,3826068495,3792283334,1672620970,1672623606,2636
11132,3903994989,3388937390,1672630854,1672631463,609
10469,3776953418,3792682835,1672594044,1672594806,762
10545,3703277359,3662522808,1672678146,1672680848,2702
11430,3514628916,3602054754,1672624327,1672626305,1978
10964,3452024572,3239082508,1672645615,1672648732,3117
10940,3365839890,3332124606,1672669324,1672671698,2374
9986,3488988274,3459799131,1672676629,1672680164,3535
10926,3463729805,3511199555,1672625515,1672626332,817
11037,3315094386,3471177177,1672654709,1672657857,3148
10766,3710149975,3397527886,1672613099,1672614498,1399
10164,3402105276,3738873928,1672655129,1672657972,2843
10674,3445733121,3318056480,1672606698,1672610068,3370
10852,3505248368,3756843139,1672622781,1672625333,2552
11176,3907039612,3242082716,1672542649,1672546054,3405
9896,3231963246,3381055770,1672642623,1672643970,1347
9933,3344778261,3615447269,1672622780,1672625542,2762
11066,3688870751,3774506868,1672670359,1672672754,2395
10003,3772251279,3850904092,1672534675,1672537270,2595
10898,3245121919,3400112498,1672558023,1672558181,158
9813,3739618347,3924366353,1672658260,1672660584,2324
11502,3793732968,3626631210,1672638798,1672639041,243
11131,3881785069,3823307824,1672632817,1672634900,2083
10090,3480108752,3433189219,1672603152,1672604297,1145
10400,3711187791,3772234939,1672690336,1672692705,2369
11632,3701512498,3777932581,1672560070,1672561199,1129
9953,3853386575,3713475356,1672583092,1672583299,207
11130,3273674596,3792255406,1672633836,1672636046,2210
10102,3519924982,3772966919,1672613767,1672616337,2570
10122,3777655401,3685396470,1672588090,1672590917,2827
10066,3509252934,3714074120,1672598345,1672600744,2399
10143,3517960740,3389367628,1672634512,1672637595,3083
10998,3534562354,3703476890,1672558246,1672560699,2453
9921,3206241691,3810584695,1672689361,1672689744,383
10956,3732846295,3660246433,1672566170,1672566494,324
10854,3791368349,3330318282,1672691955,1672693431,1476
10668,3434581257,3443102414,1672661130,1672661206,76
11436,3793375825,3806471413,1672620189,1672622325,2136
10859,3209280342,3714116241,1672638230,1672641008,2778
10990,3703614781,3601214648,1672672704,1672675814,3110
10971,3511289729,3774029494,1672607934,1672609523,1589
10885,3245882008,3514297012,1672636595,1672637252,657
10606,3393376416,3500093945,1672692865,1672694658,1793
11280,3793699467,3780500764,1672629980,1672632131,2151
10495,3533593766,3714902042,1672545577,1672545688,111
10019,3619796619,3668720465,1672656043,1672658090,2047
10614,3512784888,3811351746,1672652675,1672653993,1318
11400,3813085701,3971447562,1672570986,1672573906,2920
10223,3513186622,3500695402,1672643741,1672644136,395
10423,3513629502,3516429380,1672661334,1672662822,1488
11506,3774744663,3922153821,1672665092,1672667010,1918
10350,3755170743,3710051427,1672553736,1672555813,2077
9813,3478915403,3391854325,1672691852,1672693714,1862
9944,3520165730,3534374523,1672587856,1672591235,3379
10969,3233993993,3281148858,1672601904,1672604661,2757
10829,3204821370,3376842515,1672636014,1672639491,3477
10418,3732128078,3817478012,1672576646,1672576855,209
10630,3756897029,3276209319,1672644964,1672645445,481
10425,3439651226,3234445133,1672697161,1672698800,1639
10798,3236254381,3669918958,1672638294,1672638656,362
11210,3513250976,3812516461,1672610249,1672610825,576
10428,3373135211,3757869138,1672695740,1672699005,3265
11024,3443102414,3834424604,1672576987,1672580484,3497
11362,3246804115,3778479297,1672657612,1672661203,3591
10419,3777112124,3777928067,1672700169,1672700868,699
10551,3701519251,3711854614,1672642124,1672645588,3464
11252,3774450494,3774682234,1672648662,1672651660,2998
11364,3770424941,3622458047,1672648516,1672649877,1361
11459,3510439480,3688845298,1672698659,1672699740,1081
11035,3713858538,3273537848,1672588837,1672590756,1919
10792,3716467469,3639503148,1672656277,1672658785,2508
10477,3200372897,3520515739,1672599497,1672600620,1123
11407,3714142299,3773440794,1672635217,1672638263,3046
10643,3895507040,3512744657,1672569425,1672570645,1220
9954,3770924034,3884001167,1672570851,1672571265,414
11061,3613781977,3501734800,1672684632,1672686829,2197
11474,3600441934,3402338011,1672590979,1672594211,3232
11003,3316406470,3247845642,1672547936,1672550172,2236
10549,3773432494,3330466913,1672655318,1672657392,2074
10907,3850735936,3812261241,1672703526,1672705737,2211
10625,3512477276,3922409420,1672619820,1672621775,1955
11631,3927675706,3713373455,1672545559,1672548612,3053
10100,3497732613,3791222330,1672696559,1672698677,2118
10317,3505560793,3274894848,1672647490,1672648935,1445
11363,3701534043,3793978936,1672675645,1672677289,1644
11695,3713767153,3918126468,1672549534,1672553113,3579
10503,3342368576,3511867383,1672700063,1672701573,1510
11550,3930727474,3512480125,1672616904,1672619199,2295
10125,3515970536,3534081527,1672675873,1672678079,2206
10728,3509651954,3714074120,1672628076,1672630423,2347
11671,3978417055,3459951739,1672551446,1672554959,3513
10425,3435652260,3493047640,1672679708,1672681567,1859
10959,3520016705,3514747345,1672629928,1672632599,2671
10899,3817376705,3856129522,1672544071,1672546091,2020
10675,3515096959,3710919244,1672624029,1672626834,2805
10581,3553229537,3303432071,1672698706,1672701906,3200
10205,3791532324,3358982831,1672683857,1672685938,2081
10014,3777387533,3533131937,1672622125,1672625080,2955
10901,3636927297,3417969824,1672665598,1672667295,1697
10132,3501225887,3241593146,1672663992,1672664794,802
11121,3514926921,3512417028,1672589331,1672589818,487
10559,3353335252,3273674596,1672534293,1672536749,2456
11077,3376487118,3342027511,1672600074,1672603399,3325
9835,3476308535,3520165730,1672700543,1672701548,1005
11425,3732440502,3435159896,1672646386,1672647499,1113
10539,3716233100,3623894390,1672699464,1672700125,661
9824,3558264627,3770424892,1672589554,1672590321,767
9975,3512871568,3427049290,1672658866,1672662392,3526
11689,3351728355,3371238318,1672637502,1672638019,517
10134,3793926338,3500590302,1672691336,1672693472,2136
9825,3488887919,3738160394,1672698621,1672701254,2633
10758,3808849597,3408982612,1672663818,1672664589,771
10744,3809216145,3778713526,1672621631,1672623364,1733
10559,3480560014,3935520819,1672541695,1672544168,2473
10102,3501548163,3919211457,1672560971,1672561931,960
11503,3511382748,3500889287,1672629894,1672630907,1013
9855,3976742903,3703749690,1672615988,1672618080,2092
11031,3520009158,3792708936,1672632401,1672633884,1483
10788,3818904268,3500329674,1672593492,1672594378,886
11018,3468343480,3411213032,1672646372,1672646840,468
10350,3910190872,3837271330,1672557847,1672558160,313
10420,3533830748,3738547113,1672681642,1672681962,320
11752,3361926328,3372778334,1672547525,1672550974,3449
10787,3703481882,3225356349,1672613226,1672615736,2510
11764,3466655775,3770991234,1672606136,1672608805,2669
10356,3812516461,3834980281,1672584512,1672586742,2230
9994,3701956841,3915962248,1672613920,1672617225,3305
10124,3936851114,3812880543,1672549770,1672549946,176
11409,3499343927,3826542169,1672546637,1672548652,2015
10692,3715858201,3850181934,1672615877,1672618322,2445
11608,3533077580,3342545285,1672678443,1672679066,623
10894,3520273299,3451757423,1672667337,1672670714,3377
9855,3404375908,3792824886,1672535473,1672538311,2838
10032,3779130507,3466620548,1672584034,1672586531,2497
11730,3429610195,3791532324,1672602082,1672605333,3251
10885,3442462115,3812756400,1672625617,1672626158,541
9927,3330799389,3715700639,1672640305,1672643237,2932
9940,3854202447,3418382025,1672600565,1672601260,695
11505,3830599959,3337673625,1672537530,1672538720,1190
10840,3228997424,3884862164,1672541857,1672544620,2763
11038,3710813103,3317989975,1672621711,1672624853,3142
9858,3489340327,3432466467,1672614627,1672617698,3071
10888,3701893620,3780050328,1672556979,1672557348,369
10636,3773083407,3516497645,1672558570,1672559605,1035
10641,3908883591,3311569360,1672641298,1672643425,2127
10255,3500440602,3610517436,1672649071,1672652251,3180
10731,3760966645,3552922094,1672627938,1672628073,135
9975,3716468783,3926065090,1672615145,1672618024,2879
11210,3701004302,3772055279,1672615487,1672617574,2087
11647,3495446254,3755411110,1672592287,1672595220,2933
10826,3832002939,3714516404,1672560061,1672562382,2321
10594,3770275898,3711804184,1672655035,1672656955,1920
11123,3352295704,3434581257,1672673624,1672674886,1262
11412,3518164450,3239423794,1672614304,1672614693,389
10569,3342426430,3792851584,1672666924,1672667705,781
11772,3277061226,3701971784,1672543907,1672546411,2504
10688,3299052917,3890638402,1672573311,1672573822,511
10457,3619538249,3783043770,1672561824,1672564322,2498
10630,3515230715,3710861700,1672692957,1672695594,2637
11360,3534068874,3510206323,1672563625,1672564099,474
10357,3621629499,3904004824,1672568814,1672570964,2150
11156,3773853619,3932491622,1672650127,1672653727,3600
11248,3400025324,3634766042,1672532188,1672534699,2511
11744,3533777032,3896123242,1672676767,1672680340,3573
11327,3755357292,3934070285,1672540041,1672541849,1808
9911,3510968599,3755570137,1672603162,1672606380,3218
11733,3821103640,3739395381,1672678145,1672680923,2778
11192,3933872044,3473562779,1672621882,1672624718,2836
11179,3288675710,3517800171,1672562130,1672563878,1748
10561,3467663782,3512965991,1672563657,1672565963,2306
10277,3714287902,3519102732,1672535889,1672537374,1485
10273,3756616853,3632720032,1672612133,1672615241,3108
10468,3627081426,3245642576,1672555271,1672557191,1920
11456,3533201269,3284829602,1672534891,1672537799,2908
11445,3774447975,3715858201,1672536073,1672539661,3588
10928,3778986795,3714142299,1672666074,1672667135,1061
10407,3516969689,3777932581,1672640564,1672642090,1526
10171,3770966950,3625952981,1672557088,1672557499,411
11784,3774238066,3519689906,1672618640,1672620013,1373
11771,3625779003,3755767856,1672650401,1672652687,2286
10924,3713990030,3772751765,1672565815,1672568623,2808
11469,3610723722,3830254808,1672579063,1672580206,1143
10553,3711430738,3517132086,1672606799,1672608146,1347
10181,3510795808,3517756624,1672599600,1672602071,2471
10846,3307997700,3681274982,1672620658,1672621531,873
10022,3513186622,3242149533,1672570176,1672570916,740
10815,3792063616,3514013999,1672590909,1672591235,326
10339,3701041860,3665841655,1672590249,1672593021,2772
11509,3511415786,3453464785,1672536063,1672536762,699
11149,3520362238,3342545285,1672686878,1672688085,1207
10987,3688130094,3398489033,1672555762,1672556742,980
11040,3505908965,3369482983,1672685727,1672686451,724
11198,3395069149,3716475340,1672604557,1672606437,1880
11086,3534426696,3714690161,1672541594,1672544219,2625
10957,3518794921,3447202943,1672682630,1672683234,604
10824,3500105301,3971422524,1672559386,1672560518,1132
11316,3374195945,3776304080,1672595662,1672597342,1680
11045,3831981073,3770846374,1672534595,1672535621,1026
11726,3933562725,3755570137,1672571723,1672572715,992
11328,3791758175,3829358750,1672632204,1672634165,1961
11161,3756493561,3780786276,1672574783,1672576390,1607
11685,3716118473,3927675706,1672643762,1672646194,2432
10696,3500695402,3355903597,1672627794,1672630942,3148
11127,3713141087,3239423794,1672611002,1672613539,2537
10062,3367299721,3225371682,1672584757,1672586420,1663
9843,3514498259,3636877469,1672561059,1672562378,1319
10340,3903115138,3491335890,1672587129,1672588055,926
11633,3492064037,3792824886,1672696369,1672698634,2265
10652,3406390503,3514007122,1672547622,1672547694,72
10351,3309415277,3512744657,1672536865,1672540326,3461
10392,3248061684,3472173212,1672598909,1672600065,1156
10437,3774822697,3791574640,1672627925,1672629106,1181
10124,3793978936,3415032547,1672543224,1672544342,1118
9946,3209958726,3317190427,1672606647,1672610224,3577
10575,3207497598,3380418745,1672575647,1672578374,2727
10580,3837435907,3756328353,1672577843,1672578864,1021
10987,3774195369,3486824047,1672637685,1672640675,2990
10085,3515655024,3772802020,1672547502,1672549001,1499
11319,3852275715,3975799349,1672657681,1672659045,1364
9807,3517469005,3777552831,1672677323,1672678540,1217
10247,3713283029,3278071998,1672632136,1672635423,3287
11664,3514329209,3439036305,1672648161,1672651085,2924
10970,3387971464,3505140123,1672565450,1672568845,3395
11085,3711243126,3920155862,1672567019,1672567369,350
10023,3812277991,3404375908,1672635733,1672637650,1917
10275,3773085258,3735422623,1672671000,1672673965,2965
10638,3515096959,3333477908,1672541100,1672543403,2303
10274,3710397477,3716197140,1672614901,1672617719,2818
10288,3891272544,3783277159,1672559236,1672562761,3525
10291,3979366845,3285136057,1672597856,1672599135,1279
10539,3777751979,3515699732,1672566446,1672567786,1340
9912,3904485393,3710223875,1672697576,1672698897,1321
10334,3823600319,3533131937,1672656499,1672659892,3393
11171,3330318282,3343859998,1672561783,1672563215,1432
11253,3814378625,3482687604,1672594824,1672597130,2306
10812,3501356814,3400793223,1672609466,1672610875,1409
11425,3776791436,3480185839,1672612020,1672614200,2180
9830,3755769731,3703443664,1672629511,1672629758,247
11645,3412605548,3770023722,1672622970,1672623265,295
10704,3520558137,3779951373,1672635562,1672638918,3356
10471,3341129425,3637522163,1672627406,1672627559,153
10661,3518534560,3450234157,1672615698,1672616182,484
11660,3273771395,3310021925,1672657595,1672657664,69
9889,3501927452,3622729771,1672569466,1672569756,290
9956,3517021928,3501619113,1672660999,1672661866,867
11709,3881579907,3505234868,1672573860,1672576015,2155
11411,3716647407,3929002318,1672582013,1672584570,2557
10094,3505190512,3512411326,1672687808,1672689232,1424
11179,3916463490,3500734346,1672648335,1672651556,3221
11600,3710919244,3517552930,1672640786,1672644306,3520
10586,3422314045,3777112124,1672556667,1672558285,1618
11018,3791108593,3245774173,1672554683,1672558198,3515
10687,3308965136,3793920312,1672581601,1672582092,491
10340,3703502114,3393909269,1672624491,1672625217,726
10422,3500589560,3515753241,1672662745,1672663691,946
11347,3773534165,3703443664,1672620490,1672623191,2701
9837,3429315500,3533728729,1672569507,1672569593,86
10759,3343193067,3512477276,1672676282,1672676789,507
10937,3777932581,3710529628,1672618637,1672618867,230
11532,3390368796,3774273260,1672622601,1672625978,3377
10673,3716994924,3342056927,1672572510,1672576006,3496
10815,3682673884,3509186338,1672628953,1672630083,1130
10866,3924583142,3757311529,1672660370,1672662976,2606
11301,3272581469,3822786416,1672659494,1672660247,753
11001,3298706213,3636852764,1672605437,1672607847,2410
10752,3236886943,3755175497,1672634890,1672636329,1439
9995,3512794667,3303772923,1672646591,1672649311,2720
10886,3703462221,3604569804,1672534607,1672537599,2992
10986,3973582279,3760420315,1672655655,1672659220,3565
10618,3417223898,3776182849,1672675325,1672677145,1820
10007,3973134902,3780298499,1672566774,1672566865,91
11467,3701291994,3379517265,1672568355,1672568745,390
9912,3772609551,3492350318,1672610558,1672611822,1264
11170,3319645922,3278443807,1672703322,1672704445,1123
11601,3400903513,3501271930,1672687263,1672690417,3154
10038,3300810210,3354405535,1672556843,1672559235,2392
11291,3772751765,3779951373,1672567812,1672568004,192
11462,3434452046,3391093411,1672545828,1672549423,3595
10478,3471131277,3773134128,1672563875,1672563976,101
11208,3716285196,3278071998,1672626988,1672627455,467
9852,3398483531,3636605690,1672638283,1672640112,1829
11342,3306066522,3701065296,1672690468,1672691154,686
11181,3976225898,3779174993,1672646710,1672648375,1665
10421,3900195680,3793689267,1672552359,1672554064,1705
9997,3227874229,3772223331,1672683061,1672683397,336
11205,3380418745,3512596743,1672553800,1672554416,616
11004,3896211741,3480259863,1672618365,1672619571,1206
10348,3664523809,3303772923,1672600392,1672601718,1326
10519,3805718871,3812516461,1672611768,1672614122,2354
10224,3370245766,3907225070,1672703376,1672705176,1800
11670,3716197140,3738132114,1672636671,1672637793,1122
10273,3774145748,3493515706,1672664755,1672667477,2722
11189,3711767051,3756680289,1672676503,1672680037,3534
10243,3925098136,3505804611,1672658509,1672659800,1291
10989,3760979523,3856975355,1672586121,1672589709,3588
10572,3688870751,3509360869,1672652202,1672652564,362
10224,3934980229,3760274119,1672673768,1672674238,470
11028,3496579251,3774744663,1672638776,1672640734,1958
10381,3738734246,3792008302,1672538817,1672539932,1115
11195,3517992521,3516257130,1672612734,1672613973,1239
10930,3387413950,3639465750,1672672689,1672673086,397
11438,3760529327,3334381941,1672633142,1672634483,1341
11568,3276230295,3783060739,1672572412,1672573168,756
11115,3713191326,3770497768,1672546931,1672550099,3168
10675,3493515706,3271282663,1672599633,1672601119,1486
10717,3534278019,3897851509,1672563470,1672565875,2405
10581,3776182849,3731905251,1672539801,1672542705,2904
10410,3756616853,3778909412,1672558127,1672559625,1498
10489,3770497768,3299587876,1672702670,1672703298,628
11595,3669418238,3687445224,1672612748,1672614353,1605
11692,3369558911,3500793739,1672696702,1672700214,3512
11164,3774652449,3356972733,1672651403,1672651756,353
9968,3616242727,3394986304,1672661273,1672664294,3021
10779,3288920399,3701475090,1672562308,1672565779,3471
10558,3663353552,3433196933,1672680383,1672683649,3266
10500,3772343750,3510233949,1672643707,1672646470,2763
9848,3550887623,3509431396,1672699519,1672701435,1916
11227,3364718040,3311959533,1672590383,1672590789,406
11091,3783942518,3711015176,1672563147,1672564298,1151
11580,3512154443,3896200048,1672698744,1672698956,212
9795,3533566754,3773523569,1672552392,1672555205,2813
11088,3893629892,3513186622,1672625237,1672628302,3065
11472,3350966326,3779312237,1672615494,1672617264,1770
9827,3888523259,3516454693,1672634492,1672634665,173
11114,3831864108,3440770466,1672635656,1672637787,2131
10288,3244397548,3829358750,1672679860,1672681408,1548
10636,3518368900,3520694387,1672607250,1672608884,1634
10961,3514352989,3304252969,1672552571,1672554251,1680
11039,3342031426,3715111016,1672533615,1672536798,3183
10740,3437108337,3734957248,1672692663,1672693429,766
11409,3774447975,3245882008,1672594447,1672597971,3524
11506,3438028077,3510542303,1672597682,1672599106,1424
10238,3774195369,3446537819,1672531379,1672531591,212
11418,3932955949,3783967375,1672638799,1672639567,768
11670,3558203963,3755729826,1672647849,1672647949,100
10888,3517136772,3458432407,1672591120,1672594075,2955
10379,3609103278,3501004005,1672554162,1672554609,447
10508,3807717766,3936486724,1672581404,1672584822,3418
11058,3505908965,3888903181,1672668880,1672670537,1657
11019,3776068937,3714525519,1672583146,1672586014,2868
11564,3701350519,3343698137,1672698460,1672701656,3196
9906,3520009158,3341432459,1672541680,1672541910,230
9991,3855977674,3774221318,1672583099,1672584599,1500
10350,3710185376,3534362749,1672598905,1672599964,1059
10482,3919719755,3776447604,1672643363,1672644571,1208
11498,3352493805,3515893948,1672554703,1672556432,1729
10999,3777149336,3347172556,1672663039,1672665941,2902
11301,3625779003,3793822639,1672555625,1672556209,584
11674,3514327931,3533365834,1672674297,1672676452,2155
10210,3757514745,3443580855,1672592082,1672595328,3246
11582,3505148522,3857590978,1672550802,1672550984,182
9802,3773697080,3240622654,1672701972,1672704560,2588
10339,3783172505,3318220119,1672534853,1672536409,1556
11703,3367262509,3909220912,1672573584,1672575977,2393
11169,3716595760,3972847837,1672614449,1672615872,1423
10151,3792440162,3776182849,1672647885,1672650538,2653
10025,3495152069,3371497614,1672680215,1672680488,273
10178,3715441786,3714435747,1672595271,1672598025,2754
10908,3513508737,3515893948,1672617087,1672620307,3220
9962,3821087562,3710119555,1672550563,1672552381,1818
9886,3770595035,3711591464,1672654464,1672657476,3012
10622,3776534957,3332840671,1672538669,1672540705,2036
10865,3510638085,3271282663,1672600933,1672601023,90
10591,3710185376,3801501384,1672634377,1672634936,559
11026,3783443095,3534506090,1672644561,1672647879,3318
9879,3822368676,3713191326,1672649120,1672651442,2322
11266,3665603628,3774205060,1672655021,1672658331,3310
11242,3927763819,3359351267,1672597481,1672598372,891
11079,3774221318,3534204885,1672561685,1672564999,3314
10254,3385006834,3917905192,1672648330,1672649594,1264
11713,3772291207,3511364193,1672612169,1672612572,403
11511,3283106998,3392010033,1672599334,1672602158,2824
11554,3431317400,3774744663,1672645535,1672646996,1461
9832,3520779124,3756168814,1672592406,1672593647,1241
10885,3828568868,3445733121,1672595173,1672597583,2410
10187,3516026189,3783067048,1672673132,1672676451,3319
11016,3337673625,3734957248,1672586901,1672588874,1973
11711,3465227623,3510894809,1672675085,1672677532,2447
11744,3793987483,3533009565,1672679986,1672680160,174
11267,3772055279,3415840750,1672601692,1672604488,2796
10987,3716475340,3783730769,1672696722,1672699634,2912
10862,3916955566,3276209319,1672604095,1672605566,1471
10651,3514673213,3515304526,1672552969,1672556501,3532
10084,3820922991,3501873139,1672532406,1672535530,3124
11405,3430823498,3756413374,1672582184,1672583586,1402
10729,3791628263,3892177203,1672578979,1672580618,1639
9923,3512492332,3937636109,1672609641,1672610636,995
11076,3381055770,3732533330,1672607086,1672609039,1953
10708,3509167758,3920116284,1672674565,1672675016,451
10745,3773852157,3822368676,1672668881,1672670939,2058
10963,3432050858,3822786416,1672545950,1672548258,2308
11065,3424425746,3510758718,1672570508,1672573314,2806
10329,3480418192,3512826895,1672553127,1672554400,1273
10634,3514747345,3338195686,1672611397,1672614457,3060
11749,3382696725,3501828287,1672564736,1672567831,3095
11456,3519951586,3888523259,1672639240,1672642657,3417
10018,3441944896,3446575109,1672574188,1672574302,114
11330,3791332061,3500596577,1672689882,1672690033,151
10966,3755203055,3373135211,1672601653,1672604335,2682
10071,3511750850,3710919244,1672601042,1672601400,358
11310,3500317923,3776125503,1672666552,1672667285,733
11270,3417268745,3851737350,1672631203,1672633618,2415
9843,3510894809,3711404205,1672544387,1672544469,82
10203,3400186699,3703481882,1672643670,1672645320,1650
10209,3714065165,3851877325,1672600168,1672600933,765
10965,3772112976,3495482863,1672555370,1672556150,780
10077,3224053840,3715724166,1672665720,1672666849,1129
11081,3465107990,3715844082,1672642760,1672644250,1490
10407,3422460919,3273537848,1672586449,1672588262,1813
10569,3513486828,3501828287,1672544543,1672547012,2469
10743,3394394262,3358675021,1672630442,1672633651,3209
11096,3714951681,3452175941,1672664497,1672666114,1617
11719,3779454060,3624365837,1672686715,1672689765,3050
10962,3514450836,3681504869,1672638009,1672638131,122
10826,3714919471,3510781595,1672565204,1672565454,250
10222,3602680347,3853275529,1672579388,1672579628,240
9971,3772262649,3627081426,1672536711,1672539241,2530
9815,3662522808,3760656396,1672633688,1672634607,919
11238,3334936138,3710173412,1672612477,1672612605,128
11538,3701448521,3534284132,1672660321,1672660868,547
11071,3336225953,3783695231,1672571070,1672574372,3302
9947,3760267158,3488749569,1672656431,1672659938,3507
10654,3235578852,3804095239,1672674165,1672677037,2872
11671,3714250543,3791409441,1672595611,1672597744,2133
10238,3500968729,3757598610,1672616472,1672618686,2214
9933,3792512768,3611298237,1672533519,1672534860,1341
11107,3757523596,3715590997,1672667546,1672668048,502
10754,3304030474,3917004141,1672584713,1672586598,1885
10216,3793926338,3359929534,1672647527,1672648831,1304
11491,3885545415,3459951739,1672592937,1672594677,1740
9850,3409098014,3490008012,1672630156,1672632999,2843
10006,3518205307,3791070926,1672701185,1672702064,879
11452,3710147457,3801379377,1672681310,1672683468,2158
10561,3906874577,3370245766,1672589679,1672590956,1277
11430,3470135167,3739297004,1672646768,1672648870,2102
10984,3773899531,3428076194,1672659172,1672659327,155
11354,3509677530,3247845642,1672564474,1672566023,1549
10909,3559221089,3669418238,1672684059,1672684212,153
11263,3359351267,3476431618,1672689951,1672692036,2085
10156,3293673220,3770012744,1672554990,1672556830,1840
10520,3857389270,3757549235,1672543870,1672545200,1330
11169,3714281210,3711176990,1672692431,1672692729,298
10462,3791289855,3703722212,1672562952,1672564483,1531
10419,3515558215,3631444265,1672562095,1672564730,2635
11300,3770497768,3976225898,1672607218,1672607975,757
11598,3420664407,3282053097,1672625867,1672628949,3082
10057,3686644062,3294326116,1672583321,1672584150,829
11059,3779689733,3927181190,1672619230,1672620813,1583
10161,3305612422,3791194984,1672664118,1672666936,2818
11368,3714892312,3686860179,1672620438,1672623822,3384
10619,3304592684,3512819376,1672599695,1672602453,2758
10464,3760541837,3855222429,1672550838,1672552927,2089
11313,3783172505,3505500523,1672605821,1672606595,774
9875,3220987526,3770019143,1672678302,1672679560,1258
10762,3685522474,3285201542,1672653542,1672653880,338
10413,3512288503,3347205332,1672574708,1672575833,1125
10103,3364718040,3773424266,1672671257,1672672602,1345
10279,3398483531,3793987483,1672693196,1672694998,1802
10123,3791224239,3245755569,1672632418,1672635080,2662
11499,3736056340,3703423962,1672548407,1672550845,2438
11493,3520305100,3515577866,1672619006,1672622493,3487
10542,3353335252,3509503263,1672607676,1672608427,751
9975,3624164232,3886896755,1672535305,1672536835,1530
11316,3774822697,3235074007,1672643698,1672646193,2495
10375,3505845400,3703611876,1672671401,1672672901,1500
11479,3407734098,3822368676,1672678614,1672678690,76
11414,3971447562,3618024815,1672637908,1672639981,2073
10857,3208519320,3812559393,1672657946,1672661214,3268
11657,3520022175,3447591143,1672556823,1672558098,1275
11301,3293540333,3710891331,1672696530,1672699875,3345
10063,3791825536,3760997159,1672666439,1672668328,1889
10956,3228997424,3710051427,1672662865,1672663710,845
10228,3442403264,3500209015,1672642806,1672645881,3075
11537,3505121295,3318590083,1672532824,1672533848,1024
11776,3445406685,3534459983,1672619272,1672621599,2327
10172,3355899481,3902023467,1672545627,1672547874,2247
10715,3780511388,3480270940,1672614665,1672616534,1869
10207,3380185102,3738760498,1672702010,1672705048,3038
10829,3518164450,3534696810,1672650207,1672653246,3039
10648,3515047288,3776053084,1672682069,1672684762,2693
10932,3776053084,3622729771,1672675712,1672677091,1379
10828,3423353911,3487988841,1672602437,1672603776,1339
10704,3274239253,3777878462,1672644282,1672645111,829
10394,3604569804,3520471156,1672659780,1672661149,1369
10133,3770441717,3380357490,1672647981,1672651242,3261
10545,3486509752,3791121243,1672619911,1672622147,2236
9806,3352057037,3516335333,1672579370,1672582840,3470
10372,3791547827,3533822490,1672539742,1672541857,2115
10753,3783095041,3738526914,1672666015,1672669499,3484
10088,3435159896,3770630937,1672676161,1672679502,3341
11303,3792512768,3880882684,1672661020,1672663598,2578
11211,3773853619,3778195766,1672584510,1672585965,1455
10444,3432838598,3617771673,1672628329,1672629127,798
10723,3714281795,3774035405,1672561659,1672563768,2109
9813,3510178791,3510153173,1672650267,1672651742,1475
10880,3422205569,3501244753,1672608018,1672608079,61
11119,3716733618,3297624618,1672587610,1672591147,3537
10730,3510153173,3916955566,1672582949,1672583427,478
10696,3711219767,3757497708,1672622148,1672624802,2654
10739,3756363182,3472173212,1672627090,1672628308,1218
9954,3780287649,3783373085,1672655333,1672658300,2967
11251,3516249472,3551833298,1672662058,1672662385,327
11596,3375905193,3622152515,1672615202,1672615648,446
11558,3235198316,3515974881,1672597401,1672599399,1998
11628,3517144269,3780168985,1672555854,1672557159,1305
9875,3715587520,3382670400,1672611442,1672612445,1003
11404,3510189563,3533030343,1672567495,1672569397,1902
11749,3773852157,3452175941,1672575016,1672577415,2399
9943,3774483862,3730052916,1672677190,1672679996,2806
11186,3533830748,3342368576,1672674069,1672675595,1526
9958,3519356606,3603682643,1672553626,1672557030,3404
11227,3313795594,3979366845,1672558485,1672559870,1385
10945,3621812406,3757855416,1672590831,1672592226,1395
11121,3713566527,3533037906,1672692632,1672694278,1646
11759,3777060250,3609166109,1672547675,1672551040,3365
10912,3779748270,3770564547,1672661249,1672664676,3427
11367,3510535683,3974400577,1672625995,1672629203,3208
10693,3713224986,3533030343,1672568452,1672569684,1232
10150,3512871568,3732223664,1672651879,1672652631,752
9914,3783651407,3791031227,1672646947,1672647908,961
11723,3304672737,3619538249,1672696233,1672697349,1116
9842,3228218081,3792063616,1672636120,1672636823,703
11358,3372236721,3510919509,1672669689,1672670066,377
9942,3619796619,3298831109,1672648070,1672649002,932
10417,3772250554,3770544738,1672695920,1672698832,2912
11181,3755865626,3518335611,1672664594,1672665196,602
11183,3367109648,3533017131,1672598493,1672600592,2099
10492,3505825767,3510291656,1672666504,1672669197,2693
10579,3715282492,3711770773,1672636219,1672638936,2717
10196,3930766276,3501192566,1672531913,1672534556,2643
9801,3612705426,3780563627,1672568919,1672569819,900
10559,3361711720,3773697080,1672687416,1672688061,645
11145,3807584987,3519162582,1672637290,1672638197,907
9808,3500595432,3533209168,1672581609,1672581961,352
11570,3669283586,3791994414,1672687061,1672687303,242
10947,3776348451,3450164574,1672549605,1672550382,777
11143,3275975921,3852310652,1672683484,1672684309,825
11034,3711219767,3770441717,1672662333,1672662823,490
9814,3435342362,3716633983,1672646730,1672648462,1732
10349,3517627003,3203457161,1672677413,1672680878,3465
11532,3770595035,3513740840,1672544177,1672544362,185
10963,3347520239,3423353911,1672537905,1672539798,1893
10248,3534531039,3395082458,1672565728,1672568811,3083
11071,3533593766,3780238637,1672573272,1672575477,2205
10097,3711040761,3776001441,1672595467,1672598371,2904
11190,3793274846,3395565040,1672673298,1672674662,1364
10425,3500695402,3886957097,1672552862,1672554559,1697
11782,3476416072,3893932944,1672687450,1672689119,1669
9968,3627081426,3402338011,1672541263,1672542391,1128
11765,3682266017,3701865589,1672613663,1672616412,2749
10435,3701567668,3313282478,1672694482,1672695390,908
11691,3757623259,3491390365,1672556819,1672557599,780
10802,3343767438,3534589501,1672586074,1672586148,74
9875,3509167758,3770018912,1672640199,1672643046,2847
11307,3358530225,3776316903,1672687878,1672690743,2865
10909,3310021925,3518058151,1672547084,1672549780,2696
10708,3311305760,3220976338,1672685767,1672687652,1885
11089,3902023467,3490008012,1672674471,1672675922,1451
10512,3757872458,3406390503,1672618519,1672620274,1755
10700,3772055279,3756781024,1672664209,1672667756,3547
11548,3791222330,3701412729,1672545209,1672545808,599
9930,3308759754,3308744016,1672555307,1672556683,1376
10754,3371184929,3307216611,1672651949,1672653121,1172
11217,3774316305,3793407883,1672532787,1672532970,183
11745,3773534165,3367526113,1672638018,1672639755,1737
10767,3890194669,3352295704,1672600920,1672604338,3418
9804,3770273459,3635433296,1672647846,1672648037,191
11199,3822634862,3732596503,1672679598,1672679735,137
11067,3514329209,3779454060,1672699097,1672700495,1398
10318,3910049345,3778713526,1672638506,1672641116,2610
11599,3520824937,3975796415,1672686086,1672688148,2062
10832,3826542169,3792440162,1672639571,1672640676,1105
10344,3516026189,3760382349,1672632952,1672633689,737
9853,3505828210,3432762943,1672583696,1672584479,783
11706,3362706073,3458753033,1672652691,1672655214,2523
10303,3623512088,3243056734,1672597621,1672601058,3437
11365,3513215373,3805831563,1672594538,1672596424,1886
9859,3774606418,3349573092,1672532183,1672534507,2324
10547,3701065296,3972653129,1672556111,1672559369,3258
10698,3713283029,3559221089,1672575079,1672576112,1033
10466,3231963246,3773899531,1672601015,1672602500,1485
10715,3501137133,3505482210,1672590460,1672593786,3326
11220,3402105276,3444881567,1672674388,1672677474,3086
11287,3275735969,3496352027,1672571435,1672573087,1652
10210,3810818108,3354877289,1672577954,1672579078,1124
10475,3459799131,3378747834,1672695697,1672698913,3216
10638,3972442654,3514033319,1672594049,1672595685,1636
10630,3418382025,3245755569,1672699729,1672699923,194
11522,3716609198,3737738751,1672622470,1672624069,1599
10961,3613940925,3435342362,1672565971,1672569205,3234
11654,3701770921,3760554453,1672620294,1672621764,1470
10726,3817315443,3757869138,1672579747,1672581785,2038
10584,3247193800,3415228763,1672600450,1672602252,1802
11108,3519521903,3338642026,1672606902,1672609308,2406
10454,3684199077,3533628528,1672535465,1672535706,241
9895,3534122907,3246062632,1672583343,1672585336,1993
10235,3501619113,3668855144,1672638585,1672641506,2921
10037,3778479297,3669497617,1672700996,1672702812,1816
10373,3738760498,3388774559,1672585608,1672589200,3592
10842,3312800145,3772223331,1672685635,1672687058,1423
11708,3228033254,3627358016,1672565878,1672569087,3209
10223,3776561263,3778819352,1672644084,1672645041,957
10157,3520725149,3355880028,1672687579,1672690854,3275
10461,3511382748,3395069149,1672610989,1672611663,674
10481,3711223297,3550405857,1672570449,1672573124,2675
10774,3776811587,3489212992,1672630130,1672630255,125
10616,3514297012,3736885568,1672551477,1672554569,3092
10374,3915195160,3436401020,1672663156,1672666198,3042
10411,3780942505,3686081254,1672559726,1672560320,594
11366,3715140418,3501828287,1672567867,1672569024,1157
11410,3701770921,3836090778,1672614254,1672616837,2583
10218,3756616853,3278071998,1672699190,1672701227,2037
10190,3773085258,3511500932,1672668044,1672671593,3549
10747,3923133978,3513840186,1672664189,1672666298,2109
11544,3934280144,3202787155,1672602459,1672605267,2808
10166,3635433296,3778100960,1672659516,1672659825,309
10551,3473520701,3273674596,1672701951,1672704901,2950
11576,3515304526,3732104286,1672667047,1672669918,2871
11615,3496407500,3466620548,1672618138,1672618949,811
10239,3778702093,3885645840,1672619071,1672621170,2099
11485,3714897456,3293553295,1672579933,1672580423,490
10652,3299587876,3370512945,1672594631,1672594871,240
10609,3342495377,3311410533,1672655612,1672656191,579
11784,3774939922,3444598583,1672627525,1672628800,1275
11007,3916656185,3511640720,1672611479,1672611914,435
10202,3466620548,3534531039,1672603460,1672605924,2464
10277,3774296721,3850005949,1672645317,1672645514,197
11454,3715039960,3316406470,1672539513,1672540856,1343
10238,3837887478,3318220119,1672672729,1672675679,2950
11292,3510795808,3716460706,1672605764,1672608926,3162
11705,3515597467,3783368855,1672548338,1672549077,739
11623,3927181190,3277634944,1672609383,1672609544,161
10835,3512794667,3534122907,1672586754,1672589721,2967
9911,3226037966,3905955166,1672655527,1672656055,528
11162,3422205569,3804095239,1672642103,1672644240,2137
11642,3483701493,3518088154,1672568601,1672571834,3233
10876,3475033290,3311133296,1672662106,1672662172,66
10086,3715587520,3665603628,1672542244,1672544931,2687
10651,3856552205,3760529327,1672594017,1672595092,1075
10545,3792851584,3791289855,1672668854,1672670330,1476
11352,3201419050,3509470194,1672532676,1672533137,461
10035,3411213032,3393001196,1672650065,1672652144,2079
11646,3735152111,3305612422,1672582431,1672584014,1583
11014,3500421940,3458130310,1672593630,1672594229,599
9798,3701060732,3612705426,1672609414,1672612293,2879
11711,3245501577,3485468650,1672586010,1672586815,805
9816,3810949170,3772980989,1672601480,1672602518,1038
10928,3375257546,3514638555,1672545533,1672545986,453
11781,3559125467,3668154066,1672591825,1672592990,1165
11569,3791796190,3365839890,1672592053,1672593343,1290
10692,3287403291,3318056480,1672640833,1672642357,1524
10403,3832333115,3311904032,1672577881,1672579998,2117
10592,3779160052,3660496328,1672540532,1672541390,858
10947,3738103378,3469778316,1672661628,1672664866,3238
10237,3450234157,3426468199,1672604939,1672606024,1085
10464,3884862164,3736056340,1672680417,1672682551,2134
11096,3713606829,3310021925,1672691548,1672694088,2540
11758,3808849597,3711404205,1672671166,1672672808,1642
11747,3760274119,3667814788,1672586929,1672589097,2168
10550,3733870816,3234445133,1672660795,1672663513,2718
9809,3609103278,3308759754,1672577931,1672580170,2239
11768,3370751461,3827889533,1672586877,1672587529,652
10451,3201419050,3855674398,1672653287,1672656076,2789
10331,3458130310,3780941637,1672639384,1672641318,1934
10545,3284407073,3518947256,1672666292,1672668764,2472
11424,3933469838,3772291207,1672539731,1672542680,2949
9968,3201634072,3454554552,1672619052,1672620500,1448
10264,3783679478,3783201950,1672698813,1672699841,1028
10880,3338115824,3500329674,1672564482,1672566883,2401
11487,3971422524,3505804611,1672538572,1672541200,2628
11187,3520697518,3713102459,1672552818,1672555509,2691
10765,3896859936,3683514731,1672576899,1672578552,1653
11646,3927805949,3715750580,1672633025,1672633186,161
10209,3519703964,3974264211,1672566919,1672568373,1454
10494,3533703578,3518368900,1672541528,1672541937,409
9900,3450679913,3792708936,1672699587,1672703114,3527
9908,3716944983,3515706117,1672622481,1672622815,334
11058,3513802404,3509470194,1672584055,1672587620,3565
11760,3737622701,3715114417,1672699006,1672699946,940
11766,3836136159,3500793739,1672695996,1672696203,207
11756,3336501403,3776166086,1672653462,1672654817,1355
10724,3513840186,3501550490,1672541057,1672543914,2857
9898,3791825536,3500198430,1672619568,1672622769,3201
11101,3515047288,3380167818,1672687210,1672690465,3255
11302,3509912164,3220123678,1672552506,1672552616,110
10900,3921138062,3384601925,1672661896,1672665237,3341
10802,3513996288,3609166109,1672682485,1672683440,955
9834,3713996094,3500833053,1672682321,1672685257,2936
10400,3711243126,3687183789,1672674247,1672675541,1294
11551,3774296721,3813276198,1672688636,1672690466,1830
11431,3780740477,3903994989,1672652549,1672655593,3044
11114,3777149336,3613828705,1672571672,1672574086,2414
10895,3437286595,3447591143,1672657304,1672660770,3466
10242,3825082811,3919994216,1672600189,1672602333,2144
9965,3713807459,3511963020,1672581257,1672582725,1468
11700,3776727271,3402338011,1672636400,1672639854,3454
10549,3715320359,3515597467,1672626593,1672630175,3582
10521,3770172119,3757406215,1672586528,1672589623,3095
10681,3533703578,3979366845,1672668707,1672671121,2414
11419,3533009565,3777135415,1672677664,1672680848,3184
11026,3282240901,3714688409,1672611929,1672613904,1975
10788,3793689267,3517331746,1672670983,1672673353,2370
11144,3403257752,3516706121,1672618666,1672620245,1579
10184,3935569749,3367526113,1672579831,1672582189,2358
11371,3830599959,3618672178,1672543086,1672544803,1717
11109,3311264420,3772556646,1672563408,1672564397,989
11604,3780173788,3630802959,1672672436,1672675248,2812
10626,3716467469,3331228758,1672663713,1672664277,564
11147,3772216305,3970851830,1672540191,1672543565,3374
11617,3793996996,3519621901,1672549322,1672550621,1299
9996,3319436533,3494680853,1672559774,1672560784,1010
10946,3285322570,3534758256,1672669724,1672671796,2072
11521,3516585063,3733123020,1672578348,1672581149,2801
9921,3555215568,3517645656,1672659862,1672661586,1724
10961,3838423363,3311479294,1672664985,1672666136,1151
9832,3513508737,3345902033,1672670869,1672672945,2076
10540,3511867383,3439283360,1672543968,1672544450,482
9835,3445355677,3915679140,1672616116,1672617951,1835
10372,3685877449,3776187150,1672624097,1672624295,198
11328,3780733404,3500473064,1672559044,1672561478,2434
10706,3281970147,3307454562,1672674473,1672675107,634
11037,3358262975,3227919286,1672547852,1672549032,1180
10025,3420664407,3713475356,1672585970,1672587522,1552
11440,3534190196,3285322570,1672652477,1672654199,1722
10620,3203876438,3511198566,1672677380,1672680536,3156
10025,3302988745,3458130310,1672671668,1672674105,2437
11521,3819024145,3680988889,1672568192,1672569741,1549
9879,3931028233,3715680249,1672703146,1672705015,1869
11223,3739844610,3899294071,1672694481,1672697897,3416
9936,3465672238,3911376818,1672536119,1672538157,2038
10209,3534812391,3779706467,1672647710,1672648951,1241
11285,3711119575,3474879231,1672610304,1672612026,1722
11736,3701893620,3662495290,1672597256,1672600083,2827
10840,3430310785,3776727271,1672703823,1672705862,2039
10808,3682802569,3341311972,1672576716,1672578701,1985
11265,3703732445,3934070285,1672542744,1672544730,1986
10835,3938059867,3900766525,1672639482,1672639881,399
11107,3345954031,3505502819,1672556119,1672556256,137
11500,3773434690,3470962222,1672579938,1672581808,1870
10037,3970265139,3612042508,1672695848,1672696314,466
10326,3246567963,3372778334,1672560209,1672562274,2065
11432,3636857871,3500421940,1672647163,1672649309,2146
10117,3755230010,3208962614,1672676103,1672676535,432
11607,3515230715,3756736726,1672554916,1672555996,1080
11125,3555215568,3710082615,1672561706,1672564754,3048
10760,3715622084,3227647190,1672635662,1672637595,1933
10439,3474074188,3514021667,1672615265,1672615673,408
10529,3370401047,3509370016,1672638379,1672641518,3139
11723,3684651755,3518157683,1672560759,1672562958,2199
10423,3757198930,3733953055,1672620496,1672622438,1942
10568,3791434207,3236360179,1672611334,1672613317,1983
11420,3330466913,3385124073,1672682196,1672684803,2607
11344,3500440602,3835599049,1672614281,1672615517,1236
10982,3703588004,3511750850,1672617050,1672620508,3458
9890,3730571757,3822634862,1672663270,1672665214,1944
10956,3534204885,3510250740,1672580446,1672580525,79
11399,3687445224,3517552930,1672591435,1672591679,244
10422,3500928990,3209417223,1672575751,1672576279,528
10117,3311133296,3533822490,1672599480,1672602980,3500
11295,3685396470,3733915784,1672598369,1672600891,2522
10933,3437703650,3929446196,1672546918,1672549794,2876
10516,3924366353,3520725149,1672656359,1672656919,560
10779,3632303304,3774355339,1672632936,1672636238,3302
11616,3703779674,3505164060,1672609324,1672609750,426
10070,3509394912,3319660530,1672689145,1672689629,484
9953,3352295704,3511412229,1672558870,1672560941,2071
11336,3713373455,3512101369,1672572109,1672573359,1250
11261,3716733618,3774448657,1672550054,1672552088,2034
10542,3311569360,3512819376,1672697468,1672699818,2350
10134,3850904092,3773738817,1672598199,1672601779,3580
9905,3316551382,3791841318,1672548227,1672551369,3142
10878,3778986795,3804095239,1672640730,1672643762,3032
11574,3391854325,3730115019,1672564665,1672567122,2457
11651,3480185839,3760801237,1672600332,1672601825,1493
10491,3342837214,3773876312,1672679057,1672681815,2758
10934,3887030182,3511466117,1672699517,1672701116,1599
11606,3773840321,3391093411,1672557988,1672560955,2967
11373,3311264420,3881579907,1672558114,1672558583,469
10976,3429409539,3850993995,1672556011,1672556271,260
10884,3908464960,3623953446,1672692308,1672695861,3553
10229,3223177147,3518408734,1672595322,1672597967,2645
10655,3500429731,3399504157,1672607482,1672610553,3071
10422,3774304163,3515047288,1672639078,1672640882,1804
10565,3711196962,3243763209,1672691860,1672693944,2084
10462,3755342153,3287683210,1672538547,1672538817,270
11663,3773798215,3447202943,1672678660,1672680716,2056
10607,3515284733,3793407883,1672607701,1672610231,2530
9876,3905889514,3515681585,1672581551,1672581782,231
9892,3902292032,3246381831,1672542513,1672545690,3177
10255,3609997804,3776200012,1672607783,1672610771,2988
9883,3490804766,3455907179,1672662441,1672664360,1919
10271,3791841318,3227339675,1672576083,1672578787,2704
10465,3711131262,3203909360,1672575363,1672578842,3479
10704,3533440736,3757128722,1672659151,1672662530,3379
11518,3518511124,3931767736,1672602600,1672603089,489
11596,3510262025,3516572212,1672615644,1672617829,2185
10320,3773523569,3770981604,1672630775,1672631872,1097
10718,3711767051,3343193067,1672547062,1672547747,685
9917,3311260898,3245121919,1672612567,1672613718,1151
11326,3520860199,3770780655,1672690079,1672690820,741
10956,3554174421,3505416534,1672668659,1672670570,1911
11060,3511864772,3553321027,1672583217,1672584051,834
10259,3472718723,3770457058,1672697041,1672700574,3533
10780,3777060250,3520763492,1672647282,1672649702,2420
10417,3276230295,3711367577,1672578552,1672578684,132
10394,3852310652,3475845921,1672622516,1672624438,1922
10588,3238310644,3512641538,1672613767,1672616987,3220
10272,3501370430,3505291330,1672589115,1672592342,3227
10529,3893629892,3917811545,1672672210,1672674468,2258
10814,3393909269,3776348451,1672626577,1672629566,2989
11750,3730290851,3611832288,1672572592,1672576061,3469
10191,3517253559,3501253130,1672557261,1672557577,316
10203,3701385831,3774702364,1672604346,1672606691,2345
9897,3772909073,3346755179,1672685830,1672688631,2801
11006,3358675021,3934611532,1672534022,1672537407,3385
11266,3778604070,3778479297,1672556339,1672559310,2971
10931,3235198316,3888642876,1672677846,1672681026,3180
9973,3909822999,3772609551,1672697450,1672700194,2744
11775,3362385373,3401215739,1672586436,1672589897,3461
10698,3757001552,3452982957,1672692668,1672693579,911
11527,3557653200,3429610195,1672650319,1672650709,390
11416,3369270860,3778924002,1672636190,1672639022,2832
11327,3513816744,3829358750,1672661351,1672663702,2351
10099,3515047288,3773798215,1672551191,1672554185,2994
11263,3772802020,3687183789,1672649650,1672652216,2566
10180,3520165730,3422915648,1672691058,1672693860,2802
9907,3288346356,3435801763,1672586111,1672587888,1777
10868,3755361692,3450735824,1672575457,1672576265,808
11340,3512417028,3909220912,1672592015,1672594051,2036
11105,3755779925,3520506192,1672665729,1672667210,1481
10321,3776447604,3488333295,1672673769,1672674077,308
11665,3415032547,3509377714,1672655944,1672659269,3325
10637,3920526713,3354968884,1672554653,1672556351,1698
11646,3832002939,3515944817,1672647613,1672650891,3278
10133,3515284733,3491335890,1672700745,1672702028,1283
11377,3519465545,3779415433,1672648093,1672648491,398
10647,3391854325,3208519320,1672595927,1672596812,885
11422,3778824229,3208894215,1672614513,1672617770,3257
10506,3715204544,3300810210,1672568181,1672568417,236
11230,3757128722,3774090455,1672655520,1672656142,622
11555,3791382196,3778124514,1672614063,1672614262,199
10301,3760274119,3856552205,1672700504,1672700689,185
11166,3793874490,3512417028,1672631036,1672634000,2964
10996,3519780867,3488931357,1672596241,1672598105,1864
11357,3482639402,3515284733,1672627906,1672629836,1930
11215,3468343480,3505010941,1672676985,1672678771,1786
10816,3780423516,3245245283,1672598587,1672600131,1544
10468,3533628528,3929002318,1672601503,1672604533,3030
10199,3514306458,3604908372,1672695147,1672698113,2966
10309,3850181934,3714897456,1672553537,1672556406,2869
11137,3711947828,3505119470,1672591222,1672592123,901
11002,3270607273,3770715115,1672613440,1672614814,1374
11123,3714179543,3391093411,1672599028,1672602306,3278
11699,3716676869,3371132167,1672702890,1672705869,2979
10292,3711671702,3716492409,1672637848,1672641246,3398
11443,3703779674,3310021925,1672682582,1672684753,2171
10006,3703938162,3335055096,1672557186,1672557953,767
11328,3518408734,3338187803,1672603755,1672605040,1285
10139,3791074200,3812880543,1672693183,1672696019,2836
10746,3520725149,3777405860,1672677136,1672677475,339
10294,3909504515,3711029952,1672603265,1672603343,78
11394,3891272544,3505392452,1672684454,1672686100,1646
11427,3303432071,3736621212,1672560215,1672563174,2959
10833,3755790149,3518157683,1672593512,1672596250,2738
10124,3534775239,3710680073,1672558906,1672560891,1985
11364,3500019810,3890638402,1672634881,1672637376,2495
9988,3760232135,3668855144,1672596091,1672598295,2204
10728,3294952405,3777200549,1672535918,1672536489,571
10771,3505547832,3755369666,1672560049,1672561366,1317
11271,3370751461,3884934977,1672568151,1672571280,3129
11758,3615742989,3793689267,1672685583,1672688712,3129
11049,3511729562,3622218289,1672654913,1672655937,1024
10480,3491250381,3301403047,1672557873,1672559792,1919
11408,3378729459,3509828883,1672558144,1672559224,1080
11457,3501600785,3624365837,1672598783,1672599350,567
11742,3510781595,3374195945,1672643378,1672646148,2770
10716,3500726347,3714595459,1672638545,1672640774,2229
10064,3311529105,3512726649,1672547609,1672548964,1355
10940,3760554453,3907390925,1672580019,1672582894,2875
10955,3713996094,3512744657,1672545304,1672548890,3586
10330,3516585063,3614112171,1672551965,1672553161,1196
11648,3517325365,3415840750,1672638268,1672640147,1879
10727,3772251279,3510894809,1672686715,1672687671,956
10286,3711947828,3884180202,1672532517,1672534250,1733
10077,3896622009,3287734830,1672594599,1672596949,2350
9980,3520305100,3368176107,1672594167,1672595403,1236
10460,3533627473,3716526314,1672548012,1672549846,1834
9799,3770941125,3379400553,1672558107,1672559914,1807
11749,3505665253,3534937492,1672580866,1672584286,3420
10284,3378172464,3427741923,1672576432,1672579191,2759
10001,3636852764,3387700451,1672632801,1672635006,2205
11316,3239779992,3901169230,1672654586,1672656181,1595
11598,3301431129,3279726491,1672641144,1672643133,1989
10281,3382670400,3516731917,1672596767,1672600354,3587
10880,3452982957,3760074281,1672695376,1672695508,132
10628,3505155858,3776841808,1672648038,1672649705,1667
11537,3454151554,3772164469,1672688025,1672688808,783
11531,3554317844,3739618347,1672605476,1672608477,3001
10147,3622729771,3382696725,1672668513,1672671821,3308
10804,3429610195,3513213122,1672608896,1672609729,833
11179,3533960602,3279851026,1672571569,1672573647,2078
10967,3220987526,3311602936,1672573634,1672576479,2845
10952,3416474842,3517991042,1672546481,1672548666,2185
9808,3505496725,3804095239,1672657561,1672659496,1935
10453,3900195680,3774304163,1672569350,1672570616,1266
11168,3274894848,3501550490,1672534281,1672536267,1986
11253,3340723781,3487622510,1672673321,1672675409,2088
10834,3710125627,3500473064,1672634378,1672635832,1454
11280,3897003751,3501244753,1672602953,1672604719,1766
10082,3472901378,3778824229,1672611284,1672613521,2237
10552,3284483177,3318220119,1672622266,1672623016,750
11455,3919349138,3711947828,1672601872,1672604466,2594
11576,3335974305,3760274119,1672594546,1672595315,769
11360,3515379622,3209280342,1672581939,1672583727,1788
11526,3884001167,3384170206,1672597354,1672598097,743
10139,3311774510,3380167818,1672605919,1672606992,1073
11165,3974668678,3285322570,1672551715,1672552868,1153
10170,3333505404,3680832669,1672537224,1672538533,1309
10891,3428878402,3247075753,1672594141,1672596984,2843
11367,3776778306,3716020849,1672682232,1672685409,3177
11281,3735422623,3478937459,1672585617,1672586397,780
10997,3776182849,3917243005,1672626036,1672628385,2349
10670,3475090917,3393502004,1672611144,1672612838,1694
10525,3895839169,3441683673,1672619049,1672619979,930
11421,3380185102,3689420679,1672544490,1672546346,1856
10234,3757678397,3209417223,1672645605,1672648822,3217
10868,3288791629,3683562111,1672658769,1672660049,1280
10522,3510178791,3534531039,1672614087,1672614601,514
10115,3773202954,3243056734,1672655409,1672658873,3464
11606,3776407517,3235198316,1672700330,1672703860,3530
10585,3755230010,3778695895,1672532781,1672533924,1143
11359,3500654356,3294164983,1672535273,1672536932,1659
10623,3513739060,3822786416,1672533466,1672534178,712
10204,3533642281,3519937708,1672556584,1672557273,689
10860,3500889287,3501557463,1672553450,1672554617,1167
10849,3395082458,3510244209,1672654221,1672654364,143
9939,3399734748,3534984243,1672671771,1672674310,2539
10626,3757872458,3730600658,1672588524,1672591379,2855
10681,3516249472,3509912164,1672665241,1672665320,79
9950,3517149023,3379400553,1672573840,1672575761,1921
11669,3429587594,3773579644,1672588269,1672590081,1812
10152,3406238754,3907225070,1672689510,1672692649,3139
11223,3554317844,3534328311,1672536751,1672538561,1810
10401,3668202976,3310702648,1672685855,1672687685,1830
9831,3513894659,3778838936,1672695941,1672699239,3298
11033,3491527603,3483347530,1672579997,1672581407,1410
11580,3515548696,3302348002,1672648017,1672649966,1949
10171,3701265238,3916924978,1672676834,1672677554,720
10279,3716178116,3505531432,1672675904,1672679478,3574
11407,3500922040,3604908372,1672538142,1672538933,791
10460,3632189887,3369810091,1672700148,1672701348,1200
10018,3517325365,3710316008,1672675006,1672676963,1957
10869,3779212271,3519435459,1672693370,1672693767,397
11746,3701060732,3372778334,1672647128,1672650262,3134
11678,3974400577,3639503148,1672701868,1672704398,2530
11727,3756066702,3755769254,1672596018,1672597780,1762
10981,3387621912,3635433296,1672625202,1672626089,887
10250,3881785069,3520362238,1672646100,1672646693,593
11224,3898592058,3715852330,1672557829,1672558751,922
11425,3461743188,3701385831,1672573919,1672576698,2779
11055,3832312129,3772683155,1672537122,1672539728,2606
11743,3534111498,3509433155,1672667809,1672668738,929
11723,3311260898,3621960662,1672600266,1672603043,2777
11310,3755767856,3793719515,1672543268,1672546799,3531
9971,3618672178,3514515499,1672636735,1672637239,504
10477,3397783490,3772216305,1672538322,1672538720,398
11339,3442462115,3515100211,1672662987,1672663096,109
10702,3755584983,3715897627,1672552109,1672553505,1396
10327,3822315407,3368441333,1672627876,1672628970,1094
10903,3756890980,3347996015,1672562120,1672564637,2517
11165,3703572036,3517902505,1672585390,1672588936,3546
9858,3349573092,3242149533,1672577599,1672578898,1299
10367,3737685967,3793822639,1672538377,1672538883,506
9799,3513143959,3772893815,1672596803,1672598905,2102
10220,3886879696,3669918958,1672638159,1672639633,1474
10355,3533703578,3228218081,1672574438,1672576109,1671
11133,3630802959,3783879023,1672587405,1672590576,3171
11015,3353194923,3500720752,1672560358,1672561023,665
11253,3776279305,3760271237,1672673106,1672676217,3111
10325,3730290851,3311200541,1672537454,1672537951,497
11051,3505097206,3447591143,1672545063,1672547861,2798
10255,3628423403,3512753567,1672595006,1672598450,3444
10946,3509377714,3757393413,1672644751,1672645320,569
9953,3360837082,3307236682,1672677418,1672678949,1531
10134,3715790104,3406492167,1672612470,1672614699,2229
11736,3447253775,3756345026,1672591430,1672593680,2250
11054,3837435907,3801501384,1672595616,1672597009,1393
10936,3756843139,3505853594,1672674294,1672676288,1994
11335,3510882576,3884934977,1672694325,1672696718,2393
11059,3793704155,3445077330,1672672215,1672674973,2758
9921,3898595916,3730459093,1672544440,1672547814,3374
10357,3701919083,3395610742,1672575350,1672577965,2615
10007,3505173665,3826418889,1672594188,1672595715,1527
10388,3770564547,3238056215,1672682739,1672683061,322
10137,3473520701,3793704155,1672645243,1672648535,3292
10136,3858497718,3468343480,1672534168,1672536487,2319
11420,3518534560,3975799349,1672534557,1672537377,2820
10381,3500695402,3309415277,1672573457,1672573550,93
11679,3534426696,3774394000,1672646118,1672649623,3505
11643,3447554599,3295710494,1672632717,1672635570,2853
10575,3815184540,3770846374,1672620015,1672620434,419
11265,3711947828,3553694590,1672547095,1672548114,1019
10261,3465672238,3900540310,1672588350,1672588423,73
9952,3738873928,3476308535,1672694733,1672695692,959
11161,3518209090,3711770773,1672603145,1672603804,659
11353,3817478012,3791121243,1672687664,1672687767,103
11667,3779478448,3929355087,1672591786,1672592237,451
11530,3783947742,3774145748,1672588806,1672592283,3477
11003,3488887919,3908464960,1672562753,1672565499,2746
10876,3311696372,3716976932,1672703627,1672706841,3214
10091,3382757142,3826315540,1672625627,1672627440,1813
11140,3512490032,3805704844,1672588090,1672590261,2171
11601,3714870496,3558567160,1672672295,1672672434,139
10284,3534284132,3777370601,1672600343,1672600569,226
10640,3510244209,3971289056,1672689274,1672691988,2714
11620,3912811715,3446066492,1672690384,1672693061,2677
11313,3780982229,3664719070,1672698178,1672700441,2263
10068,3449672240,3716183063,1672692447,1672693962,1515
10614,3774965463,3387971464,1672607094,1672610317,3223
10175,3773603836,3313101243,1672570631,1672572355,1724
9981,3515715968,3514576083,1672605803,1672606575,772
11072,3660980656,3815440588,1672608037,1672610297,2260
10118,3791222330,3516335333,1672571220,1672574663,3443
9999,3520339198,3500785888,1672647560,1672650088,2528
11169,3756948477,3302348002,1672576873,1672580467,3594
11145,3791108593,3714688409,1672698115,1672699883,1768
10647,3701218904,3898965585,1672664196,1672664588,392
10407,3977209952,3770533588,1672691790,1672694035,2245
11503,3505331014,3500785888,1672640269,1672642984,2715
10293,3362385373,3730226545,1672566633,1672568634,2001
10738,3505994703,3226761201,1672644919,1672646209,1290
11648,3493598658,3334936138,1672627385,1672628693,1308
10993,3779468781,3422915648,1672595964,1672596382,418
10062,3613781977,3887382548,1672619722,1672623099,3377
11556,3777672363,3619538249,1672694445,1672695702,1257
10104,3710865678,3515405509,1672674726,1672676869,2143
10664,3813276198,3701065296,1672536364,1672537567,1203
11788,3510775046,3380185102,1672577267,1672580289,3022
10940,3481365330,3774109138,1672687702,1672689307,1605
11754,3500591274,3534374523,1672648440,1672649629,1189
11179,3512411326,3714806574,1672578397,1672581206,2809
11153,3757994002,3732090606,1672531739,1672535176,3437
10966,3519494023,3732467455,1672690726,1672691985,1259
10956,3289258397,3510143850,1672577604,1672580618,3014
9891,3711179193,3461741050,1672631313,1672634221,2908
10728,3770976984,3512546783,1672592916,1672593274,358
11024,3514761434,3275751794,1672620626,1672622941,2315
9881,3710185376,3755286041,1672635592,1672636990,1398
10215,3755989680,3517210356,1672531812,1672533746,1934
11607,3883640904,3287753579,1672695938,1672697635,1697
11680,3713102459,3884862164,1672667288,1672667858,570
11717,3616242727,3756736726,1672607029,1672607742,713
10089,3662522808,3316406470,1672573340,1672573528,188
9842,3377311502,3855440101,1672638898,1672640210,1312
11684,3772055279,3510968599,1672638061,1672638887,826
11481,3777909822,3519351747,1672632908,1672636216,3308
11070,3713283029,3925823748,1672635828,1672639394,3566
11201,3534284132,3760710525,1672625342,1672628139,2797
10863,3772489471,3275661834,1672580860,1672583334,2474
11617,3208560443,3910049345,1672655113,1672656568,1455
11607,3369270860,3207307681,1672602089,1672603875,1786
10915,3533876927,3274894848,1672641053,1672643283,2230
10025,3778738044,3977209952,1672579519,1672580708,1189
10932,3770497768,3792851584,1672635272,1672635476,204
10482,3776309810,3818532143,1672603340,1672605869,2529
10073,3792797648,3501550490,1672623432,1672625569,2137
10809,3791108593,3499343927,1672600455,1672602493,2038
10046,3248409083,3780074082,1672616721,1672617482,761
10634,3375906394,3511095300,1672651985,1672654360,2375
11353,3415803494,3394976623,1672615034,1672617003,1969
11714,3351856699,3909632424,1672675856,1672678065,2209
11093,3512768285,3975799349,1672696826,1672697846,1020
10485,3446810761,3755670258,1672604779,1672606984,2205
11434,3505828210,3636015050,1672547502,1672548644,1142
9994,3735422623,3701127475,1672534576,1672537115,2539
11363,3713726267,3390438262,1672583039,1672583113,74
11668,3495427619,3900195680,1672544799,1672546186,1387
11123,3519848902,3780626668,1672678366,1672678926,560
11014,3935333166,3471507117,1672620795,1672623408,2613
10534,3500994763,3881012415,1672567568,1672568462,894
10328,3605078841,3667814788,1672543506,1672545087,1581
11327,3487395357,3208594306,1672676943,1672680526,3583
11231,3369108286,3738103378,1672699804,1672702317,2513
10842,3780648744,3381254180,1672640386,1672642783,2397
11449,3501370430,3516969689,1672703104,1672704354,1250
11703,3628423403,3407734098,1672538218,1672539738,1520
10930,3756079870,3513140146,1672682257,1672682766,509
9816,3505032773,3807584987,1672675514,1672676321,807
10633,3439532406,3780500764,1672545167,1672548039,2872
10459,3310712221,3428198021,1672603377,1672604737,1360
10126,3911376818,3774682234,1672618660,1672620198,1538
10820,3240683148,3711404205,1672666582,1672668848,2266
11333,3780563627,3714283424,1672584169,1672584744,575
11753,3905934770,3491250381,1672553387,1672555377,1990
10622,3515507526,3318224774,1672699197,1672701047,1850
11340,3514013999,3421674406,1672549020,1672549215,195
11723,3772786559,3682241594,1672643994,1672645933,1939
10601,3206544535,3772216305,1672672282,1672674799,2517
10690,3715039960,3455907179,1672537891,1672540265,2374
10276,3378747834,3505248368,1672667501,1672670437,2936
10030,3515284733,3714951681,1672544033,1672545061,1028
11588,3283785820,3716178116,1672587233,1672587415,182
9874,3233917789,3511069449,1672635418,1672638503,3085
11512,3783947742,3783947742,1672617578,1672620943,3365
11236,3304661369,3919814073,1672607986,1672609766,1780
11497,3246381831,3613703906,1672572612,1672573241,629
10377,3358262975,3774448657,1672630674,1672633712,3038
10941,3239990061,3519255644,1672636603,1672638961,2358
11454,3619705594,3813986705,1672576782,1672577602,820
10356,3452802329,3371238318,1672620126,1672623086,2960
9896,3310737478,3713159131,1672603487,1672606456,2969
10270,3479452888,3977880564,1672616803,1672618056,1253
10263,3206926634,3715320359,1672636206,1672637300,1094
10492,3516257130,3294164983,1672562161,1672564992,2831
11559,3491527603,3715737742,1672560756,1672563642,2886
9833,3500415589,3701291994,1672583447,1672584160,713
10717,3701685828,3806720019,1672659476,1672662936,3460
10149,3703476890,3770981604,1672681154,1672682141,987
11610,3711131262,3792475476,1672667217,1672668007,790
10958,3505066871,3772882440,1672641809,1672642587,778
10564,3715750580,3398075553,1672547903,1672548870,967
10016,3713767153,3455430943,1672617775,1672619336,1561
10743,3703277359,3760069457,1672584120,1672585795,1675
10136,3716179251,3755729826,1672574623,1672576129,1506
10275,3515939841,3514980025,1672561030,1672564221,3191
9936,3368441333,3772296376,1672616359,1672616771,412
10576,3624365837,3773878451,1672630215,1672630992,777
9869,3703476890,3533154906,1672673410,1672673751,341
10550,3756413374,3514107131,1672594888,1672597274,2386
10872,3299847117,3760748418,1672546424,1672549114,2690
10430,3927504954,3516585063,1672649124,1672651675,2551
11312,3311264420,3710228292,1672647741,1672649513,1772
10104,3304227085,3792008302,1672612392,1672614846,2454
10126,3450679913,3509355477,1672609129,1672609446,317
11348,3885645840,3400903513,1672587272,1672588771,1499
10116,3662307789,3668855144,1672677755,1672679439,1684
11759,3880549316,3713224986,1672657425,1672659867,2442
10858,3857244486,3512251592,1672586199,1672588889,2690
11171,3534626053,3399430522,1672591077,1672593541,2464
10698,3774706478,3201656220,1672561390,1672563006,1616
10689,3774221318,3398489033,1672666736,1672667760,1024
10462,3780213684,3908862092,1672628187,1672630072,1885
10267,3452389513,3402774497,1672613738,1672614659,921
11289,3850735936,3295787354,1672665917,1672665986,69
11599,3393376416,3249614888,1672604242,1672605972,1730
11304,3905358065,3739618347,1672570604,1672573739,3135
10500,3885339157,3773768643,1672584525,1672584673,148
11323,3501550490,3907390925,1672683810,1672686681,2871
10900,3681701931,3516340010,1672608876,1672609455,579
10178,3732467455,3311305760,1672583891,1672586896,3005
9859,3755170743,3500814753,1672662487,1672663589,1102
10693,3207497598,3233712975,1672533511,1672534933,1422
11165,3710783759,3413511621,1672595389,1672598635,3246
10364,3757796416,3515378306,1672591561,1672594988,3427
10596,3510149298,3791205793,1672640532,1672640719,187
11339,3440305508,3774109138,1672650165,1672650662,497
10958,3514941815,3829358750,1672689060,1672691394,2334
10407,3478206139,3311805161,1672559382,1672561008,1626
10031,3732540636,3803382101,1672585370,1672586092,722
11708,3778713526,3450735824,1672626416,1672628503,2087
10761,3519356606,3302929858,1672574176,1672575521,1345
10461,3307454562,3667950469,1672546869,1672548421,1552
11329,3200785194,3885645840,1672661258,1672661633,375
10176,3505720915,3505010941,1672700658,1672702900,2242
10163,3476308535,3301449986,1672627545,1672628013,468
11235,3716891903,3500421940,1672542148,1672544273,2125
11328,3501734800,3387322545,1672665909,1672668548,2639
10073,3512343029,3801379377,1672534553,1672537308,2755
11003,3505011956,3776200012,1672541365,1672541776,411
9881,3384713976,3812880543,1672683282,1672685025,1743
9857,3773440794,3514021667,1672692760,1672693774,1014
10117,3294949958,3770018912,1672676595,1672677120,525
10961,3361711720,3333355914,1672533853,1672536170,2317
11413,3514005973,3509503263,1672697606,1672701189,3583
11307,3352295704,3760854788,1672545236,1672548484,3248
10448,3772112976,3231859576,1672622988,1672625831,2843
10220,3713923960,3301403047,1672567494,1672570988,3494
11204,3293579860,3760382349,1672617807,1672619021,1214
11482,3511289729,3278251248,1672672034,1672675496,3462
11119,3791106473,3828568868,1672667466,1672668536,1070
10296,3509370633,3205113625,1672664566,1672665951,1385
11336,3774946684,3812559393,1672667292,1672668182,890
11394,3773826624,3774436159,1672546006,1672548881,2875
11099,3825932442,3500543341,1672540875,1672540959,84
11092,3666958814,3703611876,1672610797,1672612077,1280
10292,3223512565,3501988762,1672574583,1672577382,2799
11543,3703419800,3336501403,1672650596,1672653243,2647
11509,3971280379,3287094447,1672669222,1672672439,3217
9820,3713969196,3835982340,1672655012,1672657198,2186
10857,3714471069,3436099135,1672677304,1672678173,869
11217,3519357822,3805616707,1672586283,1672589522,3239
10565,3286938590,3310702648,1672562673,1672564411,1738
11091,3534562354,3628423403,1672594178,1672594994,816
11435,3310961923,3732467455,1672571240,1672573583,2343
9849,3971447562,3710149975,1672614712,1672616495,1783
10193,3491758029,3773134128,1672635766,1672637471,1705
10454,3553321027,3603167427,1672575022,1672576921,1899
10618,3772250554,3772250554,1672546810,1672549761,2951
11786,3243651036,3614484939,1672685196,1672686296,1100
10026,3715680249,3291153514,1672619489,1672619599,110
10028,3520012007,3888523259,1672567166,1672567415,249
10546,3780969898,3278805844,1672583550,1672585871,2321
10548,3244397548,3509544691,1672608128,1672609567,1439
10630,3466655775,3553321027,1672664935,1672667533,2598
10473,3394364348,3773697080,1672623359,1672626620,3261
11436,3827981800,3858429342,1672547884,1672551092,3208
11785,3813276198,3516588277,1672555845,1672558591,2746
10671,3424988692,3715750580,1672694910,1672697918,3008
10936,3307454562,3435037864,1672601074,1672603452,2378
11123,3516454693,3375905193,1672696420,1672696569,149
10994,3334708091,3447267291,1672639281,1672641311,2030
11454,3228033254,3414841458,1672587701,1672588749,1048
10205,3711015176,3415032547,1672662091,1672664112,2021
11063,3485468650,3776534957,1672558212,1672559360,1148
11063,3930727474,3619676231,1672697281,1672699636,2355
11195,3701519251,3316406470,1672607182,1672608731,1549
9919,3316117186,3920526713,1672636589,1672637091,502
11710,3714892312,3276393542,1672605764,1672606975,1211
10093,3514980025,3345896913,1672541026,1672542120,1094
10158,3509317054,3511382748,1672548486,1672551905,3419
10234,3732128078,3760648750,1672647933,1672649289,1356
10087,3520506192,3343511947,1672609926,1672612910,2984
11270,3732467455,3510278533,1672675040,1672677143,2103
11554,3206544535,3377883705,1672683437,1672686042,2605
10395,3908550561,3778044082,1672552553,1672553570,1017
10768,3972653129,3373018943,1672606918,1672609630,2712
10981,3287403291,3452878062,1672615438,1672616983,1545
11612,3662354016,3483078667,1672560803,1672561701,898
10377,3330799389,3204821370,1672555895,1672559409,3514
11521,3977615973,3500821475,1672628123,1672628400,277
11219,3711015176,3416225867,1672656097,1672658521,2424
11459,3246395239,3710046567,1672640468,1672643045,2577
11497,3701971784,3777937949,1672683690,1672684149,459
11342,3239423794,3711015176,1672587657,1672588987,1330
10373,3711430738,3937636109,1672614715,1672615486,771
11497,3501271930,3915195160,1672662478,1672665554,3076
9997,3499711458,3435652260,1672613444,1672616290,2846
10172,3600978954,3505839395,1672626017,1672627444,1427
11611,3505359060,3505245692,1672548373,1672550091,1718
10404,3731644240,3505720915,1672591821,1672592745,924
11737,3701668745,3515284733,1672545599,1672546709,1110
11089,3501004005,3342495377,1672639298,1672640508,1210
11425,3802374620,3793375825,1672613851,1672615427,1576
10984,3464622743,3770285500,1672540026,1672541376,1350
11683,3714892312,3368951504,1672538310,1672538501,191
11738,3519352855,3933469838,1672701820,1672704726,2906
10298,3805616707,3533030343,1672614693,1672617151,2458
10187,3701028092,3713514933,1672597108,1672597468,360
11730,3710316008,3930475498,1672625602,1672625716,114
10240,3501261089,3400903513,1672669346,1672671865,2519
10639,3452024572,3311188620,1672560588,1672563412,2824
10961,3619796619,3291153514,1672617442,1672621029,3587
11304,3534426696,3501261089,1672537486,1672541076,3590
10699,3713954144,3513092056,1672585086,1672586842,1756
10261,3701663839,3835982340,1672592495,1672592735,240
10078,3518164450,3433902955,1672601763,1672604923,3160
11664,3774939922,3509317776,1672536584,1672537557,973
10991,3429610195,3278779955,1672673953,1672674924,971
11432,3501137133,3932955949,1672627464,1672630529,3065
11273,3209925780,3284407073,1672699945,1672702501,2556
11389,3772262649,3311774510,1672640474,1672642801,2327
10252,3440401725,3297624618,1672532989,1672533134,145
11265,3793232021,3203457161,1672625919,1672627961,2042
11283,3347140733,3514389188,1672661454,1672663603,2149
11627,3518164450,3231654754,1672561872,1672564493,2621
10170,3391612879,3369810091,1672545518,1672548234,2716
11556,3755357292,3292663993,1672571575,1672573333,1758
10606,3711755596,3793232021,1672631215,1672631536,321
10812,3331228758,3912862842,1672555393,1672556814,1421
10593,3308744016,3520160414,1672568125,1672570543,2418
10979,3835982340,3517045396,1672624853,1672627566,2713
11530,3780969898,3505392452,1672601746,1672603922,2176
10396,3757446082,3783043770,1672693313,1672694129,816
10371,3440770466,3368079099,1672536015,1672539257,3242
10640,3479585868,3279851026,1672694752,1672695663,911
11044,3402020492,3361789225,1672666029,1672666299,270
9881,3510864325,3792719263,1672700847,1672702244,1397
10406,3770630937,3352057037,1672594535,1672596777,2242
11469,3512411326,3713807459,1672602939,1672604560,1621
9875,3703749690,3713475356,1672643857,1672646089,2232
10216,3919342147,3716460706,1672532605,1672536101,3496
11460,3500096103,3908862092,1672531353,1672534711,3358
10202,3515405509,3713336088,1672585871,1672588579,2708
10236,3450164574,3511296895,1672634915,1672637735,2820
11549,3817478012,3716160006,1672644255,1672647524,3269
11434,3403218814,3756685732,1672537768,1672539661,1893
9824,3352044245,3780921044,1672661005,1672662193,1188
10278,3505571800,3770595035,1672655765,1672657916,2151
10262,3293673220,3716118473,1672624779,1672627405,2626
10190,3778125688,3559759778,1672582553,1672585506,2953
11205,3513486828,3443580855,1672631393,1672633900,2507
11000,3520165730,3776068937,1672664419,1672665879,1460
10818,3516429380,3509382404,1672665336,1672665686,350
10343,3624365837,3500145103,1672617447,1672619390,1943
10073,3894495222,3520339198,1672551586,1672555184,3598
10527,3825932442,3512251592,1672570237,1672572755,2518
11735,3534068874,3510894809,1672682614,1672682753,139
11244,3550405857,3415840750,1672535174,1672536045,871
9949,3757660578,3488749569,1672628517,1672630107,1590
11615,3209958726,3776034313,1672685970,1672688734,2764
10232,3914947393,3519356606,1672544601,1672547039,2438
10655,3273537848,3822496670,1672601328,1672602698,1370
11060,3783172505,3809860102,1672604583,1672606507,1924
11635,3716118473,3364302157,1672567243,1672569924,2681
10887,3778479297,3443004958,1672579546,1672583076,3530
10446,3899205452,3387870683,1672645877,1672649087,3210
10628,3778253021,3505037247,1672533724,1672536918,3194
11141,3713219299,3773878451,1672622917,1672623961,1044
10275,3919994216,3792440162,1672641218,1672643079,1861
10548,3713219299,3388537708,1672568422,1672571193,2771
11072,3505786561,3777878462,1672618041,1672619537,1496
10944,3660163550,3779665641,1672535679,1672537607,1928
11046,3513250976,3791716170,1672644998,1672647053,2055
11334,3713969196,3511476353,1672540838,1672542451,1613
10589,3310961923,3534111498,1672672858,1672673476,618
11777,3791409441,3858330969,1672558328,1672559649,1321
11679,3773636983,3772235668,1672644941,1672645866,925
10642,3882851213,3779561601,1672697645,1672698880,1235
11286,3853783593,3937636109,1672643557,1672643969,412
10651,3400560073,3294952405,1672675169,1672677195,2026
10667,3760737203,3298113026,1672633353,1672636306,2953
10841,3755507566,3450679913,1672626344,1672627692,1348
10430,3815700240,3368176107,1672673509,1672674095,586
10512,3514297012,3516321814,1672635024,1672635776,752
10947,3342252701,3556684272,1672582592,1672583466,874
10876,3600871715,3808849597,1672543914,1672544274,360
10405,3760537855,3770172119,1672676658,1672680252,3594
11537,3510439480,3793902476,1672603356,1672606628,3272
10710,3342235058,3511382748,1672563758,1672564567,809
11416,3511415786,3511198566,1672625928,1672628930,3002
10469,3485521840,3517949586,1672656063,1672657962,1899
10582,3777992576,3437703650,1672659880,1672663319,3439
11702,3774633364,3400186699,1672692506,1672694024,1518
10364,3774589551,3447078933,1672577519,1672580452,2933
11584,3515047288,3688130094,1672535752,1672536896,1144
10894,3636927297,3701725839,1672616945,1672617887,942
11304,3715897627,3661543201,1672539198,1672541167,1969
10273,3289771213,3829761380,1672640306,1672642097,1791
11328,3803382101,3714268380,1672699442,1672701862,2420
10739,3713069234,3464622743,1672611754,1672612021,267
10385,3236948071,3780740477,1672649764,1672651842,2078
11551,3303772923,3735422623,1672612998,1672616171,3173
10008,3805704844,3516249472,1672581363,1672584454,3091
10496,3703749690,3505665253,1672676481,1672679978,3497
9890,3818570577,3773534165,1672613941,1672615096,1155
10375,3850735936,3907039612,1672592625,1672593165,540
11691,3806471413,3910049345,1672656141,1672657876,1735
10560,3780500764,3773738817,1672684004,1672686795,2791
10836,3756437169,3783313202,1672631291,1672634259,2968
10802,3390438262,3793497672,1672676026,1672676263,237
10098,3774401596,3519621901,1672703519,1672704925,1406
11206,3500640854,3512794667,1672595876,1672598487,2611
10464,3703351452,3773134128,1672635410,1672636431,1021
11731,3777932225,3714951681,1672604059,1672607312,3253
10363,3716740576,3510882576,1672607780,1672610866,3086
10736,3835599049,3313282478,1672582951,1672586050,3099
10134,3835262447,3515378306,1672604081,1672606920,2839
10897,3839744168,3477248170,1672655634,1672656191,557
10002,3880882684,3807584987,1672543260,1672543530,270
10569,3836757034,3360309868,1672676968,1672680364,3396
10940,3534372899,3793822639,1672596885,1672599511,2626
11112,3287689454,3500178849,1672637500,1672638050,550
10633,3792824886,3703938162,1672631109,1672633362,2253
10120,3509167758,3513140146,1672540037,1672543052,3015
10804,3778182724,3756616853,1672557182,1672560771,3589
11051,3533113740,3471996194,1672540766,1672544142,3376
9960,3424476995,3825877848,1672630969,1672633903,2934
11394,3376842515,3792900315,1672535124,1672537814,2690
10898,3779818784,3511744756,1672618645,1672619862,1217
11227,3505491969,3362706073,1672633241,1672636795,3554
9898,3534531039,3713475356,1672649963,1672652246,2283
10804,3852461753,3500863429,1672658363,1672658743,380
10983,3457249798,3334381941,1672554219,1672554895,676
11699,3791905743,3881785069,1672592455,1672592690,235
10190,3513213122,3348100657,1672621828,1672624750,2922
11185,3660163550,3553229537,1672678052,1672678751,699
9960,3235198316,3774921252,1672607164,1672607838,674
10324,3209075485,3619538249,1672577971,1672579565,1594
10286,3755229631,3715700639,1672538074,1672541524,3450
10785,3935520819,3388774559,1672664840,1672666875,2035
10105,3510368377,3347172556,1672565315,1672566824,1509
11186,3505234868,3512288503,1672642274,1672642919,645
10469,3895944547,3613940925,1672582206,1672585125,2919
11417,3466655775,3361635547,1672606976,1672607791,815
10078,3372617110,3703999217,1672658718,1672660516,1798
10025,3519108639,3908177413,1672585816,1672587430,1614
11336,3362706073,3505786561,1672592390,1672595849,3459
10868,3228997424,3810584695,1672701475,1672704947,3472
11697,3384601925,3519937708,1672571275,1672574483,3208
11378,3533627473,3500198430,1672584123,1672587572,3449
10779,3902300755,3501515425,1672545557,1672547010,1453
10221,3422959249,3756998113,1672639198,1672641342,2144
9995,3831864108,3373851012,1672538485,1672541593,3108
11087,3667654673,3227059650,1672651344,1672654807,3463
9883,3778713526,3468343480,1672554461,1672556671,2210
10914,3516572212,3772070986,1672653250,1672654419,1169
10399,3367121615,3686211958,1672618390,1672621674,3284
10875,3703438617,3777672363,1672672674,1672674093,1419
9843,3519351747,3716183063,1672592094,1672593145,1051
9853,3220660616,3509317054,1672692837,1672693517,680
10302,3439283360,3803996569,1672630403,1672631952,1549
10184,3358434853,3459163055,1672695927,1672697811,1884
11290,3623512088,3633294415,1672605356,1672608359,3003
11628,3311989687,3500415589,1672654432,1672655226,794
10418,3776811587,3779454060,1672607210,1672610652,3442
10695,3228033254,3666958814,1672610643,1672612169,1526
9952,3380167818,3294164983,1672674813,1672677868,3055
10847,3639465750,3755378125,1672632620,1672632802,182
11167,3393543588,3756759239,1672574514,1672577780,3266
10522,3347205332,3517426473,1672593939,1672595297,1358
10275,3425260097,3533419409,1672661995,1672664613,2618
11177,3910020031,3519463038,1672627850,1672630743,2893
10119,3520515739,3446810761,1672616229,1672619279,3050
10832,3534491112,3773669001,1672574419,1672574972,553
10131,3711718368,3884001167,1672676134,1672679258,3124
11210,3779561601,3311924005,1672580040,1672581130,1090
10862,3201957157,3714787207,1672683100,1672684775,1675
11623,3306066522,3776291254,1672608667,1672610526,1859
9873,3907225070,3716341323,1672676660,1672678951,2291
10149,3442462115,3836136159,1672674372,1672675979,1607
11293,3662495290,3482786946,1672685816,1672688553,2737
9835,3812261241,3319436533,1672542036,1672545205,3169
10343,3711518637,3917811545,1672573384,1672573492,108
10646,3511218261,3202787155,1672690146,1672691552,1406
11305,3714903253,3770457058,1672691984,1672694374,2390
9869,3850108828,3441840658,1672695845,1672697405,1560
10549,3319061210,3703588004,1672694312,1672697330,3018
11674,3314965818,3890194669,1672678563,1672679803,1240
10654,3516668203,3772845364,1672604724,1672607825,3101
11517,3793948300,3345896913,1672594315,1672596692,2377
11406,3779102237,3714688409,1672582803,1672584842,2039
10641,3505155858,3358434853,1672540936,1672542092,1156
11041,3501853868,3779706467,1672656629,1672657671,1042
10655,3226913558,3514145752,1672575537,1672577872,2335
10127,3791072829,3456795601,1672693303,1672694990,1687
10651,3245121919,3305612422,1672690728,1672691422,694
11650,3510882475,3509377714,1672696900,1672698481,1581
11369,3716209499,3344710271,1672617360,1672620221,2861
11563,3458753033,3290060215,1672624099,1672625895,1796
11374,3791581138,3462153833,1672702143,1672703917,1774
9867,3715111016,3779282072,1672700417,1672703888,3471
10717,3856601074,3418382025,1672638682,1672641067,2385
10197,3515764058,3711349327,1672633718,1672636179,2461
9816,3228056289,3804095239,1672684531,1672687005,2474
10514,3513215373,3396472026,1672667404,1672669623,2219
10726,3853275529,3348100657,1672655424,1672658640,3216
11383,3780749789,3818461836,1672646028,1672647065,1037
10813,3716179251,3516572212,1672597092,1672597796,704
10001,3738760498,3484490325,1672536639,1672538124,1485
10200,3791581138,3489340327,1672658599,1672659560,961
9826,3755865626,3760749218,1672687789,1672690055,2266
10407,3773424266,3372617110,1672606297,1672608545,2248
10431,3505684690,3515470462,1672535834,1672536060,226
11065,3760749218,3520471156,1672613134,1672614313,1179
10819,3534531061,3337715675,1672630398,1672631595,1197
10197,3505351253,3602570831,1672699628,1672702796,3168
10169,3519997661,3760382349,1672548699,1672549381,682
11647,3439045964,3730414796,1672677253,1672678205,952
11417,3703624327,3559619861,1672675241,1672676270,1029
10453,3472561941,3792824886,1672672181,1672675684,3503
11413,3711889178,3282240901,1672536867,1672539800,2933
11033,3500356342,3776348472,1672545268,1672547775,2507
9970,3516321993,3663505156,1672695278,1672695853,575
10107,3791825536,3248409083,1672559567,1672560275,708
10684,3739297004,3435715962,1672531628,1672532203,575
10929,3896622009,3533340292,1672625639,1672628492,2853
10895,3778382224,3373851012,1672598079,1672599233,1154
10148,3778695017,3512411326,1672565274,1672568651,3377
11490,3827981800,3512477276,1672675592,1672678884,3292
10791,3343698137,3431317400,1672596314,1672598258,1944
11606,3472718723,3309178914,1672547333,1672548836,1503
11491,3714718326,3915195160,1672686197,1672686559,362
11540,3757407184,3703659324,1672571073,1672574532,3459
11653,3520860199,3773041843,1672612626,1672615631,3005
10627,3623512088,3206377955,1672669658,1672672492,2834
10506,3661543201,3512288503,1672684685,1672686433,1748
10955,3617771673,3517960157,1672686385,1672688612,2227
10899,3519255644,3350169064,1672680068,1672683434,3366
10791,3518088154,3512371853,1672660473,1672661295,822
11547,3906874577,3714923092,1672598013,1672599820,1807
10303,3901169230,3713416756,1672662970,1672664536,1566
10217,3517645656,3770780655,1672569049,1672571232,2183
11658,3919345990,3710260848,1672663042,1672664070,1028
11781,3386323728,3318250647,1672641556,1672644586,3030
10552,3911821258,3703168159,1672631668,1672633648,1980
10789,3514564903,3701971784,1672641400,1672642562,1162
10980,3812516461,3930475498,1672539548,1672540541,993
10696,3518157683,3780423516,1672619979,1672622004,2025
11265,3371238318,3918981936,1672581332,1672583831,2499
11746,3917467642,3519831322,1672618327,1672621914,3587
10118,3202740652,3469370398,1672687249,1672689760,2511
11076,3374348845,3245121919,1672546266,1672547272,1006
10858,3716541851,3620157388,1672553784,1672555298,1514
11142,3710008760,3713805968,1672639267,1672642065,2798
9912,3517499844,3736056340,1672564635,1672567844,3209
11262,3791863922,3890278838,1672623435,1672624408,973
10747,3902023467,3505491969,1672663056,1672664086,1030
10359,3773554767,3340723781,1672685265,1672687903,2638
10246,3777290300,3893950585,1672588978,1672591445,2467
11765,3514341451,3772980989,1672549109,1672550115,1006
11263,3500793739,3757584114,1672545783,1672549103,3320
11295,3701971784,3783172505,1672588323,1672591297,2974
11224,3403218814,3915460293,1672649811,1672650364,553
10054,3791121243,3757514745,1672575876,1672577215,1339
11475,3760481622,3500624846,1672600441,1672603898,3457
11309,3359929534,3533365834,1672568229,1672568703,474
11702,3905889514,3359929534,1672682377,1672685542,3165
10806,3830599959,3514297012,1672590186,1672590703,517
11020,3792008302,3910354786,1672644024,1672647298,3274
11219,3755823805,3805268739,1672546800,1672549462,2662
11170,3352057037,3344478603,1672632344,1672633360,1016
11646,3779340538,3366801723,1672639633,1672642748,3115
11349,3241593146,3665841655,1672698658,1672699154,496
10585,3314965818,3711029952,1672650221,1672652200,1979
10384,3682906048,3780982229,1672626372,1672628445,2073
11544,3839417558,3505825767,1672696445,1672699392,2947
11458,3714116241,3511382748,1672575076,1672578328,3252
10014,3365839890,3399504157,1672625427,1672627089,1662
11617,3710147457,3735152111,1672536653,1672538835,2182
11278,3703697059,3770780655,1672584028,1672586271,2243
11068,3711844574,3777706200,1672614646,1672617902,3256
11059,3779454060,3225554956,1672649290,1672649609,319
10921,3500105301,3445406685,1672690987,1672692772,1785
11268,3510454018,3202740652,1672687442,1672689494,2052
10860,3533777032,3505901826,1672548239,1672550119,1880
11203,3515284733,3825153408,1672612849,1672616285,3436
11364,3517949586,3416225867,1672638597,1672641030,2433
11041,3713141087,3776249160,1672537602,1672540174,2572
10719,3770441717,3711804184,1672632971,1672634573,1602
10395,3780964089,3303772923,1672614488,1672615703,1215
10919,3793442891,3858497718,1672676115,1672677507,1392
9844,3777200549,3287094447,1672562803,1672563587,784
9881,3818324410,3285971415,1672655274,1672657458,2184
10185,3347172556,3776581518,1672656399,1672656933,534
10722,3856897914,3515939841,1672642946,1672644818,1872
10403,3355430975,3452878062,1672698921,1672702219,3298
11484,3773953689,3793699467,1672694671,1672696528,1857
10719,3772962072,3755238321,1672685968,1672688415,2447
10352,3511640720,3757406215,1672553005,1672555676,2671
11043,3379076106,3392010033,1672638187,1672639604,1417
10003,3512411326,3455430943,1672615880,1672617190,1310
11195,3757549235,3505278562,1672668210,1672668908,698
11788,3757623259,3756536512,1672618359,1672619154,795
11078,3511289729,3403988682,1672624981,1672626903,1922
10544,3791825536,3514329209,1672575428,1672578813,3385
11635,3808442442,3714919471,1672601363,1672601734,371
11596,3242149533,3511476353,1672616556,1672619988,3432
10348,3710865678,3495637721,1672613915,1672617260,3345
10140,3772114731,3500543341,1672565210,1672566686,1476
11647,3714787207,3367526113,1672537222,1672538841,1619
10494,3490804766,3858330969,1672598652,1672599712,1060
11050,3772461583,3430823498,1672604643,1672605590,947
11698,3519465545,3713906305,1672600838,1672603625,2787
11614,3452175941,3711671702,1672661158,1672662607,1449
9839,3500596577,3283295213,1672671175,1672672028,853
10843,3310702648,3882580580,1672585138,1672586905,1767
11362,3405435885,3701291994,1672664566,1672664789,223
10614,3520824937,3777304517,1672672931,1672676165,3234
10392,3514941815,3512819376,1672664397,1672666354,1957
10039,3791409441,3500251781,1672597848,1672599877,2029
11029,3276209319,3735056027,1672545803,1672546452,649
11302,3341432459,3791698084,1672549049,1672551327,2278
10047,3733953055,3384151770,1672665090,1672666356,1266
10595,3318220119,3520832066,1672611362,1672613994,2632
10761,3402020492,3689420679,1672587765,1672587900,135
11760,3791222330,3776811587,1672602192,1672604251,2059
11341,3774326754,3807111856,1672556855,1672557207,352
10700,3514585995,3915962248,1672678437,1672678821,384
11191,3247845642,3511750695,1672669278,1672669632,354
11011,3473706746,3501208658,1672564662,1672567578,2916
11176,3457249798,3681274982,1672595340,1672596970,1630
10660,3760537855,3887382548,1672617870,1672619241,1371
11147,3778402454,3481365330,1672598646,1672600711,2065
10877,3976225898,3791994414,1672661946,1672663392,1446
11116,3711015176,3756428507,1672559748,1672562062,2314
11329,3414510793,3509377714,1672558360,1672558809,449
10805,3516668203,3791106473,1672590980,1672594463,3483
10188,3778924002,3438818153,1672558325,1672560988,2663
10213,3632720032,3517558635,1672557795,1672559064,1269
10290,3770180844,3621960662,1672589973,1672591810,1837
10314,3776183353,3494157939,1672660233,1672662559,2326
11505,3757607649,3755502373,1672567470,1672567538,68
11203,3432838598,3228218081,1672578721,1672580940,2219
10435,3773378103,3682150740,1672614156,1672616946,2790
10005,3895839169,3772877723,1672670686,1672671299,613
11685,3730052916,3515655024,1672619338,1672620097,759
11085,3710515351,3374348845,1672593847,1672595505,1658
11483,3713224986,3776732532,1672660256,1672660840,584
11150,3520155898,3755922811,1672621515,1672624613,3098
10971,3756066765,3227874229,1672646648,1672648897,2249
10934,3710865678,3757639274,1672612155,1672614248,2093
11441,3664478769,3776600696,1672703180,1672705159,1979
9913,3435801763,3912862842,1672548279,1672549645,1366
10612,3501600785,3515699732,1672648854,1672651764,2910
10349,3241567995,3343698137,1672624712,1672626633,1921
11318,3510250740,3514145752,1672623632,1672627106,3474
11328,3735197034,3701521510,1672660601,1672661712,1111
10378,3760776967,3311331205,1672697831,1672698711,880
11782,3534937492,3774606418,1672584355,1672586430,2075
11413,3500922040,3711219767,1672694647,1672697257,2610
11425,3774652449,3518425740,1672683422,1672684569,1147
11088,3780013266,3511182297,1672625434,1672626450,1016
11509,3511364193,3366566029,1672624055,1672626665,2610
11672,3778479297,3631444265,1672620467,1672623402,2935
10776,3417431173,3793274957,1672540831,1672541585,754
10143,3395069149,3855674398,1672594610,1672595397,787
11366,3774627091,3601214648,1672629235,1672630480,1245
11187,3971282455,3334482021,1672681671,1672683053,1382
10455,3515096959,3791222330,1672662206,1672665120,2914
10668,3756536512,3854202447,1672537776,1672538642,866
11133,3360525513,3534562354,1672554534,1672554972,438
9834,3778731000,3511245705,1672666694,1672667625,931
11367,3779706467,3710861700,1672657765,1672660641,2876
11518,3895507040,3713906305,1672592919,1672593106,187
11753,3558264627,3683562111,1672566770,1672567709,939
10402,3487779363,3714268380,1672677580,1672678318,738
9984,3470135167,3519174861,1672606179,1672609243,3064
10040,3777204977,3480405740,1672618259,1672621805,3546
10104,3774296721,3533566754,1672584782,1672587793,3011
9966,3777370992,3770533675,1672687497,1672690044,2547
10713,3605591994,3509457543,1672666055,1672667648,1593
11733,3701449715,3777112124,1672593039,1672594355,1316
10846,3367202274,3512753567,1672630107,1672632630,2523
10716,3773344258,3473706746,1672654295,1672656517,2222
11071,3756119976,3774447975,1672647034,1672650214,3180
9993,3805831563,3505538902,1672564889,1672567118,2229
10838,3714919471,3387870683,1672569895,1672569964,69
9904,3792337863,3519322066,1672624289,1672627138,2849
10504,3622218289,3854202447,1672567009,1672570534,3525
10028,3428303756,3284865931,1672656780,1672657637,857
10074,3514564903,3831981073,1672697720,1672700417,2697
9917,3821103640,3974400577,1672537653,1672538579,926
10413,3713969196,3916656185,1672602199,1672602933,734
10217,3703502114,3636605690,1672699151,1672700841,1690
11305,3377446376,3534531039,1672687703,1672691077,3374
10762,3857344874,3772216305,1672608208,1672610195,1987
9811,3682266017,3703502114,1672632640,1672633826,1186
10343,3284374600,3811419378,1672638358,1672640636,2278
11690,3519521903,3500931474,1672677883,1672681098,3215
11385,3733411026,3394986304,1672553492,1672553749,257
11010,3772869013,3716020849,1672640773,1672643634,2861
11373,3703206956,3505066871,1672573356,1672575571,2215
10815,3379400553,3501574882,1672533234,1672535722,2488
10744,3792075871,3779778679,1672663956,1672664429,473
10364,3534426696,3513545735,1672702066,1672703937,1871
10680,3739567072,3714923092,1672597356,1672600409,3053
10658,3915195160,3688870751,1672677919,1672680102,2183
10891,3620157388,3756695502,1672593728,1672596999,3271
10959,3352057037,3620157388,1672675771,1672678496,2725
10478,3703742071,3272838634,1672624342,1672626649,2307
11016,3610723722,3517960740,1672650424,1672652875,2451
11160,3737467358,3515405509,1672594558,1672597899,3341
10754,3501515425,3701127475,1672594778,1672595742,964
11013,3779312237,3500589560,1672632900,1672635116,2216
9847,3309178914,3715622084,1672695918,1672696678,760
11202,3357026115,3923133978,1672701775,1672702596,821
10843,3791628263,3514145752,1672605089,1672605913,824
10205,3533974355,3880000841,1672640619,1672641250,631
10587,3714903456,3777370992,1672637536,1672640487,2951
10115,3485898181,3519357822,1672614109,1672616022,1913
10987,3519730914,3533017131,1672578960,1672582146,3186
11141,3551972633,3505331014,1672622193,1672622659,466
11097,3623512088,3505155858,1672636620,1672637190,570
9971,3513140146,3907039612,1672587181,1672589143,1962
10897,3714453773,3783939161,1672673447,1672676836,3389
10291,3716118473,3555378248,1672615353,1672615956,603
10312,3802101760,3398075553,1672629251,1672632309,3058
11318,3714179543,3770574826,1672660330,1672662361,2031
11359,3459951739,3517960740,1672687545,1672688516,971
11246,3687183789,3710271021,1672598673,1672599009,336
11206,3359472956,3776034313,1672632291,1672632650,359
10613,3716492409,3491527603,1672584613,1672587132,2519
11324,3602401154,3756363182,1672649653,1672651224,1571
11055,3776710698,3446066492,1672572614,1672576001,3387
10594,3312946269,3811419378,1672553342,1672555344,2002
10022,3287968403,3603167427,1672595253,1672596342,1089
9915,3714892312,3714283424,1672533196,1672535162,1966
10964,3662794240,3783060739,1672627221,1672630582,3361
10248,3619676231,3505438826,1672578663,1672579382,719
11406,3513740840,3791070926,1672661198,1672664500,3302
10236,3445558740,3778273230,1672595962,1672599137,3175
10211,3703336988,3517652011,1672596592,1672599060,2468
10295,3515304526,3811354125,1672641066,1672641542,476
9799,3308759754,3446810761,1672702257,1672703295,1038
10336,3533077580,3793497672,1672603749,1672605305,1556
11397,3334633634,3445896667,1672696456,1672699765,3309
10273,3777928067,3792173463,1672670837,1672671869,1032
11681,3792987243,3713611960,1672660457,1672662531,2074
10045,3516319492,3519055736,1672632686,1672635904,3218
11634,3756876537,3289017988,1672689144,1672689610,466
10115,3516444589,3774221318,1672643732,1672646311,2579
11025,3513739060,3285587972,1672593026,1672593939,913
10953,3791072829,3231271498,1672703689,1672706134,2445
11280,3319436533,3880549316,1672597729,1672600770,3041
10556,3701359045,3334633634,1672534737,1672536044,1307
9947,3388830370,3772489471,1672635399,1672637873,2474
11097,3387322545,3756413374,1672671721,1672674752,3031
11198,3511458926,3780423516,1672560157,1672561392,1235
10299,3512203553,3893950585,1672608902,1672609427,525
11491,3410788026,3937636109,1672561817,1672562372,555
10477,3501843187,3515706117,1672688499,1672689321,822
9976,3511199555,3857344874,1672682033,1672685297,3264
10508,3735422623,3776001441,1672602950,1672604527,1577
11379,3713927376,3446764595,1672550923,1672553900,2977
11595,3388923880,3469663062,1672605874,1672608799,2925
11277,3715320359,3774304163,1672659465,1672662912,3447
11220,3495152069,3427527462,1672609689,1672610381,692
10679,3402774497,3501557463,1672583898,1672584708,810
10384,3516472352,3435342362,1672639833,1672640877,1044
9824,3397527886,3476308535,1672569158,1672569347,189
9941,3246062632,3304697982,1672592382,1672594494,2112
10237,3520763492,3710919244,1672548915,1672552054,3139
9940,3276230295,3510143850,1672570389,1672571396,1007
11463,3534775239,3602054754,1672619685,1672623135,3450
9818,3209280342,3520470646,1672640091,1672640827,736
10638,3287734830,3341129425,1672557275,1672558660,1385
10552,3733915784,3930766276,1672677683,1672678896,1213
10760,3701449715,3609166109,1672589218,1672589528,310
11342,3519000878,3668855144,1672633757,1672636752,2995
11365,3517552930,3822634862,1672577476,1672577637,161
10211,3207307681,3492728794,1672587326,1672588053,727
10690,3703938162,3760481622,1672622832,1672623831,999
10949,3791587717,3755729826,1672562739,1672565903,3164
10966,3284865931,3505291330,1672683208,1672683965,757
10624,3615846003,3716371766,1672696045,1672696634,589
9964,3773424266,3772909073,1672635535,1672637450,1915
11051,3733411026,3555954355,1672635451,1672636891,1440
11663,3514508773,3770424892,1672691888,1672692240,352
9918,3347172556,3793689267,1672591069,1672594263,3194
10631,3701453343,3293540333,1672700294,1672703475,3181
11100,3714688409,3435715962,1672686610,1672688377,1767
9837,3511645260,3469778316,1672693260,1672693363,103
9892,3284334297,3713621169,1672562602,1672565753,3151
11537,3715441777,3477511446,1672594157,1672597216,3059
9971,3404187438,3553321027,1672546440,1672547302,862
11744,3343859998,3905889514,1672603499,1672605616,2117
10378,3429333292,3206377955,1672582871,1672584953,2082
10477,3415840750,3755273361,1672537971,1672540269,2298
10249,3613828705,3910354786,1672620744,1672621902,1158
11480,3425545115,3517083465,1672538966,1672540207,1241
11199,3851810349,3342368576,1672623935,1672624391,456
11360,3791628195,3716595760,1672617617,1672618969,1352
10285,3409514897,3510894809,1672702041,1672705109,3068
10325,3447554599,3773523569,1672648429,1672651832,3403
10253,3755192104,3603452936,1672531592,1672533267,1675
10100,3318224774,3776122272,1672647284,1672650746,3462
11057,3756948477,3836090778,1672543651,1672546061,2410
10271,3287968403,3760731595,1672606390,1672607884,1494
11744,3600441934,3299847117,1672575526,1672575703,177
10565,3500073824,3222357355,1672665914,1672669175,3261
10683,3770564547,3486824047,1672610420,1672613953,3533
11380,3510244209,3892177203,1672601905,1672602249,344
11270,3559619861,3669497617,1672631777,1672635207,3430
10541,3608973523,3760749218,1672616931,1672619694,2763
11233,3510368377,3760748418,1672660092,1672663376,3284
11733,3805704844,3422460919,1672654362,1672654971,609
10962,3851877325,3711599043,1672543087,1672545394,2307
11033,3780969898,3853275529,1672575843,1672577213,1370
10924,3331471764,3687445224,1672660462,1672663823,3361
10307,3974400577,3358473096,1672584923,1672586710,1787
10488,3896615831,3518759318,1672627378,1672627514,136
11720,3711065081,3389069291,1672588366,1672590351,1985
11632,3297684667,3518931700,1672699863,1672700443,580
10513,3909399636,3907923381,1672536971,1672539229,2258
11464,3739844610,3899205452,1672576318,1672578527,2209
10953,3624872714,3511580693,1672635450,1672636751,1301
11098,3603682643,3887918622,1672603636,1672604283,647
10972,3885422379,3760481622,1672589531,1672592857,3326
9988,3306037126,3850993995,1672584316,1672585440,1124
11037,3792162098,3510189563,1672632291,1672635284,2993
9928,3703462221,3404395454,1672674509,1672677858,3349
10325,3792008302,3430296808,1672672516,1672675294,2778
10295,3495152069,3818570577,1672597814,1672599303,1489
10182,3755849241,3774483862,1672541328,1672544766,3438
11236,3850181934,3778702093,1672615704,1672616523,819
10628,3779174993,3533960602,1672656034,1672658842,2808
10422,3443041059,3517800171,1672665322,1672665824,502
11040,3517766135,3792337863,1672576568,1672578151,1583
11704,3428788958,3416474842,1672568530,1672570832,2302
10236,3880549316,3703611876,1672557661,1672561258,3597
10124,3930766276,3510454018,1672566760,1672567439,679
11163,3791905743,3773736248,1672531561,1672533118,1557
10671,3406390503,3791522832,1672622033,1672624751,2718
10614,3773798215,3713031958,1672608514,1672610538,2024
10593,3757523596,3779393140,1672623890,1672625083,1193
11139,3715261950,3309415277,1672591500,1672591939,439
11320,3415228763,3887030182,1672549964,1672551825,1861
11692,3776534957,3371564186,1672602395,1672604041,1646
10083,3703818358,3445896667,1672575224,1672576739,1515
9898,3500429731,3485468650,1672627080,1672628012,932
9926,3918981936,3756761603,1672653017,1672653827,810
9919,3493047640,3496579251,1672614252,1672616284,2032
11106,3501554468,3311739926,1672634904,1672636589,1685
10294,3716595760,3301765144,1672596979,1672597207,228
9996,3513213122,3360972732,1672549796,1672550057,261
11138,3206926634,3534537581,1672601666,1672603531,1865
11654,3379076106,3773688906,1672663107,1672665055,1948
10244,3684651755,3520016705,1672583817,1672586838,3021
10460,3505804611,3505769529,1672618508,1672619051,543
11118,3468201976,3472272792,1672681363,1672682486,1123
10922,3239082508,3638035545,1672659431,1672661621,2190
10470,3688410383,3733730342,1672595504,1672596925,1421
11100,3605078841,3513111053,1672577474,1672580835,3361
10130,3319436533,3311583437,1672681090,1672683281,2191
11520,3403257752,3311924005,1672580482,1672581474,992
10227,3201634072,3924963918,1672591959,1672592998,1039
10418,3242149533,3208519320,1672651473,1672651610,137
10025,3703481882,3783067048,1672684802,1672687505,2703
9817,3519260216,3411355804,1672686328,1672689603,3275
11364,3600871715,3896211741,1672622689,1672623972,1283
9964,3534278019,3558349840,1672636152,1672639134,2982
10483,3830599959,3791434207,1672545156,1672547484,2328
10468,3515893948,3930727474,1672630397,1672633774,3377
10275,3509431396,3755175497,1672537298,1672538388,1090
11660,3501657158,3500814753,1672690853,1672691384,531
10653,3311449914,3514329209,1672632417,1672634390,1973
10389,3516067011,3880788853,1672637929,1672639236,1307
11573,3438470128,3472718723,1672551594,1672554902,3308
11428,3206377955,3714640103,1672623530,1672625899,2369
9839,3772689657,3355903597,1672661398,1672664266,2868
10176,3713694278,3713547793,1672624979,1672625442,463
10987,3337903727,3604569804,1672555648,1672558586,2938
9853,3511296895,3308481706,1672561475,1672563524,2049
10534,3516454693,3660176760,1672661612,1672664189,2577
10082,3208594306,3520009158,1672531708,1672535224,3516
9820,3357026115,3713219299,1672637362,1672639678,2316
10378,3517766135,3760080378,1672645871,1672647805,1934
10501,3510826414,3636015050,1672565932,1672567949,2017
11181,3734957248,3716541851,1672691861,1672692970,1109
10772,3806720019,3633860380,1672667517,1672667775,258
11175,3533154906,3366961580,1672682620,1672684192,1572
11410,3978643889,3347520239,1672628229,1672630212,1983
11693,3207307681,3203630241,1672595608,1672595920,312
11640,3772509599,3836090778,1672543657,1672546655,2998
10331,3887069914,3627081426,1672696514,1672700031,3517
9944,3511004622,3486509752,1672699840,1672701257,1417
10937,3430823498,3701374160,1672640247,1672643318,3071
10827,3711404205,3776901443,1672550685,1672554047,3362
10701,3534102440,3710119555,1672667852,1672668153,301
10527,3817029483,3454151554,1672664963,1672668121,3158
9954,3773738817,3402774497,1672679408,1672680440,1032
10587,3714074120,3623113240,1672690944,1672692862,1918
10153,3353194923,3760901975,1672547303,1672550099,2796
9901,3605760561,3513739060,1672675284,1672675819,535
10791,3791382196,3515984911,1672685322,1672686327,1005
10866,3513186578,3685645561,1672701295,1672704076,2781
10066,3805831563,3469663062,1672606689,1672608312,1623
11146,3757592622,3755075988,1672649922,1672650220,298
11205,3894328297,3517816581,1672681910,1672682352,442
10282,3757773786,3916955566,1672680734,1672682961,2227
11317,3356972733,3308965136,1672543363,1672544739,1376
10715,3929391979,3342426430,1672647386,1672650805,3419
11233,3520694387,3505148522,1672564266,1672567040,2774
10565,3783727937,3701412729,1672534588,1672534705,117
9813,3501574882,3893932944,1672646684,1672649069,2385
10742,3555954355,3403218814,1672643330,1672644227,897
11067,3756536476,3241567995,1672664885,1672665969,1084
11361,3403035480,3780733404,1672549227,1672550385,1158
11712,3505416534,3774706478,1672579277,1672580918,1641
11498,3710228292,3505119470,1672620985,1672624355,3370
9977,3514021667,3892487982,1672540408,1672541198,790
10271,3793948300,3514145752,1672555391,1672557983,2592
11355,3356599815,3783201950,1672699635,1672702671,3036
10764,3711836873,3772708314,1672627205,1672627388,183
10780,3701925712,3809207482,1672701410,1672702796,1386
11336,3892487982,3510864325,1672643115,1672644058,943
11119,3922301238,3488887919,1672630079,1672630526,447
10357,3856975355,3465227623,1672656749,1672659355,2606
10401,3534984243,3361635547,1672620952,1672624319,3367
11620,3887918622,3815700240,1672645379,1672647988,2609
11069,3208560443,3774448657,1672659161,1672662016,2855
11461,3921736061,3756428507,1672672856,1672673633,777
10225,3505684690,3272328752,1672613191,1672614953,1762
11081,3711040761,3513111053,1672673742,1672676747,3005
10527,3776034313,3623067708,1672679106,1672681339,2233
11768,3499142934,3756784813,1672585842,1672588366,2524
9908,3367109648,3461741050,1672541951,1672542670,719
11363,3453164933,3511580693,1672642901,1672643863,962
9885,3780467276,3410602007,1672575030,1672576770,1740
9846,3703474558,3857244486,1672659246,1672660450,1204
11424,3919719755,3756876537,1672605582,1672608684,3102
9817,3756536512,3774236212,1672616576,1672618729,2153
11360,3928076270,3480560014,1672639515,1672643071,3556
11222,3780238637,3488749569,1672644671,1672646436,1765
10334,3293540333,3774589551,1672568755,1672570241,1486
10562,3922480066,3514353133,1672628857,1672629172,315
9795,3417969824,3925175853,1672702182,1672705102,2920
10072,3760648750,3278071998,1672542174,1672543650,1476
11678,3770480149,3520470646,1672571659,1672572211,552
10037,3772489471,3776053084,1672533660,1672535399,1739
10475,3776348472,3816184951,1672679159,1672681677,2518
10334,3501225887,3511671476,1672621548,1672624459,2911
10360,3927805949,3664719070,1672604731,1672608074,3343
10750,3770764940,3406101720,1672637080,1672638416,1336
10401,3490804766,3603167427,1672656049,1672659042,2993
10789,3773032706,3443580855,1672685844,1672686079,235
11752,3687445224,3236360179,1672582469,1672585971,3502
11550,3850108828,3518408734,1672614006,1672615446,1440
11211,3715246385,3281935691,1672617600,1672619813,2213
11474,3632303304,3858330969,1672621147,1672623103,1956
11377,3356599815,3735838864,1672551398,1672553630,2232
9987,3812261241,3791351852,1672691398,1672692899,1501
10335,3492064037,3520779124,1672679356,1672679851,495
10407,3500444748,3774394000,1672531436,1672531986,550
10765,3559112196,3701519251,1672597068,1672597943,875
11165,3390537737,3305656670,1672627102,1672630314,3212
11086,3755209597,3701978422,1672597697,1672601038,3341
11247,3756668747,3483347530,1672624076,1672625054,978
9799,3454554552,3825153408,1672555299,1672555803,504
11685,3377311502,3703614781,1672692467,1672694102,1635
11762,3519174861,3411626917,1672610061,1672613276,3215
11398,3298113026,3316121649,1672631685,1672633588,1903
10127,3772844451,3713069234,1672593889,1672595120,1231
10595,3303772923,3711518637,1672561808,1672563085,1277
10810,3917811545,3757064623,1672628152,1672630857,2705
11115,3281935691,3517253559,1672649848,1672651137,1289
10549,3713990030,3359418136,1672623290,1672623429,139
10942,3756536476,3409098014,1672611968,1672612163,195
10362,3501370430,3614484939,1672562264,1672564625,2361
11022,3776316903,3713906305,1672610371,1672613147,2776
11372,3915679140,3332124606,1672556837,1672560166,3329
10057,3803996569,3780786276,1672630746,1672631555,809
10900,3511003541,3778741325,1672554309,1672557236,2927
11015,3779815753,3513661302,1672665823,1672669005,3182
10834,3770476738,3858497718,1672596724,1672598067,1343
11219,3386323728,3500776597,1672636692,1672637061,369
10402,3780733404,3738873928,1672671049,1672673048,1999
10525,3519165527,3774792696,1672660209,1672662864,2655
11724,3880000841,3294952405,1672567250,1672567925,675
10174,3783430498,3804779247,1672590107,1672592407,2300
11385,3487278983,3776124041,1672652584,1672654802,2218
11501,3509370016,3476308535,1672613554,1672615387,1833
10129,3772802020,3791409441,1672703949,1672707470,3521
10762,3892177203,3534775239,1672666514,1672668083,1569
11703,3607288879,3701971784,1672549334,1672551589,2255
11509,3713990030,3495152069,1672663470,1672666789,3319
11291,3510750299,3757212744,1672598921,1672601672,2751
10621,3227498870,3713031958,1672680888,1672683096,2208
11142,3792682835,3200785194,1672661603,1672665147,3544
11380,3513092056,3308481706,1672635505,1672637068,1563
9901,3899903158,3514306458,1672697119,1672699681,2562
10816,3713636175,3472561941,1672651201,1672654027,2826
10830,3241567995,3822315407,1672690846,1672693030,2184
11225,3774273260,3282053097,1672627715,1672629242,1527
11140,3452090950,3447267291,1672538669,1672539169,500
11743,3444646562,3205324639,1672675775,1672675955,180
10856,3603682643,3245501577,1672639361,1672641342,1981
10457,3241682278,3777992576,1672591558,1672592040,482
11498,3550206045,3245121919,1672548857,1672551586,2729
11098,3440991826,3893950585,1672676826,1672678858,2032
10239,3780969898,3770925016,1672674096,1672677053,2957
10675,3774539067,3735197034,1672658983,1672659687,704
10639,3205908584,3685877449,1672701931,1672704800,2869
10763,3515548696,3341738186,1672697137,1672700182,3045
11324,3465690527,3854957153,1672544430,1672545595,1165
11611,3462985379,3415228763,1672640161,1672643481,3320
11644,3509544691,3715622084,1672697027,1672697968,941
11633,3342368576,3602680347,1672678787,1672682082,3295
10053,3510368377,3833993674,1672566056,1672566150,94
11390,3611570003,3908464960,1672641498,1672644276,2778
10432,3895507040,3736056340,1672592306,1672594089,1783
9993,3779312237,3856975355,1672615649,1672616220,571
11289,3888642876,3613703906,1672675954,1672678517,2563
10724,3559619861,3906075386,1672644490,1672645164,674
11133,3805616707,3793407883,1672634724,1672638180,3456
10180,3505826673,3733836732,1672646647,1672649901,3254
10219,3793987483,3515470462,1672640508,1672641196,688
11562,3511969443,3633622298,1672563219,1672563713,494
10045,3509297453,3466655775,1672662057,1672664837,2780
10394,3371759126,3773411968,1672647496,1672649552,2056
11179,3337715675,3351728355,1672672464,1672672777,313
11255,3887069914,3512477276,1672692875,1672695423,2548
10642,3756763585,3662495290,1672551598,1672551895,297
10336,3512794667,3516777819,1672583020,1672586480,3460
9838,3500536897,3517810375,1672659181,1672660057,876
11774,3780308809,3475830203,1672536479,1672538527,2048
11200,3342235058,3517448452,1672562529,1672565213,2684
11110,3780680252,3919258737,1672635136,1672637524,2388
10222,3318220119,3311142523,1672644048,1672645417,1369
10573,3519513219,3714065165,1672691688,1672694026,2338
11755,3505901826,3779561601,1672696844,1672699709,2865
11198,3514685272,3505392452,1672664766,1672666749,1983
10086,3756642173,3380167818,1672555127,1672558726,3599
11686,3337673625,3893932944,1672535398,1672535458,60
10643,3505547832,3511003541,1672634466,1672635447,981
11687,3228465044,3755369666,1672583058,1672584589,1531
10434,3755286041,3774822697,1672551429,1672554224,2795
10268,3831981073,3780074082,1672589034,1672591880,2846
10825,3379517265,3662522808,1672691613,1672695128,3515
11277,3713566527,3703419800,1672641313,1672644386,3073
10777,3716160006,3779102237,1672595956,1672596829,873
11419,3710919244,3512546783,1672698406,1672700792,2386
10807,3701596047,3632303304,1672655117,1672656165,1048
9805,3711854614,3500544306,1672601519,1672601736,217
11702,3850904092,3467415939,1672648867,1672652132,3265
10583,3902548260,3613216900,1672684352,1672685899,1547
9989,3437108337,3701824335,1672680528,1672682579,2051
11416,3613828705,3534812391,1672607631,1672607716,85
10308,3667814788,3305612422,1672701796,1672703849,2053
11243,3791108593,3501557463,1672679563,1672682224,2661
11504,3809871495,3510291656,1672596207,1672597584,1377
11481,3505828210,3780294116,1672554995,1672558116,3121
11142,3807717766,3716647407,1672555502,1672555756,254
10982,3801501384,3661856558,1672623846,1672627143,3297
10861,3711349327,3520182275,1672548107,1672549741,1634
10851,3511650296,3369810091,1672695774,1672695894,120
11402,3275661834,3236360179,1672681522,1672684826,3304
9880,3850108828,3500630465,1672649468,1672652749,3281
9895,3662821438,3201920708,1672677697,1672679957,2260
10467,3855440101,3471131277,1672698312,1672700374,2062
11648,3792785261,3898965585,1672581253,1672582635,1382
11101,3510291656,3933731871,1672532007,1672532265,258
11307,3358211034,3515597467,1672701060,1672702854,1794
10463,3304697982,3516026189,1672616890,1672617294,404
11204,3622218289,3779102237,1672627041,1672628088,1047
10985,3791194984,3976400190,1672637023,1672638644,1621
11066,3517949586,3505066871,1672673478,1672674295,817
10423,3230612965,3756890980,1672642898,1672645041,2143
10559,3505571800,3755218683,1672542190,1672545290,3100
9920,3760656396,3236206821,1672623904,1672625973,2069
10708,3773556853,3512395783,1672699376,1672702411,3035
11128,3406238754,3519712497,1672617700,1672620663,2963
11011,3884933821,3511218261,1672668833,1672671845,3012
9935,3661359073,3505853594,1672654522,1672656948,2426
10364,3737946004,3229615214,1672541329,1672542199,870
11294,3793497672,3776778306,1672699892,1672700105,213
10532,3607288879,3716541851,1672691391,1672693428,2037
10373,3463892928,3909822999,1672702512,1672702713,201
10570,3534204885,3760346746,1672546437,1672549841,3404
11465,3734233216,3737467358,1672618877,1672619385,508
10164,3732312480,3203954795,1672671931,1672674128,2197
9901,3793497672,3773669001,1672595981,1672598810,2829
11574,3772055279,3501370430,1672538299,1672541002,2703
11044,3516932899,3780423516,1672597308,1672599075,1767
10212,3757713457,3470962222,1672698716,1672702224,3508
10883,3443041059,3774627091,1672532579,1672535663,3084
10141,3714919471,3235313062,1672703199,1672706666,3467
10989,3512753567,3518995270,1672639603,1672641506,1903
11592,3715700639,3612042508,1672696966,1672699898,2932
9919,3468343480,3666655293,1672649518,1672652848,3330
10930,3666561358,3358959807,1672596923,1672598421,1498
10263,3374552204,3777498160,1672696555,1672697700,1145
11494,3559112196,3780626668,1672629120,1672630103,983
11527,3360783381,3776182849,1672625092,1672626533,1441
11786,3915652382,3917811545,1672574869,1672577646,2777
11765,3774029494,3802101760,1672642909,1672645247,2338
10337,3517440258,3703749690,1672683291,1672686652,3361
10608,3716647407,3905889514,1672585658,1672587122,1464
11320,3373018943,3505502819,1672597376,1672600196,2820
10902,3774238066,3517021928,1672699420,1672701062,1642
10399,3891272544,3533201269,1672680866,1672681081,215
10109,3757501067,3293673220,1672560826,1672563402,2576
10651,3287821258,3499998389,1672551106,1672552287,1181
11208,3501126057,3777439655,1672694066,1672696950,2884
11324,3899294071,3736203662,1672700551,1672703745,3194
10440,3520395850,3533703578,1672640274,1672643432,3158
9881,3533419409,3926065090,1672609434,1672612326,2892
10727,3613940925,3513764665,1672553702,1672557159,3457
11701,3311133296,3398862999,1672651852,1672652847,995
10591,3303747093,3505709407,1672580255,1672582160,1905
11061,3381055770,3791031227,1672535941,1672536878,937
10471,3226172318,3701028092,1672699225,1672700216,991
10549,3701919083,3514107131,1672631216,1672632090,874
11477,3493515706,3899903158,1672588422,1672590019,1597
11131,3283295213,3275171954,1672556727,1672557295,568
10014,3207586072,3618024815,1672575682,1672579003,3321
10002,3897107253,3757514745,1672621662,1672621975,313
11418,3236886943,3662821438,1672602459,1672604042,1583
11740,3732128078,3735679000,1672673191,1672676154,2963
10721,3757855416,3919349138,1672563017,1672566598,3581
11167,3359929534,3500057674,1672588392,1672589579,1187
10792,3792930090,3710046567,1672674791,1672678101,3310
10817,3509457543,3779505358,1672703714,1672705629,1915
11618,3770715115,3773344258,1672646413,1672647255,842
10445,3245755569,3822315407,1672664153,1672665131,978
9843,3711599043,3501548163,1672587455,1672588240,785
11781,3713416756,3791628195,1672559175,1672561811,2636
10701,3757198930,3424476995,1672661070,1672663464,2394
11010,3517797610,3756680289,1672597301,1672597719,418
9837,3509470194,3511286390,1672668257,1672670480,2223
10493,3810584695,3313282478,1672659871,1672661543,1672
11318,3517949586,3500589560,1672605033,1672607967,2934
10248,3458432407,3444453261,1672593535,1672596986,3451
10021,3505351253,3770925016,1672583779,1672586758,2979
9854,3391093411,3613781977,1672641980,1672642150,170
11267,3512490032,3510680251,1672670508,1672670803,295
11094,3711613085,3779975575,1672690640,1672692712,2072
11262,3756759239,3935256825,1672695727,1672698498,2771
11119,3715724166,3713224986,1672647489,1672648535,1046
10842,3779454060,3814378625,1672621526,1672622506,980
10422,3500433278,3780013266,1672553586,1672554997,1411
10826,3780900318,3505032773,1672666882,1672666977,95
11099,3368339963,3622152515,1672568763,1672570029,1266
11173,3793081195,3500429731,1672577230,1672580129,2899
10468,3688410383,3428878402,1672642362,1672645701,3339
10295,3520165730,3362127525,1672534465,1672536367,1902
9882,3614112171,3710891331,1672659780,1672660106,326
9985,3934070285,3855629383,1672685383,1672686700,1317
10027,3368339963,3667654673,1672560434,1672563348,2914
10519,3856975355,3783067048,1672664232,1672664552,320
10369,3669918958,3517021928,1672634326,1672637423,3097
11021,3381244346,3500440602,1672643325,1672646718,3393
11427,3533440736,3776053981,1672574622,1672576976,2354
11086,3533876927,3711131262,1672691390,1672693699,2309
9928,3394364348,3817120976,1672700552,1672702699,2147
9827,3922301238,3850993995,1672662554,1672664831,2277
10936,3772845364,3620105539,1672669151,1672669694,543
11415,3830291558,3374552204,1672620249,1672621420,1171
10986,3904004824,3208962614,1672532423,1672535186,2763
10765,3716389356,3551972633,1672693431,1672695601,2170
11577,3400025324,3359012188,1672616814,1672620308,3494
11598,3227498870,3713636175,1672550932,1672553294,2362
11685,3934564437,3812277991,1672537022,1672537660,638
11122,3855629383,3235578852,1672539278,1672542384,3106
11198,3669140241,3907245259,1672666557,1672668458,1901
10560,3811354125,3225356349,1672626439,1672627781,1342
11185,3760074281,3510987684,1672562815,1672564332,1517
11170,3822315407,3661359073,1672600800,1672604085,3285
10330,3518368900,3514508773,1672626471,1672629935,3464
10464,3486824047,3915035136,1672622020,1672623955,1935
11422,3792455305,3501574882,1672679801,1672681902,2101
9916,3444453261,3755465396,1672577718,1672579616,1898
10948,3773697080,3283106998,1672556181,1672558210,2029
11429,3814378625,3760390822,1672665571,1672665926,355
9817,3467415939,3286938590,1672700497,1672700807,310
11336,3791698084,3772296376,1672678952,1672680646,1694
10258,3624365837,3512645289,1672627881,1672630381,2500
9912,3514306458,3791758175,1672593522,1672594322,800
11411,3774221318,3516167000,1672559239,1672561013,1774
10745,3970775805,3970851830,1672605832,1672608040,2208
11437,3756998113,3822786416,1672627909,1672629020,1111
9885,3923910914,3711015176,1672602939,1672603759,820
10340,3972196462,3713611960,1672669973,1672671613,1640
9927,3627431396,3534491112,1672640576,1672642550,1974
11509,3418382025,3716982179,1672622639,1672623288,649
11429,3501980730,3793569914,1672559992,1672561396,1404
11677,3509828883,3519059808,1672634088,1672637271,3183
10250,3756157377,3496579251,1672540933,1672541790,857
10298,3304672737,3776182849,1672699150,1672701986,2836
9928,3773523569,3780206849,1672698307,1672699333,1026
11136,3606804618,3783879023,1672636955,1672639477,2522
11456,3554317844,3703722212,1672633447,1672635470,2023
10442,3510159441,3511671476,1672613914,1672615490,1576
10039,3239779992,3918981936,1672674346,1672677925,3579
10180,3901169230,3422314045,1672600578,1672601337,759
11247,3311569360,3772114731,1672581987,1672583958,1971
11518,3519046342,3274739459,1672554930,1672556963,2033
10087,3716609198,3806720019,1672600059,1672603101,3042
11682,3667072319,3505502819,1672549881,1672553258,3377
10509,3777729184,3713954144,1672619739,1672621137,1398
11701,3793332600,3440305508,1672689755,1672693206,3451
11322,3500438542,3618895679,1672655890,1672656725,835
9957,3500674240,3374652108,1672555862,1672558269,2407
10644,3511466117,3755502373,1672654383,1672657868,3485
10131,3701291994,3442403264,1672677598,1672678719,1121
11022,3425646356,3896622009,1672675337,1672676592,1255
10339,3512411326,3388830370,1672567940,1672571500,3560
11761,3403177609,3792012147,1672672394,1672674631,2237
10454,3220123678,3395069149,1672609862,1672613082,3220
10731,3519319233,3818461836,1672647412,1672648357,945
11667,3389367628,3437023385,1672689407,1672691285,1878
10692,3410602007,3520471156,1672625346,1672626289,943
11054,3359418136,3516257130,1672647486,1672648562,1076
10009,3555764822,3500927619,1672592247,1672595121,2874
10180,3791031227,3368848936,1672665748,1672667713,1965
10144,3711287751,3533077580,1672648601,1672649953,1352
10369,3224824355,3716676869,1672565458,1672568152,2694
11595,3735056027,3914947393,1672546539,1672547869,1330
10682,3276499910,3379400553,1672662025,1672664816,2791
10992,3972653129,3710119555,1672555253,1672557326,2073
9951,3713954144,3519351747,1672578426,1672581002,2576
9914,3711179193,3416225867,1672539668,1672541519,1851
10874,3520925688,3901217668,1672608128,1672610067,1939
10001,3204473480,3890813040,1672690977,1672692137,1160
10717,3387706541,3703423962,1672641985,1672643790,1805
11696,3791205793,3347760784,1672578182,1672580136,1954
10521,3222357355,3311188620,1672633500,1672635289,1789
11550,3810584695,3779393140,1672555382,1672558111,2729
9821,3791841318,3730290851,1672568567,1672569379,812
10701,3414841458,3783368855,1672665645,1672668346,2701
11598,3824657614,3515528947,1672566257,1672569446,3189
10256,3835982340,3711945923,1672678216,1672678416,200
11722,3714453773,3427741923,1672595815,1672596747,932
10539,3713611960,3512203553,1672625325,1672628576,3251
10300,3715790104,3371497614,1672698170,1672701651,3481
10701,3308481706,3773432494,1672586229,1672589799,3570
10627,3300810210,3207307681,1672564222,1672565912,1690
11675,3715441777,3359418136,1672691641,1672692260,619
10868,3776034313,3482786946,1672655744,1672657577,1833
10687,3313795594,3732312480,1672588097,1672589816,1719
10683,3777135415,3342252701,1672595136,1672596214,1078
10531,3715590997,3510233949,1672690605,1672691847,1242
9849,3276393542,3330188769,1672622167,1672622837,670
10374,3500145103,3533009565,1672585942,1672588585,2643
11577,3755411110,3920116284,1672649978,1672650750,772
10228,3500994763,3516668203,1672663812,1672665835,2023
11753,3349475873,3284829602,1672668619,1672670803,2184
9995,3715737742,3516815069,1672599936,1672601570,1634
11222,3511750850,3229890340,1672549720,1672549935,215
10625,3610517436,3669418238,1672618668,1672622014,3346
10587,3241682278,3780127017,1672696494,1672698537,2043
10692,3520165730,3716095450,1672595691,1672595771,80
10062,3738760498,3432466467,1672679493,1672682544,3051
10947,3685645561,3510178791,1672617276,1672620675,3399
11472,3713224038,3406937294,1672599545,1672601564,2019
10879,3777932581,3220798451,1672567263,1672568079,816
10747,3828568868,3885645840,1672702979,1672706565,3586
10226,3510250740,3933562725,1672594400,1672595151,751
11247,3518209090,3774606418,1672544782,1672546044,1262
10501,3777992576,3558567160,1672685922,1672687151,1229
10530,3311771689,3511963020,1672574747,1672576622,1875
10314,3500799617,3476144563,1672674038,1672675885,1847
11535,3285136057,3411626917,1672670508,1672671380,872
10082,3510750299,3738547113,1672616526,1672619504,2978
10155,3513293711,3773041843,1672592737,1672594631,1894
10838,3382696725,3919342147,1672597239,1672600236,2997
10351,3855209450,3509503263,1672666007,1672666534,527
10006,3710046567,3492056330,1672582650,1672585626,2976
9998,3669475165,3778044082,1672596931,1672599134,2203
11098,3716178116,3440671139,1672669555,1672671398,1843
10317,3417268745,3773424266,1672656300,1672657214,914
9846,3770019143,3776407517,1672674285,1672677467,3182
10802,3662794240,3391093411,1672684812,1672685811,999
11080,3894328297,3783563043,1672604981,1672605628,647
10949,3355899481,3399943757,1672602724,1672605339,2615
10316,3776778306,3777290300,1672553251,1672556467,3216
11208,3890194669,3882905311,1672601629,1672602901,1272
11634,3622218289,3757660578,1672684740,1672686648,1908
10698,3359472956,3772659062,1672551698,1672553799,2101
11398,3403120725,3203172170,1672591009,1672592404,1395
10878,3714731729,3514244308,1672550834,1672552989,2155
10243,3520779124,3287821258,1672658052,1672660778,2726
10410,3918981936,3916656185,1672663000,1672666364,3364
10551,3774355339,3711065081,1672585212,1672586144,932
10677,3334708091,3475845921,1672549731,1672550629,898
11469,3514013999,3205687719,1672657322,1672660177,2855
9794,3621439107,3501628472,1672652658,1672652827,169
10479,3308149799,3331471764,1672688458,1672690999,2541
11769,3778838936,3776291254,1672628010,1672630300,2290
11486,3884180202,3715246385,1672644280,1672647625,3345
10265,3880882684,3801501384,1672598274,1672599144,870
10808,3516535558,3760679372,1672701812,1672704195,2383
11516,3396440259,3933872044,1672632906,1672634433,1527
10115,3701655378,3809207482,1672627793,1672630238,2445
10468,3422081502,3791359168,1672631632,1672633334,1702
11470,3305656670,3793029132,1672648023,1672648667,644
9876,3730414796,3939422411,1672654121,1672656034,1913
10027,3834949242,3518408734,1672540319,1672542400,2081
10509,3533822490,3285322570,1672684887,1672686778,1891
10004,3413511621,3777931341,1672577361,1672580378,3017
10522,3294949958,3711171132,1672544376,1672544449,73
11215,3776124041,3893629892,1672645667,1672646231,564
10611,3439662051,3299587876,1672677260,1672679016,1756
9968,3772131127,3931917809,1672533253,1672533770,517
11099,3774633364,3853182912,1672645414,1672648308,2894
11555,3500096103,3616371564,1672677791,1672680359,2568
11338,3801501384,3413511621,1672620025,1672621148,1123
11424,3505438826,3510484107,1672653601,1672654434,833
9960,3316537706,3973134902,1672577434,1672579483,2049
10390,3778479297,3776778306,1672683183,1672685321,2138
11503,3479207976,3402580733,1672701261,1672702857,1596
11222,3223144610,3410788026,1672694012,1672694518,506
10471,3408408584,3791542842,1672697369,1672698615,1246
10685,3520049965,3511289729,1672689677,1672691864,2187
9879,3550405857,3478937459,1672614860,1672618127,3267
11250,3482687604,3832312129,1672626863,1672627221,358
11131,3282053097,3791841318,1672699598,1672701358,1760
10432,3313298164,3909822999,1672581491,1672581832,341
11067,3500317923,3295691964,1672572032,1672575156,3124
9933,3534102440,3713726267,1672544009,1672544794,785
10598,3505140123,3919211457,1672610153,1672612535,2382
10847,3555954355,3791581138,1672684072,1672685522,1450
10394,3367299721,3665603628,1672696103,1672696276,173
10185,3301403047,3358473096,1672562218,1672565589,3371
11707,3236886943,3501612813,1672633522,1672635696,2174
11267,3834980281,3517949586,1672611062,1672611996,934
10922,3627377299,3828354855,1672573207,1672574894,1687
11020,3519730914,3701512498,1672671545,1672674060,2515
11736,3510916875,3913746581,1672552727,1672554827,2100
11727,3919345990,3311260898,1672673223,1672675886,2663
10538,3714731729,3534362749,1672569411,1672570595,1184
10437,3345954031,3623512088,1672536450,1672538656,2206
10865,3519260216,3520558137,1672557132,1672559627,2495
9911,3468201976,3714525519,1672689209,1672690915,1706
10822,3611939581,3935333166,1672536469,1672538830,2361
9861,3309528048,3880000841,1672591434,1672592558,1124
11513,3823307824,3419762444,1672621340,1672622962,1622
10638,3668764192,3501427691,1672612169,1672613549,1380
11049,3713283029,3311805161,1672585915,1672586594,679
10270,3445733121,3780626668,1672692022,1672692584,562
10650,3938398160,3791825536,1672603085,1672604489,1404
10190,3826542169,3396656251,1672572825,1672575793,2968
10626,3715858201,3773376762,1672557132,1672559554,2422
11702,3342235058,3447253775,1672647845,1672649401,1556
11510,3352295704,3510919509,1672642914,1672644904,1990
10436,3793081195,3714787207,1672618882,1672621487,2605
11396,3773424266,3898592058,1672631388,1672632860,1472
11732,3715897627,3825932442,1672634002,1672636800,2798
10499,3701655378,3501427691,1672547044,1672548701,1657
11126,3779818784,3505839395,1672622594,1672623594,1000
10900,3533986052,3429409539,1672531419,1672531988,569
10335,3499343927,3517136772,1672558240,1672560124,1884
9805,3512750313,3278805844,1672584497,1672587887,3390
11453,3900766525,3500579482,1672570068,1672570776,708
9803,3773523569,3474097405,1672618450,1672619582,1132
11190,3287968403,3445406685,1672646534,1672649607,3073
10788,3822496670,3687445224,1672547921,1672550359,2438
11364,3471996194,3303432071,1672647706,1672650655,2949
9796,3772786559,3358959807,1672675404,1672677013,1609
11082,3881012415,3509828883,1672639189,1672642718,3529
10158,3520725149,3711722554,1672654844,1672656785,1941
9852,3510189563,3505786561,1672621222,1672622531,1309
10134,3755688231,3792337863,1672579275,1672581637,2362
11691,3892177203,3939422411,1672623466,1672625835,2369
10608,3776304080,3362385373,1672658130,1672659657,1527
10994,3303772923,3774436159,1672701152,1672704438,3286
10972,3221126799,3604569804,1672694338,1672695993,1655
10085,3774145748,3311142523,1672607890,1672611014,3124
11423,3911376818,3533209168,1672645550,1672648533,2983
10913,3500120676,3713476192,1672697686,1672698084,398
10161,3638071975,3351856699,1672574915,1672575680,765
10886,3295748489,3505867821,1672684630,1672686945,2315
10126,3220123678,3520625600,1672537406,1672538837,1431
10968,3484739955,3368441333,1672573661,1672574045,384
11048,3511206717,3374652108,1672613884,1672614165,281
10000,3801501384,3505121295,1672615138,1672617174,2036
10398,3396453219,3826997668,1672650476,1672653682,3206
10200,3896622009,3713434898,1672578008,1672581588,3580
10078,3819315404,3490804766,1672693788,1672694582,794
10006,3757994002,3515558215,1672651668,1672653790,2122
10729,3417268745,3493679801,1672685718,1672688336,2618
11613,3513545735,3701512498,1672579177,1672580884,1707
9958,3301332095,3755229631,1672646245,1672646358,113
10939,3715111016,3296970170,1672575131,1672578300,3169
10042,3419789418,3517718901,1672546325,1672548290,1965
11457,3912181197,3390537737,1672615807,1672619183,3376
10864,3756066765,3511296895,1672593560,1672594552,992
11178,3492056330,3703336988,1672544980,1672547150,2170
11378,3886837151,3906693728,1672650181,1672653542,3361
10353,3353326305,3607583720,1672660171,1672661352,1181
10668,3779723939,3773736248,1672563574,1672565969,2395
10164,3517766135,3773798215,1672631313,1672633871,2558
11126,3973138649,3882905311,1672702788,1672704577,1789
11280,3276499910,3533154906,1672692518,1672695581,3063
10127,3510373076,3779951373,1672693314,1672694928,1614
11511,3783067048,3884388188,1672582398,1672585827,3429
10336,3972653129,3515753241,1672587449,1672589310,1861
9912,3836757034,3822368676,1672677473,1672678833,1360
10821,3773411968,3636927297,1672675385,1672678206,2821
11721,3513092056,3342426430,1672592223,1672592900,677
11031,3756328353,3610723722,1672667914,1672670097,2183
9941,3711755596,3559123082,1672641963,1672642291,328
10067,3901217668,3813853446,1672692611,1672695642,3031
10803,3779160052,3533037906,1672668534,1672672083,3549
11497,3505245692,3558203963,1672609787,1672611476,1689
10963,3772909073,3514107131,1672695216,1672697666,2450
10675,3477951091,3391093411,1672576577,1672578310,1733
11729,3792797648,3338465050,1672669439,1672672804,3365
10885,3505901826,3822315407,1672591645,1672592867,1222
10282,3515699732,3510335069,1672550740,1672551435,695
10267,3205687719,3825526565,1672636028,1672639613,3585
11181,3977360666,3756736726,1672578408,1672579942,1534
11154,3387322545,3223144610,1672648861,1672650324,1463
10890,3884191432,3716595760,1672568655,1672572012,3357
10532,3710515351,3513739060,1672684501,1672684942,441
10184,3439662051,3623067708,1672648744,1672649223,479
10664,3440770466,3501583486,1672674008,1672676219,2211
11027,3415840750,3852275715,1672607196,1672608324,1128
10796,3333505404,3792900315,1672617685,1672619758,2073
10271,3534604516,3978417055,1672611174,1672611343,169
10190,3893932944,3517144269,1672574659,1672575186,527
10600,3923910914,3533867833,1672691816,1672693525,1709
9884,3972442654,3811629200,1672699682,1672700378,696
10695,3914353062,3343616490,1672701335,1672704192,2857
10136,3713100169,3421524698,1672566056,1672568577,2521
11344,3338642026,3934980229,1672557960,1672560117,2157
11031,3500421940,3851810349,1672693475,1672695185,1710
9918,3424988692,3413799143,1672645378,1672646331,953
11388,3774447975,3514145752,1672625738,1672628062,2324
9951,3757201138,3778318250,1672660803,1672662338,1535
10974,3514341451,3517440258,1672567459,1672569384,1925
10861,3776034313,3287968403,1672690405,1672693336,2931
10007,3447202943,3385124073,1672591858,1672594211,2353
9971,3235074007,3682086200,1672695841,1672697538,1697
11092,3899294071,3295787354,1672534409,1672537220,2811
11778,3701668745,3770709417,1672600467,1672602200,1733
10050,3811354125,3773017746,1672574738,1672575956,1218
10108,3732533330,3600978954,1672678456,1672678772,316
11665,3783357035,3627081426,1672631195,1672632413,1218
11409,3533427742,3778253021,1672664578,1672666742,2164
11185,3330466913,3241855333,1672612545,1672614646,2101
10463,3433902955,3793704155,1672533239,1672535547,2308
10840,3287734830,3387621912,1672660106,1672661077,971
11361,3289258397,3805831563,1672667266,1672667465,199
10659,3893043842,3760731595,1672688279,1672689652,1373
11002,3489205994,3609997804,1672655386,1672655890,504
11202,3334381941,3809194824,1672597840,1672600304,2464
11778,3856601074,3664478769,1672549979,1672551497,1518
10257,3850005949,3823307824,1672587543,1672588943,1400
9815,3832289185,3500096103,1672614673,1672616451,1778
11772,3444168914,3917243005,1672549183,1672549435,252
11445,3927181190,3780500331,1672691279,1672694797,3518
10122,3903065952,3770276815,1672599948,1672602342,2394
10172,3399173821,3612042508,1672638833,1672638897,64
11411,3509996827,3716341323,1672558265,1672560920,2655
9850,3402105276,3510758718,1672597480,1672599169,1689
11529,3249614888,3303747093,1672565975,1672566927,952
11352,3792930090,3760443176,1672561761,1672562566,805
11596,3501574882,3701663839,1672545683,1672547519,1836
10878,3791106473,3295691964,1672600350,1672600439,89
11321,3427527462,3886896755,1672658405,1672661207,2802
11768,3311045951,3666823095,1672584370,1672587386,3016
11083,3342495377,3283295213,1672535385,1672538959,3574
10807,3711131262,3612705426,1672663677,1672664309,632
11150,3512641538,3770273966,1672648534,1672651255,2721
9970,3783043770,3716423829,1672548442,1672549789,1347
11604,3287760230,3618024815,1672542233,1672545194,2961
11319,3855440101,3792107875,1672675099,1672677916,2817
10715,3770924034,3505266343,1672600207,1672602653,2446
10057,3341738186,3366961580,1672622226,1672625045,2819
10245,3778318250,3515096959,1672574042,1672575273,1231
10681,3397972945,3922480066,1672534278,1672536427,2149
11542,3791581138,3520182275,1672573416,1672575065,1649
11728,3518205307,3757199889,1672657431,1672660021,2590
9875,3600302127,3501901313,1672681300,1672681964,664
10086,3733870816,3756297396,1672691052,1672691552,500
10589,3890638402,3757378286,1672645624,1672647186,1562
9858,3500544306,3533867833,1672543190,1672543530,340
10151,3776901443,3206241691,1672662143,1672663360,1217
9927,3770630937,3793814153,1672629040,1672630148,1108
11564,3776867553,3755769254,1672606866,1672609785,2919
10218,3514564903,3271719569,1672681539,1672684155,2616
11074,3461877104,3513894659,1672600629,1672601772,1143
11205,3512769522,3757393413,1672576287,1672577588,1301
11451,3358530225,3501583486,1672544569,1672545669,1100
10161,3411626917,3912878303,1672565583,1672568632,3049
10485,3423217578,3519102732,1672680144,1672680704,560
10507,3912811715,3894328297,1672542925,1672545653,2728
11054,3661359073,3774598935,1672541797,1672544768,2971
9809,3299587876,3662055682,1672695243,1672698429,3186
11281,3497138014,3711945923,1672575627,1672575768,141
10599,3311521176,3345954031,1672659365,1672661979,2614
11410,3757199889,3246567963,1672644212,1672645498,1286
10340,3509394912,3314965818,1672653224,1672655451,2227
9895,3979115924,3601214648,1672583356,1672583424,68
11753,3501901313,3977666815,1672568152,1672570162,2010
10080,3884192843,3505998260,1672593356,1672594820,1464
11568,3919342147,3701512498,1672622402,1672624122,1720
10851,3732128078,3229734741,1672693380,1672696705,3325
10043,3515507526,3338115824,1672640925,1672641720,795
10139,3605078841,3517149023,1672547367,1672548766,1399
11004,3972729768,3371238318,1672689499,1672690302,803
10605,3334708091,3317190427,1672642083,1672642659,576
10208,3277634944,3512768285,1672625123,1672625639,516
10987,3534459983,3229465607,1672556625,1672559382,2757
11102,3273674596,3554236075,1672560037,1672561305,1268
10625,3882905311,3311739926,1672551965,1672555344,3379
9949,3245501577,3519055736,1672612920,1672615443,2523
10706,3852310652,3711518637,1672602635,1672604626,1991
10343,3715897627,3792512768,1672683509,1672683615,106
9834,3553640169,3715284599,1672665078,1672665620,542
11485,3311463998,3783067048,1672582913,1672584567,1654
10652,3601063076,3905955166,1672554423,1672556781,2358
10737,3288346356,3358959807,1672535913,1672537554,1641
11443,3621629499,3715844082,1672618158,1672619206,1048
11433,3703999217,3440743218,1672633568,1672634806,1238
10797,3770497768,3397330170,1672653386,1672654554,1168
11762,3703277359,3772962072,1672625009,1672625406,397
10529,3755209597,3380418745,1672691634,1672693913,2279
10571,3513215373,3430399931,1672654900,1672656060,1160
11742,3284374600,3236360179,1672548586,1672551203,2617
10502,3515715968,3487622510,1672570170,1672570291,121
10081,3776710698,3473706746,1672672516,1672675860,3344
11174,3667072319,3349319959,1672628175,1672629465,1290
11403,3559759778,3512417724,1672575554,1672576632,1078
11515,3380285779,3351153781,1672571204,1672574364,3160
10986,3400545490,3516378356,1672592202,1672593423,1221
11206,3206544535,3803473387,1672550908,1672553190,2282
10723,3291936679,3513800589,1672553356,1672554232,876
11391,3423800775,3715246385,1672683594,1672684325,731
10248,3776407517,3894756677,1672687048,1672687123,75
11675,3757607649,3312651192,1672631936,1672633787,1851
10390,3519848902,3309415277,1672649804,1672651473,1669
11372,3517045396,3447696555,1672568067,1672569409,1342
11628,3818532143,3856975355,1672534591,1672537719,3128
9943,3517552930,3416474842,1672646051,1672647162,1111
11000,3512477276,3710125627,1672565484,1672566047,563
10126,3780171640,3779778679,1672611777,1672613955,2178
11192,3505331014,3511867383,1672579681,1672581281,1600
11494,3388830370,3779748270,1672585906,1672589011,3105
9972,3307521389,3611533094,1672544967,1672547837,2870
10491,3534775239,3701675183,1672548020,1672548488,468
10480,3440671139,3615245840,1672700755,1672701604,849
11485,3776182849,3711599043,1672690592,1672693089,2497
10398,3517210356,3778195766,1672565859,1672567719,1860
11461,3287403291,3235313062,1672660889,1672662264,1375
10394,3500211484,3512750313,1672703800,1672704047,247
11180,3312800145,3396472026,1672682876,1672683068,192
11307,3780142207,3908862092,1672611175,1672614156,2981
10934,3932955949,3825153408,1672660391,1672662170,1779
10759,3499343927,3519297683,1672675299,1672675871,572
11250,3313579674,3372236721,1672585293,1672588631,3338
11296,3703104365,3520305100,1672564951,1672565714,763
10015,3701385831,3517949586,1672654206,1672657644,3438
10789,3756536476,3776968640,1672681870,1672683719,1849
11402,3662307789,3701385831,1672537295,1672540806,3511
10191,3475845921,3368441333,1672702470,1672704132,1662
9874,3755175497,3777878462,1672651248,1672654032,2784
10892,3349475873,3792824886,1672563435,1672565142,1707
11366,3777499535,3773636983,1672546751,1672548116,1365
11642,3317887374,3310737478,1672557603,1672558651,1048
10335,3319862687,3701459978,1672552257,1672552455,198
11278,3278805844,3906260966,1672627130,1672628828,1698
11552,3701925712,3778044082,1672627470,1672629812,2342
10954,3757623259,3242149533,1672703379,1672704215,836
11726,3714250543,3501171785,1672661574,1672663007,1433
10824,3305656670,3779130507,1672624317,1672627174,2857
10586,3855674398,3447554599,1672556741,1672557288,547
9887,3760322661,3822496670,1672593006,1672595417,2411
10294,3348343425,3311197635,1672696774,1672698543,1769
10689,3514107131,3779102237,1672587036,1672589384,2348
10831,3920155862,3514216460,1672580087,1672582167,2080
10422,3776440009,3432838598,1672694743,1672697952,3209
11315,3793274846,3520145112,1672624465,1672626828,2363
10987,3205113625,3533986052,1672681171,1672684618,3447
11157,3205687719,3472272792,1672663625,1672664130,505
10645,3632303304,3973138649,1672594229,1672597162,2933
11126,3533628528,3469780362,1672620582,1672623741,3159
10100,3520725149,3713374884,1672607459,1672607645,186
10981,3357074700,3779427180,1672686835,1672690388,3553
10403,3770105006,3633949990,1672607506,1672607598,92
10416,3367262509,3428878402,1672540608,1672543986,3378
11539,3713878219,3384151770,1672619497,1672621549,2052
10103,3778909412,3345028045,1672634738,1672638089,3351
10970,3930501172,3436774112,1672634021,1672636013,1992
11351,3835509670,3238779889,1672677978,1672680809,2831
10975,3716740576,3444168914,1672633747,1672636434,2687
11299,3803382101,3399173821,1672690244,1672693636,3392
10863,3501901313,3715724166,1672612424,1672613941,1517
11408,3512087090,3756428507,1672580767,1672582232,1465
11146,3515637968,3779415433,1672670113,1672671381,1268
10540,3234445133,3906693728,1672668793,1672671350,2557
10976,3424476995,3621591266,1672563735,1672564083,348
10426,3801501384,3755129708,1672663318,1672666912,3594
10866,3756328353,3441683673,1672533146,1672535611,2465
10197,3930501172,3481019442,1672540325,1672543702,3377
11599,3512203553,3307236682,1672703303,1672704231,928
11644,3501992314,3776778306,1672586079,1672588860,2781
10658,3975796415,3438028077,1672690438,1672691873,1435
11113,3831981073,3519621901,1672557614,1672559577,1963
11279,3601340045,3774606418,1672703387,1672704254,867
10897,3710260848,3305656670,1672686873,1672688470,1597
10773,3715196780,3600978954,1672652566,1672653327,761
10980,3776732532,3633622298,1672685740,1672687466,1726
11701,3516585063,3514033319,1672637095,1672640408,3313
10629,3662821438,3302416197,1672687917,1672689038,1121
11725,3482786946,3291153514,1672642934,1672646218,3284
11720,3312733562,3245755569,1672588046,1672590866,2820
11032,3468281011,3505175620,1672627718,1672628131,413
11243,3510291656,3342368576,1672651145,1672652739,1594
10685,3783157469,3505697295,1672576425,1672577664,1239
11168,3518931700,3828568868,1672682241,1672682728,487
9825,3773017746,3701265238,1672563403,1672565640,2237
11636,3778561231,3435037864,1672660529,1672661159,630
10655,3516535558,3930727474,1672669705,1672672562,2857
11325,3713740434,3512072679,1672601898,1672602994,1096
10158,3857847527,3780171640,1672548950,1672549932,982
9873,3533830748,3732312480,1672647367,1672648006,639
11135,3606688595,3613703906,1672584944,1672585655,711
10345,3772320856,3777405860,1672615816,1672618086,2270
10196,3776600696,3201634072,1672631007,1672633515,2508
11387,3397972945,3505560793,1672553315,1672553598,283
11186,3756668747,3612042508,1672678308,1672679839,1531
11449,3429047448,3609644043,1672693953,1672694212,259
11783,3533974355,3776791436,1672538441,1672541745,3304
10248,3778927933,3682150740,1672601349,1672604555,3206
10641,3554437212,3777909822,1672568009,1672570750,2741
11320,3783727937,3901169230,1672666902,1672670377,3475
10856,3533974355,3510535683,1672622632,1672624798,2166
9887,3716595760,3519712497,1672583899,1672587052,3153
11484,3851737350,3311739926,1672533195,1672533954,759
10650,3399430522,3755203055,1672553292,1672555573,2281
11757,3287760230,3682086200,1672566320,1672568631,2311
11423,3361865467,3663353552,1672643173,1672645992,2819
11692,3501407804,3505190512,1672635158,1672637707,2549
11121,3501192566,3366801723,1672647121,1672648558,1437
11427,3287760230,3306066522,1672637839,1672639602,1763
10864,3482786946,3512645289,1672558768,1672562244,3476
10435,3276230295,3856129522,1672666779,1672667391,612
9893,3380444321,3368176107,1672663275,1672665789,2514
10885,3857344874,3792578118,1672598313,1672599870,1557
10586,3662495290,3854229296,1672668192,1672670716,2524
10020,3399430522,3710680073,1672634333,1672635573,1240
11257,3555954355,3774965463,1672599947,1672600024,77
11193,3857344874,3379400553,1672647004,1672647137,133
10844,3716118473,3335055096,1672656671,1672657804,1133
10601,3471996194,3776710698,1672668239,1672670243,2004
10113,3407734098,3310712221,1672674124,1672676686,2562
11558,3285322570,3817076003,1672700597,1672701809,1212
11187,3918126468,3309651238,1672623149,1672625748,2599
9992,3757796416,3494680853,1672565057,1672568196,3139
10414,3801501384,3226037966,1672549741,1672552843,3102
11726,3505685294,3800434325,1672558406,1672560813,2407
10549,3791509881,3514585995,1672690217,1672691790,1573
9879,3733953055,3373018943,1672667666,1672668711,1045
10111,3465672238,3347172556,1672674825,1672678149,3324
10629,3756680289,3776182849,1672535718,1672537109,1391
10543,3354877289,3388463477,1672645867,1672646616,749
11412,3433902955,3482786946,1672683363,1672683862,499
11217,3224053074,3688410383,1672694967,1672697100,2133
10124,3295748489,3559123082,1672549476,1672552383,2907
10358,3400545490,3711938229,1672644938,1672647156,2218
9957,3713906305,3364660506,1672671348,1672674255,2907
10778,3770595035,3489212992,1672539322,1672540556,1234
10134,3284865931,3661543201,1672593100,1672595963,2863
11713,3374552204,3516321814,1672679805,1672679977,172
11030,3276209319,3703336988,1672644741,1672647670,2929
11240,3792267993,3368848936,1672557654,1672558391,737
11677,3393001196,3817315443,1672540133,1672540363,230
10271,3772569860,3610723722,1672657051,1672658347,1296
10725,3455907179,3780982229,1672677572,1672678243,671
11765,3496579251,3616403486,1672624724,1672625712,988
10507,3534168768,3435801763,1672590228,1672592230,2002
10271,3534168768,3410788026,1672593863,1672595378,1515
11640,3714250543,3517949586,1672682275,1672683862,1587
11128,3714688409,3480405740,1672663349,1672663853,504
11209,3777149336,3414387263,1672652967,1672653812,845
11761,3276393542,3757032266,1672556891,1672557372,481
11491,3533876927,3792497486,1672579143,1672582081,2938
11676,3418367752,3703938162,1672551827,1672553419,1592
11337,3825153408,3510484107,1672584095,1672586228,2133
11605,3480270940,3517551721,1672592823,1672593947,1124
10121,3902300755,3441737317,1672699164,1672702700,3536
11757,3776291254,3760274119,1672566076,1672566816,740
11634,3332840671,3519352855,1672640443,1672642966,2523
10271,3505190512,3714471069,1672603164,1672603991,827
11447,3519174861,3735197034,1672580493,1672580730,237
10205,3236948071,3835599049,1672600381,1672602643,2262
11003,3711131262,3701824335,1672595180,1672595311,131
10980,3394986304,3300810210,1672657940,1672658294,354
10278,3772262649,3783373085,1672585227,1672586745,1518
9885,3811629200,3509208005,1672625575,1672629170,3595
11217,3501853868,3207307681,1672649631,1672652880,3249
11000,3975796415,3716445184,1672703766,1672705970,2204
10990,3452982957,3772869013,1672655865,1672658997,3132
10723,3760966645,3304028109,1672560140,1672561298,1158
11587,3755374000,3780466967,1672657116,1672659010,1894
11271,3415032547,3501901313,1672642374,1672643973,1599
10941,3248409083,3500590302,1672592225,1672594399,2174
9804,3302879906,3884001167,1672577335,1672580626,3291
10547,3770972037,3505414878,1672535998,1672537957,1959
11566,3900793652,3793996996,1672538236,1672539173,937
11077,3514560138,3513213122,1672606646,1672608586,1940
10917,3431317400,3500104976,1672558281,1672559056,775
11471,3792708936,3406390503,1672695153,1672695531,378
10328,3223144610,3437934509,1672618566,1672621001,2435
10143,3435652260,3715790104,1672691956,1672694767,2811
10922,3275171954,3369938668,1672658240,1672660304,2064
11634,3732871856,3791906680,1672555631,1672559191,3560
10369,3273242177,3431317400,1672570016,1672571623,1607
10615,3773378103,3928076270,1672560637,1672562173,1536
11043,3458130310,3701865589,1672702156,1672704718,2562
10406,3449672240,3703725221,1672630433,1672633054,2621
10705,3792289287,3455955489,1672588443,1672590042,1599
11047,3882851213,3890211161,1672694703,1672694943,240
10707,3730414796,3773669001,1672643215,1672643463,248
11343,3500473064,3701311947,1672599894,1672603020,3126
11141,3426207439,3792785261,1672638178,1672640157,1979
9928,3923133978,3776125503,1672555917,1672557964,2047
11428,3246062632,3755394177,1672618240,1672618584,344
10520,3755630085,3896211741,1672574776,1672575938,1162
10653,3703742071,3756297396,1672606809,1672607673,864
10420,3482786946,3701971784,1672661798,1672665286,3488
10562,3713285095,3772751765,1672587021,1672588207,1186
10178,3711179193,3533960602,1672672526,1672676000,3474
11319,3287760230,3207497598,1672663569,1672664544,975
10881,3608214600,3778932673,1672619661,1672620170,509
10161,3558264627,3770533588,1672681978,1672684257,2279
11296,3516904926,3509556649,1672581954,1672585406,3452
9871,3715881104,3240683148,1672574740,1672577729,2989
11150,3711518637,3770709417,1672700084,1672700421,337
10883,3220798451,3783157469,1672539181,1672540216,1035
9842,3516472352,3500429731,1672664176,1672665868,1692
9892,3391093411,3388481990,1672664594,1672665042,448
9910,3500695402,3779102237,1672533950,1672536732,2782
11336,3519465545,3760731595,1672672502,1672673693,1191
10321,3776583229,3757549235,1672695383,1672697901,2518
10034,3311305760,3505697295,1672597851,1672598798,947
9957,3774682234,3774663639,1672699218,1672700036,818
10416,3435159896,3533077580,1672587414,1672590839,3425
10872,3533628528,3505697295,1672585081,1672586641,1560
11435,3367526113,3482172065,1672611829,1672613393,1564
10757,3500093945,3302348002,1672590216,1672591157,941
9944,3345028045,3510484107,1672645422,1672648196,2774
9934,3701534043,3533867833,1672586883,1672589159,2276
11327,3760382349,3938409715,1672637391,1672638542,1151
9925,3515558215,3901169230,1672601910,1672603488,1578
10147,3518157683,3444397804,1672683274,1672683875,601
10654,3488988274,3822368676,1672692491,1672693479,988
10249,3392482187,3435715962,1672692853,1672693259,406
10271,3513802404,3505117019,1672596059,1672598445,2386
10323,3632094087,3609103278,1672613204,1672615145,1941
10941,3359012188,3519174861,1672578602,1672579675,1073
11569,3664523809,3500209015,1672544892,1672546502,1610
10401,3703462221,3501873139,1672614691,1672614871,180
9995,3516517348,3924963918,1672629074,1672629813,739
11628,3533960602,3773161055,1672678645,1672681274,2629
11442,3894495222,3406238754,1672684618,1672687895,3277
10163,3520165730,3735422623,1672537294,1672539983,2689
11425,3430296808,3778370462,1672636981,1672638795,1814
10295,3518572231,3820280594,1672587707,1672590645,2938
10048,3778741325,3515726910,1672685077,1672688578,3501
10538,3533728729,3739844610,1672543175,1672544529,1354
10507,3711258452,3716733618,1672669573,1672672190,2617
9987,3703849264,3466492108,1672619283,1672621652,2369
11359,3931495845,3245755569,1672553311,1672553741,430
9927,3491390365,3933731871,1672532139,1672532290,151
11600,3340723781,3467663782,1672644249,1672646504,2255
10869,3510968599,3792440162,1672687645,1672688793,1148
10890,3826068495,3773826624,1672597351,1672597904,553
10702,3423782420,3364683368,1672659599,1672659732,133
10768,3229465607,3703048107,1672638803,1672639776,973
10019,3479402555,3755849241,1672544884,1672545865,981
10603,3244397548,3517960157,1672619699,1672623248,3549
10364,3500674240,3779835734,1672622238,1672625184,2946
10243,3778924002,3249380931,1672638458,1672638906,448
11459,3442096275,3701567668,1672605807,1672606078,271
11719,3534667712,3358385652,1672594575,1672596490,1915
10481,3231271498,3972196462,1672664681,1672667676,2995
11524,3711722554,3772708314,1672606375,1672609918,3543
10230,3856129522,3793442891,1672665637,1672667484,1847
11587,3777074709,3201920708,1672531409,1672533841,2432
11122,3534426696,3515096959,1672665225,1672665953,728
10544,3290797257,3821082558,1672552140,1672555051,2911
11680,3760776967,3711804184,1672596610,1672599390,2780
11602,3511645260,3519435459,1672700688,1672702164,1476
11082,3287753579,3778842400,1672674188,1672674410,222
10753,3317989975,3310702648,1672682622,1672683708,1086
11698,3713471446,3773434690,1672588244,1672590528,2284
10971,3934070285,3783879023,1672692088,1672693594,1506
10059,3358262975,3403870769,1672598529,1672600122,1593
11071,3398021818,3311583437,1672560593,1672561065,472
9860,3534168768,3500543341,1672537639,1672539749,2110
10296,3660246433,3387388336,1672563398,1672566478,3080
10564,3295530454,3520558137,1672676202,1672678185,1983
11420,3897500723,3703474558,1672569345,1672570199,854
10485,3755107521,3294949958,1672614556,1672617751,3195
10996,3501027795,3972442654,1672575548,1672575822,274
10922,3780576351,3224040894,1672539536,1672539856,320
10019,3703614781,3510916875,1672642327,1672643345,1018
10062,3780680252,3339649817,1672589625,1672591920,2295
11167,3343859998,3776193847,1672595419,1672598920,3501
9868,3855977674,3272096922,1672660878,1672664200,3322
10141,3207748225,3515096959,1672668870,1672669578,708
10914,3311142523,3533440294,1672615358,1672617913,2555
11109,3756525103,3510178791,1672701713,1672702681,968
10674,3897107253,3394357241,1672662583,1672663965,1382
11024,3533365834,3429610195,1672650353,1672653751,3398
11305,3505531432,3791074200,1672549461,1672550944,1483
11167,3487622510,3399430522,1672576377,1672579208,2831
10618,3500720752,3501261089,1672589580,1672590245,665
11378,3776901443,3780921044,1672677659,1672680287,2628
11549,3317887374,3909632424,1672541715,1672542209,494
11557,3714281795,3826315540,1672681177,1672683377,2200
11293,3774702364,3552261072,1672548044,1672551096,3052
11043,3249771731,3915962248,1672564025,1672566994,2969
11417,3364286028,3316551382,1672615750,1672618007,2257
11171,3755465396,3209075485,1672645141,1672647004,1863
10419,3393128259,3286862903,1672581076,1672582144,1068
11458,3791664049,3896615831,1672698912,1672699619,707
9877,3774325486,3817315443,1672646563,1672648268,1705
10574,3714179543,3520926977,1672589379,1672591849,2470
11654,3737745988,3500019810,1672635509,1672638855,3346
10706,3515284733,3510819040,1672574854,1672578148,3294
10678,3334936138,3689420679,1672534470,1672537747,3277
11428,3482786946,3818532143,1672591928,1672593298,1370
11690,3755175497,3774238066,1672587669,1672589270,1601
11066,3343767438,3512697456,1672611403,1672611485,82
10603,3783086267,3625400710,1672633972,1672636048,2076
9963,3716944983,3818324410,1672668798,1672671274,2476
11224,3475090917,3225371682,1672593160,1672595396,2236
11170,3500057674,3783122313,1672578524,1672580929,2405
11776,3776193847,3905571273,1672604400,1672605592,1192
11547,3552261072,3780900318,1672543448,1672546627,3179
11250,3505164060,3447267291,1672693748,1672695234,1486
10224,3514007122,3309528048,1672610227,1672610480,253
10082,3780969898,3402105276,1672554294,1672555617,1323
10342,3557528150,3311188620,1672639589,1672641999,2410
10820,3559754304,3777672363,1672632878,1672633759,881
10736,3512492332,3638071975,1672677226,1672680094,2868
10927,3730169449,3621629499,1672560661,1672563842,3181
11263,3451757423,3293673220,1672650743,1672653544,2801
11293,3304592684,3716160006,1672685889,1672687722,1833
11120,3937854073,3776841808,1672611618,1672613089,1471
10590,3500096103,3505266343,1672610422,1672611877,1455
10687,3220123678,3482687604,1672694086,1672696431,2345
10399,3973138649,3772905073,1672538308,1672540350,2042
10142,3636857871,3772708314,1672593628,1672594497,869
10966,3285201542,3773768643,1672556553,1672557103,550
10953,3520057139,3432762943,1672702625,1672704787,2162
11028,3510484107,3500741005,1672675472,1672677431,1959
10962,3819400315,3236254381,1672563566,1672565767,2201
10438,3903994989,3379400553,1672557840,1672561351,3511
10538,3715249954,3666823095,1672531272,1672532158,886
11534,3780467276,3667654673,1672663232,1672666571,3339
10933,3227919286,3756647451,1672612119,1672614258,2139
9808,3469778316,3235578852,1672600051,1672600153,102
11153,3405221863,3555378248,1672697515,1672699296,1781
9913,3774450494,3493679801,1672625750,1672626274,524
10135,3501261089,3208560443,1672691075,1672693945,2870
11285,3660980656,3519730914,1672615623,1672617083,1460
10186,3516668203,3778738044,1672612871,1672615522,2651
11281,3681274982,3711770773,1672613683,1672616903,3220
10262,3756493561,3896840409,1672549297,1672550472,1175
9939,3501557463,3681504869,1672555296,1672558336,3040
9918,3780050328,3703481882,1672612567,1672614536,1969
11467,3509626590,3441737317,1672562472,1672563197,725
11316,3379076106,3516319492,1672534646,1672535416,770
10663,3307236682,3893932944,1672558370,1672561084,2714
11203,3318590083,3490008012,1672631561,1672633401,1840
11027,3701770921,3713547793,1672635637,1672636550,913
10004,3714688409,3368079099,1672583008,1672585239,2231
11035,3756850160,3487779363,1672657166,1672658062,896
10626,3299743638,3760554453,1672552419,1672553817,1398
11118,3366961580,3514560138,1672681535,1672682661,1126
11056,3756367938,3533036499,1672656440,1672659744,3304
10041,3501515425,3338115824,1672664258,1672666697,2439
10795,3512411326,3668202976,1672677033,1672679796,2763
11670,3513802404,3687445224,1672655788,1672657405,1617
10745,3820280594,3510864325,1672682785,1672686122,3337
9834,3319585148,3409514897,1672671324,1672671629,305
10292,3381254180,3343859998,1672695590,1672695822,232
11349,3701459978,3316821313,1672650072,1672651031,959
10283,3553008208,3977209952,1672670496,1672673006,2510
10555,3500674240,3837378340,1672535792,1672539111,3319
11291,3458271585,3922480066,1672582157,1672583659,1502
10441,3474097405,3514341451,1672666415,1672669314,2899
10545,3776583229,3370751461,1672546821,1672549077,2256
9922,3230612965,3514515499,1672609963,1672613362,3399
11407,3295691964,3791974273,1672617591,1672619571,1980
11623,3713740434,3423782420,1672624880,1672627295,2415
11583,3245245283,3231859576,1672552451,1672555111,2660
11287,3757198930,3716463756,1672558024,1672559973,1949
11562,3701675183,3905934770,1672687239,1672687490,251
11542,3311774510,3669140241,1672592758,1672594255,1497
10285,3307791650,3703351452,1672578332,1672580556,2224
10582,3512768285,3238310644,1672534829,1672536022,1193
11292,3497904539,3203909360,1672628644,1672629129,485
11372,3533816813,3510882576,1672550084,1672552060,1976
10557,3660702754,3774939922,1672695288,1672697219,1931
10266,3229570647,3806034626,1672620019,1672623267,3248
10461,3461630842,3345896913,1672665414,1672667080,1666
11596,3701725839,3415840750,1672599208,1672601567,2359
10665,3505665788,3485151614,1672606406,1672609377,2971
10537,3358262975,3791796190,1672637403,1672639327,1924
10784,3515984911,3793442891,1672555803,1672557463,1660
10933,3519724388,3939851140,1672632361,1672633414,1053
10692,3835599049,3732223664,1672686468,1672689267,2799
10053,3825234433,3388774559,1672597878,1672599879,2001
11554,3304252969,3638050763,1672551158,1672552396,1238
11725,3776053084,3501992314,1672671045,1672673375,2330
10842,3737738751,3927699036,1672576473,1672578770,2297
11264,3680939042,3500814753,1672544406,1672545020,614
11624,3772844451,3466655775,1672545431,1672548524,3093
10528,3772343750,3514327931,1672635758,1672639036,3278
10783,3710622746,3715261950,1672575863,1672577779,1916
10909,3511311554,3776279305,1672622952,1672624357,1405
11191,3479585868,3236512807,1672657174,1672659183,2009
11714,3755502373,3428303756,1672665472,1672665864,392
10276,3663902064,3505416534,1672537457,1672539481,2024
11454,3772296376,3497732613,1672570956,1672573330,2374
11385,3512965991,3509018337,1672639100,1672640582,1482
10043,3802374620,3778382224,1672577895,1672578826,931
10174,3912862842,3919211457,1672661708,1672662072,364
11518,3517426473,3907923381,1672624563,1672625746,1183
10602,3668764192,3519948471,1672691090,1672694556,3466
10076,3510486220,3275975921,1672678620,1672681697,3077
10242,3517377614,3445558740,1672545198,1672546471,1273
10955,3517499844,3734233216,1672557692,1672558837,1145
11777,3711214982,3293157673,1672543703,1672546945,3242
10144,3559754304,3534426696,1672583852,1672585705,1853
11417,3345896913,3496352027,1672658129,1672659832,1703
9946,3293579860,3668955834,1672538857,1672539196,339
9956,3295710494,3465107990,1672572656,1672574033,1377
11500,3834424604,3505697295,1672629189,1672632089,2900
11070,3355430975,3897186782,1672692671,1672695296,2625
11210,3511969443,3500455935,1672692146,1672693259,1113
11311,3774589551,3713807753,1672663624,1672665370,1746
10686,3772250554,3471507117,1672580433,1672583589,3156
11608,3612841103,3519553933,1672538699,1672539643,944
10436,3714101349,3938059867,1672674806,1672676092,1286
11439,3208560443,3491948594,1672635357,1672637674,2317
11648,3403218814,3238310644,1672632282,1672632795,513
9844,3512546783,3854957153,1672681148,1672684025,2877
11681,3534775239,3453538201,1672606809,1672608145,1336
11417,3534624672,3919494952,1672664929,1672666465,1536
9906,3422314045,3291936679,1672552020,1672553002,982
11181,3760529327,3491250381,1672536678,1672536930,252
10621,3817076003,3713805968,1672570333,1672572820,2487
10148,3354015456,3779212271,1672585497,1672587301,1804
10759,3208594306,3755502373,1672631108,1672633895,2787
10112,3304227085,3494560663,1672607302,1672609218,1916
11649,3757607649,3501253130,1672623146,1672626205,3059
11353,3774450494,3204821370,1672678974,1672680342,1368
10229,3416474842,3313101243,1672675242,1672677407,2165
10730,3776778306,3478052226,1672586633,1672588738,2105
11545,3228218081,3686860179,1672613090,1672616355,3265
10763,3715881104,3409098014,1672580868,1672583945,3077
10261,3287821258,3510159441,1672640211,1672643005,2794
10722,3491250381,3392573386,1672685268,1672686474,1206
10749,3716389356,3553321027,1672675174,1672675683,509
11014,3792785261,3756428507,1672538468,1672541109,2641
10922,3760322661,3783060739,1672584613,1672588195,3582
11385,3603740088,3772070986,1672577090,1672578771,1681
11477,3208962614,3501557463,1672626407,1672628304,1897
11106,3459799131,3895507040,1672639598,1672642806,3208
11127,3629248353,3429333292,1672581249,1672581708,459
10040,3233965781,3468201976,1672610376,1672612969,2593
11329,3514297012,3476308535,1672660779,1672661517,738
10813,3313298164,3715897627,1672560841,1672561438,597
9903,3714902042,3375906394,1672649851,1672651593,1742
10574,3497904539,3756536512,1672684069,1672685209,1140
10722,3857609616,3778741325,1672678233,1672679352,1119
11119,3714919471,3933731871,1672622371,1672624769,2398
9837,3533703578,3777552831,1672699162,1672699898,736
11546,3303772923,3793926338,1672672622,1672674332,1710
11649,3738103378,3904184638,1672566732,1672569616,2884
10031,3272838634,3703659324,1672638899,1672640605,1706
10299,3838748301,3500927619,1672603774,1672606722,2948
10342,3500591274,3710046567,1672580821,1672582263,1442
10249,3881012415,3972196462,1672674570,1672677978,3408
9958,3791194984,3893950585,1672532737,1672535741,3004
11773,3624365837,3311529105,1672626538,1672628695,2157
10763,3209075485,3828568868,1672691170,1672692293,1123
9841,3716891903,3634766042,1672687042,1672690333,3291
10717,3476958001,3736036532,1672545942,1672547310,1368
11434,3245245283,3511744756,1672596226,1672596821,595
10415,3519435459,3500051606,1672537701,1672539772,2071
11384,3809207482,3533209168,1672596305,1672598312,2007
11497,3972729768,3245882008,1672682947,1672683216,269
10442,3513092056,3557324887,1672579641,1672582527,2886
11113,3732596503,3701887470,1672598426,1672600459,2033
10266,3484483775,3509457543,1672595453,1672597175,1722
10313,3330188769,3510680251,1672533168,1672533309,141
10687,3713444403,3756680289,1672666481,1672667353,872
10092,3368951504,3622458047,1672660034,1672662503,2469
11338,3510454018,3231271498,1672665660,1672666143,483
11225,3780074082,3932955949,1672640579,1672642137,1558
10330,3512154443,3713219299,1672638497,1672641987,3490
10792,3445355677,3416079461,1672693382,1672694777,1395
10487,3505121295,3858429342,1672688145,1672691653,3508
11570,3777992576,3375906394,1672670121,1672670598,477
10684,3792597493,3896615831,1672689791,1672690660,869
11132,3518368900,3780013266,1672645548,1672647880,2332
9816,3512625661,3304447950,1672576768,1672578575,1807
11730,3770630937,3488988274,1672662422,1672665650,3228
11709,3245774173,3307997700,1672581086,1672583716,2630
11138,3791289855,3335353798,1672645532,1672648118,2586
11186,3501600785,3414841458,1672559866,1672561196,1330
9817,3666561358,3518882056,1672554687,1672554998,311
9886,3837888196,3773579644,1672592974,1672596249,3275
11014,3311449914,3485151614,1672608461,1672612004,3543
10195,3662794240,3711770853,1672632644,1672633352,708
11518,3711599043,3772882440,1672582093,1672584732,2639
10444,3777387533,3703048107,1672659639,1672659815,176
10610,3360949039,3822634862,1672687810,1672688763,953
10078,3516651799,3405221863,1672577374,1672577660,286
10070,3534204885,3713875941,1672621029,1672624612,3583
10757,3917905192,3278805844,1672581689,1672582809,1120
10634,3509445318,3306491253,1672643382,1672643528,146
11312,3770966950,3756157377,1672587050,1672587866,816
11230,3774145748,3934980229,1672547549,1672550177,2628
11541,3500317923,3366566029,1672634422,1672637247,2825
10905,3274739459,3512625661,1672690266,1672690394,128
10491,3505804611,3773848111,1672693789,1672696015,2226
10446,3713416756,3501600785,1672664286,1672666635,2349
10340,3817038422,3342495377,1672608987,1672610319,1332
11148,3892487982,3603167427,1672546173,1672546991,818
11313,3910049345,3517377614,1672568045,1672570828,2783
11651,3428198021,3417431173,1672555015,1672555581,566
10756,3777370992,3711015176,1672547953,1672551251,3298
9832,3839417558,3791332226,1672621796,1672625319,3523
9859,3513629502,3200320674,1672636709,1672637732,1023
10090,3517377614,3307454562,1672547405,1672550356,2951
10345,3510939082,3512784888,1672601306,1672602356,1050
10679,3738103378,3776732532,1672591654,1672592459,805
10252,3358434853,3454343398,1672555390,1672557845,2455
11156,3310702648,3533265491,1672556603,1672557760,1157
10887,3793081195,3457249798,1672539294,1672540150,856
9931,3311479294,3519513219,1672626068,1672627827,1759
11595,3519922921,3505547832,1672580574,1672582533,1959
10412,3225554956,3681274982,1672539135,1672539314,179
10871,3714250543,3760107540,1672644715,1672645471,756
10205,3711223297,3755922811,1672547898,1672550312,2414
9835,3501126057,3516026189,1672681349,1672681410,61
10952,3773853619,3774939922,1672532683,1672534606,1923
9930,3515939841,3823600319,1672561844,1672563546,1702
11127,3300238532,3893932944,1672547813,1672549976,2163
10537,3222364320,3783879023,1672639771,1672640906,1135
10818,3713107380,3714312797,1672673907,1672675363,1456
10578,3779723939,3510826414,1672576299,1672579738,3439
10609,3739844610,3235373942,1672680731,1672684254,3523
10353,3689386663,3298706213,1672579212,1672580336,1124
11264,3783172505,3501619113,1672540742,1672543605,2863
11402,3555763674,3757678397,1672590757,1672592157,1400
11785,3711243126,3760648750,1672656262,1672657103,841
11317,3686853863,3350631472,1672533981,1672535035,1054
11303,3481700413,3912878303,1672690518,1672691024,506
11635,3501734800,3850904092,1672657263,1672658283,1020
10110,3519356606,3978417055,1672538000,1672541331,3331
11086,3714074120,3772689657,1672637756,1672639446,1690
11673,3428878402,3733730342,1672534838,1672537121,2283
11336,3817478012,3246804115,1672599143,1672600537,1394
11480,3774326754,3304697982,1672678886,1672681053,2167
10105,3534284132,3603682643,1672639827,1672642199,2372
10469,3710865678,3757728121,1672624555,1672625703,1148
9880,3636857871,3836136159,1672693803,1672695610,1807
11340,3778479297,3378747834,1672674717,1672677739,3022
10672,3776316903,3905571273,1672560849,1672563631,2782
10888,3236563828,3534362749,1672636416,1672636916,500
9883,3518572231,3398021818,1672652179,1672653676,1497
11634,3509018337,3512625661,1672651221,1672651593,372
10984,3514455363,3938409715,1672696138,1672699594,3456
11099,3353194923,3783554600,1672638205,1672639189,984
11092,3770019143,3757514745,1672654576,1672657152,2576
10058,3387870683,3534362749,1672565337,1672568870,3533
11176,3511466117,3791796190,1672700013,1672700308,295
10472,3802625412,3909822999,1672672990,1672674100,1110
10829,3812516461,3285587972,1672648949,1672651646,2697
11621,3774316305,3510680251,1672545105,1672546608,1503
11262,3501619113,3924583142,1672541505,1672542949,1444
10157,3295710494,3779835734,1672585703,1672585795,92
11773,3492350318,3407734098,1672649127,1672651802,2675
10302,3455907179,3818324410,1672538286,1672539964,1678
11357,3772893815,3459799131,1672671265,1672672836,1571
11318,3783357035,3396440259,1672548067,1672549530,1463
11705,3770476738,3812559393,1672641413,1672642734,1321
9979,3307521389,3517902505,1672599224,1672602242,3018
11612,3410602007,3516335333,1672593595,1672594535,940
11473,3509073025,3387621912,1672585811,1672587721,1910
11722,3903879740,3713514933,1672699236,1672700484,1248
11725,3505032773,3519712497,1672616458,1672616553,95
10040,3714595459,3501835995,1672577325,1672580569,3244
10615,3793332600,3839744168,1672575127,1672575255,128
10588,3701567668,3555954355,1672686192,1672689027,2835
11252,3248061684,3791368349,1672617678,1672619205,1527
11704,3229465607,3909822999,1672667930,1672670575,2645
10251,3204473480,3534589501,1672566582,1672568638,2056
11104,3780648744,3293157673,1672632332,1672635450,3118
10194,3713195480,3777370992,1672543798,1672544079,281
10563,3452175941,3774394000,1672615164,1672618387,3223
10665,3757050615,3600441934,1672662250,1672662632,382
11030,3293157673,3500579482,1672611307,1672612979,1672
10010,3713996094,3488988274,1672604172,1672607172,3000
10500,3512527440,3505653701,1672632977,1672633739,762
10119,3826997668,3501225887,1672640736,1672642623,1887
11733,3554437212,3534984243,1672560013,1672561995,1982
9901,3738429905,3793497672,1672566778,1672569961,3183
11170,3779609338,3505571800,1672672113,1672674359,2246
10978,3774205060,3509503263,1672703084,1672704522,1438
11375,3711770773,3512784888,1672604259,1672607632,3373
9870,3703624327,3925208102,1672649647,1672651243,1596
9936,3829698950,3610806770,1672648812,1672651009,2197
10270,3900195680,3668855144,1672679146,1672682463,3317
11755,3779478448,3513111053,1672600696,1672601698,1002
11782,3281148858,3770780655,1672565511,1672566693,1182
10842,3857847527,3715737742,1672587889,1672588989,1100
11172,3201957157,3776124041,1672688158,1672690378,2220
10630,3780612543,3714179543,1672573726,1672575619,1893
10273,3347172556,3791688526,1672552917,1672554557,1640
10805,3444168914,3512753567,1672638195,1672640607,2412
10657,3620836520,3534624672,1672639967,1672643071,3104
10972,3240683148,3311472321,1672659318,1672661273,1955
11208,3312959324,3408111327,1672642694,1672644023,1329
10624,3777112124,3248409083,1672540468,1672542846,2378
10111,3207497598,3714101349,1672666934,1672669644,2710
11640,3792432094,3510824484,1672634073,1672637183,3110
11344,3512768285,3636927297,1672537087,1672539852,2765
11768,3379400553,3971422524,1672544855,1672546742,1887
10722,3500096103,3406169279,1672533009,1672535886,2877
11732,3710865678,3881579907,1672643568,1672644366,798
10029,3516815069,3715712376,1672674208,1672674748,540
10111,3770972037,3776249160,1672627356,1672627620,264
10890,3617771673,3398862999,1672695034,1672696633,1599
10298,3518759318,3621439107,1672564721,1672566932,2211
11324,3715566511,3501927452,1672632667,1672635499,2832
10436,3710813103,3778824229,1672626797,1672628552,1755
11069,3444295435,3710680073,1672672334,1672674815,2481
9817,3715246385,3838748301,1672601250,1672604138,2888
11695,3424425746,3473706746,1672697224,1672698874,1650
11481,3937854073,3519521903,1672587626,1672589480,1854
11397,3426207439,3820200446,1672543246,1672544924,1678
10263,3510368377,3440770466,1672687833,1672688780,947
10559,3304252969,3772251279,1672554018,1672556757,2739
10213,3473562779,3424988692,1672675272,1672677670,2398
10728,3793949077,3437703650,1672660274,1672663735,3461
9932,3711029952,3780142207,1672574460,1672577179,2719
9828,3812677669,3231859576,1672567431,1672570376,2945
10326,3500928990,3770172119,1672597805,1672599150,1345
10708,3423346297,3514021667,1672572015,1672573903,1888
10226,3714264759,3203837944,1672636267,1672637003,736
11515,3805831563,3701377471,1672566083,1672569486,3403
11465,3500799617,3713726267,1672568026,1672569978,1952
10394,3770023722,3854390432,1672626151,1672626581,430
10020,3770424892,3429610195,1672678221,1672678903,682
11260,3778819352,3819315404,1672595821,1672597978,2157
10664,3776440009,3519352855,1672655023,1672657618,2595
11505,3714268380,3832745283,1672578320,1672578671,351
10274,3334936138,3206926634,1672673518,1672675963,2445
10716,3662307789,3533960602,1672550189,1672550467,278
11418,3710316008,3935333166,1672635908,1672638497,2589
10510,3444397804,3429610195,1672608673,1672609334,661
11655,3714179543,3926065090,1672586020,1672588879,2859
11122,3435037864,3733796228,1672541028,1672541931,903
11013,3353194923,3458432407,1672664558,1672667512,2954
10072,3283785820,3516827471,1672677627,1672678059,432
10802,3505826673,3533325993,1672566342,1672568155,1813
10034,3783430498,3517045396,1672687550,1672691022,3472
10000,3368441333,3791088014,1672537515,1672540570,3055
11301,3505491969,3512288503,1672541052,1672544541,3489
9851,3778318250,3772112976,1672562248,1672562998,750
11657,3760322661,3778370462,1672602575,1672604789,2214
11030,3519886257,3533017131,1672589623,1672591599,1976
9883,3770018912,3715261950,1672617512,1672620120,2608
10965,3822634862,3857847527,1672646727,1672648902,2175
11360,3297624618,3714101349,1672655208,1672655883,675
11625,3714870496,3304252969,1672560644,1672564079,3435
10748,3500329674,3760737203,1672578744,1672581379,2635
10916,3836090778,3512641538,1672564031,1672567629,3598
10488,3885422379,3756345026,1672696534,1672699439,2905
11027,3509996827,3520725149,1672602633,1672604447,1814
11229,3793003432,3285587972,1672691818,1672693771,1953
10384,3885147558,3342027511,1672577582,1672579708,2126
9853,3512546783,3362706073,1672597565,1672600437,2872
11081,3778842400,3438028077,1672586869,1672588314,1445
11576,3818236682,3274341934,1672642719,1672642783,64
9972,3227956115,3494680853,1672602741,1672605528,2787
11493,3622152515,3936871734,1672624136,1672625581,1445
11162,3858330969,3714268380,1672694489,1672696655,2166
11344,3609335008,3500544306,1672558051,1672561341,3290
11158,3910020031,3301431129,1672540673,1672543670,2997
11410,3610806770,3517331746,1672639831,1672640241,410
11600,3364286028,3701841013,1672594202,1672594779,577
9797,3713031958,3402020492,1672588789,1672588868,79
11445,3687445224,3311414429,1672640738,1672643712,2974
10706,3228218081,3359012188,1672637192,1672640436,3244
11690,3777135415,3301449986,1672695889,1672697140,1251
10580,3510801769,3500624846,1672532761,1672534111,1350
11297,3293673220,3609997804,1672592840,1672593524,684
10586,3793699467,3378747834,1672675291,1672676150,859
10593,3713374884,3481019442,1672639700,1672642057,2357
10054,3510781595,3627377299,1672698641,1672699956,1315
10539,3316537706,3429610195,1672531536,1672531629,93
11326,3802625412,3780942505,1672662605,1672665509,2904
11279,3791617239,3715622084,1672590062,1672590438,376
9888,3384170206,3519435459,1672656408,1672656637,229
11376,3716676869,3371184929,1672594721,1672598242,3521
11490,3484490325,3757001552,1672551057,1672551152,95
11620,3247193800,3760656396,1672669604,1672672238,2634
9935,3520009158,3882580580,1672557852,1672558727,875
10996,3516586325,3813276198,1672645242,1672647792,2550
11610,3774627091,3681504869,1672563602,1672566808,3206
10213,3203837944,3510484107,1672629782,1672630094,312
10189,3756272704,3919494952,1672703800,1672707016,3216
11627,3756367938,3520022175,1672660387,1672660787,400
10101,3516965624,3793920312,1672679833,1672680052,219
11482,3613940925,3773554767,1672574291,1672576780,2489
10148,3235313062,3468281011,1672596701,1672599002,2301
10905,3627377299,3357026115,1672650177,1672651835,1658
10394,3716669659,3755865626,1672660964,1672663851,2887
10548,3893629892,3534506090,1672666284,1672667859,1575
10768,3927763819,3229621693,1672539400,1672541272,1872
11098,3500596577,3201573194,1672558924,1672559052,128
11601,3925792265,3505183641,1672593773,1672594621,848
10039,3352295704,3780733404,1672556346,1672558564,2218
11062,3505547832,3779835734,1672541993,1672543206,1213
10775,3513140146,3226172318,1672640945,1672643032,2087
11605,3351728355,3516486526,1672701077,1672703807,2730
11007,3774921252,3505496725,1672559853,1672561905,2052
9819,3318224774,3714640103,1672627446,1672627672,226
11189,3515528947,3393001196,1672653354,1672656361,3007
11247,3713906305,3821082558,1672658103,1672660243,2140
10687,3971447562,3608973523,1672566017,1672566739,722
10265,3716209499,3516497645,1672669381,1672672154,2773
11274,3809860102,3450164574,1672593978,1672594056,78
9959,3520160414,3732871856,1672591953,1672592362,409
10452,3732223664,3356599815,1672557473,1672558226,753
11790,3710316008,3444646562,1672546998,1672549417,2419
11459,3366501813,3662495290,1672686211,1672688406,2195
11177,3249614888,3203876438,1672635905,1672636815,910
10148,3306491253,3733870816,1672553579,1672556705,3126
10923,3713107380,3520694387,1672550374,1672552013,1639
10216,3358982831,3902023467,1672666537,1672669885,3348
11724,3826068495,3830599959,1672544454,1672545222,768
11180,3500442370,3711804184,1672619431,1672621703,2272
10425,3605591994,3294952405,1672650434,1672652145,1711
10646,3500671218,3805831563,1672562239,1672564188,1949
11022,3289258397,3802625412,1672565369,1672568622,3253
11507,3222357355,3432050858,1672649267,1672651955,2688
10371,3348100657,3811354125,1672590740,1672592775,2035
11480,3310702648,3389069291,1672622789,1672622875,86
11079,3208894215,3715881104,1672596502,1672599123,2621
11620,3714453773,3917004141,1672647816,1672649183,1367
10714,3730169449,3776279305,1672671891,1672674386,2495
11308,3970265139,3716541851,1672576966,1672578720,1754
10664,3917004141,3760554453,1672562439,1672564792,2353
10538,3353326305,3378534521,1672583441,1672585952,2511
11276,3414387263,3834980281,1672534069,1672534466,397
11038,3793949077,3711258452,1672568800,1672569318,518
10643,3832902787,3852014884,1672696038,1672699529,3491
10495,3203909360,3773032706,1672654966,1672658033,3067
11548,3487231844,3711367577,1672606647,1672609152,2505
11556,3510758718,3779665641,1672597974,1672601094,3120
11778,3688845298,3806471413,1672648223,1672649487,1264
11733,3756119976,3305612422,1672689112,1672691078,1966
11353,3468201976,3449672240,1672644294,1672644783,489
10124,3514761434,3757924067,1672649165,1672649466,301
10036,3510301454,3512411326,1672583497,1672585456,1959
11540,3780050146,3432838598,1672532392,1672532631,239
10872,3668154066,3757032266,1672538964,1672539124,160
11170,3533566754,3818904268,1672626769,1672629046,2277
11098,3432762943,3936871734,1672625674,1672626309,635
10799,3780171640,3370245766,1672550149,1672552416,2267
11789,3518759318,3512857020,1672633569,1672636303,2734
9798,3701779683,3805831563,1672583799,1672586507,2708
9921,3428878402,3231227362,1672588710,1672589744,1034
11128,3409514897,3755779925,1672698564,1672702152,3588
11263,3791863922,3793442891,1672535790,1672539310,3520
11119,3311514075,3301332095,1672582715,1672583053,338
10129,3925835590,3343859998,1672592529,1672595492,2963
10584,3451757423,3481365330,1672539119,1672539344,225
11355,3204473480,3414510793,1672577406,1672579577,2171
10837,3408982612,3760396348,1672559646,1672562744,3098
10679,3513740840,3233712975,1672547111,1672548791,1680
10962,3773424266,3663353552,1672673835,1672677435,3600
10323,3972847837,3505438826,1672702840,1672705865,3025
10216,3777564559,3516378356,1672555191,1672555982,791
11249,3973582279,3703474558,1672581116,1672583144,2028
11783,3739618347,3246567963,1672665376,1672667106,1730
10815,3479452888,3711430738,1672554792,1672556238,1446
11255,3756616853,3916463490,1672544045,1672546993,2948
11019,3494157939,3701311947,1672617591,1672619385,1794
10777,3636927297,3701841013,1672586373,1672587099,726
10745,3937636109,3791796190,1672660898,1672663579,2681
10749,3501619113,3616242727,1672582531,1672585269,2738
10439,3809216145,3685396470,1672560109,1672560332,223
9865,3512417724,3772882440,1672540635,1672541458,823
11617,3287760230,3760397450,1672645231,1672646579,1348
11280,3772251279,3701291994,1672689159,1672690208,1049
9977,3923133978,3465690527,1672584072,1672586004,1932
10032,3300238532,3434452046,1672588393,1672588723,330
11517,3500018566,3776617627,1672651176,1672652967,1791
10661,3755769731,3278805844,1672632087,1672633255,1168
11556,3509073025,3429315500,1672582169,1672582726,557
11187,3777060250,3517083465,1672698447,1672698833,386
10195,3520694387,3716891903,1672614728,1672615570,842
10952,3555215568,3403177609,1672597020,1672600538,3518
10046,3756740153,3701655378,1672570903,1672571267,364
10904,3295710494,3636857871,1672671119,1672672925,1806
10701,3668955834,3551833298,1672650542,1672654114,3572
10789,3436099135,3478937459,1672653911,1672655990,2079
10789,3511458926,3400560073,1672555676,1672557351,1675
10987,3517960157,3510638085,1672653412,1672656454,3042
11056,3553694590,3227956115,1672536732,1672538875,2143
11447,3378172464,3373802545,1672694162,1672694343,181
10360,3756668747,3737946004,1672678282,1672681234,2952
11593,3701529552,3772689657,1672631290,1672631622,332
10424,3770941125,3772489471,1672554767,1672557047,2280
11096,3276499910,3339478490,1672649102,1672650170,1068
11757,3380167818,3466655775,1672541603,1672542672,1069
11733,3501657158,3770457058,1672689588,1672691802,2214
10928,3714525519,3851515560,1672564476,1672566791,2315
9877,3517325365,3515804844,1672575995,1672577838,1843
10438,3272096922,3415032547,1672657336,1672660869,3533
10845,3811629200,3811629200,1672535708,1672536548,840
11162,3776867553,3509167758,1672538099,1672539178,1079
11422,3819400315,3770273459,1672648466,1672650870,2404
11017,3235470567,3438204844,1672601088,1672602723,1635
10436,3770276815,3398075553,1672634666,1672635204,538
10468,3518408734,3778741325,1672669872,1672670088,216
10964,3792012147,3925792265,1672690260,1672693716,3456
9820,3501843187,3711404205,1672679583,1672682590,3007
11048,3481019442,3368951504,1672558650,1672560109,1459
10021,3559754304,3826542169,1672646916,1672647190,274
11015,3284829602,3977880564,1672610624,1672611720,1096
10827,3533036499,3713069234,1672570249,1672572264,2015
10636,3636857871,3452024572,1672533789,1672535207,1418
11512,3280208630,3622654885,1672602936,1672605926,2990
11566,3505887814,3735422623,1672533965,1672535550,1585
9916,3408828584,3397783490,1672636860,1672639548,2688
11650,3792682835,3387989658,1672545988,1672546409,421
10489,3711287751,3248409083,1672663269,1672665746,2477
10820,3703438617,3711810268,1672536503,1672536972,469
10337,3497732613,3338016147,1672559573,1672562263,2690
11406,3276231633,3711029952,1672676220,1672678150,1930
10656,3519341916,3711836873,1672661522,1672661687,165
11726,3533009565,3491104534,1672614949,1672617451,2502
10440,3755394177,3519689906,1672629197,1672631413,2216
10413,3884192843,3517992521,1672605287,1672606065,778
10031,3533037906,3249614888,1672579095,1672581604,2509
11539,3519167605,3519703964,1672653289,1672656710,3421
11428,3384001094,3756119976,1672536598,1672537525,927
11627,3510987684,3912811715,1672609692,1672610796,1104
11690,3711219767,3733243990,1672582576,1672585326,2750
11063,3898592058,3517632796,1672620989,1672624393,3404
10745,3423217578,3893527651,1672555064,1672557324,2260
11182,3553640169,3791368349,1672683239,1672684189,950
11265,3792475476,3885339157,1672694305,1672694572,267
11629,3235074007,3472561941,1672547286,1672548717,1431
10345,3772223331,3533225084,1672681383,1672682546,1163
11210,3273537848,3818236682,1672669470,1672672747,3277
10977,3779975575,3927763819,1672685829,1672685951,122
11532,3429587594,3756668747,1672693030,1672695725,2695
11760,3792283334,3512133625,1672573574,1672575457,1883
10965,3791628263,3505571800,1672683496,1672683932,436
11538,3776732532,3384001094,1672701030,1672701512,482
11761,3510758718,3514638555,1672573119,1672573991,872
10929,3855440101,3207586072,1672574494,1672574682,188
11721,3777498160,3812559393,1672567788,1672568341,553
10441,3757393413,3776841808,1672686444,1672688139,1695
11554,3533201269,3359929534,1672641069,1672643820,2751
10106,3518368900,3735197034,1672542563,1672545807,3244
10124,3892177203,3505155858,1672633411,1672636751,3340
10880,3668764192,3203630241,1672591764,1672592667,903
10068,3518335611,3358959807,1672588178,1672590606,2428
11672,3313502623,3276230295,1672580835,1672582014,1179
11379,3534122907,3701359045,1672551824,1672553497,1673
11741,3687024828,3533929043,1672536132,1672538780,2648
11485,3301449986,3319660530,1672620733,1672620998,265
11594,3404187438,3738160394,1672541076,1672542411,1335
10406,3533703578,3605591994,1672606444,1672608704,2260
10250,3520189871,3343511947,1672625881,1672628795,2914
10502,3783238023,3510278533,1672660099,1672661973,1874
10823,3352295704,3337715675,1672639413,1672641379,1966
11185,3938398160,3714892312,1672579432,1672582868,3436
10723,3711938229,3937636109,1672669805,1672670606,801
10976,3300810210,3773408491,1672669945,1672670775,830
9975,3935569749,3711258452,1672582112,1672585215,3103
10198,3715111016,3364286028,1672613810,1672617372,3562
11256,3516463579,3415840750,1672698350,1672700148,1798
10970,3513739060,3302988745,1672567372,1672570415,3043
11052,3204473480,3334824744,1672550972,1672554566,3594
10104,3303747093,3703474558,1672574895,1672577276,2381
10676,3510535683,3360949039,1672652169,1672655148,2979
10638,3518794921,3306475287,1672663949,1672665085,1136
10022,3755374000,3344478603,1672598559,1672600401,1842
10316,3773408491,3637566026,1672584233,1672585603,1370
10816,3908464960,3271762055,1672687931,1672689760,1829
11129,3773878451,3518478484,1672562145,1672562347,202
10291,3552444228,3909504515,1672695119,1672696965,1846
9821,3701448521,3288346356,1672645421,1672647353,1932
11608,3512477276,3500104976,1672642225,1672644405,2180
10730,3701041860,3857609616,1672564902,1672565162,260
10474,3418367752,3473706746,1672636333,1672638658,2325
11628,3716595760,3511663572,1672659129,1672659543,414
11006,3773161055,3922480066,1672574225,1672575324,1099
10372,3406101720,3779835734,1672597799,1672598002,203
10781,3770105006,3770564547,1672668269,1672668504,235
9827,3495637721,3284374600,1672609606,1672610250,644
10654,3552444228,3776901443,1672616789,1672619588,2799
10125,3778706119,3791644831,1672670251,1672672392,2141
10655,3755465396,3614112171,1672602062,1672602586,524
10830,3500544306,3417969824,1672633630,1672637103,3473
11042,3229615214,3533726421,1672615050,1672615190,140
10156,3424997707,3780680252,1672533983,1672534593,610
10159,3773378103,3311410533,1672583434,1672586764,3330
10675,3815440588,3780648744,1672604374,1672605821,1447
10879,3273537848,3783679478,1672641330,1672642585,1255
10467,3733123020,3713476192,1672618761,1672619724,963
10243,3480108752,3792283334,1672653337,1672654677,1340
9907,3533009565,3513624915,1672664608,1672665984,1376
11524,3777439655,3511311554,1672693976,1672694728,752
10385,3756784813,3682802569,1672670010,1672670132,122
11142,3512645289,3505190512,1672617002,1672619978,2976
11791,3792719263,3736885568,1672544860,1672545124,264
9993,3977157565,3774606418,1672672773,1672673498,725
10966,3791106473,3779393140,1672551142,1672551642,500
10986,3472018395,3450503086,1672565617,1672568992,3375
11181,3770630937,3634766042,1672545601,1672548917,3316
10204,3244397548,3711854614,1672625279,1672628415,3136
11218,3772708314,3755790149,1672605835,1672608232,2397
10418,3972729768,3433196933,1672571550,1672574867,3317
11029,3701060732,3701385831,1672631862,1672634312,2450
11164,3534362749,3915962248,1672634670,1672636645,1975
10303,3512072679,3716669659,1672559548,1672561259,1711
11112,3882905311,3501628472,1672626419,1672628129,1710
9856,3915679140,3735056027,1672635618,1672637573,1955
9798,3533859712,3517227599,1672593147,1672594405,1258
11685,3511500932,3505665253,1672538166,1672538500,334
10747,3826542169,3791106473,1672541063,1672542746,1683
11547,3316821313,3669418238,1672665470,1672668242,2772
9834,3439045964,3908177413,1672650999,1672654284,3285
11171,3514327931,3244495586,1672633735,1672634651,916
10381,3812559393,3437023385,1672582249,1672583036,787
11214,3710223875,3777686966,1672637916,1672640430,2514
10476,3636015050,3757869138,1672610170,1672613412,3242
10497,3910190872,3909504515,1672671777,1672672662,885
10824,3897107253,3520926977,1672547638,1672549661,2023
10584,3803996569,3500741005,1672538203,1672539665,1462
9942,3515577866,3903115138,1672696667,1672697919,1252
11747,3792597493,3907088952,1672592034,1672593698,1664
10264,3343511947,3505066871,1672635315,1672636043,728
10750,3774627091,3500931474,1672670708,1672673715,3007
10993,3276499910,3510824484,1672577145,1672579238,2093
9999,3501205057,3308965136,1672562258,1672562836,578
11617,3837888196,3376487118,1672576807,1672576968,161
9847,3716526314,3791974273,1672692470,1672693707,1237
11659,3791758175,3701385831,1672613754,1672614015,261
10790,3404461403,3755942724,1672615855,1672616307,452
9954,3756437169,3235198316,1672603599,1672607189,3590
11392,3334708091,3735197034,1672651342,1672653158,1816
10015,3970775805,3792277399,1672634100,1672634968,868
10717,3519465545,3711131262,1672627704,1672628919,1215
10103,3627431396,3421956717,1672649126,1672652333,3207
9807,3622218289,3316121649,1672618695,1672621250,2555
10007,3294164983,3774598935,1672662344,1672664903,2559
11292,3520049965,3779427180,1672685049,1672685495,446
10211,3512871568,3833520635,1672594994,1672597821,2827
11286,3791509334,3513624915,1672652943,1672656332,3389
11614,3978643889,3711190257,1672688977,1672691624,2647
11617,3517210356,3716020849,1672532254,1672535626,3372
11706,3203630241,3757851680,1672692148,1672695667,3519
10375,3774090455,3473520701,1672642845,1672646047,3202
10347,3478206139,3894495222,1672625403,1672628623,3220
10086,3505472087,3609335008,1672599088,1672600105,1017
11465,3488399075,3316121649,1672657351,1672659669,2318
11128,3368079099,3509912164,1672617227,1672618567,1340
10569,3760024021,3779393140,1672602543,1672603756,1213
10479,3381244346,3904004824,1672647346,1672650282,2936
9815,3909632424,3351153781,1672552225,1672553806,1581
10014,3893527651,3484739955,1672537083,1672537433,350
11490,3461630842,3517195738,1672676420,1672678637,2217
9918,3277634944,3710316008,1672693419,1672696804,3385
11699,3773853619,3514216460,1672531914,1672535097,3183
11103,3454151554,3779689733,1672535577,1672538198,2621
11370,3776001441,3715737742,1672686522,1672689236,2714
10309,3297684667,3922430928,1672699126,1672702366,3240
11140,3636877469,3818570577,1672560417,1672562541,2124
9872,3511028193,3510826414,1672656038,1672657678,1640
9805,3774663639,3440991826,1672669925,1672670242,317
11155,3389069291,3407403080,1672615264,1672615991,727
11175,3514145752,3713444403,1672684439,1672687414,2975
10858,3716944983,3756149282,1672635809,1672637717,1908
10603,3772296376,3714264759,1672600246,1672602472,2226
11385,3510301454,3686853863,1672691727,1672693772,2045
10049,3296970170,3272096922,1672672991,1672674855,1864
10045,3904485393,3500015630,1672559161,1672560826,1665
9842,3510750299,3458130310,1672692349,1672694479,2130
11484,3512527440,3850108828,1672649272,1672651385,2113
10504,3461137945,3736885568,1672562075,1672562219,144
10723,3377250778,3710397477,1672617595,1672620215,2620
10315,3511645260,3284334297,1672588731,1672589834,1103
10951,3501734800,3455907179,1672626298,1672629063,2765
11109,3436774112,3777909822,1672626792,1672627006,214
10787,3514801709,3482687604,1672668696,1672671215,2519
10527,3274341934,3757198930,1672580611,1672581900,1289
10105,3615245840,3979115924,1672638457,1672640513,2056
11621,3905358065,3389069291,1672561925,1672563713,1788
11598,3292936094,3807486812,1672574190,1672577087,2897
10705,3807584987,3855222429,1672623301,1672625776,2475
11676,3227206772,3399173821,1672641824,1672643284,1460
10300,3500415589,3516655509,1672562308,1672565674,3366
9884,3680075399,3928421417,1672662338,1672664957,2619
10953,3467415939,3519319233,1672544903,1672548192,3289
11589,3389069291,3776727271,1672574171,1672575387,1216
10907,3715712376,3776600696,1672542598,1672545406,2808
10527,3518572231,3533859712,1672594197,1672595139,942
10090,3347760784,3517797610,1672565721,1672566087,366
11392,3825526565,3318220119,1672556225,1672559174,2949
11459,3760346746,3387700451,1672545470,1672546559,1089
10367,3880788853,3772112976,1672590413,1672591589,1176
9848,3851877325,3491527603,1672609027,1672611776,2749
10624,3612042508,3807111856,1672651946,1672652902,956
11054,3701449715,3713636175,1672597682,1672598283,601
9892,3499142934,3776200012,1672576204,1672576389,185
10954,3791031227,3361789225,1672657734,1672657867,133
10098,3886957097,3319645922,1672621709,1672622259,550
11034,3711767051,3826068495,1672680327,1672681287,960
11703,3534531039,3551833298,1672605738,1672608177,2439
10421,3205948776,3778838936,1672612030,1672614682,2652
11015,3519255644,3777135415,1672546197,1672547274,1077
11666,3505140123,3773636983,1672652883,1672655595,2712
10144,3462985379,3509677530,1672664933,1672665626,693
9834,3793689267,3330188769,1672667489,1672670668,3179
11747,3425260097,3408408584,1672622133,1672625231,3098
11761,3393909269,3732223664,1672567369,1672568150,781
11308,3756876537,3459951739,1672568413,1672571149,2736
10774,3716468783,3472272792,1672673877,1672676238,2361
11785,3934280144,3206853747,1672622124,1672623318,1194
11759,3505119470,3711889178,1672648634,1672651378,2744
11268,3519322066,3755378125,1672535770,1672536772,1002
11461,3380218091,3703476890,1672643449,1672645524,2075
11086,3444598583,3248061684,1672583391,1672584962,1571
10963,3770273459,3715737742,1672670513,1672672650,2137
10464,3888057649,3517551721,1672557000,1672560014,3014
11101,3501027795,3711938229,1672685059,1672688194,3135
11493,3367109648,3423782420,1672632850,1672636336,3486
11439,3512101369,3783809405,1672598589,1672598984,395
10957,3919719755,3476144563,1672579693,1672580824,1131
11030,3499998389,3778706119,1672569624,1672571188,1564
10660,3500105301,3554437212,1672637992,1672640304,2312
11119,3234445133,3512477276,1672552880,1672555788,2908
10529,3854957153,3315432466,1672605481,1672605657,176
10081,3512641538,3295710494,1672619740,1672620201,461
10169,3479402555,3792930090,1672551168,1672551583,415
11136,3776968640,3783594246,1672584607,1672588057,3450
10718,3850993995,3701519251,1672615895,1672616201,306
10820,3908177413,3895507040,1672594798,1672596724,1926
11089,3511969443,3737622701,1672582518,1672583831,1313
11302,3358982831,3244495586,1672562126,1672564867,2741
11439,3241567995,3511218261,1672667239,1672668578,1339
9828,3617771673,3776183353,1672545702,1672547330,1628
11074,3373677765,3439662051,1672618440,1672620319,1879
10942,3783935976,3304697982,1672638261,1672641152,2891
10772,3921138062,3755394177,1672598917,1672599480,563
11315,3931319307,3201502111,1672639480,1672641402,1922
10865,3779689733,3384151770,1672595176,1672595806,630
10872,3374147279,3505482210,1672634829,1672636229,1400
11614,3792107875,3479402555,1672620819,1672622744,1925
10795,3625779003,3793920312,1672697094,1672697984,890
11088,3311159418,3515470462,1672549878,1672551508,1630
10662,3830599959,3285587972,1672559111,1672559769,658
11469,3778100960,3713434898,1672580433,1672581217,784
10182,3703849264,3501612813,1672592231,1672595663,3432
11049,3514005973,3317887374,1672652537,1672653745,1208
11140,3533822490,3603167427,1672619682,1672621495,1813
10063,3410602007,3703502114,1672585250,1672586486,1236
10817,3515893948,3791206902,1672622014,1672623802,1788
10422,3809194824,3512504247,1672609274,1672612584,3310
11653,3973582279,3357496255,1672672065,1672672770,705
9807,3772070986,3760080378,1672555756,1672558606,2850
10096,3715441777,3510218188,1672673462,1672675083,1621
11034,3516034245,3772802020,1672695350,1672695651,301
11102,3838423363,3832289185,1672658347,1672658834,487
11590,3519255644,3511500932,1672560495,1672560827,332
10954,3533841983,3512857020,1672580022,1672580483,461
11022,3491239350,3783443095,1672698878,1672699466,588
10474,3755192104,3778731000,1672635965,1672638975,3010
11447,3513486828,3209958726,1672628395,1672629588,1193
11610,3476144563,3772291207,1672564450,1672564571,121
10598,3500671218,3778273230,1672531759,1672532077,318
11648,3971996397,3681701931,1672651535,1672651867,332
9973,3510638085,3770441717,1672590143,1672590307,164
9885,3248409083,3770273966,1672669520,1672672607,3087
9837,3793949077,3815700240,1672582524,1672584297,1773
10585,3371132167,3231859576,1672531837,1672533610,1773
10812,3817376705,3311410533,1672635811,1672638987,3176
9878,3500968729,3501115299,1672565732,1672567576,1844
10458,3358982831,3243763209,1672683231,1672685455,2224
11496,3779102237,3461743188,1672561395,1672562985,1590
10975,3519703964,3511580693,1672594564,1672595516,952
10697,3703588004,3519922921,1672556355,1672559496,3141
11200,3701475090,3716209499,1672591106,1672591323,217
11636,3855977674,3714690161,1672607941,1672608099,158
10066,3899205452,3633294415,1672607569,1672608824,1255
10424,3757514745,3779665641,1672703599,1672706774,3175
9848,3703779674,3378172464,1672566324,1672566560,236
11729,3710861700,3435801763,1672579414,1672580093,679
9984,3352374868,3802374620,1672547872,1672548210,338
11755,3342235058,3626631210,1672635212,1672636427,1215
10347,3662354016,3701028092,1672582371,1672585861,3490
10304,3774195369,3880562532,1672664599,1672666336,1737
10384,3500927619,3520506192,1672663476,1672664849,1373
10468,3757201538,3279731391,1672616564,1672618908,2344
10923,3737738751,3463883997,1672694391,1672696201,1810
10728,3500776597,3777932581,1672632475,1672633426,951
11109,3207307681,3516200419,1672541948,1672542251,303
10194,3231859576,3520155898,1672640195,1672643381,3186
10912,3736036532,3330799389,1672675655,1672677454,1799
11760,3779604279,3362127525,1672532473,1672533895,1422
10434,3780482864,3770533675,1672604882,1672606858,1976
9969,3367202274,3510826414,1672644411,1672647779,3368
10302,3715419141,3716095450,1672587059,1672590623,3564
11303,3203876438,3422460919,1672621015,1672621190,175
10418,3855440101,3896859936,1672633329,1672634342,1013
11225,3505816624,3450503086,1672633448,1672636023,2575
11062,3636885498,3909632424,1672674669,1672676075,1406
10773,3901169230,3809860102,1672619876,1672621643,1767
10477,3793364952,3520860199,1672619594,1672621787,2193
10261,3510335069,3366961580,1672584858,1672586649,1791
11528,3715039960,3505234868,1672640708,1672643620,2912
11114,3899294071,3271762055,1672681094,1672682466,1372
11490,3491948594,3511663572,1672563601,1672566974,3373
11476,3516486526,3520506192,1672544926,1672548363,3437
10662,3486824047,3394976623,1672579607,1672582088,2481
10239,3710529628,3605760561,1672687927,1672691150,3223
10991,3716209499,3480259863,1672698424,1672699906,1482
11117,3374348845,3779665641,1672644162,1672647491,3329
9983,3515753241,3885422379,1672579680,1672583115,3435
11533,3780048608,3477951091,1672677638,1672678971,1333
11549,3660496328,3500922040,1672659042,1672662073,3031
10932,3701865589,3703031637,1672583987,1672585127,1140
11486,3837888196,3757311529,1672691915,1672692053,138
11420,3792012147,3791409441,1672699090,1672699476,386
10093,3418997135,3773411968,1672647265,1672647487,222
11596,3299052917,3837887478,1672688067,1672691420,3353
10341,3938398160,3852275715,1672561289,1672563479,2190
10228,3663505156,3713767153,1672543419,1672544812,1393
9962,3774326754,3501600785,1672568397,1672569889,1492
11622,3518368900,3811629200,1672597106,1672598919,1813
10727,3516904926,3505140123,1672670495,1672671256,761
11242,3927202773,3206544535,1672693498,1672697088,3590
9946,3519351747,3730414796,1672677307,1672679902,2595
10892,3297100323,3760144712,1672547675,1672548097,422
9804,3716609198,3351856699,1672681340,1672683094,1754
10624,3606688595,3505234868,1672646267,1672647275,1008
11553,3884191432,3245642576,1672654454,1672655696,1242
10254,3779604279,3916673751,1672696048,1672697339,1291
11086,3403870769,3361789225,1672660483,1672663918,3435
11228,3716467469,3479910993,1672543141,1672544443,1302
11155,3917905192,3713031958,1672567820,1672568102,282
11017,3714903456,3703336988,1672666143,1672666799,656
11419,3793978936,3701065296,1672623930,1672624195,265
10516,3891272544,3311432176,1672615365,1672615826,461
11238,3297100323,3935520819,1672665415,1672668532,3117
10802,3411626917,3484739955,1672682355,1672683928,1573
11517,3422205569,3517440258,1672558881,1672560184,1303
10296,3514327931,3972847837,1672575644,1672576857,1213
9876,3279851026,3514585995,1672583963,1672585100,1137
10284,3437023385,3756616853,1672620854,1672621412,558
11261,3777932225,3510750299,1672558024,1672559870,1846
10371,3919345990,3516969689,1672628975,1672630525,1550
11702,3482519872,3467756698,1672627132,1672630088,2956
11749,3462985379,3661359073,1672648034,1672650698,2664
10305,3735152111,3915962248,1672532654,1672535805,3151
10492,3509370633,3499622352,1672639109,1672641064,1955
10912,3290797257,3779130507,1672642282,1672644367,2085
11049,3783506190,3533419409,1672652366,1672653040,674
11477,3619676231,3402580733,1672589858,1672591586,1728
11296,3816184951,3713920790,1672675838,1672678232,2394
11573,3773134128,3792797648,1672698807,1672701882,3075
11363,3701265238,3805831563,1672649703,1672652229,2526
11715,3303772923,3820200446,1672563031,1672566284,3253
10450,3318224774,3730115019,1672635865,1672636284,419
10196,3533841983,3278779955,1672697452,1672700411,2959
10666,3680988889,3500596577,1672547617,1672548465,848
10115,3299052917,3732104286,1672626767,1672629825,3058
11450,3715106566,3710819760,1672543822,1672544671,849
10337,3512306195,3518209090,1672620957,1672622743,1786
10753,3370448531,3517021928,1672585655,1672587769,2114
10141,3756297396,3505010941,1672656516,1672658321,1805
10156,3792277399,3505037247,1672687443,1672689682,2239
10081,3680939042,3505351253,1672651762,1672654835,3073
11179,3825526565,3368441333,1672558758,1672561473,2715
10930,3777370992,3780294116,1672590952,1672591552,600
9856,3760074281,3501027795,1672556849,1672558194,1345
10579,3283847934,3783172505,1672622048,1672624177,2129
10519,3518989186,3686885442,1672696440,1672699111,2671
10962,3921736061,3635433296,1672567844,1672570197,2353
11386,3206217657,3224053840,1672610984,1672611620,636
11383,3760274119,3773669001,1672623006,1672626301,3295
10593,3703168159,3240683148,1672555559,1672559005,3446
10891,3711404205,3533365834,1672702625,1672705293,2668
10481,3519046342,3716733618,1672605107,1672607442,2335
11162,3814672661,3703624327,1672620972,1672623961,2989
9935,3623512088,3703438617,1672622627,1672625012,2385
10014,3435801763,3770544738,1672574849,1672577164,2315
9823,3711219767,3517530943,1672538800,1672541561,2761
11450,3905934770,3927365255,1672646074,1672649174,3100
10055,3792719263,3358473096,1672681556,1672683322,1766
11396,3838748301,3682086200,1672571146,1672572715,1569
10383,3359929534,3926065090,1672655579,1672657557,1978
10497,3429610195,3519553933,1672643321,1672645487,2166
10674,3505278562,3735152111,1672603500,1672604707,1207
11433,3770991234,3515764058,1672543868,1672544665,797
11421,3231271498,3773202954,1672626101,1672629659,3558
9990,3903088144,3625931630,1672580801,1672583304,2503
10693,3613828705,3518335611,1672615135,1672616770,1635
11374,3777729184,3432838598,1672619527,1672620329,802
11475,3770480149,3242082716,1672664207,1672664338,131
11033,3450164574,3510178791,1672617117,1672620468,3351
10467,3505472087,3777909822,1672671407,1672673739,2332
11178,3684651755,3622654885,1672654761,1672654980,219
11588,3519260216,3755175497,1672587166,1672588643,1477
10105,3716841469,3351856699,1672671213,1672673253,2040
10722,3716492409,3377311502,1672616924,1672617315,391
10221,3517943697,3760396348,1672619231,1672622629,3398
10387,3446066492,3793719515,1672578649,1672582011,3362
10518,3791236983,3905358065,1672663988,1672664970,982
10415,3505786561,3371238318,1672590884,1672591879,995
10837,3311924005,3505351253,1672616546,1672617354,808
10137,3510680251,3774447975,1672620170,1672621510,1340
10099,3636852764,3510894809,1672617678,1672618618,940
10317,3755230010,3783939161,1672662366,1672664935,2569
10014,3756998113,3301449986,1672631694,1672634165,2471
10559,3792440162,3511883778,1672643403,1672646639,3236
9926,3511245705,3703572036,1672643766,1672644322,556
11414,3427527462,3206853747,1672676318,1672678942,2624
11625,3341129425,3791205793,1672624060,1672625478,1418
11069,3463564410,3505908965,1672576340,1672578461,2121
10332,3715602742,3485898181,1672656337,1672659319,2982
11720,3227647190,3778731000,1672593158,1672593560,402
11426,3505331083,3519463038,1672674873,1672676264,1391
10479,3855629383,3347140733,1672585454,1672587542,2088
11760,3609925909,3623894390,1672597769,1672600228,2459
10243,3229570647,3209958726,1672531621,1672533665,2044
10811,3468066881,3445172440,1672570977,1672571961,984
10167,3311197635,3272096922,1672675074,1672675692,618
10962,3311045951,3834311054,1672558379,1672558470,91
11468,3395505794,3824259677,1672544557,1672547295,2738
11640,3558203963,3423346297,1672570351,1672571418,1067
11423,3760979523,3275751794,1672547125,1672547232,107
9930,3773432494,3369482983,1672561286,1672563254,1968
10332,3398021818,3779174993,1672696419,1672699568,3149
10859,3534984243,3703168159,1672636715,1672639809,3094
11059,3515304526,3227339675,1672575947,1672578774,2827
11015,3779778679,3912915644,1672682935,1672685112,2177
11224,3517991042,3916924978,1672583118,1672585792,2674
10401,3621591266,3929923442,1672556472,1672557672,1200
10789,3301431129,3363549860,1672571728,1672573976,2248
11254,3359012188,3422081502,1672702461,1672704977,2516
10355,3501261089,3711755596,1672592278,1672594533,2255
11719,3505500665,3770275898,1672699066,1672699172,106
11394,3472173212,3701925712,1672643208,1672646434,3226
10015,3398075553,3935444008,1672613255,1672615944,2689
10265,3500630465,3408111327,1672535759,1672536042,283
10522,3779835734,3780287649,1672574146,1672576508,2362
10456,3341985886,3533960602,1672667807,1672668551,744
11043,3976742903,3205161801,1672688830,1672689135,305
10506,3491104534,3510919509,1672597655,1672598751,1096
10274,3632189887,3774236212,1672639102,1672639839,737
10059,3703614781,3737738751,1672702206,1672702636,430
9836,3517377614,3511750850,1672673586,1672675252,1666
11770,3478915403,3850904092,1672696322,1672697257,935
11578,3682241594,3792107875,1672555412,1672557439,2027
11576,3927763819,3338187803,1672660638,1672663143,2505
10492,3513250976,3760776967,1672551524,1672552456,932
11354,3773853619,3435652260,1672543001,1672544481,1480
10461,3505665788,3716475340,1672622985,1672623872,887
11702,3517627003,3760776967,1672560036,1672561740,1704
11745,3517943697,3773826624,1672660416,1672662999,2583
9857,3760107540,3463729805,1672650532,1672651369,837
10536,3714455496,3602570831,1672679477,1672681577,2100
11263,3780142207,3716179251,1672587491,1672588473,982
11286,3510968599,3773714494,1672664950,1672667062,2112
11037,3388830370,3811419378,1672590120,1672593555,3435
11732,3917004141,3518067857,1672665731,1672667920,2189
11205,3501244753,3757855416,1672562876,1672563300,424
11143,3714287902,3518572231,1672703258,1672703424,166
11786,3452677710,3302988745,1672697283,1672698355,1072
10648,3394976623,3773434690,1672533614,1672536239,2625
11005,3710680073,3450621820,1672576516,1672579177,2661
10006,3791509334,3533777032,1672657527,1672657877,350
11181,3519167605,3203630241,1672613294,1672614757,1463
10137,3311472321,3891272544,1672689867,1672692364,2497
10113,3275171954,3701887470,1672578027,1672581160,3133
10988,3605760561,3832312129,1672691636,1672695125,3489
11711,3825932442,3513186578,1672664086,1672664324,238
10804,3715858201,3715490209,1672579082,1672580477,1395
10243,3770533675,3356972733,1672649513,1672652190,2677
9928,3285136057,3341738186,1672640058,1672641959,1901
11475,3517718901,3501573548,1672568938,1672571606,2668
11746,3519352855,3838748301,1672543104,1672545197,2093
11320,3515637968,3757924067,1672630933,1672631961,1028
11730,3333477908,3776182849,1672559899,1672562531,2632
9989,3519174861,3496352027,1672561607,1672564830,3223
9820,3519167605,3714268380,1672622007,1672622226,219
11109,3512417028,3856897914,1672638457,1672640544,2087
11508,3516706935,3818532143,1672541315,1672542862,1547
10902,3780294116,3302416197,1672632988,1672635620,2632
11607,3857344874,3441336851,1672679167,1672681112,1945
10982,3516651799,3682673884,1672690602,1672693540,2938
10387,3772216305,3236886943,1672607707,1672611263,3556
11576,3701567668,3824259677,1672591332,1672593804,2472
11684,3520697518,3380285779,1672636749,1672637000,251
10138,3779665641,3433902955,1672592897,1672595366,2469
11076,3395069149,3602054754,1672700651,1672703954,3303
10980,3512527440,3514107131,1672667491,1672667887,396
10949,3516904926,3603452936,1672654824,1672655391,567
11153,3715196780,3513739060,1672645179,1672645516,337
10023,3453519360,3236886943,1672698492,1672699492,1000
10377,3302348002,3853783593,1672546204,1672549237,3033
10560,3804075198,3500968729,1672701575,1672702133,558
11081,3226037966,3510439480,1672702549,1672705750,3201
11444,3774627091,3505117019,1672664114,1672666113,1999
11166,3203630241,3244495586,1672616730,1672617668,938
9809,3458271585,3793948300,1672559198,1672559696,498
10243,3907245259,3509556649,1672666947,1672669398,2451
11513,3770285500,3715106566,1672653968,1672656057,2089
10920,3783727937,3783554600,1672637777,1672638980,1203
11671,3291617477,3773736248,1672685661,1672689139,3478
11159,3441737317,3778702093,1672619887,1672621171,1284
11015,3711076751,3791509881,1672573771,1672574658,887
10506,3512490032,3299052917,1672644648,1672646867,2219
11195,3516535558,3513840186,1672602908,1672605716,2808
10232,3518511124,3390537737,1672606447,1672606651,204
11230,3386323728,3664719070,1672593523,1672594261,738
10185,3615846003,3711804184,1672655309,1672656606,1297
11652,3376487118,3500720752,1672630408,1672632013,1605
11787,3602401154,3283295213,1672627548,1672629314,1766
10507,3285971415,3515984911,1672702072,1672703792,1720
9973,3442403264,3551972633,1672531789,1672534386,2597
10087,3639465750,3512337054,1672578064,1672578983,919
10860,3203151036,3519228207,1672556833,1672557425,592
10232,3517358336,3975796415,1672668954,1672669490,536
10291,3931917809,3921138062,1672637526,1672640483,2957
10269,3780648744,3514013999,1672627240,1672628603,1363
9910,3345954031,3773408491,1672702855,1672704099,1244
10752,3895422995,3685522474,1672625140,1672627634,2494
10922,3792475476,3468871103,1672646974,1672648018,1044
10766,3363549860,3682150740,1672652098,1672655352,3254
11471,3713636175,3772223331,1672539551,1672539843,292
11513,3361635547,3792708936,1672568459,1672571053,2594
11778,3777370601,3760525465,1672682149,1672683567,1418
11423,3505825767,3756948477,1672669691,1672670026,335
10232,3732223664,3689420679,1672580865,1672583528,2663
11002,3711770773,3770172119,1672666003,1672667523,1520
11680,3637566026,3681701931,1672616438,1672618397,1959
11086,3501557463,3534984243,1672685093,1672687407,2314
10435,3855077502,3516572212,1672694671,1672696603,1932
9799,3379666159,3713694278,1672691291,1672693220,1929
10599,3434052463,3284865931,1672670273,1672673727,3454
9880,3445896667,3977337501,1672695731,1672695825,94
10756,3688768189,3617771673,1672541712,1672542474,762
11346,3807646028,3779778679,1672555882,1672557372,1490
10246,3509073025,3368951504,1672660678,1672661226,548
11521,3519924982,3239279744,1672691691,1672691985,294
10667,3374147279,3534984243,1672547399,1672548224,825
11405,3774205060,3820922991,1672682427,1672684364,1937
11443,3792797648,3714731729,1672637755,1672638756,1001
10442,3792432763,3714688409,1672585079,1672585190,111
10207,3779951373,3518205307,1672572951,1672576329,3378
10885,3500922040,3246395239,1672673534,1672674935,1401
11383,3770476738,3660246433,1672625525,1672627101,1576
11719,3515715968,3360309868,1672610159,1672612152,1993
10163,3757823215,3471585513,1672615018,1672616442,1424
10963,3305093237,3600978954,1672590134,1672591616,1482
11702,3520145112,3307791650,1672637425,1672639182,1757
11107,3336501403,3711367577,1672561958,1672562318,360
10033,3343698137,3905571273,1672570311,1672572577,2266
10594,3793874490,3703476890,1672695819,1672696812,993
9923,3249380931,3347760784,1672606506,1672606643,137
11697,3471507117,3450503086,1672692646,1672693832,1186
10598,3500544306,3662055682,1672642737,1672645362,2625
10465,3429610195,3780733404,1672554932,1672557821,2889
10323,3621439107,3756493561,1672691551,1672692899,1348
10198,3913847876,3622218289,1672556025,1672558716,2691
10072,3770457058,3774326754,1672565435,1672568335,2900
9849,3739395381,3757678397,1672672177,1672675633,3456
10325,3479402555,3352493805,1672687227,1672689402,2175
9900,3778125688,3467232654,1672634331,1672635399,1068
11383,3774939922,3632094087,1672654149,1672654543,394
11584,3660176760,3885147558,1672616683,1672618514,1831
10830,3513816744,3511289729,1672569277,1672571196,1919
11373,3475090917,3511750695,1672548196,1672549261,1065
10226,3415562576,3780127017,1672608192,1672610996,2804
10471,3978417055,3368951504,1672669827,1672670163,336
9863,3888409038,3520305100,1672633564,1672634673,1109
10136,3509457543,3779393140,1672603896,1672606063,2167
10475,3385416697,3757823215,1672549457,1672549519,62
11223,3358262975,3505531432,1672636054,1672638724,2670
11549,3792785261,3755209597,1672677896,1672678341,445
11275,3755849241,3929446196,1672695775,1672696799,1024
10216,3899294071,3505007498,1672562564,1672565538,2974
10945,3970851830,3311529105,1672608212,1672610377,2165
9965,3701459978,3780142207,1672692843,1672694511,1668
10520,3853783593,3489205994,1672651067,1672654263,3196
10980,3500405175,3509470194,1672531527,1672532669,1142
11588,3792440162,3318224774,1672698693,1672702261,3568
10625,3881012415,3816184951,1672555243,1672557275,2032
10268,3774744663,3470997293,1672584093,1672586288,2195
10519,3825795004,3714287902,1672558766,1672559158,392
11079,3770018912,3778713526,1672682759,1672685159,2400
10865,3295787354,3294326116,1672555849,1672557396,1547
10246,3773579644,3773714494,1672657871,1672660003,2132
10882,3972729768,3485521840,1672609572,1672610921,1349
10383,3501711464,3352493805,1672569485,1672571074,1589
10587,3510882576,3505653701,1672566897,1672567041,144
10029,3453519360,3555954355,1672564719,1672566558,1839
11600,3716801088,3466620548,1672619653,1672621246,1593
9938,3520182275,3417268745,1672623505,1672625309,1804
10390,3791289855,3851515560,1672697252,1672700022,2770
11485,3779413388,3779930476,1672629857,1672632109,2252
11527,3822315407,3500785888,1672686640,1672687163,523
9961,3778927933,3711770853,1672702699,1672705864,3165
9857,3780576351,3636885498,1672541455,1672541749,294
10624,3780786276,3437934509,1672640124,1672641832,1708
10111,3777263928,3773424266,1672630315,1672630708,393
11315,3388774559,3779930476,1672692346,1672693860,1514
10206,3208894215,3755570137,1672646814,1672650034,3220
11577,3415032547,3760525465,1672560493,1672561617,1124
10997,3805831563,3685083275,1672563386,1672564031,645
11460,3934280144,3793899166,1672590098,1672591280,1182
11315,3371238318,3733730342,1672607106,1672607201,95
11776,3304447950,3627358016,1672602263,1672604421,2158
10326,3770709417,3517440258,1672665445,1672668799,3354
11285,3284407073,3930727474,1672578516,1672579527,1011
10528,3713471446,3713373455,1672692394,1672693941,1547
10608,3467663782,3518534560,1672597667,1672601240,3573
11089,3349475873,3343193067,1672697265,1672700205,2940
11314,3402020492,3468281011,1672561788,1672562408,620
10520,3459163055,3414841458,1672642692,1672644446,1754
10604,3710397477,3667814788,1672647778,1672650377,2599
11249,3783611957,3307535495,1672616020,1672618802,2782
10542,3772055279,3439283360,1672534476,1672537398,2922
10691,3774939922,3825234433,1672682984,1672683155,171
11292,3738873928,3436018575,1672652349,1672653194,845
11382,3533030343,3756168814,1672556287,1672556831,544
11443,3310702648,3605760561,1672557561,1672558332,771
11138,3888642876,3668764192,1672581323,1672583186,1863
11541,3475653510,3703438617,1672697917,1672699014,1097
11225,3755924094,3760267158,1672596081,1672596994,913
9960,3713875941,3716341323,1672536756,1672539764,3008
10593,3833993674,3827836825,1672551557,1672553993,2436
10610,3774236212,3356972733,1672587816,1672589084,1268
10612,3793719515,3447696555,1672668688,1672669087,399
10720,3533830748,3884001167,1672576804,1672577613,809
11733,3305657559,3837435907,1672690136,1672692193,2057
11598,3418683594,3519965717,1672613224,1672615342,2118
10566,3474879231,3792162098,1672612846,1672615859,3013
11266,3428788958,3773840321,1672659550,1672662152,2602
11719,3400903513,3770530739,1672533135,1672534685,1550
11575,3461137945,3414841458,1672553595,1672555458,1863
10262,3310021925,3291936679,1672538048,1672540115,2067
9969,3732846295,3284829602,1672559282,1672562260,2978
11693,3810584695,3552261072,1672619490,1672621567,2077
10331,3500221079,3711767051,1672597713,1672600712,2999
10941,3304447950,3770631449,1672665181,1672668055,2874
11411,3511458926,3512726649,1672601618,1672604256,2638
10916,3773899531,3400545490,1672548668,1672549341,673
11532,3534284132,3858429342,1672666642,1672669588,2946
11430,3407403080,3516588277,1672674799,1672676102,1303
10663,3517377614,3333477908,1672575487,1672576747,1260
10197,3909457959,3825877848,1672591140,1672594176,3036
11515,3510301454,3684199077,1672662525,1672663406,881
10667,3701725839,3308759754,1672536412,1672537346,934
11706,3739217535,3287689454,1672562319,1672563125,806
11690,3520832066,3778544203,1672584684,1672587915,3231
11635,3971996397,3732223664,1672561640,1672563130,1490
11633,3778924002,3611298237,1672537319,1672537520,201
10337,3925175853,3824259677,1672640143,1672642724,2581
11615,3469780362,3780786276,1672587448,1672590507,3059
10207,3293579860,3304661369,1672692462,1672693962,1500
10141,3515558215,3715750580,1672549200,1672551823,2623
11460,3499622352,3281970147,1672576914,1672577972,1058
11130,3375324190,3890194669,1672630517,1672631345,828
11448,3715039960,3432466467,1672698212,1672699841,1629
10516,3311521176,3703614781,1672699280,1672702034,2754
10004,3273537848,3385481989,1672556506,1672557182,676
9975,3792475476,3770273966,1672666401,1672669499,3098
10289,3205948776,3555763674,1672561770,1672564324,2554
10329,3278805844,3773688906,1672684649,1672685435,786
9967,3534328311,3772461583,1672543716,1672543845,129
10291,3382308738,3627358016,1672589225,1672592031,2806
10750,3396656251,3882851213,1672668924,1672670925,2001
10360,3809871495,3516321993,1672680607,1672682049,1442
11103,3403988682,3703476890,1672644980,1672648258,3278
10463,3890211161,3480108752,1672536186,1672537334,1148
10227,3479452888,3481365330,1672631343,1672632697,1354
11356,3512306195,3534174363,1672564757,1672566903,2146
10793,3855977674,3907225070,1672681215,1672682249,1034
9907,3636015050,3512638952,1672618826,1672619000,174
9869,3714897456,3338115824,1672658553,1672660462,1909
10863,3770976984,3517210356,1672532669,1672534364,1695
11271,3450342110,3533816813,1672614620,1672617682,3062
9905,3857244486,3305093237,1672573807,1672576182,2375
11261,3411626917,3418683594,1672692580,1672692778,198
10546,3311159418,3498857406,1672675947,1672677603,1656
9842,3711518637,3737467358,1672626515,1672630114,3599
10746,3714897456,3913847876,1672601740,1672602637,897
9965,3777370992,3681504869,1672563242,1672564097,855
10148,3688768189,3780129338,1672614443,1672616015,1572
10791,3884192843,3780206849,1672596579,1672598308,1729
11294,3777655401,3716463756,1672661972,1672663301,1329
9821,3609103278,3907923381,1672611372,1672613198,1826
10143,3225554956,3971282455,1672668168,1672669210,1042
10974,3518882056,3496579251,1672623311,1672624375,1064
10272,3430310785,3760080378,1672687420,1672690279,2859
11650,3511729562,3235578852,1672699103,1672699435,332
9895,3810584695,3777290300,1672692980,1672696205,3225
9849,3278779955,3713219299,1672545034,1672546435,1401
11272,3776348451,3793232021,1672583583,1672585664,2081
10181,3425260097,3681504869,1672593878,1672595982,2104
11590,3779604279,3778986795,1672686760,1672688361,1601
11530,3791796190,3701725839,1672584509,1672586028,1519
9845,3559759778,3621629499,1672536397,1672538922,2525
11359,3885674996,3500209015,1672558497,1672562057,3560
11029,3454554552,3362127525,1672608684,1672612246,3562
10896,3711804184,3857344874,1672675732,1672678639,2907
10448,3343616490,3534696810,1672537700,1672540668,2968
11030,3885545415,3509208005,1672663423,1672665597,2174
11127,3930501172,3358473096,1672533309,1672536454,3145
10731,3415228763,3715126587,1672551459,1672551843,384
10069,3534102440,3780298499,1672563691,1672566702,3011
11355,3439651226,3458432407,1672599309,1672599683,374
10509,3713906305,3713444403,1672645768,1672647383,1615
10122,3512072679,3755192104,1672584371,1672585671,1300
10455,3511466117,3493598658,1672646479,1672647933,1454
10689,3366164642,3445558740,1672669715,1672672389,2674
10247,3301403047,3236886943,1672647841,1672651124,3283
10166,3201634072,3408828584,1672615566,1672615715,149
11033,3492056330,3440582836,1672636791,1672640363,3572
10808,3716633983,3777552831,1672586252,1672588574,2322
10660,3512306195,3776710698,1672607726,1672608225,499
11371,3515681585,3822496670,1672700893,1672704107,3214
11608,3791224239,3903994989,1672570441,1672573130,2689
11630,3441737317,3512087090,1672639609,1672640989,1380
11033,3774035405,3419789418,1672646118,1672647663,1545
11013,3315432466,3668764192,1672604271,1672606613,2342
11240,3904184638,3779561601,1672697044,1672699727,2683
10310,3223177147,3505266343,1672684645,1672687885,3240
11192,3304227085,3664478769,1672647997,1672648840,843
11300,3711959141,3783043770,1672655340,1672657751,2411
11342,3773041843,3420983899,1672689344,1672690326,982
10904,3336501403,3772869013,1672614702,1672618099,3397
10139,3791542842,3773878451,1672643135,1672644850,1715
11202,3512645289,3755286041,1672589720,1672592091,2371
9882,3714074120,3422205569,1672616188,1672618807,2619
11603,3716020849,3892487982,1672670081,1672672100,2019
11094,3776053981,3518058151,1672642247,1672644598,2351
10816,3533703578,3355430975,1672647292,1672648117,825
10460,3510919509,3276209319,1672693386,1672693498,112
11153,3623512088,3238056215,1672652490,1672654752,2262
10003,3778100960,3915035136,1672672441,1672674538,2097
9813,3830291558,3368079099,1672685922,1672689291,3369
10489,3444680955,3774109138,1672580361,1672583821,3460
10404,3311771689,3309455369,1672647713,1672647804,91
11629,3511750695,3311514075,1672624060,1672625711,1651
10093,3660176760,3791382196,1672647461,1672649180,1719
10414,3897003751,3755942724,1672672192,1672673792,1600
10677,3668855144,3364286028,1672682423,1672685425,3002
11012,3780168985,3810818108,1672656691,1672656800,109
10311,3902023467,3600871715,1672628716,1672630045,1329
9926,3223144610,3455907179,1672598252,1672599289,1037
10109,3533777032,3245755569,1672607194,1672609205,2011
10023,3736056340,3714892312,1672682917,1672685615,2698
10769,3510189563,3621439107,1672673755,1672674175,420
10393,3387989658,3756998113,1672622232,1672625021,2789
10053,3399734748,3770285500,1672605258,1672606322,1064
11394,3203151036,3499343927,1672701284,1672703578,2294
11456,3792972270,3358675021,1672607393,1672610044,2651
10857,3393502004,3807717766,1672566465,1672569322,2857
10389,3520925688,3780238637,1672533902,1672536976,3074
11464,3337673625,3756876537,1672569018,1672572458,3440
10664,3780171640,3701350519,1672703411,1672706851,3440
10571,3791070926,3481019442,1672653890,1672654327,437
11478,3715852330,3420881591,1672556697,1672558081,1384
10811,3820280594,3837435907,1672672239,1672674623,2384
10010,3520697518,3772648837,1672592877,1672593830,953
10943,3681737865,3899756737,1672584437,1672586886,2449
11687,3903065952,3757406215,1672574169,1672575732,1563
11588,3791716170,3473706746,1672689678,1672692492,2814
11638,3780740477,3715101177,1672692133,1672694717,2584
10501,3701065296,3512826895,1672593452,1672593585,133
11043,3281970147,3534624672,1672611377,1672614680,3303
9877,3898989233,3857244486,1672595836,1672597616,1780
11017,3713728777,3331471764,1672625898,1672628008,2110
10321,3793814153,3355430975,1672618834,1672620935,2101
11120,3625952981,3354015456,1672673398,1672675925,2527
11171,3715712376,3465107990,1672565098,1672568345,3247
10122,3779975575,3736987749,1672575715,1672575842,127
10234,3403150349,3776811587,1672568182,1672569116,934
10062,3783408830,3800434325,1672614312,1672615309,997
11345,3517943697,3472901378,1672533923,1672534591,668
11181,3515528947,3792075871,1672666980,1672668493,1513
10439,3534578428,3858330969,1672681657,1672684520,2863
10649,3661543201,3780173788,1672603937,1672606422,2485
11749,3792708936,3716801088,1672571155,1672571915,760
11791,3201419050,3309528048,1672656845,1672658323,1478
10139,3783172505,3505392452,1672650162,1672650570,408
10000,3337673625,3919984986,1672554724,1672556073,1349
9833,3777041132,3972442654,1672552543,1672554889,2346
11168,3906874577,3499820963,1672560087,1672561725,1638
11768,3520506192,3499343927,1672658426,1672659542,1116
10176,3703502114,3710852576,1672569150,1672572345,3195
10924,3884192843,3609103278,1672669658,1672672121,2463
11381,3711015176,3390438262,1672659319,1672662673,3354
10418,3513894659,3856316719,1672671200,1672674320,3120
11752,3340723781,3278430820,1672690771,1672691070,299
11427,3791905743,3774436159,1672680234,1672680783,549
11588,3428878402,3755374000,1672594066,1672595006,940
10735,3668202976,3757513651,1672596489,1672598691,2202
11404,3730600658,3496407500,1672552367,1672553679,1312
11183,3233965781,3779835734,1672540298,1672541934,1636
11779,3520558137,3311805161,1672649308,1672652501,3193
9875,3200320674,3791224239,1672633746,1672633999,253
10731,3854229296,3442564712,1672623032,1672626076,3044
10131,3355430975,3791332226,1672632206,1672635805,3599
9873,3701387745,3907225070,1672653242,1672654065,823
11363,3308149799,3311260898,1672656132,1672658791,2659
9804,3512596743,3517766135,1672601647,1672602039,392
10024,3228997424,3816184951,1672633583,1672635465,1882
11667,3423353911,3909822999,1672669553,1672669962,409
11307,3733123020,3714718326,1672578977,1672579308,331
11620,3892487982,3773826624,1672539334,1672541168,1834
9988,3452104161,3500087325,1672581484,1672582922,1438
11530,3404461403,3774447975,1672667016,1672668179,1163
10159,3380167818,3852461753,1672637953,1672639075,1122
10932,3515507526,3825932442,1672602425,1672605940,3515
11433,3514498259,3488887919,1672604528,1672606333,1805
10109,3500624846,3511296895,1672595880,1672597288,1408
11011,3711755596,3517718901,1672702882,1672706375,3493
10752,3812559393,3533976217,1672537547,1672538426,879
10641,3499622352,3244395841,1672667677,1672670885,3208
9882,3730459093,3773852157,1672608932,1672610443,1511
11442,3791332061,3760749218,1672667360,1672669095,1735
11322,3907923381,3500087325,1672662033,1672663223,1190
10962,3307236682,3229890340,1672593702,1672596651,2949
10701,3791644831,3518157683,1672603449,1672604736,1287
10525,3500145103,3713224038,1672549091,1672550885,1794
11106,3778125688,3307236682,1672560364,1672561317,953
11350,3520860199,3800434325,1672646616,1672647006,390
11206,3636605690,3510486220,1672594200,1672594452,252
10691,3703502114,3777552831,1672661672,1672664648,2976
10914,3899756737,3779312237,1672542559,1672543812,1253
10216,3619676231,3292663993,1672544787,1672545786,999
11375,3430296808,3710223875,1672639286,1672640052,766
10729,3475830203,3495637721,1672634330,1672637529,3199
10239,3811419378,3715441786,1672660722,1672662690,1968
11120,3559619861,3512480125,1672665422,1672665674,252
9944,3715923089,3770424941,1672569201,1672571304,2103
11708,3287821258,3513143959,1672571120,1672573075,1955
10815,3772169046,3332010532,1672641875,1672643023,1148
9958,3778544203,3772869013,1672534047,1672536578,2531
10458,3891272544,3802757611,1672625985,1672629328,3343
11491,3505845400,3516200419,1672536449,1672536644,195
11454,3703614781,3245642576,1672550968,1672551425,457
10667,3715852330,3792972270,1672535181,1672536967,1786
10058,3701385831,3425646356,1672609961,1672612599,2638
11540,3520925688,3884862164,1672672603,1672674044,1441
9803,3492056330,3926724515,1672686297,1672687630,1333
10160,3310961923,3783176874,1672664012,1672665532,1520
10304,3420664407,3515637968,1672671630,1672671976,346
11736,3440671139,3361789225,1672701358,1672702046,688
11702,3380357490,3770941125,1672684589,1672686173,1584
11059,3358675021,3519000878,1672641969,1672644896,2927
10029,3713606829,3778544203,1672671596,1672672150,554
10484,3715008501,3902548260,1672583587,1672585784,2197
11315,3481365330,3682906048,1672539143,1672539299,156
11001,3206241691,3355430975,1672669162,1672672695,3533
11299,3534589501,3637522163,1672659498,1672662707,3209
10713,3779503296,3517325365,1672570047,1672571167,1120
11760,3472901378,3780467276,1672588642,1672591551,2909
10983,3772509599,3776001441,1672594678,1672596513,1835
10661,3285587972,3436401020,1672649482,1672651924,2442
11765,3710783759,3887502536,1672702506,1672703899,1393
11603,3757732853,3450503086,1672652804,1672653993,1189
10192,3355903597,3770941125,1672538614,1672541274,2660
10856,3772943811,3922430928,1672627418,1672628020,602
10999,3757501067,3792497486,1672696968,1672699275,2307
10605,3760776967,3518947256,1672642504,1672645041,2537
11693,3703031637,3917243005,1672664267,1672667030,2763
10309,3446537819,3809860102,1672617340,1672620539,3199
11610,3930475498,3294164983,1672585106,1672585831,725
10731,3802625412,3783939161,1672560025,1672563542,3517
11645,3730571757,3467944159,1672667989,1672669244,1255
10656,3534190196,3334824744,1672636698,1672637136,438
11502,3434452046,3713694278,1672598230,1672601448,3218
10552,3516517348,3776183353,1672573851,1672575496,1645
11292,3634670780,3500776597,1672662034,1672663053,1019
11655,3513996288,3319660530,1672618440,1672619641,1201
10185,3534190196,3737946004,1672634244,1672637770,3526
11090,3733423371,3613781977,1672610866,1672613657,2791
11004,3938059867,3776304080,1672630979,1672632334,1355
10485,3770925016,3510987684,1672682244,1672685581,3337
10955,3319585148,3783942518,1672677801,1672678423,622
10961,3511969443,3312733562,1672582705,1672585637,2932
10063,3927365255,3440991826,1672674691,1672677166,2475
10566,3236206821,3423346297,1672554324,1672556745,2421
10844,3777928067,3930727474,1672575824,1672578951,3127
10387,3810584695,3501711464,1672625306,1672626390,1084
11178,3500429731,3793987483,1672664315,1672664684,369
11709,3710107905,3780749789,1672670721,1672671094,373
11268,3512477276,3810818108,1672660898,1672663111,2213
10532,3716891903,3514980025,1672687994,1672690563,2569
11430,3478206139,3318056480,1672689431,1672690425,994
11096,3701475090,3515944817,1672543603,1672547056,3453
11523,3247845642,3602680347,1672549877,1672552473,2596
10863,3774090455,3271719569,1672612100,1672612545,445
10949,3783408469,3774539067,1672673310,1672674519,1209
11092,3516429380,3772019557,1672653285,1672656123,2838
11147,3396453219,3287920864,1672661857,1672662351,494
11041,3533830748,3447948483,1672581823,1672583084,1261
11168,3347140733,3404461403,1672651522,1672651961,439
10851,3511867383,3779102237,1672572279,1672574005,1726
11435,3233965781,3512726649,1672692409,1672695126,2717
9988,3437703650,3505684690,1672603256,1672603394,138
10992,3505121295,3427527462,1672608278,1672610927,2649
11329,3366801723,3462985379,1672689277,1672692686,3409
10188,3520763492,3500455935,1672541909,1672543148,1239
11303,3312651192,3279851026,1672536700,1672540147,3447
11088,3279731391,3514498259,1672686552,1672687273,721
11642,3515096959,3885339157,1672648401,1672651357,2956
11246,3756761603,3287760230,1672603238,1672603843,605
10984,3701956841,3739387948,1672585804,1672588121,2317
10678,3416474842,3622729771,1672576152,1672576540,388
11101,3920606331,3513802404,1672611454,1672611532,78
11100,3515753241,3505097206,1672609209,1672610899,1690
11428,3689420679,3757732853,1672542964,1672545370,2406
10948,3735152111,3533876927,1672546762,1672548683,1921
10992,3716160006,3533365834,1672595244,1672597881,2637
11627,3935520819,3337675386,1672621961,1672625054,3093
10321,3511245705,3517949586,1672610206,1672610707,501
10357,3711176990,3500579482,1672599410,1672602513,3103
9913,3518794921,3780749789,1672690308,1672691212,904
11055,3513586642,3461137945,1672545656,1672548758,3102
10916,3455955489,3514737648,1672694453,1672695658,1205
10154,3353335252,3494748808,1672654365,1672655539,1174
10602,3738547113,3914947393,1672543032,1672543721,689
10204,3354968884,3665478011,1672700409,1672703708,3299
10930,3461931154,3343859998,1672575868,1672577461,1593
10181,3516335333,3293673220,1672672169,1672672627,458
10350,3238997746,3894756677,1672637926,1672639146,1220
11639,3501427691,3826068495,1672661233,1672661344,111
10144,3605760561,3500720752,1672535158,1672538249,3091
10464,3206926634,3424476995,1672533824,1672534350,526
10605,3714455496,3510836047,1672581071,1672582849,1778
11698,3510022922,3685083275,1672547415,1672547701,286
11490,3534624672,3783879023,1672550137,1672551336,1199
11613,3738103378,3817120976,1672559396,1672561764,2368
11572,3780467276,3275171954,1672702362,1672704918,2556
11479,3201573194,3235074007,1672602616,1672605314,2698
10665,3520625600,3777499535,1672534652,1672534759,107
10690,3930501172,3777686966,1672593297,1672594496,1199
10203,3384601925,3434052463,1672600388,1672602744,2356
10506,3306475287,3361711720,1672685013,1672686424,1411
11484,3703438617,3311739926,1672603811,1672605702,1891
10081,3680939042,3770630937,1672605188,1672608510,3322
9945,3401215739,3347140733,1672662029,1672662514,485
9985,3514297012,3778731000,1672562348,1672565250,2902
9867,3713954144,3756413374,1672554269,1672556970,2701
11699,3791351852,3201573194,1672638205,1672638287,82
10148,3559754304,3783238023,1672641158,1672642824,1666
11393,3937299996,3534696810,1672686760,1672687912,1152
11761,3755729826,3825526565,1672604615,1672604864,249
11325,3406169279,3403120725,1672657983,1672658137,154
10742,3660702754,3307454562,1672653938,1672654707,769
10077,3668369938,3710008760,1672569630,1672571147,1517
10057,3791332226,3498857406,1672626716,1672626905,189
10635,3780142207,3791581138,1672674591,1672676068,1477
10140,3513996288,3427049290,1672649603,1672650219,616
11423,3886879696,3815700240,1672660395,1672663287,2892
10263,3273537848,3716492409,1672637616,1672640546,2930
10831,3429610195,3505756991,1672606035,1672607542,1507
10672,3345954031,3515970536,1672628633,1672629335,702
10468,3416225867,3760749218,1672623986,1672624930,944
11713,3428076194,3505756991,1672576409,1672577078,669
10922,3515804844,3519463038,1672664690,1672666767,2077
9835,3389367628,3505684690,1672535557,1672538041,2484
10148,3307535495,3774682234,1672600844,1672601177,333
11783,3500120676,3311188620,1672643685,1672646514,2829
10350,3778838936,3428076194,1672612224,1672614411,2187
9841,3909822999,3245642576,1672555504,1672557409,1905
10347,3519924982,3793874490,1672593578,1672594979,1401
11303,3783408830,3511458926,1672667998,1672670745,2747
10442,3482519872,3557528150,1672674319,1672675740,1421
10124,3733796228,3701350519,1672586041,1672589463,3422
11770,3755192104,3715441777,1672619436,1672620075,639
11641,3837888196,3369938668,1672607961,1672608656,695
10685,3716020849,3509274030,1672557244,1672558794,1550
9927,3910354786,3971280379,1672697749,1672699596,1847
11324,3663505156,3660980656,1672621415,1672624302,2887
10899,3202787155,3711187791,1672629057,1672632411,3354
11401,3494680853,3533009565,1672685956,1672686416,460
10628,3770486161,3600699873,1672661902,1672662760,858
11146,3770018912,3779706467,1672556967,1672559256,2289
10774,3514389188,3418791124,1672533374,1672535200,1826
10332,3512681214,3512495325,1672586419,1672587537,1118
10808,3774109138,3713805968,1672577766,1672581016,3250
11492,3517132086,3287821258,1672694747,1672695359,612
11744,3441840658,3285136057,1672532636,1672534485,1849
10528,3732871856,3737571883,1672632501,1672633442,941
10986,3442403264,3791905743,1672638983,1672642463,3480
11453,3613781977,3373135211,1672546388,1672549713,3325
11517,3359929534,3515893948,1672582907,1672584208,1301
10582,3773378103,3710223875,1672671363,1672671645,282
10225,3505331083,3450735824,1672630617,1672632101,1484
10090,3501963428,3491104534,1672650248,1672652161,1913
11324,3510250740,3362706073,1672539016,1672542379,3363
11193,3425545115,3275661834,1672608264,1672611796,3532
11023,3701374160,3625400710,1672639408,1672639786,378
10988,3977615973,3928076270,1672692550,1672696013,3463
11533,3209417223,3516827471,1672598869,1672599932,1063
11706,3773475506,3368441333,1672665034,1672665994,960
11158,3894495222,3431317400,1672694229,1672696942,2713
10686,3202787155,3760024021,1672703780,1672706887,3107
10135,3703999217,3517960157,1672676544,1672677317,773
10372,3378172464,3737745988,1672683400,1672684481,1081
10639,3756991235,3406937294,1672661783,1672662895,1112
11713,3500062408,3711196962,1672558722,1672560156,1434
11018,3398075553,3512726649,1672546824,1672548757,1933
10704,3739217535,3780298499,1672688762,1672691161,2399
11270,3971280379,3311515179,1672571341,1672571669,328
10439,3882905311,3836136159,1672547116,1672547640,524
10681,3516904926,3896840409,1672597008,1672597271,263
10592,3714838100,3480108752,1672534536,1672535723,1187
11137,3223177147,3520925688,1672678573,1672681283,2710
11403,3397330170,3793689267,1672585803,1672589326,3523
10002,3886879696,3286938590,1672644529,1672647202,2673
11535,3427527462,3776279305,1672536162,1672536770,608
10782,3774296721,3387621912,1672572673,1672574597,1924
11146,3467415939,3711862792,1672551152,1672552171,1019
11769,3701540249,3308759754,1672662817,1672665688,2871
10881,3311515179,3311142523,1672673187,1672675552,2365
11083,3609997804,3512802259,1672632968,1672634109,1141
10093,3899903158,3791245127,1672682718,1672683281,563
10989,3500536897,3755230010,1672588358,1672591296,2938
11768,3770018912,3241567995,1672540413,1672542733,2320
11729,3783594729,3490953301,1672701217,1672701535,318
11279,3519319233,3403870769,1672671630,1672673198,1568
10580,3914947393,3888523259,1672577539,1672580680,3141
10650,3779478448,3241567995,1672560822,1672562228,1406
11761,3513171472,3220976338,1672627433,1672629286,1853
11265,3703048107,3779748270,1672536437,1672538868,2431
10817,3792107875,3245121919,1672531276,1672531579,303
10880,3512480125,3233712975,1672558864,1672560115,1251
11448,3757660578,3301431129,1672621355,1672621980,625
9866,3755823805,3229570647,1672563710,1672567012,3302
10781,3518882056,3424476995,1672560542,1672563295,2753
10949,3713434898,3358211034,1672646609,1672649376,2767
10355,3939882169,3783947742,1672591290,1672591977,687
10347,3311463998,3552261072,1672572470,1672576054,3584
10909,3773953689,3662495290,1672557856,1672558231,375
11647,3715590997,3478915403,1672651485,1672652424,939
11280,3711196962,3519997661,1672549431,1672549779,348
10923,3792411831,3283106998,1672638718,1672642159,3441
10683,3342837214,3887069914,1672645420,1672647718,2298
11164,3937636109,3505538902,1672612414,1672613454,1040
9796,3711518637,3760648750,1672690295,1672691178,883
10175,3287094447,3778544203,1672673157,1672675326,2169
9943,3735422623,3711810752,1672647483,1672649506,2023
10494,3621960662,3505175620,1672695605,1672698327,2722
10427,3610517436,3229890340,1672582493,1672583667,1174
9974,3613936929,3912181197,1672645067,1672648364,3297
9889,3687024828,3755922811,1672680374,1672681114,740
10995,3517552930,3773878451,1672678361,1672681953,3592
10071,3783086267,3772802020,1672601632,1672602025,393
10185,3838039092,3500590302,1672656600,1672659352,2752
11650,3359418136,3714264759,1672567441,1672570366,2925
10090,3516200419,3376842515,1672696729,1672699539,2810
10773,3701127475,3513859809,1672631743,1672632202,459
10356,3730052916,3774702364,1672672011,1672674479,2468
11482,3518572231,3533440294,1672602368,1672602432,64
11108,3307216611,3370245766,1672674086,1672675593,1507
10651,3856601074,3757212744,1672641533,1672643986,2453
10567,3855629383,3291153514,1672677017,1672678334,1317
9841,3837888196,3501244753,1672631951,1672633069,1118
10221,3774109138,3520339198,1672621589,1672623794,2205
11506,3400545490,3509317776,1672649057,1672651687,2630
9975,3349573092,3770275898,1672692298,1672694330,2032
10283,3772980989,3505011956,1672551244,1672554506,3262
10080,3977666815,3755779925,1672673416,1672676441,3025
10056,3774109138,3916463490,1672627364,1672630875,3511
10899,3415032547,3519951586,1672654177,1672655776,1599
10484,3792162098,3778370462,1672642989,1672644256,1267
10536,3304661369,3505164060,1672658445,1672659171,726
10300,3810584695,3514107131,1672674493,1672674636,143
10187,3783967375,3917467642,1672590166,1672591929,1763
9952,3770276815,3276209319,1672629768,1672631878,2110
10507,3716285196,3818532143,1672560463,1672560811,348
11191,3520625600,3669283586,1672558015,1672558790,775
10049,3791205793,3770275898,1672598414,1672598944,530
9906,3772169046,3791088014,1672681026,1672683191,2165
11219,3735056027,3335055096,1672587958,1672588776,818
10414,3710861700,3756428507,1672699321,1672701969,2648
10907,3500444748,3778561231,1672581767,1672584950,3183
10657,3480259863,3519886257,1672574794,1672575337,543
10921,3461741050,3825234433,1672563360,1672564952,1592
10927,3416225867,3934280144,1672542260,1672543798,1538
11705,3498857406,3371238318,1672581129,1672583208,2079
10807,3390537737,3760748418,1672661718,1672664458,2740
10127,3616403486,3304447950,1672639984,1672642599,2615
10009,3534506090,3827889533,1672616509,1672618030,1521
11624,3305657559,3792432094,1672625743,1672629192,3449
10312,3500693568,3427741923,1672658123,1672661291,3168
10993,3510486220,3517210356,1672681329,1672684678,3349
10917,3395610742,3516827471,1672630059,1672632033,1974
10213,3335055096,3701475090,1672639598,1672639870,272
10653,3711854614,3519351747,1672594885,1672595092,207
9978,3500688476,3770019143,1672589897,1672590976,1079
9933,3500928990,3914353062,1672667158,1672668803,1645
10585,3292663993,3354968884,1672696388,1672699773,3385
11137,3247545468,3737745988,1672553673,1672556375,2702
11524,3373677765,3518205307,1672596869,1672597110,241
10774,3305656670,3512527440,1672644826,1672645707,881
10189,3501115299,3513586642,1672626286,1672626715,429
10231,3519951586,3714281795,1672651422,1672652657,1235
9851,3278430820,3474852115,1672594915,1672595636,721
10903,3805831563,3312733562,1672622833,1672624936,2103
11329,3827889533,3227059650,1672607936,1672609644,1708
10970,3890211161,3603167427,1672588740,1672590666,1926
10563,3514926921,3900540310,1672628664,1672628989,325
9886,3735497729,3510159441,1672656435,1672658193,1758
10535,3533960602,3776122272,1672600447,1672603803,3356
11072,3908883591,3466492108,1672631179,1672633591,2412
11757,3973138649,3776778306,1672671996,1672674956,2960
10203,3701291994,3519435459,1672668556,1672671714,3158
11767,3519465545,3236254381,1672675747,1672675880,133
10134,3777751979,3760537855,1672689790,1672693087,3297
11480,3534102440,3401215739,1672629291,1672631926,2635
10139,3688130094,3783373085,1672596539,1672599233,2694
10636,3681504869,3622218289,1672673349,1672676928,3579
11245,3756759239,3513624915,1672606414,1672608004,1590
10486,3500726347,3285515107,1672630920,1672633524,2604
11595,3509663119,3793996996,1672594975,1672598210,3235
10484,3970775805,3906693728,1672577767,1672580243,2476
10648,3777715675,3701887470,1672569371,1672572396,3025
10944,3342027511,3505148522,1672666551,1672667851,1300
11222,3714951681,3805704844,1672629665,1672631696,2031
9881,3772291207,3710397477,1672695546,1672697716,2170
10476,3553321027,3623953446,1672654180,1672656811,2631
10482,3519108639,3440671139,1672649243,1672651048,1805
9985,3715140418,3773432494,1672618932,1672619066,134
10288,3774673193,3509562377,1672669855,1672671809,1954
10202,3791236983,3289017988,1672619804,1672622862,3058
11514,3756536476,3510795808,1672701666,1672705139,3473
11529,3937299996,3505500523,1672638321,1672641845,3524
9818,3837378340,3398021818,1672692687,1672695891,3204
11459,3534984243,3891586951,1672688080,1672690237,2157
11635,3772164469,3662794240,1672628314,1672629183,869
10503,3433196933,3519947298,1672682269,1672684828,2559
11113,3517448452,3660980656,1672646420,1672647750,1330
9928,3293553295,3519065870,1672582972,1672584340,1368
10740,3850181934,3301369282,1672637935,1672640890,2955
11325,3716841469,3716922925,1672557516,1672560530,3014
10889,3710585241,3223796145,1672591187,1672593586,2399
10956,3473706746,3778605154,1672607826,1672609482,1656
10346,3438028077,3500018566,1672703254,1672705749,2495
11379,3779393140,3838748301,1672571562,1672572252,690
11439,3856552205,3279851026,1672588047,1672589263,1216
10640,3703277359,3271389160,1672564970,1672565799,829
11550,3619494735,3808442442,1672657324,1672657401,77
10212,3358530225,3516827471,1672639198,1672639807,609
10606,3479910993,3780168985,1672545196,1672545414,218
10740,3683514731,3813276198,1672678746,1672681140,2394
10711,3380281484,3888057649,1672615960,1672618307,2347
9876,3778044082,3914947393,1672582317,1672584330,2013
11419,3511412229,3827981800,1672576442,1672578326,1884
11485,3701060732,3520049965,1672570647,1672572277,1630
11748,3510189563,3716178116,1672665242,1672665760,518
11431,3609644043,3776304080,1672585349,1672585643,294
10100,3554437212,3519352855,1672569273,1672571775,2502
10889,3838119022,3817376705,1672683729,1672686904,3175
11323,3554174421,3500928990,1672597241,1672599565,2324
11561,3516535558,3776953418,1672659432,1672660418,986
10091,3774251051,3343193067,1672698796,1672700550,1754
10296,3446810761,3662307789,1672657447,1672659867,2420
10727,3755630085,3780050328,1672677231,1672678029,798
10811,3770424892,3289258397,1672622329,1672623628,1299
11058,3501208658,3881579907,1672585780,1672587857,2077
10951,3756759239,3783095041,1672547800,1672548021,221
10048,3732533330,3514747345,1672678437,1672681966,3529
11310,3922409420,3757855416,1672558405,1672558652,247
11771,3793822639,3778124514,1672562212,1672565763,3551
11683,3736621212,3858497718,1672596187,1672598081,1894
11295,3755767856,3534426696,1672647377,1672649050,1673
11236,3360837082,3851877325,1672630666,1672631890,1224
9873,3611939581,3830254808,1672653221,1672654826,1605
10425,3773736248,3519513219,1672638196,1672639272,1076
11494,3713107380,3777569538,1672671434,1672671908,474
11708,3791906680,3505697295,1672559324,1672559979,655
11776,3783730769,3307236682,1672679233,1672681417,2184
10217,3664719070,3302988745,1672560779,1672563462,2683
10485,3612042508,3366801723,1672551497,1672551772,275
10126,3501126057,3623113240,1672666282,1672667667,1385
11398,3710046567,3778986795,1672586438,1672588477,2039
11767,3501574882,3755154460,1672647982,1672648382,400
10655,3510439480,3791841318,1672656149,1672657248,1099
9981,3462985379,3359472956,1672562522,1672563764,1242
10813,3458130310,3611533094,1672594660,1672596646,1986
10451,3449020351,3772262649,1672631048,1672633531,2483
11749,3737685967,3755688231,1672641515,1672643800,2285
11706,3509186338,3791509881,1672686069,1672689082,3013
11698,3713100169,3517960157,1672568646,1672569837,1191
9859,3711258452,3820422111,1672631585,1672632675,1090
11294,3780563627,3558567160,1672658708,1672658809,101
10376,3625400710,3908878965,1672543794,1672544904,1110
10341,3701065296,3558349840,1672543369,1672544388,1019
11385,3334381941,3811354125,1672576470,1672578086,1616
10226,3791236983,3229615214,1672647417,1672648255,838
10263,3283295213,3776468503,1672603327,1672605319,1992
11343,3713728777,3972653129,1672558317,1672559537,1220
10346,3243651036,3780142207,1672647236,1672648589,1353
11414,3703104365,3335353798,1672648146,1672648805,659
10420,3916955566,3534122907,1672689211,1672691158,1947
11534,3609166109,3452982957,1672642998,1672646396,3398
10128,3516472352,3510535683,1672551529,1672552699,1170
11225,3203151036,3776182849,1672561323,1672562133,810
11318,3804075198,3313282478,1672581054,1672584342,3288
10936,3779282072,3738429905,1672613672,1672617185,3513
9833,3334381941,3711767051,1672598427,1672598669,242
11548,3284374600,3757407184,1672598683,1672601958,3275
11071,3921138062,3369938668,1672554146,1672555872,1726
11268,3516321993,3301489209,1672677569,1672678762,1193
10547,3832902787,3459951739,1672556432,1672558738,2306
10582,3793934396,3600302127,1672538351,1672540364,2013
10116,3773440794,3732846295,1672576847,1672577216,369
10273,3827889533,3379076106,1672693164,1672694668,1504
11240,3710891331,3780740477,1672639769,1672641919,2150
10368,3793003432,3881785069,1672595831,1672597526,1695
10948,3246395239,3804075198,1672611308,1672612970,1662
10243,3513840186,3885422379,1672680164,1672681958,1794
11004,3760443176,3204149913,1672566491,1672568460,1969
11568,3305657559,3737745988,1672596387,1672597375,988
11141,3429610195,3760069457,1672553622,1672553736,114
11332,3682086200,3516321814,1672699300,1672701680,2380
10139,3778838936,3927202773,1672551816,1672553616,1800
11328,3755411110,3736203662,1672638588,1672639258,670
10855,3312800145,3791688526,1672667348,1672667498,150
10516,3791688526,3777909822,1672625842,1672626789,947
10947,3701521510,3820280594,1672628470,1672629494,1024
11741,3499343927,3511963020,1672641660,1672643194,1534
10653,3780786276,3208962614,1672532524,1672534574,2050
11700,3833520635,3505560793,1672637237,1672638822,1585
11637,3479452888,3354405535,1672557969,1672560287,2318
10101,3500073824,3533974355,1672583495,1672585976,2481
10366,3627377299,3776534957,1672662038,1672663697,1659
10177,3703725221,3511289729,1672563890,1672566325,2435
10569,3439283360,3732596503,1672681102,1672681864,762
10576,3313502623,3836757034,1672627885,1672629664,1779
11437,3778044082,3518205307,1672579596,1672580676,1080
11319,3422205569,3884191432,1672589245,1672592350,3105
10389,3512495325,3517756624,1672592247,1672593931,1684
10365,3838039092,3600842635,1672689331,1672691708,2377
9928,3669140241,3452982957,1672554849,1672555872,1023
11171,3516651799,3505331083,1672581468,1672584788,3320
11788,3755779925,3514107131,1672674184,1672674621,437
10320,3511908639,3853182912,1672681412,1672681697,285
10401,3509208005,3517195738,1672666686,1672669109,2423
10824,3792851584,3453464785,1672620803,1672623336,2533
10269,3714883746,3716020849,1672674451,1672675014,563
11625,3516969689,3625400710,1672566346,1672567036,690
10702,3393128259,3972856326,1672689094,1672689266,172
10228,3472561941,3714067998,1672582757,1672583566,809
10065,3364683368,3757994002,1672540679,1672542643,1964
9858,3792475476,3739567072,1672683152,1672683476,324
11240,3757064623,3466655775,1672639219,1672639947,728
10583,3239401337,3505901826,1672576234,1672577222,988
10007,3776291254,3376487118,1672569579,1672572197,2618
11173,3715291931,3467232654,1672689140,1672692516,3376
11133,3780435349,3715700639,1672617645,1672620491,2846
11282,3714923092,3505416534,1672562323,1672563064,741
11555,3755570137,3533867833,1672598950,1672599848,898
10524,3246296769,3362706073,1672582014,1672582938,924
10619,3776581518,3512753567,1672543326,1672546164,2838
10527,3505037247,3774598935,1672620978,1672621931,953
11721,3836090778,3626631210,1672624566,1672628114,3548
11297,3510484107,3839744168,1672577339,1672578396,1057
11592,3302416197,3501980730,1672623640,1672626321,2681
11317,3938021614,3703611876,1672600383,1672602209,1826
11361,3756668747,3780129338,1672593514,1672594663,1149
10178,3301431129,3894495222,1672700929,1672701721,792
10450,3557129226,3233712975,1672579077,1672582400,3323
11363,3520471156,3384001094,1672532306,1672535643,3337
11681,3515528947,3850181934,1672702924,1672706413,3489
11620,3223144610,3779835734,1672624111,1672624796,685
9873,3736987749,3611832288,1672643683,1672645484,1801
10190,3780435349,3517800171,1672590572,1672593950,3378
11566,3906874577,3354968884,1672661451,1672664259,2808
11146,3970851830,3770780655,1672578884,1672582242,3358
10163,3779255367,3293540333,1672551591,1672555188,3597
10836,3714142299,3777370992,1672645407,1672646472,1065
11198,3807717766,3501619113,1672549096,1672551469,2373
9841,3919345990,3392573386,1672656422,1672657876,1454
9953,3288346356,3512750313,1672648818,1672649042,224
11160,3834949242,3710585241,1672655270,1672656620,1350
10347,3201573194,3770780655,1672661144,1672662728,1584
10948,3701769970,3835599049,1672622898,1672625783,2885
10052,3931495845,3233917789,1672612615,1672615223,2608
11115,3774633364,3491250381,1672693831,1672695937,2106
10231,3606688595,3293673220,1672576583,1672577393,810
10497,3553321027,3341129425,1672577714,1672579038,1324
11425,3777112124,3714455496,1672624131,1672626431,2300
10431,3830771832,3357026115,1672611412,1672613689,2277
11478,3511095300,3701377471,1672632034,1672635544,3510
11487,3378729459,3770019143,1672627376,1672628206,830
11472,3444680955,3792597493,1672653664,1672656231,2567
10625,3701493094,3899970524,1672656272,1672658610,2338
10173,3684651755,3732871856,1672644564,1672645866,1302
11064,3478052226,3687024828,1672627556,1672630842,3286
11102,3384601925,3205161801,1672691151,1672693877,2726
11386,3791974273,3398483531,1672629018,1672632442,3424
10900,3701841013,3760854788,1672655341,1672656513,1172
11756,3334461288,3519162582,1672539356,1672539477,121
11473,3714435747,3687183789,1672615889,1672616591,702
9871,3909457959,3501550490,1672576575,1672578485,1910
10041,3405221863,3715790104,1672619281,1672621008,1727
11310,3668369938,3229890340,1672539797,1672541538,1741
10672,3357026115,3519465545,1672661352,1672664547,3195
10515,3897851509,3358675021,1672637699,1672640082,2383
10845,3776583229,3284865931,1672667441,1672667795,354
10836,3755584983,3350966326,1672651827,1672653990,2163
11303,3757773786,3930475498,1672616276,1672618684,2408
9953,3732090606,3559754304,1672664556,1672665809,1253
11690,3287753579,3519297683,1672533058,1672533251,193
9828,3898965585,3236948071,1672631591,1672633447,1856
11460,3716526314,3755630085,1672594252,1672595061,809
11277,3318056480,3276231633,1672632179,1672634655,2476
11360,3930727474,3450342110,1672623928,1672625763,1835
10210,3515706117,3776053981,1672674875,1672675800,925
10872,3519034304,3884001167,1672565620,1672568960,3340
11505,3245642576,3432050858,1672560039,1672562211,2172
9957,3802101760,3774316305,1672599531,1672600368,837
10578,3661359073,3342426430,1672545340,1672546085,745
11759,3440401725,3512154443,1672553266,1672554066,800
11513,3979115924,3777758203,1672647284,1672647675,391
11638,3399943757,3791108593,1672703106,1672704161,1055
10137,3760144712,3304235700,1672593779,1672594174,395
10101,3372079985,3203954795,1672653144,1672656190,3046
10885,3714919471,3417360319,1672568318,1672570395,2077
10146,3777758203,3780224882,1672621827,1672622415,588
11314,3533440294,3703476890,1672603899,1672605090,1191
11409,3470135167,3772114731,1672558226,1672560840,2614
10910,3362368123,3512417724,1672562067,1672564552,2485
10811,3517617472,3387706541,1672629803,1672633226,3423
10717,3509445318,3333477908,1672693912,1672694507,595
11722,3303747093,3511003541,1672702958,1672704043,1085
11751,3779454060,3510542303,1672664201,1672666117,1916
11494,3234445133,3774029494,1672646346,1672648959,2613
10639,3505709407,3903088144,1672558479,1672559844,1365
10553,3509544691,3447253775,1672585424,1672586372,948
11489,3342027511,3773024346,1672664289,1672664444,155
11394,3480185839,3513203127,1672652892,1672655304,2412
11546,3783043346,3770709417,1672632498,1672633440,942
9845,3441336851,3514564903,1672699553,1672702503,2950
10624,3793497672,3779468781,1672621239,1672622670,1431
10414,3888903181,3514007122,1672582594,1672585152,2558
11261,3505697295,3416105769,1672666884,1672668074,1190
11515,3349319959,3710296607,1672678969,1672681485,2516
10578,3915652382,3372596013,1672634246,1672636383,2137
10577,3447078933,3519297683,1672548426,1672548835,409
10258,3360837082,3780423516,1672607998,1672610446,2448
11107,3515970536,3475560058,1672691240,1672693467,2227
11450,3934991640,3468201976,1672606353,1672607110,757
10215,3518882056,3681737865,1672593360,1672594746,1386
11555,3307521389,3533209168,1672660745,1672662589,1844
10801,3370245766,3452090950,1672677499,1672678572,1073
11552,3500693568,3360309868,1672631527,1672634525,2998
11166,3520189871,3711844574,1672684299,1672686978,2679
11002,3760901975,3880882684,1672628658,1672631358,2700
11220,3711349327,3780969898,1672627168,1672627558,390
11135,3311771689,3778182724,1672680316,1672683050,2734
10255,3711367577,3417268745,1672690857,1672692352,1495
10327,3518759318,3533113740,1672623808,1672627031,3223
10247,3500221079,3701685828,1672606789,1672608385,1596
10565,3246296769,3378430760,1672558415,1672561011,2596
10663,3714312797,3509562377,1672582436,1672585171,2735
11124,3636927297,3517083465,1672553290,1672553963,673
11613,3511744756,3715712376,1672594086,1672594422,336
10467,3227206772,3446810761,1672581044,1672582497,1453
9879,3333505404,3919814073,1672627394,1672630899,3505
11791,3757678397,3511580693,1672534206,1672536343,2137
9838,3319585148,3272581469,1672689888,1672692943,3055
9877,3772708314,3791072829,1672662585,1672663589,1004
11056,3333505404,3440743218,1672563539,1672565333,1794
10491,3518117078,3369810091,1672662377,1672663797,1420
10264,3899970524,3463564410,1672531905,1672532882,977
11030,3515838621,3505709407,1672616238,1672618058,1820
10018,3382757142,3500421940,1672656765,1672657494,729
10789,3737745988,3756876537,1672694718,1672695584,866
9797,3501619113,3511206717,1672670568,1672671247,679
11250,3772234939,3201573194,1672558372,1672559854,1482
11451,3514244308,3715261950,1672703787,1672705029,1242
11727,3609166109,3515706117,1672606886,1672607728,842
11656,3738873928,3791698084,1672600638,1672601313,675
10571,3473520701,3500994763,1672638193,1672641493,3300
11686,3774436159,3701779683,1672615039,1672615756,717
11003,3680075399,3445896667,1672619874,1672622892,3018
11010,3792597493,3757732853,1672685901,1672686545,644
10445,3294952405,3413511621,1672544277,1672544674,397
9943,3294164983,3534362749,1672586918,1672590437,3519
10524,3776600696,3901217668,1672678109,1672681357,3248
10278,3442073613,3809871495,1672605966,1672609434,3468
11387,3459163055,3773768643,1672548602,1672551346,2744
10267,3932919664,3811351746,1672642988,1672643180,192
10634,3360309868,3776304080,1672664938,1672665765,827
10806,3687445224,3791716170,1672622037,1672624589,2552
10108,3812880543,3224040894,1672645741,1672646247,506
10980,3793920312,3516497645,1672558330,1672558555,225
10801,3793232021,3500974385,1672533534,1672537012,3478
10369,3201419050,3900793652,1672546866,1672547236,370
10103,3911431642,3757378286,1672695728,1672697220,1492
10973,3733123020,3801501384,1672568610,1672571623,3013
10647,3222364320,3509445318,1672630925,1672633230,2305
10819,3858429342,3701512498,1672562899,1672566450,3551
11449,3201502111,3780224882,1672649655,1672651521,1866
10072,3500415589,3509274030,1672683092,1672685322,2230
10694,3898965585,3770391782,1672569460,1672572016,2556
11471,3513508737,3517426473,1672575176,1672576346,1170
11323,3660702754,3703697059,1672654785,1672657176,2391
11469,3779169946,3772169046,1672693878,1672696985,3107
11599,3711518637,3243056734,1672548712,1672549926,1214
10639,3777041132,3471996194,1672640858,1672643867,3009
11105,3916924978,3512495325,1672622571,1672625353,2782
10701,3713969196,3338115824,1672679851,1672679937,86
11503,3403257752,3814378625,1672662706,1672665516,2810
11785,3773770134,3818570577,1672668256,1672668384,128
10321,3511245705,3511729562,1672570132,1672572219,2087
10669,3755570137,3361952532,1672682249,1672685212,2963
11050,3533131937,3514560138,1672695906,1672698014,2108
10572,3312733562,3493598658,1672617553,1672620494,2941
11778,3660163550,3534604516,1672631997,1672632468,471
11417,3395082458,3517810375,1672626073,1672626201,128
10754,3505183641,3714640103,1672703139,1672704759,1620
10092,3735679000,3515838621,1672580784,1672583881,3097
10387,3450621820,3226913558,1672608425,1672611562,3137
10230,3354968884,3511004622,1672543604,1672546103,2499
9813,3801501384,3904184638,1672667753,1672669054,1301
10925,3923524564,3516486526,1672685380,1672687991,2611
10058,3207497598,3512826895,1672625701,1672627094,1393
10503,3463564410,3701893620,1672622486,1672625760,3274
11768,3778924002,3664523809,1672573244,1672576221,2977
11131,3240443426,3423353911,1672657600,1672657695,95
10578,3701978422,3739820448,1672534374,1672536993,2619
10344,3713566527,3778195766,1672589652,1672591517,1865
11201,3223796145,3757446082,1672531676,1672533760,2084
11010,3393001196,3519947298,1672624836,1672626941,2105
10690,3792597493,3778195766,1672645273,1672646999,1726
11574,3437023385,3791584994,1672626689,1672629519,2830
11754,3399726243,3245121919,1672610591,1672611606,1015
11473,3373851012,3512395783,1672597488,1672598038,550
11683,3435652260,3687183789,1672568546,1672571142,2596
9876,3791522832,3201957157,1672682827,1672683099,272
11444,3421956717,3509073025,1672618758,1672619097,339
9808,3466620548,3772909073,1672671339,1672674805,3466
11364,3936871734,3910020031,1672682364,1672685441,3077
10590,3471507117,3682266017,1672574258,1672577523,3265
11438,3500178849,3779561601,1672620890,1672621323,433
11637,3760382349,3756784813,1672539137,1672541137,2000
11493,3406169279,3276230295,1672535318,1672537597,2279
11673,3294949958,3815700240,1672690869,1672692314,1445
10824,3483078667,3616371564,1672618101,1672621625,3524
10599,3313392810,3394959062,1672539960,1672540025,65
9995,3893527651,3897186782,1672596792,1672598776,1984
10150,3791194984,3854229296,1672675922,1672677870,1948
10980,3512726649,3710861700,1672580454,1672581566,1112
9916,3756272704,3408111327,1672630012,1672633162,3150
9865,3388774559,3714281210,1672693036,1672695497,2461
10352,3927699036,3777041132,1672661011,1672664375,3364
11039,3515379622,3369482983,1672610312,1672613140,2828
11164,3912915644,3850735936,1672540589,1672541312,723
11401,3220123678,3701512498,1672681678,1672684398,2720
10618,3533566754,3491239350,1672591874,1672594920,3046
10316,3793860209,3293579860,1672552320,1672555574,3254
9955,3239401337,3273758330,1672671886,1672672397,511
11439,3491948594,3501657158,1672682744,1672684279,1535
10850,3776867553,3903879740,1672599997,1672600179,182
10264,3473562779,3823600319,1672672141,1672675285,3144
10995,3369270860,3792277399,1672696544,1672697450,906
9796,3306037126,3770012744,1672534118,1672536602,2484
11239,3779130507,3236948071,1672683768,1672685288,1520
10983,3804707712,3415840750,1672593304,1672594001,697
10004,3515607283,3512251592,1672549570,1672549975,405
10972,3534459983,3343193067,1672573203,1672574988,1785
10064,3205161801,3514361485,1672634739,1672635487,748
11240,3908862092,3738132114,1672673309,1672676423,3114
9982,3770180844,3978643889,1672545328,1672548265,2937
11777,3282053097,3377446376,1672673954,1672675964,2010
11517,3772055279,3500726347,1672687528,1672690438,2910
10314,3711889178,3710783759,1672596851,1672599811,2960
10718,3756647451,3534531039,1672581920,1672582537,617
10783,3778738044,3501174621,1672700902,1672702050,1148
11182,3239279744,3703104365,1672561603,1672563883,2280
9797,3792719263,3773895671,1672617887,1672619971,2084
11417,3915962248,3905571273,1672644959,1672646929,1970
10694,3341129425,3669418238,1672559235,1672560848,1613
10988,3779382417,3517551721,1672559673,1672560660,987
11596,3772019557,3783043770,1672594879,1672597362,2483
10318,3779468781,3505314920,1672669803,1672671308,1505
10930,3505140123,3852310652,1672633976,1672636697,2721
10992,3276230295,3911431642,1672640047,1672641412,1365
11695,3533974355,3500589560,1672654728,1672656289,1561
10363,3776710698,3505032644,1672591523,1672591930,407
11644,3517021928,3228056289,1672637547,1672639544,1997
11482,3221290808,3760420315,1672625694,1672626105,411
10923,3453164933,3783067048,1672641125,1672643003,1878
11338,3533816813,3685083275,1672571800,1672574387,2587
10647,3424988692,3393128259,1672695345,1672698403,3058
11112,3287753579,3430310785,1672556204,1672558296,2092
10572,3919258737,3777641081,1672566943,1672568136,1193
11665,3897107253,3491527603,1672608192,1672611153,2961
11042,3621591266,3687445224,1672604005,1672606838,2833
11077,3685877449,3311924005,1672571447,1672572892,1445
11767,3850005949,3770544738,1672567124,1672567373,249
11086,3780612543,3780500764,1672689938,1672691940,2002
11015,3400903513,3405435885,1672589007,1672589653,646
10150,3792173463,3519162582,1672535502,1672535933,431
10874,3770457058,3450511428,1672646753,1672647734,981
10276,3203954795,3714116241,1672565804,1672567411,1607
10668,3791796190,3439283360,1672649213,1672651227,2014
11377,3701041860,3461743188,1672678406,1672681170,2764
11100,3778100960,3436018575,1672561864,1672565239,3375
11186,3776304080,3516019206,1672578333,1672578887,554
10740,3703725221,3311515179,1672663467,1672666630,3163
9947,3519015940,3501550490,1672598225,1672599069,844
11414,3509370016,3500640854,1672539300,1672541325,2025
11329,3824259677,3853188285,1672624864,1672625170,306
11458,3793902476,3779382417,1672560426,1672561868,1442
9898,3409514897,3534537581,1672580852,1672584048,3196
10711,3605591994,3714074120,1672688870,1672691434,2564
10361,3227206772,3281970147,1672667144,1672669710,2566
11137,3514638555,3757592622,1672593781,1672594698,917
10306,3896123242,3711040761,1672608415,1672609479,1064
9824,3319436533,3505491969,1672630035,1672633048,3013
10196,3660702754,3497732613,1672582689,1672583089,400
11148,3394394262,3501612813,1672534073,1672536634,2561
10829,3770276815,3933469838,1672565153,1672566954,1801
10369,3882580580,3511382748,1672688382,1672691252,2870
11545,3500444748,3733796228,1672588935,1672591520,2585
11638,3510484107,3711287751,1672565122,1672567131,2009
10077,3225356349,3458271585,1672621516,1672622396,880
10070,3773085258,3792008302,1672685243,1672687769,2526
10819,3755374000,3387870683,1672542861,1672543548,687
9861,3557653200,3509360869,1672593197,1672595807,2610
11628,3313579674,3756363182,1672546851,1672546914,63
9902,3534775239,3908331271,1672640109,1672643222,3113
9795,3519553933,3435715962,1672565902,1672568380,2478
10936,3855629383,3510869438,1672600749,1672601652,903
11539,3510987684,3715101177,1672657828,1672658996,1168
11732,3228477490,3342027511,1672701144,1672702051,907
10012,3505496725,3684199077,1672551574,1672554088,2514
10230,3293553295,3716179251,1672669436,1672671095,1659
10297,3505756991,3514515499,1672667264,1672668157,893
10624,3514980025,3493679801,1672674092,1672675237,1145
11074,3512154443,3555763674,1672573058,1672573137,79
10071,3909632424,3445355677,1672653293,1672656351,3058
10003,3710173412,3534081527,1672579671,1672581794,2123
10852,3715441777,3378172464,1672692578,1672695306,2728
11628,3760737203,3466620548,1672603838,1672604448,610
10107,3500093945,3738526914,1672564980,1672566671,1691
10017,3603452936,3403738461,1672675411,1672678562,3151
11340,3738103378,3512492332,1672543624,1672544672,1048
11494,3711367577,3774035405,1672641473,1672643390,1917
10347,3512744657,3207748225,1672627756,1672629571,1815
10815,3715126587,3770018912,1672579777,1672582611,2834
11561,3533419409,3757378286,1672610913,1672610997,84
10727,3770564547,3710046567,1672680097,1672682950,2853
10090,3638018906,3516257130,1672538647,1672541256,2609
11412,3812516461,3227339675,1672581403,1672582129,726
10762,3511963020,3517448452,1672532136,1672533754,1618
10595,3393543588,3757030923,1672669075,1672670978,1903
11424,3291936679,3813853446,1672615392,1672616897,1505
11117,3783313202,3855674398,1672672058,1672673011,953
10037,3793274957,3850181934,1672686296,1672688181,1885
10001,3487395357,3853275529,1672664592,1672666973,2381
10652,3710173412,3911821258,1672623905,1672624908,1003
10575,3293540333,3517151644,1672605263,1672608098,2835
10269,3774325486,3710585241,1672610843,1672611228,385
10197,3909067335,3474879231,1672644638,1672644964,326
10462,3464622743,3881012415,1672549075,1672550802,1727
10491,3441683673,3714424237,1672565436,1672567469,2033
9997,3315432466,3880637958,1672543644,1672545590,1946
11230,3512555384,3885422379,1672532480,1672535634,3154
11256,3755209597,3509503263,1672532525,1672534106,1581
9915,3388937390,3834456158,1672597499,1672597896,397
10950,3714424237,3220123678,1672606187,1672608993,2806
11086,3371759126,3493679801,1672699171,1672701469,2298
10318,3306491253,3733870816,1672625057,1672626973,1916
11129,3403150349,3514747345,1672591382,1672592841,1459
11709,3513486828,3500974385,1672688584,1672691571,2987
10331,3776968640,3423800775,1672553546,1672557132,3586
11589,3355903597,3505825767,1672601695,1672602966,1271
9929,3755361692,3226913558,1672642365,1672642745,380
11181,3793996996,3902300755,1672607602,1672609857,2255
10587,3780308809,3509663119,1672585563,1672586105,542
11769,3971280379,3809194824,1672539755,1672541487,1732
11702,3737738751,3732846295,1672563650,1672565659,2009
10970,3780956975,3396453219,1672612058,1672612981,923
10254,3473706746,3711854614,1672598355,1672601937,3582
11648,3311305760,3773534165,1672674316,1672674765,449
11567,3205161801,3380357490,1672617782,1672621361,3579
10772,3412605548,3703438617,1672630829,1672632826,1997
11162,3505007498,3778695895,1672587961,1672588727,766
11359,3505901826,3409078869,1672547179,1672548458,1279
9870,3755394177,3474074188,1672549858,1672551783,1925
9901,3515096959,3716209499,1672570533,1672570790,257
10543,3249380931,3437023385,1672585419,1672588744,3325
10350,3516340010,3779212271,1672675636,1672676664,1028
10542,3780168985,3279726491,1672660645,1672664196,3551
10428,3910049345,3757060033,1672540471,1672541460,989
11779,3773738817,3467232654,1672663652,1672664243,591
11500,3756759239,3636877469,1672551356,1672553526,2170
11649,3461931154,3519162582,1672573709,1672577264,3555
10251,3774483862,3668720465,1672618120,1672621455,3335
10613,3716740576,3887030182,1672671069,1672672060,991
9933,3616403486,3339649817,1672632113,1672633410,1297
11209,3500120676,3713069234,1672664965,1672666927,1962
11572,3710082615,3716944983,1672593253,1672593462,209
11714,3685522474,3206217657,1672552029,1672554298,2269
10657,3311479294,3402020492,1672684125,1672684249,124
10093,3480418192,3757378286,1672597356,1672600029,2673
11542,3421674406,3501759031,1672673846,1672674123,277
11712,3501225887,3601063076,1672537012,1672539751,2739
11676,3515706117,3302348002,1672591047,1672592339,1292
11427,3533036499,3501126057,1672601188,1672602468,1280
11244,3517499844,3247845642,1672603524,1672604947,1423
10545,3308744016,3513996288,1672538924,1672541397,2473
11548,3277634944,3838039092,1672677832,1672681151,3319
10775,3783172505,3605905645,1672621150,1672622426,1276
9844,3791409441,3311142523,1672648845,1672651231,2386
11291,3756119976,3757549235,1672631105,1672633311,2206
11334,3511908639,3422548081,1672583281,1672585131,1850
10087,3278779955,3483701493,1672548490,1672551526,3036
11070,3823600319,3393001196,1672541198,1672544235,3037
11614,3339649817,3625952981,1672633578,1672635520,1942
11419,3757446082,3510335069,1672610729,1672613297,2568
10965,3757732853,3906693728,1672534014,1672536318,2304
10640,3888057649,3501205057,1672566960,1672568452,1492
9913,3272838634,3774145748,1672696896,1672700466,3570
10649,3397527886,3291446384,1672570035,1672572969,2934
10091,3711404205,3509370633,1672582827,1672583030,203
10778,3319061210,3341129425,1672694034,1672695049,1015
10429,3374348845,3779503296,1672557301,1672558172,871
10919,3513840186,3333355914,1672634394,1672637922,3528
10979,3220660616,3714250543,1672691797,1672692988,1191
9834,3710397477,3510939082,1672604734,1672608008,3274
10558,3701841013,3714179543,1672574671,1672577064,2393
11147,3476416072,3778838936,1672672281,1672675063,2782
10184,3509614126,3373802545,1672634499,1672637957,3458
11095,3330238204,3837888196,1672655634,1672655785,151
10964,3682241594,3505826673,1672570962,1672572182,1220
11679,3825082811,3776811587,1672653621,1672654443,822
11564,3776732532,3713219299,1672683741,1672685695,1954
10814,3770925016,3701218904,1672649057,1672649374,317
11270,3330188769,3772802020,1672663019,1672664859,1840
11743,3777992576,3307791650,1672553637,1672555021,1384
10814,3757623259,3318590083,1672553016,1672556588,3572
11392,3278629965,3501407804,1672702613,1672704101,1488
10395,3517902505,3703697059,1672690354,1672692241,1887
11270,3393001196,3760481622,1672644744,1672647741,2997
10535,3227206772,3388915945,1672666236,1672669037,2801
10175,3520926977,3230612965,1672533100,1672533776,676
11551,3663353552,3819400315,1672668111,1672669471,1360
10843,3703502114,3772751765,1672664595,1672667656,3061
11297,3505032773,3471996194,1672620576,1672622656,2080
10108,3373851012,3311410533,1672597603,1672599450,1847
10761,3284829602,3374147279,1672615175,1672618740,3565
9850,3518408734,3444680955,1672534345,1672537471,3126
10338,3371759126,3887069914,1672668480,1672672040,3560
10393,3472718723,3688870751,1672538729,1672539559,830
10088,3857590978,3534362749,1672536723,1672537855,1132
10462,3472272792,3520344592,1672698200,1672700456,2256
10826,3516319492,3886837151,1672663577,1672665931,2354
11575,3817376705,3290060215,1672593184,1672594759,1575
10650,3512826895,3311472321,1672583201,1672586287,3086
11405,3686885442,3241593146,1672634023,1672634288,265
11609,3307521389,3773202954,1672610807,1672613824,3017
10658,3686853863,3285587972,1672575140,1672578241,3101
10066,3756066702,3755238321,1672579650,1672580993,1343
10435,3715923089,3334824744,1672689986,1672690977,991
11521,3755374000,3777706200,1672612985,1672615115,2130
11264,3777387533,3931028233,1672658348,1672658896,548
11257,3368951504,3330799389,1672582794,1672584070,1276
9837,3711770853,3501977123,1672578662,1672582197,3535
11783,3518511124,3501174621,1672560547,1672560888,341
11752,3206262649,3501977123,1672618742,1672619703,961
10941,3713373455,3516020922,1672536392,1672536477,85
11777,3406937294,3514389188,1672639485,1672639778,293
10439,3367242388,3827981800,1672678768,1672679248,480
11513,3281148858,3827981800,1672581293,1672584666,3373
11192,3834456158,3500120676,1672690047,1672692257,2210
10304,3378729459,3427741923,1672696529,1672697277,748
10141,3495446254,3426468199,1672537922,1672540776,2854
10269,3629248353,3612042508,1672547190,1672549077,1887
10257,3494680853,3936486724,1672546907,1672548709,1802
10597,3442403264,3776187150,1672591305,1672593841,2536
9954,3715700639,3245882008,1672618176,1672620805,2629
10658,3511867383,3933872044,1672702135,1672702364,229
10656,3501927452,3613936929,1672664538,1672666454,1916
10060,3275751794,3510189563,1672631207,1672633404,2197
10118,3715790104,3974264211,1672621621,1672624138,2517
11419,3912811715,3206241691,1672698469,1672698950,481
10131,3226761201,3559125467,1672566977,1672568809,1832
10693,3773017746,3514352989,1672586965,1672587889,924
11382,3822368676,3778909412,1672578212,1672579214,1002
11002,3714902042,3533077580,1672577689,1672579125,1436
11247,3791863922,3807486812,1672696030,1672698278,2248
11689,3777564559,3514508773,1672654210,1672656948,2738
10471,3664719070,3533037906,1672585316,1672588332,3016
10962,3770574826,3344710271,1672630405,1672632048,1643
11361,3501208658,3779951373,1672562885,1672564323,1438
10075,3287683210,3246296769,1672629061,1672629162,101
10407,3390438262,3757089924,1672575402,1672576594,1192
10226,3310702648,3514005973,1672636974,1672638135,1161
10731,3303772923,3517530943,1672601210,1672603200,1990
9995,3511218261,3701449715,1672668175,1672669556,1381
10562,3512802259,3604569804,1672668932,1672671021,2089
10901,3687024828,3519463038,1672534116,1672535277,1161
11284,3757607649,3906075386,1672632252,1672634017,1765
11390,3337715675,3509355477,1672660614,1672661368,754
10452,3776447604,3791224239,1672693319,1672694653,1334
11405,3793920312,3793814153,1672649059,1672650492,1433
10416,3755779925,3605101443,1672533529,1672536921,3392
11201,3201419050,3311200541,1672594349,1672597185,2836
10275,3445077330,3406238754,1672563799,1672566908,3109
10951,3703614781,3501550490,1672653796,1672655354,1558
11344,3972653129,3714424237,1672636969,1672639783,2814
10532,3772569860,3491104534,1672666600,1672668745,2145
10614,3512306195,3701519251,1672661549,1672662534,985
9902,3505449070,3774236212,1672633286,1672635799,2513
11246,3807111856,3715196780,1672668946,1672670002,1056
9824,3505571800,3520506192,1672532579,1672535692,3113
10258,3773738817,3774436159,1672694137,1672697149,3012
11129,3476431618,3514361485,1672643285,1672644065,780
11579,3830962592,3660163550,1672614490,1672616343,1853
10054,3614944981,3760710525,1672549441,1672551938,2497
10767,3207586072,3374348845,1672654877,1672656193,1316
11204,3371132167,3773579644,1672608431,1672609104,673
11237,3716423829,3440991826,1672562501,1672565517,3016
10025,3519034304,3511750695,1672702607,1672703181,574
11402,3492350318,3225371682,1672574757,1672574918,161
11330,3423782420,3419829238,1672602841,1672605055,2214
11333,3773636983,3512965991,1672578935,1672580822,1887
10899,3463564410,3400903513,1672563119,1672566156,3037
11090,3417431173,3811419378,1672621927,1672625250,3323
10769,3716468783,3793699467,1672689735,1672691302,1567
10682,3463883997,3778402454,1672646116,1672647763,1647
9806,3515939841,3881579907,1672582195,1672585375,3180
10362,3520182275,3534081527,1672655352,1672655662,310
11350,3516588277,3908862092,1672680047,1672681982,1935
11102,3519102732,3780482864,1672692654,1672695399,2745
9874,3511864772,3778927933,1672671189,1672672216,1027
9878,3792337863,3801501384,1672591265,1672594277,3012
10886,3972196462,3287403291,1672548228,1672550179,1951
11488,3491758029,3857909328,1672595053,1672596138,1085
11038,3515802579,3713141087,1672582332,1672582652,320
10193,3505190512,3779382417,1672665733,1672667792,2059
9912,3420881591,3287683210,1672557196,1672558024,828
11172,3476431618,3559754304,1672536254,1672539393,3139
10102,3203172170,3316406470,1672659728,1672660366,638
9823,3534562354,3510278533,1672670629,1672672904,2275
11373,3206926634,3806471413,1672661818,1672663852,2034
9829,3828568868,3368079099,1672638002,1672639409,1407
9838,3716976932,3780423516,1672692610,1672696093,3483
10932,3500776597,3773770134,1672583408,1672583719,311
11234,3774921252,3711029952,1672701006,1672702126,1120
9982,3519465545,3779468781,1672632174,1672635391,3217
10458,3760749218,3439662051,1672665822,1672666849,1027
11189,3898592058,3757513651,1672615075,1672617441,2366
10982,3772695548,3780308809,1672610725,1672611944,1219
10305,3737571883,3517144269,1672589538,1672591214,1676
10420,3360309868,3505500523,1672532223,1672533279,1056
10022,3505593034,3500415589,1672622955,1672623310,355
10831,3637522163,3474350534,1672598402,1672600261,1859
10917,3854390432,3505351253,1672631351,1672632253,902
10937,3703742071,3683047199,1672700162,1672702440,2278
11041,3501244753,3780740477,1672664625,1672665214,589
11092,3397330170,3519015940,1672693121,1672696265,3144
10127,3779282072,3517632796,1672556424,1672558310,1886
10433,3475560058,3518995270,1672687758,1672690485,2727
10549,3660163550,3701385831,1672553334,1672555870,2536
9913,3446066492,3311037445,1672656555,1672657564,1009
10832,3776166086,3554317844,1672668590,1672671379,2789
11274,3308149799,3792597493,1672596446,1672596969,523
10027,3756781024,3440582836,1672617793,1672618868,1075
10759,3783947742,3701311947,1672697657,1672699380,1723
9861,3285201542,3760966645,1672581843,1672583005,1162
11628,3757924067,3772262649,1672629702,1672631470,1768
10066,3777909822,3903879740,1672536210,1672537657,1447
10869,3912915644,3476308535,1672682306,1672683947,1641
10959,3669427589,3783095041,1672556021,1672558325,2304
11643,3686860179,3755736024,1672535315,1672537400,2085
11117,3777060250,3505560793,1672612286,1672615301,3015
10969,3713224038,3757660578,1672609167,1672612739,3572
10834,3760274119,3429333292,1672535241,1672536483,1242
9994,3900793652,3770424941,1672641944,1672643338,1394
10199,3701218904,3668154066,1672635858,1672636604,746
10992,3894495222,3361635547,1672635677,1672635956,279
10500,3615742989,3518408734,1672662117,1672665586,3469
11089,3397783490,3420854927,1672549344,1672551240,1896
9916,3405435885,3334482021,1672548682,1672551713,3031
10957,3484490325,3792633495,1672630668,1672633768,3100
10731,3778370462,3510919509,1672671363,1672674477,3114
10951,3441944896,3737738751,1672567615,1672570787,3172
11041,3403177609,3534122907,1672686594,1672687940,1346
10033,3779689733,3555954355,1672699629,1672700047,418
10638,3925792265,3663353552,1672619309,1672619809,500
9868,3904184638,3472018395,1672619344,1672621003,1659
10001,3515970536,3896622009,1672654543,1672656472,1929
10960,3510894809,3774029494,1672667405,1672668499,1094
9881,3501992314,3774506868,1672685937,1672686230,293
10814,3389367628,3402580733,1672543629,1672546933,3304
10375,3519108639,3436018575,1672636395,1672639176,2781
11031,3436099135,3440671139,1672633876,1672637114,3238
11051,3273771395,3778731000,1672548923,1672549025,102
10605,3779415433,3760656396,1672589379,1672592133,2754
10604,3311529105,3777041132,1672582498,1672584920,2422
11197,3285587972,3856975355,1672648684,1672651150,2466
10096,3514361485,3279731391,1672537690,1672539598,1908
10494,3804779247,3497138014,1672673924,1672677371,3447
11620,3756763585,3513740840,1672591623,1672593755,2132
11341,3461137945,3686644062,1672553356,1672556944,3588
10046,3791206902,3428788958,1672585628,1672588064,2436
9885,3426207439,3760322661,1672592458,1672593885,1427
10874,3773556853,3302416197,1672667322,1672667670,348
10413,3311414429,3278805844,1672538700,1672541074,2374
10181,3780352400,3710223875,1672661990,1672664348,2358
11242,3669427589,3909457959,1672668533,1672671857,3324
11671,3884001167,3533419409,1672542411,1672543808,1397
11225,3513586642,3500405175,1672589427,1672591746,2319
11429,3715712376,3445172440,1672703113,1672703895,782
10965,3520625600,3500145103,1672688349,1672688717,368
10662,3778927933,3776279305,1672538031,1672539488,1457
10520,3755170743,3927805949,1672639157,1672640814,1657
11764,3500630465,3339478490,1672559812,1672560150,338
10084,3341738186,3519951586,1672554933,1672556171,1238
11532,3331228758,3387971464,1672624641,1672625527,886
10101,3760997159,3760382349,1672651191,1672654179,2988
11629,3499998389,3818461836,1672683341,1672685726,2385
11528,3273537848,3409514897,1672584548,1672586018,1470
10094,3733123020,3534531061,1672679051,1672681935,2884
10688,3739618347,3343193067,1672687251,1672690377,3126
11206,3938059867,3484483775,1672566972,1672567821,849
10098,3341432459,3319585148,1672619869,1672620638,769
11635,3476416072,3462645981,1672562913,1672563895,982
10956,3772055279,3514611187,1672648920,1672649641,721
10688,3755849241,3904846341,1672637401,1672639510,2109
10773,3467756698,3620105539,1672567733,1672570108,2375
11191,3202787155,3857590978,1672563855,1672564225,370
10569,3971282455,3915652382,1672689760,1672692107,2347
11697,3382308738,3401215739,1672551533,1672554077,2544
10760,3512306195,3392573386,1672674655,1672678158,3503
10688,3713726267,3925208102,1672674926,1672676737,1811
11542,3639081201,3495446254,1672680192,1672682300,2108
10523,3703938162,3774205060,1672570957,1672572263,1306
10308,3350169064,3935256825,1672560923,1672562770,1847
10114,3491527603,3807111856,1672624164,1672624824,660
11049,3555378248,3353335252,1672662664,1672664007,1343
9844,3779505358,3973134902,1672639107,1672640405,1298
10272,3711404205,3715114417,1672538983,1672540158,1175
10354,3703737650,3817376705,1672564697,1672568016,3319
10907,3432838598,3774316305,1672535732,1672537780,2048
11204,3343698137,3770924034,1672580947,1672582883,1936
11260,3501253130,3818461836,1672602364,1672603531,1167
10649,3937299996,3908862092,1672564630,1672566320,1690
10582,3512477276,3779604279,1672563485,1672566651,3166
11614,3731644240,3415840750,1672650066,1672652672,2606
10679,3447078933,3514455363,1672602310,1672602798,488
11015,3819400315,3519831322,1672627003,1672630091,3088
11257,3558349840,3354405535,1672650850,1672653065,2215
10459,3915460293,3446233783,1672586052,1672587972,1920
11624,3511218261,3791072829,1672649016,1672650612,1596
10217,3534068874,3513250976,1672611907,1672614476,2569
11633,3735497729,3732128078,1672648582,1672651337,2755
10335,3902775449,3916463490,1672698727,1672699423,696
10782,3403395712,3519341916,1672594115,1672594487,372
10816,3884180202,3516319492,1672574822,1672575018,196
11360,3931767736,3446537819,1672687589,1672688658,1069
10124,3777074709,3509701363,1672581314,1672582976,1662
11786,3500726347,3235578121,1672600070,1672601239,1169
10172,3505538902,3813085701,1672703054,1672703901,847
11233,3757728121,3791796190,1672574981,1672577449,2468
9863,3855977674,3757201538,1672632704,1672635466,2762
11615,3393128259,3774326754,1672703644,1672704404,760
10459,3335055096,3467415939,1672651442,1672654332,2890
11030,3512306195,3755790149,1672694241,1672697191,2950
11193,3509018337,3701529552,1672641218,1672643448,2230
11439,3533131937,3520515739,1672671063,1672671982,919
10557,3407403080,3730290851,1672620685,1672621123,438
11248,3514353133,3756119976,1672570431,1672573592,3161
10823,3350631472,3533201269,1672592777,1672593280,503
11597,3622458047,3779169946,1672596006,1672599330,3324
10253,3367242388,3342027511,1672596017,1672597515,1498
10587,3772114731,3714902042,1672670941,1672671473,532
10131,3978417055,3757050615,1672671199,1672672377,1178
11662,3833520635,3800434325,1672692998,1672696193,3195
11629,3394986304,3373802545,1672553391,1672554874,1483
10336,3533440736,3823600319,1672546255,1672548762,2507
10444,3497904539,3505155858,1672595947,1672596959,1012
10567,3884001167,3713336088,1672662733,1672665070,2337
10904,3935569749,3505482210,1672606360,1672607571,1211
10431,3636927297,3304672737,1672614716,1672616961,2245
10767,3516319492,3398075553,1672701546,1672702333,787
10818,3734233216,3416474842,1672627559,1672629746,2187
9841,3243305367,3621960662,1672681672,1672682573,901
9833,3934611532,3818461836,1672572078,1672573531,1453
11609,3792162098,3501407804,1672651092,1672653791,2699
10233,3474074188,3884369346,1672691058,1672693915,2857
10527,3793442891,3703419800,1672674141,1672675273,1132
11147,3246296769,3235198316,1672548640,1672551968,3328
9889,3534499421,3618024815,1672587643,1672590392,2749
11589,3509663119,3619494735,1672644853,1672645080,227
10571,3516969689,3233965781,1672564459,1672565657,1198
10730,3622152515,3235578121,1672698002,1672699153,1151
11111,3302416197,3485468650,1672586581,1672589155,2574
10288,3311037445,3701770921,1672578566,1672580293,1727
11278,3342426430,3481700413,1672676563,1672679332,2769
11162,3519948471,3661543201,1672543802,1672545856,2054
11506,3832312129,3755411110,1672571099,1672573525,2426
11633,3857909328,3314363575,1672657511,1672660950,3439
11669,3793332600,3278805844,1672674303,1672677097,2794
11252,3619676231,3559112196,1672684092,1672685717,1625
10288,3430032005,3442564712,1672535510,1672537840,2330
11378,3756157377,3371759126,1672571614,1672574498,2884
10379,3851737350,3510254698,1672688204,1672688280,76
10524,3735197034,3309415277,1672678347,1672678554,207
10898,3288791629,3703818358,1672552149,1672553009,860
10480,3346755179,3439662051,1672616582,1672616879,297
10499,3514638555,3837271330,1672665366,1672666010,644
9911,3638823001,3780287649,1672577792,1672578753,961
11224,3776561263,3455907179,1672689055,1672691084,2029
10456,3776791436,3273674596,1672561689,1672562091,402
11521,3345028045,3450164574,1672643810,1672646534,2724
11646,3534278019,3710185376,1672568408,1672569599,1191
9957,3559112196,3683047199,1672562995,1672563332,337
11464,3273771395,3773826624,1672639746,1672640182,436
10674,3890194669,3480108752,1672560695,1672561707,1012
10752,3715441777,3710060386,1672664592,1672666318,1726
10324,3757514745,3817478012,1672679121,1672679302,181
10545,3444646562,3792337863,1672573554,1672576728,3174
10572,3772296376,3511867383,1672639642,1672640010,368
10940,3293579860,3929923442,1672661030,1672662662,1632
11332,3517797610,3559619861,1672548170,1672550324,2154
9940,3779382417,3399726243,1672594418,1672596272,1854
9857,3533036499,3481365330,1672554837,1672558289,3452
11618,3388774559,3202740652,1672604705,1672605149,444
10329,3813853446,3779255367,1672691335,1672693813,2478
10640,3240683148,3780482864,1672620801,1672622273,1472
11647,3792682835,3668955834,1672583878,1672586683,2805
9803,3778695895,3511526885,1672649911,1672653459,3548
11001,3520763492,3669497617,1672571730,1672573135,1405
11192,3518209090,3777909822,1672617038,1672620100,3062
11051,3812516461,3791974273,1672582608,1672584941,2333
11133,3738526914,3350966326,1672586595,1672588756,2161
10933,3501137133,3760648750,1672692115,1672692198,83
10977,3516731917,3279851026,1672624873,1672627370,2497
11599,3374147279,3344778261,1672533848,1672534849,1001
11122,3246567963,3774304163,1672556975,1672557719,744
10420,3780749789,3853386575,1672636862,1672639990,3128
11179,3774273260,3519000878,1672567316,1672569527,2211
11775,3411213032,3807800457,1672691655,1672692782,1127
10796,3414841458,3534081527,1672604581,1672605839,1258
11541,3755394177,3757060033,1672591703,1672593121,1418
10993,3371759044,3220798451,1672609982,1672612853,2871
10375,3778605154,3517331746,1672660849,1672661530,681
10912,3760541837,3317190427,1672671210,1672673312,2102
11099,3512417724,3204473480,1672580016,1672581086,1070
10000,3517943697,3779454060,1672544943,1672546638,1695
10548,3807646028,3713159131,1672620874,1672623619,2745
11204,3355899481,3757944870,1672572758,1672573354,596
10861,3514329209,3713969196,1672537075,1672539459,2384
10702,3760710525,3480560014,1672580339,1672581710,1371
10389,3450511428,3924366353,1672617519,1672620783,3264
11207,3773432494,3713416756,1672598792,1672600994,2202
10863,3446233783,3512133625,1672652745,1672655877,3132
10633,3971289056,3519322066,1672555375,1672557814,2439
11271,3301765144,3509394912,1672591758,1672592550,792
11678,3501515425,3454343398,1672657089,1672658811,1722
11556,3732871856,3513215373,1672577763,1672579245,1482
10863,3713170867,3553008208,1672653230,1672655625,2395
10097,3780956975,3713996094,1672650966,1672653001,2035
9805,3463883997,3346755179,1672572860,1672575586,2726
10654,3495152069,3770424941,1672546334,1672549363,3029
11496,3668764192,3343767438,1672613832,1672616398,2566
10847,3472018395,3893629892,1672558694,1672559422,728
10009,3519297683,3559112196,1672551235,1672552677,1442
11337,3516904926,3208894215,1672681508,1672684681,3173
11584,3661359073,3938059867,1672609822,1672612696,2874
10159,3779975575,3516815069,1672538538,1672541956,3418
10290,3391612879,3306491253,1672685885,1672687014,1129
11297,3554236075,3701770921,1672701266,1672703723,2457
10792,3711040761,3770966950,1672657197,1672659367,2170
10338,3501370430,3701675183,1672598987,1672599532,545
10607,3971280379,3850181934,1672679741,1672682846,3105
10232,3500440602,3500590302,1672541705,1672544270,2565
10345,3247193800,3512395783,1672593400,1672594014,614
10818,3403870769,3471585513,1672585256,1672588841,3585
10864,3733411026,3974264211,1672674109,1672674891,782
10358,3555954355,3791617239,1672545057,1672547488,2431
10124,3638823001,3897003751,1672562250,1672563924,1674
10583,3518205307,3777041132,1672644504,1672646623,2119
10431,3791031227,3756717136,1672610972,1672614517,3545
10445,3501963428,3368079099,1672654029,1672656870,2841
10131,3517331746,3908862092,1672667576,1672668474,898
10935,3533986052,3814289471,1672666476,1672669195,2719
10840,3236254381,3519965717,1672673016,1672674109,1093
11614,3514747345,3517800171,1672558533,1672560799,2266
11372,3235470567,3755075988,1672692400,1672693718,1318
9927,3278629965,3202740652,1672585915,1672587187,1272
10662,3310702648,3287094447,1672676869,1672678784,1915
11442,3683514731,3924366353,1672702097,1672703330,1233
11642,3774326754,3315432466,1672669707,1672672834,3127
11748,3736987749,3776811587,1672697484,1672699679,2195
10221,3500589560,3287760230,1672685732,1672688831,3099
11495,3715566511,3291936679,1672597155,1672599979,2824
10654,3513140146,3888903181,1672656214,1672656629,415
10050,3534204885,3791542842,1672554707,1672556663,1956
11608,3369482983,3776187150,1672589315,1672589967,652
10759,3623113240,3478915403,1672640750,1672641370,620
11441,3935256825,3669283586,1672547518,1672547847,329
11736,3927504954,3772893815,1672703991,1672706845,2854
10979,3733730342,3311197635,1672682968,1672684858,1890
9823,3777499535,3772188086,1672562038,1672564745,2707
9916,3688768189,3714919471,1672558684,1672560806,2122
10019,3756168814,3772227820,1672656731,1672659923,3192
10647,3476958001,3441336851,1672586886,1672590464,3578
11205,3837888196,3730226545,1672623530,1672623618,88
9876,3479585868,3710585241,1672575915,1672577195,1280
10868,3636852764,3399173821,1672692755,1672693764,1009
11311,3500544306,3974264211,1672549229,1672549545,316
11616,3404375908,3205948776,1672689306,1672689604,298
10148,3792432763,3772845364,1672681858,1672684335,2477
10705,3686211958,3600978954,1672555957,1672557599,1642
11065,3509186338,3514926921,1672672942,1672673429,487
9984,3629869834,3783430498,1672645728,1672645903,175
10153,3773669001,3513215373,1672690934,1672691530,596
10410,3512726649,3756998113,1672537174,1672537332,158
11712,3854957153,3422314045,1672591123,1672592006,883
11217,3555954355,3473706746,1672604657,1672606972,2315
11358,3850005949,3276209319,1672542647,1672542723,76
10379,3387989658,3517380144,1672645023,1672645415,392
10816,3710173412,3421040626,1672620211,1672622197,1986
10487,3715441777,3533225084,1672541203,1672544180,2977
11537,3812277991,3516904926,1672664723,1672666140,1417
10430,3505685294,3826997668,1672582861,1672585447,2586
11208,3249380931,3779689733,1672700787,1672703414,2627
10418,3714074120,3774236212,1672560623,1672561911,1288
10080,3395565040,3793987483,1672690316,1672691537,1221
11653,3918126468,3713195480,1672629287,1672631247,1960
11712,3519322066,3534531039,1672548163,1672549030,867
11730,3687183789,3760801237,1672586012,1672589061,3049
10173,3910049345,3387971464,1672648093,1672651059,2966
10794,3501515425,3402774497,1672606740,1672607204,464
10922,3635599307,3517718901,1672626289,1672628129,1840
11642,3830599959,3793949077,1672614604,1672615715,1111
10272,3517960157,3703659324,1672656977,1672660306,3329
10102,3857590978,3441683673,1672637256,1672638640,1384
10432,3886879696,3893629892,1672573752,1672575183,1431
10156,3515230715,3317887374,1672657191,1672659737,2546
11216,3715106566,3223144610,1672580010,1672581361,1351
11684,3510919509,3661543201,1672690693,1672691082,389
10516,3755286041,3509274030,1672623628,1672625795,2167
11482,3343859998,3715790104,1672584182,1672587248,3066
10143,3501759031,3772683155,1672674051,1672674886,835
9840,3393376416,3792972270,1672667670,1672670765,3095
11345,3611533094,3407734098,1672645684,1672647904,2220
9887,3393955069,3716371766,1672582080,1672582564,484
10705,3780435349,3334482021,1672676164,1672679412,3248
11779,3755107521,3240683148,1672542152,1672542750,598
10590,3403177609,3519513219,1672699900,1672701208,1308
10082,3516777819,3711258452,1672626250,1672627630,1380
10903,3500456339,3228218081,1672688776,1672691048,2272
11057,3520189871,3413511621,1672627680,1672628181,501
10171,3770564547,3760346746,1672559041,1672560296,1255
10234,3511296895,3480259863,1672627665,1672629453,1788
10510,3419648004,3514361485,1672610315,1672612106,1791
9909,3735679000,3295710494,1672568150,1672568401,251
10855,3772786559,3756428507,1672584001,1672585787,1786
11015,3778731000,3240443426,1672698828,1672700627,1799
9880,3830291558,3739567072,1672659540,1672660670,1130
10998,3359880163,3369270860,1672633099,1672635993,2894
10757,3510178791,3511296895,1672558345,1672559901,1556
11201,3492728794,3783695231,1672656961,1672658026,1065
11738,3347760784,3854957153,1672601158,1672602307,1149
9844,3475845921,3773432494,1672588614,1672590961,2347
10999,3534506090,3276231633,1672592476,1672595787,3311
11776,3774325486,3407734098,1672680515,1672682788,2273
11495,3299052917,3978254945,1672612462,1672615842,3380
11301,3241682278,3682086200,1672638550,1672638703,153
10683,3616242727,3275057862,1672700845,1672704290,3445
11156,3500814753,3413511621,1672620028,1672623399,3371
9844,3783430498,3446810761,1672675982,1672676954,972
10793,3501225887,3711810268,1672551433,1672551622,189
10086,3733915784,3777263928,1672599216,1672602646,3430
10681,3512802259,3514776568,1672628566,1672631510,2944
11061,3826315540,3359929534,1672538195,1672541059,2864
10532,3330188769,3511615015,1672678644,1672679849,1205
10494,3904485393,3662495290,1672672924,1672673609,685
11200,3703277359,3505449070,1672694673,1672697077,2404
10024,3601214648,3776447604,1672606241,1672608152,1911
11768,3518164450,3414510793,1672694667,1672698061,3394
11275,3484483775,3472018395,1672585224,1672587831,2607
10106,3499343927,3755361692,1672655442,1672655594,152
11030,3715261950,3770275898,1672682692,1672686199,3507
11155,3809860102,3340723781,1672627374,1672630206,2832
11572,3559221089,3857909328,1672595488,1672595864,376
10408,3770019143,3805831563,1672561969,1672565383,3414
11691,3308965136,3359472956,1672593646,1672596323,2677
11692,3515284733,3311037445,1672652572,1672654596,2024
10763,3376487118,3713606829,1672675899,1672677043,1144
11270,3703614781,3517331746,1672585107,1672585825,718
11519,3772343750,3510218188,1672558250,1672559242,992
9843,3516472352,3534667712,1672703775,1672707007,3232
11092,3287821258,3701387745,1672651799,1672654112,2313
11420,3936486724,3884191432,1672622724,1672622825,101
10615,3352493805,3807800457,1672603795,1672604527,732
10134,3760749218,3519448648,1672582817,1672583935,1118
10327,3505032644,3772235668,1672654185,1672654387,202
11184,3349573092,3229615214,1672553905,1672556252,2347
9974,3238056215,3713416106,1672601911,1672603465,1554
11148,3511867383,3736987749,1672592683,1672595061,2378
10317,3287094447,3778370462,1672600891,1672602892,2001
11778,3890211161,3633622298,1672663431,1672666685,3254
9930,3512753567,3669140241,1672619676,1672621337,1661
11656,3501027795,3455907179,1672693755,1672695409,1654
10292,3288791629,3609644043,1672571296,1672573443,2147
10926,3336225953,3534362749,1672670268,1672670557,289
10346,3246567963,3773556853,1672674122,1672676112,1990
11532,3428303756,3419648004,1672687205,1672688600,1395
10823,3793719515,3737467358,1672611036,1672614489,3453
10147,3515507526,3713906305,1672671358,1672674538,3180
10819,3701449715,3375905193,1672683517,1672684668,1151
10159,3371759044,3514628916,1672612697,1672616032,3335
11010,3501554468,3406132280,1672552243,1672555142,2899
11629,3286862903,3512288503,1672592462,1672592577,115
11381,3713805968,3208519320,1672616125,1672617726,1601
11554,3716669659,3361789225,1672564401,1672567145,2744
10083,3760481622,3408982612,1672656917,1672658319,1402
10539,3285136057,3512826895,1672623832,1672624002,170
10196,3834643026,3772893815,1672701681,1672701775,94
11335,3474350534,3519886257,1672682435,1672683989,1554
11614,3534491112,3369810091,1672678166,1672679011,845
10122,3736056340,3792021895,1672555078,1672557273,2195
11292,3703415246,3444453261,1672607292,1672610784,3492
11752,3292663993,3899156705,1672565089,1672565881,792
10302,3519689906,3345954031,1672581514,1672583616,2102
10096,3893932944,3200372897,1672534474,1672536376,1902
10009,3703336988,3855629383,1672591407,1672592311,904
10290,3453464785,3970851830,1672634920,1672636335,1415
11187,3534988162,3793926338,1672700660,1672701404,744
10385,3301403047,3779689733,1672675393,1672677214,1821
11310,3511744756,3791825536,1672534471,1672534783,312
11281,3931028233,3703779674,1672683244,1672686132,2888
11569,3387706541,3838039092,1672674375,1672677210,2835
10898,3518931700,3780173788,1672601176,1672602254,1078
11306,3780074082,3689386663,1672630207,1672633773,3566
10671,3909220912,3793332600,1672690096,1672692811,2715
11388,3342056927,3909220912,1672639835,1672643341,3506
10472,3307997700,3834311054,1672563847,1672566570,2723
10424,3783730769,3514107131,1672578745,1672581532,2787
10522,3421040626,3915962248,1672611800,1672612192,392
11550,3783313202,3514297012,1672597134,1672598231,1097
10491,3514776568,3805831563,1672671835,1672673220,1385
10738,3500821475,3360525513,1672577171,1672579501,2330
10173,3715140418,3772882440,1672673156,1672675870,2714
11088,3792972270,3755924094,1672592328,1672594309,1981
10674,3239990061,3497562878,1672645154,1672647932,2778
9863,3505828210,3756685732,1672586942,1672589397,2455
10818,3773134128,3625952981,1672629834,1672631590,1756
10414,3511218261,3680278447,1672646586,1672650084,3498
10771,3450234157,3533628528,1672604651,1672606170,1519
11526,3478206139,3430296808,1672633867,1672636589,2722
11372,3837435907,3345954031,1672670865,1672673459,2594
10911,3303772923,3442073613,1672606334,1672608115,1781
10300,3515715968,3779604279,1672646915,1672650377,3462
10941,3480405740,3682241594,1672548893,1672550443,1550
10999,3477951091,3669497617,1672553225,1672554040,815
10626,3380357490,3701060732,1672659853,1672660880,1027
11025,3910049345,3779665641,1672595371,1672597601,2230
10652,3714688409,3357074700,1672606283,1672608910,2627
11321,3439532406,3820280594,1672681572,1672682866,1294
11306,3533960602,3713476192,1672687068,1672690017,2949
10249,3665603628,3454554552,1672618922,1672622274,3352
11395,3779689733,3500211484,1672692249,1672692598,349
10395,3710119555,3411355804,1672623580,1672626742,3162
10604,3482519872,3778713526,1672615691,1672616820,1129
10958,3511750695,3512495325,1672605505,1672608148,2643
11016,3231227362,3368176107,1672624991,1672628179,3188
11603,3701448521,3238796398,1672559457,1672560360,903
10670,3608214600,3780648744,1672674317,1672677700,3383
10810,3202787155,3368339963,1672647062,1672649760,2698
10761,3287821258,3703896751,1672702751,1672703586,835
10506,3780500764,3760267158,1672693507,1672696909,3402
9881,3505769529,3792987243,1672629022,1672630669,1647
11454,3663505156,3780500764,1672653192,1672653778,586
10012,3430296808,3778909412,1672575828,1672579360,3532
11019,3922786716,3512288503,1672637835,1672639702,1867
10849,3501205057,3937854073,1672620272,1672623214,2942
11659,3774682234,3439045964,1672606559,1672608010,1451
11544,3355880028,3452982957,1672540432,1672543910,3478
9836,3776468503,3509208005,1672593800,1672596729,2929
10643,3971051020,3511069449,1672702338,1672702830,492
9957,3350631472,3555378248,1672647626,1672649646,2020
10242,3791245127,3915035136,1672667277,1672669863,2586
9858,3307216611,3602570831,1672588898,1672590454,1556
10810,3756113624,3511615015,1672569358,1672570666,1308
10099,3735197034,3715737742,1672578402,1672581690,3288
11419,3510987684,3890638402,1672630627,1672631107,480
11028,3417223898,3908177413,1672686685,1672688830,2145
11644,3309455369,3890813040,1672546275,1672548993,2718
10964,3760749218,3770497768,1672602661,1672603125,464
9900,3419762444,3207497598,1672557545,1672558502,957
11674,3343193067,3899205452,1672558595,1672562168,3573
10757,3494680853,3244495586,1672624698,1672627162,2464
9838,3534604516,3512477276,1672664153,1672667410,3257
9827,3514306458,3373677765,1672555546,1672558192,2646
10676,3685645561,3208962614,1672608779,1672611755,2976
11418,3534328311,3429047448,1672609149,1672612638,3489
10389,3760901975,3399734748,1672558975,1672560432,1457
11571,3533154906,3343698137,1672652480,1672654339,1859
10515,3435159896,3512417724,1672672669,1672673931,1262
10662,3355903597,3668855144,1672582014,1672585034,3020
10788,3492056330,3890194669,1672625278,1672628237,2959
10118,3226761201,3780576351,1672559166,1672560058,892
9850,3416474842,3520012007,1672689222,1672691494,2272
11435,3716209499,3227206772,1672615014,1672618528,3514
11495,3452090950,3296970170,1672624413,1672626945,2532
9988,3510143850,3683514731,1672686202,1672689375,3173
10303,3430823498,3423147369,1672650737,1672651204,467
10303,3418791124,3778273230,1672548863,1672550664,1801
10914,3703572036,3208519320,1672600382,1672603228,2846
10106,3518882056,3394959062,1672673763,1672676512,2749
10320,3779130507,3421674406,1672641820,1672645344,3524
11089,3245642576,3494680853,1672545180,1672546486,1306
10227,3663505156,3817478012,1672700813,1672702002,1189
10326,3291617477,3701971784,1672549350,1672550793,1443
11745,3272096922,3518882056,1672540439,1672541263,824
10334,3896123242,3205948776,1672669095,1672669345,250
11001,3792785261,3851737350,1672597654,1672598139,485
10953,3511415786,3390368796,1672645261,1672646306,1045
11733,3533728729,3276231633,1672611719,1672612506,787
11757,3287821258,3757311529,1672597248,1672599819,2571
11393,3517144269,3519948471,1672614142,1672617467,3325
11763,3739297004,3791758175,1672635284,1672638563,3279
9860,3618895679,3770172119,1672635361,1672638113,2752
11054,3471177177,3895839169,1672556948,1672559660,2712
11224,3791547827,3393001196,1672646266,1672647187,921
11314,3533859712,3511640720,1672669882,1672670669,787
11760,3310961923,3461877104,1672583166,1672584077,911
11388,3710125627,3852161626,1672578173,1672581129,2956
10630,3409098014,3382696725,1672561255,1672561603,348
9889,3779505358,3884191432,1672645378,1672645632,254
11758,3505547832,3890278838,1672538971,1672541977,3006
10559,3774448657,3341129425,1672610982,1672612639,1657
11472,3776534957,3755209597,1672643837,1672646202,2365
10488,3817478012,3791070926,1672536628,1672538568,1940
9891,3711219767,3772282008,1672641051,1672643155,2104
11558,3302929858,3760390822,1672625162,1672626139,977
9980,3445558740,3517652011,1672634284,1672637590,3306
11464,3757592622,3505291330,1672677029,1672680248,3219
9916,3384001094,3793442891,1672645162,1672647463,2301
9930,3515984911,3711287751,1672589749,1672589965,216
11761,3319529422,3732596503,1672584782,1672586374,1592
11601,3500251781,3713336088,1672538220,1672541615,3395
11223,3511963020,3205687719,1672600185,1672600761,576
10134,3239423794,3475090917,1672639945,1672640732,787
11097,3454151554,3517949586,1672645695,1672647920,2225
11236,3500596577,3774145748,1672653014,1672653534,520
10069,3235578852,3505769529,1672664272,1672665737,1465
11573,3314363575,3419789418,1672689769,1672691030,1261
10999,3899756737,3714595459,1672702426,1672705811,3385
11245,3533037906,3342027511,1672630413,1672633412,2999
11242,3509562377,3904846341,1672653017,1672655465,2448
10818,3340321384,3623894390,1672631214,1672634583,3369
10683,3241855333,3621629499,1672571283,1672571744,461
11033,3602401154,3756642173,1672661266,1672662820,1554
11287,3791542842,3899156705,1672676323,1672679118,2795
10606,3510218188,3311142523,1672611294,1672611651,357
9823,3710680073,3885422379,1672552484,1672552822,338
11541,3919211457,3739075176,1672535746,1672536624,878
10147,3293553295,3505684690,1672575310,1672576159,849
9992,3533440294,3514926921,1672660054,1672662293,2239
10412,3513850048,3757924067,1672645402,1672646079,677
9906,3509274030,3850181934,1672624533,1672626688,2155
10711,3774663639,3505359060,1672673457,1672673600,143
11385,3520515739,3511750850,1672599927,1672602344,2417
10028,3517151644,3711770853,1672653308,1672655755,2447
11270,3736056340,3912862842,1672640594,1672641036,442
9825,3933731871,3716492409,1672608039,1672610606,2567
11344,3492728794,3510486220,1672611884,1672613829,1945
11603,3884933821,3319061210,1672691651,1672693123,1472
11575,3713471446,3791359168,1672629656,1672632898,3242
10776,3432466467,3205324639,1672665601,1672668593,2992
11575,3302988745,3772188086,1672607968,1672608495,527
10658,3517253559,3715852330,1672562964,1672565628,2664
9995,3418997135,3287683210,1672636858,1672638968,2110
11705,3814770073,3701359045,1672565751,1672566580,829
10417,3403035480,3772169046,1672596382,1672599321,2939
9977,3458432407,3439283360,1672607645,1672609946,2301
10816,3512203553,3493679801,1672585513,1672588624,3111
10790,3703938162,3533777032,1672677382,1672680241,2859
10469,3757994002,3352374868,1672533091,1672533752,661
11137,3494157939,3500329674,1672660963,1672664264,3301
11466,3515470462,3714264759,1672643135,1672645909,2774
10672,3517021928,3372617110,1672659358,1672661468,2110
11535,3235470567,3773853619,1672543654,1672547182,3528
11470,3509626590,3517960157,1672680078,1672681692,1614
10293,3382670400,3311805161,1672620193,1672622399,2206
11076,3701291994,3736885568,1672583931,1672584076,145
10848,3311515179,3779468781,1672688890,1672691366,2476
9833,3375257546,3680939042,1672665471,1672666477,1006
11441,3774589551,3906260966,1672588809,1672589301,492
10264,3688130094,3486509752,1672584389,1672586144,1755
10711,3533841983,3713694278,1672653460,1672654201,741
11528,3885645840,3338016147,1672603575,1672606766,3191
10942,3512555384,3357496255,1672625562,1672628054,2492
11636,3534374523,3978643889,1672541007,1672543558,2551
11414,3273674596,3622218289,1672666847,1672668272,1425
10234,3520832066,3505482210,1672551120,1672554027,2907
11669,3501407804,3515284733,1672572878,1672576443,3565
11772,3925823748,3760748418,1672652603,1672653867,1264
10892,3776068937,3701493094,1672676523,1672678864,2341
11531,3513140146,3755357292,1672652427,1672652822,395
10793,3755790149,3710173412,1672550118,1672552071,1953
10033,3609103278,3288346356,1672625847,1672629018,3171
10239,3513586642,3311989687,1672689639,1672691903,2264
10166,3979366845,3802625412,1672610349,1672613917,3568
10545,3517992521,3776968640,1672674509,1672675547,1038
10110,3783594729,3774401596,1672589062,1672592179,3117
10312,3714870496,3770019143,1672609113,1672612679,3566
11125,3209925780,3622458047,1672535711,1672537361,1650
11105,3713906305,3275975921,1672603487,1672606997,3510
9880,3778842400,3777767907,1672573891,1672575667,1776
9889,3246971044,3760420315,1672601243,1672602873,1630
10678,3780626668,3791359168,1672597841,1672600053,2212
11447,3483347530,3513486828,1672653609,1672654545,936
10502,3382757142,3711844574,1672657858,1672660990,3132
10582,3973582279,3760420315,1672618751,1672619379,628
10575,3518088154,3828906027,1672675021,1672675890,869
11213,3511907179,3241855333,1672549059,1672550391,1332
11085,3403738461,3501927452,1672656025,1672659283,3258
11516,3830962592,3361635547,1672680358,1672680460,102
10586,3774706478,3710807030,1672603583,1672605056,1473
10243,3777729184,3776053084,1672534244,1672537607,3363
10441,3792824886,3778695895,1672638266,1672640051,1785
10913,3278779955,3636852764,1672676499,1672679951,3452
10002,3755170743,3381244346,1672603295,1672606308,3013
11249,3756272704,3711959141,1672565237,1672567107,1870
11271,3394986304,3701004302,1672588819,1672591716,2897
10219,3774598935,3911821258,1672661597,1672662782,1185
11115,3517797610,3688845298,1672672326,1672673916,1590
10193,3514353133,3514013999,1672621825,1672624578,2753
10921,3779505358,3710397477,1672690336,1672690528,192
9849,3519034304,3517530943,1672570616,1672572602,1986
9880,3783408469,3907245259,1672537143,1672538492,1349
10540,3337903727,3716020849,1672622168,1672622837,669
11674,3971289056,3515726910,1672696376,1672697544,1168
11078,3302416197,3533030343,1672582696,1672583379,683
11420,3805831563,3475653510,1672595830,1672596844,1014
11654,3919494952,3559754304,1672638535,1672640518,1983
10756,3776953418,3305093237,1672625801,1672628607,2806
11717,3231227362,3924583142,1672650257,1672650599,342
10380,3518989186,3455907179,1672631888,1672633617,1729
10444,3915679140,3774296721,1672701180,1672702784,1604
9866,3892487982,3914740937,1672688688,1672691987,3299
11770,3778924002,3500555856,1672567601,1672570819,3218
11362,3505500523,3820422111,1672593674,1672597121,3447
10413,3283106998,3903994989,1672582253,1672582563,310
10297,3374652108,3757732853,1672615045,1672616823,1778
10219,3668855144,3457249798,1672606010,1672608945,2935
11124,3774029494,3633622298,1672661034,1672663560,2526
11282,3432050858,3701127475,1672613097,1672615335,2238
9982,3912878303,3716541851,1672647701,1672649890,2189
10753,3912915644,3412605548,1672642419,1672644342,1923
10634,3760096466,3925835590,1672642009,1672642533,524
11673,3760737203,3395069149,1672554006,1672555767,1761
11207,3713767153,3922409420,1672594979,1672597759,2780
10542,3225371682,3919994216,1672635360,1672635903,543
11252,3505867821,3793899166,1672688034,1672689684,1650
10984,3505769529,3772188086,1672670694,1672670979,285
10201,3304235700,3776068937,1672689233,1672691402,2169
10191,3481019442,3977880564,1672615606,1672617574,1968
10089,3500198430,3783157469,1672548419,1672549542,1123
10289,3857847527,3520049965,1672694681,1672697589,2908
11002,3689420679,3793029132,1672586638,1672588466,1828
10101,3792900315,3495637721,1672647696,1672647858,162
11098,3497562878,3369482983,1672647594,1672649097,1503
10949,3730935770,3505720915,1672674218,1672675369,1151
10989,3368176107,3851737350,1672675794,1672679131,3337
11228,3760416450,3514628916,1672646642,1672647922,1280
9885,3501407804,3701296091,1672547431,1672549565,2134
10235,3468343480,3500922040,1672629067,1672629777,710
10203,3534426696,3242149533,1672603251,1672606074,2823
11376,3509370016,3505980138,1672624425,1672626263,1838
10848,3931917809,3400186699,1672703984,1672704286,302
10420,3335139032,3509382404,1672645360,1672646052,692
11471,3916955566,3334381941,1672696128,1672696903,775
11580,3738103378,3884001167,1672575649,1672576734,1085
10377,3206377955,3479207976,1672638757,1672640400,1643
11483,3773376762,3519463038,1672655364,1672658334,2970
11483,3770533588,3351728355,1672638394,1672639555,1161
10152,3732223664,3666958814,1672555882,1672555952,70
9821,3518425740,3777706200,1672703766,1672704437,671
9874,3780173788,3791617239,1672539432,1672542274,2842
10406,3512492332,3552922094,1672692367,1672694053,1686
10033,3510254698,3391612879,1672671354,1672672052,698
11384,3405435885,3271719569,1672570305,1672572325,2020
11622,3511645260,3494748808,1672569401,1672572883,3482
9947,3978643889,3778318250,1672569325,1672572912,3587
10946,3520009158,3505010941,1672551580,1672551948,368
10953,3276393542,3837887478,1672573567,1672575932,2365
10981,3492064037,3713374884,1672633828,1672635424,1596
9853,3404375908,3774359137,1672573564,1672575666,2102
11044,3973138649,3205687719,1672609826,1672610255,429
10005,3713444403,3713224038,1672691264,1672691777,513
10619,3515047288,3354405535,1672623896,1672625061,1165
9898,3501137133,3831864108,1672568831,1672568892,61
11657,3387700451,3500018566,1672672454,1672674306,1852
10655,3489340327,3227059650,1672694978,1672696933,1955
11504,3315432466,3271389160,1672647814,1672649959,2145
11709,3513764665,3285587972,1672557207,1672557670,463
11395,3239779992,3362127525,1672657626,1672658471,845
11539,3334824744,3305657559,1672540091,1672542046,1955
11643,3793497672,3501573548,1672583845,1672587184,3339
11149,3509651954,3479910993,1672565523,1672567324,1801
10005,3450503086,3777063455,1672649655,1672652150,2495
10666,3773534165,3660246433,1672588622,1672590443,1821
11599,3520362238,3412605548,1672550200,1672551701,1501
10233,3772250554,3770497768,1672590904,1672592101,1197
11515,3906075386,3275751794,1672617328,1672618008,680
10296,3359351267,3434052463,1672605057,1672606444,1387
9866,3774448657,3513586642,1672576276,1672577269,993
11745,3487622510,3897186782,1672635693,1672636336,643
11249,3513890046,3294326116,1672606769,1672608679,1910
10875,3757728121,3780213684,1672584659,1672586535,1876
10792,3772250554,3446810761,1672616598,1672619942,3344
11676,3444295435,3344710271,1672638967,1672639796,829
11058,3403120725,3511744756,1672545901,1672548630,2729
11736,3447078933,3772556646,1672595969,1672599202,3233
10221,3511458926,3793987483,1672674021,1672675630,1609
9944,3399943757,3711349327,1672553063,1672554304,1241
10712,3378747834,3517552930,1672597888,1672598364,476
11742,3339649817,3519937708,1672599022,1672600654,1632
11394,3288791629,3715923089,1672697322,1672699345,2023
11580,3804779247,3452389513,1672692491,1672693000,509
11360,3344478603,3815184540,1672599487,1672599907,420
10236,3770533588,3779604279,1672597494,1672599023,1529
9890,3499622352,3246971044,1672590260,1672592308,2048
10954,3201502111,3221736756,1672639940,1672642631,2691
11051,3830771832,3925098136,1672687326,1672690289,2963
10275,3380444321,3714525519,1672573649,1672576898,3249
11651,3510882576,3346755179,1672541166,1672542660,1494
10693,3294326116,3492064037,1672598541,1672601112,2571
11057,3501027795,3802101760,1672556654,1672557272,618
11105,3435037864,3774205060,1672689931,1672693413,3482
11390,3306491253,3710919244,1672637458,1672639713,2255
11698,3292663993,3756680289,1672541052,1672542323,1271
10439,3716285196,3701540249,1672593181,1672595614,2433
10180,3309178914,3433196933,1672576817,1672577969,1152
10190,3757732853,3908464960,1672547706,1672550239,2533
10870,3783095041,3716460706,1672553846,1672556328,2482
9947,3408111327,3311200541,1672688800,1672692201,3401
9804,3783201950,3435159896,1672694747,1672695935,1188
9917,3480108752,3408982612,1672613555,1672614224,669
11687,3770574826,3430310785,1672541360,1672542802,1442
10554,3791688526,3511364193,1672652065,1672653706,1641
10271,3774326754,3716209499,1672667713,1672671009,3296
10330,3558203963,3783408830,1672646988,1672648882,1894
11493,3513486828,3489340327,1672695855,1672698350,2495
11153,3731905251,3666367524,1672628939,1672631351,2412
11310,3442073613,3519228207,1672612364,1672614907,2543
10710,3500031401,3385124073,1672597625,1672600379,2754
10482,3908550561,3777063455,1672572367,1672573411,1044
10031,3773041843,3300810210,1672693877,1672694837,960
10996,3245755569,3229615214,1672584046,1672584251,205
11137,3714287902,3770424941,1672580922,1672583024,2102
11431,3517816581,3516257130,1672615031,1672616730,1699
10893,3517448452,3937299996,1672596667,1672598648,1981
11539,3491527603,3467232654,1672559496,1672560360,864
11537,3908464960,3826997668,1672669196,1672670288,1092
11246,3701004302,3493047640,1672700778,1672700913,135
10110,3806034626,3203837944,1672533160,1672535943,2783
11467,3454343398,3639503148,1672635144,1672637727,2583
11126,3494560663,3201573194,1672539161,1672539224,63
10405,3312651192,3716160006,1672582266,1672583486,1220
10848,3911376818,3778702093,1672663543,1672665621,2078
11186,3774359137,3501619113,1672666014,1672667406,1392
11083,3780238637,3668720465,1672590113,1672593323,3210
11370,3778195766,3505438826,1672662668,1672666046,3378
10896,3520925688,3612705426,1672669488,1672671999,2511
10134,3757607649,3493598658,1672662134,1672665237,3103
10130,3911431642,3505007498,1672667804,1672670886,3082
11551,3755502373,3792633495,1672537324,1672540100,2776
10853,3688130094,3204473480,1672538796,1672540351,1555
11316,3779282072,3834424604,1672674556,1672676572,2016
9817,3778741325,3772223331,1672565807,1672567803,1996
10334,3760710525,3793987483,1672652659,1672655302,2643
10597,3362385373,3510694464,1672673819,1672674211,392
10279,3517440258,3397527886,1672587954,1672590636,2682
10348,3400025324,3756717136,1672603152,1672605821,2669
11487,3518425740,3493598658,1672661801,1672663726,1925
10393,3756066765,3341129425,1672636109,1672638274,2165
9995,3466620548,3375324190,1672579683,1672582620,2937
10177,3669418238,3777655401,1672647876,1672649548,1672
11718,3904045870,3415228763,1672676131,1672679453,3322
10810,3350631472,3755729826,1672656138,1672657483,1345
11074,3400186699,3780423516,1672650584,1672653075,2491
10622,3389367628,3701350519,1672604263,1672605403,1140
11359,3624872714,3517380144,1672578923,1672581197,2274
10813,3732533330,3913847876,1672552310,1672553540,1230
10965,3501963428,3914353062,1672555002,1672556187,1185
10900,3517227599,3716460706,1672668961,1672672103,3142
10620,3883640904,3293157673,1672558890,1672559570,680
11017,3893950585,3347996015,1672653107,1672655913,2806
11364,3714268380,3452104161,1672695333,1672698238,2905
11523,3534174363,3222357355,1672561795,1672562027,232
10181,3793689267,3516167000,1672608761,1672609992,1231
10634,3350631472,3500693568,1672635711,1672636502,791
11651,3533265491,3454151554,1672677786,1672679981,2195
11216,3447938130,3897500723,1672625547,1672627968,2421
10642,3533830748,3908883591,1672661071,1672662258,1187
10233,3440991826,3880000841,1672578785,1672580295,1510
10659,3500062408,3519712497,1672620754,1672624177,3423
11545,3711613085,3277061226,1672635057,1672638222,3165
10655,3711187791,3888642876,1672544238,1672546546,2308
10115,3304447950,3533627473,1672641470,1672643872,2402
10269,3509544691,3732467455,1672641707,1672642191,484
10527,3495427619,3500695402,1672633208,1672634113,905
11336,3733953055,3395610742,1672695530,1672696243,713
10413,3776732532,3395565040,1672608101,1672610509,2408
11328,3783060739,3481700413,1672533751,1672536734,2983
11175,3513894659,3713224986,1672634941,1672637193,2252
10412,3776053981,3791841318,1672534085,1672536502,2417
11715,3484490325,3793949077,1672625654,1672628748,3094
9869,3511199555,3822496670,1672603668,1672606862,3194
9923,3715291931,3783611957,1672583358,1672583721,363
10860,3778702093,3403988682,1672619109,1672621520,2411
10248,3756157377,3534562354,1672676771,1672678941,2170
10705,3715039960,3276499910,1672667233,1672668504,1271
11498,3783611957,3778044082,1672585720,1672588385,2665
11237,3779561601,3509297453,1672575891,1672577218,1327
10698,3434052463,3205161801,1672683265,1672684122,857
10936,3730414796,3934070285,1672603836,1672605376,1540
9915,3780224882,3231271498,1672596124,1672598622,2498
10426,3512546783,3713566527,1672619649,1672620716,1067
10399,3778909412,3905889514,1672627485,1672627765,280
11790,3516965624,3444881567,1672545984,1672546403,419
10362,3710173412,3387388336,1672563993,1672566853,2860
9894,3518572231,3351837521,1672605047,1672605407,360
11015,3701448521,3518376262,1672577537,1672580136,2599
10307,3505490878,3776901443,1672596506,1672597231,725
11415,3919349138,3793003432,1672663870,1672666795,2925
11373,3772223331,3500057674,1672668281,1672670466,2185
11295,3394394262,3447312353,1672618106,1672620436,2330
10345,3774195369,3516731917,1672548570,1672549059,489
10896,3818532143,3533593766,1672619474,1672623052,3578
10316,3500630465,3501873139,1672688568,1672690128,1560
11171,3703277359,3308481706,1672663549,1672665863,2314
10533,3369558911,3500630465,1672596038,1672599357,3319
10557,3756066765,3534775239,1672539278,1672540212,934
10952,3242149533,3711671702,1672563044,1672563254,210
11317,3501208658,3352057037,1672616375,1672618508,2133
10150,3407403080,3311409212,1672551394,1672552033,639
10530,3512753567,3393909269,1672672940,1672673157,217
10213,3516321814,3360783381,1672570390,1672570828,438
11342,3810818108,3517902505,1672656245,1672657142,897
11546,3345896913,3379076106,1672570315,1672573796,3481
10239,3778125688,3711945923,1672702104,1672705070,2966
10591,3396656251,3271282663,1672556827,1672559011,2184
10039,3311696372,3803996569,1672575488,1672578069,2581
10867,3310702648,3458753033,1672615230,1672616457,1227
11518,3307791650,3428076194,1672693882,1672695369,1487
9794,3445558740,3302929858,1672691022,1672693102,2080
9958,3609335008,3400560073,1672686434,1672690014,3580
10520,3855977674,3815184540,1672608934,1672611365,2431
10612,3779604279,3778382224,1672644184,1672646985,2801
11017,3903065952,3492728794,1672551479,1672552426,947
10821,3701663839,3501515425,1672700914,1672701007,93
11464,3505828210,3976742903,1672544938,1672547602,2664
10413,3239082508,3302988745,1672579929,1672582427,2498
10049,3313795594,3516020922,1672569169,1672571348,2179
11012,3558349840,3417268745,1672693400,1672695467,2067
11357,3554317844,3703697059,1672536703,1672538396,1693
11451,3515379622,3505148522,1672633848,1672636449,2601
10238,3307791650,3311583437,1672569215,1672570846,1631
9887,3245121919,3449672240,1672581189,1672583374,2185
11763,3369270860,3440743218,1672581356,1672583509,2153
10424,3806034626,3701453343,1672610057,1672611522,1465
10172,3713767153,3780298499,1672635840,1672637149,1309
10841,3774221318,3440401725,1672647382,1672650762,3380
10926,3716183063,3227339675,1672663229,1672665504,2275
10367,3919984986,3716468783,1672653338,1672656648,3310
10327,3319436533,3362385373,1672696311,1672699701,3390
10785,3496407500,3703206956,1672659442,1672661836,2394
10107,3510882475,3512495325,1672556535,1672557489,954
11330,3621591266,3716209499,1672545420,1672547625,2205
9804,3239990061,3922409420,1672680063,1672682398,2335
10342,3512072679,3832902787,1672625442,1672627265,1823
10947,3534081527,3915962248,1672596935,1672598812,1877
11627,3714640103,3515804844,1672683250,1672685843,2593
10512,3555215568,3283295213,1672636962,1672640486,3524
10392,3311331205,3899903158,1672636627,1672638655,2028
11414,3710060386,3533201269,1672685673,1672687539,1866
11715,3511078598,3337715675,1672684348,1672685633,1285
9809,3715282492,3349573092,1672556339,1672558734,2395
11375,3715114417,3660257653,1672590456,1672593565,3109
10021,3500079479,3776124041,1672585797,1672588278,2481
11782,3884394685,3970775805,1672665035,1672666684,1649
10681,3783157469,3285136057,1672567972,1672570088,2116
10064,3520145112,3779478448,1672678344,1672680072,1728
11027,3716463756,3394976623,1672574449,1672575291,842
10695,3915035136,3311432176,1672643620,1672645085,1465
11256,3882580580,3513143959,1672578798,1672580442,1644
11515,3500093945,3519260216,1672646187,1672648129,1942
10427,3514007122,3439662051,1672563466,1672565043,1577
11089,3466655775,3518995270,1672546961,1672548015,1054
11545,3619796619,3307997700,1672535210,1672535677,467
10169,3501734800,3432838598,1672578773,1672579856,1083
10968,3902775449,3710529628,1672569231,1672571133,1902
10484,3305612422,3283785820,1672665817,1672666617,800
11691,3361635547,3662507634,1672591490,1672592993,1503
10991,3687183789,3360309868,1672612711,1672613611,900
10974,3701824335,3519448648,1672654366,1672654593,227
10212,3510919509,3932955949,1672594200,1672594603,403
10892,3791236983,3387322545,1672692851,1672695628,2777
10244,3703438617,3500442370,1672606909,1672607662,753
10371,3512596743,3793003432,1672557658,1672561234,3576
10667,3514980025,3514941815,1672624579,1672628072,3493
10078,3403395712,3359351267,1672534660,1672537504,2844
9864,3776034313,3425545115,1672648607,1672651521,2914
11113,3773953689,3802374620,1672534598,1672534770,172
9951,3701374160,3512477276,1672629003,1672631610,2607
10008,3286862903,3853188285,1672658003,1672658849,846
11097,3311177439,3307454562,1672547839,1672549705,1866
11502,3520057139,3711671702,1672635455,1672638135,2680
10433,3463729805,3757201138,1672558502,1672558803,301
11219,3379400553,3319061210,1672585708,1672589003,3295
10241,3500695402,3513894659,1672601828,1672605211,3383
10767,3894756677,3774195369,1672571672,1672573063,1391
11508,3901217668,3204149913,1672674014,1672676801,2787
11532,3777564559,3514498259,1672625467,1672626967,1500
9931,3925835590,3480270940,1672677076,1672677598,522
11534,3304028109,3511078598,1672641070,1672644468,3398
11749,3514361485,3271762055,1672536009,1672538524,2515
11698,3290797257,3713726267,1672556703,1672558124,1421
11080,3780435349,3667072319,1672647785,1672648704,919
10701,3490953301,3973138649,1672591361,1672593926,2565
10607,3380185102,3756890980,1672665721,1672666089,368
10994,3501583486,3783594729,1672549815,1672550109,294
10579,3500854711,3454343398,1672559526,1672561242,1716
10445,3341432459,3688870751,1672636659,1672638332,1673
10336,3519621901,3791206902,1672643426,1672645172,1746
11468,3713606829,3403870769,1672701225,1672701486,261
10098,3780969898,3755507566,1672556272,1672558428,2156
11252,3777751979,3314965818,1672539711,1672540435,724
11561,3668369938,3660980656,1672680402,1672680621,219
11075,3368848936,3715291931,1672552045,1672555122,3077
11586,3625931630,3735838864,1672636534,1672638073,1539
11021,3393955069,3533340292,1672572856,1672574769,1913
11494,3305657559,3201920708,1672668217,1672668617,400
9816,3669475165,3922786716,1672677340,1672680014,2674
11261,3792432094,3243651036,1672650626,1672654087,3461
10816,3627377299,3428325402,1672676137,1672677162,1025
10271,3792008302,3680832669,1672616317,1672619357,3040
10370,3520182275,3514801709,1672592563,1672593269,706
11146,3519937708,3520824937,1672537877,1672540981,3104
11630,3711844574,3517136772,1672542047,1672543668,1621
10518,3455955489,3701596047,1672699107,1672702245,3138
11487,3354968884,3361926328,1672625933,1672626358,425
10766,3488399075,3513894659,1672551292,1672553745,2453
11177,3385006834,3515405509,1672595102,1672596730,1628
11358,3817478012,3493047640,1672601746,1672602480,734
11233,3505901826,3774205060,1672668355,1672669528,1173
10491,3921138062,3500433278,1672625738,1672626260,522
10695,3228033254,3359351267,1672634990,1672637866,2876
9975,3490008012,3639465750,1672595547,1672597461,1914
10299,3600842635,3241567995,1672638777,1672639789,1012
9901,3760776967,3388774559,1672625618,1672625683,65
10106,3444680955,3663505156,1672532954,1672536208,3254
10024,3837378340,3825082811,1672597129,1672597970,841
10291,3703351452,3501628472,1672560015,1672563587,3572
11598,3811351746,3227874229,1672668809,1672670124,1315
11325,3783947742,3716118473,1672599986,1672602438,2452
11601,3408828584,3514926921,1672548107,1672548632,525
11062,3686644062,3239082508,1672695525,1672696180,655
11321,3350631472,3236254381,1672656250,1672658882,2632
11607,3714435747,3793874490,1672682724,1672683462,738
11036,3407398464,3902300755,1672638984,1672639111,127
10748,3518209090,3779478448,1672535042,1672535624,582
10946,3852461753,3344710271,1672652047,1672655337,3290
11111,3520558137,3715602742,1672666700,1672669695,2995
10485,3776581518,3801501384,1672579417,1672582650,3233
11401,3780941637,3417268745,1672664060,1672665170,1110
11301,3900766525,3858497718,1672642267,1672644160,1893
10383,3773899531,3446233783,1672601148,1672602869,1721
9897,3488887919,3938398160,1672652351,1672655443,3092
9822,3939882169,3519494023,1672687710,1672687795,85
10533,3711718368,3400793223,1672611022,1672614163,3141
11426,3616242727,3638823001,1672554228,1672556596,2368
11765,3756363182,3481700413,1672552537,1672555654,3117
10285,3206544535,3519947298,1672634801,1672637473,2672
11544,3826315540,3756493561,1672581443,1672584681,3238
10121,3454554552,3897107253,1672577378,1672579175,1797
10350,3299587876,3714838100,1672644417,1672644722,305
10654,3779561601,3893629892,1672659769,1672661474,1705
11589,3203172170,3713139039,1672654409,1672656483,2074
11118,3468343480,3716526314,1672698777,1672699982,1205
11629,3920116284,3939422411,1672549593,1672552955,3362
10249,3496352027,3711219767,1672659458,1672660620,1162
10817,3499998389,3519352855,1672600485,1672602454,1969
11039,3495637721,3209280342,1672674031,1672676877,2846
11004,3791542842,3533077580,1672536842,1672539863,3021
11733,3893932944,3755129708,1672669305,1672672703,3398
11783,3880788853,3711430738,1672535882,1672538762,2880
10228,3287753579,3492056330,1672640677,1672643541,2864
10476,3756428507,3352044245,1672542599,1672545346,2747
11792,3780921044,3903879740,1672651706,1672655125,3419
10077,3369482983,3852461753,1672605470,1672605615,145
10774,3312733562,3467232654,1672649834,1672652135,2301
11288,3685083275,3517227599,1672663574,1672665307,1733
10122,3793732968,3428325402,1672552739,1672555034,2295
9994,3519108639,3393001196,1672610592,1672613601,3009
10360,3500726347,3716179251,1672548880,1672550682,1802
10581,3390444181,3461877104,1672595106,1672596414,1308
10642,3370961012,3710046567,1672556502,1672558660,2158
9942,3209280342,3247845642,1672591794,1672595143,3349
10726,3518368900,3309178914,1672631348,1672633925,2577
11084,3519922921,3331228758,1672602131,1672605395,3264
10001,3792283334,3834980281,1672544976,1672545762,786
10499,3711015176,3888642876,1672609169,1672610932,1763
10506,3791547827,3972653129,1672681332,1672684810,3478
11727,3755922811,3517021928,1672531231,1672534251,3020
10829,3853182912,3711243126,1672546554,1672549815,3261
10880,3774145748,3516731917,1672565749,1672567909,2160
10849,3710051427,3680939042,1672654508,1672658020,3512
10011,3854229296,3780942505,1672652082,1672652397,315
9843,3821087562,3908862092,1672617071,1672620410,3339
10106,3395615598,3852275715,1672692301,1672694575,2274
11412,3792930090,3419648004,1672693968,1672695038,1070
10389,3828906027,3207307681,1672603549,1672605121,1572
11206,3916955566,3818532143,1672578702,1672582054,3352
11172,3662354016,3756763585,1672681606,1672681830,224
10259,3430032005,3295748489,1672629355,1672629715,360
10390,3338187803,3711854614,1672644548,1672645888,1340
11198,3510218188,3779340538,1672574172,1672577013,2841
10867,3534168768,3791332061,1672659409,1672662298,2889
10078,3701655378,3300238532,1672662354,1672665146,2792
10830,3515970536,3343859998,1672635615,1672638994,3379
10260,3388481990,3444881567,1672636449,1672637950,1501
10425,3368951504,3669283586,1672572193,1672573429,1236
11048,3362706073,3515838621,1672693463,1672694155,692
10638,3534206917,3510864325,1672586903,1672590469,3566
11785,3311045951,3755688231,1672625040,1672627895,2855
10819,3533265491,3908883591,1672576007,1672579022,3015
10063,3711854614,3711176990,1672653664,1672655772,2108
11354,3972442654,3939422411,1672653488,1672654140,652
10878,3856975355,3510301454,1672551228,1672554806,3578
11381,3403738461,3777715675,1672698890,1672701160,2270
11730,3395610742,3318590083,1672647344,1672648712,1368
11655,3509208005,3890278838,1672697984,1672699052,1068
11128,3422460919,3900766525,1672651164,1672651824,660
10741,3882905311,3440743218,1672613807,1672615048,1241
10036,3554437212,3772943811,1672547787,1672549416,1629
11721,3388937390,3922409420,1672531558,1672534811,3253
10319,3516034245,3482687604,1672631564,1672632961,1397
10617,3430310785,3714787207,1672618527,1672620515,1988
11063,3932955949,3714471069,1672586037,1672589406,3369
10074,3770530739,3467232654,1672576651,1672579439,2788
10438,3773579644,3783201950,1672583634,1672586157,2523
11574,3224824355,3501174621,1672587945,1672591466,3521
10616,3774606418,3312733562,1672558064,1672559521,1457
10277,3505491969,3245882008,1672699584,1672703096,3512
10917,3240877710,3714870496,1672621050,1672622283,1233
11346,3783594246,3777370601,1672703560,1672705425,1865
11751,3920890008,3500793739,1672664648,1672666372,1724
10689,3509701363,3517021928,1672549778,1672553051,3273
10991,3311569360,3783238023,1672646103,1672648653,2550
11100,3852461753,3501843187,1672592671,1672593088,417
10064,3778479297,3287753579,1672554617,1672557830,3213
10090,3344710271,3513111053,1672558749,1672561697,2948
10491,3511182297,3909822999,1672596034,1672596548,514
10802,3511663572,3533340292,1672534456,1672535388,932
9929,3735197034,3229890340,1672546203,1672548684,2481
10520,3730414796,3600302127,1672650129,1672650309,180
11276,3714455496,3615742989,1672599992,1672603462,3470
10401,3485521840,3777118499,1672661695,1672662791,1096
10097,3710807030,3772659062,1672624980,1672626843,1863
11464,3375905193,3854957153,1672569065,1672570987,1922
10463,3511078598,3737622701,1672603104,1672604015,911
10311,3890278838,3308759754,1672616246,1672616453,207
10297,3516497645,3345954031,1672610387,1672612628,2241
10348,3857244486,3452389513,1672636104,1672639149,3045
11735,3792283334,3926065090,1672547160,1672547329,169
10885,3824657614,3520305100,1672644731,1672646838,2107
11437,3756781024,3713969196,1672614596,1672617662,3066
11699,3311805161,3347520239,1672604025,1672605479,1454
10028,3757497708,3238056215,1672590876,1672591621,745
11589,3509382404,3220976338,1672547757,1672549292,1535
10506,3221290808,3501174621,1672595458,1672596035,577
11785,3301765144,3512871568,1672694966,1672696877,1911
10286,3826997668,3779454060,1672595978,1672597484,1506
11250,3777758203,3492064037,1672557116,1672560340,3224
11432,3713476192,3408982612,1672589961,1672591765,1804
10372,3468281011,3701971784,1672675746,1672677385,1639
9958,3442403264,3776166086,1672676531,1672677063,532
11149,3279102372,3662354016,1672567719,1672569384,1665
10518,3356972733,3459163055,1672539188,1672539423,235
11400,3735056027,3713858538,1672608010,1672611000,2990
11444,3773798215,3822315407,1672563095,1672564676,1581
10938,3730226545,3791106473,1672615384,1672615495,111
11792,3711131262,3736941123,1672592663,1672594691,2028
11173,3446233783,3791644831,1672688787,1672689031,244
10705,3288791629,3888903181,1672602446,1672605873,3427
11528,3390537737,3737738751,1672602013,1672603837,1824
11766,3756763585,3365519448,1672671613,1672673442,1829
10036,3428198021,3687445224,1672685410,1672686465,1055
11096,3305656670,3471507117,1672657844,1672658854,1010
10763,3517380144,3812677669,1672571431,1672573346,1915
10685,3285971415,3701387745,1672647550,1672648274,724
11490,3636857871,3436018575,1672701432,1672701756,324
11278,3701065296,3501225887,1672681760,1672682713,953
11487,3711179193,3814770073,1672594429,1672597170,2741
11755,3756759239,3715196780,1672662408,1672665968,3560
10536,3805268739,3904485393,1672700589,1672703978,3389
10820,3757032266,3701291994,1672622622,1672622754,132
10145,3935520819,3627081426,1672683401,1672686739,3338
11175,3777931341,3777715675,1672550293,1672551557,1264
10135,3394394262,3511908639,1672533535,1672533916,381
11610,3760648750,3884192843,1672686670,1672687054,384
10965,3701779683,3924963918,1672604870,1672606102,1232
10878,3825932442,3520553959,1672665017,1672667286,2269
11231,3501550490,3510368377,1672559581,1672563026,3445
10766,3515804844,3923133978,1672643406,1672643642,236
11104,3534578428,3482639402,1672544775,1672548319,3544
10402,3472018395,3350966326,1672533894,1672533997,103
10286,3701065296,3287403291,1672596172,1672599092,2920
11322,3517227599,3783176874,1672665002,1672668413,3411
11296,3347140733,3206377955,1672656514,1672656723,209
11153,3668681400,3770285500,1672680138,1672683120,2982
11170,3783563043,3710585241,1672675679,1672677309,1630
10570,3927675706,3920606331,1672633788,1672635748,1960
10128,3779951373,3360949039,1672585611,1672586760,1149
10898,3688845298,3780500764,1672533882,1672535905,2023
10424,3893950585,3824657614,1672593743,1672595928,2185
11444,3515100211,3500630465,1672582785,1672584156,1371
10260,3514007122,3386323728,1672665131,1672665848,717
10855,3342837214,3739820448,1672585157,1672585560,403
10358,3922153821,3493679801,1672641191,1672643940,2749
11151,3905358065,3777200549,1672581605,1672583163,1558
11034,3337673625,3755203055,1672571069,1672571566,497
11319,3856975623,3380285779,1672665564,1672669122,3558
10859,3809216145,3462645981,1672564007,1672565880,1873
10163,3770497768,3516321993,1672600388,1672600829,441
10509,3927763819,3533209168,1672535983,1672536404,421
10738,3463729805,3777729184,1672560331,1672563632,3301
10897,3660980656,3713069234,1672555060,1672556025,965
9801,3713224986,3373802545,1672547694,1672549625,1931
10675,3501853868,3509828883,1672702973,1672705401,2428
10744,3783611957,3517943697,1672603308,1672606336,3028
9860,3850993995,3515726910,1672662661,1672664697,2036
10021,3713107380,3772234939,1672599147,1672600091,944
11746,3360949039,3400903513,1672659048,1672661123,2075
11015,3290797257,3772114731,1672680010,1672682487,2477
10234,3520009158,3850735936,1672550094,1672552643,2549
11067,3773853619,3902300755,1672648671,1672652229,3558
9865,3509018337,3364067937,1672548580,1672550199,1619
10906,3779689733,3773411968,1672650920,1672651789,869
11129,3792627762,3601214648,1672697945,1672699367,1422
10538,3856129522,3308759754,1672542267,1672542705,438
10331,3514776568,3452104161,1672554091,1672556662,2571
9865,3925208102,3756695502,1672686408,1672687036,628
11506,3773394570,3703624327,1672594952,1672597382,2430
9982,3680939042,3273771395,1672696573,1672699765,3192
10862,3533974355,3917905192,1672642371,1672644085,1714
9853,3770530739,3773534165,1672631981,1672633263,1282
10870,3307791650,3701512498,1672623144,1672626512,3368
10353,3511206717,3822315407,1672701265,1672701614,349
10269,3318590083,3924366353,1672668115,1672668806,691
10777,3510781595,3498803823,1672566277,1672567865,1588
11435,3483347530,3623067708,1672692398,1672694870,2472
11088,3555954355,3488931357,1672685275,1672688122,2847
11600,3453538201,3400186699,1672599785,1672602289,2504
10275,3975796415,3600171014,1672629065,1672631186,2121
11421,3783947742,3519174861,1672567288,1672570683,3395
9797,3447948483,3803996569,1672703728,1672705603,1875
10609,3633622298,3208962614,1672578695,1672579162,467
10658,3301489209,3500019810,1672700660,1672701293,633
9996,3669140241,3496579251,1672617067,1672620567,3500
10970,3423147369,3624365837,1672617276,1672618608,1332
11394,3819400315,3353326305,1672580324,1672580628,304
10513,3369810091,3377250778,1672676382,1672677931,1549
10491,3770981604,3480185839,1672577646,1672579498,1852
11678,3687183789,3770544738,1672547660,1672550601,2941
11034,3668681400,3822634862,1672559993,1672562307,2314
10323,3713102459,3760801237,1672552540,1672552999,459
9821,3486509752,3755729826,1672666749,1672668749,2000
10914,3380285779,3701512498,1672670201,1672671263,1062
11690,3205324639,3716179251,1672672677,1672676080,3403
10292,3783506190,3928421417,1672533639,1672534758,1119
11778,3711518637,3711856534,1672595704,1672596530,826
10431,3357074700,3475845921,1672677303,1672680701,3398
11365,3715246385,3703588004,1672599720,1672602107,2387
10608,3884192843,3773161055,1672696245,1672698620,2375
10208,3772425253,3902300755,1672600390,1672601644,1254
11610,3850005949,3238779889,1672649137,1672650627,1490
10972,3444453261,3229570647,1672657086,1672660496,3410
11579,3311989687,3896123242,1672656246,1672656705,459
11091,3514216460,3371759126,1672660479,1672664054,3575
10247,3898965585,3499820963,1672534574,1672535954,1380
11520,3793699467,3703336988,1672567424,1672568431,1007
10883,3793232021,3714116241,1672645869,1672648821,2952
9935,3239082508,3311924005,1672568975,1672569935,960
10703,3710397477,3470997293,1672602986,1672605955,2969
11639,3711223297,3734233216,1672554382,1672556961,2579
11709,3976400190,3792432763,1672633863,1672635477,1614
10533,3434452046,3792075871,1672677059,1672677776,717
10105,3342368576,3473706746,1672686172,1672688356,2184
10475,3276499910,3380167818,1672585585,1672586620,1035
10175,3837888196,3238056215,1672662550,1672664265,1715
11286,3837885956,3793987483,1672635615,1672636474,859
10394,3783730769,3505756991,1672697378,1672698459,1081
11268,3510484107,3888903181,1672621563,1672624806,3243
11492,3465107990,3512596743,1672584569,1672586133,1564
11496,3780482864,3500595432,1672661021,1672663616,2595
10994,3688845298,3513800589,1672632641,1672635837,3196
11455,3307216611,3714919471,1672589715,1672591341,1626
11491,3519922921,3621960662,1672699601,1672702211,2610
11445,3512337054,3711287751,1672548018,1672549150,1132
11715,3500120676,3472901378,1672701344,1672702007,663
10368,3777370992,3515838621,1672570241,1672572572,2331
10640,3777937949,3471585513,1672699385,1672701234,1849
9869,3424997707,3817076003,1672593381,1672594005,624
11783,3907923381,3450164574,1672591988,1672592100,112
11205,3772962072,3534174363,1672654297,1672655285,988
10352,3894328297,3714516404,1672551998,1672554493,2495
11345,3398021818,3478937459,1672667610,1672669288,1678
11434,3778125688,3619796619,1672698608,1672701841,3233
10925,3756843139,3201920708,1672644053,1672644565,512
11367,3514353133,3783430498,1672682567,1672685985,3418
10557,3305656670,3520273299,1672533799,1672537288,3489
9883,3405200303,3807717766,1672628172,1672629441,1269
10154,3668202976,3713954144,1672664259,1672664384,125
10808,3392573386,3475090917,1672695116,1672698048,2932
10694,3236948071,3397330170,1672664390,1672665286,896
10454,3271389160,3912862842,1672588355,1672590661,2306
10014,3681504869,3444646562,1672538112,1672538931,819
11094,3392573386,3505769529,1672605450,1672607298,1848
10242,3505887814,3467756698,1672593630,1672596256,2626
11364,3773798215,3818461836,1672605681,1672608288,2607
11571,3494748808,3314965818,1672625942,1672627540,1598
10532,3780511388,3491239350,1672690149,1672692921,2772
11544,3714688409,3772489471,1672650561,1672653199,2638
10088,3773134128,3533030343,1672592864,1672596316,3452
11116,3792475476,3496352027,1672552711,1672555851,3140
10800,3827889533,3703588004,1672642152,1672643121,969
10644,3737571883,3834424604,1672701189,1672701273,84
10408,3774652449,3434581257,1672654215,1672656990,2775
10640,3978643889,3512726649,1672695598,1672698971,3373
10439,3827836825,3519055736,1672559919,1672561695,1776
9804,3519015940,3710228292,1672569954,1672570445,491
10252,3520022175,3893932944,1672668458,1672669148,690
11091,3351856699,3783563043,1672543023,1672543557,534
11659,3936851114,3505164060,1672681793,1672685083,3290
10450,3533642281,3390537737,1672549646,1672551318,1672
10855,3783408469,3423147369,1672666428,1672668179,1751
11773,3735422623,3473520701,1672583654,1672586542,2888
10337,3554317844,3823307824,1672549579,1672552875,3296
10541,3777370992,3387971464,1672649762,1672650266,504
11040,3773041843,3514541800,1672622063,1672624419,2356
10351,3534111498,3701596047,1672544497,1672546354,1857
11360,3515974881,3512072679,1672578721,1672581359,2638
10504,3492350318,3500433278,1672546304,1672547437,1133
11057,3467415939,3203457161,1672701073,1672702524,1451
10075,3505037247,3711856534,1672680636,1672683396,2760
9947,3757549235,3669283586,1672628524,1672629647,1123
11484,3701971784,3510301454,1672650674,1672653892,3218
10515,3551833298,3682086200,1672566365,1672566954,589
10662,3418791124,3755203055,1672683157,1672684671,1514
10977,3783373085,3814672661,1672573000,1672574999,1999
11706,3689386663,3302988745,1672603774,1672605298,1524
9805,3235313062,3534374523,1672567476,1672571018,3542
11782,3909632424,3228465044,1672593492,1672595831,2339
10342,3374348845,3756759239,1672658790,1672659757,967
11739,3711076751,3520009158,1672650905,1672653875,2970
11282,3883640904,3430823498,1672541071,1672541663,592
9903,3711040761,3623894390,1672687039,1672689479,2440
11475,3773697080,3812261241,1672533566,1672534301,735
10308,3939882169,3912811715,1672543301,1672545608,2307
10963,3760966645,3287760230,1672696992,1672697732,740
11194,3520057139,3512495325,1672648766,1672650556,1790
11369,3501873139,3703168159,1672564441,1672567169,2728
10921,3713444403,3472901378,1672621836,1672621937,101
11374,3730115019,3666823095,1672615944,1672618406,2462
11717,3770018912,3304447950,1672643879,1672645924,2045
10479,3760397450,3443521234,1672649982,1672652103,2121
10740,3896840409,3509626590,1672692664,1672694956,2292
11468,3810818108,3509431396,1672687549,1672688050,501
11406,3371759126,3399173821,1672681326,1672682705,1379
11318,3389069291,3832312129,1672611395,1672614977,3582
11212,3462645981,3807111856,1672592028,1672594002,1974
10698,3772909073,3770180844,1672584891,1672587091,2200
11167,3482519872,3518209090,1672652323,1672654313,1990
9833,3909504515,3311583437,1672641788,1672643833,2045
9905,3711243126,3880030249,1672693149,1672694374,1225
11584,3739387948,3780129338,1672662149,1672665260,3111
10473,3511864772,3791332061,1672552855,1672553644,789
10483,3760541837,3823307824,1672545718,1672546222,504
10541,3501427691,3770180844,1672563353,1672566947,3594
11779,3416105769,3886957097,1672596422,1672597588,1166
11718,3555378248,3203909360,1672602279,1672604843,2564
10450,3783060739,3885645840,1672570837,1672573879,3042
9990,3430296808,3755584983,1672692542,1672694519,1977
10211,3311521176,3500776597,1672593087,1672596545,3458
11788,3756079870,3406492167,1672628954,1672630552,1598
10687,3970775805,3515259326,1672634998,1672638138,3140
10857,3681504869,3791758175,1672579650,1672580926,1276
10881,3880030249,3519034304,1672578047,1672581151,3104
10394,3826542169,3500555856,1672703075,1672705848,2773
10341,3505901826,3856601074,1672585723,1672588806,3083
11141,3518058151,3446810761,1672653143,1672653368,225
10277,3791628195,3912862842,1672589915,1672592796,2881
11200,3445355677,3304227085,1672631503,1672631986,483
11045,3534426696,3783373085,1672681619,1672682840,1221
11399,3500405175,3715282492,1672615221,1672617517,2296
9941,3517949586,3714283424,1672623500,1672626934,3434
9956,3933562725,3243056734,1672642347,1672644828,2481
10451,3935444008,3515304526,1672699058,1672701694,2636
11279,3295787354,3394394262,1672536862,1672537404,542
10480,3621591266,3715291931,1672542652,1672543227,575
11275,3903115138,3901217668,1672572070,1672572685,615
11119,3516486526,3773876312,1672561645,1672563151,1506
9804,3783043770,3666367524,1672625778,1672628634,2856
10276,3714281210,3714883746,1672648490,1672648640,150
11499,3246062632,3334381941,1672531450,1672532322,872
11331,3780680252,3881012415,1672596460,1672597010,550
11247,3282053097,3854390432,1672535556,1672538818,3262
10760,3517756624,3757604311,1672690319,1672693329,3010
11664,3855440101,3515802579,1672701686,1672703346,1660
9915,3420854927,3517816581,1672622464,1672625212,2748
11559,3732846295,3703443664,1672537377,1672538431,1054
10715,3617135064,3838748301,1672603241,1672605765,2524
11333,3360783381,3714516404,1672688743,1672689085,342
9848,3515558215,3517718901,1672693329,1672693911,582
11177,3339649817,3512681214,1672558726,1672561414,2688
10693,3393543588,3418997135,1672607877,1672610063,2186
11238,3338187803,3300810210,1672696097,1672696219,122
11077,3711718368,3500785888,1672654902,1672658425,3523
10395,3805268739,3907245259,1672592769,1672593836,1067
11547,3852275715,3793442891,1672623636,1672625242,1606
10309,3404187438,3850005949,1672602215,1672604519,2304
11140,3880030249,3665431349,1672635001,1672635133,132
10355,3509544691,3915652382,1672635727,1672637642,1915
11171,3372778334,3483078667,1672553922,1672557197,3275
11788,3453164933,3713031958,1672632918,1672633214,296
11723,3711938229,3931164237,1672659017,1672660725,1708
10538,3495427619,3897186782,1672653639,1672655886,2247
10669,3780563627,3776407517,1672661920,1672665502,3582
11512,3755411110,3780352400,1672551203,1672553509,2306
11161,3515753241,3713100169,1672584424,1672586150,1726
10786,3475653510,3511364193,1672687828,1672689935,2107
10087,3713475356,3203954795,1672637033,1672637776,743
11459,3605078841,3793987483,1672531386,1672534225,2839
10095,3701663839,3760096466,1672550561,1672551391,830
10942,3792162098,3716595760,1672596084,1672599682,3598
9861,3756272704,3703419800,1672534941,1672536517,1576
10544,3417360319,3885545415,1672622012,1672625217,3205
11641,3283106998,3716195780,1672610323,1672610494,171
9802,3715140418,3701519251,1672645517,1672648653,3136
11698,3755584983,3387971464,1672666869,1672669233,2364
10581,3515706117,3461877104,1672624687,1672625152,465
10823,3760997159,3355880028,1672644616,1672647932,3316
11472,3760396348,3515970536,1672545277,1672547303,2026
9875,3971282455,3779689733,1672646341,1672648592,2251
11279,3513508737,3686853863,1672641211,1672641371,160
10692,3760322661,3310961923,1672659037,1672661918,2881
11615,3779748270,3204821370,1672614677,1672617466,2789
11333,3703742071,3882580580,1672664314,1672667475,3161
10339,3533859712,3783809405,1672694256,1672695224,968
10956,3204473480,3760274119,1672565342,1672567181,1839
10617,3227919286,3780576351,1672678696,1672680075,1379
11254,3857609616,3513816744,1672545052,1672545320,268
9976,3515047288,3513890046,1672551806,1672552430,624
10944,3291153514,3291936679,1672615375,1672617732,2357
10632,3510864325,3933469838,1672538907,1672542267,3360
9949,3461743188,3468343480,1672595819,1672599324,3505
11534,3516965624,3513859809,1672578647,1672579585,938
11227,3520926977,3852161626,1672593492,1672595495,2003
11608,3806471413,3274223335,1672533175,1672536027,2852
9979,3737946004,3971422524,1672605379,1672606672,1293
10885,3907923381,3311231911,1672542564,1672545711,3147
10856,3701359045,3450234157,1672626845,1672626997,152
10690,3904045870,3399726243,1672675523,1672678290,2767
10130,3780749789,3424988692,1672662534,1672663540,1006
10603,3445172440,3738103378,1672580969,1672583637,2668
11723,3225554956,3757855416,1672630464,1672632631,2167
11665,3338016147,3716341323,1672578552,1672581630,3078
11713,3793442891,3380628097,1672702208,1672705312,3104
10123,3779723939,3514638555,1672653576,1672655188,1612
11309,3730459093,3511245705,1672546322,1672548840,2518
10099,3613703906,3804779247,1672656955,1672659022,2067
11371,3907039612,3757407184,1672681975,1672684686,2711
10251,3772234939,3778182724,1672555981,1672558464,2483
10734,3518572231,3514297012,1672533186,1672534728,1542
10229,3534362749,3772489471,1672597977,1672599701,1724
10305,3533440736,3313824913,1672582314,1672583659,1345
10461,3304227085,3236206821,1672641232,1672644353,3121
10882,3710819760,3608214600,1672670096,1672670247,151
11692,3776125503,3792824886,1672582029,1672583478,1449
10936,3509018337,3755170743,1672596683,1672597756,1073
9844,3285587972,3461877104,1672637272,1672638646,1374
10831,3755502373,3514564903,1672536937,1672540101,3164
10598,3488399075,3973138649,1672540660,1672543393,2733
11420,3778182724,3737467358,1672561813,1672562728,915
10754,3884191432,3311472321,1672637559,1672638741,1182
11665,3339478490,3247193800,1672547321,1672548836,1515
10450,3513545735,3732090606,1672611222,1672613198,1976
9821,3514145752,3360949039,1672595030,1672596618,1588
11419,3519924982,3880882684,1672619566,1672622830,3264
11566,3519162582,3408828584,1672576101,1672577453,1352
11029,3505709407,3886879696,1672588468,1672590720,2252
11551,3518572231,3511245705,1672642513,1672643780,1267
10675,3836586875,3372617110,1672620314,1672620761,447
10303,3244397548,3511003541,1672638186,1672639858,1672
10430,3756763585,3501548163,1672607023,1672608470,1447
10871,3517499844,3534624672,1672597940,1672599623,1683
9918,3824135033,3791584994,1672672758,1672673066,308
10457,3609335008,3309178914,1672562097,1672565226,3129
9848,3791796190,3500640854,1672537971,1672539719,1748
10375,3783563043,3512417028,1672661902,1672664531,2629
10771,3477582923,3519521903,1672536233,1672536607,374
10856,3838748301,3534941710,1672649967,1672652007,2040
10597,3497138014,3287689454,1672671290,1672673319,2029
10130,3209958726,3354015456,1672683041,1672685719,2678
9814,3716095450,3511206717,1672619500,1672621214,1714
10767,3510254698,3738526914,1672556002,1672557452,1450
11430,3465227623,3380357490,1672645292,1672648340,3048
11686,3880562532,3703818358,1672661713,1672663478,1765
10482,3827889533,3337715675,1672638708,1672640211,1503
11410,3755688231,3776841808,1672578128,1672580179,2051
10911,3361926328,3474879231,1672651566,1672653591,2025
10880,3791548838,3903879740,1672604688,1672606307,1619
10140,3773853619,3311959533,1672646414,1672648374,1960
10888,3505173665,3711404205,1672648399,1672651465,3066
10173,3382757142,3620836520,1672668153,1672671435,3282
10380,3667950469,3400545490,1672664355,1672664714,359
11155,3774236212,3703502114,1672692454,1672692999,545
10993,3686211958,3715858201,1672644305,1672647034,2729
11109,3711287751,3291936679,1672605585,1672606353,768
11714,3500741534,3613547091,1672574301,1672574633,332
10974,3429587594,3520625600,1672537434,1672537565,131
10286,3311805161,3914947393,1672622442,1672624324,1882
10076,3505183641,3701004302,1672651557,1672653671,2114
10134,3715680249,3553694590,1672689966,1672692516,2550
11128,3612841103,3519351747,1672622197,1672625049,2852
11639,3810949170,3778544203,1672589527,1672592191,2664
10445,3208962614,3516335333,1672606158,1672606917,759
10203,3510209505,3304447950,1672627224,1672627500,276
10438,3807111856,3919258737,1672618185,1672620959,2774
10139,3335055096,3703502114,1672553018,1672554302,1284
11780,3777304517,3780941637,1672602735,1672605255,2520
10849,3375906394,3756616853,1672677326,1672677838,512
10989,3505496725,3685083275,1672662303,1672664948,2645
11356,3384001094,3711844574,1672669682,1672671896,2214
10637,3715106566,3773523569,1672600747,1672603675,2928
9893,3415803494,3515096959,1672639672,1672643260,3588
10277,3755203055,3791644831,1672639809,1672640946,1137
9830,3533627473,3711862792,1672571679,1672575235,3556
10833,3516792348,3501515425,1672578958,1672581170,2212
11109,3701567668,3238796398,1672612212,1672613740,1528
10187,3515507526,3432838598,1672692115,1672694895,2780
9849,3270502801,3776732532,1672668898,1672669953,1055
11156,3932919664,3928076270,1672565934,1672566802,868
11649,3792162098,3509556649,1672543284,1672546461,3177
11570,3519255644,3818570577,1672571631,1672571937,306
10406,3364660506,3516167000,1672645259,1672646035,776
10821,3233993993,3713805968,1672569660,1672572033,2373
10105,3519689906,3512753567,1672614124,1672616911,2787
11187,3812880543,3971051020,1672669595,1672671316,1721
10322,3306066522,3760966645,1672578678,1672579541,863
10605,3818324410,3778927933,1672654524,1672657770,3246
10518,3880030249,3701956841,1672623467,1672626431,2964
9802,3972856326,3558203963,1672629518,1672632210,2692
11670,3514628916,3418683594,1672554354,1672557817,3463
10957,3757393413,3533037906,1672614792,1672616569,1777
11238,3928421417,3516378356,1672670000,1672672178,2178
11064,3755170743,3440671139,1672634955,1672635743,788
10659,3279731391,3208594306,1672577692,1672578174,482
10068,3313101243,3716183063,1672531758,1672533902,2144
11102,3935569749,3534372899,1672545359,1672545549,190
10302,3513624915,3400112498,1672585899,1672589371,3472
11055,3831864108,3201957157,1672547413,1672547730,317
11686,3439662051,3479910993,1672674277,1672677180,2903
11108,3833520635,3773876312,1672679865,1672680157,292
9813,3371759044,3500833053,1672543296,1672545271,1975
10623,3933872044,3770925016,1672549539,1672550316,777
10662,3757869138,3244395841,1672641709,1672644569,2860
10453,3511364193,3512555384,1672631636,1672634909,3273
10234,3389069291,3783679478,1672606595,1672607195,600
11595,3516321993,3639503148,1672608024,1672610103,2079
11354,3778817220,3520553959,1672647796,1672648842,1046
10093,3776901443,3773736248,1672611877,1672613854,1977
10677,3776200012,3772905073,1672577165,1672579306,2141
11734,3514698862,3465227623,1672576481,1672578048,1567
11119,3514306458,3510233949,1672625328,1672627510,2182
11297,3667950469,3299587876,1672638476,1672641805,3329
10603,3446764595,3839308659,1672637285,1672640818,3533
10349,3367202274,3737622701,1672583962,1672586075,2113
10888,3793874490,3500596577,1672586748,1672587930,1182
10382,3333505404,3713566527,1672693254,1672696767,3513
11234,3286938590,3760080378,1672653200,1672653487,287
11043,3919984986,3241855333,1672622363,1672624936,2573
11423,3407734098,3514776568,1672594479,1672597809,3330
11536,3776187150,3755203055,1672570595,1672571392,797
10179,3780352400,3686644062,1672536295,1672539390,3095
9882,3516731917,3418997135,1672564363,1672564577,214
10970,3779930476,3855629383,1672676081,1672676647,566
9808,3907039612,3500909455,1672673218,1672674840,1622
9819,3807646028,3505811269,1672597947,1672599202,1255
11668,3510178791,3517552930,1672577978,1672580098,2120
11610,3516588277,3922153821,1672631575,1672633700,2125
11179,3227956115,3613781977,1672657883,1672660690,2807
11456,3314363575,3501988762,1672577964,1672580112,2148
11074,3485468650,3777063455,1672639218,1672641251,2033
10887,3774325486,3479910993,1672578807,1672581326,2519
9829,3703438617,3275661834,1672651481,1672651626,145
10725,3509445318,3313101243,1672632944,1672633592,648
11605,3519228207,3777641081,1672613926,1672616110,2184
11557,3517331746,3519341916,1672608629,1672610985,2356
10413,3276499910,3793783685,1672686559,1672687663,1104
11313,3468343480,3783172505,1672669591,1672672513,2922
11043,3639926564,3427741923,1672649157,1672649762,605
10285,3425545115,3711430738,1672586287,1672587035,748
10563,3931028233,3282053097,1672688075,1672690901,2826
9892,3357074700,3703737650,1672556470,1672557197,727
11777,3505140123,3514776568,1672668992,1672670144,1152
11681,3701412729,3711836873,1672638857,1672640834,1977
10668,3977337501,3660496328,1672627654,1672630913,3259
11436,3838119022,3236948071,1672661808,1672665344,3536
11102,3773376762,3776811587,1672657297,1672658784,1487
11074,3780050146,3500015630,1672667235,1672668455,1220
11592,3462645981,3233712975,1672701658,1672704320,2662
9796,3519174861,3713224986,1672546737,1672549239,2502
11041,3710813103,3711959141,1672554823,1672558365,3542
11251,3481365330,3793407883,1672617164,1672618397,1233
10707,3791289855,3776125503,1672588103,1672590131,2028
10133,3516153301,3738760498,1672538349,1672540223,1874
10851,3510206323,3713514933,1672635141,1672638528,3387
10624,3780287649,3553694590,1672592800,1672594980,2180
10090,3910354786,3305727497,1672637488,1672639200,1712
10330,3756850160,3468201976,1672659569,1672661609,2040
10723,3519059808,3713416756,1672573092,1672576348,3256
10542,3938409715,3534174363,1672613710,1672616602,2892
10394,3686081254,3774251051,1672607832,1672610623,2791
11718,3931028233,3485521840,1672553012,1672554635,1623
11257,3206377955,3304697982,1672538884,1672540192,1308
11617,3855674398,3206544535,1672594450,1672597570,3120
10254,3851451801,3511466117,1672576363,1672579058,2695
9974,3245774173,3633294415,1672663473,1672664408,935
11482,3715590997,3500011591,1672583769,1672585136,1367
10351,3382696725,3426207439,1672703670,1672706319,2649
11701,3273758330,3703443664,1672647003,1672649522,2519
10848,3931917809,3476958001,1672543142,1672545128,1986
10500,3895507040,3311432176,1672677907,1672679632,1725
11756,3500889287,3776053084,1672569480,1672570417,937
10584,3792987243,3311472321,1672635734,1672639123,3389
10833,3713434898,3772689657,1672664267,1672666146,1879
11208,3435159896,3505234868,1672540191,1672540509,318
10732,3600441934,3519831322,1672543236,1672546820,3584
10866,3203909360,3757311529,1672557989,1672558208,219
10470,3480259863,3662821438,1672542627,1672543041,414
10619,3933872044,3368079099,1672546712,1672549080,2368
10486,3904846341,3519922921,1672599231,1672602268,3037
10298,3533440294,3513508737,1672615249,1672616361,1112
10161,3485151614,3824657614,1672683511,1672684543,1032
11771,3372236721,3835599049,1672569139,1672569466,327
10161,3534562354,3368951504,1672650848,1672654044,3196
10989,3932566114,3918981936,1672595547,1672596799,1252
11480,3770671714,3792597493,1672664608,1672665260,652
9851,3421524698,3373135211,1672662776,1672664908,2132
10331,3772943811,3772905073,1672660207,1672661334,1127
10952,3760271237,3520016705,1672681011,1672683785,2774
10504,3517645656,3515681585,1672655355,1672658490,3135
10155,3907923381,3312946269,1672614403,1672615227,824
11692,3974400577,3621439107,1672604999,1672605374,375
10716,3361952532,3468343480,1672536980,1672539435,2455
10356,3716468783,3773697080,1672570049,1672571189,1140
9827,3500178849,3272827860,1672606121,1672607862,1741
10890,3905571273,3756736726,1672636305,1672638299,1994
11456,3517113478,3500019810,1672538062,1672538247,185
11547,3774483862,3381254180,1672648767,1672650446,1679
9883,3500734346,3316821313,1672628439,1672629674,1235
11399,3291153514,3772320856,1672610871,1672613901,3030
10840,3430310785,3360309868,1672554759,1672557531,2772
11323,3271762055,3711219767,1672553909,1672555846,1937
10293,3938021614,3284829602,1672548044,1672551146,3102
10380,3793375825,3533473206,1672568541,1672571243,2702
11604,3710147457,3374552204,1672619555,1672620199,644
10658,3899970524,3792173463,1672686696,1672688703,2007
10347,3611298237,3428076194,1672550251,1672551057,806
10351,3512596743,3701385831,1672682923,1672685962,3039
10241,3928421417,3779312237,1672556662,1672558865,2203
9803,3348100657,3760274119,1672559812,1672560103,291
11664,3633622298,3713906305,1672574242,1672576116,1874
11275,3713807459,3509433155,1672703116,1672704352,1236
11528,3915652382,3734233216,1672702715,1672704357,1642
11168,3776561263,3713476192,1672630625,1672633147,2522
11683,3667814788,3514329209,1672563919,1672566013,2094
11235,3920606331,3853275529,1672542093,1672545640,3547
10331,3908464960,3603682643,1672681616,1672682023,407
9866,3773848111,3518209090,1672649098,1672649562,464
11376,3739395381,3498857406,1672635560,1672636918,1358
10140,3773134128,3534506090,1672650480,1672652956,2476
10682,3756616853,3397527886,1672548840,1672551764,2924
9880,3302988745,3552444228,1672584073,1672585813,1740
10922,3716841469,3501853868,1672559954,1672562113,2159
11629,3500974385,3496407500,1672673872,1672677143,3271
11474,3716669659,3303747093,1672686956,1672689382,2426
10024,3903088144,3773394570,1672564629,1672565020,391
9983,3500456339,3885545415,1672619433,1672621204,1771
10221,3517440258,3500863429,1672684049,1672686941,2892
10058,3793926338,3271719569,1672572269,1672575205,2936
10424,3294164983,3772909073,1672588477,1672590375,1898
10369,3711722554,3378747834,1672531826,1672533092,1266
10931,3270502801,3773848111,1672691356,1672693475,2119
11283,3511908639,3897003751,1672623094,1672626098,3004
11394,3715419141,3362706073,1672638196,1672639638,1442
11546,3732312480,3517645656,1672636414,1672637816,1402
11558,3730935770,3236512807,1672625793,1672626431,638
9877,3682086200,3509431396,1672693322,1672695976,2654
10213,3939422411,3713566527,1672689584,1672692289,2705
9886,3514361485,3858330969,1672686028,1672686602,574
10341,3372596013,3414841458,1672588403,1672591852,3449
11676,3714101349,3779815753,1672658660,1672660521,1861
11467,3756717136,3387971464,1672575882,1672576754,872
11768,3815700240,3518058151,1672592181,1672593517,1336
10235,3393909269,3662307789,1672621302,1672621454,152
10429,3500909455,3342426430,1672655631,1672657545,1914
11021,3972196462,3512395783,1672584121,1672585617,1496
10154,3905934770,3461877104,1672699542,1672701949,2407
10429,3793704155,3713141087,1672605727,1672607524,1797
11476,3773895671,3318224774,1672690864,1672690983,119
10272,3512306195,3509360869,1672616438,1672619251,2813
11697,3519260216,3514576083,1672676990,1672677396,406
10211,3340723781,3514297012,1672596444,1672597632,1188
11753,3342545285,3903115138,1672641523,1672643293,1770
11118,3439651226,3350169064,1672593221,1672595985,2764
10859,3505786561,3393128259,1672567875,1672568784,909
11088,3779174993,3835982340,1672613641,1672613842,201
10190,3666958814,3780680252,1672547550,1672550491,2941
9932,3517992521,3311159418,1672686831,1672688084,1253
10611,3313502623,3519621901,1672534603,1672538152,3549
10691,3413236071,3203876438,1672697630,1672699990,2360
10345,3756066765,3510781595,1672632280,1672632612,332
10741,3908883591,3793497672,1672532094,1672533025,931
11104,3398151217,3716179251,1672615834,1672617883,2049
11336,3435159896,3772250554,1672607993,1672609546,1553
10331,3533929043,3512768285,1672548355,1672550388,2033
10570,3813276198,3977615973,1672551720,1672553917,2197
10261,3372596013,3500096103,1672543622,1672545229,1607
11735,3715441777,3512343029,1672626351,1672629684,3333
11315,3309455369,3491250381,1672660649,1672663541,2892
10808,3355899481,3639503148,1672569375,1672570215,840
11309,3776291254,3710819760,1672578789,1672581175,2386
9949,3777932225,3405303958,1672596921,1672599323,2402
9971,3272827860,3390368796,1672582755,1672584329,1574
11063,3501356814,3852275715,1672617667,1672619823,2156
10071,3500640854,3377311502,1672582764,1672584230,1466
9811,3710807030,3779604279,1672536054,1672537757,1703
11124,3501901313,3389069291,1672572763,1672575904,3141
10102,3363549860,3777060250,1672573850,1672576515,2665
11214,3517469005,3520022175,1672577499,1672580426,2927
11143,3482687604,3229734741,1672641582,1672643736,2154
9842,3714471069,3369938668,1672666573,1672669383,2810
10667,3715590997,3517617472,1672598106,1672600730,2624
11583,3310712221,3772112976,1672676425,1672677520,1095
11159,3772070986,3701512498,1672532667,1672534994,2327
11721,3773041843,3517617472,1672595105,1672598104,2999
10517,3519162582,3500198430,1672669052,1672672448,3396
10284,3791664049,3818324410,1672609951,1672613536,3585
10887,3715140418,3519997661,1672584802,1672587184,2382
11672,3368951504,3367109648,1672572394,1672573943,1549
10203,3805616707,3756668747,1672700700,1672700868,168
10736,3514361485,3793948300,1672671765,1672673946,2181
10012,3514508773,3285136057,1672605991,1672609459,3468
11132,3713990030,3476958001,1672644884,1672645518,634
10738,3445733121,3495482863,1672560946,1672561540,594
10519,3735679000,3294952405,1672634499,1672638031,3532
10510,3687024828,3820422111,1672640004,1672643144,3140
10956,3387989658,3441737317,1672671881,1672673535,1654
11481,3406238754,3518058151,1672698010,1672700428,2418
10566,3774673193,3907225070,1672555908,1672556046,138
11316,3778986795,3407734098,1672563989,1672566735,2746
9986,3439045964,3517718901,1672578010,1672581377,3367
11779,3480405740,3505720915,1672679291,1672681295,2004
10459,3500928990,3510486220,1672676400,1672677469,1069
11419,3330799389,3473562779,1672617087,1672617923,836
10135,3822496670,3493598658,1672625363,1672628234,2871
9905,3284865931,3932955949,1672701613,1672704855,3242
11504,3667072319,3924583142,1672601975,1672604215,2240
11349,3246804115,3665478011,1672568085,1672571571,3486
10731,3756119976,3516444589,1672592473,1672595984,3511
11004,3703572036,3776304080,1672572470,1672574716,2246
10232,3975796415,3711367577,1672648133,1672651540,3407
11183,3668955834,3777932581,1672625257,1672628291,3034
10195,3534869444,3714281795,1672610668,1672612817,2149
10454,3802757611,3933562725,1672625277,1672625996,719
10188,3271762055,3400025324,1672672303,1672673570,1267
11734,3406937294,3373851012,1672698193,1672699615,1422
10855,3911431642,3756736726,1672567784,1672568958,1174
9850,3373677765,3447948483,1672594971,1672597735,2764
10022,3379517265,3778100960,1672646824,1672649092,2268
10020,3462153833,3459163055,1672551664,1672555082,3418
10092,3780423516,3839308659,1672693171,1672696551,3380
10012,3516340010,3516321814,1672559071,1672559512,441
11583,3340723781,3777499535,1672531715,1672532048,333
10165,3505521491,3501873139,1672661776,1672662487,711
11749,3345896913,3857909328,1672607868,1672610042,2174
10498,3935256825,3701004302,1672574987,1672577438,2451
10057,3505665253,3440305508,1672557540,1672558174,634
10708,3439651226,3534531061,1672589702,1672589816,114
9823,3439662051,3624365837,1672624054,1672624774,720
11717,3639503148,3939851140,1672650392,1672652096,1704
10663,3359472956,3821082558,1672674561,1672676999,2438
10133,3791409441,3501554468,1672687735,1672688189,454
11283,3519965717,3703419800,1672612465,1672613777,1312
10438,3899756737,3519351747,1672573228,1672574817,1589
11204,3773826624,3279851026,1672621377,1672621926,549
10792,3534174363,3829412384,1672660602,1672662960,2358
11469,3755502373,3517943697,1672678335,1672681637,3302
10761,3714903456,3756066765,1672589710,1672589847,137
10588,3511245705,3832002939,1672608529,1672610897,2368
10427,3505500665,3382308738,1672595565,1672598080,2515
10957,3701519251,3756119976,1672537475,1672537562,87
11148,3511608609,3777498160,1672570636,1672573611,2975
10452,3776593726,3514297012,1672702813,1672704150,1337
10538,3716669659,3903879740,1672632961,1672635218,2257
11269,3517426473,3513215373,1672583970,1672587500,3530
11586,3517558635,3703849264,1672578511,1672579642,1131
11118,3616371564,3311583437,1672697968,1672699037,1069
10500,3487988841,3903065952,1672609069,1672609144,75
10411,3436774112,3756717136,1672687402,1672690293,2891
11368,3773408491,3505496725,1672583385,1672585927,2542
10348,3480560014,3772556646,1672563210,1672564601,1391
11684,3714892312,3665431349,1672671666,1672675000,3334
10724,3436018575,3779282072,1672695222,1672696425,1203
10388,3510149298,3364067937,1672682639,1672684929,2290
10211,3792267993,3686081254,1672599875,1672602758,2883
11162,3436099135,3513894659,1672634905,1672636763,1858
10279,3793222045,3505248368,1672671434,1672673941,2507
11695,3517949586,3780982229,1672581934,1672582029,95
10264,3772169046,3360837082,1672658400,1672660669,2269
9892,3662821438,3777204977,1672671590,1672673815,2225
11342,3423800775,3827836825,1672659618,1672660921,1303
11062,3826542169,3779818784,1672575849,1672578753,2904
10441,3685396470,3369482983,1672678817,1672682384,3567
9903,3442462115,3367526113,1672596718,1672599958,3240
11753,3519513219,3791522832,1672629101,1672629943,842
10912,3509556649,3838039092,1672545094,1672545814,720
10276,3520145112,3520506192,1672619365,1672622640,3275
10875,3520305100,3776279305,1672561317,1672563569,2252
11297,3778713526,3668955834,1672666377,1672669100,2723
10902,3711258452,3515507526,1672616371,1672616956,585
11382,3403150349,3516454693,1672564793,1672564950,157
11760,3857389270,3820922991,1672674345,1672677806,3461
9893,3884862164,3512697456,1672663147,1672666747,3600
11673,3514515499,3668855144,1672567429,1672570777,3348
10857,3483078667,3901217668,1672696728,1672696942,214
11028,3917811545,3610517436,1672552985,1672554289,1304
10325,3688130094,3372778334,1672648206,1672651656,3450
10307,3510159441,3227874229,1672551601,1672552884,1283
9955,3835509670,3897500723,1672656012,1672658655,2643
11159,3513629502,3791359168,1672543620,1672547184,3564
9903,3628423403,3800434325,1672690610,1672693026,2416
10912,3511458926,3896211741,1672555999,1672558460,2461
10632,3977337501,3713878219,1672572502,1672574191,1689
10568,3732312480,3780733404,1672620500,1672621022,522
11153,3773798215,3425545115,1672541156,1672543199,2043
9836,3274894848,3792440162,1672642748,1672645621,2873
10684,3772019557,3512768285,1672583886,1672587027,3141
11071,3778125688,3406937294,1672531416,1672534185,2769
11424,3342027511,3755729826,1672531841,1672534063,2222
11218,3772695548,3512417028,1672638822,1672641638,2816
10185,3609997804,3770023722,1672677780,1672681136,3356
10653,3803382101,3231859576,1672536989,1672540490,3501
10900,3856699097,3311231911,1672558354,1672561013,2659
10943,3334708091,3850108828,1672563044,1672566097,3053
9939,3773202954,3783594246,1672682031,1672682846,815
11325,3780612543,3701865589,1672587062,1672589066,2004
11418,3514761434,3510022922,1672590608,1672593070,2462
10416,3509274030,3686885442,1672603490,1672606905,3415
10206,3501980730,3500019810,1672654716,1672657719,3003
9915,3780612543,3463564410,1672567491,1672569295,1804
10284,3971289056,3732223664,1672664936,1672666065,1129
10027,3429610195,3550887623,1672581945,1672583938,1993
10279,3793274846,3881579907,1672679029,1672679117,88
10501,3310961923,3814770073,1672680576,1672683555,2979
11224,3793948300,3435037864,1672542788,1672545634,2846
10083,3701865589,3716467469,1672641691,1672644113,2422
10206,3500455935,3500994763,1672605135,1672607698,2563
11697,3703031637,3776200012,1672664666,1672666966,2300
11312,3513293711,3393376416,1672585866,1672586825,959
11095,3511729562,3348343425,1672548663,1672550535,1872
10943,3505482210,3710173412,1672678261,1672678843,582
11641,3437286595,3669918958,1672665519,1672665857,338
11385,3756948477,3343511947,1672609903,1672610225,322
11320,3332010532,3880637958,1672683859,1672684628,769
10192,3475845921,3519831322,1672549265,1672551815,2550
10279,3229615214,3240683148,1672660548,1672662956,2408
10954,3710125627,3510291656,1672670856,1672674317,3461
11613,3610517436,3550887623,1672577471,1672578239,768
10422,3343193067,3701655378,1672682093,1672684478,2385
10237,3713728777,3316821313,1672610403,1672613148,2745
11593,3297624618,3474097405,1672670263,1672671265,1002
11630,3911431642,3420854927,1672607147,1672610235,3088
9794,3501427691,3711810268,1672630564,1672632171,1607
10546,3516651799,3274223335,1672668322,1672669347,1025
11111,3779478448,3757713457,1672591008,1672593388,2380
10436,3779382417,3778924002,1672548269,1672549716,1447
10736,3439662051,3755924094,1672612968,1672615286,2318
9974,3812261241,3757201538,1672613127,1672616255,3128
11030,3756784813,3511750850,1672552487,1672554495,2008
11009,3510694464,3244098077,1672609698,1672610013,315
11721,3469663062,3519886257,1672537042,1672538476,1434
11086,3339478490,3505624416,1672615397,1672616128,731
11724,3738760498,3513586642,1672608500,1672608751,251
10450,3627377299,3433196933,1672594953,1672598027,3074
10115,3533642281,3365519448,1672541345,1672544218,2873
10922,3711131262,3776316903,1672659765,1672662255,2490
11727,3920116284,3839308659,1672677721,1672678875,1154
10834,3780563627,3505173665,1672542760,1672543353,593
10350,3929355087,3446218191,1672610598,1672611262,664
11436,3519712497,3515699732,1672688732,1672690952,2220
10656,3974400577,3780740477,1672591388,1672591881,493
11561,3779454060,3780129338,1672575883,1672578542,2659
10791,3803996569,3276393542,1672672613,1672675695,3082
11505,3760525465,3714688409,1672620295,1672620814,519
11375,3516249472,3533822490,1672599171,1672600783,1612
11408,3880000841,3804707712,1672613057,1672615565,2508
10293,3602054754,3773878451,1672532001,1672534179,2178
10579,3636877469,3278629965,1672690858,1672693299,2441
11083,3760107540,3480270940,1672547893,1672548895,1002
10076,3224053840,3779454060,1672698447,1672699888,1441
11155,3703588004,3511245705,1672565823,1672567547,1724
10483,3713219299,3340897079,1672622764,1672623797,1033
11655,3477511446,3856601074,1672664464,1672667570,3106
10269,3423346297,3519448648,1672644480,1672644898,418
10516,3283847934,3534770827,1672564165,1672566017,1852
11281,3534537581,3493679801,1672660834,1672662579,1745
11728,3776901443,3447696555,1672657563,1672659789,2226
10001,3770023722,3714455496,1672683605,1672684546,941
10288,3387322545,3714516404,1672542644,1672544847,2203
11339,3774205060,3772250554,1672685523,1672688660,3137
10630,3772461583,3703168159,1672702549,1672703646,1097
10164,3515802579,3500968729,1672560827,1672561000,173
10998,3779340538,3829358750,1672625783,1672628024,2241
10572,3757060033,3618024815,1672698592,1672699238,646
11695,3776440009,3381055770,1672659239,1672659882,643
10277,3620836520,3376487118,1672535048,1672537857,2809
10728,3515944817,3205161801,1672647156,1672650681,3525
10789,3294949958,3519065870,1672622854,1672623549,695
10664,3715441786,3516815069,1672632262,1672634556,2294
10042,3793497672,3636927297,1672581659,1672582999,1340
11006,3803996569,3349475873,1672695274,1672696002,728
10033,3778604070,3778044082,1672675546,1672678548,3002
11539,3505190512,3510694464,1672701753,1672702884,1131
11637,3755942724,3287734830,1672676866,1672677549,683
11505,3716445184,3977157565,1672533336,1672535029,1693
10886,3713878219,3204149913,1672618096,1672619397,1301
10120,3757584114,3510209505,1672644240,1672647782,3542
10636,3739075176,3777112124,1672627465,1672627652,187
11700,3715587520,3733411026,1672582545,1672585906,3361
10238,3855977674,3511289729,1672666969,1672670357,3388
11557,3305612422,3505291330,1672686615,1672688756,2141
10763,3394959062,3757728121,1672696351,1672697513,1162
10301,3402580733,3828906027,1672564867,1672568392,3525
10144,3229621693,3515970536,1672677159,1672679710,2551
10064,3735679000,3636852764,1672575378,1672576608,1230
9800,3756763585,3231859576,1672650536,1672651692,1156
11281,3660980656,3371184929,1672644711,1672647502,2791
11628,3500693568,3500011591,1672683536,1672686387,2851
9812,3514585995,3714951681,1672637009,1672639701,2692
10914,3710228292,3203630241,1672662269,1672663519,1250
10766,3821087562,3312946269,1672601815,1672601903,88
11087,3884192843,3812880543,1672561076,1672564230,3154
10275,3444453261,3772216305,1672549297,1672552888,3591
11331,3505331014,3500741005,1672542718,1672543346,628
10338,3683047199,3500720752,1672693505,1672694604,1099
10828,3534328311,3669140241,1672699764,1672700136,372
9922,3500421940,3442462115,1672596915,1672599665,2750
11166,3439283360,3533726421,1672549231,1672551809,2578
11260,3311583437,3755823805,1672538478,1672540303,1825
9853,3501927452,3519965717,1672580418,1672580797,379
10821,3364718040,3810949170,1672632707,1672632967,260
10357,3973582279,3511415786,1672580474,1672582306,1832
11745,3534284132,3520160414,1672636957,1672637960,1003
11126,3711243126,3387971464,1672662452,1672665337,2885
10102,3791994414,3510240661,1672607841,1672609198,1357
10183,3779706467,3783554600,1672559890,1672563197,3307
11270,3774205060,3444881567,1672648632,1672649520,888
10828,3613703906,3830599959,1672540009,1672543140,3131
10987,3791409441,3792255406,1672668718,1672672318,3600
9987,3772943811,3757855416,1672607804,1672608669,865
9996,3703168159,3520009158,1672667276,1672668362,1086
10880,3793029132,3245501577,1672584808,1672584915,107
11464,3487779363,3757378286,1672685009,1672685120,111
9893,3331228758,3515699732,1672593526,1672593988,462
11542,3509912164,3490008012,1672571709,1672574237,2528
11287,3755129708,3710228292,1672655144,1672657250,2106
11405,3612705426,3513486828,1672683111,1672685974,2863
11210,3774506868,3302348002,1672576099,1672576253,154
10325,3628423403,3431317400,1672598478,1672600781,2303
10363,3779382417,3450342110,1672667819,1672668613,794
10091,3469663062,3770486161,1672619660,1672622140,2480
11383,3830962592,3829761380,1672602961,1672605189,2228
9885,3479585868,3372236721,1672551277,1672553858,2581
10892,3235198316,3791863922,1672661773,1672662659,886
10128,3714892312,3713728777,1672606056,1672608493,2437
11505,3683677062,3559123082,1672643752,1672645200,1448
10626,3776950532,3341129425,1672654175,1672655802,1627
11054,3701540249,3359418136,1672695470,1672698973,3503
10720,3824135033,3371564186,1672537716,1672540690,2974
10025,3930475498,3290097447,1672643179,1672644250,1071
11380,3510153173,3780224882,1672666084,1672667823,1739
11277,3660496328,3509445318,1672642981,1672644407,1426
10470,3399726243,3632094087,1672588052,1672588368,316
10455,3311602936,3777751979,1672626476,1672628460,1984
11788,3514761434,3476144563,1672611769,1672612583,814
11136,3935444008,3511963020,1672533547,1672534475,928
11082,3515699732,3777928067,1672653797,1672655289,1492
11521,3438028077,3505496725,1672689098,1672692128,3030
9802,3703476890,3510919509,1672592117,1672593642,1525
11061,3756761603,3394364348,1672585341,1672587618,2277
10678,3516777819,3517377614,1672551122,1672551739,617
10672,3394394262,3783086267,1672686443,1672688871,2428
9917,3505720915,3510864325,1672578869,1672581955,3086
10481,3469780362,3509370633,1672679792,1672681366,1574
9805,3359929534,3516454693,1672697958,1672698496,538
11631,3306037126,3791698084,1672669830,1672672159,2329
10406,3637522163,3434581257,1672608304,1672611215,2911
10031,3427049290,3925208102,1672537698,1672538563,865
11585,3505521491,3756784813,1672623541,1672624527,986
10174,3711243126,3713726267,1672648864,1672651225,2361
10196,3227339675,3757030923,1672542519,1672544341,1822
11207,3924583142,3247545468,1672557735,1672558682,947
10669,3510291656,3360309868,1672628080,1672629067,987
11626,3209925780,3240877710,1672667561,1672670697,3136
11747,3434581257,3367202274,1672546830,1672548845,2015
10828,3903115138,3301765144,1672553139,1672554664,1525
11558,3220987526,3716195780,1672536917,1672539618,2701
10597,3520926977,3534190196,1672666486,1672668257,1771
10970,3514021667,3505825767,1672599057,1672602405,3348
10668,3381055770,3406132280,1672580428,1672582985,2557
11093,3500590302,3229465607,1672646675,1672647040,365
10035,3793814153,3299052917,1672653849,1672654177,328
11441,3908331271,3770780655,1672671391,1672671898,507
9836,3779130507,3288791629,1672570786,1672571280,494
10597,3703694139,3516706935,1672594616,1672596237,1621
10521,3310737478,3396440259,1672639119,1672640454,1335
11339,3703419800,3777499535,1672677462,1672677781,319
10990,3368079099,3714283424,1672646895,1672647778,883
10533,3812756400,3519357822,1672656729,1672658195,1466
11610,3777928067,3515558215,1672579391,1672580587,1196
10627,3284334297,3416079461,1672690389,1672693376,2987
11038,3208894215,3413799143,1672656378,1672659214,2836
10229,3513111053,3403257752,1672635218,1672637102,1884
9891,3235373942,3925098136,1672599705,1672600312,607
10687,3495482863,3311529105,1672615901,1672618742,2841
11641,3427527462,3397972945,1672631530,1672633527,1997
9894,3298831109,3772114731,1672574869,1672576510,1641
10763,3780423516,3500356342,1672545262,1672545857,595
11539,3792475476,3534426696,1672612100,1672613599,1499
10035,3341129425,3341432459,1672623211,1672625394,2183
10633,3348343425,3282240901,1672630741,1672632964,2223
11522,3835599049,3422915648,1672559123,1672561250,2127
10009,3337675386,3446218191,1672626119,1672629278,3159
10712,3533325993,3914947393,1672644029,1672645735,1706
9795,3701521510,3776791436,1672702231,1672703676,1445
11434,3715852330,3207497598,1672692405,1672695870,3465
11132,3682266017,3854229296,1672600135,1672602085,1950
11559,3807646028,3512495325,1672684404,1672685092,688
11429,3773768643,3755075988,1672541061,1672542664,1603
10353,3770941125,3853188285,1672692311,1672695051,2740
11508,3755218683,3435342362,1672666996,1672668302,1306
10782,3936851114,3513140146,1672568698,1672568786,88
11661,3206544535,3780941637,1672566135,1672567164,1029
10928,3666655293,3520273299,1672543824,1672545020,1196
11286,3756525103,3927365255,1672574877,1672577928,3051
11288,3391612879,3284334297,1672672219,1672673220,1001
11634,3534190196,3512337054,1672627682,1672631256,3574
11717,3511069449,3516655509,1672592489,1672594119,1630
10661,3233712975,3516777819,1672616123,1672619532,3409
11294,3310737478,3805926853,1672677692,1672680487,2795
10159,3439283360,3479910993,1672635346,1672638880,3534
10691,3284829602,3701311947,1672703094,1672703303,209
11071,3777063455,3770408300,1672569760,1672573029,3269
10085,3885674996,3757201138,1672619386,1672621999,2613
10143,3713636175,3714595459,1672622050,1672623592,1542
10631,3351949206,3505887814,1672586551,1672587007,456
10352,3779413388,3516454693,1672612167,1672615015,2848
10977,3509503263,3516969689,1672549282,1672551125,1843
11707,3713969196,3772867078,1672661345,1672663194,1849
11598,3509379617,3510801769,1672595666,1672597241,1575
11636,3501873139,3485898181,1672654041,1672657034,2993
10738,3422081502,3517800171,1672660227,1672663307,3080
11548,3509562377,3374147279,1672662121,1672665224,3103
11500,3662821438,3617135064,1672658699,1672661161,2462
11247,3770533588,3783201950,1672613677,1672614003,326
11105,3902548260,3242149533,1672666213,1672667337,1124
10696,3783086267,3509317776,1672685501,1672686986,1485
10500,3774633364,3805616707,1672667679,1672670247,2568
10041,3505825767,3202740652,1672574984,1672578299,3315
11746,3664478769,3777112124,1672651340,1672654520,3180
10785,3288675710,3760748418,1672601190,1672604398,3208
10302,3333477908,3714065165,1672688329,1672691732,3403
11324,3519924982,3511078598,1672535282,1672537971,2689
11190,3377311502,3439036305,1672547817,1672548733,916
10150,3534168768,3887382548,1672670325,1672670484,159
10408,3686853863,3857847527,1672653881,1672656887,3006
11092,3393128259,3935256825,1672697649,1672698840,1191
11614,3358262975,3777149336,1672677392,1672679357,1965
11544,3774744663,3387870683,1672652839,1672656226,3387
10030,3935569749,3500726347,1672696460,1672698005,1545
11049,3618895679,3365519448,1672581251,1672581943,692
10124,3715246385,3512546783,1672634425,1672635797,1372
10744,3306475287,3780969898,1672670148,1672671815,1667
11307,3367109648,3307535495,1672598505,1672598644,139
11396,3757607649,3500456339,1672536759,1672537296,537
10688,3306475287,3293673220,1672687494,1672688536,1042
11301,3757639274,3442073613,1672621199,1672621883,684
10037,3517469005,3520009158,1672617325,1672620248,2923
10713,3910049345,3352044245,1672559250,1672562185,2935
10670,3819400315,3458432407,1672603119,1672605229,2110
11170,3662055682,3627431396,1672542817,1672544582,1765
10761,3614112171,3755729826,1672555755,1672556229,474
11038,3930766276,3818324410,1672687184,1672687494,310
10621,3518088154,3619796619,1672644670,1672644741,71
10111,3447554599,3713434898,1672622714,1672624736,2022
10593,3901169230,3505826673,1672584647,1672587604,2957
10147,3513143959,3930727474,1672631788,1672635188,3400
11773,3915679140,3666022373,1672668219,1672671406,3187
11515,3730571757,3479910993,1672546593,1672548835,2242
11225,3520763492,3756784813,1672571227,1672571590,363
10957,3667950469,3710807030,1672679466,1672680902,1436
10458,3907245259,3534499421,1672557098,1672557465,367
10349,3203630241,3513802404,1672615464,1672618003,2539
10613,3489340327,3757030923,1672577069,1672577218,149
10990,3836136159,3445733121,1672646490,1672650014,3524
10332,3770023722,3205687719,1672643207,1672643327,120
10970,3882905311,3710865678,1672577383,1672578210,827
11623,3783727937,3515764058,1672552353,1672553034,681
9957,3661359073,3287734830,1672533735,1672534542,807
10004,3512596743,3501515425,1672544839,1672547158,2319
10763,3221290808,3776455762,1672636456,1672637628,1172
11132,3792627762,3613828705,1672533390,1672534046,656
9991,3510153173,3776583229,1672687407,1672688078,671
10876,3773041843,3311305760,1672615757,1672617998,2241
10660,3231227362,3421524698,1672674202,1672677711,3509
11298,3772188086,3520155898,1672688847,1672689367,520
10720,3513203127,3442181067,1672585193,1672585805,612
11765,3311529105,3515100211,1672534524,1672535882,1358
10360,3778604070,3711852131,1672640020,1672640979,959
11137,3204149913,3312959324,1672625949,1672627998,2049
10952,3479402555,3509377714,1672565649,1672566522,873
10962,3780612543,3342056927,1672702281,1672702554,273
10799,3520016705,3519297683,1672533326,1672533580,254
11445,3281970147,3396453219,1672583059,1672585970,2911
11683,3485521840,3276499910,1672673794,1672675471,1677
11433,3812880543,3276230295,1672665790,1672666414,624
10029,3368339963,3494748808,1672679504,1672679728,224
11057,3511500932,3776534957,1672625226,1672625389,163
10288,3777672363,3776068937,1672639945,1672641954,2009
10213,3516572212,3519689906,1672664819,1672667195,2376
11516,3757393413,3770497768,1672689237,1672689540,303
9885,3375905193,3477951091,1672581430,1672583302,1872
9871,3500785888,3884388188,1672663761,1672665548,1787
10182,3757060033,3756668747,1672635304,1672638122,2818
10337,3246804115,3710919244,1672614919,1672617776,2857
10730,3776732532,3669283586,1672694961,1672697287,2326
11025,3732596503,3519841427,1672637650,1672639792,2142
10274,3231963246,3777498160,1672616316,1672618409,2093
10893,3380418745,3447202943,1672607707,1672608127,420
10415,3711854614,3805704844,1672592692,1672596007,3315
11140,3500720752,3487395357,1672579963,1672580235,272
10157,3343767438,3772683155,1672566699,1672567743,1044
9809,3452802329,3779282072,1672647148,1672649148,2000
10586,3791644831,3309455369,1672644724,1672645874,1150
11752,3499343927,3760080378,1672682415,1672685701,3286
11221,3534988162,3760731595,1672691117,1672693646,2529
11758,3755107521,3829412384,1672594566,1672595051,485
10835,3366801723,3755229631,1672550492,1672553721,3229
11111,3534459983,3488988274,1672632904,1672636392,3488
11256,3516321993,3520860199,1672535776,1672536586,810
10749,3233993993,3770018912,1672651022,1672652029,1007
11193,3483078667,3519553933,1672698104,1672700758,2654
10355,3332010532,3683677062,1672561458,1672561691,233
9911,3374348845,3272581469,1672561462,1672564154,2692
10554,3303747093,3515803462,1672583372,1672586082,2710
10806,3551833298,3421040626,1672593843,1672596308,2465
11777,3624365837,3884458862,1672617963,1672618352,389
10173,3791841318,3463564410,1672541801,1672544341,2540
11016,3773556853,3370401047,1672662634,1672664169,1535
9882,3518794921,3295748489,1672672192,1672673556,1364
11654,3756680289,3370512945,1672650170,1672653547,3377
11674,3437703650,3533976217,1672661136,1672661865,729
11403,3710046567,3792475476,1672624831,1672626239,1408
10185,3520763492,3770544738,1672683079,1672686660,3581
10208,3418791124,3711765138,1672703918,1672706391,2473
10763,3403120725,3856975355,1672624339,1672627850,3511
10227,3715750580,3831981073,1672627215,1672627337,122
9942,3399734748,3461743188,1672606353,1672609052,2699
10448,3791224239,3772695548,1672545419,1672548691,3272
10929,3760271237,3520160414,1672613230,1672613634,404
10771,3509167758,3755769731,1672634458,1672636736,2278
10801,3513486828,3517325365,1672699096,1672699528,432
10844,3801379377,3310961923,1672693007,1672695313,2306
11539,3681504869,3510824484,1672674447,1672674678,231
10432,3387413950,3417360319,1672667550,1672670923,3373
10178,3505826673,3313101243,1672561366,1672563877,2511
11482,3772235668,3517627003,1672551676,1672552139,463
10242,3757924067,3919994216,1672586161,1672589608,3447
10745,3500444748,3776183353,1672562570,1672565163,2593
10098,3245755569,3501988762,1672698279,1672700043,1764
10583,3500444748,3714074120,1672574790,1672577210,2420
11394,3772251279,3413799143,1672699639,1672701198,1559
10229,3344710271,3241567995,1672703155,1672705343,2188
10871,3450679913,3224040894,1672569906,1672570843,937
10353,3819400315,3400560073,1672634344,1672637327,2983
11613,3793407883,3446218191,1672652568,1672652962,394
10105,3517469005,3738132114,1672575379,1672577864,2485
10110,3701534043,3387621912,1672694559,1672696761,2202
11601,3666022373,3669140241,1672577737,1672581105,3368
11053,3514389188,3714142299,1672703349,1672705092,1743
10909,3276393542,3760687922,1672667232,1672667572,340
11012,3850005949,3931164237,1672587648,1672588307,659
10997,3514515499,3330799389,1672571097,1672572666,1569
10292,3557324887,3780680252,1672665991,1672666298,307
10975,3238779889,3284865931,1672591132,1672592382,1250
11491,3238779889,3505010941,1672607216,1672607619,403
10316,3469778316,3711804184,1672646606,1672646962,356
9835,3519435459,3450164574,1672582191,1672585137,2946
9942,3779169946,3555763674,1672694142,1672695386,1244
10502,3900766525,3240622654,1672683126,1672683231,105
10925,3603740088,3773432494,1672607590,1672610452,2862
11299,3778695017,3231654754,1672534201,1672534342,141
10532,3552261072,3839308659,1672554629,1672556511,1882
9843,3893043842,3438204844,1672593496,1672596630,3134
10377,3501407804,3355430975,1672639338,1672642668,3330
11780,3714902042,3682673884,1672617493,1672621072,3579
9919,3906874577,3773554767,1672576171,1672578445,2274
10187,3857909328,3511069449,1672641392,1672642098,706
10552,3517426473,3912862842,1672664472,1672667426,2954
11118,3500051606,3492064037,1672600787,1672602203,1416
11428,3533365834,3703572036,1672687037,1672687300,263
11599,3394394262,3900195680,1672583667,1672586253,2586
10150,3838423363,3485898181,1672606116,1672609113,2997
10712,3516867729,3930766276,1672585265,1672586142,877
10320,3886837151,3780466967,1672588932,1672590441,1509
10947,3389367628,3882905311,1672575454,1672576874,1420
10948,3311231911,3516463579,1672654844,1672655007,163
11098,3509614126,3514145752,1672538355,1672538966,611
10838,3491390365,3513171472,1672567417,1672567676,259
9959,3229621693,3783086267,1672600473,1672602659,2186
10050,3351856699,3554317844,1672622826,1672626025,3199
10610,3200372897,3973134902,1672696271,1672696627,356
10415,3462153833,3895422995,1672587552,1672588858,1306
11006,3716179251,3738132114,1672673198,1672674301,1103
10879,3757050615,3471177177,1672645407,1672648435,3028
10273,3779835734,3615742989,1672605630,1672607728,2098
10544,3364683368,3403150349,1672685280,1672688275,2995
10096,3773085258,3856975623,1672558322,1672559773,1451
10697,3922430928,3282240901,1672639553,1672640584,1031
11516,3281970147,3461630842,1672580770,1672582654,1884
10720,3369482983,3368441333,1672617494,1672618701,1207
10823,3777878462,3780900318,1672580923,1672582194,1271
11597,3311924005,3899903158,1672624545,1672627432,2887
11545,3500555856,3313282478,1672676880,1672677950,1070
9800,3904846341,3817376705,1672533758,1672535528,1770
10498,3371759044,3932955949,1672653620,1672657024,3404
10664,3462985379,3518882056,1672681370,1672682395,1025
10963,3440743218,3826315540,1672675582,1672675760,178
10620,3772905073,3364718040,1672584253,1672585371,1118
10662,3375324190,3518759318,1672554575,1672555821,1246
11727,3779604279,3200785194,1672676644,1672679147,2503
10003,3372596013,3461931154,1672668821,1672671194,2373
10930,3755942724,3917905192,1672688266,1672689990,1724
10546,3886879696,3770530739,1672639213,1672640535,1322
11476,3293553295,3420983899,1672644213,1672645085,872
9945,3857847527,3476958001,1672541761,1672543201,1440
10864,3605591994,3760107540,1672563166,1672563715,549
10179,3396440259,3937854073,1672668726,1672670095,1369
11300,3223512565,3395505794,1672590459,1672592711,2252
10114,3772509599,3801501384,1672559561,1672559995,434
11355,3420854927,3735497729,1672532727,1672535108,2381
10256,3513213122,3618895679,1672683459,1672683606,147
11216,3472901378,3534667712,1672631247,1672633952,2705
10701,3856975355,3533867833,1672632499,1672635716,3217
10869,3737622701,3510819040,1672641123,1672642413,1290
11148,3732090606,3519055736,1672700967,1672701446,479
10122,3512417724,3783095041,1672691730,1672693022,1292
11408,3815700240,3516340010,1672640195,1672641056,861
11105,3737946004,3703624327,1672649401,1672652979,3578
11025,3662307789,3559112196,1672673249,1672675132,1883
10780,3404375908,3908878965,1672590750,1672594087,3337
11326,3924963918,3710680073,1672680471,1672682592,2121
11471,3814770073,3760776967,1672677298,1672680582,3284
11164,3384151770,3375257546,1672608714,1672610744,2030
9894,3312651192,3825877848,1672618566,1672619230,664
10881,3936851114,3351153781,1672660944,1672662837,1893
10484,3396472026,3533830748,1672650036,1672652006,1970
11622,3370448531,3757311529,1672588124,1672588399,275
11112,3812880543,3501515425,1672697292,1672700199,2907
10578,3713195480,3520725149,1672533898,1672535431,1533
10632,3792173463,3601340045,1672645934,1672649275,3341
11448,3682266017,3519448648,1672541520,1672543528,2008
9935,3793029132,3770630937,1672692092,1672693210,1118
11139,3907390925,3342235058,1672573442,1672574044,602
11082,3341311972,3354015456,1672561279,1672562291,1012
10778,3505538902,3378534521,1672637158,1672639264,2106
10250,3783809405,3791825536,1672600428,1672603551,3123
11189,3516932899,3774965463,1672684194,1672684763,569
11546,3714718326,3516067011,1672676137,1672677053,916
11651,3711190257,3410602007,1672595821,1672596194,373
10223,3803473387,3821103640,1672641840,1672645351,3511
11026,3426468199,3513816744,1672582011,1672583908,1897
11002,3772250554,3533628528,1672624417,1672625076,659
10588,3278251248,3204149913,1672653229,1672654526,1297
11579,3770018912,3837887478,1672557549,1672560032,2483
10898,3792008302,3287683210,1672686611,1672688101,1490
10029,3226761201,3913847876,1672696582,1672698158,1576
9905,3756066765,3716195780,1672682777,1672683574,797
11557,3511095300,3367121615,1672605758,1672606706,948
11443,3533816813,3246804115,1672616608,1672619087,2479
11090,3296970170,3621629499,1672627765,1672629023,1258
10399,3917243005,3715490209,1672677783,1672680108,2325
10729,3880637958,3319862687,1672606006,1672606708,702
9911,3445558740,3358262975,1672693113,1672694641,1528
9966,3852014884,3533113740,1672664865,1672665191,326
11509,3756157377,3316117186,1672645412,1672645765,353
10246,3285971415,3773714494,1672558052,1672560979,2927
10721,3714294005,3925098136,1672666665,1672669068,2403
10407,3558567160,3820200446,1672702687,1672705198,2511
11621,3773826624,3755209597,1672644558,1672644813,255
9819,3776182849,3287753579,1672643196,1672644042,846
10560,3774304163,3300810210,1672683979,1672686065,2086
10898,3713767153,3778838936,1672698744,1672699201,457
10676,3512527440,3518209090,1672685363,1672685733,370
10949,3636927297,3553640169,1672546284,1672548535,2251
10538,3493598658,3893527651,1672620303,1672621640,1337
11074,3484490325,3779951373,1672653528,1672655452,1924
10486,3660702754,3929391979,1672571555,1672574358,2803
10661,3439045964,3633294415,1672542605,1672543997,1392
9820,3423800775,3559112196,1672587633,1672590916,3283
11198,3203837944,3638823001,1672669680,1672670546,866
10761,3520189871,3501828287,1672557242,1672558597,1355
11654,3776791436,3500234771,1672561251,1672562796,1545
9898,3611832288,3360972732,1672636729,1672638714,1985
11245,3774506868,3518368900,1672569946,1672571209,1263
10862,3973138649,3880637958,1672634542,1672636480,1938
9800,3239279744,3395505794,1672671755,1672675139,3384
10178,3713606829,3439532406,1672700630,1672701952,1322
10980,3362385373,3512681214,1672634413,1672635638,1225
11729,3920890008,3395069149,1672571160,1672574255,3095
10032,3701770921,3900793652,1672636530,1672638540,2010
11128,3505816624,3364948616,1672678902,1672679591,689
10683,3351949206,3716460706,1672575264,1672576325,1061
11209,3711591464,3714283424,1672589402,1672592324,2922
10253,3701028092,3453519360,1672651213,1672653781,2568
10038,3512769522,3772845364,1672679927,1672683439,3512
11554,3662794240,3606804618,1672616734,1672618438,1704
9854,3772234939,3501208658,1672647271,1672648438,1167
11691,3552922094,3615447269,1672666182,1672667055,873
9991,3505908965,3770019143,1672538806,1672542261,3455
11531,3710107905,3701841013,1672579337,1672581905,2568
9934,3512965991,3715566511,1672629246,1672631907,2661
11354,3832902787,3389367628,1672628735,1672630041,1306
10477,3209925780,3807646028,1672601119,1672602067,948
10188,3774706478,3534204885,1672562425,1672564776,2351
11443,3374348845,3352493805,1672670633,1672671082,449
11545,3505119470,3755342153,1672663774,1672666739,2965
11573,3801501384,3287753579,1672588875,1672590400,1525
10179,3359929534,3415032547,1672570500,1672573488,2988
10951,3342495377,3931028233,1672703201,1672706411,3210
10400,3517645656,3393376416,1672661062,1672661301,239
10334,3713434898,3710316008,1672687771,1672689362,1591
11788,3976225898,3520832066,1672581515,1672581753,238
10804,3238997746,3500031401,1672694299,1672696675,2376
9803,3554317844,3520362238,1672634920,1672638462,3542
11521,3515715968,3291617477,1672551880,1672552175,295
10909,3474852115,3374652108,1672686148,1672687427,1279
10775,3922786716,3884862164,1672555737,1672555977,240
10933,3519937708,3512101369,1672537111,1672538626,1515
10577,3756763585,3780969898,1672581326,1672584846,3520
10133,3976225898,3881012415,1672558354,1672561458,3104
11450,3633949990,3394959062,1672610637,1672611432,795
10040,3682802569,3756437169,1672611181,1672613308,2127
10887,3500057674,3802374620,1672602910,1672603490,580
10550,3312800145,3227206772,1672536324,1672536515,191
10093,3922786716,3517149023,1672566421,1672568138,1717
11013,3516731917,3893950585,1672597322,1672598363,1041
11443,3919719755,3510233949,1672581829,1672582623,794
10145,3505416534,3462985379,1672541329,1672542310,981
10475,3829698950,3487988841,1672650048,1672651955,1907
10688,3776183353,3737745988,1672696396,1672698660,2264
11524,3505291330,3793704155,1672600004,1672601942,1938
10516,3805926853,3500793739,1672696334,1672698110,1776
10683,3714287902,3403988682,1672594406,1672596331,1925
11267,3890813040,3802101760,1672625939,1672626369,430
10841,3755849241,3358434853,1672688534,1672688961,427
11402,3884369346,3757514745,1672609730,1672613220,3490
10897,3901169230,3304252969,1672612739,1672614180,1441
10826,3274223335,3500049870,1672543469,1672546660,3191
10377,3380285779,3509360869,1672590650,1672591833,1183
11146,3623113240,3514327931,1672623376,1672623988,612
11436,3492728794,3701296091,1672547051,1672549969,2918
10077,3793689267,3779212271,1672549429,1672549593,164
10051,3932919664,3772893815,1672608017,1672610121,2104
10505,3857244486,3777499535,1672577662,1672580250,2588
11429,3791088014,3619705594,1672620301,1672622700,2399
10678,3395069149,3470962222,1672676233,1672679596,3363
11371,3246062632,3465227623,1672560467,1672563498,3031
10990,3777112124,3515753241,1672616443,1672617097,654
10464,3777751979,3770630937,1672538946,1672539190,244
11658,3515893948,3713374884,1672701338,1672703959,2621
11635,3770424892,3479402555,1672626831,1672627953,1122
10820,3403988682,3772893815,1672576952,1672580341,3389
11352,3511663572,3780142207,1672560084,1672560350,266
11248,3827836825,3668855144,1672647309,1672648530,1221
10430,3624307518,3777112124,1672669256,1672672347,3091
10788,3475653510,3509828883,1672659678,1672661146,1468
11362,3713728777,3756149282,1672643006,1672646247,3241
11188,3776561263,3779951373,1672531600,1672533317,1717
10319,3906693728,3774436159,1672647406,1672648786,1380
10188,3509167758,3933106901,1672634566,1672635206,640
10287,3559123082,3500543341,1672702252,1672703861,1609
9905,3418367752,3801501384,1672666506,1672668370,1864
9961,3855209450,3500833053,1672578749,1672580508,1759
10816,3791796190,3380418745,1672611477,1672613790,2313
10723,3668063289,3856897914,1672542483,1672543412,929
10646,3511182297,3760737203,1672694663,1672696272,1609
10975,3778932673,3487278983,1672622406,1672622961,555
11404,3500544306,3756843139,1672592177,1672593450,1273
11470,3466655775,3500640854,1672666961,1672668183,1222
10724,3315432466,3374348845,1672602894,1672603451,557
10812,3885645840,3520273299,1672690094,1672692047,1953
11420,3773041843,3426207439,1672621053,1672622479,1426
10496,3793920312,3774506868,1672668796,1672669658,862
10934,3499998389,3478455812,1672605269,1672607855,2586
10082,3710783759,3760397450,1672661748,1672664837,3089
10462,3400025324,3388537708,1672663065,1672663995,930
11522,3500640854,3611832288,1672680078,1672681527,1449
9902,3453164933,3337673625,1672667737,1672669700,1963
10715,3203172170,3203151036,1672696050,1672698295,2245
10677,3478455812,3482172065,1672692091,1672692327,236
9827,3710585241,3688130094,1672568605,1672568740,135
11530,3931028233,3286938590,1672586897,1672588819,1922
11286,3780740477,3732128078,1672541036,1672543099,2063
11776,3476144563,3774035405,1672606591,1672609797,3206
10258,3424425746,3500927619,1672642571,1672645347,2776
10359,3430310785,3680988889,1672544739,1672545637,898
11122,3608973523,3516034245,1672601511,1672604048,2537
11689,3780287649,3273758330,1672643483,1672644982,1499
10427,3517083465,3935520819,1672573939,1672574453,514
10751,3516340010,3270502801,1672599085,1672599603,518
11258,3513111053,3511729562,1672659952,1672661786,1834
10004,3335139032,3481365330,1672610969,1672611497,528
10463,3912181197,3851877325,1672678084,1672681018,2934
11266,3820200446,3516249472,1672603695,1672605996,2301
11385,3898965585,3683514731,1672688054,1672690986,2932
9894,3500720752,3716341323,1672539681,1672540138,457
11374,3772556646,3932955949,1672617692,1672620486,2794
10478,3358675021,3483078667,1672617048,1672617667,619
10522,3311200541,3238056215,1672589144,1672592502,3358
11375,3449672240,3246296769,1672683295,1672685153,1858
11397,3339478490,3779282072,1672556298,1672557342,1044
11160,3534531061,3501115299,1672568032,1672570905,2873
10662,3274341934,3311200541,1672628263,1672630516,2253
11154,3345028045,3856316719,1672591851,1672593893,2042
11652,3711214982,3713636175,1672644659,1672645533,874
10128,3500456339,3791194984,1672616108,1672618228,2120
10370,3240622654,3513586642,1672667270,1672670517,3247
10185,3239423794,3555378248,1672637047,1672640377,3330
11318,3231963246,3389069291,1672581306,1672582377,1071
11279,3684651755,3934991640,1672605868,1672606836,968
11024,3500821475,3680832669,1672535824,1672536961,1137
10956,3854390432,3505173665,1672703502,1672705678,2176
10056,3906260966,3226913558,1672632996,1672635463,2467
9912,3906075386,3760267158,1672542839,1672544138,1299
10474,3439651226,3922153821,1672696035,1672698869,2834
11488,3857909328,3713434898,1672577701,1672578246,545
11240,3819400315,3520824937,1672602374,1672604002,1628
11688,3776279305,3931164237,1672586071,1672589262,3191
11542,3755075988,3446537819,1672596519,1672597450,931
10630,3418382025,3832902787,1672539611,1672542847,3236
10483,3420664407,3509556649,1672644715,1672645153,438
10183,3701060732,3714453773,1672672985,1672675696,2711
11530,3756781024,3636605690,1672647278,1672648427,1149
10774,3517440258,3520165730,1672547187,1672547250,63
10376,3773738817,3772164469,1672627078,1672627223,145
11290,3490008012,3510240661,1672686069,1672688533,2464
11032,3450735824,3517530943,1672551081,1672552474,1393
11231,3246381831,3359012188,1672632635,1672633408,773
11405,3772216305,3713606829,1672628740,1672631075,2335
11436,3779689733,3369108286,1672677914,1672678689,775
11235,3505826673,3403218814,1672576740,1672578997,2257
10989,3974400577,3505491969,1672670314,1672671590,1276
10020,3408828584,3509377714,1672597223,1672598274,1051
11733,3736987749,3472561941,1672544623,1672546151,1528
10342,3534111498,3887382548,1672535183,1672538091,2908
10036,3516815069,3713170867,1672534408,1672537144,2736
10168,3703438617,3330466913,1672696915,1672698040,1125
9960,3476144563,3711856534,1672557509,1672560445,2936
10364,3510240661,3783408469,1672613944,1672615617,1673
11722,3622729771,3773669001,1672701301,1672701420,119
10325,3472018395,3345902033,1672664710,1672665376,666
9799,3760069457,3520022175,1672635319,1672636023,704
11415,3604908372,3792267993,1672614252,1672617074,2822
11469,3469663062,3509701363,1672677813,1672680911,3098
9802,3939422411,3791106473,1672537359,1672540884,3525
9864,3774606418,3664478769,1672626748,1672626833,85
11657,3731905251,3622152515,1672558425,1672561133,2708
10536,3290097447,3513111053,1672568223,1672571575,3352
10037,3293540333,3500536897,1672538195,1672539172,977
10238,3518408734,3757032266,1672659260,1672659333,73
11734,3437108337,3806471413,1672640733,1672640954,221
11437,3756843139,3829412384,1672535179,1672536444,1265
10862,3407734098,3634670780,1672648018,1672649526,1508
10209,3773840321,3361926328,1672699944,1672702086,2142
10089,3228465044,3515100211,1672602860,1672603318,458
9963,3303747093,3510250740,1672684582,1672686100,1518
10567,3757514745,3791628263,1672699015,1672700864,1849
10069,3791072829,3403120725,1672542432,1672542729,297
11023,3510694464,3557324887,1672588114,1672590064,1950
10640,3520395850,3520395850,1672627997,1672629665,1668
9930,3776034313,3228056289,1672633654,1672634667,1013
11371,3853188285,3559754304,1672694395,1672695096,701
11393,3311432176,3491527603,1672560961,1672564490,3529
10552,3772291207,3854957153,1672620867,1672622833,1966
11442,3319862687,3514571807,1672591968,1672593275,1307
10577,3283785820,3275057862,1672567575,1672568472,897
10920,3830291558,3779454060,1672610202,1672613298,3096
11437,3513250976,3834311054,1672634282,1672636702,2420
10905,3436401020,3505359060,1672672512,1672674325,1813
11399,3519463038,3519046342,1672631903,1672635345,3442
10501,3713224986,3405200303,1672565695,1672568107,2412
11312,3899294071,3897851509,1672622718,1672622933,215
11274,3550887623,3713927376,1672656575,1672657137,562
10214,3773853619,3379400553,1672543472,1672544366,894
10988,3342426430,3509562377,1672579080,1672579603,523
11098,3501711464,3271780525,1672579825,1672580519,694
10730,3520057139,3921138062,1672702075,1672704185,2110
9921,3234445133,3304227085,1672539832,1672542548,2716
9998,3823307824,3289771213,1672696160,1672697361,1201
9907,3891272544,3701350519,1672593523,1672594255,732
9972,3491527603,3777909822,1672647270,1672650614,3344
10303,3381055770,3440305508,1672623941,1672627033,3092
10194,3490804766,3408408584,1672554052,1672555123,1071
11240,3500974385,3500591274,1672593648,1672596407,2759
9980,3792708936,3884934977,1672630097,1672633272,3175
10059,3453164933,3235074007,1672549876,1672552538,2662
10466,3778838936,3774109138,1672653499,1672656774,3275
10224,3360309868,3413511621,1672630645,1672634058,3413
11090,3475560058,3486509752,1672624507,1672627263,2756
10049,3309651238,3971051020,1672548030,1672550204,2174
10369,3489205994,3411626917,1672633136,1672634249,1113
10013,3783373085,3805831563,1672646829,1672647914,1085
10413,3509297453,3791863922,1672562253,1672563977,1724
11723,3710316008,3623512088,1672646073,1672647777,1704
11617,3427527462,3755630085,1672658703,1672659348,645
11558,3510484107,3886837151,1672573474,1672575824,2350
10084,3509297453,3465227623,1672545886,1672548539,2653
10881,3444680955,3248061684,1672600031,1672602879,2848
11426,3778044082,3783157469,1672606492,1672607211,719
10049,3666655293,3301431129,1672633984,1672635371,1387
9882,3779282072,3730226545,1672671276,1672674257,2981
10469,3510278533,3296970170,1672545907,1672546349,442
11291,3883640454,3793222045,1672694363,1672697743,3380
10027,3520558137,3289258397,1672633705,1672636864,3159
10041,3511640720,3936486724,1672602295,1672603486,1191
10794,3491390365,3634670780,1672601398,1672603959,2561
10707,3501657158,3755584983,1672594953,1672598094,3141
10410,3716633983,3830291558,1672649921,1672651447,1526
10955,3419648004,3780511388,1672684234,1672686827,2593
11197,3534988162,3311449914,1672631261,1672633128,1867
9958,3512546783,3620157388,1672623634,1672626887,3253
10827,3777932225,3716178116,1672543206,1672543645,439
10163,3511640720,3773714494,1672581337,1672583902,2565
11076,3715844082,3979366845,1672582471,1672584678,2207
10488,3341985886,3201573194,1672594235,1672597800,3565
11707,3853783593,3776778306,1672631570,1672634156,2586
11396,3776778306,3203457161,1672636462,1672639866,3404
11488,3336225953,3772509599,1672679653,1672680334,681
10403,3756647451,3403395712,1672680420,1672681793,1373
11437,3779169946,3488333295,1672602776,1672605328,2552
10194,3272827860,3509274030,1672700420,1672701337,917
10950,3422081502,3299847117,1672617338,1672618144,806
10588,3204149913,3778318250,1672679592,1672683100,3508
10839,3757678397,3365519448,1672557679,1672559706,2027
10600,3249771731,3760420315,1672686975,1672687749,774
10103,3354405535,3450164574,1672703208,1672704182,974
10556,3713728777,3755209597,1672620198,1672620568,370
10390,3436401020,3756437169,1672680059,1672681903,1844
10018,3228997424,3636605690,1672614018,1672614501,483
10623,3777931341,3500442370,1672608296,1672609981,1685
11376,3757713457,3774506868,1672680407,1672682127,1720
10292,3307535495,3533726421,1672587883,1672589729,1846
10245,3514450836,3895422995,1672631790,1672631963,173
11516,3505155858,3511650296,1672576630,1672579339,2709
10380,3756168814,3512371853,1672542053,1672544859,2806
10739,3887030182,3683562111,1672670944,1672672449,1505
10952,3892487982,3491758029,1672602446,1672605989,3543
9976,3773394570,3977209952,1672568040,1672570114,2074
10377,3774109138,3474074188,1672652386,1672652938,552
10302,3515607283,3534626053,1672597735,1672599266,1531
11214,3510824484,3534937492,1672672278,1672675651,3373
10361,3348100657,3756066765,1672615138,1672615780,642
9811,3710223875,3736885568,1672639107,1672641907,2800
11418,3711219767,3737467358,1672678888,1672682288,3400
10444,3976742903,3886957097,1672630354,1672630835,481
11356,3520725149,3713969196,1672581530,1672582987,1457
11149,3516588277,3510262025,1672677206,1672677587,381
11508,3291617477,3924205112,1672691666,1672693824,2158
11258,3384170206,3514638555,1672636510,1672638407,1897
10817,3500405175,3778706119,1672665147,1672667462,2315
9844,3304252969,3783430498,1672644032,1672644391,359
11353,3334633634,3380167818,1672683148,1672686514,3366
10530,3420854927,3474852115,1672568225,1672571184,2959
10338,3347760784,3534362749,1672664852,1672665369,517
10457,3390537737,3977360666,1672541454,1672541928,474
10717,3757060033,3776468503,1672642833,1672645336,2503
11668,3414510793,3308759754,1672553258,1672556414,3156
10095,3550206045,3884192843,1672640882,1672643974,3092
11632,3683677062,3826542169,1672658625,1672661195,2570
10307,3233712975,3682906048,1672635196,1672635791,595
11738,3501554468,3688845298,1672616214,1672616823,609
11110,3917004141,3393376416,1672555230,1672556570,1340
11260,3638823001,3352044245,1672668641,1672671975,3334
11721,3774326754,3450679913,1672688955,1672690985,2030
9970,3905955166,3518947256,1672661063,1672663187,2124
11632,3402020492,3973582279,1672697291,1672697630,339
11783,3884192843,3343616490,1672580936,1672582827,1891
11756,3209417223,3972196462,1672640218,1672642944,2726
10632,3710223875,3839417558,1672686848,1672689608,2760
11254,3779454060,3638126174,1672675826,1672676364,538
11244,3516340010,3517083465,1672620378,1672622638,2260
9932,3730052916,3622218289,1672644701,1672646756,2055
10386,3757994002,3278251248,1672621073,1672624141,3068
10062,3701521510,3770715115,1672626878,1672630321,3443
10809,3469780362,3519724388,1672656393,1672658688,2295
11109,3778605154,3817478012,1672601098,1672602524,1426
10392,3505496725,3497904539,1672663264,1672666588,3324
10717,3780171640,3711870537,1672561955,1672563944,1989
11782,3451757423,3423940256,1672671334,1672673733,2399
11023,3371132167,3533365834,1672572369,1672573625,1256
11628,3278430820,3778125688,1672637982,1672638938,956
10926,3406169279,3812261241,1672653499,1672656371,2872
10921,3500596577,3791332226,1672579950,1672581379,1429
10742,3505155858,3915195160,1672573919,1672574805,886
11625,3616403486,3514564903,1672699853,1672702979,3126
10388,3242149533,3520824937,1672594746,1672595200,454
11305,3901217668,3317887374,1672628872,1672630229,1357
9912,3372236721,3278443807,1672591589,1672594383,2794
10985,3362706073,3434581257,1672637176,1672639319,2143
10274,3335974305,3241855333,1672553802,1672555218,1416
11313,3757607649,3307997700,1672590879,1672592790,1911
10705,3512504247,3776953418,1672571787,1672575175,3388
10207,3500019810,3512871568,1672686454,1672689101,2647
10561,3779255367,3792162098,1672630296,1672632887,2591
11394,3818532143,3433189219,1672570511,1672573601,3090
10912,3490008012,3239279744,1672670307,1672671478,1171
11230,3838119022,3792900315,1672583902,1672585795,1893
10626,3813085701,3447591143,1672630029,1672633495,3466
9856,3756328353,3885645840,1672533615,1672536229,2614
10520,3778702093,3770991234,1672590018,1672590200,182
10727,3500536897,3272096922,1672626138,1672627735,1597
11642,3512555384,3715106566,1672699955,1672703180,3225
10923,3375324190,3710819760,1672623816,1672624050,234
10006,3703474558,3386323728,1672668561,1672671018,2457
10184,3334824744,3804095239,1672676601,1672679496,2895
11218,3701512498,3668154066,1672573606,1672575197,1591
10127,3636857871,3311515179,1672674737,1672678062,3325
10612,3772169046,3509503263,1672655251,1672657870,2619
9982,3756998113,3307236682,1672576480,1672578660,2180
10436,3436774112,3739618347,1672679230,1672681137,1907
10074,3779818784,3517325365,1672697595,1672700856,3261
10054,3534604516,3713444403,1672538137,1672541041,2904
11165,3828906027,3311924005,1672587578,1672588187,609
10673,3772708314,3552444228,1672584006,1672585764,1758
11114,3930501172,3311521176,1672688129,1672690485,2356
11709,3756328353,3774359137,1672693058,1672694831,1773
11118,3241593146,3760679372,1672694641,1672696992,2351
10438,3909822999,3515803462,1672691610,1672693628,2018
10287,3428878402,3760525465,1672539142,1672541549,2407
11666,3513586642,3973138649,1672673218,1672676750,3532
10908,3885422379,3756066702,1672673581,1672673843,262
11278,3534624672,3853386575,1672621013,1672622356,1343
10597,3559759778,3713373455,1672656771,1672659508,2737
10817,3714883746,3900766525,1672626857,1672629336,2479
10965,3501253130,3500145103,1672600118,1672602141,2023
11158,3534206917,3311805161,1672549231,1672551702,2471
9878,3505697295,3609997804,1672535532,1672538998,3466
10550,3793699467,3716944983,1672538453,1672539946,1493
11486,3902023467,3681737865,1672701890,1672704645,2755
9861,3341432459,3917467642,1672658173,1672661659,3486
9818,3520012007,3430823498,1672559376,1672559786,410
10851,3716467469,3512371853,1672647177,1672649886,2709
11214,3373018943,3701385831,1672642289,1672645391,3102
10576,3520022175,3462985379,1672538284,1672539606,1322
10036,3306066522,3368848936,1672591577,1672594181,2604
10132,3447948483,3510916875,1672592398,1672595401,3003
11136,3496591885,3319529422,1672660922,1672661801,879
11178,3792289287,3756066765,1672651424,1672653277,1853
10990,3780466967,3308149799,1672607516,1672610205,2689
11613,3760397450,3510291656,1672625234,1672625469,235
11727,3200320674,3510869438,1672653116,1672654989,1873
10976,3755688231,3619538249,1672600602,1672602055,1453
10331,3205324639,3703737650,1672581227,1672581431,204
10857,3711179193,3274739459,1672612041,1672612103,62
11775,3533822490,3441683673,1672640555,1672641597,1042
10005,3509651954,3713878219,1672664603,1672667689,3086
10490,3755361692,3512251592,1672651996,1672653394,1398
10735,3773434690,3515715968,1672592200,1672595223,3023
11592,3458271585,3756876537,1672534416,1672537727,3311
10172,3510250740,3437108337,1672609482,1672612377,2895
11179,3510547682,3778824229,1672637375,1672638359,984
11480,3516867729,3284829602,1672603991,1672606855,2864
11091,3517552930,3513802404,1672661464,1672661638,174
11129,3356599815,3236563828,1672576411,1672577836,1425
10132,3714787207,3665841655,1672577968,1672580130,2162
11655,3501828287,3911376818,1672536807,1672539072,2265
10205,3716733618,3423940256,1672574947,1672577727,2780
11350,3222357355,3778605154,1672536520,1672536912,392
10090,3639081201,3510484107,1672654461,1672656730,2269
11490,3203172170,3512871568,1672650658,1672652771,2113
11725,3824657614,3755507566,1672543418,1672544849,1431
11275,3715284599,3372079985,1672667440,1672669754,2314
10294,3512645289,3603452936,1672555118,1672558635,3517
10985,3623113240,3516020922,1672670436,1672671951,1515
10796,3832745283,3511615015,1672680291,1672681115,824
11703,3505684690,3772980989,1672571447,1672572706,1259
10945,3907039612,3510189563,1672662716,1672664808,2092
11532,3701475090,3636605690,1672541404,1672544296,2892
10375,3779255367,3393955069,1672564350,1672566973,2623
9896,3608973523,3442096275,1672565306,1672565480,174
10492,3776447604,3755273361,1672573807,1672575099,1292
10566,3516497645,3606804618,1672689615,1672690224,609
10878,3501192566,3370401047,1672590599,1672592402,1803
10111,3311331205,3885422379,1672534437,1672535539,1102
10591,3756428507,3791509334,1672558244,1672559846,1602
11525,3287753579,3519780867,1672696139,1672696211,72
11131,3496579251,3792277399,1672670927,1672672478,1551
11213,3772980989,3827981800,1672689705,1672691993,2288
10515,3776124041,3715881104,1672604663,1672607878,3215
10368,3423940256,3773041843,1672560994,1672561821,827
11596,3701387745,3703415246,1672575121,1672578206,3085
10139,3703476890,3505521491,1672625029,1672625310,281
10804,3311037445,3520344592,1672632086,1672634535,2449
9817,3550405857,3516026189,1672539057,1672539395,338
11178,3533440294,3505148522,1672670714,1672671463,749
11301,3512072679,3601214648,1672639690,1672642425,2735
11191,3509828883,3838119022,1672586956,1672587201,245
10030,3613828705,3423940256,1672565641,1672568284,2643
11094,3533427742,3343616490,1672689708,1672690801,1093
10026,3499820963,3514941815,1672617811,1672618966,1155
10063,3711671702,3408828584,1672668457,1672671665,3208
10835,3716676869,3732846295,1672599830,1672600239,409
11786,3428198021,3779561601,1672616702,1672620268,3566
10831,3711065081,3620836520,1672619847,1672621282,1435
11143,3518376262,3683677062,1672614541,1672614639,98
10313,3510535683,3624365837,1672587523,1672590080,2557
11633,3884458862,3505804611,1672651998,1672652141,143
11453,3713224038,3519937708,1672553103,1672555636,2533
11485,3510869438,3714142299,1672603249,1672605241,1992
11203,3668369938,3512769522,1672658835,1672660080,1245
10639,3710147457,3756668747,1672567936,1672570373,2437
9806,3552922094,3489212992,1672608995,1672610493,1498
10165,3444295435,3639081201,1672674146,1672674338,192
10150,3805704844,3610517436,1672684923,1672685629,706
10890,3915679140,3510209505,1672588390,1672588725,335
11039,3511744756,3510824484,1672678266,1672681357,3091
10796,3778370462,3514776568,1672648806,1672649283,477
10462,3384713976,3311410533,1672671894,1672672116,222
11000,3511500932,3701493094,1672613096,1672614548,1452
11089,3501873139,3703999217,1672683038,1672685152,2114
9947,3622654885,3714892312,1672620956,1672621418,462
11673,3500211484,3703351452,1672668421,1672670539,2118
10247,3240443426,3453464785,1672556912,1672557064,152
11125,3407734098,3792021895,1672653097,1672655132,2035
11365,3242149533,3701668745,1672531460,1672533579,2119
10328,3756413374,3501004005,1672587028,1672590573,3545
9803,3302879906,3233712975,1672585114,1672587796,2682
9874,3501261089,3770424941,1672695661,1672697737,2076
11078,3714731729,3513140146,1672658024,1672659225,1201
10329,3713807753,3680075399,1672685807,1672686766,959
11776,3509433155,3888409038,1672672519,1672672859,340
10026,3357097510,3200320674,1672632811,1672636405,3594
9926,3605905645,3939422411,1672669997,1672670312,315
11693,3714923092,3517949586,1672575619,1672575819,200
11060,3227647190,3369270860,1672703883,1672706231,2348
11688,3309528048,3403870769,1672605671,1672608297,2626
11122,3684199077,3773770134,1672603353,1672606944,3591
11593,3236512807,3755942724,1672696687,1672699658,2971
11650,3793222045,3757001552,1672646773,1672650346,3573
10724,3510781595,3979115924,1672570036,1672570821,785
10433,3755670258,3715111016,1672533528,1672536694,3166
10744,3770533588,3519463038,1672681038,1672682680,1642
11404,3825877848,3818532143,1672657466,1672659741,2275
10501,3311231911,3517113478,1672642649,1672644315,1666
10739,3619705594,3756363182,1672626554,1672626973,419
10104,3757924067,3511883778,1672562293,1672565289,2996
11219,3309651238,3444295435,1672548508,1672549077,569
11127,3713807459,3668369938,1672660507,1672663710,3203
10608,3923133978,3777135415,1672569609,1672570126,517
10192,3513764665,3772962072,1672625989,1672627477,1488
9904,3907225070,3779505358,1672594222,1672595810,1588
11634,3295530454,3377446376,1672633236,1672635218,1982
10665,3534667712,3440671139,1672696782,1672697001,219
10355,3832002939,3273537848,1672640662,1672641334,672
10767,3716423829,3510153173,1672589878,1672590321,443
10583,3755342153,3783730769,1672575447,1672578692,3245
11458,3491948594,3602054754,1672598466,1672600795,2329
10760,3505148522,3783060739,1672651118,1672653572,2454
10034,3396656251,3772909073,1672670412,1672672498,2086
10655,3738103378,3439045964,1672698479,1672700111,1632
10845,3519357822,3517530943,1672660245,1672661971,1726
10346,3773848111,3246395239,1672671385,1672671932,547
11000,3630462406,3735197034,1672540392,1672540611,219
10460,3612042508,3500695402,1672601831,1672602306,475
10696,3497562878,3514761434,1672642780,1672644852,2072
11045,3760271237,3314965818,1672661908,1672663104,1196
10365,3515230715,3770012744,1672562498,1672563971,1473
11323,3780173788,3616403486,1672568218,1672570446,2228
10416,3429587594,3791994414,1672639942,1672641620,1678
11355,3552309108,3809207482,1672586777,1672586995,218
10586,3509614126,3342027511,1672627710,1672628250,540
10731,3432466467,3901217668,1672656186,1672656724,538
11276,3856601074,3604569804,1672553379,1672555311,1932
10616,3791236983,3852992961,1672675317,1672675559,242
11587,3738547113,3505245692,1672540920,1672541735,815
10182,3285971415,3512395783,1672692788,1672693734,946
10729,3487231844,3206544535,1672563695,1672565808,2113
10757,3314363575,3770924034,1672561700,1672562503,803
10119,3757523596,3227498870,1672561932,1672563341,1409
10630,3360972732,3302879906,1672700578,1672702342,1764
10862,3711810268,3850005949,1672540557,1672543614,3057
10297,3379400553,3793860209,1672647034,1672649901,2867
11081,3783043770,3609166109,1672551151,1672552987,1836
11013,3713191326,3242149533,1672581721,1672583788,2067
10421,3244397548,3411626917,1672555497,1672555881,384
11459,3403120725,3779748270,1672548764,1672551834,3070
11179,3511466117,3229621693,1672551612,1672554196,2584
11579,3514107131,3430399931,1672642032,1672642919,887
9861,3774273260,3510159441,1672642586,1672642878,292
10757,3534499421,3716463756,1672601473,1672603022,1549
9911,3557129226,3701668745,1672549813,1672550370,557
10516,3857244486,3500096103,1672555667,1672555758,91
11363,3665431349,3757201138,1672643442,1672646114,2672
10773,3701377471,3490008012,1672646503,1672648896,2393
10025,3463892928,3501628472,1672612037,1672612370,333
10134,3689386663,3778044082,1672556477,1672558324,1847
9820,3450503086,3517810375,1672688276,1672688851,575
11285,3806471413,3430032005,1672541257,1672544537,3280
11292,3826315540,3433189219,1672545211,1672547004,1793
10518,3298113026,3773953689,1672545050,1672545901,851
10077,3470962222,3500931474,1672574074,1672574820,746
11716,3201634072,3443580855,1672688093,1672690601,2508
10827,3434052463,3714294005,1672595369,1672598754,3385
10724,3710783759,3638126174,1672574065,1672576820,2755
10382,3780941637,3783313202,1672589376,1672590423,1047
9820,3505685294,3770530739,1672586640,1672589553,2913
10814,3512337054,3616371564,1672599734,1672601379,1645
11371,3309178914,3517960740,1672651307,1672653856,2549
10669,3517469005,3760648750,1672685656,1672686664,1008
10950,3773394570,3351837521,1672665077,1672667215,2138
9990,3287821258,3271780525,1672631815,1672634507,2692
10564,3780435349,3304447950,1672565747,1672567525,1778
11380,3682150740,3281970147,1672636424,1672639829,3405
11660,3510826414,3505804611,1672675586,1672677603,2017
10580,3534328311,3776053084,1672531808,1672532313,505
10078,3505709407,3488749569,1672649071,1672650897,1826
10977,3364660506,3380185102,1672570392,1672571830,1438
10548,3388915945,3511069449,1672684574,1672687564,2990
11439,3505155858,3352057037,1672641218,1672644580,3362
10811,3792785261,3783563043,1672598143,1672598543,400
9960,3330318282,3734233216,1672568076,1672569012,936
10445,3780964089,3516517348,1672566021,1672568841,2820
10440,3730115019,3609925909,1672600460,1672601833,1373
10927,3276499910,3505140123,1672666372,1672666738,366
11343,3505491969,3519065870,1672563772,1672566141,2369
10115,3979366845,3934070285,1672661982,1672663318,1336
11110,3501980730,3505500523,1672659156,1672662301,3145
11074,3501356814,3733953055,1672602550,1672604142,1592
10599,3231153513,3388915945,1672547891,1672550285,2394
9813,3483701493,3379076106,1672694086,1672694366,280
11523,3273674596,3311432176,1672652545,1672655211,2666
11662,3701893620,3295748489,1672608815,1672611195,2380
10364,3312612693,3701919083,1672637899,1672640811,2912
9922,3517331746,3377446376,1672653901,1672656999,3098
10970,3772070986,3439045964,1672657671,1672660438,2767
11335,3512395783,3710125627,1672554064,1672556135,2071
10172,3466492108,3403150349,1672689058,1672691837,2779
9985,3755688231,3487779363,1672589611,1672590530,919
11747,3458753033,3703849264,1672595961,1672599416,3455
11262,3668369938,3295787354,1672699436,1672699755,319
11331,3778706119,3711770853,1672557185,1672557318,133
10923,3302988745,3346755179,1672594170,1672595651,1481
11694,3511640720,3614484939,1672677855,1672681130,3275
11478,3701385831,3791332226,1672661751,1672662388,637
10653,3855222429,3480270940,1672568539,1672571424,2885
10054,3441683673,3497138014,1672661286,1672661865,579
11758,3500695402,3446218191,1672646720,1672646900,180
10296,3243305367,3291936679,1672532332,1672533080,748
10651,3716676869,3851515560,1672627124,1672628560,1436
9868,3520160414,3770972037,1672582479,1672583515,1036
11603,3519951586,3510143850,1672648413,1672651576,3163
11358,3514033319,3436401020,1672639056,1672640092,1036
10017,3978417055,3312800145,1672627630,1672631160,3530
10839,3238056215,3355430975,1672638433,1672640646,2213
10472,3463564410,3432762943,1672638410,1672639792,1382
11285,3703462221,3519255644,1672665195,1672668060,2865
10680,3341311972,3772343750,1672567145,1672568650,1505
11640,3703697059,3511645260,1672702557,1672703440,883
10729,3505097206,3301765144,1672593018,1672593920,902
10417,3400560073,3469663062,1672564427,1672565655,1228
10003,3517426473,3661359073,1672664574,1672666117,1543
10617,3331228758,3701412729,1672591549,1672594835,3286
10140,3452024572,3804779247,1672639835,1672643113,3278
11057,3517766135,3838039092,1672604542,1672607747,3205
11393,3622654885,3411213032,1672676597,1672677441,844
10098,3600441934,3710223875,1672612953,1672615295,2342
10444,3201419050,3514216460,1672565071,1672567741,2670
11378,3904485393,3510680251,1672649449,1672649622,173
11242,3511526885,3444598583,1672632114,1672633097,983
10239,3513486828,3377883705,1672596165,1672599326,3161
10343,3779706467,3780964089,1672666239,1672669003,2764
11760,3512819376,3207307681,1672668329,1672670072,1743
10714,3517627003,3520558137,1672638894,1672639116,222
10462,3913746581,3792972270,1672574782,1672576578,1796
11360,3505148522,3480259863,1672589159,1672591931,2772
11718,3516932899,3512527440,1672570626,1672572098,1472
11425,3755924094,3533859712,1672641764,1672644746,2982
11562,3716994924,3273242177,1672613735,1672614528,793
10721,3701956841,3773434690,1672560851,1672561056,205
11388,3773636983,3505291330,1672651198,1672652707,1509
11601,3739387948,3716647407,1672582895,1672586424,3529
10762,3520553959,3452175941,1672569294,1672571481,2187
9961,3471555057,3505845400,1672540185,1672542226,2041
11579,3714424237,3701655378,1672567887,1672569842,1955
10468,3377446376,3285515107,1672641068,1672642596,1528
11314,3802374620,3714838100,1672651933,1672653079,1146
10448,3713283029,3760271237,1672613596,1672615803,2207
10354,3701028092,3684108920,1672560834,1672562236,1402
11319,3682086200,3519055736,1672614593,1672615509,916
10784,3389367628,3480259863,1672562669,1672565972,3303
11529,3516319492,3513890046,1672687681,1672689168,1487
9954,3906693728,3249614888,1672640883,1672641341,458
10545,3736056340,3611939581,1672659981,1672661211,1230
10612,3293898029,3518478484,1672625780,1672629031,3251
11337,3475653510,3249614888,1672551725,1672552953,1228
11227,3619494735,3783679478,1672689844,1672692940,3096
11515,3777204977,3500011591,1672689396,1672692496,3100
10363,3756647451,3932491622,1672681688,1672685249,3561
10663,3791574640,3379666159,1672620050,1672623645,3595
10482,3511476353,3554236075,1672619083,1672619839,756
10292,3910020031,3778605154,1672581258,1672581588,330
11305,3833520635,3713969196,1672586301,1672587185,884
11602,3755779925,3773826624,1672671291,1672672069,778
10038,3701448521,3520305100,1672664839,1672666761,1922
10890,3756616853,3487988841,1672618803,1672621686,2883
10332,3385481989,3476416072,1672673194,1672676415,3221
11455,3505887814,3513850048,1672645346,1672648086,2740
9809,3358211034,3780941637,1672637711,1672640128,2417
11257,3461877104,3904846341,1672643910,1672647092,3182
11681,3340723781,3512744657,1672679046,1672680203,1157
11592,3683562111,3793920312,1672537546,1672541085,3539
11468,3916656185,3770671714,1672661864,1672663624,1760
9922,3520832066,3239990061,1672656269,1672656375,106
10804,3792900315,3757311529,1672594722,1672596625,1903
10176,3791664049,3634766042,1672598469,1672601377,2908
9819,3514297012,3509562377,1672548028,1672551065,3037
11690,3559112196,3375257546,1672593782,1672595544,1762
10764,3779212271,3783826338,1672592525,1672595020,2495
11024,3495446254,3284483177,1672571814,1672572755,941
11215,3780148144,3534284132,1672605112,1672608360,3248
11303,3919342147,3770424892,1672655767,1672658858,3091
10984,3517136772,3681274982,1672636901,1672640390,3489
10861,3516249472,3509394912,1672698631,1672702186,3555
10198,3338195686,3498803823,1672692257,1672694413,2156
10870,3418683594,3515047288,1672613573,1672615464,1891
9896,3810584695,3509828883,1672595272,1672596930,1658
11483,3520395850,3710865678,1672575782,1672576027,245
10456,3302416197,3632189887,1672576944,1672579315,2371
11361,3774706478,3616403486,1672576922,1672577496,574
11694,3422915648,3825877848,1672585100,1672588647,3547
10295,3407398464,3512087090,1672560227,1672562054,1827
9912,3415840750,3500120676,1672625710,1672625908,198
11692,3511028193,3304697982,1672640157,1672642398,2241
9838,3778382224,3638126174,1672677545,1672678270,725
11312,3454343398,3220798451,1672658586,1672661590,3004
11601,3469350379,3311959533,1672592040,1672594806,2766
10813,3780648744,3501554468,1672578981,1672581470,2489
10906,3618024815,3772609551,1672689312,1672689541,229
11324,3413511621,3703438617,1672610221,1672612098,1877
10940,3804075198,3533473206,1672560893,1672563863,2970
9840,3773738817,3778741325,1672551297,1672553130,1833
11755,3716740576,3783060739,1672600668,1672602404,1736
10203,3772112976,3703572036,1672544351,1672545252,901
11605,3354968884,3332840671,1672599720,1672600722,1002
11584,3927504954,3710008760,1672609220,1672611975,2755
11631,3356599815,3500018566,1672647191,1672650682,3491
11348,3336501403,3915652382,1672648874,1672650676,1802
10449,3517718901,3778479297,1672666271,1672668567,2296
11479,3220123678,3228477490,1672546230,1672548378,2148
10712,3511794841,3703818358,1672536130,1672537017,887
10019,3293898029,3476144563,1672636608,1672638017,1409
10173,3713920790,3620105539,1672688832,1672691192,2360
9822,3701171318,3755394177,1672565070,1672566125,1055
11062,3421956717,3772569860,1672572840,1672573337,497
10278,3516904926,3533726421,1672574832,1672575425,593
10103,3200372897,3514361485,1672567745,1672570781,3036
10621,3400025324,3284865931,1672613862,1672616605,2743
10873,3756675909,3755502373,1672573867,1672577409,3542
10737,3711804184,3358675021,1672568506,1672568694,188
10686,3772802020,3513859809,1672636089,1672639172,3083
11200,3756740153,3923524564,1672573689,1672575636,1947
10690,3755570137,3314363575,1672700173,1672703639,3466
10820,3417969824,3774965463,1672626179,1672628984,2805
11256,3409078869,3776727271,1672668255,1672668641,386
10026,3760541837,3287920864,1672700915,1672703342,2427
10797,3890211161,3792719263,1672602831,1672604031,1200
11488,3937636109,3513143959,1672632659,1672636138,3479
10615,3739395381,3791070926,1672578621,1672581371,2750
10571,3935569749,3854957153,1672575891,1672576321,430
11032,3710271021,3513293711,1672661097,1672662430,1333
11101,3714883746,3858497718,1672587720,1672588835,1115
11710,3223796145,3534812391,1672644696,1672646096,1400
10939,3701218904,3236563828,1672700579,1672701196,617
10402,3791245127,3791825536,1672572514,1672572954,440
11244,3938059867,3711852131,1672702197,1672702407,210
11312,3760274119,3792475476,1672654235,1672656453,2218
10794,3713807459,3231271498,1672551904,1672553922,2018
10673,3772683155,3283785820,1672648302,1672649408,1106
10357,3820200446,3613781977,1672586438,1672588095,1657
10615,3818570577,3935256825,1672655678,1672655937,259
11426,3510143850,3511500932,1672593253,1672595221,1968
11400,3472774606,3715680249,1672661661,1672662802,1141
10585,3472272792,3710487368,1672676363,1672679635,3272
11467,3364302157,3730600658,1672666134,1672669186,3052
11406,3240877710,3756998113,1672698848,1672700820,1972
10193,3501873139,3515655024,1672532911,1672535014,2103
9842,3715622084,3501988762,1672686689,1672688772,2083
11469,3783942518,3501407804,1672551778,1672551867,89
10385,3443004958,3336225953,1672702193,1672702841,648
11117,3792455305,3806034626,1672596342,1672599253,2911
11750,3453464785,3715419141,1672694381,1672697536,3155
10672,3916673751,3774702364,1672550377,1672552156,1779
11084,3396472026,3701663839,1672554485,1672554611,126
10526,3352493805,3853783593,1672634323,1672636938,2615
9840,3272581469,3421040626,1672586131,1672587324,1193
9928,3311410533,3780576351,1672544563,1672546307,1744
9941,3831981073,3510368377,1672548205,1672550719,2514
9857,3514353133,3755502373,1672599032,1672601659,2627
11752,3336225953,3713969196,1672589526,1672591956,2430
11610,3774606418,3370448531,1672642915,1672644674,1759
10776,3366164642,3226761201,1672666628,1672669681,3053
11085,3485468650,3248061684,1672648878,1672650318,1440
11066,3936851114,3505684690,1672588370,1672589607,1237
10720,3480405740,3711854614,1672670229,1672671502,1273
10802,3390444181,3441336851,1672632916,1672636430,3514
11606,3505129296,3792578118,1672598703,1672600959,2256
10033,3512417724,3911431642,1672599726,1672600207,481
11368,3556684272,3311188620,1672677024,1672680335,3311
11623,3777370992,3512641538,1672650817,1672652380,1563
9971,3778561231,3516257130,1672688463,1672689741,1278
11709,3311989687,3362368123,1672551039,1672554513,3474
9930,3619538249,3779427180,1672575874,1672579105,3231
10609,3832002939,3609997804,1672647120,1672649818,2698
11314,3406390503,3713920790,1672648153,1672650148,1995
11103,3515597467,3505314920,1672660811,1672663484,2673
11239,3756876537,3360837082,1672608924,1672611958,3034
9999,3931917809,3470962222,1672687863,1672689699,1836
11655,3778382224,3205908584,1672590939,1672591117,178
9894,3414841458,3701374160,1672590859,1672591175,316
11339,3755175497,3510153173,1672615891,1672615956,65
10468,3755729826,3462645981,1672531804,1672531925,121
10200,3773736248,3809216145,1672699118,1672702474,3356
11700,3710515351,3924583142,1672642704,1672645079,2375
10715,3301765144,3714455496,1672602085,1672605221,3136
11682,3200320674,3713374884,1672542546,1672543346,800
11452,3711349327,3772250554,1672597060,1672599149,2089
11667,3737467358,3520182275,1672674352,1672677743,3391
11120,3498803823,3229621693,1672592877,1672593551,674
10710,3287753579,3308744016,1672648724,1672650914,2190
10182,3236886943,3358434853,1672673719,1672674194,475
10430,3713726267,3512527440,1672658292,1672661162,2870
10497,3273537848,3756763585,1672628727,1672629347,620
11058,3516486526,3446233783,1672647406,1672649416,2010
10830,3233993993,3500073824,1672542841,1672544802,1961
10199,3304227085,3335353798,1672613331,1672615594,2263
9930,3791716170,3716285196,1672533980,1672534968,988
11018,3760737203,3774483862,1672630606,1672633570,2964
11782,3792851584,3711190257,1672598776,1672601603,2827
11218,3520763492,3755670258,1672651202,1672653166,1964
10771,3500734346,3456795601,1672626060,1672628795,2735
9929,3972729768,3703104365,1672548508,1672549773,1265
10425,3778253021,3936871734,1672661943,1672662882,939
11434,3417969824,3534578428,1672672813,1672676249,3436
11326,3244397548,3515802579,1672703658,1672706488,2830
10926,3716195780,3240877710,1672647803,1672648746,943
11584,3780982229,3245882008,1672670971,1672674467,3496
11773,3783368855,3776468503,1672549810,1672550545,735
10079,3733953055,3367109648,1672646336,1672648045,1709
11005,3930501172,3710223875,1672656217,1672656459,242
9864,3512769522,3834643026,1672542898,1672544760,1862
11454,3664478769,3756079870,1672662272,1672665700,3428
10101,3370751461,3975799349,1672567101,1672567826,725
9866,3710296607,3442073613,1672599214,1672600282,1068
11662,3710223875,3778702093,1672584138,1672585763,1625
11284,3516651799,3665603628,1672580317,1672583636,3319
11750,3716891903,3668855144,1672701449,1672704838,3389
11054,3510189563,3467756698,1672654810,1672657425,2615
10101,3245245283,3510694464,1672648612,1672650713,2101
9944,3505066871,3838748301,1672555941,1672559157,3216
10379,3276209319,3703732445,1672538003,1672540316,2313
10903,3461743188,3804095239,1672662319,1672665109,2790
11017,3470997293,3509377714,1672537550,1672540490,2940
11327,3821103640,3520362238,1672659781,1672661960,2179
11460,3770966950,3793689267,1672655212,1672657575,2363
10827,3512546783,3852310652,1672610129,1672612831,2702
10244,3903994989,3611533094,1672702948,1672703471,523
10914,3424425746,3623512088,1672573535,1672575953,2418
10334,3509651954,3776455762,1672614127,1672616736,2609
10670,3914947393,3680278447,1672555228,1672557298,2070
10719,3478052226,3533325993,1672545771,1672547770,1999
11203,3239990061,3510987684,1672618458,1672619212,754
10543,3303432071,3905934770,1672703554,1672705628,2074
11015,3308744016,3893950585,1672659081,1672661766,2685
10927,3513840186,3715750580,1672548167,1672550967,2800
11445,3500793739,3459694275,1672560847,1672561347,500
9857,3929355087,3520824937,1672541069,1672541594,525
11683,3923524564,3555378248,1672701110,1672701548,438
11356,3311774510,3511364193,1672548247,1672549783,1536
10547,3830291558,3405200303,1672580725,1672583440,2715
10523,3419762444,3857847527,1672666199,1672667177,978
11196,3770709417,3756784813,1672696351,1672698090,1739
9840,3505392452,3500079479,1672563963,1672565756,1793
11028,3714424237,3605101443,1672647133,1672650255,3122
10949,3770981604,3513140146,1672536015,1672539290,3275
10698,3246062632,3511341866,1672671766,1672672769,1003
11639,3783942518,3505164060,1672531226,1672532106,880
10281,3221126799,3554317844,1672574314,1672577609,3295
11729,3735422623,3760481622,1672606973,1672608853,1880
10706,3313795594,3465227623,1672595036,1672595574,538
10835,3290060215,3916656185,1672544222,1672546855,2633
11646,3688768189,3510368377,1672670301,1672672545,2244
9809,3514107131,3373135211,1672566803,1672569964,3161
9920,3791289855,3246804115,1672609832,1672613283,3451
11474,3780964089,3888523259,1672634572,1672637331,2759
11782,3620157388,3517617472,1672578787,1672581429,2642
11499,3308149799,3552922094,1672690120,1672692938,2818
11241,3500776597,3403738461,1672538720,1672542229,3509
11790,3487231844,3310961923,1672680612,1672682224,1612
10934,3435342362,3713694278,1672549788,1672550555,767
10150,3710807030,3239423794,1672587494,1672589832,2338
11553,3513996288,3604908372,1672541928,1672543331,1403
11512,3756525103,3703694139,1672584081,1672584459,378
10348,3436774112,3229621693,1672633101,1672633359,258
10953,3449020351,3791332061,1672676849,1672677247,398
9966,3770273459,3730459093,1672626778,1672629088,2310
11436,3776455762,3935333166,1672594491,1672595277,786
11466,3711862792,3779282072,1672628160,1672631417,3257
11073,3491948594,3276209319,1672625340,1672627242,1902
11787,3780941637,3711404205,1672602031,1672603055,1024
9989,3517766135,3501027795,1672551238,1672553089,1851
11569,3516378356,3534604516,1672587728,1672589522,1794
11572,3632094087,3500854711,1672610030,1672612490,2460
10427,3711179193,3711804184,1672679793,1672682659,2866
11409,3367526113,3756367938,1672648044,1672650297,2253
10852,3505129296,3621960662,1672651264,1672651582,318
10417,3439651226,3778318250,1672625099,1672627119,2020
11278,3283106998,3303552616,1672698518,1672700177,1659
11117,3899970524,3514145752,1672693950,1672696179,2229
10938,3533566754,3358959807,1672560530,1672561021,491
11482,3713990030,3511608609,1672639558,1672640374,816
10890,3443041059,3713514933,1672693357,1672694624,1267
11615,3511640720,3450621820,1672612124,1672615367,3243
11777,3517195738,3315432466,1672674294,1672677330,3036
11052,3371132167,3757393413,1672612428,1672612996,568
11057,3513111053,3714688409,1672584059,1672586612,2553
11670,3812277991,3919342147,1672538116,1672540673,2557
11453,3245755569,3772877723,1672560820,1672561868,1048
11267,3364948616,3473562779,1672623395,1672624704,1309
10979,3513215373,3850108828,1672567083,1672569182,2099
10731,3370401047,3514541800,1672681218,1672683013,1795
11648,3793732968,3711223297,1672676008,1672679301,3293
11398,3701971784,3395615598,1672547642,1672549767,2125
10000,3439651226,3272096922,1672683305,1672683422,117
10353,3293553295,3511003541,1672600233,1672601436,1203
11156,3319862687,3897186782,1672598105,1672598648,543
10441,3756736726,3285136057,1672694534,1672696058,1524
10112,3688768189,3973138649,1672556861,1672557759,898
10183,3500234771,3342031426,1672668587,1672669935,1348
11769,3757639274,3519886257,1672572590,1672573984,1394
9990,3227874229,3501759031,1672531686,1672532542,856
10693,3716179251,3853182912,1672555280,1672558728,3448
11029,3397330170,3519465545,1672641980,1672643075,1095
11786,3733411026,3317989975,1672648689,1672649205,516
10453,3908883591,3770574826,1672630608,1672631514,906
11542,3313282478,3710185376,1672637212,1672640528,3316
11543,3760382349,3777672363,1672531514,1672533097,1583
11730,3851877325,3517151644,1672674649,1672678218,3569
10034,3779340538,3755507566,1672558260,1672561006,2746
11705,3773408491,3839744168,1672666289,1672668546,2257
10851,3620105539,3394394262,1672580615,1672583341,2726
11599,3859191694,3756685732,1672576866,1672578937,2071
11148,3818532143,3509626590,1672559867,1672562923,3056
9939,3514541800,3714281795,1672660680,1672661888,1208
9916,3938129916,3533830748,1672557505,1672559166,1661
10895,3516731917,3343511947,1672549370,1672550787,1417
10897,3356972733,3342545285,1672571710,1672571952,242
10320,3701475090,3226761201,1672676371,1672678703,2332
11169,3500198430,3811351746,1672533132,1672533761,629
10166,3534770827,3935444008,1672634480,1672635359,879
9910,3534284132,3497138014,1672595743,1672597497,1754
11507,3509431396,3443102414,1672637238,1672640749,3511
11310,3772683155,3616371564,1672583769,1672585345,1576
10898,3610517436,3774109138,1672668580,1672668800,220
9991,3551833298,3396453219,1672592679,1672592802,123
9982,3825082811,3302929858,1672588142,1672588256,114
11461,3533440736,3509073025,1672693101,1672696064,2963
9947,3318590083,3609644043,1672543712,1672544730,1018
11217,3466149998,3505037247,1672670344,1672673825,3481
10994,3715724166,3293673220,1672542074,1672544429,2355
11310,3377446376,3512645289,1672699266,1672701810,2544
10992,3421956717,3229621693,1672572472,1672575672,3200
10983,3791194984,3513816744,1672670138,1672672891,2753
10827,3779454060,3757855416,1672620141,1672623588,3447
9928,3780050328,3311810583,1672604748,1672606717,1969
10799,3500922040,3793222045,1672661222,1672661360,138
11030,3388830370,3519162582,1672663286,1672666697,3411
10827,3395505794,3533620069,1672674361,1672675970,1609
9971,3710529628,3609997804,1672565137,1672568455,3318
10460,3200372897,3358385652,1672588954,1672591928,2974
11234,3311142523,3510218188,1672665626,1672668073,2447
10749,3773017746,3518794921,1672680021,1672682808,2787
11536,3777074709,3791628195,1672597105,1672599183,2078
11616,3533703578,3207586072,1672619561,1672621382,1821
9902,3924205112,3909457959,1672537389,1672538641,1252
9879,3445077330,3533929043,1672646392,1672648550,2158
11448,3514801709,3760541837,1672537676,1672541226,3550
9864,3830254808,3301431129,1672694505,1672695178,673
10223,3822368676,3501977123,1672693188,1672695878,2690
11150,3297100323,3501963428,1672626316,1672626622,306
10458,3452878062,3774965463,1672688779,1672690962,2183
10278,3509663119,3287968403,1672544852,1672547014,2162
10975,3247075753,3519228207,1672549990,1672550888,898
10224,3480560014,3898965585,1672623813,1672626133,2320
11535,3735838864,3757089924,1672698704,1672700557,1853
11659,3780173788,3434052463,1672602673,1672603474,801
10453,3505825767,3513740840,1672652137,1672655519,3382
10201,3904485393,3293540333,1672568654,1672571149,2495
10801,3475653510,3619538249,1672610403,1672613348,2945
11176,3369938668,3819315404,1672558595,1672559379,784
11578,3305727497,3517949586,1672536487,1672538103,1616
10325,3793407883,3701685828,1672533723,1672534213,490
10527,3500405175,3519831322,1672644838,1672648219,3381
10882,3305727497,3510694464,1672605728,1672608631,2903
10353,3365839890,3714516404,1672531840,1672534986,3146
10847,3701350519,3806471413,1672599448,1672600036,588
10618,3629869834,3919345990,1672613057,1672614639,1582
11440,3278430820,3822496670,1672575371,1672578477,3106
11001,3893629892,3511289729,1672657914,1672659091,1177
10140,3893629892,3711810268,1672690387,1672692542,2155
10079,3773853619,3501356814,1672567499,1672567590,91
10867,3505786561,3346755179,1672604703,1672605833,1130
11289,3511907179,3622152515,1672532297,1672532572,275
9933,3714074120,3755736024,1672694375,1672695272,897
10286,3793899166,3776001441,1672544608,1672547812,3204
10351,3738132114,3442073613,1672669235,1672670366,1131
10677,3398862999,3829761380,1672559115,1672561359,2244
11672,3361952532,3852992961,1672542848,1672543658,810
9841,3515970536,3207307681,1672689795,1672690750,955
10572,3685645561,3309415277,1672689421,1672691179,1758
11071,3415032547,3450164574,1672588650,1672591915,3265
10888,3204149913,3512411326,1672547977,1672550346,2369
9811,3341311972,3316551382,1672658157,1672661167,3010
11204,3270607273,3893527651,1672597087,1672600134,3047
11743,3715291931,3897186782,1672698639,1672698720,81
11145,3937854073,3511650296,1672577704,1672579754,2050
10791,3756272704,3437934509,1672590977,1672591338,361
9971,3737622701,3733411026,1672659532,1672660788,1256
10633,3272581469,3500536897,1672552401,1672555277,2876
11310,3604908372,3372596013,1672654362,1672657766,3404
10000,3807111856,3401215739,1672538065,1672540189,2124
11565,3916463490,3505836431,1672695037,1672696409,1372
10981,3378172464,3710051427,1672700524,1672702368,1844
10329,3783357035,3932955949,1672702915,1672704603,1688
10880,3517943697,3777498160,1672573292,1672573529,237
9988,3512784888,3447078933,1672679985,1672680164,179
10207,3792337863,3444453261,1672616695,1672617507,812
11753,3520189871,3310702648,1672547349,1672547938,589
10021,3902775449,3499820963,1672676754,1672678685,1931
11371,3382696725,3517718901,1672653925,1672655749,1824
11641,3398862999,3429315500,1672636450,1672639570,3120
10210,3534174363,3500793739,1672570524,1672572231,1707
11449,3756763585,3294164983,1672620815,1672622726,1911
11053,3550405857,3500799617,1672550553,1672552754,2201
10167,3713139039,3469778316,1672674132,1672675008,876
11608,3925792265,3304672737,1672668688,1672670487,1799
10307,3791548838,3501137133,1672614504,1672616564,2060
9805,3770424941,3505173665,1672667147,1672668511,1364
11580,3776867553,3351856699,1672550151,1672551100,949
10132,3277061226,3505867821,1672623239,1672626361,3122
10717,3755119166,3610517436,1672536423,1672537961,1538
11360,3624164232,3505175620,1672536844,1672537834,990
10976,3520165730,3469370398,1672672478,1672673423,945
11229,3332010532,3519730914,1672614899,1672615546,647
10679,3533113740,3777751979,1672624048,1672626654,2606
9944,3689420679,3343616490,1672589537,1672592458,2921
10037,3406390503,3450679913,1672691154,1672693177,2023
10923,3773041843,3682906048,1672597700,1672599610,1910
10704,3390444181,3511663572,1672598142,1672599846,1704
11688,3509828883,3851737350,1672696366,1672696837,471
10277,3783122313,3458271585,1672563614,1672565680,2066
11111,3341311972,3711755596,1672627660,1672628875,1215
11607,3511069449,3937636109,1672531822,1672532910,1088
10685,3772869013,3777928067,1672666500,1672666779,279
10569,3792289287,3293898029,1672650544,1672651539,995
11713,3773848111,3713444403,1672553541,1672556845,3304
10666,3777758203,3830771832,1672661622,1672663594,1972
11514,3620836520,3770285500,1672543523,1672544878,1355
11545,3853188285,3497562878,1672610179,1672611934,1755
10341,3834456158,3500785888,1672660762,1672661252,490
11590,3519937708,3779706467,1672702257,1672703902,1645
10187,3512337054,3551833298,1672687540,1672688382,842
10716,3395610742,3773432494,1672538974,1672541048,2074
11356,3716475340,3773768643,1672621858,1672623424,1566
11000,3206544535,3501126057,1672648920,1672651616,2696
10410,3505449070,3636877469,1672567230,1672568036,806
11524,3756680289,3436774112,1672630840,1672632811,1971
11086,3622654885,3513508737,1672593446,1672595133,1687
10263,3714640103,3227339675,1672563388,1672564088,700
10887,3757639274,3668154066,1672659990,1672661275,1285
10717,3235578121,3516969689,1672559356,1672562165,2809
11298,3701041860,3897186782,1672558519,1672559366,847
10775,3244395841,3774663639,1672658159,1672661291,3132
10465,3703502114,3243056734,1672643800,1672644789,989
11228,3418367752,3452802329,1672667518,1672668133,615
11219,3716209499,3755218683,1672597895,1672599325,1430
10446,3500793739,3600699873,1672533652,1672535577,1925
11308,3757060033,3404187438,1672630035,1672630257,222
11511,3516321814,3714951681,1672562131,1672564671,2540
10028,3711671702,3231654754,1672626985,1672628126,1141
11733,3387706541,3465107990,1672597913,1672598887,974
10554,3662821438,3297684667,1672590208,1672590307,99
10471,3362368123,3394959062,1672569013,1672570871,1858
10984,3512306195,3803382101,1672696877,1672699953,3076
10570,3227206772,3757584114,1672560572,1672562576,2004
10717,3714067998,3517718901,1672532398,1672535951,3553
10507,3834949242,3399504157,1672643015,1672643254,239
11437,3367202274,3418382025,1672682992,1672685392,2400
10720,3244098077,3520506192,1672591716,1672593704,1988
11653,3516167000,3703206956,1672569612,1672572934,3322
11555,3284374600,3927699036,1672606421,1672608057,1636
10201,3793222045,3500178849,1672586777,1672590273,3496
10975,3480108752,3791587717,1672654832,1672656084,1252
11539,3500011591,3893950585,1672609957,1672612275,2318
11782,3906874577,3714595459,1672541671,1672544350,2679
10731,3474852115,3808849597,1672594138,1672597342,3204
10339,3620105539,3777992576,1672688194,1672689807,1613
11623,3518205307,3714903456,1672583443,1672585721,2278
11646,3733730342,3351949206,1672692507,1672694722,2215
11312,3686081254,3342031426,1672567079,1672570222,3143
10522,3513859809,3510758718,1672663676,1672665913,2237
11115,3505908965,3914926436,1672673937,1672675804,1867
11606,3512504247,3909067335,1672561768,1672565343,3575
10791,3777498160,3355903597,1672650967,1672651148,181
11021,3512794667,3505351253,1672555001,1672555540,539
9972,3534459983,3661543201,1672609759,1672611749,1990
10120,3738734246,3897186782,1672547372,1672550737,3365
10458,3498857406,3808849597,1672615296,1672617417,2121
11230,3774251051,3510368377,1672677282,1672680409,3127
11721,3510218188,3452104161,1672629691,1672632876,3185
11384,3470997293,3730290851,1672654409,1672656642,2233
11650,3783730769,3714525519,1672559249,1672559877,628
11736,3393502004,3387706541,1672574457,1672577142,2685
10610,3236360179,3515597467,1672656692,1672658660,1968
10281,3233993993,3311432176,1672551588,1672554997,3409
11396,3288920399,3662495290,1672532099,1672533275,1176
10023,3510836047,3756536476,1672615806,1672617358,1552
10051,3777263928,3312651192,1672677318,1672678826,1508
10546,3534190196,3487231844,1672611695,1672615216,3521
10212,3715126587,3461137945,1672683916,1672685307,1391
9999,3533036499,3621591266,1672658081,1672661364,3283
11031,3783368855,3770019143,1672671967,1672675419,3452
10213,3515893948,3756149282,1672652589,1672655005,2416
10373,3710852576,3513800589,1672613576,1672616242,2666
9950,3520012007,3908331271,1672657977,1672660074,2097
11722,3399726243,3606688595,1672639452,1672640133,681
10272,3284829602,3293579860,1672581709,1672585152,3443
10462,3703697059,3779174993,1672575812,1672577789,1977
11620,3417360319,3703694139,1672684755,1672688311,3556
10288,3710529628,3353194923,1672610003,1672610304,301
11496,3306037126,3837435907,1672575652,1672576560,908
10922,3891586951,3777932581,1672600939,1672604449,3510
11373,3229615214,3715852330,1672586824,1672587516,692
9921,3201419050,3367262509,1672595230,1672595557,327
10023,3511028193,3517552930,1672538047,1672540342,2295
9844,3777387533,3931028233,1672538687,1672540190,1503
11249,3436774112,3200320674,1672624074,1672627348,3274
11290,3703588004,3711190257,1672633743,1672635650,1907
11218,3760416450,3778044082,1672540205,1672542704,2499
10876,3834949242,3818904268,1672557802,1672559298,1496
10408,3680075399,3407734098,1672602449,1672604131,1682
10619,3887030182,3713566527,1672638232,1672640638,2406
11227,3891586951,3772234939,1672577159,1672579124,1965
10386,3776593726,3760529327,1672683847,1672686523,2676
10889,3511028193,3776279305,1672581231,1672584069,2838
9941,3459799131,3619538249,1672583525,1672585415,1890
10996,3405200303,3770533588,1672610169,1672611161,992
9861,3713285095,3517440258,1672532041,1672532366,325
11157,3755170743,3446575109,1672630438,1672631272,834
11614,3364286028,3893950585,1672573193,1672574061,868
9970,3514585995,3295710494,1672651655,1672653584,1929
11505,3614112171,3884862164,1672608631,1672610832,2201
11766,3428878402,3289017988,1672610510,1672611482,972
10853,3298706213,3402338011,1672546231,1672549321,3090
11411,3238779889,3701171318,1672658986,1672661284,2298
9913,3467944159,3621960662,1672671058,1672674084,3026
10208,3801379377,3756328353,1672554009,1672554999,990
9970,3462153833,3520697518,1672585397,1672587274,1877
11572,3510022922,3235470567,1672639504,1672641602,2098
10982,3534604516,3734233216,1672576953,1672579680,2727
11566,3533365834,3517800171,1672612509,1672613563,1054
11264,3791359168,3513215373,1672576386,1672577879,1493
11037,3319436533,3337673625,1672552226,1672553530,1304
9991,3630462406,3627081426,1672645269,1672647296,2027
10028,3770275898,3616371564,1672554960,1672558108,3148
11599,3757660578,3511729562,1672548068,1672548849,781
11332,3294326116,3757497708,1672548437,1672551496,3059
11203,3887502536,3437703650,1672663301,1672666274,2973
10810,3517083465,3760966645,1672663524,1672665448,1924
11206,3792682835,3685877449,1672617400,1672619736,2336
10635,3828354855,3378729459,1672546749,1672548502,1753
10210,3385006834,3711171132,1672565236,1672566508,1272
11105,3469350379,3459163055,1672595906,1672599252,3346
10837,3776581518,3272328752,1672652465,1672655471,3006
10203,3809860102,3910190872,1672697022,1672698214,1192
11538,3420881591,3791532324,1672649816,1672651366,1550
10449,3777063455,3511069449,1672649897,1672650237,340
11289,3780648744,3906693728,1672647490,1672649107,1617
9898,3803996569,3703336988,1672621087,1672623126,2039
11570,3380444321,3500595432,1672546519,1672547976,1457
10742,3443004958,3319862687,1672563348,1672566236,2888
10636,3776348472,3408111327,1672574584,1672575656,1072
10210,3713726267,3897003751,1672539521,1672543018,3497
10093,3520553959,3890278838,1672635662,1672637026,1364
11701,3714294005,3701887470,1672586081,1672589394,3313
11255,3807111856,3713807459,1672659271,1672662264,2993
11455,3621629499,3490804766,1672701805,1672703937,2132
11404,3516020922,3340723781,1672571005,1672571706,701
10096,3732104286,3500096103,1672695119,1672696823,1704
10522,3780467276,3249380931,1672575338,1672578815,3477
11467,3319862687,3512395783,1672610002,1672611569,1567
11285,3932566114,3505291330,1672600757,1672603046,2289
11314,3423940256,3776727271,1672666464,1672668280,1816
9879,3777439655,3613936929,1672689708,1672690417,709
10014,3703048107,3520763492,1672657036,1672659633,2597
11729,3684108920,3474074188,1672591109,1672592802,1693
11097,3662495290,3516497645,1672669525,1672672538,3013
11175,3553321027,3793719515,1672608823,1672611615,2792
10819,3517627003,3513802404,1672559416,1672560533,1117
11170,3340321384,3509317054,1672672524,1672674785,2261
11649,3490953301,3834949242,1672688322,1672689820,1498
11791,3517816581,3354405535,1672679911,1672682444,2533
11650,3410788026,3469663062,1672537614,1672538660,1046
11352,3446575109,3710228292,1672623343,1672624716,1373
11491,3701311947,3772845364,1672695146,1672696640,1494
10414,3500473064,3512697456,1672686784,1672689590,2806
10768,3520344592,3282240901,1672611484,1672614228,2744
10800,3534204885,3400112498,1672548793,1672551138,2345
11209,3625400710,3760144712,1672576369,1672576767,398
10055,3479207976,3776166086,1672599619,1672603080,3461
10189,3494748808,3500555856,1672577416,1672578654,1238
10638,3791031227,3339331632,1672614032,1672616951,2919
10140,3371132167,3713434898,1672653012,1672654149,1137
11151,3275661834,3518511124,1672695309,1672698244,2935
11466,3773636983,3755374000,1672662038,1672663309,1271
11689,3756066765,3896211741,1672543747,1672544712,965
11105,3757513651,3501126057,1672661165,1672662391,1226
10213,3710529628,3513740840,1672627038,1672629641,2603
10794,3505720915,3505331083,1672573069,1672575816,2747
10928,3665431349,3419762444,1672549664,1672551085,1421
11061,3776440009,3885147558,1672670752,1672670959,207
10514,3294326116,3732533330,1672558567,1672558956,389
10272,3755119166,3714074120,1672616233,1672617648,1415
11015,3972196462,3517380144,1672687075,1672688419,1344
10488,3636857871,3682266017,1672606706,1672608975,2269
10188,3926724515,3534362749,1672634043,1672634508,465
10843,3467415939,3505438826,1672559196,1672559801,605
9888,3783611957,3734233216,1672681338,1672681642,304
11235,3807584987,3755192104,1672614921,1672618266,3345
10419,3273537848,3512769522,1672601660,1672604595,2935
11133,3534174363,3500536897,1672662980,1672665321,2341
11564,3776166086,3887030182,1672549667,1672552864,3197
10632,3755374000,3229615214,1672606097,1672608487,2390
10933,3414841458,3247193800,1672702134,1672705048,2914
11462,3835982340,3515470462,1672533276,1672536339,3063
10053,3713416756,3682241594,1672531395,1672532415,1020
11212,3497904539,3780013266,1672585452,1672588593,3141
10105,3369938668,3713858538,1672627903,1672628722,819
10362,3514329209,3442403264,1672702720,1672704311,1591
10517,3622654885,3716647407,1672544550,1672546895,2345
10321,3516034245,3899756737,1672588055,1672590118,2063
11283,3783086267,3777499535,1672607855,1672609437,1582
10877,3713606829,3770715115,1672673721,1672674558,837
10151,3636927297,3603167427,1672543368,1672544233,865
10356,3500814753,3552261072,1672536213,1672536342,129
11057,3715441786,3666367524,1672549373,1672550662,1289
10660,3379400553,3516965624,1672555660,1672558397,2737
10530,3516668203,3780921044,1672596155,1672599399,3244
10661,3922409420,3505140123,1672578011,1672579539,1528
11239,3880788853,3447591143,1672607907,1672609044,1137
10463,3480418192,3388774559,1672662741,1672665643,2902
10858,3505491969,3888903181,1672562599,1672565463,2864
9811,3306475287,3738160394,1672695352,1672696222,870
9910,3444295435,3780423516,1672613813,1672615682,1869
11029,3818532143,3291936679,1672667755,1672669634,1879
9847,3500031401,3714264759,1672650397,1672650854,457
11761,3688410383,3515100211,1672622751,1672623308,557
10054,3912878303,3201634072,1672596946,1672600350,3404
11237,3792597493,3854229296,1672546279,1672547515,1236
10870,3311805161,3710119555,1672689397,1672691637,2240
10836,3821082558,3778604070,1672650951,1672651338,387
10004,3627377299,3791031227,1672646488,1672649638,3150
11641,3517253559,3922430928,1672538563,1672539046,483
11194,3314965818,3311479294,1672622518,1672626068,3550
9912,3368848936,3933562725,1672698096,1672701304,3208
10762,3613828705,3512784888,1672621600,1672624431,2831
11276,3778370462,3783357035,1672672666,1672673660,994
11788,3512744657,3453164933,1672669535,1672670279,744
10643,3273242177,3905955166,1672664963,1672668538,3575
11115,3713767153,3511286390,1672694203,1672696249,2046
10384,3714838100,3387989658,1672613444,1672616557,3113
10897,3510368377,3710680073,1672640102,1672640721,619
9877,3891586951,3710271021,1672623560,1672626418,2858
11067,3611939581,3783373085,1672640027,1672643464,3437
11525,3732540636,3510638085,1672555783,1672556023,240
10650,3513894659,3533365834,1672552750,1672555280,2530
10415,3893043842,3203151036,1672672111,1672675195,3084
10354,3780680252,3518989186,1672643727,1672645829,2102
10710,3772223331,3814289471,1672559143,1672560986,1843
11609,3497138014,3516969689,1672670234,1672671100,866
11742,3505331014,3479207976,1672595599,1672598203,2604
10224,3505119470,3367299721,1672628477,1672629608,1131
11006,3914740937,3756536512,1672685008,1672686652,1644
11666,3518794921,3713606829,1672613677,1672614662,985
10588,3224053840,3770574826,1672552479,1672554374,1895
11380,3388937390,3497904539,1672623482,1672624268,786
10836,3297100323,3716526314,1672665735,1672667315,1580
9957,3920116284,3852310652,1672682135,1672682884,749
10554,3821087562,3505491969,1672682910,1672685260,2350
11463,3802374620,3510987684,1672597534,1672600648,3114
10152,3793003432,3772251279,1672631315,1672633912,2597
11733,3805616707,3665478011,1672576202,1672577579,1377
11021,3805926853,3293898029,1672552502,1672554429,1927
11484,3420881591,3824259677,1672693466,1672694930,1464
11709,3932955949,3730935770,1672656625,1672659740,3115
10731,3830254808,3319061210,1672611078,1672611792,714
11145,3498857406,3713740434,1672648309,1672650477,2168
10898,3311200541,3607583720,1672577435,1672578421,986
9932,3715246385,3430296808,1672566306,1672569713,3407
9970,3737622701,3201634072,1672630108,1672632181,2073
11123,3311015817,3505547832,1672700975,1672701210,235
11149,3380357490,3909504515,1672579304,1672582294,2990
11258,3780050146,3374348845,1672581103,1672583102,1999
11770,3236512807,3710819760,1672647687,1672649845,2158
10283,3501600785,3779282072,1672602783,1672603795,1012
11572,3243651036,3773554767,1672673954,1672674145,191
10494,3778544203,3792162098,1672665187,1672666448,1261
10140,3897186782,3627081426,1672668771,1672669648,877
10124,3515637968,3501370430,1672590154,1672592923,2769
10595,3476958001,3505291330,1672604954,1672605959,1005
11485,3307791650,3520824937,1672642415,1672644565,2150
9813,3534374523,3514508773,1672642209,1672644286,2077
11750,3520022175,3617771673,1672623695,1672625157,1462
11104,3827981800,3730571757,1672651044,1672651322,278
11686,3500624846,3756761603,1672588156,1672590499,2343
10749,3440671139,3791106473,1672687823,1672690151,2328
10370,3275751794,3276393542,1672674656,1672677571,2915
10287,3513545735,3311449914,1672535816,1672539300,3484
11522,3803382101,3445896667,1672586266,1672587800,1534
10662,3347205332,3499998389,1672617939,1672618748,809
10941,3776291254,3783238023,1672623041,1672625782,2741
11121,3533986052,3520012007,1672611869,1672613585,1716
11412,3393001196,3512133625,1672676154,1672678538,2384
10428,3283106998,3917243005,1672646027,1672647270,1243
11258,3714690161,3288920399,1672621027,1672623059,2032
10747,3280208630,3756328353,1672552539,1672555401,2862
10213,3921736061,3780048608,1672559887,1672560209,322
11249,3295710494,3899970524,1672679635,1672682660,3025
11184,3511640720,3227874229,1672679440,1672682565,3125
10970,3884862164,3520625600,1672597895,1672600517,2622
11672,3755286041,3533960602,1672610608,1672613315,2707
10742,3450234157,3301369282,1672584945,1672587330,2385
10753,3760074281,3557324887,1672569089,1672569927,838
10581,3534459983,3281148858,1672543845,1672545102,1257
9995,3714903253,3331471764,1672647687,1672650225,2538
10980,3516668203,3294821709,1672590667,1672592684,2017
9984,3509379617,3911821258,1672607667,1672609470,1803
10494,3242149533,3516867729,1672571246,1672573368,2122
10192,3406937294,3420664407,1672676436,1672678003,1567
10008,3511744756,3478937459,1672581771,1672584513,2742
11117,3511615015,3500555856,1672560513,1672561393,880
10671,3760416450,3824657614,1672684190,1672684629,439
10485,3855440101,3600842635,1672655459,1672655899,440
10268,3791698084,3510894809,1672640660,1672643645,2985
10848,3714281795,3773768643,1672587925,1672589304,1379
11753,3505032644,3520344592,1672688429,1672691382,2953
11342,3403870769,3500057674,1672639478,1672643074,3596
11161,3856975623,3440305508,1672605552,1672606005,453
10045,3909632424,3756536476,1672685142,1672685747,605
10554,3855222429,3910020031,1672568297,1672569075,778
10222,3779689733,3360972732,1672560630,1672560854,224
11377,3514761434,3912862842,1672641585,1672643859,2274
11286,3772019557,3410788026,1672664855,1672665289,434
10461,3331471764,3283295213,1672678026,1672680517,2491
11667,3517210356,3755767856,1672535873,1672536500,627
10836,3342837214,3505496725,1672620867,1672621416,549
9977,3778986795,3421956717,1672672762,1672673676,914
11260,3346755179,3319862687,1672557932,1672560115,2183
10787,3505496725,3475653510,1672588795,1672590861,2066
11472,3421956717,3774401596,1672557258,1672558018,760
9878,3760537855,3207586072,1672562626,1672564623,1997
11291,3510882475,3515706117,1672636697,1672639302,2605
11491,3886896755,3780942505,1672702681,1672704554,1873
10346,3205113625,3500543341,1672551134,1672551447,313
9934,3916463490,3625400710,1672697371,1672698408,1037
10897,3419378107,3534562354,1672537026,1672538691,1665
11101,3306037126,3309178914,1672541180,1672544753,3573
10514,3294164983,3352044245,1672570581,1672573150,2569
10090,3776968640,3792063616,1672702552,1672705959,3407
11465,3776122272,3774706478,1672555630,1672558493,2863
10221,3512133625,3820922991,1672641564,1672643460,1896
10096,3611832288,3755942724,1672572006,1672573133,1127
10175,3510486220,3738103378,1672592624,1672594652,2028
11358,3422915648,3495637721,1672608111,1672611054,2943
11392,3735422623,3902682060,1672663874,1672664379,505
10075,3776122272,3515259326,1672587765,1672590333,2568
9988,3977157565,3490953301,1672638763,1672641338,2575
10950,3511750850,3979366845,1672628140,1672630985,2845
10152,3510278533,3638823001,1672589885,1672590063,178
9974,3778100960,3293898029,1672689617,1672690585,968
10029,3318220119,3500695402,1672664733,1672668189,3456
11156,3505756991,3276499910,1672692506,1672692920,414
10968,3505032644,3298831109,1672583816,1672585917,2101
10857,3377250778,3667072319,1672625333,1672627722,2389
11666,3518067857,3710173412,1672570580,1672573273,2693
11288,3492728794,3701770921,1672543530,1672546430,2900
10609,3277061226,3934564437,1672567588,1672569051,1463
10605,3511296895,3240683148,1672636356,1672638470,2114
10461,3857609616,3511645260,1672635777,1672638552,2775
10296,3829358750,3711767051,1672537142,1672540732,3590
11619,3780148144,3287760230,1672665766,1672667358,1592
11576,3517530943,3760656396,1672548072,1672548503,431
10095,3817376705,3757773786,1672669445,1672669615,170
10714,3459951739,3917905192,1672561853,1672564916,3063
10919,3519780867,3501711464,1672535020,1672537640,2620
9916,3931495845,3904846341,1672681861,1672682065,204
10216,3415228763,3440770466,1672584667,1672587826,3159
9899,3514747345,3792432763,1672582641,1672584398,1757
10490,3517227599,3783594729,1672700162,1672701925,1763
11445,3936851114,3500741534,1672553812,1672556320,2508
10527,3509186338,3776316903,1672544572,1672544653,81
10028,3274739459,3918981936,1672622942,1672624996,2054
11455,3513816744,3393543588,1672543420,1672546618,3198
11316,3559112196,3516819320,1672631837,1672635030,3193
10163,3625400710,3756761603,1672692738,1672695940,3202
10423,3246062632,3378729459,1672572461,1672572994,533
9893,3977666815,3430296808,1672670374,1672673185,2811
10002,3395505794,3519015940,1672627022,1672629148,2126
11021,3287683210,3505331083,1672622953,1672624369,1416
11091,3856699097,3778702093,1672629350,1672630406,1056
10219,3711852131,3311260898,1672685069,1672687627,2558
9967,3367262509,3497904539,1672550585,1672553116,2531
10920,3465690527,3519034304,1672595765,1672596311,546
11470,3379666159,3440770466,1672694301,1672695536,1235
11388,3776187150,3501574882,1672566818,1672567461,643
10918,3344478603,3280208630,1672578376,1672581370,2994
11285,3772786559,3600302127,1672545954,1672548336,2382
10633,3417360319,3780168985,1672686407,1672688066,1659
10969,3500863429,3240683148,1672549109,1672549845,736
11559,3716209499,3779102237,1672685163,1672688473,3310
10698,3514628916,3405435885,1672595757,1672598943,3186
11457,3513629502,3203151036,1672591904,1672594373,2469
11419,3516497645,3242082716,1672665513,1672667996,2483
11769,3711196962,3791758175,1672640251,1672641072,821
11106,3351153781,3938021614,1672642470,1672645515,3045
10197,3710891331,3473706746,1672703501,1672706144,2643
11169,3514341451,3779975575,1672593587,1672594211,624
11034,3203909360,3330238204,1672660908,1672663706,2798
11622,3770846374,3710622746,1672702964,1672705384,2420
9801,3710585241,3903065952,1672604785,1672606395,1610
10399,3760687922,3206262649,1672646911,1672648150,1239
10197,3780466967,3711119575,1672581524,1672584851,3327
9893,3757584114,3701004302,1672697279,1672697403,124
11208,3701663839,3439045964,1672547253,1672548253,1000
10881,3359880163,3239990061,1672560684,1672563146,2462
10495,3710891331,3755229631,1672597129,1672598076,947
11236,3776440009,3334461288,1672671812,1672674773,2961
10307,3715246385,3500922040,1672641870,1672643840,1970
11240,3450511428,3405303958,1672534219,1672535517,1298
11263,3418382025,3450164574,1672661251,1672662309,1058
10161,3272838634,3390438262,1672655595,1672655951,356
11761,3518088154,3710919244,1672662377,1672664757,2380
10762,3361865467,3516588277,1672608071,1672610929,2858
10751,3351949206,3339649817,1672662109,1672664597,2488
10485,3392482187,3772968080,1672703415,1672705820,2405
9996,3519065870,3636857871,1672688113,1672690274,2161
9803,3780626668,3367121615,1672676295,1672677256,961
10650,3630462406,3616242727,1672557951,1672559634,1683
10733,3466620548,3930501172,1672603150,1672603583,433
9818,3368848936,3605101443,1672641487,1672643721,2234
10065,3518058151,3770991234,1672665381,1672665580,199
11715,3404375908,3302348002,1672647435,1672648379,944
11747,3756119976,3342027511,1672626055,1672629310,3255
11079,3380357490,3446537819,1672552221,1672554743,2522
10795,3220660616,3857909328,1672620237,1672620363,126
10015,3897186782,3557653200,1672676111,1672676637,526
11175,3853275529,3777060250,1672599974,1672603273,3299
11170,3711945923,3777405860,1672600120,1672600671,551
10343,3481019442,3772223331,1672671494,1672673694,2200
9847,3311472321,3773852157,1672659571,1672661173,1602
10223,3887502536,3783095041,1672678597,1672680329,1732
10184,3933731871,3391093411,1672577790,1672578923,1133
11684,3760080378,3515597467,1672681852,1672683818,1966
10786,3701596047,3287689454,1672610387,1672611270,883
10630,3924205112,3424425746,1672565063,1672567529,2466
11447,3373018943,3660980656,1672597677,1672600540,2863
10640,3233712975,3239279744,1672600128,1672603012,2884
10146,3427527462,3890638402,1672640523,1672642811,2288
11460,3783679478,3925792265,1672560828,1672564393,3565
10362,3778273230,3811354125,1672572099,1672573459,1360
10980,3533859712,3513800589,1672553703,1672553984,281
10576,3896840409,3791716170,1672570088,1672570191,103
10340,3311432176,3281970147,1672690021,1672691472,1451
10300,3505980138,3495152069,1672597216,1672598829,1613
11115,3837888196,3976225898,1672694244,1672697545,3301
10365,3634670780,3510882576,1672682253,1672682426,173
11787,3366566029,3776534957,1672642436,1672645982,3546
10086,3760679372,3711770773,1672685908,1672689015,3107
10830,3774633364,3224040894,1672676483,1672678096,1613
10452,3791587717,3855629383,1672539151,1672540738,1587
11192,3838748301,3936486724,1672669330,1672669755,425
11577,3777655401,3246804115,1672608377,1672610609,2232
10716,3808849597,3777063455,1672609648,1672609999,351
11067,3394357241,3519167605,1672635766,1672635854,88
10233,3273758330,3701668745,1672573309,1672575944,2635
11684,3500049870,3555215568,1672641416,1672644789,3373
11623,3209075485,3372617110,1672537922,1672540045,2123
11549,3287968403,3520515739,1672667999,1672670267,2268
10353,3897107253,3938398160,1672695780,1672697634,1854
9900,3285515107,3471555057,1672566436,1672567339,903
11678,3929923442,3791269060,1672614340,1672614747,407
11630,3686860179,3972442654,1672672961,1672673773,812
10476,3774782065,3485151614,1672663621,1672666924,3303
11290,3513215373,3519046342,1672615294,1672616693,1399
10047,3776901443,3411213032,1672580028,1672583225,3197
10902,3402774497,3793732968,1672586515,1672589410,2895
9925,3437703650,3235373942,1672689660,1672689749,89
10887,3345954031,3772962072,1672669255,1672671108,1853
10447,3500595432,3533830748,1672570034,1672570491,457
10929,3500793739,3516340010,1672582802,1672584555,1753
11522,3931767736,3713416756,1672631250,1672633297,2047
9987,3391093411,3438818153,1672646938,1672648273,1335
10247,3516668203,3713219299,1672679743,1672680638,895
11070,3302929858,3471177177,1672673559,1672674196,637
10368,3852161626,3285515107,1672620272,1672621377,1105
10890,3895944547,3900540310,1672616116,1672619322,3206
10066,3519435459,3856975355,1672610402,1672610590,188
10600,3831981073,3783879023,1672577083,1672580421,3338
10153,3739217535,3500695402,1672701467,1672704116,2649
11519,3534122907,3512527440,1672607333,1672607867,534
11010,3802625412,3783879023,1672573880,1672575315,1435
10110,3332124606,3928076270,1672553110,1672556617,3507
10484,3779382417,3200320674,1672562970,1672563186,216
10223,3519015940,3458130310,1672700946,1672703329,2383
10997,3624307518,3515507526,1672675850,1672677356,1506
10610,3297624618,3236360179,1672619933,1672621740,1807
10031,3471555057,3780308809,1672644300,1672645731,1431
9941,3738160394,3519448648,1672610673,1672614116,3443
10707,3711518637,3513384042,1672564072,1672566662,2590
10231,3559759778,3760346746,1672554261,1672555038,777
9996,3516517348,3309651238,1672591866,1672594304,2438
11778,3554236075,3715111016,1672609322,1672611923,2601
9794,3773411968,3304235700,1672602855,1672604383,1528
10350,3910049345,3419648004,1672595492,1672595557,65
11004,3778986795,3239401337,1672638468,1672640230,1762
10027,3614484939,3922480066,1672569285,1672570999,1714
10548,3710223875,3880882684,1672594265,1672595923,1658
9797,3463729805,3306066522,1672682424,1672685054,2630
10038,3235313062,3445077330,1672681211,1672683485,2274
11104,3517253559,3777263928,1672600874,1672602109,1235
10941,3716195780,3396472026,1672672841,1672674011,1170
10775,3415840750,3509394912,1672648515,1672650841,2326
11139,3231963246,3922480066,1672669857,1672671158,1301
9799,3780213684,3710529628,1672607580,1672608115,535
11410,3423800775,3311200541,1672677949,1672680121,2172
10417,3366501813,3491758029,1672535589,1672537126,1537
9999,3710891331,3806034626,1672564504,1672565131,627
10616,3777112124,3533876927,1672589436,1672592753,3317
11489,3621960662,3756525103,1672695422,1672697628,2206
10414,3760322661,3854229296,1672601425,1672604263,2838
11464,3773032706,3402338011,1672589650,1672592944,3294
9836,3442096275,3832289185,1672593597,1672596261,2664
10147,3713159131,3373135211,1672598144,1672599309,1165
10137,3791522832,3701493094,1672661372,1672664627,3255
9869,3519908593,3444168914,1672557804,1672561037,3233
10538,3435037864,3394976623,1672696925,1672698535,1610
11075,3714281210,3514941815,1672624609,1672626094,1485
11107,3887382548,3703742071,1672539923,1672541817,1894
11067,3344778261,3857847527,1672573304,1672576043,2739
9827,3896200048,3311231911,1672598588,1672600111,1523
10139,3436401020,3244495586,1672590939,1672593882,2943
11244,3978643889,3779609338,1672702351,1672703237,886
10545,3735056027,3511969443,1672673568,1672676359,2791
10265,3434052463,3770925016,1672651125,1672652019,894
10280,3714658474,3519065870,1672623201,1672623265,64
10481,3624307518,3783095041,1672574449,1672577393,2944
11204,3514498259,3716197140,1672616793,1672618425,1632
11656,3241567995,3710397477,1672684040,1672684422,382
10468,3516321993,3897107253,1672647389,1672650343,2954
10430,3792440162,3772019557,1672587917,1672590164,2247
11273,3739387948,3317887374,1672609187,1672610568,1381
11604,3931767736,3665603628,1672699962,1672700874,912
11585,3555378248,3429409539,1672667230,1672668992,1762
10564,3666823095,3534543864,1672656716,1672657428,712
11062,3512638952,3373677765,1672698975,1672701860,2885
9892,3476431618,3309455369,1672685821,1672687417,1596
11755,3301332095,3778842400,1672703473,1672704902,1429
11181,3682802569,3516335333,1672604661,1672605370,709
10333,3933106901,3812261241,1672590458,1672593024,2566
10922,3638018906,3711518637,1672570287,1672573616,3329
11385,3757050615,3284483177,1672592360,1672595362,3002
11567,3639465750,3238310644,1672653604,1672654416,812
10436,3774145748,3973134902,1672642120,1672644472,2352
11135,3777932581,3450621820,1672628107,1672631332,3225
11083,3224824355,3483347530,1672679445,1672681820,2375
10160,3229570647,3733730342,1672534501,1672535763,1262
11759,3792277399,3533566754,1672635045,1672637909,2864
10452,3513143959,3361789225,1672569976,1672572487,2511
10513,3822634862,3437108337,1672597796,1672599366,1570
9922,3772262649,3774946684,1672596950,1672600130,3180
9874,3494560663,3919814073,1672541264,1672543559,2295
11126,3272827860,3310737478,1672600869,1672604425,3556
11673,3791574640,3446218191,1672531786,1672534492,2706
10305,3713139039,3364302157,1672582131,1672584132,2001
10293,3552261072,3311602936,1672677698,1672681275,3577
10623,3312651192,3701493094,1672655094,1672657510,2416
9820,3919494952,3338187803,1672691746,1672694375,2629
11011,3520558137,3755192104,1672549036,1672551069,2033
10772,3710695372,3245774173,1672558524,1672561534,3010
11684,3474074188,3783172505,1672641821,1672645110,3289
11284,3510882576,3559759778,1672624848,1672627946,3098
11448,3777552831,3233993993,1672605467,1672608330,2863
10821,3272838634,3780466967,1672568214,1672571351,3137
11186,3415228763,3517331746,1672597211,1672600133,2922
10984,3791906680,3403035480,1672596537,1672598359,1822
10096,3440991826,3605591994,1672674052,1672675383,1331
10322,3714453773,3334381941,1672690195,1672692761,2566
10305,3512826895,3236206821,1672544384,1672547467,3083
9974,3711856534,3756367938,1672665109,1672668010,2901
11268,3516249472,3373851012,1672591087,1672593141,2054
11499,3205324639,3776600696,1672574335,1672574718,383
10873,3711810268,3350966326,1672685106,1672687253,2147
10073,3509677530,3466492108,1672628421,1672631185,2764
10737,3284865931,3491390365,1672638291,1672640921,2630
11154,3205908584,3778100960,1672656738,1672658782,2044
10836,3394357241,3780941637,1672657875,1672659360,1485
11200,3924583142,3369558911,1672670456,1672670614,158
11580,3773378103,3899970524,1672537067,1672540533,3466
10902,3348100657,3424997707,1672605561,1672607513,1952
10618,3739075176,3489205994,1672647467,1672651038,3571
11483,3514297012,3710173412,1672637661,1672640748,3087
11162,3905358065,3909067335,1672637273,1672638233,960
11297,3615245840,3429315500,1672578013,1672578709,696
10524,3519015940,3830771832,1672664591,1672665096,505
11501,3908878965,3319529422,1672548600,1672549504,904
9867,3701127475,3801379377,1672535862,1672539111,3249
10190,3711854614,3770486161,1672590562,1672590894,332
10669,3665431349,3922409420,1672540111,1672540857,746
10490,3394357241,3519059808,1672565602,1672566535,933
10545,3534426696,3730052916,1672648045,1672649590,1545
11758,3376842515,3662794240,1672696836,1672700252,3416
11023,3770981604,3516103646,1672531720,1672533972,2252
11749,3362368123,3428878402,1672621170,1672622297,1127
10292,3880882684,3505331014,1672649848,1672651055,1207
11607,3311037445,3792475476,1672564356,1672565309,953
10004,3510824484,3669418238,1672606955,1672608499,1544
11718,3207497598,3804707712,1672583655,1672585175,1520
10931,3791108593,3614484939,1672560811,1672562393,1582
10587,3807800457,3770530739,1672616878,1672617999,1121
11765,3243056734,3519162582,1672576725,1672578015,1290
11223,3716492409,3778819352,1672695227,1672696442,1215
9797,3511645260,3287734830,1672652706,1672653286,580
10746,3773953689,3792289287,1672553381,1672554792,1411
10479,3783067048,3311515179,1672569726,1672573182,3456
10896,3822368676,3662495290,1672667063,1672669246,2183
10505,3714424237,3774316305,1672636520,1672637553,1033
11721,3510143850,3303552616,1672562045,1672565516,3471
11225,3783809405,3510535683,1672669212,1672671927,2715
11761,3713224986,3505190512,1672545093,1672545554,461
11208,3491335890,3227874229,1672676345,1672676557,212
11201,3829358750,3510218188,1672688012,1672690411,2399
10705,3778382224,3500456339,1672616682,1672619683,3001
9885,3664523809,3205161801,1672554918,1672556551,1633
9886,3611832288,3713336088,1672543120,1672546253,3133
11263,3335353798,3710051427,1672600219,1672603274,3055
9920,3927181190,3711196962,1672532043,1672533829,1786
11664,3688870751,3890638402,1672627603,1672630523,2920
11792,3388946581,3423353911,1672571275,1672574060,2785
9950,3907245259,3755203055,1672576339,1672578361,2022
11605,3368176107,3509626590,1672655070,1672658358,3288
10158,3471177177,3772250554,1672676293,1672677267,974
11003,3311514075,3512625661,1672543219,1672545990,2771
10988,3936851114,3501901313,1672570047,1672570795,748
10221,3773424266,3711187791,1672556442,1672559814,3372
10682,3894495222,3466655775,1672584118,1672585133,1015
9966,3275975921,3406492167,1672680012,1672683398,3386
11441,3777370992,3341311972,1672655720,1672656376,656
11581,3791796190,3978643889,1672626261,1672627545,1284
11036,3714688409,3910190872,1672667602,1672668166,564
11454,3511867383,3520697518,1672679235,1672681967,2732
9825,3274341934,3512596743,1672567829,1672569141,1312
10642,3517632796,3773697080,1672538646,1672539884,1238
11689,3919814073,3361635547,1672672469,1672675584,3115
10673,3713475356,3343767438,1672683329,1672684318,989
11370,3779505358,3885422379,1672633045,1672634502,1457
11141,3519947298,3356599815,1672635943,1672638923,2980
10280,3772227820,3555378248,1672646286,1672646533,247
10048,3621960662,3505331083,1672702868,1672704559,1691
10542,3295530454,3924205112,1672572391,1672575908,3517
11276,3293540333,3858497718,1672674452,1672674754,302
11173,3755342153,3304030474,1672655280,1672655573,293
10213,3710783759,3792633495,1672568247,1672570326,2079
10996,3395565040,3701311947,1672634526,1672635567,1041
10391,3505998260,3406238754,1672570968,1672573681,2713
10193,3893043842,3224053074,1672576478,1672579795,3317
11543,3433189219,3512087090,1672556655,1672558921,2266
9827,3716891903,3447312353,1672551198,1672553836,2638
10747,3456795601,3779748270,1672604316,1672605318,1002
11768,3711131262,3516378356,1672675502,1672676509,1007
11737,3780294116,3445896667,1672646390,1672648907,2517
11375,3500579482,3551833298,1672570166,1672572211,2045
11194,3519908593,3792785261,1672636952,1672639549,2597
10146,3500178849,3395615598,1672626440,1672628421,1981
10398,3756759239,3776319560,1672602851,1672603971,1120
10208,3703697059,3755119166,1672663932,1672664217,285
10799,3489205994,3434581257,1672568866,1672570713,1847
11653,3710060386,3755823805,1672677254,1672677634,380
10050,3403035480,3357496255,1672684992,1672685075,83
10442,3909822999,3772802020,1672646617,1672648072,1455
10749,3534174363,3221736756,1672577186,1672578985,1799
11614,3312612693,3755075988,1672540833,1672543232,2399
10142,3516340010,3510916875,1672693695,1672696186,2491
10890,3813111107,3500720752,1672569555,1672569852,297
11695,3316537706,3335353798,1672655802,1672658241,2439
11047,3387989658,3306066522,1672576360,1672578820,2460
11545,3880549316,3205161801,1672547208,1672548340,1132
11687,3770408300,3757001552,1672649023,1672649245,222
9925,3342837214,3755729826,1672634244,1672637465,3221
10032,3972729768,3777937949,1672695341,1672698422,3081
11577,3206262649,3516651799,1672653474,1672655563,2089
11069,3622152515,3757732853,1672641548,1672644641,3093
9808,3601214648,3828568868,1672640787,1672641288,501
11309,3884862164,3973582279,1672578882,1672579843,961
11028,3774236212,3780576351,1672563805,1672566439,2634
10204,3791074200,3755170743,1672594790,1672597759,2969
11741,3311521176,3715441777,1672629015,1672631020,2005
11397,3778195766,3776309810,1672611394,1672613878,2484
9827,3776122272,3415562576,1672612974,1672613813,839
10574,3288791629,3780467276,1672695576,1672697762,2186
11698,3469778316,3382696725,1672631574,1672632109,535
9862,3505720915,3793732968,1672694635,1672696399,1764
10889,3393128259,3517949586,1672576196,1672576534,338
10647,3620836520,3755779925,1672639571,1672642976,3405
9938,3923524564,3516731917,1672631418,1672631912,494
10019,3780563627,3511198566,1672692138,1672694319,2181
10036,3760854788,3714923092,1672647582,1672648369,787
10766,3803382101,3772070986,1672564476,1672565467,991
10843,3772869013,3772235668,1672606807,1672610264,3457
11199,3515470462,3857847527,1672668585,1672670963,2378
11304,3283295213,3469663062,1672649560,1672652170,2610
11064,3812880543,3411213032,1672531315,1672531684,369
9976,3447696555,3792851584,1672628352,1672628616,264
10158,3780168985,3922786716,1672643563,1672644894,1331
10990,3505502819,3856975355,1672649373,1672651421,2048
10623,3885339157,3783730769,1672604834,1672607840,3006
11060,3812261241,3662354016,1672687632,1672690020,2388
10696,3551833298,3358675021,1672604927,1672605577,650
11214,3510781595,3915652382,1672649919,1672650764,845
10780,3505449070,3428076194,1672620525,1672622252,1727
11470,3281148858,3714870496,1672578295,1672578837,542
10512,3275661834,3701291994,1672676802,1672680236,3434
10682,3772164469,3757678397,1672544219,1672546625,2406
10404,3516655509,3384170206,1672647568,1672650451,2883
11753,3760397450,3777200549,1672669051,1672669703,652
11450,3441944896,3667814788,1672618652,1672620564,1912
11251,3793407883,3802374620,1672558162,1672561041,2879
11282,3613216900,3779102237,1672635526,1672636004,478
10124,3971996397,3289258397,1672679307,1672682503,3196
9898,3714281795,3309178914,1672531674,1672532941,1267
10300,3226761201,3772055279,1672699051,1672702128,3077
11382,3756998113,3605905645,1672646557,1672649207,2650
11228,3809207482,3756493561,1672665435,1672666526,1091
10213,3905889514,3793814153,1672611656,1672614012,2356
10397,3453519360,3779815753,1672565962,1672568322,2360
11207,3792785261,3688870751,1672684891,1672686458,1567
11075,3755507566,3755769254,1672555674,1672557733,2059
10749,3515803462,3897186782,1672547362,1672548332,970
11415,3516651799,3791716170,1672638597,1672640406,1809
11228,3899970524,3533030343,1672534378,1672536676,2298
10768,3710865678,3509379617,1672656328,1672659631,3303
10527,3614944981,3760267158,1672626076,1672628188,2112
9982,3757060033,3516777819,1672604046,1672604577,531
10616,3454924050,3500104976,1672697534,1672698226,692
10084,3770180844,3514926921,1672678083,1672679960,1877
10904,3779102237,3912862842,1672572316,1672574834,2518
11753,3292050211,3783357035,1672604643,1672605743,1100
10691,3703818358,3450503086,1672669082,1672670032,950
10790,3514297012,3308149799,1672661662,1672663252,1590
10662,3772966919,3299052917,1672635551,1672637742,2191
10979,3206377955,3514327931,1672628915,1672632404,3489
10207,3760024021,3714897456,1672621954,1672622171,217
10318,3792021895,3856975355,1672540483,1672540841,358
11578,3534988162,3397783490,1672643772,1672645513,1741
11598,3630802959,3468281011,1672667853,1672668814,961
10489,3229570647,3668681400,1672639277,1672641393,2116
10961,3807646028,3703031637,1672578099,1672580944,2845
10636,3453464785,3505756991,1672696221,1672699652,3431
10896,3501171785,3756536476,1672559045,1672560425,1380
10335,3757660578,3338642026,1672618478,1672620259,1781
11237,3510775046,3884934977,1672651139,1672652666,1527
10951,3533620069,3684199077,1672612764,1672614739,1975
11025,3683677062,3755154460,1672644490,1672647727,3237
11548,3505998260,3827889533,1672582242,1672585818,3576
10190,3513586642,3777672363,1672700122,1672701935,1813
10565,3534775239,3884001167,1672612394,1672612769,375
10184,3491239350,3703415246,1672620514,1672620758,244
10935,3533440294,3387700451,1672651131,1672653267,2136
11521,3474852115,3287689454,1672639746,1672642563,2817
10136,3714688409,3512769522,1672587409,1672587523,114
11073,3776968640,3715111016,1672692146,1672694645,2499
10015,3433196933,3776953418,1672691324,1672693246,1922
10469,3777715675,3902292032,1672580578,1672583000,2422
11497,3512492332,3374147279,1672644203,1672644565,362
10046,3887069914,3668955834,1672580363,1672583287,2924
9922,3400112498,3467663782,1672627308,1672629560,2252
9987,3812880543,3777439655,1672602078,1672602324,246
10077,3415803494,3774822697,1672548041,1672549551,1510
11699,3519055736,3333355914,1672568243,1672570265,2022
11023,3311200541,3274239253,1672596339,1672598655,2316
10116,3772461583,3205324639,1672534862,1672538442,3580
11158,3683514731,3515699732,1672666545,1672670028,3483
11523,3711671702,3495637721,1672637746,1672639363,1617
11215,3233993993,3757201138,1672701442,1672703621,2179
10897,3311037445,3436401020,1672643793,1672647103,3310
11394,3710149975,3783172505,1672563591,1672565601,2010
11657,3755584983,3911821258,1672645699,1672647372,1673
10240,3550206045,3468201976,1672623200,1672626592,3392
11595,3499998389,3425646356,1672620451,1672622755,2304
11720,3711889178,3515558215,1672593988,1672597088,3100
11377,3760748418,3434581257,1672580563,1672581036,473
10482,3299847117,3791224239,1672621257,1672624088,2831
11544,3880562532,3756297396,1672654126,1672655176,1050
11368,3850993995,3517358336,1672584944,1672585682,738
10449,3500591274,3818461836,1672686210,1672686687,477
11107,3500864577,3515715968,1672697329,1672698622,1293
10341,3497904539,3283295213,1672618193,1672621141,2948
11321,3791548838,3855440101,1672549599,1672550990,1391
11458,3772869013,3501271930,1672693959,1672695373,1414
11374,3515715968,3778927933,1672579760,1672580654,894
11022,3339331632,3436401020,1672672138,1672673517,1379
10104,3760074281,3760679372,1672553181,1672556138,2957
9936,3716733618,3512203553,1672662583,1672665824,3241
11670,3514926921,3927675706,1672667723,1672671307,3584
10243,3339478490,3979366845,1672598088,1672601206,3118
11556,3760443176,3710695372,1672652818,1672656415,3597
11689,3533976217,3415562576,1672582414,1672585302,2888
11455,3780576351,3492350318,1672637325,1672638753,1428
10351,3899294071,3220798451,1672646026,1672646629,603
11574,3813111107,3916463490,1672630608,1672631531,923
10052,3499820963,3369810091,1672643725,1672646546,2821
10104,3510894809,3604908372,1672591996,1672593026,1030
11076,3756345026,3202740652,1672593038,1672595420,2382
10837,3555954355,3509379617,1672644810,1672647510,2700
11524,3404187438,3294952405,1672639215,1672640645,1430
11335,3822786416,3884862164,1672695065,1672696791,1726
10264,3516319492,3932919664,1672676118,1672677286,1168
11559,3606804618,3514980025,1672597019,1672600424,3405
11334,3715249954,3777304517,1672675407,1672675588,181
10309,3669418238,3352493805,1672650816,1672653437,2621
10392,3510801769,3772943811,1672613439,1672616658,3219
10793,3701291994,3519108639,1672701420,1672702052,632
11058,3359472956,3517151644,1672666627,1672669612,2985
11015,3360972732,3783122313,1672584650,1672586809,2159
10101,3791409441,3200372897,1672582374,1672584839,2465
10993,3711591464,3550887623,1672548583,1672548648,65
10117,3472018395,3773826624,1672680509,1672681831,1322
10325,3374195945,3772343750,1672605308,1672607801,2493
11213,3398075553,3755192104,1672702876,1672705468,2592
11465,3925823748,3791664049,1672548586,1672551078,2492
10021,3517949586,3500440602,1672583196,1672586445,3249
11436,3342426430,3517800171,1672550456,1672553053,2597
11762,3755378125,3500591274,1672600978,1672601511,533
11515,3703659324,3500209015,1672589929,1672590948,1019
10414,3367299721,3686081254,1672620457,1672620652,195
10151,3814289471,3905934770,1672639314,1672639867,553
11016,3915460293,3757732853,1672642535,1672645311,2776
10499,3975799349,3711076751,1672686822,1672690266,3444
11332,3632303304,3380444321,1672614506,1672614683,177
11539,3757678397,3439283360,1672624051,1672626855,2804
10758,3792432763,3682673884,1672667092,1672669664,2572
9827,3627358016,3501174621,1672698061,1672698757,696
11340,3979366845,3505331083,1672631331,1672634709,3378
11104,3780466967,3534537581,1672674662,1672677226,2564
10596,3633949990,3444397804,1672563022,1672565242,2220
11635,3936871734,3402580733,1672644112,1672647520,3408
10249,3413236071,3510368377,1672607761,1672611150,3389
9815,3756113624,3366566029,1672591078,1672594605,3527
9853,3520860199,3206853747,1672559217,1672559338,121
11528,3513661302,3454343398,1672638520,1672639273,753
9851,3756695502,3711187791,1672660412,1672661540,1128
11054,3355903597,3715712376,1672664271,1672664719,448
11477,3629869834,3510547682,1672585435,1672587952,2517
10983,3516777819,3224040894,1672693305,1672694827,1522
11404,3757212744,3501835995,1672611703,1672614999,3296
9849,3756297396,3533620069,1672543022,1672546287,3265
11542,3610723722,3710107905,1672552417,1672554949,2532
11630,3857344874,3890813040,1672637952,1672639072,1120
11634,3791332226,3519341916,1672549588,1672551215,1627
10783,3442564712,3516026189,1672656862,1672658559,1697
10611,3701779683,3517800171,1672630631,1672633338,2707
11757,3713170867,3714787207,1672644104,1672646107,2003
10327,3226913558,3703168159,1672619520,1672619812,292
11060,3475560058,3791072829,1672669779,1672671253,1474
11392,3465107990,3711430738,1672621260,1672624207,2947
10357,3701291994,3791974273,1672639333,1672642437,3104
10493,3552444228,3515984911,1672654804,1672656453,1649
11317,3703999217,3241855333,1672554423,1672556400,1977
10296,3772877723,3510856388,1672599922,1672600140,218
10997,3233712975,3713170867,1672664561,1672667946,3385
10239,3613703906,3838423363,1672537121,1672538809,1688
10548,3783730769,3780942505,1672633745,1672633947,202
10526,3773344258,3736056340,1672601584,1672602073,489
10133,3832333115,3305093237,1672578709,1672579512,803
11190,3510153173,3835982340,1672574018,1672575422,1404
10051,3970775805,3822634862,1672602891,1672604022,1131
10092,3511650296,3895944547,1672660397,1672663565,3168
10405,3500421940,3780648744,1672601757,1672602916,1159
10742,3501612813,3793029132,1672615206,1672616204,998
11544,3600871715,3470135167,1672700817,1672703374,2557
10464,3513171472,3755209597,1672567087,1672567414,327
11712,3906874577,3780048608,1672547673,1672548038,365
10916,3738526914,3534869444,1672567785,1672570283,2498
11700,3625400710,3812516461,1672696506,1672697521,1015
11022,3770533675,3276231633,1672650053,1672652440,2387
10646,3418683594,3832902787,1672599604,1672601346,1742
11111,3716891903,3206262649,1672596181,1672596763,582
11430,3500854711,3925098136,1672654748,1672655993,1245
10007,3495427619,3701675183,1672549648,1672550639,991
10500,3772070986,3514007122,1672536896,1672539315,2419
10027,3512306195,3559619861,1672638217,1672640622,2405
10886,3778695017,3350966326,1672534957,1672538241,3284
10575,3804707712,3669427589,1672637660,1672639210,1550
9959,3772234939,3776455762,1672664250,1672667497,3247
11200,3501988762,3490008012,1672646040,1672648254,2214
9960,3757198930,3500317923,1672650928,1672652568,1640
11573,3337673625,3434052463,1672584067,1672585660,1593
10603,3454343398,3622654885,1672531432,1672531773,341
10231,3902775449,3278629965,1672651380,1672654429,3049
10903,3516815069,3473706746,1672699338,1672700007,669
10737,3453538201,3519831322,1672584873,1672587033,2160
10679,3511069449,3772169046,1672589819,1672592044,2225
10713,3703502114,3618672178,1672578157,1672580673,2516
9829,3303432071,3499142934,1672610115,1672612774,2659
10270,3500057674,3715419141,1672531553,1672532504,951
11753,3511794841,3291446384,1672545672,1672547078,1406
11280,3701521510,3553640169,1672539515,1672541266,1751
10211,3242149533,3832312129,1672581558,1672582353,795
10662,3311037445,3805616707,1672625347,1672627906,2559
10234,3271389160,3278805844,1672641481,1672643744,2263
11673,3711591464,3518205307,1672553709,1672555584,1875
9943,3534775239,3823307824,1672558588,1672560533,1945
11014,3938398160,3838423363,1672532244,1672532995,751
10971,3221290808,3534589501,1672576248,1672579303,3055
11706,3908550561,3513894659,1672593709,1672597052,3343
11098,3559619861,3703849264,1672641643,1672642387,744
11350,3442462115,3278779955,1672602509,1672605631,3122
10673,3510278533,3501244753,1672672191,1672674741,2550
10424,3514853709,3440582836,1672582785,1672586032,3247
10637,3920116284,3271389160,1672645378,1672647864,2486
11605,3520182275,3732540636,1672545649,1672548295,2646
11405,3977615973,3414510793,1672555435,1672555788,353
11081,3534174363,3533628528,1672541373,1672542727,1354
9898,3972856326,3971051020,1672697750,1672700512,2762
11658,3756428507,3834424604,1672690385,1672693143,2758
10254,3452878062,3756413374,1672591250,1672593739,2489
11473,3938129916,3710125627,1672606267,1672606868,601
9825,3338195686,3518067857,1672696229,1672698869,2640
9981,3791688526,3756876537,1672649777,1672651694,1917
9911,3713636175,3511640720,1672619150,1672621030,1880
10644,3756763585,3776124041,1672674546,1672675991,1445
10671,3478052226,3359012188,1672634746,1672636720,1974
11524,3887918622,3228033254,1672603669,1672605182,1513
10646,3827836825,3306475287,1672548298,1672550945,2647
10934,3793987483,3500591274,1672593787,1672597248,3461
10211,3814289471,3701284535,1672687579,1672690203,2624
10562,3279851026,3278443807,1672626779,1672627242,463
11240,3500543341,3519886257,1672642292,1672645457,3165
10735,3818461836,3533077580,1672586046,1672587666,1620
11454,3446810761,3701824335,1672622156,1672622751,595
11030,3298113026,3668154066,1672553471,1672555814,2343
9814,3462153833,3500889287,1672657816,1672657900,84
10442,3783172505,3330466913,1672549502,1672550082,580
11534,3776901443,3703277359,1672649471,1672650706,1235
11077,3497138014,3736941123,1672649366,1672650384,1018
11569,3228997424,3371759044,1672622453,1672623696,1243
9979,3288346356,3778479297,1672660283,1672661920,1637
10943,3774035405,3714919471,1672538322,1672538930,608
11391,3774702364,3770564547,1672571986,1672575564,3578
11610,3792107875,3520273299,1672600801,1672603174,2373
10732,3516932899,3491390365,1672656125,1672658120,1995
11566,3491527603,3205161801,1672703373,1672704789,1416
11368,3713476192,3703474558,1672591271,1672592217,946
11768,3510882576,3271719569,1672650319,1672653287,2968
10694,3615447269,3520145112,1672673586,1672674613,1027
10877,3516444589,3519463038,1672542650,1672542791,141
11589,3770285500,3534204885,1672702727,1672705020,2293
10845,3246381831,3760397450,1672608348,1672608897,549
11519,3309528048,3818904268,1672534491,1672536840,2349
11673,3520926977,3513850048,1672592634,1672593967,1333
11705,3802625412,3414510793,1672642450,1672646013,3563
11066,3772320856,3701350519,1672559201,1672560131,930
9809,3791206902,3711810268,1672637937,1672640253,2316
10066,3380357490,3510335069,1672643307,1672644351,1044
10442,3500079479,3609103278,1672544399,1672546937,2538
10387,3716676869,3312651192,1672541907,1672545232,3325
10798,3343193067,3241855333,1672626780,1672630346,3566
11230,3516340010,3513186622,1672568374,1672571834,3460
9826,3519319233,3439036305,1672565260,1672565492,232
11646,3555763674,3413799143,1672636399,1672639642,3243
10323,3778817220,3804075198,1672692484,1672692660,176
11544,3300810210,3778561231,1672661536,1672662548,1012
10449,3735497729,3937747312,1672566760,1672568052,1292
10522,3602570831,3792719263,1672540818,1672542496,1678
11422,3825234433,3357026115,1672560835,1672561086,251
10973,3312651192,3312651192,1672585165,1672587324,2159
11639,3500251781,3772234939,1672575064,1672576621,1557
10874,3474852115,3716389356,1672644485,1672647939,3454
9953,3667814788,3517949586,1672620979,1672624332,3353
10261,3534984243,3510486220,1672596293,1672599437,3144
10343,3510826414,3792075871,1672645111,1672647132,2021
10493,3777569538,3731905251,1672649113,1672650615,1502
11395,3793934396,3301369282,1672656515,1672657943,1428
11183,3430399931,3516867729,1672614679,1672617834,3155
10377,3230250213,3774652449,1672604478,1672605803,1325
10637,3888903181,3551833298,1672579012,1672580120,1108
10260,3341432459,3932919664,1672703446,1672703837,391
11490,3343767438,3318590083,1672583949,1672586584,2635
11180,3979115924,3201920708,1672614513,1672614842,329
10255,3710296607,3500093945,1672537576,1672538329,753
10256,3517358336,3505183641,1672683655,1672686931,3276
10739,3772250554,3272838634,1672632812,1672634701,1889
11685,3362706073,3803473387,1672544460,1672546961,2501
10744,3501027795,3387322545,1672692778,1672695278,2500
9906,3498857406,3809860102,1672556938,1672557069,131
11534,3908550561,3730571757,1672635822,1672636710,888
10850,3500726347,3778100960,1672542311,1672543351,1040
11261,3900195680,3505032773,1672698975,1672700611,1636
11160,3314363575,3501977123,1672548611,1672549143,532
11186,3972653129,3757796416,1672567699,1672568487,788
10329,3289771213,3938409715,1672566578,1672568235,1657
10027,3739820448,3454554552,1672675632,1672676244,612
11697,3772188086,3511608609,1672698166,1672698930,764
10495,3516067011,3688870751,1672686259,1672689804,3545
10905,3200785194,3516200419,1672579678,1672580888,1210
11138,3512857020,3491948594,1672668797,1672670242,1445
11439,3505994703,3776447604,1672611899,1672614810,2911
11488,3975796415,3510254698,1672549475,1672552670,3195
10613,3779312237,3811629200,1672589566,1672592301,2735
11484,3465227623,3779427180,1672666905,1672668560,1655
10958,3221736756,3534812391,1672583650,1672585114,1464
10674,3517943697,3783967375,1672643442,1672644265,823
11000,3472901378,3388463477,1672577262,1672577589,327
11431,3520558137,3906874577,1672634556,1672636027,1471
10472,3898965585,3497562878,1672616188,1672617926,1738
10166,3777112124,3834980281,1672667928,1672669278,1350
10548,3500251781,3902775449,1672662184,1672663151,967
10178,3501628472,3475090917,1672600388,1672603352,2964
11719,3533976217,3710695372,1672552016,1672553954,1938
10051,3792633495,3909067335,1672651323,1672653353,2030
11085,3438818153,3519102732,1672692554,1672696011,3457
9811,3919984986,3755779925,1672600001,1672600943,942
11461,3203172170,3360972732,1672649683,1672650210,527
11140,3517045396,3774702364,1672655641,1672656471,830
10450,3755584983,3631444265,1672564001,1672566811,2810
10185,3621812406,3402020492,1672643025,1672646236,3211
10040,3516535558,3514941815,1672674377,1672676249,1872
10999,3884001167,3513800589,1672630210,1672632158,1948
11770,3511645260,3703737650,1672597012,1672597354,342
11075,3755361692,3501711464,1672691000,1672693542,2542
10538,3285515107,3735056027,1672700571,1672700747,176
11021,3519356606,3342056927,1672597343,1672598998,1655
10606,3791351852,3839308659,1672564630,1672567500,2870
11754,3415032547,3489205994,1672698641,1672698867,226
10609,3757032266,3633949990,1672663825,1672666021,2196
9824,3519621901,3343511947,1672575859,1672578336,2477
11184,3511466117,3518425740,1672575597,1672578822,3225
9903,3447948483,3806720019,1672597103,1672600271,3168
10019,3884933821,3780563627,1672544134,1672544780,646
11789,3497904539,3512819376,1672629367,1672631506,2139
10491,3928421417,3347760784,1672659556,1672662484,2928
10898,3247193800,3791269060,1672683334,1672686344,3010
11064,3476958001,3780050328,1672585243,1672587991,2748
10716,3925208102,3730459093,1672585359,1672586069,710
10707,3442462115,3662794240,1672594332,1672597117,2785
11150,3461137945,3974668678,1672630549,1672630699,150
10777,3730600658,3703206956,1672679538,1672682917,3379
10573,3627358016,3780213684,1672585506,1672587641,2135
10632,3282240901,3776309810,1672536507,1672539455,2948
9847,3778927933,3852992961,1672580756,1672583672,2916
10816,3760966645,3500145103,1672609131,1672609444,313
10869,3220660616,3780129338,1672623688,1672624253,565
10085,3510240661,3735838864,1672607442,1672610325,2883
11225,3714892312,3715126587,1672690790,1672691690,900
11214,3701540249,3509297453,1672567841,1672570458,2617
11179,3792008302,3486824047,1672674533,1672676621,2088
10697,3857590978,3711119575,1672581801,1672584689,2888
11502,3501137133,3304252969,1672694474,1672697077,2603
10173,3505173665,3534362749,1672662783,1672664788,2005
10489,3510869438,3516321993,1672569474,1672571574,2100
11186,3356972733,3714116241,1672583200,1672585363,2163
10485,3318590083,3520625600,1672619942,1672622937,2995
10900,3737745988,3403870769,1672680937,1672683150,2213
10063,3513894659,3777672363,1672578017,1672580168,2151
11426,3388915945,3615742989,1672643350,1672643753,403
9872,3469663062,3778819352,1672668058,1672669405,1347
11269,3374147279,3772751765,1672659367,1672660090,723
10187,3359929534,3809207482,1672689953,1672691617,1664
10128,3701459978,3514801709,1672535939,1672536608,669
10895,3770019143,3369270860,1672650074,1672653600,3526
10734,3299845453,3400793223,1672660821,1672663457,2636
11257,3330799389,3822368676,1672600075,1672600271,196
10099,3244098077,3619538249,1672557616,1672559044,1428
10195,3206544535,3760080378,1672665396,1672667350,1954
9920,3405303958,3900540310,1672660441,1672662013,1572
10853,3203172170,3228477490,1672685780,1672687146,1366
11596,3703438617,3689386663,1672684905,1672687069,2164
10450,3505901826,3342426430,1672648957,1672649860,903
11536,3613781977,3517960740,1672652923,1672656512,3589
9825,3791906680,3732223664,1672565181,1672567191,2010
11290,3755192104,3313579674,1672635312,1672637495,2183
10886,3680939042,3791088014,1672572564,1672572940,376
10814,3881012415,3515607283,1672630640,1672633003,2363
11140,3760554453,3497562878,1672557619,1672561024,3405
9983,3772055279,3494680853,1672537918,1672540751,2833
11733,3409098014,3283785820,1672659390,1672662226,2836
10651,3509186338,3624307518,1672674870,1672675044,174
11347,3444295435,3755823805,1672693266,1672693515,249
9882,3425646356,3715282492,1672567525,1672569394,1869
11472,3660176760,3851737350,1672542792,1672546077,3285
10330,3933106901,3361926328,1672546565,1672547526,961
10874,3512794667,3276230295,1672615259,1672618077,2818
10382,3929391979,3433196933,1672657100,1672657470,370
11598,3710783759,3514737648,1672621436,1672623690,2254
10818,3710487368,3733423371,1672636504,1672638517,2013
10846,3499343927,3760322661,1672573991,1672577216,3225
11278,3710680073,3516019206,1672633453,1672636123,2670
9946,3446537819,3774236212,1672583227,1672583911,684
11040,3229734741,3243305367,1672583360,1672586223,2863
9980,3792785261,3613547091,1672621303,1672621771,468
10500,3715039960,3500793739,1672676680,1672677889,1209
10629,3512965991,3498857406,1672690145,1672690566,421
10836,3634766042,3516429380,1672610526,1672610867,341
10912,3509544691,3773895671,1672598388,1672601639,3251
10657,3703722212,3303772923,1672644402,1672646394,1992
10486,3477248170,3885645840,1672667987,1672669260,1273
10530,3520145112,3900793652,1672531355,1672532595,1240
10974,3711187791,3774221318,1672647291,1672650062,2771
11261,3511645260,3471996194,1672586391,1672589413,3022
10069,3533201269,3533340292,1672635439,1672638632,3193
10945,3774706478,3515706117,1672571286,1672572841,1555
10949,3534168768,3776950532,1672534306,1672536091,1785
10403,3428878402,3388830370,1672535801,1672537121,1320
10090,3404461403,3791121243,1672668727,1672672160,3433
11032,3235198316,3630802959,1672567589,1672569121,1532
10924,3501583486,3533077580,1672550116,1672553290,3174
9911,3423353911,3342495377,1672605249,1672608068,2819
11232,3852310652,3378430760,1672653191,1672655069,1878
10976,3885645840,3490953301,1672679145,1672681820,2675
11399,3511500932,3774236212,1672656798,1672659704,2906
11754,3713920790,3756781024,1672631605,1672633674,2069
10941,3393128259,3484739955,1672555004,1672556462,1458
11572,3711755596,3882905311,1672549559,1672550921,1362
11447,3473706746,3907088952,1672642037,1672643567,1530
10006,3366801723,3703423962,1672655545,1672656066,521
10107,3293553295,3519059808,1672543180,1672543732,552
11361,3777200549,3666823095,1672600195,1672602589,2394
10032,3783679478,3440305508,1672578734,1672581301,2567
10730,3791222330,3713636175,1672603792,1672607382,3590
9976,3224053074,3971996397,1672540394,1672543809,3415
10288,3510638085,3494680853,1672552978,1672553114,136
10688,3813085701,3777498160,1672627706,1672628989,1283
11403,3713878219,3716183063,1672670306,1672672115,1809
11539,3271389160,3777931341,1672661554,1672662076,522
10595,3516026189,3711770773,1672655028,1672655162,134
11112,3777932581,3512495325,1672683264,1672684626,1362
11126,3236948071,3392010033,1672640893,1672643553,2660
10282,3520926977,3301403047,1672632064,1672632464,400
10923,3311331205,3201502111,1672632339,1672633878,1539
10926,3792289287,3533017131,1672682669,1672684167,1498
9993,3912862842,3779212271,1672555495,1672556796,1301
11571,3283847934,3516257130,1672644218,1672646806,2588
10450,3779102237,3533201269,1672555410,1672557535,2125
10540,3783238023,3243763209,1672611153,1672613784,2631
11146,3519494023,3686853863,1672608249,1672609074,825
10941,3513777705,3311514075,1672653728,1672657055,3327
11579,3834311054,3392010033,1672567154,1672567631,477
11273,3512504247,3393502004,1672576170,1672576689,519
11483,3493515706,3330318282,1672540200,1672542712,2512
11186,3774483862,3501515425,1672693100,1672695981,2881
11389,3534374523,3793332600,1672587205,1672588125,920
11676,3793920312,3520273299,1672548264,1672550906,2642
11781,3716160006,3832312129,1672638572,1672642111,3539
11067,3701359045,3730052916,1672589128,1672591460,2332
11226,3703572036,3355880028,1672542611,1672545286,2675
11213,3509377714,3364286028,1672551742,1672552267,525
10118,3609166109,3519108639,1672615385,1672616022,637
9956,3714294005,3618024815,1672608528,1672610565,2037
11212,3701291994,3791628263,1672699917,1672700098,181
10439,3202740652,3669497617,1672640674,1672641950,1276
10744,3770715115,3711119575,1672668821,1672670113,1292
11370,3756781024,3500145103,1672638341,1672640547,2206
10294,3463892928,3777370992,1672602418,1672605407,2989
10465,3520049965,3660246433,1672615403,1672616427,1024
10942,3776811587,3371184929,1672557408,1672559557,2149
10149,3399173821,3203630241,1672651053,1672651671,618
11091,3757128722,3774195369,1672686152,1672687080,928
11188,3473562779,3558567160,1672699546,1672701310,1764
10464,3519965717,3937299996,1672661301,1672661489,188
10693,3911431642,3714525519,1672598875,1672598938,63
10190,3519841427,3813085701,1672556301,1672558829,2528
10219,3501554468,3313824913,1672644424,1672645058,634
11321,3509073025,3505011956,1672534194,1672535004,810
10628,3757924067,3715106566,1672570479,1672571428,949
10343,3667072319,3367242388,1672681183,1672681988,805
11247,3509626590,3780500331,1672678342,1672681461,3119
10677,3517358336,3236360179,1672549060,1672552237,3177
10329,3421040626,3312946269,1672570981,1672571513,532
9798,3819024145,3441683673,1672663310,1672664397,1087
10657,3384151770,3241682278,1672621567,1672622394,827
10025,3757089924,3505066871,1672563936,1672564891,955
10246,3518931700,3682266017,1672658828,1672661664,2836
9827,3509252934,3334461288,1672666454,1672667619,1165
11328,3711836873,3273771395,1672629834,1672631491,1657
11142,3519937708,3714870496,1672584666,1672586054,1388
11605,3774304163,3500120676,1672675373,1672677340,1967
10982,3714453773,3208594306,1672572369,1672575212,2843
11653,3500931474,3440401725,1672539875,1672542145,2270
11383,3737622701,3509626590,1672651495,1672652511,1016
10947,3515230715,3851515560,1672663287,1672664459,1172
11315,3424997707,3511069449,1672675084,1672676695,1611
10469,3772489471,3760420315,1672683431,1672683615,184
10627,3392010033,3882851213,1672558280,1672558949,669
9822,3713476192,3517448452,1672562889,1672565287,2398
10978,3249380931,3924205112,1672660720,1672662778,2058
11065,3755924094,3927504954,1672689819,1672692226,2407
11719,3780127017,3927365255,1672606445,1672608375,1930
9829,3467944159,3511382748,1672673424,1672675273,1849
10974,3815700240,3498857406,1672635425,1672638949,3524
10275,3826542169,3305656670,1672685026,1672687761,2735
11469,3716475340,3367262509,1672686698,1672687307,609
10135,3342426430,3780964089,1672679802,1672682588,2786
10082,3716468783,3701540249,1672671089,1672672026,937
11651,3733953055,3638823001,1672656582,1672659562,2980
11240,3495152069,3619705594,1672701800,1672705103,3303
10502,3517766135,3517992521,1672585570,1672587552,1982
10093,3533726421,3756079870,1672607757,1672611235,3478
10800,3447202943,3822634862,1672566182,1672567402,1220
11460,3701449715,3500591274,1672555314,1672556083,769
11431,3908464960,3203909360,1672571809,1672575036,3227
11235,3773697080,3511206717,1672574057,1672577387,3330
11031,3435715962,3337715675,1672702967,1672705164,2197
9858,3770715115,3513486828,1672585885,1672588587,2702
11111,3513563152,3755670258,1672665149,1672665348,199
10872,3554437212,3505140123,1672570557,1672571459,902
11249,3735197034,3513213122,1672639053,1672642023,2970
10698,3533642281,3533728729,1672640087,1672640401,314
11431,3308149799,3520725149,1672593456,1672596840,3384
10596,3510882576,3791688526,1672584120,1672584476,356
10560,3519553933,3616242727,1672674520,1672675680,1160
10342,3791245127,3435159896,1672625608,1672627188,1580
10682,3452024572,3738429905,1672563813,1672564835,1022
9931,3518931700,3515607283,1672543074,1672545527,2453
11311,3757639274,3736987749,1672702678,1672705386,2708
9907,3288791629,3511458926,1672635874,1672638060,2186
10040,3467415939,3614484939,1672677356,1672677708,352
10988,3500456339,3515939841,1672670820,1672671451,631
10314,3204149913,3513894659,1672645795,1672649297,3502
10940,3780740477,3505980138,1672618152,1672618480,328
11729,3393128259,3779503296,1672643711,1672647235,3524
10154,3512492332,3777498160,1672535613,1672538507,2894
10988,3511729562,3713219299,1672643613,1672644954,1341
11607,3534278019,3370512945,1672685636,1672686646,1010
9978,3452090950,3301449986,1672620476,1672621421,945
10761,3510547682,3716526314,1672579023,1672580406,1383
11134,3818570577,3513624915,1672611689,1672612862,1173
10591,3330188769,3533620069,1672661370,1672661526,156
10623,3791994414,3921138062,1672618880,1672622028,3148
9826,3885422379,3318056480,1672649601,1672650656,1055
10325,3937747312,3201656220,1672615769,1672619267,3498
11512,3311529105,3391093411,1672560979,1672564267,3288
10416,3777686966,3780648744,1672589151,1672591586,2435
10777,3505314920,3450621820,1672559741,1672562166,2425
11278,3352057037,3632094087,1672599891,1672602884,2993
11611,3776183353,3715897627,1672610455,1672612143,1688
11498,3509508477,3519351747,1672577054,1672580642,3588
11500,3517325365,3407734098,1672619144,1672620604,1460
11144,3852992961,3233712975,1672557029,1672559843,2814
10347,3780050146,3505720915,1672600605,1672600934,329
9891,3927763819,3533440294,1672537708,1672539765,2057
10487,3711856534,3533154906,1672624392,1672625111,719
10049,3734233216,3500329674,1672609899,1672611525,1626
10070,3511218261,3468871103,1672695355,1672698159,2804
10123,3662522808,3402338011,1672533722,1672534547,825
10856,3714731729,3778842400,1672539104,1672542515,3411
9834,3500104976,3732871856,1672552374,1672554689,2315
10323,3518989186,3772844451,1672587609,1672589340,1731
10233,3882580580,3755203055,1672609090,1672609800,710
9798,3857847527,3449020351,1672661300,1672662719,1419
10175,3853182912,3309528048,1672650836,1672652703,1867
10706,3703206956,3374147279,1672647854,1672648755,901
11239,3772962072,3778706119,1672535735,1672537528,1793
9919,3445896667,3510856388,1672531455,1672534815,3360
10799,3434052463,3701685828,1672656737,1672660154,3417
11010,3805831563,3495152069,1672565888,1672567767,1879
10378,3773134128,3517756624,1672633563,1672633632,69
11365,3277061226,3783201950,1672575851,1672576558,707
11184,3791108593,3315432466,1672534364,1672537687,3323
11441,3666958814,3519046342,1672596831,1672598569,1738
9982,3533628528,3400025324,1672598037,1672601466,3429
10370,3421674406,3773669001,1672650983,1672654051,3068
10177,3493679801,3776968640,1672690774,1672692685,1911
10461,3701004302,3495152069,1672564287,1672566986,2699
10907,3409098014,3780013266,1672598712,1672599902,1190
9934,3402020492,3501126057,1672693439,1672696349,2910
10524,3780956975,3275975921,1672572883,1672576288,3405
10490,3778695895,3780740477,1672695202,1672695327,125
10658,3459951739,3406101720,1672648120,1672650701,2581
9837,3512555384,3703725221,1672638415,1672639746,1331
10687,3902023467,3519494023,1672611937,1672613799,1862
10877,3511744756,3421674406,1672676074,1672678757,2683
10024,3287968403,3857244486,1672663813,1672664177,364
11055,3335353798,3792987243,1672535905,1672539366,3461
11138,3756157377,3666655293,1672626113,1672628222,2109
10071,3792627762,3406238754,1672558538,1672558766,228
10830,3505593034,3779102237,1672664139,1672664903,764
10234,3509370016,3288675710,1672564910,1672568366,3456
10690,3779393140,3516827471,1672573329,1672574424,1095
10145,3236254381,3638018906,1672670704,1672673790,3086
9818,3512395783,3757869138,1672592704,1672595107,2403
11024,3368441333,3439283360,1672531963,1672533837,1874
10800,3735838864,3512638952,1672534125,1672537427,3302
11229,3912181197,3711844574,1672621701,1672623893,2192
10981,3534937492,3511004622,1672630044,1672631988,1944
11101,3357496255,3359012188,1672661105,1672662903,1798
11472,3757607649,3716341323,1672558639,1672560934,2295
11309,3553229537,3203457161,1672535938,1672536209,271
10645,3780213684,3713416756,1672572533,1672575016,2483
10392,3730600658,3732104286,1672589565,1672592556,2991
10569,3772556646,3827981800,1672681355,1672681640,285
11140,3682086200,3713621169,1672554469,1672555031,562
11047,3505980138,3511908639,1672699652,1672701086,1434
10310,3394364348,3857389270,1672700238,1672703128,2890
11115,3422959249,3511245705,1672673410,1672674559,1149
10481,3755230010,3776534957,1672580606,1672584092,3486
11194,3756740153,3500178849,1672644383,1672647605,3222
10398,3501843187,3793332600,1672635484,1672638291,2807
10471,3835262447,3760397450,1672545894,1672548745,2851
11239,3343511947,3427527462,1672586491,1672586943,452
10379,3639503148,3605078841,1672703627,1672703859,232
10864,3510939082,3501573548,1672638743,1672640580,1837
11298,3516668203,3278071998,1672561805,1672564712,2907
11101,3445077330,3424997707,1672618435,1672620581,2146
10872,3345902033,3559619861,1672658285,1672661096,2811
11260,3779723939,3533867833,1672611574,1672613981,2407
10607,3906874577,3772968080,1672558864,1672560323,1459
11349,3756428507,3298831109,1672544970,1672548248,3278
10219,3733411026,3445406685,1672647196,1672647524,328
10317,3517469005,3813853446,1672642033,1672643919,1886
10581,3856897914,3755769731,1672679848,1672683197,3349
10968,3713476192,3837435907,1672700728,1672703379,2651
10250,3510484107,3394364348,1672667249,1672670417,3168
10484,3822368676,3756784813,1672639467,1672640533,1066
10939,3558567160,3701519251,1672682059,1672683413,1354
11722,3660257653,3245882008,1672633173,1672633774,601
11096,3511364193,3933562725,1672538348,1672539021,673
10918,3342368576,3417223898,1672589740,1672591724,1984
10717,3474097405,3308965136,1672582621,1672585438,2817
10170,3440770466,3890813040,1672697804,1672698332,528
10012,3686081254,3446575109,1672627880,1672628204,324
10316,3469350379,3713159131,1672662334,1672663978,1644
11453,3777499535,3274739459,1672599781,1672601815,2034
11399,3496407500,3711722554,1672668082,1672668575,493
11551,3500974385,3510373076,1672591576,1672592409,833
10835,3701359045,3520022175,1672673242,1672674702,1460
10478,3683562111,3511969443,1672574504,1672578015,3511
11341,3911821258,3780626668,1672632845,1672633160,315
10961,3617135064,3418367752,1672606325,1672608081,1756
10174,3777041132,3510244209,1672560826,1672562939,2113
11758,3779130507,3667814788,1672649458,1672651728,2270
10441,3773161055,3512306195,1672557046,1672559018,1972
10258,3475090917,3604908372,1672658916,1672661648,2732
9999,3716891903,3710173412,1672683187,1672684462,1275
10877,3345896913,3716183063,1672617777,1672619001,1224
10048,3737571883,3516019206,1672702733,1672705938,3205
10528,3714645218,3510694464,1672631825,1672633749,1924
10349,3513171472,3534758256,1672686335,1672687747,1412
10727,3669475165,3783086267,1672610942,1672613050,2108
11762,3822496670,3880637958,1672614667,1672615063,396
11071,3777928067,3772659062,1672578022,1672579609,1587
10153,3514776568,3360783381,1672693775,1672696973,3198
10953,3274894848,3334824744,1672645614,1672647288,1674
11034,3515970536,3311810583,1672676237,1672676513,276
11370,3774606418,3509556649,1672626274,1672629099,2825
11548,3837378340,3770012744,1672635856,1672637666,1810
10933,3516153301,3755767856,1672642464,1672643944,1480
10475,3669497617,3520022175,1672532514,1672535812,3298
10290,3833993674,3925175853,1672594358,1672597672,3314
11172,3757050615,3516668203,1672543691,1672544127,436
10373,3938059867,3851810349,1672678683,1672679242,559
10860,3223177147,3519848902,1672583152,1672584872,1720
11564,3488399075,3600302127,1672639298,1672640236,938
10013,3500776597,3757501067,1672558867,1672560183,1316
10018,3772055279,3415562576,1672701097,1672701796,699
10868,3617771673,3479452888,1672621717,1672623458,1741
10729,3779468781,3791841318,1672673835,1672675969,2134
10633,3757514745,3680832669,1672556361,1672558956,2595
11114,3777758203,3514628916,1672616588,1672618307,1719
9818,3434452046,3770574826,1672549485,1672552770,3285
10830,3803996569,3801501384,1672535819,1672538791,2972
10632,3402580733,3413799143,1672605679,1672608981,3302
10983,3461743188,3516319492,1672626393,1672627834,1441
10205,3776187150,3776319560,1672691314,1672692035,721
11471,3453464785,3792455305,1672539594,1672541264,1670
10230,3510206323,3777304517,1672677106,1672678422,1316
10351,3837888196,3624872714,1672650430,1672653434,3004
10595,3716475340,3518425740,1672573374,1672575996,2622
11235,3919994216,3302929858,1672701481,1672703442,1961
10319,3501407804,3711367577,1672684593,1672686770,2177
11412,3780127017,3209075485,1672696050,1672699380,3330
11241,3307236682,3304235700,1672653199,1672656046,2847
11065,3509503263,3710223875,1672697479,1672699472,1993
11061,3275171954,3773376762,1672663354,1672663849,495
10898,3703742071,3810584695,1672582978,1672585662,2684
11266,3770966950,3430296808,1672605251,1672605750,499
11768,3825932442,3929923442,1672670122,1672672001,1879
10059,3716195780,3703779674,1672599760,1672599840,80
11421,3505037247,3518335611,1672628888,1672629361,473
10109,3776348451,3780048608,1672600204,1672603479,3275
11716,3818532143,3403738461,1672632987,1672633532,545
10881,3444453261,3732128078,1672541365,1672544360,2995
11204,3804779247,3636605690,1672660437,1672661258,821
11113,3311472321,3208894215,1672597809,1672598234,425
10724,3512750313,3773434690,1672698384,1672700024,1640
11114,3713373455,3505414878,1672701165,1672703985,2820
10625,3937747312,3517943697,1672564399,1672566304,1905
9804,3534328311,3770276815,1672691564,1672692612,1048
11154,3513894659,3509317054,1672622778,1672623621,843
10415,3516321814,3509912164,1672539481,1672541491,2010
10806,3791224239,3358959807,1672546844,1672547625,781
9809,3664478769,3308744016,1672606109,1672607331,1222
11323,3736056340,3514361485,1672599359,1672599451,92
11516,3735497729,3793949077,1672533565,1672534411,846
11344,3501835995,3850108828,1672613524,1672615654,2130
10313,3904045870,3711119575,1672660542,1672661724,1182
10923,3680075399,3248409083,1672674902,1672678342,3440
10693,3610517436,3774325486,1672579721,1672580613,892
10828,3511969443,3306066522,1672636822,1672639061,2239
10767,3710622746,3887069914,1672549179,1672551066,1887
9794,3511286390,3730459093,1672631480,1672633145,1665
11716,3617771673,3760737203,1672592627,1672592742,115
9849,3450503086,3500640854,1672590314,1672590428,114
10951,3807646028,3406492167,1672702541,1672703369,828
11592,3923910914,3770924034,1672542017,1672545362,3345
11604,3715680249,3298706213,1672565658,1672569166,3508
10773,3343616490,3779478448,1672596316,1672597405,1089
11391,3792021895,3457249798,1672632163,1672633785,1622
11431,3364067937,3837887478,1672640807,1672644159,3352
11505,3513186622,3791905743,1672569858,1672570746,888
11426,3621591266,3605101443,1672646095,1672648727,2632
10076,3792682835,3283106998,1672562607,1672563751,1144
10571,3557528150,3415562576,1672574371,1672575776,1405
10762,3512417028,3772683155,1672534610,1672537539,2929
10598,3276393542,3458271585,1672648577,1672651659,3082
11259,3711029952,3509208005,1672630000,1672632625,2625
10751,3773852157,3505164060,1672657332,1672658342,1010
10894,3716475340,3475560058,1672621534,1672623985,2451
11393,3608214600,3459799131,1672612785,1672614838,2053
10378,3450511428,3755218683,1672622437,1672624562,2125
10535,3807646028,3520470646,1672536978,1672538953,1975
10586,3399504157,3783809405,1672585174,1672586382,1208
10225,3510795808,3311409212,1672554380,1672555183,803
11174,3505121295,3509274030,1672638147,1672639119,972
11781,3777729184,3970775805,1672669171,1672671086,1915
11027,3715897627,3501583486,1672653234,1672656308,3074
9986,3701028092,3379400553,1672546682,1672547391,709
11109,3776593726,3770273459,1672696967,1672698014,1047
10895,3793732968,3534204885,1672672376,1672673181,805
10702,3516651799,3500863429,1672603322,1672606689,3367
11007,3209417223,3282240901,1672673133,1672675532,2399
10843,3915460293,3896123242,1672534494,1672536336,1842
11114,3632189887,3776617627,1672696981,1672698186,1205
10491,3518209090,3804779247,1672572974,1672575781,2807
10078,3783730769,3239082508,1672615048,1672617152,2104
10196,3886896755,3857590978,1672616534,1672619540,3006
10131,3444168914,3422205569,1672664864,1672668165,3301
10951,3609925909,3777118499,1672683960,1672687359,3399
10189,3439651226,3684199077,1672646356,1672648447,2091
11067,3978643889,3834949242,1672618595,1672619309,714
10561,3776124041,3462153833,1672535504,1672538699,3195
11199,3738734246,3714883746,1672663974,1672665108,1134
9994,3505811269,3240622654,1672679806,1672681005,1199
10392,3512555384,3757872458,1672683599,1672684849,1250
10636,3713373455,3701385831,1672576682,1672577785,1103
10221,3501171785,3467756698,1672612009,1672613716,1707
11066,3924583142,3760801237,1672564716,1672565923,1207
10906,3505624416,3755175497,1672535025,1672538085,3060
10135,3308149799,3757201138,1672696837,1672699843,3006
11360,3888409038,3372617110,1672535319,1672536982,1663
9922,3793003432,3603682643,1672583000,1672584029,1029
11284,3335353798,3445172440,1672662650,1672662762,112
10667,3501427691,3509544691,1672645191,1672648009,2818
11062,3512596743,3711176990,1672560294,1672561806,1512
10451,3770441717,3515378306,1672682269,1672682661,392
11435,3512411326,3518511124,1672691444,1672692367,923
10791,3757050615,3500741534,1672679695,1672680439,744
10364,3394357241,3516585063,1672619183,1672619908,725
11644,3755170743,3783238023,1672570083,1672572465,2382
10974,3774238066,3774195369,1672627745,1672630146,2401
10321,3716445184,3281970147,1672644346,1672646143,1797
10442,3552309108,3780423516,1672634708,1672635314,606
10025,3772695548,3201957157,1672625170,1672625680,510
9974,3505500523,3249380931,1672576103,1672579605,3502
11021,3235470567,3780298499,1672655638,1672656954,1316
9951,3553321027,3395505794,1672653942,1672656882,2940
10792,3500814753,3510781595,1672656963,1672658326,1363
11533,3812261241,3837887478,1672551527,1672554378,2851
10568,3519848902,3615245840,1672555159,1672558146,2987
11361,3422081502,3500544306,1672542865,1672546109,3244
10924,3760710525,3779706467,1672685176,1672685463,287
11629,3925175853,3623894390,1672701078,1672704552,3474
9958,3278251248,3516378356,1672685547,1672688991,3444
11183,3520553959,3773953689,1672637206,1672639425,2219
10688,3715126587,3701060732,1672664109,1672664433,324
10024,3792708936,3904045870,1672544315,1672545165,850
10921,3316117186,3533703578,1672568836,1672569546,710
10045,3710082615,3206544535,1672605702,1672609099,3397
11788,3922786716,3604908372,1672544588,1672545941,1353
11184,3703336988,3304661369,1672545097,1672548495,3398
10846,3715737742,3500440602,1672638832,1672639232,400
10807,3304252969,3713219299,1672547770,1672549120,1350
11200,3713159131,3685396470,1672669350,1672671532,2182
11411,3791351852,3433189219,1672635738,1672638294,2556
10207,3757199889,3819024145,1672533920,1672537078,3158
10274,3501171785,3780500764,1672655480,1672659077,3597
11676,3755394177,3304030474,1672587593,1672588112,519
11654,3275274182,3245774173,1672678237,1672681829,3592
11142,3780294116,3518989186,1672612736,1672616072,3336
11254,3286938590,3780749789,1672634042,1672634423,381
10352,3518759318,3399430522,1672661351,1672663128,1777
11530,3515803462,3505653701,1672647357,1672649902,2545
11732,3402580733,3208560443,1672540487,1672541382,895
10541,3625400710,3406029706,1672671919,1672674520,2601
9913,3516815069,3439036305,1672540530,1672541525,995
11541,3900766525,3772845364,1672594438,1672596157,1719
10212,3778706119,3349319959,1672533861,1672536463,2602
10296,3680939042,3500640854,1672535635,1672538930,3295
9804,3559619861,3455430943,1672670583,1672671777,1194
10779,3826068495,3615846003,1672568537,1672569682,1145
10957,3613703906,3244098077,1672614211,1672616348,2137
10796,3341985886,3206377955,1672644643,1672646709,2066
10857,3734957248,3519848902,1672665423,1672667567,2144
10036,3756668747,3738429905,1672658723,1672659867,1144
10799,3856699097,3338016147,1672667982,1672669507,1525
10468,3366961580,3533440294,1672532717,1672535771,3054
10989,3618672178,3227874229,1672627613,1672629795,2182
11447,3890211161,3910020031,1672572858,1672573931,1073
10281,3511908639,3703423962,1672576955,1672578203,1248
9922,3511198566,3892177203,1672644213,1672647564,3351
10492,3511069449,3738132114,1672533210,1672534680,1470
11393,3316537706,3511412229,1672692298,1672694739,2441
11466,3791121243,3486509752,1672531269,1672532979,1710
10805,3316406470,3304028109,1672578918,1672582105,3187
11094,3309178914,3500342408,1672614770,1672617622,2852
10054,3772216305,3711613085,1672568619,1672568792,173
9879,3228218081,3680988889,1672664824,1672668230,3406
10451,3887030182,3755203055,1672620720,1672623268,2548
10256,3440401725,3334381941,1672666788,1672668410,1622
11202,3517210356,3336225953,1672668073,1672671369,3296
10064,3379076106,3311924005,1672559050,1672560409,1359
11477,3356972733,3888409038,1672662305,1672664399,2094
11211,3501515425,3805704844,1672564401,1672567451,3050
10949,3701567668,3773202954,1672551337,1672554863,3526
11102,3760232135,3711767051,1672611083,1672613973,2890
10527,3313282478,3534770827,1672599460,1672601123,1663
10097,3838039092,3500630465,1672551297,1672552537,1240
10205,3715844082,3834643026,1672701517,1672702320,803
10041,3774316305,3976225898,1672630501,1672630951,450
10944,3773826624,3395069149,1672662872,1672663368,496
10159,3832333115,3461931154,1672619942,1672621963,2021
11365,3792785261,3510022922,1672630313,1672632342,2029
10114,3713107380,3792283334,1672587157,1672587866,709
10245,3770441717,3600171014,1672617395,1672620817,3422
10589,3398075553,3482687604,1672535628,1672536145,517
9876,3733411026,3817315443,1672643331,1672644006,675
10920,3511412229,3516969689,1672684104,1672687311,3207
10879,3638018906,3884001167,1672539154,1672539667,513
10339,3896211741,3311305760,1672642742,1672645803,3061
9951,3807486812,3516321993,1672554452,1672557663,3211
10424,3703423962,3284483177,1672567554,1672570071,2517
10629,3500317923,3756991235,1672652080,1672652763,683
11383,3510368377,3770180844,1672588511,1672589129,618
11383,3534537581,3454554552,1672561965,1672562081,116
10240,3791532324,3714690161,1672578992,1672582380,3388
10482,3273242177,3716633983,1672656963,1672657656,693
10445,3303432071,3449233346,1672670285,1672670489,204
10663,3970265139,3274739459,1672655773,1672657336,1563
9831,3512645289,3730169449,1672603946,1672606842,2896
10475,3227956115,3710852576,1672694432,1672695287,855
10914,3772489471,3517652011,1672557753,1672561064,3311
10792,3777751979,3461741050,1672618127,1672619870,1743
11766,3511364193,3520155898,1672691526,1672694970,3444
10131,3703415246,3394959062,1672552605,1672555917,3312
11716,3774195369,3710316008,1672681785,1672684136,2351
10921,3792075871,3792987243,1672643843,1672647145,3302
10549,3716944983,3715101177,1672616340,1672616475,135
11564,3367202274,3791587717,1672553933,1672556278,2345
10036,3514244308,3605101443,1672548491,1672551851,3360
11593,3735152111,3780982229,1672545081,1672547377,2296
9949,3701779683,3510547682,1672700644,1672702104,1460
10241,3757050615,3890211161,1672559501,1672562920,3419
11478,3501137133,3772683155,1672604873,1672607146,2273
9869,3710529628,3241682278,1672537552,1672540130,2578
11708,3757201538,3533265491,1672645587,1672647056,1469
11570,3418791124,3275975921,1672626019,1672626814,795
11363,3472272792,3716160006,1672695555,1672698611,3056
10663,3714838100,3773603836,1672703661,1672706285,2624
10775,3716976932,3433196933,1672541936,1672543886,1950
11546,3220798451,3935256825,1672572458,1672574782,2324
11600,3714892312,3792627762,1672655310,1672655755,445
11200,3400545490,3505155858,1672643102,1672645869,2767
11329,3500909455,3287821258,1672532262,1672533823,1561
11199,3315432466,3492728794,1672652384,1672654563,2179
10391,3510254698,3478052226,1672635204,1672638135,2931
11015,3770408300,3899294071,1672594115,1672596610,2495
11350,3517902505,3483078667,1672697933,1672699681,1748
10744,3770023722,3514508773,1672602879,1672603619,740
11436,3880637958,3274894848,1672630156,1672633672,3516
11012,3313392810,3515470462,1672697291,1672700028,2737
11707,3533009565,3711718368,1672700244,1672703098,2854
10937,3338465050,3358262975,1672694274,1672694897,623
9943,3703336988,3520012007,1672696200,1672698366,2166
11549,3500221079,3770276815,1672692245,1672694364,2119
11050,3281935691,3225554956,1672572181,1672572756,575
10880,3778695017,3934280144,1672612379,1672615522,3143
10015,3886896755,3783122313,1672671297,1672672179,882
10396,3760731595,3739217535,1672627352,1672629664,2312
10817,3732540636,3919342147,1672587360,1672588452,1092
11704,3777041132,3716179251,1672664903,1672667091,2188
9889,3501356814,3342545285,1672698365,1672698547,182
11596,3777405860,3756647451,1672667921,1672669979,2058
11733,3510869438,3482172065,1672648254,1672651023,2769
10902,3701377471,3500209015,1672650650,1672653631,2981
10797,3500415589,3710852576,1672686074,1672688599,2525
10760,3533473206,3516319492,1672557576,1672558924,1348
9913,3514515499,3220660616,1672594941,1672597064,2123
10478,3615742989,3373135211,1672635539,1672636740,1201
11279,3883640454,3462985379,1672615178,1672616645,1467
11224,3332124606,3716609198,1672570967,1672574556,3589
10418,3413799143,3757060033,1672584370,1672586713,2343
11165,3774029494,3854390432,1672562567,1672562698,131
11564,3316821313,3928421417,1672682578,1672685531,2953
9896,3357074700,3778706119,1672559854,1672561098,1244
10518,3392010033,3246062632,1672539305,1672539606,301
10068,3902023467,3756437169,1672658550,1672658847,297
10010,3499998389,3713476192,1672555666,1672556249,583
10191,3483078667,3639081201,1672619780,1672622700,2920
10991,3501174621,3760749218,1672639355,1672640399,1044
10778,3703048107,3807646028,1672544149,1672545689,1540
11285,3972856326,3770424941,1672589951,1672590716,765
10583,3856699097,3475090917,1672664967,1672668448,3481
10317,3780648744,3434052463,1672658490,1672661533,3043
11277,3309651238,3236254381,1672687371,1672690296,2925
10335,3501115299,3716609198,1672615898,1672619353,3455
11346,3558264627,3819024145,1672531540,1672531887,347
10062,3342368576,3406238754,1672632319,1672635903,3584
10288,3783594246,3757660578,1672533706,1672535831,2125
11606,3803996569,3200320674,1672618691,1672621792,3101
9912,3730290851,3686885442,1672544642,1672546574,1932
11632,3299587876,3772844451,1672542654,1672545885,3231
10322,3807717766,3533822490,1672682237,1672685669,3432
11242,3977615973,3395082458,1672684181,1672687252,3071
11093,3394986304,3520395850,1672639040,1672639746,706
10691,3510987684,3500909455,1672605271,1672606725,1454
10823,3780500764,3713416756,1672531463,1672532595,1132
11354,3343859998,3791688526,1672654975,1672656531,1556
11549,3755729826,3373851012,1672594698,1672596367,1669
10673,3921138062,3701127475,1672650832,1672653361,2529
11333,3501137133,3423217578,1672593170,1672593893,723
11718,3500104976,3893932944,1672602599,1672604075,1476
10403,3517645656,3828568868,1672695705,1672698555,2850
10389,3441840658,3716179251,1672562430,1672563586,1156
11555,3225554956,3514941815,1672665867,1672668320,2453
11727,3713444403,3230250213,1672569557,1672572889,3332
11474,3760322661,3714688409,1672593781,1672594820,1039
11034,3791617239,3452802329,1672683668,1672686477,2809
11101,3202740652,3304592684,1672645075,1672646211,1136
10770,3512768285,3710529628,1672611532,1672613330,1798
10950,3394959062,3372596013,1672679341,1672679414,73
11523,3711856534,3793926338,1672544891,1672547756,2865
11652,3713434898,3791906680,1672594782,1672596211,1429
10814,3519065870,3514498259,1672581288,1672582639,1351
10156,3497138014,3435342362,1672604482,1672608005,3523
10924,3359418136,3774702364,1672639153,1672639512,359
10101,3600699873,3757378286,1672655533,1672658210,2677
10575,3713923960,3791905743,1672537267,1672539409,2142
11598,3335139032,3774394000,1672674244,1672674655,411
10639,3241682278,3777655401,1672607528,1672608147,619
11251,3284865931,3505032773,1672613257,1672615351,2094
10672,3311696372,3856975623,1672614144,1672615469,1325
11237,3703896751,3500433278,1672660350,1672661482,1132
11604,3500630465,3509317776,1672534195,1672534584,389
10895,3666823095,3701919083,1672568137,1672568721,584
10008,3772169046,3780048608,1672629815,1672630770,955
10822,3500688476,3276499910,1672623456,1672625267,1811
11739,3770715115,3496407500,1672612466,1672613545,1079
10083,3426207439,3922409420,1672565721,1672567901,2180
9860,3295691964,3703031637,1672565157,1672565527,370
10233,3505887814,3715622084,1672606484,1672609532,3048
11661,3509470194,3715284599,1672621789,1672622720,931
11505,3858330969,3277061226,1672549527,1672552881,3354
10845,3501427691,3509445318,1672567464,1672569181,1717
10583,3776316903,3207748225,1672583634,1672586794,3160
11595,3505665788,3793332600,1672632479,1672634779,2300
11754,3311774510,3447696555,1672581476,1672583318,1842
10326,3783506190,3512477276,1672603736,1672605433,1697
11304,3500630465,3760687922,1672589908,1672590417,509
10505,3662507634,3611832288,1672691451,1672694984,3533
11688,3468281011,3822368676,1672548533,1672551247,2714
10101,3427741923,3471177177,1672605194,1672606184,990
11791,3487988841,3899156705,1672681344,1672682018,674
10105,3470135167,3783506190,1672570114,1672572249,2135
11274,3364286028,3772112976,1672644035,1672645930,1895
10626,3493679801,3517144269,1672686079,1672689009,2930
10378,3683562111,3660257653,1672570202,1672571571,1369
11449,3375257546,3735679000,1672591109,1672591264,155
11449,3716460706,3225371682,1672563385,1672564563,1178
11036,3459799131,3512417028,1672547408,1672549012,1604
11099,3488887919,3783368855,1672557045,1672557608,563
11164,3903115138,3779748270,1672577144,1672580430,3286
11445,3829761380,3757050615,1672588205,1672590910,2705
10164,3600302127,3792475476,1672596409,1672598642,2233
10810,3606804618,3512965991,1672622389,1672623584,1195
11430,3908862092,3972653129,1672688221,1672689258,1037
10198,3505786561,3471555057,1672696283,1672698312,2029
10933,3777290300,3453164933,1672688472,1672691651,3179
11113,3770925016,3701475090,1672585548,1672588936,3388
10033,3239423794,3637105495,1672693822,1672695963,2141
11536,3512768285,3510826414,1672587002,1672589750,2748
10567,3444598583,3755767856,1672623372,1672625412,2040
10574,3450511428,3311514075,1672531880,1672535132,3252
10191,3715441777,3757201538,1672685110,1672687652,2542
10347,3715126587,3714264759,1672569715,1672571423,1708
10118,3791905743,3288791629,1672614963,1672617874,2911
10087,3517380144,3791509334,1672620049,1672622506,2457
10283,3501515425,3909399636,1672691140,1672691528,388
11188,3501574882,3792785261,1672554814,1672555175,361
10898,3366566029,3304661369,1672624716,1672625296,580
10704,3500405175,3518335611,1672651645,1672651853,208
10756,3756413374,3450735824,1672671834,1672675156,3322
10712,3357026115,3275171954,1672541920,1672545420,3500
11171,3825153408,3391093411,1672639556,1672641906,2350
10952,3533929043,3701779683,1672614982,1672618337,3355
11786,3776950532,3715590997,1672684376,1672686155,1779
10627,3341985886,3773376762,1672635036,1672638349,3313
11004,3711862792,3714883746,1672543776,1672544209,433
10642,3931917809,3534696810,1672568363,1672568660,297
11257,3500595432,3403395712,1672562051,1672565059,3008
10076,3930766276,3881579907,1672688693,1672691282,2589
10138,3714897456,3770924034,1672541583,1672544274,2691
11231,3335353798,3505502819,1672559693,1672560656,963
9887,3730052916,3779393140,1672633456,1672634466,1010
10906,3517426473,3757501067,1672625567,1672627034,1467
11297,3850993995,3713191326,1672703319,1672703660,341
10070,3395505794,3300238532,1672550061,1672552317,2256
10276,3600699873,3500624846,1672614226,1672614908,682
9878,3701377471,3778195766,1672612488,1672612654,166
9839,3853783593,3413799143,1672642484,1672644305,1821
9916,3774652449,3505190512,1672593892,1672596765,2873
11380,3703624327,3513624915,1672556210,1672559708,3498
11179,3757678397,3714287902,1672569764,1672571933,2169
11365,3224824355,3830599959,1672567861,1672569710,1849
9914,3896123242,3302929858,1672662736,1672665017,2281
10666,3501427691,3701521510,1672572661,1672572810,149
10818,3757598610,3394364348,1672627249,1672630711,3462
10724,3517810375,3710585241,1672540642,1672541068,426
10827,3824259677,3301369282,1672640344,1672641590,1246
11509,3505665788,3756367938,1672626516,1672628363,1847
10797,3287968403,3407734098,1672579808,1672582960,3152
10492,3665431349,3774633364,1672633036,1672633989,953
10200,3359351267,3398862999,1672601348,1672601907,559
9808,3517132086,3295787354,1672658297,1672659779,1482
10119,3500854711,3510484107,1672630279,1672630344,65
10039,3760901975,3938059867,1672533938,1672536452,2514
10556,3756680289,3716183063,1672702016,1672702753,737
10804,3783067048,3514560138,1672560714,1672563996,3282
10893,3500695402,3472774606,1672618342,1672620419,2077
11131,3685083275,3755075988,1672564669,1672567968,3299
11688,3342368576,3783043770,1672630041,1672630565,524
11577,3896615831,3773826624,1672591733,1672592030,297
10465,3356972733,3733123020,1672617998,1672621042,3044
10271,3635599307,3755129708,1672657468,1672658202,734
9846,3773408491,3511907179,1672615119,1672615931,812
11113,3354405535,3472561941,1672624068,1672626498,2430
10149,3534941710,3439036305,1672561407,1672562513,1106
10692,3739567072,3777928067,1672674356,1672675996,1640
11141,3369810091,3756119976,1672671964,1672672452,488
11509,3301489209,3809207482,1672694030,1672695852,1822
10412,3513250976,3715566511,1672595835,1672597282,1447
10888,3519724388,3472774606,1672570013,1672571485,1472
11172,3472018395,3972729768,1672643096,1672646201,3105
10444,3394394262,3791435852,1672540796,1672543226,2430
10758,3793704155,3730115019,1672601369,1672603065,1696
11041,3817120976,3703614781,1672660177,1672660495,318
10638,3384151770,3406029706,1672613652,1672616402,2750
11711,3517426473,3837271330,1672581340,1672584377,3037
10299,3558567160,3701475090,1672644870,1672646685,1815
11604,3519951586,3509208005,1672546000,1672549467,3467
10270,3777405860,3632094087,1672607228,1672609000,1772
10981,3301449986,3716463756,1672585517,1672585755,238
11240,3534328311,3791088014,1672660147,1672662624,2477
10766,3495427619,3469350379,1672539014,1672540244,1230
9842,3856129522,3275057862,1672621463,1672622606,1143
10700,3739217535,3520763492,1672668641,1672671565,2924
10894,3600171014,3660176760,1672680021,1672680931,910
10069,3977666815,3629248353,1672594485,1672594948,463
10484,3908883591,3510882475,1672649330,1672651335,2005
10100,3442096275,3774682234,1672629437,1672632375,2938
10176,3501612813,3290060215,1672663640,1672665103,1463
10471,3225371682,3360972732,1672619578,1672622156,2578
9911,3822496670,3395565040,1672601453,1672604099,2646
11619,3629248353,3505490878,1672559865,1672560562,697
10990,3501977123,3851737350,1672583710,1672586624,2914
11733,3715858201,3209417223,1672648019,1672650987,2968
9907,3755767856,3376842515,1672627536,1672628611,1075
10017,3897851509,3713996094,1672694116,1672694542,426
10511,3701725839,3716233100,1672545114,1672546087,973
9956,3505867821,3466492108,1672638196,1672640600,2404
10198,3520057139,3972729768,1672563225,1672564966,1741
11022,3701521510,3716341323,1672643467,1672645337,1870
11114,3291617477,3505359060,1672632496,1672632568,72
10309,3467756698,3501550490,1672607392,1672608683,1291
10504,3910049345,3342495377,1672603966,1672605670,1704
10997,3515939841,3310961923,1672696184,1672699064,2880
10253,3514244308,3605760561,1672557174,1672558193,1019
11094,3711196962,3369938668,1672676721,1672678709,1988
9881,3440671139,3505887814,1672688994,1672691691,2697
11599,3482786946,3757212744,1672565198,1672567285,2087
11276,3716183063,3220798451,1672700537,1672700889,352
11585,3701065296,3894756677,1672598899,1672601005,2106
11190,3611939581,3291446384,1672650718,1672654203,3485
9828,3201502111,3777672363,1672557528,1672558434,906
11184,3517645656,3511907179,1672691752,1672694441,2689
10297,3778713526,3235578852,1672694798,1672696222,1424
10774,3505175620,3533225084,1672539601,1672541151,1550
10634,3855977674,3511206717,1672644467,1672647548,3081
10174,3468066881,3501574882,1672582517,1672585934,3417
11692,3615846003,3755286041,1672665900,1672667200,1300
11601,3755769254,3229621693,1672653254,1672654117,863
10726,3716633983,3924205112,1672627791,1672629985,2194
11449,3513840186,3793860209,1672684165,1672686734,2569
10441,3793732968,3497904539,1672641817,1672642935,1118
11751,3463892928,3680988889,1672669461,1672671581,2120
10686,3772235668,3479207976,1672599242,1672600788,1546
10735,3514341451,3760385591,1672632252,1672633151,899
10068,3371238318,3511750695,1672691904,1672692643,739
9915,3399726243,3776841808,1672670578,1672673016,2438
11662,3905358065,3272827860,1672539524,1672539916,392
10521,3274739459,3444881567,1672626964,1672628891,1927
11403,3512871568,3772188086,1672699247,1672701150,1903
10794,3500814753,3515764058,1672543143,1672545664,2521
10111,3737571883,3457249798,1672645929,1672649145,3216
11758,3367121615,3353326305,1672605588,1672607960,2372
11287,3902548260,3778819352,1672702257,1672705141,2884
10532,3716595760,3491527603,1672584253,1672587592,3339
10569,3319862687,3459799131,1672541222,1672543797,2575
9948,3972856326,3319645922,1672535591,1672538708,3117
10763,3428788958,3602054754,1672543283,1672546182,2899
10256,3500317923,3356972733,1672606363,1672607299,936
10061,3441336851,3296970170,1672624304,1672627419,3115
9960,3500018566,3735497729,1672698801,1672702400,3599
10905,3830254808,3311463998,1672571240,1672572913,1673
10928,3294949958,3461931154,1672538397,1672538468,71
9972,3246062632,3776841808,1672552598,1672553377,779
11756,3388915945,3714923092,1672583666,1672584647,981
11260,3345896913,3934280144,1672592919,1672595940,3021
10759,3404187438,3519724388,1672603345,1672606474,3129
11417,3245501577,3518425740,1672545098,1672546591,1493
10439,3733123020,3501407804,1672604597,1672607536,2939
11612,3792411831,3703614781,1672538791,1672539777,986
11276,3509626590,3669475165,1672613804,1672615418,1614
10542,3534204885,3852275715,1672635240,1672638779,3539
10085,3791796190,3505998260,1672535617,1672537188,1571
10215,3310021925,3733953055,1672668972,1672669899,927
10666,3443004958,3501980730,1672589277,1672590418,1141
11774,3466620548,3533628528,1672658911,1672659743,832
10648,3505129296,3500049870,1672563224,1672563878,654
11287,3636857871,3520012007,1672639804,1672643008,3204
10517,3519947298,3613940925,1672686824,1672687232,408
10016,3711889178,3703725221,1672667978,1672669132,1154
11358,3680939042,3284865931,1672596446,1672598915,2469
10211,3780733404,3458753033,1672545671,1672546169,498
10214,3387989658,3683514731,1672678954,1672680779,1825
10897,3773408491,3817376705,1672542293,1672544859,2566
10238,3932491622,3757639274,1672594001,1672595496,1495
11207,3226913558,3755209597,1672570092,1672570250,158
10073,3421674406,3757050615,1672611411,1672614088,2677
10790,3226172318,3710783759,1672545839,1672549059,3220
11082,3519703964,3773556853,1672541322,1672542474,1152
10356,3811503860,3666022373,1672650106,1672651090,984
10144,3518058151,3518534560,1672697646,1672698451,805
10710,3664523809,3474879231,1672587573,1672589290,1717
11625,3226037966,3791994414,1672690909,1672694357,3448
10036,3519886257,3710487368,1672655348,1672657003,1655
10371,3479585868,3713102459,1672552506,1672555854,3348
10460,3516067011,3923910914,1672652538,1672654047,1509
10001,3495427619,3716285196,1672703920,1672705547,1627
9924,3500889287,3791542842,1672688660,1672689415,755
10103,3334461288,3220976338,1672655195,1672657193,1998
11365,3517210356,3517797610,1672695588,1672698837,3249
10681,3364683368,3285201542,1672601064,1672602188,1124
10833,3432466467,3446233783,1672639356,1672642065,2709
11481,3505291330,3505414878,1672615080,1672618403,3323
11709,3520155898,3533427742,1672623145,1672625010,1865
9864,3512965991,3760710525,1672658156,1672661573,3417
10526,3558349840,3354015456,1672578252,1672580141,1889
11361,3777686966,3511382748,1672622697,1672623972,1275
9948,3778195766,3713611960,1672685549,1672687496,1947
10126,3770533588,3664719070,1672663170,1672663541,371
10865,3512555384,3689386663,1672535732,1672536847,1115
10300,3755790149,3934070285,1672633630,1672634653,1023
10102,3780648744,3481019442,1672570937,1672572941,2004
10781,3446810761,3757199889,1672620523,1672620888,365
11585,3432762943,3444680955,1672550738,1672552834,2096
11759,3511650296,3515838621,1672531241,1672532429,1188
9885,3297100323,3238779889,1672668254,1672668710,456
9825,3352295704,3200785194,1672533305,1672533692,387
10251,3303747093,3516706121,1672617068,1672618873,1805
11455,3919494952,3511296895,1672588742,1672588967,225
9847,3703722212,3850108828,1672572931,1672573026,95
11407,3715680249,3904004824,1672603236,1672604621,1385
10863,3660702754,3277634944,1672688447,1672689373,926
10986,3478455812,3517426473,1672600228,1672602229,2001
9832,3511028193,3711015176,1672649992,1672651642,1650
10301,3733870816,3711765138,1672570103,1672571327,1224
10395,3688870751,3294949958,1672624810,1672625389,579
10260,3713807753,3757823215,1672554758,1672555585,827
11003,3701127475,3352044245,1672544907,1672546510,1603
10262,3398075553,3360783381,1672671561,1672673840,2279
9875,3207586072,3778842400,1672557069,1672559697,2628
10350,3458130310,3779393140,1672590445,1672591058,613
10938,3791664049,3349573092,1672630288,1672631802,1514
10577,3294952405,3893950585,1672678775,1672681617,2842
11051,3613216900,3445077330,1672681607,1672684122,2515
10653,3661543201,3510153173,1672542070,1672542254,184
10175,3633949990,3856147380,1672613520,1672614896,1376
10625,3293553295,3493047640,1672576367,1672577557,1190
9890,3273537848,3511671476,1672636854,1672637185,331
10519,3770391782,3396453219,1672629592,1672631554,1962
10093,3518511124,3559221089,1672546885,1672550163,3278
10030,3520515739,3831864108,1672631662,1672633547,1885
11208,3470997293,3519351747,1672574965,1672575944,979
10970,3505867821,3853188285,1672533003,1672535639,2636
11734,3387989658,3804707712,1672603704,1672606526,2822
11006,3319436533,3774921252,1672688098,1672688459,361
10264,3295530454,3293579860,1672575170,1672576188,1018
9910,3770991234,3792440162,1672652628,1672655462,2834
11389,3773697080,3511729562,1672674972,1672676651,1679
9957,3896859936,3427049290,1672547148,1672549053,1905
11109,3316821313,3772019557,1672576721,1672577195,474
11127,3776901443,3783506190,1672665894,1672667610,1716
11614,3791031227,3780740477,1672581768,1672584492,2724
10236,3513293711,3660257653,1672570177,1672571173,996
10531,3928421417,3398075553,1672594713,1672596883,2170
10642,3303552616,3809207482,1672536087,1672537879,1792
10344,3362368123,3783695231,1672699519,1672702406,2887
11299,3666958814,3779818784,1672630400,1672633099,2699
11031,3607288879,3639081201,1672595936,1672596986,1050
10277,3836586875,3272838634,1672699222,1672702523,3301
10603,3520022175,3410602007,1672555156,1672557271,2115
9987,3714250543,3880549316,1672669472,1672672112,2640
10679,3927202773,3360525513,1672694656,1672696355,1699
10905,3476308535,3382308738,1672578465,1672579383,918
11401,3680832669,3361711720,1672538420,1672538554,134
11392,3703419800,3701218904,1672568159,1672571069,2910
9957,3792930090,3207307681,1672600504,1672600761,257
11431,3513840186,3792012147,1672628500,1672631667,3167
11138,3772802020,3932919664,1672694261,1672697699,3438
11061,3756897029,3919494952,1672633381,1672635986,2605
11267,3684651755,3933731871,1672556847,1672557403,556
11066,3287094447,3703351452,1672687611,1672688117,506
11104,3500591274,3248061684,1672688661,1672692246,3585
10490,3906075386,3514361485,1672680328,1672681081,753
10949,3793029132,3777751979,1672650257,1672650934,677
10246,3920890008,3517960157,1672535384,1672538721,3337
10664,3278443807,3791905743,1672564708,1672566920,2212
10054,3779503296,3382696725,1672673063,1672673989,926
11774,3304252969,3757872458,1672660358,1672662882,2524
10305,3235313062,3478455812,1672608607,1672609343,736
11617,3770019143,3305093237,1672637170,1672640706,3536
11380,3519102732,3838039092,1672631776,1672632850,1074
11415,3715858201,3812277991,1672639723,1672640330,607
11571,3408982612,3428325402,1672584209,1672585760,1551
9973,3229615214,3512819376,1672577677,1672579537,1860
11477,3713514933,3770630937,1672665617,1672668407,2790
10378,3520362238,3773714494,1672628380,1672631547,3167
10774,3833993674,3853275529,1672656476,1672657617,1141
9861,3534543864,3403035480,1672693982,1672696904,2922
11288,3334708091,3779930476,1672650958,1672651764,806
10540,3519435459,3930727474,1672595421,1672595849,428
10693,3239279744,3736010012,1672588513,1672589105,592
11133,3779468781,3791382196,1672547280,1672549040,1760
10768,3398489033,3716633983,1672548822,1672548898,76
9997,3715320359,3533201269,1672630723,1672630878,155
10940,3334708091,3755922811,1672700927,1672701256,329
10637,3713471446,3472718723,1672634426,1672634515,89
10324,3228033254,3622218289,1672587234,1672587692,458
11482,3487231844,3344478603,1672591600,1672594767,3167
9971,3477951091,3360949039,1672644872,1672645176,304
11155,3715114417,3632189887,1672612181,1672614736,2555
11372,3972442654,3501573548,1672630424,1672633587,3163
9860,3359472956,3519951586,1672603561,1672607069,3508
11628,3711770853,3425545115,1672548660,1672550960,2300
11327,3287753579,3505472087,1672598929,1672602186,3257
10171,3245755569,3510968599,1672650233,1672653525,3292
11597,3430296808,3505117019,1672588994,1672591077,2083
9981,3510153173,3612042508,1672690628,1672691358,730
10335,3515753241,3419762444,1672647960,1672650120,2160
10436,3366433035,3440582836,1672560507,1672562956,2449
11176,3500854711,3520553959,1672545793,1672546200,407
11531,3304447950,3710316008,1672628660,1672631667,3007
10909,3773688906,3773826624,1672554986,1672555746,760
10225,3227206772,3791289855,1672629610,1672630393,783
11284,3500079479,3977337501,1672559654,1672561885,2231
11097,3791088014,3914353062,1672653942,1672654673,731
10269,3974400577,3510694464,1672644031,1672647456,3425
9974,3902023467,3776953418,1672614991,1672615182,191
10540,3732871856,3977157565,1672552934,1672554974,2040
10606,3793902476,3517943697,1672646296,1672649453,3157
10835,3505697295,3311810583,1672685894,1672685958,64
10866,3915679140,3770019143,1672588002,1672589650,1648
10881,3772869013,3239779992,1672643971,1672646824,2853
11228,3793689267,3244098077,1672679658,1672679780,122
10999,3772845364,3442096275,1672627157,1672627722,565
11532,3778702093,3520305100,1672582511,1672586026,3515
11429,3714074120,3735679000,1672615123,1672617569,2446
10138,3918126468,3757089924,1672667808,1672671248,3440
10243,3701865589,3886837151,1672607504,1672607690,186
10648,3856147380,3514628916,1672679489,1672680777,1288
10120,3360949039,3341129425,1672682931,1672684799,1868
11491,3803473387,3497732613,1672617420,1672619893,2473
11757,3501573548,3713195480,1672601547,1672602420,873
10609,3755790149,3825877848,1672633600,1672635231,1631
10257,3501853868,3792277399,1672655161,1672656647,1486
11057,3756897029,3454924050,1672634130,1672636343,2213
11704,3207497598,3500018566,1672545842,1672547762,1920
11589,3757678397,3472173212,1672649533,1672652427,2894
11198,3805926853,3518335611,1672539647,1672542085,2438
10353,3711040761,3235313062,1672647185,1672649824,2639
11053,3201502111,3293673220,1672701395,1672704952,3557
9850,3379666159,3778819352,1672699005,1672701049,2044
10940,3509186338,3411355804,1672572032,1672572756,724
10657,3780213684,3925823748,1672535333,1672538584,3251
10200,3510750299,3716371766,1672671227,1672673176,1949
11586,3335139032,3637522163,1672584620,1672587124,2504
9986,3755192104,3757311529,1672574146,1672576418,2272
11338,3772131127,3311479294,1672560132,1672562292,2160
10619,3827981800,3512750313,1672693173,1672695054,1881
11159,3814672661,3493515706,1672579568,1672582307,2739
10978,3898592058,3352057037,1672650500,1672653090,2590
11643,3447202943,3772114731,1672555337,1672555518,181
10070,3660176760,3294821709,1672590790,1672593356,2566
11244,3701350519,3890211161,1672647919,1672651399,3480
11519,3783277159,3804779247,1672532843,1672534505,1662
11465,3668154066,3793497672,1672534942,1672536298,1356
10749,3534068874,3703206956,1672654101,1672654654,553
10036,3716463756,3935444008,1672604438,1672604809,371
10265,3770480149,3461630842,1672533117,1672535640,2523
10844,3703659324,3501711464,1672594760,1672597118,2358
11578,3501004005,3520165730,1672660542,1672663618,3076
11096,3608973523,3391854325,1672581612,1672584912,3300
11121,3780964089,3338465050,1672637336,1672638498,1162
10757,3445077330,3893932944,1672577465,1672579412,1947
11601,3427049290,3308744016,1672582199,1672583812,1613
11342,3934991640,3372596013,1672691775,1672692488,713
11570,3970265139,3894495222,1672569282,1672571596,2314
10332,3890211161,3509651954,1672553995,1672554605,610
10109,3480418192,3304661369,1672539534,1672540751,1217
10024,3509828883,3777931341,1672575656,1672576486,830
10494,3633860380,3423800775,1672594792,1672598183,3391
11433,3497562878,3928508375,1672626209,1672628798,2589
10135,3973138649,3244397548,1672612427,1672612535,108
11113,3760390822,3505234868,1672628436,1672629583,1147
11477,3783021859,3755361692,1672673649,1672673709,60
11290,3780921044,3713224038,1672697284,1672700524,3240
10017,3778605154,3603740088,1672593753,1672594363,610
10529,3714294005,3883640454,1672693057,1672694008,951
10121,3291936679,3774939922,1672677437,1672681027,3590
11744,3703419800,3509701363,1672640660,1672641486,826
10426,3715897627,3757584114,1672553178,1672556339,3161
9996,3397527886,3505936495,1672697492,1672698718,1226
10012,3776455762,3301489209,1672534049,1672534711,662
10693,3818236682,3292050211,1672567038,1672568461,1423
10767,3756157377,3484490325,1672694363,1672697042,2679
10508,3668720465,3228997424,1672701378,1672701900,522
11033,3791974273,3296970170,1672690265,1672692466,2201
10209,3294949958,3711613085,1672608696,1672609840,1144
11482,3638035545,3230250213,1672671660,1672672730,1070
10230,3378747834,3533859712,1672592695,1672593802,1107
11362,3687445224,3791269060,1672660751,1672664345,3594
11693,3780733404,3555954355,1672613980,1672614998,1018
10367,3804707712,3511729562,1672696434,1672699189,2755
10784,3825234433,3511608609,1672590050,1672590880,830
10506,3780956975,3972653129,1672535983,1672539035,3052
10729,3701779683,3361865467,1672671734,1672675030,3296
10808,3913847876,3354405535,1672552266,1672553238,972
10012,3514611187,3511640720,1672574861,1672575719,858
9866,3772489471,3780013266,1672684867,1672686618,1751
10222,3505684690,3800434325,1672639868,1672640824,956
10789,3444680955,3920526713,1672668059,1672670111,2052
10114,3664523809,3606688595,1672623648,1672627046,3398
11148,3437023385,3812277991,1672687234,1672688167,933
10208,3500019810,3701770921,1672649428,1672650189,761
9899,3393955069,3235074007,1672613297,1672613445,148
10912,3855629383,3509503263,1672597258,1672599628,2370
11167,3516463579,3888642876,1672568224,1672570471,2247
10838,3388463477,3703168159,1672570028,1672571137,1109
10620,3201419050,3805268739,1672659793,1672660280,487
10240,3713805968,3687024828,1672629983,1672632914,2931
10416,3517766135,3231859576,1672598628,1672599197,569
10184,3495427619,3342426430,1672661823,1672662997,1174
10307,3715114417,3716841469,1672550010,1672550542,532
10148,3509544691,3307216611,1672565429,1672568054,2625
11716,3894328297,3306037126,1672620544,1672622869,2325
11176,3505248368,3453519360,1672627281,1672628204,923
10571,3314363575,3411626917,1672673388,1672673886,498
10379,3273758330,3770630937,1672642640,1672643207,567
10182,3824135033,3387706541,1672542898,1672545458,2560
10122,3715039960,3783122313,1672537476,1672538424,948
10195,3513140146,3359880163,1672555284,1672555570,286
10156,3312800145,3520339198,1672576503,1672578907,2404
10447,3318590083,3780941637,1672620856,1672621234,378
9850,3466655775,3888409038,1672630036,1672633313,3277
10498,3512417724,3319529422,1672549304,1672550908,1604
10804,3505032773,3760396348,1672555098,1672556569,1471
10999,3882580580,3512794667,1672574858,1672577537,2679
10888,3662794240,3277061226,1672617298,1672619579,2281
9929,3619676231,3773041843,1672673087,1672676299,3212
10536,3780352400,3773840321,1672599193,1672602275,3082
10803,3830291558,3710585241,1672642641,1672643704,1063
9841,3605078841,3501205057,1672649835,1672651895,2060
10187,3710149975,3417431173,1672647213,1672649176,1963
11258,3735838864,3774296721,1672603686,1672606057,2371
10920,3510882475,3295787354,1672692712,1672696109,3397
10723,3311602936,3713336088,1672631507,1672632060,553
10525,3772234939,3491104534,1672611847,1672613897,2050
10911,3533325993,3793978936,1672616429,1672617190,761
11408,3348100657,3716526314,1672655143,1672657376,2233
10418,3510795808,3231227362,1672664301,1672665134,833
11271,3920890008,3755849241,1672562246,1672564341,2095
11266,3518995270,3500543341,1672683794,1672684709,915
10161,3479402555,3715858201,1672549021,1672550540,1519
10890,3516359146,3897186782,1672581258,1672582965,1707
11241,3362385373,3475033290,1672562087,1672562366,279
11028,3757523596,3468201976,1672691528,1672694954,3426
11753,3916924978,3317190427,1672576272,1672576831,559
11568,3776593726,3882905311,1672568229,1672571341,3112
9906,3449020351,3792633495,1672585012,1672586246,1234
11213,3772877723,3520339198,1672569791,1672571070,1279
10126,3716460706,3459951739,1672567412,1672568300,888
11541,3736621212,3793874490,1672538971,1672541556,2585
11062,3715008501,3426468199,1672586453,1672588110,1657
10763,3512794667,3776581518,1672558185,1672561705,3520
11233,3512641538,3319585148,1672568456,1672571524,3068
11098,3776561263,3791994414,1672583885,1672585752,1867
10403,3715419141,3513890046,1672609909,1672612481,2572
9866,3294821709,3829358750,1672645605,1672646410,805
10054,3501137133,3757393413,1672595574,1672598342,2768
10979,3514498259,3838119022,1672638684,1672638964,280
10759,3291936679,3977360666,1672602180,1672602455,275
11629,3756616853,3772227820,1672598118,1672599631,1513
10091,3501550490,3505121295,1672618466,1672619777,1311
10839,3936486724,3932955949,1672703740,1672704715,975
11604,3812516461,3756642173,1672661798,1672662520,722
11390,3274739459,3737946004,1672591302,1672593323,2021
10337,3500093945,3511311554,1672559188,1672561123,1935
10421,3853188285,3783947742,1672563189,1672563804,615
10802,3730115019,3239779992,1672682688,1672682894,206
10164,3297684667,3509626590,1672648655,1672651572,2917
10272,3716178116,3368176107,1672599953,1672600062,109
11016,3736941123,3551833298,1672551867,1672553577,1710
11704,3792012147,3480108752,1672671852,1672672225,373
10541,3241682278,3512343029,1672581194,1672583791,2597
11188,3793442891,3760069457,1672608445,1672610364,1919
11153,3774673193,3315094386,1672552506,1672555686,3180
10838,3461630842,3711349327,1672543795,1672545353,1558
10722,3370245766,3713969196,1672633258,1672633696,438
11132,3398021818,3454343398,1672597626,1672599363,1737
11614,3821082558,3413799143,1672660842,1672662007,1165
10874,3855674398,3776440009,1672534949,1672536620,1671
10370,3793274846,3500589560,1672579199,1672582797,3598
11107,3430399931,3783157469,1672537476,1672539655,2179
10318,3450164574,3776316903,1672645540,1672648075,2535
10537,3756493561,3274341934,1672635236,1672638706,3470
10449,3500049870,3301765144,1672611844,1672614253,2409
10445,3513739060,3406390503,1672662754,1672665163,2409
11329,3909822999,3933106901,1672585323,1672588108,2785
11363,3510373076,3776125503,1672580343,1672581075,732
11611,3711671702,3770709417,1672620465,1672621786,1321
10588,3513563152,3929355087,1672542058,1672543296,1238
11486,3935569749,3833520635,1672699222,1672700042,820
10473,3760854788,3533976217,1672677615,1672680614,2999
11506,3516819320,3716633983,1672537529,1672540904,3375
10778,3514776568,3777060250,1672610668,1672613846,3178
11347,3337675386,3760024021,1672557632,1672558473,841
10192,3772055279,3280208630,1672559193,1672560379,1186
10211,3836586875,3757001552,1672639953,1672641075,1122
11044,3511615015,3505502819,1672690151,1672691973,1822
9911,3501356814,3517083465,1672532062,1672534003,1941
10755,3770574826,3500863429,1672539460,1672542309,2849
11395,3510869438,3977615973,1672672246,1672675478,3232
10367,3509626590,3557528150,1672643912,1672645149,1237
11302,3388481990,3336225953,1672669215,1672672040,2825
10748,3825795004,3285515107,1672703846,1672707179,3333
10060,3290060215,3701769970,1672619232,1672620341,1109
11682,3420881591,3774598935,1672657260,1672659069,1809
10183,3757523596,3520553959,1672568202,1672568419,217
9909,3715737742,3500863429,1672618599,1672619785,1186
10407,3835982340,3296970170,1672609364,1672612465,3101
10704,3445077330,3497732613,1672629784,1672629926,142
10741,3243056734,3439651226,1672540074,1672540983,909
10318,3400545490,3358385652,1672612019,1672613849,1830
11460,3510189563,3899156705,1672595096,1672597306,2210
11655,3516444589,3311045951,1672553264,1672555894,2630
11012,3385006834,3701978422,1672693904,1672694431,527
10562,3757523596,3716541851,1672568988,1672571725,2737
11745,3913746581,3519000878,1672591144,1672592530,1386
10028,3501557463,3512546783,1672642837,1672644562,1725
9925,3400560073,3505845400,1672577976,1672579088,1112
10713,3459694275,3287689454,1672634910,1672637732,2822
11037,3716633983,3906075386,1672696928,1672699486,2558
11347,3902357342,3711404205,1672625610,1672625721,111
11783,3639503148,3360949039,1672586742,1672589706,2964
10253,3520515739,3826418889,1672686015,1672686899,884
10283,3816184951,3444453261,1672577545,1672580253,2708
10335,3513092056,3817029483,1672585863,1672586016,153
11629,3505291330,3714903253,1672574384,1672575405,1021
10589,3444881567,3757050615,1672648138,1672649955,1817
11346,3373802545,3398489033,1672625153,1672626267,1114
10154,3516572212,3609166109,1672679079,1672680078,999
11406,3517558635,3500931474,1672598149,1672601467,3318
10292,3623953446,3519997661,1672662669,1672665210,2541
10665,3773394570,3293673220,1672695903,1672699426,3523
10519,3609997804,3412605548,1672668536,1672671089,2553
10026,3425545115,3510916875,1672627994,1672628197,203
9996,3739075176,3393376416,1672689633,1672690199,566
11319,3234445133,3710397477,1672687485,1672688978,1493
10550,3770391782,3242149533,1672580884,1672582813,1929
10473,3423782420,3623512088,1672599018,1672601428,2410
11426,3300810210,3340897079,1672684574,1672686868,2294
10882,3238310644,3435801763,1672661357,1672661624,267
10097,3776309810,3500120676,1672623952,1672625955,2003
10627,3791532324,3311188620,1672603943,1672604035,92
9974,3311626308,3375257546,1672660731,1672661406,675
10658,3772845364,3689420679,1672618620,1672618860,240
10300,3246395239,3770105006,1672568267,1672569299,1032
9921,3777706200,3812516461,1672571944,1672574968,3024
10021,3447202943,3927675706,1672611424,1672612629,1205
11223,3305093237,3388774559,1672593939,1672595867,1928
10645,3603452936,3423217578,1672604966,1672608555,3589
10244,3443191792,3514244308,1672533258,1672535312,2054
10407,3501004005,3780466967,1672569181,1672572038,2857
11011,3776125503,3305657559,1672559071,1672559323,252
11315,3501980730,3461931154,1672667384,1672668524,1140
11308,3274341934,3519937708,1672621039,1672622294,1255
10340,3514980025,3419829238,1672622303,1672624636,2333
9974,3756890980,3501205057,1672628622,1672629573,951
10402,3407403080,3755411110,1672550221,1672551440,1219
10638,3905358065,3780129338,1672566966,1672568750,1784
10967,3837378340,3703031637,1672586248,1672586634,386
9894,3390368796,3714838100,1672687225,1672687850,625
10450,3666561358,3534578428,1672674994,1672676724,1730
11083,3791509334,3710228292,1672660100,1672661849,1749
10652,3294949958,3387322545,1672600833,1672602245,1412
11291,3474350534,3342252701,1672682694,1672683126,432
11041,3471585513,3757407184,1672688442,1672690809,2367
11208,3792432094,3208560443,1672688159,1672690817,2658
11099,3513624915,3511883778,1672571903,1672572958,1055
10477,3440991826,3832745283,1672643873,1672645977,2104
11712,3756668747,3839744168,1672585058,1672588320,3262
9812,3773556853,3634670780,1672697846,1672698738,892
10727,3466620548,3515970536,1672543667,1672546293,2626
10999,3515607283,3204821370,1672550404,1672553243,2839
10109,3311569360,3905934770,1672606288,1672609276,2988
11059,3385006834,3938409715,1672576836,1672578183,1347
10089,3505007498,3800434325,1672615793,1672618109,2316
10346,3469370398,3817120976,1672682136,1672685288,3152
10403,3513293711,3756367938,1672677871,1672678786,915
11470,3791088014,3776617627,1672649446,1672649701,255
11169,3715490209,3533703578,1672651909,1672653081,1172
10275,3909457959,3227059650,1672597222,1672599517,2295
9920,3461931154,3713606829,1672543689,1672544669,980
11260,3296970170,3505828210,1672692474,1672694760,2286
10136,3311037445,3662495290,1672622343,1672623696,1353
9850,3839308659,3917905192,1672614528,1672615099,571
10495,3534174363,3517149023,1672547854,1672549093,1239
11162,3509431396,3778124514,1672667038,1672667150,112
10072,3511883778,3514698862,1672663780,1672665167,1387
10374,3815184540,3773202954,1672549553,1672550543,990
11325,3780224882,3776068937,1672545295,1672547328,2033
10081,3486509752,3500726347,1672659277,1672659369,92
11135,3630802959,3516378356,1672551247,1672552483,1236
10235,3533566754,3501759031,1672647956,1672648792,836
10367,3888642876,3411213032,1672584605,1672588165,3560
10530,3757378286,3908464960,1672639483,1672639606,123
10317,3922301238,3757584114,1672675197,1672677472,2275
10554,3551972633,3885545415,1672689949,1672692815,2866
10872,3716633983,3436774112,1672606117,1672607092,975
11643,3734233216,3288920399,1672577811,1672578433,622
10037,3714142299,3600441934,1672647709,1672647962,253
10690,3344478603,3518368900,1672540184,1672543383,3199
10362,3701291994,3500595432,1672602803,1672604395,1592
11489,3774236212,3935256825,1672581304,1672582795,1491
10649,3533867833,3533427742,1672693361,1672696508,3147
11543,3757128722,3780921044,1672619369,1672620512,1143
10863,3294326116,3714471069,1672598699,1672600471,1772
10732,3783879023,3811354125,1672609640,1672611348,1708
10732,3311602936,3512133625,1672671907,1672672930,1023
11437,3669140241,3773853619,1672552179,1672555662,3483
11284,3895422995,3505496725,1672632407,1672633587,1180
11103,3439662051,3888642876,1672660968,1672662483,1515
11260,3236948071,3511663572,1672672162,1672674950,2788
11256,3511458926,3710228292,1672613872,1672615579,1707
10504,3500211484,3495446254,1672641873,1672643822,1949
10838,3311739926,3311810583,1672625804,1672628728,2924
10497,3339331632,3425646356,1672558941,1672561253,2312
11773,3516034245,3312651192,1672685614,1672685743,129
11553,3711599043,3776778306,1672679799,1672683135,3336
9999,3342031426,3779604279,1672702667,1672706050,3383
10168,3285515107,3773432494,1672628351,1672629678,1327
10956,3347520239,3382757142,1672547727,1672551156,3429
10272,3773134128,3318250647,1672609203,1672610552,1349
9854,3501734800,3406169279,1672560996,1672561373,377
10555,3362368123,3480405740,1672571809,1672575392,3583
11035,3379076106,3774606418,1672642896,1672645094,2198
9998,3838039092,3783043770,1672666388,1672669704,3316
11084,3307454562,3756113624,1672667055,1672669062,2007
11017,3929355087,3778604070,1672650036,1672652145,2109
11701,3511963020,3505416534,1672659670,1672660763,1093
11250,3501356814,3791269060,1672586919,1672587900,981
10795,3703999217,3682906048,1672672784,1672675791,3007
11404,3444295435,3515597467,1672586099,1672588126,2027
10100,3791359168,3427741923,1672695569,1672698330,2761
10323,3533017131,3514353133,1672559048,1672559510,462
10265,3239990061,3836586875,1672658812,1672660641,1829
10763,3227874229,3332010532,1672576109,1672579142,3033
10786,3760776967,3512133625,1672677205,1672680471,3266
11580,3406238754,3918126468,1672574042,1672577314,3272
11674,3505183641,3664523809,1672666840,1672669827,2987
10805,3773688906,3710919244,1672640224,1672642959,2735
11612,3377250778,3892177203,1672676135,1672677235,1100
11660,3977615973,3770972037,1672690504,1672690671,167
10674,3512546783,3914353062,1672659554,1672663079,3525
9826,3760541837,3368951504,1672557020,1672559707,2687
11745,3757660578,3772968080,1672632833,1672633891,1058
11715,3459163055,3374147279,1672546627,1672547508,881
11649,3756367938,3791351852,1672557491,1672559188,1697
11728,3500922040,3433196933,1672597256,1672597650,394
9953,3519228207,3711770773,1672686798,1672688533,1735
10080,3779975575,3600978954,1672678486,1672678656,170
10093,3520305100,3667950469,1672626202,1672626855,653
10623,3885422379,3636877469,1672698131,1672698656,525
11597,3516463579,3890638402,1672532449,1672535382,2933
10473,3897003751,3701725839,1672607886,1672609410,1524
11063,3791825536,3934980229,1672620069,1672621300,1231
11320,3783238023,3516429380,1672566890,1672567184,294
11636,3773434690,3517992521,1672555308,1672558558,3250
10623,3509677530,3714806574,1672650015,1672653300,3285
10495,3701459978,3206853747,1672670404,1672673848,3444
10822,3470135167,3510301454,1672598980,1672599699,719
11426,3894495222,3434452046,1672688292,1672689478,1186
10054,3514329209,3605905645,1672629704,1672632070,2366
9985,3711755596,3779503296,1672674099,1672676419,2320
11135,3774921252,3407403080,1672672918,1672673157,239
11448,3368079099,3419789418,1672674687,1672677974,3287
11553,3638018906,3924963918,1672592373,1672595642,3269
9851,3475033290,3511645260,1672550162,1672551159,997
11016,3628423403,3511500932,1672701588,1672702754,1166
10287,3425260097,3515096959,1672682750,1672684859,2109
11095,3476431618,3386323728,1672689753,1672691142,1389
10233,3403738461,3632303304,1672596639,1672597957,1318
11476,3519000878,3201634072,1672617978,1672620025,2047
10117,3236948071,3513213122,1672627242,1672630074,2832
9804,3777932225,3929002318,1672684750,1672687262,2512
11035,3436401020,3406101720,1672642256,1672645077,2821
11309,3760271237,3239990061,1672647048,1672649914,2866
10184,3888057649,3317887374,1672601997,1672603336,1339
9949,3360309868,3793569914,1672546086,1672546605,519
9928,3703572036,3714424237,1672591225,1672592028,803
11493,3336225953,3773424266,1672610639,1672611248,609
11332,3515655024,3776316903,1672594233,1672596534,2301
11457,3551972633,3283847934,1672532402,1672534443,2041
11173,3557528150,3755119166,1672658089,1672660572,2483
9839,3406390503,3664478769,1672563381,1672566218,2837
11582,3777060250,3888523259,1672540791,1672542740,1949
11562,3476958001,3362706073,1672553444,1672554816,1372
10726,3398075553,3977157565,1672658517,1672659548,1031
10210,3499622352,3635599307,1672647080,1672647958,878
10541,3235578852,3202787155,1672648083,1672648391,308
11021,3739217535,3711755596,1672586475,1672587041,566
10969,3688845298,3777564559,1672612167,1672613408,1241
9839,3223177147,3241855333,1672673308,1672676826,3518
11594,3711214982,3274239253,1672681760,1672682732,972
10577,3514450836,3850735936,1672547168,1672549571,2403
11644,3793081195,3500442370,1672564540,1672568063,3523
11264,3512087090,3972729768,1672607272,1672607369,97
10981,3513629502,3755767856,1672544632,1672547444,2812
10729,3888057649,3520182275,1672625787,1672627063,1276
10713,3517632796,3701956841,1672617671,1672618834,1163
10901,3760710525,3829761380,1672651006,1672652664,1658
9923,3513215373,3512343029,1672551239,1672552435,1196
11707,3518511124,3661543201,1672676892,1672680043,3151
10968,3935444008,3501171785,1672624477,1672625836,1359
10428,3756784813,3772556646,1672696436,1672698898,2462
11095,3972729768,3922430928,1672588948,1672590669,1721
10714,3888642876,3923524564,1672676113,1672676332,219
9989,3884180202,3509828883,1672555652,1672557238,1586
10352,3792719263,3714116241,1672693273,1672695475,2202
11063,3517325365,3793274957,1672611002,1672613173,2171
11133,3755129708,3909399636,1672618411,1672621789,3378
11182,3605101443,3518408734,1672573957,1672574775,818
10621,3317887374,3974668678,1672537036,1672539007,1971
10659,3716801088,3733796228,1672685141,1672687266,2125
11493,3668202976,3776901443,1672595212,1672596757,1545
11572,3777751979,3734957248,1672682852,1672683148,296
11471,3835509670,3730348493,1672666838,1672668019,1181
10452,3824259677,3776200012,1672535118,1672536432,1314
11594,3511750695,3500994763,1672627659,1672628284,625
10515,3488399075,3778986795,1672596973,1672599644,2671
10675,3903879740,3481700413,1672593590,1672596390,2800
10962,3773738817,3630802959,1672546108,1672548534,2426
10262,3714690161,3513859809,1672541920,1672544790,2870
9922,3711187791,3203630241,1672613642,1672616193,2551
10962,3442096275,3487231844,1672543848,1672544710,862
10019,3505331083,3318590083,1672532256,1672535519,3263
10990,3792785261,3757944870,1672541337,1672542298,961
11507,3467663782,3756437169,1672602775,1672605889,3114
11485,3714142299,3293673220,1672535824,1672539059,3235
11489,3552261072,3371132167,1672607386,1672609675,2289
10811,3780749789,3513800589,1672623381,1672626362,2981
10165,3354968884,3792255406,1672649643,1672650646,1003
10358,3406390503,3776710698,1672598238,1672599087,849
11113,3228465044,3489340327,1672597478,1672597811,333
10789,3517551721,3701512498,1672692308,1672692571,263
10263,3374552204,3817120976,1672609704,1672609874,170
10399,3738760498,3780941637,1672681805,1672685112,3307
11675,3756781024,3711810752,1672594489,1672596614,2125
10175,3209958726,3760107540,1672588864,1672589240,376
10040,3395565040,3307791650,1672605192,1672608777,3585
11789,3701519251,3275975921,1672564551,1672568068,3517
11301,3505665253,3307236682,1672582891,1672586325,3434
11261,3439045964,3812261241,1672556485,1672557788,1303
11361,3703818358,3290060215,1672696364,1672698445,2081
10986,3713100169,3379666159,1672674548,1672674758,210
10314,3390438262,3520145112,1672690599,1672691901,1302
11256,3912811715,3553694590,1672545908,1672547123,1215
10946,3791698084,3776600696,1672647222,1672650397,3175
10320,3226037966,3480185839,1672540044,1672540920,876
9917,3511794841,3834980281,1672535992,1672536508,516
11709,3737946004,3716178116,1672682201,1672684089,1888
9798,3897186782,3914740937,1672692430,1672693367,937
11126,3615846003,3710008760,1672599657,1672600864,1207
10247,3319645922,3515558215,1672701087,1672703330,2243
9828,3908177413,3515715968,1672703911,1672706608,2697
11617,3792475476,3857590978,1672594103,1672597437,3334
11110,3757198930,3418997135,1672596007,1672598308,2301
11052,3896840409,3533030343,1672664918,1672665226,308
10533,3773424266,3519553933,1672545052,1672546616,1564
11677,3779382417,3500438542,1672545253,1672548592,3339
11027,3519357822,3902548260,1672666279,1672669749,3470
10655,3611533094,3818324410,1672693861,1672695680,1819
9843,3445172440,3302929858,1672687467,1672688216,749
10468,3603740088,3793902476,1672612903,1672615769,2866
10782,3792682835,3304227085,1672562811,1672563950,1139
10135,3501027795,3513508737,1672699506,1672701424,1918
11022,3514515499,3774145748,1672554335,1672557931,3596
10756,3409098014,3512087090,1672535132,1672538084,2952
10912,3893527651,3509317054,1672685778,1672687021,1243
10222,3792851584,3779255367,1672675530,1672677778,2248
11361,3714688409,3380185102,1672604249,1672606833,2584
11106,3512726649,3713927376,1672620268,1672623565,3297
11289,3779505358,3756647451,1672618567,1672618844,277
9846,3854229296,3479910993,1672697410,1672700848,3438
10073,3791587717,3352295704,1672535001,1672537011,2010
10568,3777200549,3772235668,1672589264,1672591039,1775
11613,3470997293,3501192566,1672592010,1672593707,1697
11027,3494560663,3445172440,1672699721,1672701237,1516
10564,3681701931,3916656185,1672616924,1672617850,926
10543,3480259863,3509614126,1672677566,1672679014,1448
9849,3517991042,3713606829,1672624691,1672626996,2305
10136,3519724388,3780612543,1672690611,1672692878,2267
10851,3919994216,3533440294,1672693557,1672694968,1411
10393,3902300755,3756428507,1672651311,1672654354,3043
10292,3894756677,3515699732,1672652029,1672652494,465
9902,3931767736,3501261089,1672563398,1672565333,1935
10409,3362368123,3439532406,1672592880,1672596125,3245
11340,3713740434,3776867553,1672676544,1672678180,1636
10690,3229615214,3409078869,1672637694,1672638789,1095
10260,3357097510,3760232135,1672568269,1672569131,862
11770,3397330170,3439662051,1672623236,1672623510,274
10409,3248061684,3618672178,1672626686,1672627278,592
10338,3510836047,3836586875,1672666860,1672666943,83
9829,3810584695,3510894809,1672644661,1672648158,3497
11630,3776183353,3711889178,1672559818,1672561550,1732
10847,3760232135,3362385373,1672698871,1672702419,3548
10622,3856975355,3739618347,1672556390,1672559373,2983
10697,3809207482,3304252969,1672585682,1672586931,1249
11157,3509252934,3362127525,1672602508,1672604023,1515
10108,3417360319,3760096466,1672609555,1672610539,984
10844,3311989687,3487622510,1672647464,1672647804,340
9834,3382696725,3533113740,1672574212,1672577069,2857
10770,3660257653,3512492332,1672564250,1672567258,3008
11118,3713102459,3500931474,1672643599,1672646080,2481
11037,3443102414,3668063289,1672664899,1672667160,2261
10691,3288675710,3493515706,1672606925,1672608808,1883
9966,3511867383,3732312480,1672579903,1672583121,3218
11226,3402338011,3757872458,1672615973,1672618173,2200
11721,3776001441,3395505794,1672619902,1672621054,1152
10762,3435715962,3352374868,1672541250,1672541836,586
11350,3701028092,3372617110,1672695616,1672695887,271
11493,3501208658,3308149799,1672600975,1672603587,2612
10279,3534174363,3793926338,1672608513,1672609380,867
10189,3286862903,3793874490,1672534809,1672535789,980
11089,3291446384,3514673213,1672647912,1672649145,1233
9993,3780050146,3780423516,1672640622,1672641533,911
11643,3500854711,3281935691,1672557746,1672560934,3188
10363,3274341934,3772169046,1672665075,1672666286,1211
10871,3421040626,3435652260,1672555275,1672556175,900
10990,3756367938,3517331746,1672693320,1672694268,948
11491,3340723781,3510439480,1672593875,1672596806,2931
10636,3976742903,3776182849,1672531888,1672532996,1108
10330,3511650296,3716609198,1672625808,1672626516,708
10093,3974400577,3859191694,1672564236,1672567079,2843
10619,3510750299,3512477276,1672626046,1672628169,2123
10620,3710260848,3435159896,1672681862,1672684071,2209
11624,3510209505,3516517348,1672536718,1672539779,3061
11313,3517210356,3279726491,1672664978,1672667982,3004
10804,3774663639,3332840671,1672686953,1672690032,3079
9826,3791548838,3416225867,1672672271,1672673008,737
10480,3710919244,3637522163,1672677206,1672678440,1234
10413,3730115019,3471996194,1672632337,1672634255,1918
10385,3509274030,3772708314,1672638049,1672640964,2915
10516,3893043842,3520012007,1672634584,1672637133,2549
10400,3511364193,3520473111,1672657969,1672659503,1534
10035,3555954355,3662794240,1672558345,1672558670,325
11323,3791368349,3288346356,1672663565,1672664789,1224
10117,3923910914,3516257130,1672624960,1672625925,965
10249,3495152069,3737050849,1672672027,1672673015,988
11539,3791542842,3716020849,1672627611,1672628482,871
10736,3714287902,3517530943,1672588786,1672590562,1776
10275,3518368900,3500011591,1672694661,1672697889,3228
11033,3505816624,3443191792,1672569448,1672569726,278
9957,3776249160,3777552831,1672580766,1672582677,1911
10586,3380418745,3793569914,1672703881,1672704403,522
10394,3242082716,3515753241,1672605592,1672607191,1599
10462,3792173463,3513293711,1672555101,1672557117,2016
11296,3793364952,3516904926,1672610576,1672612689,2113
10504,3636885498,3680832669,1672655581,1672659157,3576
10952,3471555057,3856147380,1672553399,1672554965,1566
10842,3770981604,3517021928,1672701005,1672703576,2571
10774,3206544535,3516969689,1672651815,1672653204,1389
9801,3452175941,3288675710,1672681806,1672682482,676
11386,3533009565,3342495377,1672608243,1672610592,2349
9839,3733423371,3437108337,1672612913,1672615523,2610
11158,3774238066,3780129338,1672610349,1672612750,2401
10640,3701779683,3834456158,1672637082,1672639822,2740
11567,3732312480,3417969824,1672581718,1672583016,1298
11548,3770408300,3500062408,1672694636,1672695372,736
10217,3519494023,3495152069,1672685260,1672686528,1268
11206,3358262975,3517551721,1672616028,1672616273,245
10615,3501370430,3713694278,1672556391,1672556735,344
10895,3302988745,3496407500,1672683514,1672684538,1024
10513,3783067048,3683677062,1672566668,1672569204,2536
10524,3287689454,3500415589,1672657204,1672659376,2172
10857,3703443664,3500695402,1672665332,1672666711,1379
10516,3243305367,3406169279,1672657234,1672660533,3299
10901,3931164237,3388830370,1672657618,1672660992,3374
11411,3772262649,3757944870,1672570613,1672571727,1114
10163,3716160006,3757869138,1672666184,1672666507,323
10790,3837885956,3441944896,1672697689,1672700569,2880
11706,3403395712,3468066881,1672664800,1672665609,809
11779,3533627473,3206262649,1672663367,1672665855,2488
10417,3290097447,3739820448,1672651912,1672655210,3298
10472,3514673213,3919342147,1672575180,1672577675,2495
10502,3710585241,3501174621,1672618211,1672621740,3529
9929,3367262509,3272827860,1672645527,1672645994,467
11084,3406029706,3469370398,1672684517,1672685769,1252
11473,3793948300,3511286390,1672650182,1672651647,1465
10959,3770595035,3559125467,1672667547,1672668279,732
10397,3398483531,3500062408,1672533647,1672537022,3375
9993,3739844610,3713219299,1672614781,1672617403,2622
10851,3341738186,3772216305,1672684055,1672687229,3174
10219,3505066871,3733423371,1672642540,1672644631,2091
10494,3792797648,3716233100,1672670039,1672671602,1563
11627,3285587972,3777878462,1672697245,1672700188,2943
11151,3534578428,3851810349,1672577050,1672578973,1923
11516,3738526914,3417431173,1672591008,1672591235,227
10531,3615447269,3500405175,1672656431,1672659867,3436
9866,3520779124,3780127017,1672583258,1672584497,1239
10624,3777552831,3514508773,1672599828,1672603298,3470
11542,3442403264,3367202274,1672561963,1672562198,235
10959,3711219767,3205908584,1672591140,1672594291,3151
10794,3713031958,3898592058,1672592893,1672594484,1591
11348,3716233100,3903115138,1672620944,1672621502,558
9936,3505624416,3603452936,1672641071,1672642999,1928
10312,3447948483,3372617110,1672571100,1672572555,1455
11659,3433196933,3300238532,1672665698,1672667701,2003
11026,3609644043,3311514075,1672552597,1672553069,472
10264,3858497718,3666367524,1672617177,1672619409,2232
9993,3970775805,3780050146,1672531600,1672534071,2471
10921,3715441777,3513293711,1672602178,1672603317,1139
10184,3905889514,3373018943,1672563567,1672565509,1942
11151,3783826338,3516020922,1672613180,1672614134,954
10980,3304235700,3233965781,1672703927,1672707504,3577
11045,3660980656,3276209319,1672551243,1672551460,217
10949,3534362749,3501244753,1672560031,1672560532,501
10832,3688845298,3793822639,1672582038,1672583141,1103
10576,3500221079,3714287902,1672532329,1672533733,1404
10540,3773534165,3305093237,1672627368,1672629717,2349
10814,3449233346,3509297453,1672638701,1672642286,3585
10968,3818461836,3776534957,1672610410,1672613090,2680
11515,3510439480,3487395357,1672601114,1672601438,324
10269,3505032644,3830291558,1672626985,1672627961,976
9819,3246381831,3777552831,1672659319,1672660528,1209
11518,3791245127,3600978954,1672652719,1672654925,2206
11288,3452982957,3755630085,1672597615,1672598743,1128
11512,3519167605,3779815753,1672678327,1672680793,2466
10358,3245501577,3612042508,1672695221,1672696038,817
10002,3358262975,3793081195,1672584610,1672585346,736
11328,3906874577,3774326754,1672668618,1672669770,1152
10297,3299587876,3780900318,1672703276,1672703530,254
10165,3808849597,3884388188,1672586609,1672588275,1666
10030,3732090606,3516167000,1672569702,1672570988,1286
10405,3713283029,3711040761,1672664368,1672664523,155
10628,3755865626,3776968640,1672601691,1672602023,332
11773,3301489209,3756536512,1672581377,1672583845,2468
10597,3288791629,3306475287,1672536307,1672539629,3322
11714,3368441333,3914947393,1672632650,1672634337,1687
10208,3780173788,3922430928,1672697008,1672698899,1891
10885,3804095239,3316117186,1672692017,1672693672,1655
11648,3404375908,3812756400,1672640106,1672642557,2451
10634,3393955069,3510244209,1672543002,1672545281,2279
11004,3201573194,3479207976,1672536965,1672537206,241
10797,3510864325,3703659324,1672612815,1672614705,1890
11106,3534589501,3485898181,1672609624,1672611228,1604
11348,3783086267,3701512498,1672595653,1672597746,2093
9861,3780213684,3852161626,1672551777,1672551988,211
11756,3553694590,3509503263,1672590388,1672590683,295
11241,3311521176,3899903158,1672583486,1672583629,143
11716,3618672178,3834456158,1672605179,1672607243,2064
11700,3757513651,3465690527,1672623764,1672624275,511
11409,3791906680,3512417724,1672559855,1672560001,146
11779,3420854927,3615245840,1672548185,1672549188,1003
10664,3810584695,3533325993,1672627877,1672628224,347
10278,3367121615,3235313062,1672572561,1672575091,2530
10046,3636857871,3533325993,1672608981,1672610810,1829
11003,3249614888,3839744168,1672695699,1672697876,2177
11095,3286938590,3305657559,1672552729,1672554380,1651
11408,3201573194,3509828883,1672675571,1672678256,2685
10684,3533017131,3515230715,1672691751,1672692928,1177
11664,3430823498,3777499535,1672660614,1672662361,1747
10653,3932955949,3520553959,1672560362,1672562692,2330
10174,3416225867,3760854788,1672592678,1672596216,3538
11265,3500674240,3485898181,1672611155,1672611844,689
10990,3387413950,3501171785,1672571004,1672571076,72
11728,3825932442,3517552930,1672611250,1672612410,1160
11308,3301403047,3289771213,1672695700,1672697280,1580
10910,3319529422,3629248353,1672573022,1672575585,2563
10431,3426207439,3773826624,1672614421,1672615752,1331
11243,3517132086,3669475165,1672592002,1672592631,629
9956,3777729184,3505684690,1672687691,1672688530,839
10036,3208519320,3511296895,1672663863,1672664054,191
9962,3905889514,3316121649,1672659172,1672659312,140
10770,3516588277,3755790149,1672548222,1672549520,1298
11443,3510484107,3757607649,1672578467,1672579563,1096
11716,3779951373,3271762055,1672583302,1672586213,2911
10408,3828354855,3402774497,1672539121,1672541775,2654
10375,3972196462,3802101760,1672532341,1672535078,2737
9849,3756157377,3476144563,1672573459,1672574094,635
9813,3667654673,3760776967,1672661275,1672662990,1715
11327,3505709407,3208560443,1672593227,1672593932,705
11348,3512288503,3472018395,1672649321,1672649760,439
10699,3501253130,3710622746,1672541089,1672544430,3341
10574,3394357241,3973134902,1672558741,1672560115,1374
9863,3505482210,3884862164,1672622988,1672625865,2877
11583,3859191694,3294164983,1672620973,1672622788,1815
11717,3513624915,3918981936,1672598388,1672600771,2383
9825,3505234868,3780048608,1672643397,1672644055,658
10529,3817029483,3511645260,1672613194,1672614002,808
10312,3343698137,3387971464,1672685385,1672686244,859
11773,3776561263,3928421417,1672688862,1672690126,1264
10867,3200785194,3515507526,1672581594,1672583425,1831
11043,3204149913,3931495845,1672689814,1672692377,2563
11609,3703588004,3533728729,1672617227,1672617783,556
10945,3205687719,3701448521,1672627377,1672630674,3297
11753,3364302157,3479452888,1672638906,1672641478,2572
11199,3885339157,3774436159,1672667081,1672670256,3175
11645,3772019557,3517800171,1672573265,1672574651,1386
11528,3779689733,3310021925,1672610104,1672611213,1109
10661,3558203963,3287821258,1672672730,1672672905,175
11035,3373135211,3770486161,1672661314,1672663894,2580
10512,3774029494,3894328297,1672543894,1672545690,1796
11095,3783651407,3714902042,1672630883,1672631588,705
10468,3906075386,3938059867,1672678060,1672678934,874
10741,3473562779,3703443664,1672553688,1672553829,141
11112,3884191432,3757378286,1672685458,1672688060,2602
10560,3824259677,3835982340,1672555531,1672558973,3442
11148,3774822697,3408982612,1672597189,1672599269,2080
10161,3792021895,3533728729,1672681103,1672683459,2356
11660,3780142207,3779818784,1672686736,1672687366,630
10353,3777112124,3639503148,1672691713,1672692562,849
11437,3374552204,3822368676,1672676442,1672677583,1141
9857,3500057674,3791409441,1672677077,1672679273,2196
10598,3703694139,3857344874,1672559619,1672563217,3598
11382,3534624672,3858497718,1672546058,1672546135,77
10958,3402580733,3881785069,1672639014,1672640982,1968
10875,3447938130,3510244209,1672697865,1672700280,2415
10068,3428325402,3533009565,1672551415,1672553796,2381
11274,3510864325,3776166086,1672549146,1672551971,2825
10002,3760537855,3505887814,1672552800,1672553336,536
10299,3497904539,3737467358,1672567422,1672569775,2353
10438,3614112171,3510484107,1672603833,1672607169,3336
10882,3682266017,3916924978,1672544097,1672546395,2298
11180,3519356606,3500455935,1672650258,1672650643,385
11754,3812277991,3778702093,1672545841,1672549146,3305
10217,3805704844,3444680955,1672645842,1672646787,945
11139,3778100960,3701065296,1672662469,1672664218,1749
11446,3770941125,3371184929,1672577436,1672577686,250
10307,3773344258,3510869438,1672534007,1672535326,1319
10926,3509457543,3201920708,1672556074,1672559078,3004
11231,3520471156,3270502801,1672629442,1672630019,577
11357,3811629200,3511907179,1672618094,1672619122,1028
11353,3406937294,3243305367,1672544186,1672544883,697
10765,3500994763,3825526565,1672579675,1672579741,66
10121,3479585868,3488988274,1672687457,1672689931,2474
10082,3856129522,3394959062,1672647379,1672650947,3568
10875,3519494023,3308744016,1672599767,1672601460,1693
10983,3774483862,3238997746,1672602943,1672604945,2002
10476,3291617477,3855222429,1672556850,1672559387,2537
11059,3516706935,3886879696,1672532330,1672533353,1023
10827,3713219299,3355903597,1672660322,1672661776,1454
9897,3791796190,3437286595,1672560458,1672562268,1810
10440,3972729768,3757872458,1672622843,1672625918,3075
10888,3513802404,3715140418,1672556598,1672560039,3441
10952,3499622352,3857590978,1672587527,1672587984,457
9854,3773878451,3500674240,1672654526,1672654931,405
11730,3387388336,3755849241,1672555178,1672556302,1124
10785,3902357342,3501225887,1672680507,1672683254,2747
9819,3756272704,3637522163,1672670976,1672673194,2218
10529,3534758256,3497138014,1672696168,1672698429,2261
10825,3791072829,3821082558,1672541553,1672544603,3050
11249,3244397548,3316537706,1672574168,1672575506,1338
11297,3791236983,3421040626,1672597641,1672598948,1307
10592,3381055770,3419762444,1672694042,1672697618,3576
11186,3701374160,3510547682,1672676247,1672676385,138
11647,3514352989,3807717766,1672535984,1672538147,2163
10896,3207586072,3908862092,1672630900,1672632016,1116
9833,3224040894,3420983899,1672622211,1672622309,98
9802,3510694464,3234445133,1672687293,1672688338,1045
10595,3760537855,3815440588,1672586900,1672590385,3485
11267,3885339157,3499711458,1672613905,1672616372,2467
10989,3388915945,3734233216,1672620209,1672622890,2681
11336,3713434898,3711190257,1672674437,1672675600,1163
10342,3793874490,3703614781,1672657935,1672658183,248
11753,3777932581,3713159131,1672685816,1672688316,2500
11533,3343698137,3510373076,1672673769,1672674171,402
10537,3512638952,3713805968,1672655318,1672656404,1086
10426,3897107253,3760525465,1672684928,1672686689,1761
11380,3228575883,3778182724,1672701736,1672702985,1249
10730,3342056927,3857909328,1672666795,1672667637,842
11669,3500440602,3773848111,1672568464,1672570491,2027
11614,3612705426,3371564186,1672634867,1672637294,2427
9828,3603452936,3387388336,1672565020,1672565120,100
10538,3516819320,3818461836,1672567899,1672570218,2319
11157,3610806770,3622218289,1672538038,1672540143,2105
10978,3738760498,3313282478,1672550916,1672551713,797
11612,3791509881,3278251248,1672644314,1672644938,624
10029,3757584114,3779609338,1672618447,1672619926,1479
11496,3772909073,3304227085,1672589951,1672591837,1886
9828,3511466117,3713195480,1672610597,1672611835,1238
10301,3358530225,3304227085,1672667785,1672670456,2671
11300,3812559393,3501137133,1672666631,1672670202,3571
10464,3225371682,3760554453,1672533807,1672537175,3368
10466,3228033254,3917004141,1672545095,1672545646,551
10628,3366801723,3783176874,1672666154,1672666502,348
11498,3779393140,3509370016,1672700373,1672703867,3494
10528,3208560443,3778932673,1672590217,1672591577,1360
10309,3774326754,3917243005,1672583561,1672584269,708
10388,3500221079,3701779683,1672535034,1672536103,1069
10489,3757501067,3520165730,1672640257,1672640992,735
11375,3687445224,3907923381,1672550384,1672552174,1790
10139,3461137945,3736010012,1672542022,1672544597,2575
9863,3518478484,3501548163,1672574175,1672576788,2613
10059,3660176760,3369270860,1672617195,1672619056,1861
11676,3772055279,3311463998,1672614917,1672617421,2504
11412,3813111107,3520515739,1672533891,1672537005,3114
11091,3481700413,3776583229,1672643181,1672643677,496
11385,3519448648,3685522474,1672573456,1672576519,3063
11127,3223512565,3773041843,1672643823,1672644500,677
11028,3236948071,3715680249,1672648372,1672648437,65
10558,3312800145,3419378107,1672564411,1672565769,1358
10932,3452090950,3826997668,1672533607,1672535530,1923
10217,3857909328,3505449070,1672673599,1672676342,2743
10489,3629248353,3509614126,1672661636,1672661930,294
11072,3783967375,3511218261,1672565564,1672565788,224
10031,3209075485,3686081254,1672681974,1672684582,2608
10454,3394976623,3939882169,1672659128,1672659998,870
9874,3284407073,3439036305,1672585329,1672588884,3555
11009,3885674996,3495482863,1672649855,1672650786,931
10081,3445077330,3932491622,1672564611,1672566671,2060
11676,3515405509,3617771673,1672582765,1672585772,3007
11381,3684108920,3713875941,1672703771,1672704771,1000
11446,3927805949,3711938229,1672643460,1672645510,2050
9916,3393001196,3509433155,1672580916,1672581539,623
11241,3371497614,3907390925,1672680659,1672680978,319
10664,3500209015,3516034245,1672680417,1672683951,3534
10875,3241682278,3505278562,1672636043,1672639340,3297
10218,3359351267,3894495222,1672644451,1672647535,3084
11572,3902292032,3930766276,1672634682,1672635964,1282
11165,3512203553,3858330969,1672656069,1672657867,1798
10361,3685083275,3757713457,1672647092,1672648455,1363
9847,3776348472,3420881591,1672697882,1672700123,2241
9886,3500415589,3901169230,1672678431,1672681735,3304
10592,3409078869,3500589560,1672580999,1672582632,1633
9838,3515548696,3512337054,1672557767,1672559869,2102
9912,3776968640,3483078667,1672545716,1672548671,2955
11695,3792411831,3365519448,1672593943,1672595506,1563
10315,3276393542,3334461288,1672630858,1672632612,1754
11032,3518425740,3334482021,1672623693,1672625293,1600
11441,3617771673,3932955949,1672576085,1672577911,1826
11739,3510233949,3371238318,1672596890,1672600116,3226
11773,3534122907,3713416756,1672660754,1672661550,796
11196,3856552205,3513171472,1672602795,1672604729,1934
11529,3533986052,3301449986,1672566885,1672569866,2981
11255,3703336988,3518408734,1672650587,1672653808,3221
11614,3834643026,3486824047,1672685082,1672687729,2647
10254,3520625600,3520625600,1672664911,1672667147,2236
11352,3834424604,3852275715,1672607387,1672608776,1389
11391,3516319492,3304661369,1672573581,1672575255,1674
10756,3370512945,3825877848,1672627698,1672628273,575
11262,3557129226,3247545468,1672697281,1672697746,465
11775,3780224882,3420664407,1672659558,1672662558,3000
11267,3442564712,3701004302,1672541319,1672542508,1189
11415,3209075485,3311569360,1672683584,1672686199,2615
11299,3756297396,3533620069,1672582128,1672583229,1101
10824,3713336088,3510486220,1672622003,1672623241,1238
10078,3447554599,3910190872,1672587632,1672590184,2552
10582,3393001196,3208962614,1672630044,1672632611,2567
11651,3613703906,3855209450,1672566474,1672567490,1016
10748,3711591464,3304028109,1672681791,1672684985,3194
9896,3352374868,3311197635,1672625965,1672628762,2797
10157,3802625412,3900540310,1672533322,1672534306,984
11312,3436018575,3367109648,1672672039,1672673876,1837
11410,3241682278,3756297396,1672571412,1672572587,1175
10283,3236886943,3509167758,1672634669,1672636649,1980
11207,3382308738,3935256825,1672636279,1672639801,3522
9916,3780173788,3413236071,1672552536,1672554919,2383
10100,3487779363,3516378356,1672682001,1672682450,449
10228,3287683210,3515284733,1672685337,1672688116,2779
11263,3792633495,3755411110,1672674598,1672677989,3391
10236,3760107540,3600978954,1672604923,1672607688,2765
11265,3852992961,3443041059,1672567070,1672568604,1534
11011,3513215373,3896200048,1672557045,1672557849,804
10016,3375906394,3914740937,1672661167,1672661606,439
10551,3773083407,3730169449,1672647912,1672648964,1052
10145,3423346297,3422460919,1672532519,1672536051,3532
10687,3273242177,3367202274,1672676669,1672680170,3501
11748,3760420315,3715923089,1672596601,1672598716,2115
10402,3411355804,3886957097,1672595398,1672598096,2698
11400,3713767153,3384601925,1672618608,1672618728,120
10925,3830962592,3809216145,1672663539,1672666571,3032
11185,3337675386,3533830748,1672665721,1672666068,347
11277,3519463038,3349319959,1672633389,1672634917,1528
9833,3485521840,3395505794,1672585289,1672587690,2401
10231,3479207976,3778924002,1672694814,1672696428,1614
11116,3426207439,3714294005,1672669955,1672670346,391
11401,3783313202,3505720915,1672596052,1672596658,606
11668,3450621820,3735838864,1672558384,1672561088,2704
11403,3208894215,3316551382,1672640677,1672641815,1138
11520,3714640103,3909067335,1672539063,1672540140,1077
11129,3780921044,3512638952,1672556129,1672558256,2127
11395,3783651407,3313502623,1672680282,1672682697,2415
11654,3773554767,3739844610,1672549924,1672551156,1232
10473,3283106998,3515764058,1672578783,1672578885,102
10664,3516588277,3757060033,1672703873,1672706539,2666
11356,3419789418,3933872044,1672702979,1672703931,952
9796,3552261072,3713927376,1672685687,1672686422,735
10292,3703725221,3437023385,1672668194,1672668686,492
11707,3663353552,3774706478,1672628312,1672629877,1565
10126,3773826624,3736010012,1672589533,1672591213,1680
10039,3619538249,3774296721,1672610816,1672614140,3324
11065,3923524564,3756066765,1672664855,1672666498,1643
11349,3500455935,3516321993,1672592867,1672595442,2575
10902,3533009565,3715126587,1672624703,1672625772,1069
11173,3245774173,3776053084,1672585285,1672586355,1070
11628,3710173412,3778838936,1672689734,1672691103,1369
10891,3319061210,3779427180,1672561084,1672561193,109
11127,3732871856,3772164469,1672600512,1672601122,610
11608,3444598583,3515597467,1672693891,1672696249,2358
9895,3501515425,3977880564,1672651679,1672652459,780
10143,3384170206,3681737865,1672619140,1672620712,1572
10490,3776534957,3500596577,1672684410,1672686399,1989
10310,3714883746,3735497729,1672589811,1672593359,3548
10094,3713954144,3791863922,1672610785,1672613346,2561
11014,3791825536,3630802959,1672647577,1672649621,2044
10615,3793375825,3500741005,1672675981,1672677290,1309
10556,3834424604,3453519360,1672563864,1672565903,2039
11538,3550887623,3501628472,1672539933,1672542841,2908
10415,3500974385,3772966919,1672594326,1672595356,1030
9881,3925208102,3514352989,1672533109,1672535381,2272
11010,3469663062,3520057139,1672561120,1672562916,1796
10387,3520473111,3777304517,1672609361,1672609949,588
10649,3683514731,3246971044,1672582165,1672582247,82
11680,3203954795,3714688409,1672536700,1672536820,120
9942,3791382196,3755630085,1672618424,1672619438,1014
11090,3777498160,3703697059,1672556975,1672559952,2977
11740,3512596743,3732440502,1672556777,1672558994,2217
10418,3376842515,3919342147,1672589821,1672591995,2174
11583,3623512088,3348343425,1672608496,1672609047,551
11109,3287753579,3500591274,1672554547,1672556749,2202
10132,3533620069,3669497617,1672645232,1672648478,3246
10609,3711243126,3282240901,1672689608,1672690557,949
10437,3880788853,3714951681,1672531949,1672534787,2838
10629,3285201542,3361865467,1672676352,1672679117,2765
10977,3880562532,3403257752,1672684250,1672684345,95
10950,3830962592,3615846003,1672701843,1672705317,3474
10692,3934280144,3817029483,1672583115,1672586141,3026
11755,3512417028,3290060215,1672632801,1672634057,1256
11255,3770780655,3517551721,1672567162,1672569855,2693
11620,3613936929,3512133625,1672535391,1672536659,1268
10024,3703462221,3885674996,1672541245,1672543023,1778
10919,3490008012,3824657614,1672701407,1672701821,414
11123,3514005973,3510919509,1672690044,1672692091,2047
10283,3520305100,3453519360,1672680931,1672683703,2772
11708,3520553959,3533642281,1672534773,1672536920,2147
10433,3355899481,3497562878,1672614357,1672615853,1496
9846,3447253775,3287683210,1672638369,1672638578,209
11335,3430310785,3716633983,1672531378,1672531643,265
10263,3780956975,3406101720,1672630812,1672631073,261
11685,3602570831,3933562725,1672587500,1672591062,3562
11024,3735838864,3513215373,1672655184,1672657993,2809
11177,3533265491,3513586642,1672697430,1672699797,2367
10687,3514508773,3451757423,1672702479,1672704674,2195
10006,3229615214,3901217668,1672633288,1672633397,109
10711,3783730769,3220987526,1672565947,1672568983,3036
10117,3491527603,3810584695,1672584617,1672587385,2768
11313,3783935976,3429610195,1672587740,1672588607,867
11212,3396656251,3334936138,1672657065,1672657348,283
11127,3791269060,3778370462,1672618684,1672621191,2507
11508,3711765138,3505709407,1672536635,1672540235,3600
10769,3516497645,3639081201,1672589225,1672590375,1150
10090,3445172440,3852161626,1672533270,1672535058,1788
10173,3273674596,3613703906,1672635539,1672637551,2012
10857,3399173821,3902023467,1672599582,1672600300,718
10619,3778370462,3891272544,1672675884,1672678627,2743
10186,3515047288,3773024346,1672630957,1672632613,1656
10764,3733123020,3770574826,1672673929,1672677361,3432
10026,3280208630,3242149533,1672605575,1672605653,78
9877,3500329674,3773024346,1672610124,1672613328,3204
10915,3310737478,3299052917,1672579908,1672581695,1787
11173,3415562576,3886837151,1672602408,1672602627,219
11751,3343698137,3488887919,1672542417,1672542734,317
10325,3501976169,3243651036,1672569099,1672572627,3528
10942,3778044082,3970775805,1672554582,1672558006,3424
10560,3836090778,3500821475,1672671652,1672674468,2816
10473,3249380931,3776968640,1672618214,1672621714,3500
10888,3201920708,3469663062,1672538043,1672541560,3517
11220,3858330969,3779951373,1672609836,1672612840,3004
11705,3755119166,3938059867,1672633895,1672637247,3352
10906,3773826624,3791522832,1672582802,1672582942,140
10866,3510919509,3500833053,1672657736,1672658193,457
11619,3924366353,3793569914,1672589014,1672589559,545
11138,3618024815,3516486526,1672672589,1672676065,3476
9861,3711591464,3780482864,1672589029,1672591307,2278
11146,3710783759,3851737350,1672669378,1672672718,3340
10598,3924205112,3500221079,1672666033,1672668671,2638
10532,3319436533,3338465050,1672699951,1672701107,1156
11400,3505155858,3533201269,1672617018,1672617632,614
10717,3497732613,3534604516,1672683727,1672684419,692
11038,3308149799,3822634862,1672614536,1672615298,762
11138,3779130507,3306037126,1672699543,1672702581,3038
10076,3809207482,3483701493,1672668817,1672669090,273
9893,3393376416,3756991235,1672650144,1672652007,1863
10741,3783947742,3518759318,1672551286,1672553487,2201
11471,3501174621,3206262649,1672638962,1672640225,1263
10257,3618672178,3499343927,1672552144,1672553952,1808
10095,3242149533,3600441934,1672652022,1672653662,1640
10235,3500440602,3552261072,1672684648,1672688166,3518
11785,3352295704,3285322570,1672615189,1672616273,1084
9946,3624307518,3513894659,1672555730,1672558353,2623
10900,3406101720,3293898029,1672669996,1672670756,760
10841,3285322570,3791547827,1672580203,1672581855,1652
10163,3793704155,3514611187,1672615115,1672615994,879
11777,3227874229,3713621169,1672607828,1672608150,322
11363,3633860380,3902357342,1672694729,1672694852,123
11760,3497904539,3791841318,1672627427,1672628463,1036
11552,3501873139,3908331271,1672589379,1672591574,2195
11787,3715039960,3791224239,1672569544,1672570730,1186
10771,3394394262,3854202447,1672621162,1672624053,2891
10224,3757713457,3517551721,1672679678,1672681894,2216
11531,3778824229,3519046342,1672679255,1672680449,1194
11783,3319585148,3680939042,1672687310,1672690434,3124
11216,3336225953,3203151036,1672605279,1672606880,1601
11650,3278805844,3364302157,1672636649,1672639628,2979
9906,3227919286,3519831322,1672686950,1672690404,3454
10633,3388830370,3973138649,1672612282,1672613248,966
11009,3780500764,3900540310,1672662043,1672663064,1021
10962,3901217668,3804095239,1672698669,1672699226,557
10288,3332124606,3534506090,1672662112,1672663835,1723
11276,3772708314,3516067011,1672687396,1672688216,820
9819,3353811455,3245642576,1672642755,1672642986,231
10360,3757198930,3239279744,1672543387,1672545973,2586
11006,3496591885,3452982957,1672701481,1672701944,463
10285,3517960740,3971051020,1672703068,1672704584,1516
11234,3915962248,3834424604,1672557150,1672558858,1708
11032,3343193067,3500674240,1672548641,1672549393,752
10213,3687024828,3737738751,1672580273,1672583676,3403
11172,3312800145,3772070986,1672628462,1672629547,1085
10580,3515944817,3883640904,1672689634,1672692865,3231
11583,3919349138,3756113624,1672635482,1672638758,3276
11043,3713566527,3804779247,1672553629,1672555563,1934
10031,3637522163,3308965136,1672646145,1672648346,2201
11075,3760416450,3384001094,1672681328,1672684758,3430
11696,3609997804,3739567072,1672639528,1672639619,91
10471,3235373942,3792063616,1672611151,1672613329,2178
11109,3757639274,3519228207,1672618227,1672618729,502
11067,3511750695,3780224882,1672632244,1672634558,2314
10556,3459163055,3244397548,1672566364,1672569137,2773
10813,3440991826,3387621912,1672547588,1672550234,2646
10511,3505173665,3367121615,1672566430,1672567050,620
11602,3779609338,3511466117,1672647815,1672648630,815
9973,3500630465,3349475873,1672631404,1672634757,3353
11355,3278251248,3713159131,1672609705,1672611368,1663
11549,3516827471,3515699732,1672561324,1672564589,3265
10963,3308481706,3760390822,1672558101,1672558982,881
10297,3791359168,3934980229,1672615899,1672617836,1937
11396,3914947393,3361952532,1672678026,1672679284,1258
10632,3417969824,3500536897,1672693105,1672695283,2178
10422,3403738461,3516340010,1672629635,1672631413,1778
10034,3228218081,3779748270,1672600233,1672603359,3126
10490,3466655775,3235578121,1672617296,1672620002,2706
10481,3511640720,3368079099,1672694112,1672694490,378
10535,3793719515,3358211034,1672551104,1672553528,2424
11581,3791108593,3501927452,1672579157,1672580365,1208
10471,3778927933,3713878219,1672644432,1672647323,2891
11367,3710228292,3317887374,1672591192,1672593426,2234
10063,3666367524,3772216305,1672538024,1672538485,461
10723,3715106566,3714283424,1672594944,1672595821,877
11633,3518117078,3509556649,1672677605,1672679465,1860
11016,3710119555,3604908372,1672657091,1672658160,1069
9828,3615245840,3500105301,1672575910,1672578041,2131
10573,3601063076,3471555057,1672573970,1672577306,3336
10792,3396472026,3516585063,1672648945,1672650730,1785
11264,3298831109,3935256825,1672576614,1672578750,2136
10481,3668955834,3440671139,1672561568,1672563421,1853
10091,3755286041,3779393140,1672663128,1672665539,2411
9861,3481365330,3711671702,1672677173,1672679475,2302
10323,3235470567,3772867078,1672677195,1672677704,509
11556,3500536897,3505175620,1672611027,1672614000,2973
11320,3236512807,3811351746,1672632728,1672634520,1792
11383,3778695017,3433196933,1672552117,1672555453,3336
11206,3380628097,3896615831,1672671640,1672672088,448
10720,3755922811,3501192566,1672560512,1672562438,1926
10808,3332124606,3760541837,1672692401,1672694254,1853
10379,3613703906,3333477908,1672625005,1672627313,2308
11042,3793569914,3772291207,1672577610,1672579927,2317
10147,3505245692,3760537855,1672682692,1672683902,1210
10856,3201920708,3299845453,1672668956,1672671455,2499
11003,3711131262,3515804844,1672695529,1672696624,1095
10050,3701387745,3482639402,1672562989,1672565117,2128
9899,3778824229,3438818153,1672676892,1672679520,2628
11133,3512477276,3293673220,1672625350,1672627086,1736
10514,3915035136,3283785820,1672690668,1672691739,1071
10707,3518335611,3854957153,1672673063,1672674158,1095
10318,3772648837,3533154906,1672623126,1672626522,3396
10078,3519621901,3500019810,1672622234,1672623094,860
11623,3662821438,3468281011,1672636320,1672638750,2430
10766,3469778316,3558264627,1672569666,1672572988,3322
11210,3243305367,3311569360,1672557916,1672560078,2162
11265,3756763585,3703476890,1672695436,1672696058,622
11340,3358530225,3757393413,1672586256,1672586748,492
11320,3231271498,3379076106,1672615843,1672617708,1865
10718,3513563152,3231859576,1672561343,1672562871,1528
10308,3812677669,3516167000,1672575062,1672576277,1215
11737,3834643026,3438028077,1672595583,1672597274,1691
11069,3855977674,3276209319,1672593225,1672595155,1930
10802,3500726347,3760525465,1672573678,1672575933,2255
10450,3501711464,3520926977,1672605609,1672607315,1706
11483,3313282478,3378430760,1672618177,1672621347,3170
10339,3500096103,3469663062,1672701905,1672703205,1300
11236,3514638555,3534869444,1672661056,1672661201,145
9926,3669427589,3353194923,1672634447,1672637041,2594
10709,3505011956,3757994002,1672581713,1672584249,2536
10047,3617135064,3515507526,1672641917,1672643630,1713
11028,3311449914,3509445318,1672631093,1672631815,722
11206,3500356342,3755942724,1672687168,1672688969,1801
10419,3791236983,3812880543,1672611714,1672614462,2748
9907,3662794240,3229465607,1672617248,1672617340,92
9843,3611533094,3791194984,1672649320,1672651530,2210
9922,3515379622,3358959807,1672616518,1672619244,2726
11387,3278629965,3896859936,1672588798,1672591443,2645
10072,3534941710,3488931357,1672602046,1672605430,3384
10666,3313282478,3551833298,1672560769,1672564314,3545
11645,3500104976,3624365837,1672574290,1672576852,2562
11600,3512411326,3770709417,1672674813,1672678033,3220
10604,3711810268,3681504869,1672576468,1672577440,972
10637,3776053084,3404187438,1672581167,1672582441,1274
11693,3779102237,3884862164,1672624622,1672628103,3481
11565,3716994924,3755670258,1672623459,1672623722,263
10133,3364718040,3295710494,1672536071,1672539483,3412
10209,3882905311,3777118499,1672553235,1672556160,2925
11548,3713285095,3716285196,1672567846,1672570093,2247
11190,3340897079,3701956841,1672561134,1672564064,2930
11447,3736010012,3911431642,1672620682,1672622530,1848
10440,3245882008,3513203127,1672553371,1672556437,3066
11547,3209280342,3206241691,1672695288,1672696377,1089
11147,3777909822,3856552205,1672565501,1672568405,2904
10569,3616242727,3311015817,1672627254,1672629053,1799
10149,3715622084,3755394177,1672559786,1672560203,417
10015,3207586072,3807486812,1672678987,1672681417,2430
10207,3243763209,3512411326,1672685233,1672688584,3351
11518,3901217668,3500455935,1672657638,1672660244,2606
10945,3476416072,3512492332,1672629404,1672631868,2464
11788,3773798215,3616371564,1672664884,1672665595,711
11716,3471996194,3557324887,1672685569,1672686841,1272
11444,3756850160,3510189563,1672594555,1672595646,1091
10394,3469370398,3480270940,1672663741,1672664991,1250
11258,3701127475,3206217657,1672637297,1672639222,1925
10100,3772489471,3520471156,1672609353,1672611040,1687
11633,3620105539,3519000878,1672582280,1672584310,2030
10722,3204149913,3512794667,1672542927,1672543846,919
11552,3396656251,3228997424,1672691075,1672693625,2550
9835,3772223331,3793822639,1672622787,1672623757,970
10374,3619538249,3471131277,1672577798,1672578146,348
11780,3772216305,3910049345,1672551924,1672553969,2045
10269,3793274957,3510882475,1672548001,1672551097,3096
10804,3760737203,3778817220,1672669350,1672671185,1835
10932,3713100169,3514541800,1672607160,1672607704,544
10807,3666561358,3893629892,1672682310,1672684763,2453
11558,3774325486,3311529105,1672672533,1672672999,466
10666,3476308535,3912811715,1672624163,1672626628,2465
11401,3757924067,3756536512,1672686763,1672686877,114
11501,3501853868,3711065081,1672680543,1672681458,915
10335,3231271498,3272827860,1672671712,1672673649,1937
11148,3452175941,3337903727,1672609661,1672610671,1010
10610,3534941710,3500889287,1672646408,1672647439,1031
10434,3730348493,3760396348,1672568519,1672571092,2573
11523,3271780525,3514389188,1672656433,1672659982,3549
11359,3703849264,3914926436,1672634012,1672635763,1751
11537,3332010532,3710622746,1672648572,1672650240,1668
10635,3918981936,3423147369,1672645240,1672647773,2533
10897,3450342110,3886957097,1672695490,1672697514,2024
10294,3206241691,3770172119,1672642834,1672643951,1117
11259,3516319492,3732090606,1672568326,1672571730,3404
11483,3424425746,3509470194,1672568521,1672570512,1991
9957,3517816581,3511650296,1672548764,1672551512,2748
10614,3783172505,3557129226,1672619392,1672619471,79
10450,3804707712,3223177147,1672596842,1672598885,2043
10536,3770976984,3703438617,1672589750,1672592298,2548
9797,3480108752,3501600785,1672612170,1672613091,921
10384,3285587972,3534459983,1672589780,1672591659,1879
10729,3347140733,3688130094,1672627919,1672628810,891
9795,3780482864,3511671476,1672559080,1672560989,1909
9951,3380167818,3517766135,1672594222,1672597099,2877
11704,3852310652,3235313062,1672632934,1672634470,1536
10029,3701171318,3310702648,1672562761,1672565553,2792
11489,3777641081,3551972633,1672672941,1672676086,3145
10855,3422081502,3274239253,1672675252,1672676731,1479
10929,3701540249,3714806574,1672619111,1672621891,2780
10164,3710125627,3884001167,1672543332,1672544687,1355
11291,3514021667,3311602936,1672623512,1672626037,2525
10016,3358434853,3509663119,1672586452,1672586685,233
11563,3500317923,3512857020,1672663007,1672664330,1323
10046,3682086200,3624307518,1672621847,1672624127,2280
11751,3611533094,3773523569,1672673243,1672676813,3570
11240,3352044245,3810584695,1672608885,1672609367,482
10378,3444453261,3209075485,1672640849,1672642485,1636
10113,3208519320,3701060732,1672598475,1672598976,501
11526,3519951586,3851451801,1672662097,1672664611,2514
10456,3710173412,3480418192,1672590067,1672592127,2060
10714,3516517348,3349475873,1672576756,1672578164,1408
10965,3371184929,3463892928,1672681217,1672683420,2203
10313,3517151644,3760144712,1672689232,1672692156,2924
11671,3303552616,3243056734,1672581349,1672582626,1277
10342,3638018906,3466149998,1672661341,1672663109,1768
11761,3683677062,3630462406,1672578843,1672579414,571
10439,3713920790,3509297453,1672558025,1672559950,1925
11544,3511458926,3778605154,1672543843,1672544484,641
10796,3756157377,3774598935,1672638943,1672639349,406
10937,3755823805,3203457161,1672583765,1672584645,880
11563,3510535683,3682150740,1672585816,1672587893,2077
10545,3710060386,3713728777,1672687440,1672691005,3565
10929,3760854788,3916955566,1672642388,1672643822,1434
11626,3354015456,3519553933,1672655374,1672657019,1645
10747,3312612693,3772019557,1672541408,1672543014,1606
10640,3275735969,3791194984,1672675017,1672676618,1601
10550,3364683368,3825082811,1672627347,1672630781,3434
10340,3792900315,3519848902,1672610458,1672613047,2589
10325,3505936495,3511645260,1672635834,1672639111,3277
10042,3514611187,3245121919,1672699467,1672702606,3139
10252,3818324410,3299845453,1672676864,1672680411,3547
11099,3813111107,3519703964,1672580248,1672581024,776
10523,3760737203,3668154066,1672645635,1672646912,1277
10133,3780142207,3636927297,1672573882,1672576983,3101
10503,3361865467,3505314920,1672559211,1672561117,1906
11120,3858429342,3360309868,1672635217,1672635748,531
9909,3511608609,3518376262,1672600658,1672603008,2350
10854,3714838100,3832312129,1672702782,1672703804,1022
10668,3371759044,3342031426,1672609353,1672612831,3478
10871,3495427619,3804779247,1672651587,1672652359,772
11433,3772943811,3392573386,1672617080,1672619950,2870
9936,3463883997,3223177147,1672648530,1672648603,73
10759,3465107990,3517331746,1672623333,1672626601,3268
10820,3711367577,3973582279,1672652175,1672655751,3576
10195,3246395239,3603167427,1672644233,1672646304,2071
9918,3377250778,3440991826,1672585738,1672587978,2240
11601,3461741050,3505500523,1672609811,1672609996,185
10339,3309528048,3825234433,1672662432,1672662526,94
9910,3891586951,3519848902,1672648144,1672648940,796
10749,3278071998,3714525519,1672697396,1672700669,3273
11044,3703351452,3772055279,1672692240,1672694807,2567
11786,3780127017,3715858201,1672594102,1672596606,2504
10454,3351949206,3773770134,1672540057,1672543108,3051
11382,3335974305,3701291994,1672654037,1672656293,2256
9942,3512645289,3778182724,1672578273,1672579923,1650
10099,3355880028,3474097405,1672556019,1672559343,3324
11502,3313282478,3856601074,1672544418,1672546773,2355
11235,3906075386,3715602742,1672606060,1672606305,245
11253,3200785194,3757393413,1672697831,1672700651,2820
11090,3621812406,3809860102,1672573596,1672576922,3326
11512,3352374868,3791332061,1672543345,1672544682,1337
10452,3533340292,3636885498,1672657656,1672659754,2098
10240,3511199555,3241567995,1672676431,1672678208,1777
10172,3899156705,3519553933,1672628163,1672628392,229
11403,3600441934,3939422411,1672692431,1672695727,3296
10636,3836757034,3682241594,1672646585,1672649343,2758
10025,3703624327,3415032547,1672679723,1672680668,945
9859,3221290808,3974400577,1672674465,1672674604,139
10959,3776791436,3912181197,1672676806,1672679235,2429
11487,3513186622,3520925688,1672569258,1672571155,1897
10532,3880030249,3516965624,1672673014,1672675580,2566
9939,3714731729,3757032266,1672563247,1672565443,2196
11725,3396472026,3732596503,1672631660,1672635004,3344
11307,3361711720,3774965463,1672684033,1672686207,2174
10395,3478455812,3757064623,1672549431,1672549905,474
9881,3513293711,3857609616,1672581238,1672582130,892
11669,3703749690,3395615598,1672683959,1672685830,1871
10942,3899903158,3757623259,1672548881,1672549657,776
10230,3756897029,3756647451,1672685548,1672688745,3197
10025,3500927619,3382746533,1672677791,1672680494,2703
10737,3516572212,3511500932,1672688991,1672692009,3018
9977,3206926634,3823307824,1672679358,1672682612,3254
9831,3304030474,3623512088,1672638600,1672639796,1196
11667,3425646356,3533036499,1672652224,1672655313,3089
10165,3783879023,3710515351,1672587645,1672589474,1829
9929,3514498259,3882580580,1672659354,1672661695,2341
10765,3773024346,3344710271,1672586646,1672587185,539
11257,3663353552,3444397804,1672609035,1672610017,982
10014,3756717136,3510882576,1672554037,1672556266,2229
11070,3661543201,3772556646,1672618571,1672619473,902
11207,3760737203,3792107875,1672561302,1672564235,2933
11124,3760541837,3312733562,1672675353,1672678231,2878
11344,3519352855,3509370633,1672685534,1672687173,1639
11654,3498803823,3285515107,1672578785,1672579411,626
10496,3800434325,3776001441,1672575555,1672577569,2014
10524,3793029132,3899156705,1672643699,1672647274,3575
10516,3533867833,3344710271,1672690554,1672692826,2272
10225,3757514745,3902775449,1672696516,1672696793,277
9807,3514747345,3509556649,1672577839,1672580698,2859
10618,3488749569,3509360869,1672700366,1672702773,2407
11284,3601340045,3773411968,1672603947,1672605473,1526
11263,3510856388,3452878062,1672675219,1672678522,3303
11647,3807800457,3804779247,1672617340,1672618935,1595
11083,3281148858,3480259863,1672606440,1672607264,824
11391,3757851680,3809194824,1672548676,1672550130,1454
11676,3688768189,3510373076,1672610969,1672612159,1190
10037,3777112124,3772070986,1672546020,1672547114,1094
10664,3713374884,3738873928,1672590170,1672593430,3260
11499,3512857020,3419762444,1672594287,1672597118,2831
10570,3534589501,3513545735,1672678839,1672679217,378
10043,3935333166,3411626917,1672538517,1672540554,2037
10690,3520558137,3755767856,1672557174,1672559692,2518
10713,3776455762,3314965818,1672648709,1672650566,1857
10147,3713102459,3501843187,1672552257,1672555489,3232
11097,3934991640,3711755596,1672651012,1672653803,2791
9900,3516167000,3520926977,1672681523,1672682434,911
11707,3343859998,3756297396,1672681125,1672684021,2896
11665,3518209090,3416474842,1672601135,1672604514,3379
10455,3780467276,3359012188,1672576761,1672579302,2541
10429,3780171640,3774251051,1672572434,1672575121,2687
10522,3855077502,3714516404,1672555274,1672556074,800
10776,3200372897,3511526885,1672618088,1672621622,3534
11123,3783809405,3207307681,1672603194,1672605768,2574
10632,3510486220,3471177177,1672692115,1672693669,1554
10990,3206262649,3791206902,1672536109,1672538503,2394
10899,3510486220,3713694278,1672665275,1672665841,566
11449,3517195738,3776182849,1672557384,1672560466,3082
11332,3757872458,3446764595,1672644576,1672647593,3017
11594,3854202447,3519352855,1672548200,1672550769,2569
10629,3756113624,3739820448,1672591541,1672592410,869
11549,3780749789,3361865467,1672585063,1672588321,3258
10087,3501628472,3621439107,1672672191,1672673790,1599
10848,3663505156,3827981800,1672626179,1672628576,2397
10803,3518376262,3938398160,1672646245,1672648716,2471
11440,3701377471,3231859576,1672602130,1672603633,1503
10600,3276209319,3387989658,1672689930,1672691052,1122
11680,3791716170,3779930476,1672546592,1672546791,199
11373,3701779683,3278443807,1672649952,1672652917,2965
9829,3284407073,3501027795,1672538476,1672539614,1138
10566,3851810349,3511028193,1672648517,1672650008,1491
11364,3533201269,3915652382,1672574991,1672577648,2657
10808,3455430943,3340897079,1672656466,1672659391,2925
10214,3605760561,3909822999,1672598110,1672600538,2428
11136,3711179193,3622729771,1672541862,1672542793,931
10108,3805616707,3711196962,1672634520,1672634951,431
9819,3510750299,3272096922,1672611622,1672611704,82
9995,3620836520,3230612965,1672609137,1672611687,2550
10805,3760144712,3519351747,1672540907,1672543219,2312
11457,3430032005,3780482864,1672659653,1672660450,797
11286,3856601074,3757513651,1672665709,1672668789,3080
10728,3632303304,3465690527,1672559436,1672559907,471
11601,3715622084,3701385831,1672570907,1672572462,1555
10638,3668855144,3772114731,1672671009,1672673336,2327
10030,3888903181,3359418136,1672675695,1672678970,3275
9922,3389069291,3791269060,1672535074,1672538276,3202
11387,3713514933,3701028092,1672599760,1672600550,790
9887,3770764940,3516497645,1672623088,1672624838,1750
9879,3398151217,3778819352,1672597044,1672597856,812
9983,3701284535,3627358016,1672577107,1672579866,2759
10158,3449020351,3793569914,1672589370,1672590144,774
11317,3834456158,3778741325,1672648652,1672651647,2995
10121,3623953446,3701412729,1672639853,1672640431,578
10950,3514747345,3453519360,1672556426,1672558176,1750
11450,3397527886,3821082558,1672575349,1672577512,2163
11438,3660163550,3778986795,1672680875,1672682575,1700
11290,3556684272,3922430928,1672631342,1672634794,3452
10342,3714658474,3534459983,1672598262,1672601413,3151
11756,3780129338,3734233216,1672626161,1672626634,473
10568,3534696810,3311188620,1672620723,1672622361,1638
10238,3476144563,3791994414,1672651967,1672655311,3344
10824,3755369666,3772282008,1672583994,1672584464,470
11414,3777686966,3515655024,1672674712,1672678078,3366
9935,3515304526,3458753033,1672587257,1672587412,155
11506,3505490878,3972847837,1672630320,1672632722,2402
9964,3358959807,3778561231,1672605688,1672609094,3406
10756,3780298499,3519841427,1672650724,1672650985,261
10939,3511963020,3739217535,1672652483,1672652652,169
10600,3245774173,3509274030,1672627438,1672629535,2097
10498,3347760784,3449233346,1672674909,1672676525,1616
10219,3660257653,3621439107,1672592186,1672593160,974
10230,3288920399,3423217578,1672678446,1672679300,854
11747,3408408584,3499622352,1672577391,1672580498,3107
10444,3533131937,3500799617,1672597861,1672599800,1939
11007,3776468503,3920155862,1672617559,1672618739,1180
10132,3246395239,3334381941,1672576279,1672578159,1880
11271,3755374000,3516429380,1672651517,1672654712,3195
11521,3930475498,3791236983,1672557107,1672558105,998
11576,3716669659,3783679478,1672667918,1672669631,1713
11210,3509677530,3511750850,1672631396,1672631571,175
11367,3714516404,3664719070,1672659450,1672659606,156
11123,3927763819,3478455812,1672584557,1672586196,1639
10439,3669427589,3818532143,1672672355,1672672654,299
10484,3516572212,3611939581,1672643153,1672645918,2765
11609,3299743638,3776034313,1672547563,1672551001,3438
11137,3342056927,3276230295,1672607761,1672610130,2369
10635,3823307824,3287683210,1672693056,1672694095,1039
11657,3518534560,3533037906,1672564792,1672566546,1754
10760,3772509599,3463883997,1672582340,1672584732,2392
10674,3517325365,3780466967,1672652083,1672653686,1603
9803,3500695402,3500087325,1672539870,1672542533,2663
10470,3510836047,3500591274,1672588269,1672589914,1645
9984,3534537581,3450503086,1672650293,1672650993,700
9905,3793719515,3500927619,1672550883,1672551959,1076
11245,3334381941,3301489209,1672555448,1672556589,1141
10926,3470962222,3341985886,1672646824,1672648454,1630
9968,3777729184,3505121295,1672555494,1672556438,944
10702,3755736024,3500329674,1672616680,1672619057,2377
10502,3770709417,3360783381,1672663246,1672663660,414
11182,3501927452,3516588277,1672553238,1672554047,809
10696,3632189887,3516815069,1672550252,1672552615,2363
10962,3371564186,3381055770,1672694310,1672695243,933
11080,3505684690,3884369346,1672541730,1672542742,1012
10052,3435801763,3559125467,1672570476,1672573366,2890
11754,3452389513,3516257130,1672559828,1672562828,3000
11653,3244098077,3514361485,1672565455,1672566934,1479
11281,3509651954,3780238637,1672636123,1672638428,2305
11438,3978417055,3517960157,1672572982,1672573568,586
11207,3625952981,3615742989,1672555500,1672557248,1748
10427,3500209015,3206262649,1672645746,1672646150,404
10310,3516585063,3514571807,1672559069,1672560009,940
10324,3334381941,3780224882,1672617717,1672620789,3072
10467,3231654754,3611939581,1672563270,1672566034,2764
11709,3316121649,3735152111,1672609931,1672613444,3513
10124,3520515739,3783172505,1672538882,1672540510,1628
11327,3930475498,3307791650,1672561516,1672561759,243
11415,3739387948,3783730769,1672679324,1672682706,3382
10363,3909822999,3713224986,1672683492,1672685685,2193
9855,3621591266,3477248170,1672570360,1672570745,385
11767,3514306458,3755411110,1672676947,1672679916,2969
10708,3779413388,3716197140,1672633834,1672635512,1678
10603,3913847876,3518794921,1672677684,1672680567,2883
11099,3533816813,3777552831,1672702002,1672703144,1142
10140,3338016147,3682086200,1672609984,1672611819,1835
11719,3802625412,3668681400,1672649334,1672649794,460
10858,3713031958,3516034245,1672687944,1672689252,1308
10472,3757393413,3516454693,1672536835,1672537376,541
9867,3301489209,3912862842,1672594605,1672597600,2995
10040,3701540249,3710051427,1672561912,1672563717,1805
9938,3827889533,3482639402,1672694093,1672696100,2007
10287,3467415939,3533822490,1672559345,1672562391,3046
11087,3680988889,3403988682,1672664465,1672667000,2535
11450,3774359137,3703588004,1672608732,1672610576,1844
10541,3308759754,3286938590,1672582296,1672585457,3161
10332,3513213122,3488931357,1672577992,1672579072,1080
11756,3416079461,3509370633,1672599994,1672601166,1172
11203,3893932944,3770574826,1672655825,1672656793,968
10203,3711755596,3713990030,1672683340,1672686442,3102
11028,3347205332,3756647451,1672568282,1672570352,2070
11194,3711349327,3894495222,1672579121,1672580608,1487
9867,3685396470,3856552205,1672549560,1672551665,2105
10164,3772689657,3777135415,1672636723,1672637663,940
11740,3467944159,3710147457,1672688298,1672688916,618
10751,3516588277,3206217657,1672693932,1672696023,2091
9919,3812559393,3927181190,1672615705,1672617706,2001
10726,3703336988,3511199555,1672548576,1672551790,3214
11587,3930766276,3783095041,1672562716,1672565536,2820
11465,3513384042,3361926328,1672623279,1672623576,297
11402,3534204885,3517627003,1672547251,1672549713,2462
10173,3533077580,3511908639,1672619283,1672622375,3092
10107,3422081502,3287968403,1672660424,1672663414,2990
11340,3354405535,3780352400,1672628332,1672631142,2810
10769,3755369666,3510189563,1672594779,1672597051,2272
10742,3639465750,3518376262,1672660516,1672660927,411
10137,3774506868,3203630241,1672634884,1672634954,70
9969,3774633364,3472173212,1672665648,1672669120,3472
10287,3927805949,3739297004,1672692603,1672693262,659
10288,3757994002,3316537706,1672641766,1672642727,961
10941,3359880163,3773714494,1672576844,1672579783,2939
10311,3715737742,3509186338,1672651735,1672652073,338
10030,3225371682,3434581257,1672693673,1672694104,431
10466,3235198316,3774221318,1672591090,1672591541,451
11224,3495637721,3394976623,1672532622,1672534347,1725
11707,3283847934,3939851140,1672604884,1672606166,1282
11418,3353811455,3661543201,1672575078,1672576374,1296
11642,3737571883,3715897627,1672697670,1672698359,689
9939,3903115138,3418997135,1672702999,1672704974,1975
10994,3711755596,3500726347,1672591301,1672592311,1010
10999,3776581518,3770105006,1672546834,1672547759,925
10677,3755465396,3381055770,1672699918,1672702051,2133
10930,3247545468,3244397548,1672691862,1672695383,3521
11753,3619705594,3499142934,1672677962,1672681441,3479
11450,3734957248,3487622510,1672679780,1672682772,2992
11358,3273537848,3779609338,1672698610,1672699235,625
11175,3517551721,3301332095,1672671063,1672672709,1646
11148,3716976932,3417223898,1672584032,1672585065,1033
11525,3203909360,3760648750,1672612757,1672613802,1045
10189,3776125503,3500596577,1672690646,1672693993,3347
11700,3773669001,3520860199,1672570688,1672573546,2858
11673,3715204544,3912181197,1672669138,1672672518,3380
10661,3422915648,3686860179,1672546253,1672547447,1194
11514,3814672661,3734957248,1672649924,1672651581,1657
10604,3514638555,3517632796,1672685767,1672689086,3319
11111,3629248353,3494748808,1672584368,1672587600,3232
11153,3884458862,3512101369,1672629264,1672632364,3100
11488,3309178914,3779312237,1672563063,1672566476,3413
11171,3466620548,3204473480,1672565433,1672568261,2828
11758,3346755179,3519948471,1672663399,1672664386,987
10266,3918126468,3933106901,1672634446,1672637599,3153
11447,3760554453,3760107540,1672568374,1672571525,3151
10981,3513432588,3274239253,1672573379,1672573605,226
11667,3905571273,3897186782,1672691873,1672693762,1889
10545,3793719515,3715419141,1672688812,1672689491,679
10992,3387700451,3915652382,1672622742,1672624767,2025
11177,3896622009,3770276815,1672541616,1672543738,2122
10769,3246062632,3755924094,1672610806,1672611017,211
11688,3205687719,3209958726,1672605983,1672608376,2393
11787,3362385373,3533976217,1672553060,1672554303,1243
11396,3396453219,3711671702,1672680960,1672682143,1183
11005,3478915403,3306066522,1672699981,1672701498,1517
10072,3361926328,3512769522,1672636695,1672637440,745
11173,3341129425,3515597467,1672671365,1672674089,2724
11346,3313392810,3238779889,1672626528,1672627668,1140
10601,3520339198,3243305367,1672638288,1672641858,3570
9862,3772112976,3505936495,1672547134,1672550129,2995
11630,3510484107,3391612879,1672659937,1672661138,1201
11423,3932955949,3976400190,1672531250,1672534082,2832
11245,3246804115,3884192843,1672539199,1672542401,3202
9794,3533816813,3245501577,1672603117,1672605078,1961
11745,3772296376,3777263928,1672551807,1672554311,2504
10446,3779503296,3337903727,1672555929,1672558573,2644
11422,3770180844,3792337863,1672573614,1672577136,3522
11202,3714281210,3368176107,1672629999,1672633331,3332
10094,3689420679,3227956115,1672702193,1672705720,3527
10824,3711040761,3710260848,1672625835,1672628631,2796
10886,3357496255,3780127017,1672702373,1672702660,287
11783,3534426696,3780048608,1672677838,1672679932,2094
10299,3516517348,3558349840,1672663560,1672665262,1702
9964,3514515499,3773688906,1672558754,1672561482,2728
10173,3791194984,3711196962,1672632296,1672632634,338
11308,3858330969,3737622701,1672675513,1672677314,1801
10009,3757732853,3220123678,1672538611,1672540657,2046
11092,3501271930,3755865626,1672547728,1672548842,1114
11083,3770595035,3770273966,1672661622,1672665055,3433
10398,3207307681,3668681400,1672588219,1672590014,1795
10019,3223177147,3701171318,1672613995,1672616480,2485
9892,3224040894,3332840671,1672545260,1672547647,2387
9911,3421956717,3772683155,1672578322,1672580918,2596
11686,3783727937,3495446254,1672582466,1672583308,842
9941,3337673625,3274341934,1672581144,1672582024,880
10966,3247845642,3791368349,1672545157,1672547151,1994
10017,3633294415,3977880564,1672629022,1672629242,220
10981,3516969689,3714903456,1672672286,1672672519,233
10792,3501557463,3229570647,1672591340,1672594138,2798
10614,3518376262,3703572036,1672570283,1672573679,3396
11035,3395565040,3760748418,1672549144,1672551331,2187
9845,3517380144,3239082508,1672650062,1672652187,2125
10440,3517083465,3500640854,1672649765,1672652685,2920
11032,3837885956,3514005973,1672701521,1672704133,2612
10176,3714455496,3510189563,1672691400,1672692453,1053
11428,3774589551,3517816581,1672656735,1672659185,2450
10328,3516965624,3890211161,1672556370,1672558663,2293
10490,3622152515,3534426696,1672599129,1672602723,3594
11217,3703779674,3616371564,1672616789,1672617159,370
10105,3516497645,3917467642,1672651262,1672651498,236
10108,3713514933,3505826673,1672560120,1672561400,1280
11623,3310712221,3710051427,1672568290,1672570151,1861
9948,3701265238,3429047448,1672697682,1672700021,2339
10634,3500104976,3756784813,1672531559,1672533186,1627
10438,3239990061,3773534165,1672626452,1672629945,3493
9879,3515259326,3224824355,1672580794,1672583248,2454
11730,3932491622,3701512498,1672592703,1672592863,160
10955,3318250647,3838039092,1672572157,1672573111,954
10725,3466149998,3482786946,1672579429,1672580126,697
11530,3391612879,3912811715,1672703796,1672704135,339
10584,3974400577,3976225898,1672619246,1672622677,3431
10154,3633860380,3514638555,1672590884,1672591283,399
10045,3391854325,3500776597,1672638394,1672638656,262
9989,3313298164,3423346297,1672631036,1672631973,937
9941,3805704844,3770023722,1672669209,1672671164,1955
10722,3934280144,3233993993,1672584200,1672584811,611
10698,3760382349,3711945923,1672572976,1672573042,66
10940,3738873928,3931164237,1672609418,1672612237,2819
11248,3471131277,3665603628,1672579206,1672579651,445
10259,3500595432,3201656220,1672565784,1672568757,2973
10058,3666561358,3777715675,1672579947,1672580913,966
11275,3601214648,3501711464,1672588880,1672589463,583
9952,3689420679,3511206717,1672616554,1672618469,1915
10386,3856975355,3298113026,1672531314,1672532954,1640
10530,3378172464,3246296769,1672580269,1672582617,2348
10505,3930475498,3500909455,1672554905,1672555489,584
11463,3738547113,3513545735,1672690681,1672691200,519
10937,3556684272,3533822490,1672547585,1672548030,445
10833,3272096922,3513215373,1672587777,1672590814,3037
10035,3791522832,3439532406,1672555753,1672555939,186
11672,3505804611,3534426696,1672680477,1672683390,2913
11741,3534068874,3616403486,1672676865,1672679621,2756
10949,3337715675,3974400577,1672581775,1672585244,3469
11688,3457249798,3393543588,1672531493,1672533824,2331
11782,3713416106,3403257752,1672646186,1672646415,229
10460,3773876312,3510750299,1672597464,1672599048,1584
11374,3773579644,3519000878,1672666490,1672668490,2000
10653,3667950469,3452024572,1672641713,1672642743,1030
11325,3805616707,3856316719,1672589443,1672592816,3373
10472,3450234157,3791070926,1672563093,1672565200,2107
10071,3559125467,3509360869,1672573476,1672575028,1552
11540,3791628195,3245642576,1672682825,1672683389,564
11130,3770105006,3311159418,1672577624,1672581188,3564
10018,3534696810,3512306195,1672548652,1672549122,470
11034,3755394177,3515507526,1672584455,1672585172,717
10739,3669475165,3514353133,1672651477,1672652288,811
11759,3934980229,3517149023,1672580626,1672583640,3014
11262,3885674996,3388923880,1672576856,1672577426,570
11091,3236886943,3791074200,1672587064,1672590070,3006
11330,3632303304,3417223898,1672588236,1672591565,3329
11536,3516103646,3311015817,1672606572,1672608987,2415
10941,3884180202,3776249160,1672660888,1672662533,1645
11642,3331228758,3755170743,1672688340,1672688463,123
11780,3714897456,3897186782,1672557198,1672559937,2739
11701,3500049870,3715126587,1672586864,1672589520,2656
10260,3458753033,3714718326,1672592633,1672594753,2120
10180,3514801709,3515548696,1672549113,1672549903,790
11772,3805718871,3402774497,1672550445,1672551683,1238
11468,3520506192,3341432459,1672613937,1672614828,891
10800,3512527440,3888903181,1672549651,1672552462,2811
11398,3857847527,3533440736,1672585419,1672588048,2629
11739,3466655775,3519951586,1672679367,1672680723,1356
11734,3854390432,3416105769,1672601000,1672601152,152
10469,3756781024,3701377471,1672634299,1672635344,1045
10873,3278251248,3505994703,1672603978,1672606118,2140
10139,3534111498,3811629200,1672535103,1672537822,2719
11047,3783060739,3511458926,1672558819,1672559356,537
11275,3534941710,3716801088,1672532476,1672534166,1690
11217,3902292032,3881785069,1672696075,1672696607,532
11425,3811503860,3332840671,1672622222,1672624155,1933
9962,3818570577,3512490032,1672615614,1672616129,515
10508,3500596577,3351837521,1672690689,1672693503,2814
11710,3927181190,3828568868,1672625653,1672627432,1779
10571,3757639274,3422314045,1672626144,1672626693,549
10072,3883640904,3400560073,1672653373,1672654390,1017
10482,3519703964,3891272544,1672663589,1672664561,972
11696,3517380144,3533440294,1672567109,1672567733,624
10959,3757660578,3403395712,1672585884,1672587667,1783
11601,3884180202,3773378103,1672675855,1672676434,579
10217,3480270940,3515681585,1672700198,1672701123,925
11765,3282240901,3533960602,1672608454,1672611136,2682
11290,3777909822,3825153408,1672534187,1672537126,2939
10804,3777715675,3500057674,1672626250,1672629006,2756
11501,3662495290,3385416697,1672701784,1672702518,734
10948,3770480149,3817478012,1672548572,1672550251,1679
10696,3520625600,3971996397,1672548969,1672550704,1735
11352,3519174861,3518511124,1672619685,1672620883,1198
10215,3475033290,3225554956,1672662211,1672662951,740
11625,3770424941,3505593034,1672616307,1672616386,79
9929,3757497708,3971282455,1672701471,1672703990,2519
10337,3714281795,3853188285,1672557581,1672559340,1759
11171,3505804611,3755924094,1672569969,1672571104,1135
11271,3441737317,3882580580,1672588572,1672591629,3057
11091,3471585513,3857909328,1672689136,1672692326,3190
11235,3859191694,3703818358,1672571715,1672573199,1484
9810,3515379622,3358982831,1672604588,1672605259,671
10214,3732846295,3701265238,1672633878,1672637181,3303
11074,3713840946,3407734098,1672659829,1672661725,1896
10487,3780733404,3770533588,1672606661,1672606761,100
11573,3511729562,3780612543,1672641574,1672643828,2254
10781,3774236212,3773603836,1672642612,1672644846,2234
9838,3416225867,3711810268,1672609536,1672609932,396
10071,3777937949,3881579907,1672541543,1672544246,2703
11620,3908862092,3713840946,1672597531,1672600724,3193
10579,3395615598,3354877289,1672605215,1672608125,2910
11097,3813085701,3510149298,1672650266,1672651482,1216
9884,3514244308,3818324410,1672603805,1672603977,172
10135,3884388188,3934280144,1672562642,1672563821,1179
11531,3662307789,3445733121,1672678380,1672679861,1481
10206,3422959249,3904004824,1672536631,1672537244,613
10999,3926065090,3903994989,1672639906,1672643166,3260
10000,3273242177,3902548260,1672654738,1672657848,3110
10113,3367109648,3756297396,1672660466,1672661286,820
10017,3975796415,3311188620,1672685721,1672686656,935
11744,3500590302,3365519448,1672697491,1672699897,2406
11236,3792633495,3519465545,1672541591,1672541804,213
10618,3716197140,3512504247,1672665236,1672668800,3564
10827,3481019442,3516904926,1672630404,1672632557,2153
11227,3236948071,3716197140,1672547396,1672547780,384
11742,3804075198,3520860199,1672676747,1672677540,793
9981,3501977123,3384713976,1672677248,1672677703,455
10270,3896840409,3894328297,1672629640,1672630986,1346
11652,3770019143,3757212744,1672566212,1672566655,443
10285,3440305508,3703611876,1672603486,1672604394,908
11533,3511458926,3927805949,1672622033,1672623070,1037
10321,3554437212,3203876438,1672669877,1672672012,2135
10382,3400545490,3301369282,1672703055,1672704547,1492
10238,3202740652,3625952981,1672646984,1672649125,2141
10289,3735422623,3399734748,1672678328,1672680102,1774
10278,3454343398,3770709417,1672542032,1672545597,3565
9859,3736010012,3830962592,1672594551,1672598021,3470
10802,3315432466,3505392452,1672683386,1672685171,1785
11003,3602401154,3892177203,1672688952,1672691133,2181
11685,3616403486,3803382101,1672700737,1672703652,2915
10674,3793874490,3519351747,1672606170,1672606518,348
10925,3760346746,3757201538,1672690001,1672691767,1766
11657,3711718368,3756413374,1672654991,1672658549,3558
11248,3373018943,3911821258,1672598051,1672599656,1605
10114,3778927933,3500429731,1672561703,1672562613,910
9981,3379666159,3793497672,1672621530,1672624989,3459
10550,3791581138,3836136159,1672626761,1672627274,513
10574,3520339198,3482639402,1672555026,1672556407,1381
11175,3500444748,3349573092,1672640022,1672642566,2544
10601,3510826414,3516429380,1672570407,1672572551,2144
11096,3382308738,3304030474,1672701497,1672702891,1394
10771,3973134902,3520339198,1672598589,1672599341,752
10269,3284483177,3756784813,1672675700,1672678231,2531
11682,3778273230,3772112976,1672625595,1672627866,2271
10439,3458753033,3756367938,1672538795,1672540203,1408
11437,3412605548,3713990030,1672620706,1672623095,2389
10607,3773041843,3770530739,1672617388,1672617664,276
11617,3416079461,3513171472,1672613423,1672614472,1049
10530,3772845364,3600441934,1672647005,1672649415,2410
11184,3770408300,3791194984,1672672134,1672672723,589
9975,3711029952,3312800145,1672618638,1672621086,2448
11282,3811351746,3880000841,1672656564,1672656743,179
11281,3701291994,3898989233,1672688368,1672691271,2903
10797,3415032547,3857847527,1672674811,1672677378,2567
10299,3500234771,3688845298,1672553287,1672553786,499
10641,3818904268,3559221089,1672558288,1672558404,116
9834,3347140733,3627431396,1672615518,1672617850,2332
11007,3773083407,3517652011,1672608938,1672609578,640
10664,3927805949,3701512498,1672614322,1672616715,2393
11012,3461741050,3469370398,1672678288,1672680439,2151
10121,3757549235,3731644240,1672576079,1672579370,3291
10878,3773408491,3319660530,1672658607,1672661407,2800
10683,3203457161,3404461403,1672598649,1672598915,266
10455,3519754667,3791074200,1672649235,1672652132,2897
11791,3449672240,3716492409,1672592560,1672594414,1854
10887,3757549235,3344778261,1672595606,1672598146,2540
10881,3773134128,3509370633,1672636517,1672639372,2855
10425,3393128259,3774447975,1672662630,1672665926,3296
10921,3713373455,3235470567,1672647828,1672650848,3020
10256,3313502623,3377446376,1672617539,1672619354,1815
11065,3770424892,3854202447,1672631005,1672631106,101
10312,3317887374,3520344592,1672577268,1672579361,2093
11172,3517083465,3893527651,1672641584,1672642166,582
11118,3390537737,3715261950,1672662982,1672664878,1896
10425,3332124606,3686860179,1672540945,1672542313,1368
10385,3814289471,3514005973,1672564141,1672565145,1004
10838,3894328297,3755209597,1672639991,1672642391,2400
10467,3302416197,3757851680,1672662452,1672666032,3580
11282,3716371766,3738526914,1672595584,1672599048,3464
11708,3858330969,3713069234,1672691428,1672692750,1322
10949,3780129338,3349475873,1672644165,1672644272,107
10336,3777060250,3715246385,1672616169,1672617609,1440
11308,3505521491,3501927452,1672630961,1672634007,3046
11209,3971447562,3352295704,1672599660,1672600864,1204
10226,3885422379,3710819760,1672558347,1672561384,3037
11092,3757713457,3974264211,1672625006,1672625233,227
10236,3517440258,3417969824,1672540843,1672543746,2903
11468,3313824913,3510240661,1672582812,1672585995,3183
11142,3335974305,3511286390,1672644671,1672647277,2606
11406,3513186622,3513213122,1672556850,1672558881,2031
10807,3824657614,3227498870,1672692280,1672693290,1010
10560,3501574882,3856552205,1672628637,1672631201,2564
11195,3303772923,3416105769,1672654224,1672654857,633
10620,3713336088,3713805968,1672573672,1672575901,2229
11466,3309178914,3231153513,1672631811,1672633089,1278
9996,3229890340,3513250976,1672665826,1672667289,1463
10243,3377446376,3500018566,1672593417,1672595281,1864
11546,3559123082,3714787207,1672588252,1672590233,1981
11391,3515974881,3716341323,1672574784,1672576859,2075
10463,3428878402,3278071998,1672562688,1672565068,2380
11566,3756149282,3517045396,1672572719,1672574020,1301
11413,3760854788,3437934509,1672682301,1672685457,3156
10469,3609925909,3756413374,1672612434,1672614121,1687
11082,3628556590,3518117078,1672666722,1672669716,2994
10433,3836586875,3340723781,1672644803,1672648066,3263
11238,3233965781,3703419800,1672568673,1672569400,727
11570,3622218289,3783594729,1672642844,1672644567,1723
11166,3511969443,3417969824,1672607556,1672610668,3112
10895,3933106901,3505234868,1672638452,1672640348,1896
10108,3777370992,3636015050,1672625376,1672627301,1925
9910,3334482021,3313824913,1672622971,1672623281,310
10621,3509614126,3660246433,1672536195,1672539292,3097
10452,3505887814,3714902042,1672649296,1672652179,2883
11430,3242149533,3483347530,1672571872,1672573068,1196
11690,3919494952,3711836873,1672588277,1672589884,1607
10193,3358675021,3244395841,1672593546,1672593750,204
10705,3332010532,3461743188,1672688451,1672688550,99
10595,3304030474,3818904268,1672654077,1672654938,861
10027,3774029494,3780740477,1672698380,1672701929,3549
9903,3510542303,3883640904,1672638817,1672639411,594
10203,3710051427,3512495325,1672689594,1672691332,1738
9889,3638071975,3516706121,1672629244,1672629359,115
11316,3499820963,3479402555,1672532380,1672533980,1600
11290,3510335069,3716197140,1672551077,1672554338,3261
11318,3442564712,3931917809,1672667034,1672669079,2045
9931,3906874577,3501407804,1672677653,1672680452,2799
10152,3756536476,3770544738,1672552713,1672553198,485
11626,3501963428,3418791124,1672578062,1672580863,2801
11028,3492064037,3778402454,1672671746,1672673519,1773
10584,3369810091,3500928990,1672654782,1672657221,2439
10870,3739567072,3905358065,1672663456,1672663658,202
10443,3898595916,3715140418,1672547981,1672548914,933
10830,3462153833,3515726910,1672548490,1672549821,1331
10743,3520305100,3501759031,1672622943,1672625081,2138
11543,3520344592,3791994414,1672623032,1672624668,1636
10415,3394959062,3770846374,1672610448,1672613115,2667
11411,3388537708,3422460919,1672700852,1672701126,274
11514,3435801763,3701350519,1672562092,1672563289,1197
10081,3780680252,3511750850,1672659699,1672660878,1179
11221,3773032706,3239779992,1672596559,1672597932,1373
10382,3902023467,3517195738,1672685307,1672688166,2859
10848,3760979523,3319436533,1672586191,1672589768,3577
9884,3780148144,3304697982,1672594258,1672596612,2354
10054,3368951504,3443102414,1672538111,1672539935,1824
10455,3278071998,3777751979,1672598338,1672601371,3033
10103,3289771213,3534102440,1672582934,1672585202,2268
10227,3304235700,3335055096,1672637136,1672639216,2080
10930,3715602742,3701925712,1672696007,1672697367,1360
11581,3516792348,3755688231,1672695139,1672697752,2613
9839,3939851140,3429409539,1672672073,1672673195,1122
11215,3516067011,3458271585,1672621128,1672623522,2394
11663,3755394177,3736987749,1672624126,1672626361,2235
10905,3804779247,3820200446,1672605794,1672607778,1984
11630,3511744756,3557653200,1672537824,1672541390,3566
11644,3770486161,3289771213,1672623372,1672625923,2551
11563,3307454562,3303772923,1672647223,1672648322,1099
10525,3793902476,3515764058,1672560943,1672562704,1761
11735,3223512565,3370512945,1672551741,1672554267,2526
11451,3714074120,3452389513,1672603032,1672605925,2893
11398,3920155862,3513293711,1672625211,1672626055,844
10954,3772251279,3776122272,1672628708,1672632041,3333
10127,3240877710,3714919471,1672533685,1672536969,3284
10123,3757378286,3510638085,1672643941,1672646486,2545
10507,3501976169,3224053840,1672630083,1672632671,2588
10400,3908331271,3924963918,1672581690,1672584450,2760
11654,3735152111,3703168159,1672623040,1672625529,2489
11597,3779503296,3905934770,1672619200,1672620164,964
10712,3701824335,3505901826,1672554232,1672554484,252
10955,3391612879,3238796398,1672600399,1672602081,1682
10924,3551972633,3773376762,1672554969,1672556632,1663
10727,3733423371,3770972037,1672692139,1672693222,1083
10506,3443102414,3856147380,1672615998,1672616949,951
11417,3791584994,3773798215,1672555377,1672555522,145
9857,3513624915,3852275715,1672690855,1672691151,296
10006,3205113625,3783443095,1672699941,1672700857,916
9849,3510542303,3350169064,1672546349,1672549717,3368
10367,3623113240,3880030249,1672632369,1672634132,1763
11420,3289258397,3382696725,1672626117,1672629677,3560
10127,3511864772,3667950469,1672620091,1672621078,987
10912,3493047640,3459951739,1672616047,1672618513,2466
11128,3306037126,3637105495,1672545161,1672546781,1620
11245,3804095239,3505175620,1672598955,1672599791,836
11465,3783067048,3738526914,1672640966,1672642432,1466
10145,3511615015,3770780655,1672632570,1672633759,1189
11197,3817038422,3435159896,1672625214,1672627423,2209
10575,3757796416,3701449715,1672637397,1672639980,2583
10464,3791222330,3500927619,1672548976,1672551037,2061
10162,3855440101,3299845453,1672677670,1672678383,713
10858,3343616490,3833520635,1672630224,1672630408,184
10081,3517902505,3354877289,1672583242,1672585279,2037
10434,3314363575,3757823215,1672578432,1672581658,3226
11774,3236512807,3770976984,1672545877,1672549044,3167
10118,3893629892,3553321027,1672636377,1672638035,1658
10806,3779212271,3665603628,1672648848,1672649855,1007
11103,3353811455,3662507634,1672667882,1672669447,1565
11473,3425545115,3668369938,1672628910,1672629657,747
10331,3858429342,3447696555,1672580073,1672581131,1058
11058,3313392810,3703737650,1672608180,1672611258,3078
10892,3772905073,3518335611,1672575299,1672578476,3177
10252,3615245840,3368176107,1672546160,1672546918,758
9966,3520824937,3510218188,1672626769,1672628218,1449
11626,3311463998,3439283360,1672611717,1672612753,1036
10321,3342031426,3500630465,1672646747,1672647404,657
10297,3417969824,3713807459,1672641834,1672641958,124
11763,3534102440,3367202274,1672570532,1672572815,2283
11453,3778738044,3773202954,1672692992,1672694682,1690
11765,3559619861,3715590997,1672622877,1672623372,495
10154,3623894390,3777304517,1672657372,1672658074,702
11514,3393909269,3778479297,1672600705,1672603958,3253
10327,3637566026,3793874490,1672588620,1672590520,1900
11593,3660496328,3397330170,1672593505,1672595910,2405
9919,3516200419,3241593146,1672641008,1672641409,401
10998,3774090455,3937854073,1672585757,1672588550,2793
10886,3501427691,3505828210,1672571002,1672573386,2384
11237,3276231633,3778838936,1672614835,1672615179,344
10478,3479402555,3822315407,1672626918,1672627039,121
10077,3413799143,3514352989,1672562962,1672564707,1745
11142,3791644831,3817120976,1672605406,1672606663,1257
10397,3792578118,3443580855,1672548723,1672549385,662
10742,3756157377,3518205307,1672625273,1672626513,1240
11591,3511864772,3972196462,1672652043,1672653743,1700
10346,3347172556,3791031227,1672678205,1672678613,408
11239,3820280594,3703104365,1672617157,1672618279,1122
10324,3884394685,3501835995,1672592672,1672595368,2696
10908,3682086200,3474350534,1672645419,1672646631,1212
10112,3409098014,3774304163,1672627704,1672628548,844
10512,3290060215,3912915644,1672536435,1672539829,3394
11013,3779604279,3511095300,1672608467,1672608908,441
10770,3393955069,3505314920,1672566412,1672568060,1648
10703,3424997707,3780173788,1672700549,1672702094,1545
10182,3518117078,3516019206,1672596763,1672597621,858
10977,3505291330,3381244346,1672666559,1672668914,2355
10350,3519356606,3442403264,1672615729,1672617896,2167
11735,3830291558,3474097405,1672696357,1672696836,479
11091,3472561941,3756675909,1672554425,1672557661,3236
10619,3665841655,3710260848,1672694609,1672696922,2313
11537,3205324639,3772262649,1672688394,1672690803,2409
11265,3897500723,3602054754,1672606050,1672607057,1007
11762,3834311054,3853275529,1672630906,1672634158,3252
11407,3710919244,3461877104,1672544704,1672547009,2305
11508,3515984911,3424997707,1672663135,1672664700,1565
11054,3204149913,3774652449,1672679213,1672682605,3392
10915,3701065296,3831864108,1672573216,1672573360,144
11726,3493679801,3756079870,1672566500,1672568776,2276
11375,3435715962,3793407883,1672613628,1672616563,2935
10511,3783368855,3443580855,1672587686,1672588938,1252
10353,3701374160,3304672737,1672625067,1672626067,1000
10273,3776200012,3662794240,1672677325,1672679179,1854
10235,3755286041,3505521491,1672573728,1672576979,3251
10005,3206217657,3352374868,1672667547,1672668060,513
10048,3912862842,3774238066,1672699330,1672699471,141
10859,3908331271,3471996194,1672694035,1672695381,1346
11768,3385006834,3416474842,1672555520,1672557430,1910
10382,3505155858,3770544738,1672685434,1672687569,2135
11331,3270502801,3273674596,1672628187,1672630532,2345
10949,3534190196,3791409441,1672550254,1672553819,3565
11291,3437286595,3246296769,1672619150,1672621448,2298
11759,3897003751,3505011956,1672584566,1672585779,1213
10543,3738429905,3520189871,1672543493,1672546414,2921
10377,3244495586,3885339157,1672571751,1672574274,2523
10435,3511198566,3273771395,1672697630,1672700267,2637
11547,3457249798,3776534957,1672566001,1672568183,2182
10528,3276499910,3776811587,1672656708,1672660088,3380
11792,3714424237,3454151554,1672598384,1672598659,275
11351,3773736248,3229621693,1672643626,1672645489,1863
11606,3736621212,3374652108,1672597005,1672598656,1651
10751,3778927933,3791106473,1672650142,1672651942,1800
11033,3305656670,3505994703,1672671064,1672672214,1150
10810,3804707712,3509663119,1672617399,1672620298,2899
9872,3515607283,3713195480,1672599202,1672600855,1653
10903,3783095041,3770715115,1672603633,1672604374,741
11348,3713858538,3710783759,1672615583,1672618907,3324
11073,3637566026,3281148858,1672665041,1672665771,730
10812,3776617627,3715441777,1672542325,1672543021,696
9978,3513111053,3738103378,1672682176,1672685283,3107
10508,3755394177,3783277159,1672647846,1672650568,2722
9954,3244397548,3778253021,1672569725,1672570936,1211
10062,3500031401,3500544306,1672549723,1672550244,521
11647,3414510793,3732846295,1672664104,1672666292,2188
11077,3385481989,3971422524,1672659658,1672659734,76
10151,3924366353,3773041843,1672557613,1672560890,3277
10182,3783368855,3714903253,1672544419,1672547644,3225
10950,3427527462,3882905311,1672646283,1672647596,1313
10577,3772169046,3714424237,1672672149,1672674618,2469
10431,3407403080,3757378286,1672565564,1672567623,2059
11097,3792283334,3713875941,1672533776,1672534223,447
9855,3857389270,3792432094,1672689703,1672692880,3177
10125,3513092056,3855629383,1672699788,1672701804,2016
10782,3713224986,3888409038,1672688069,1672688144,75
11511,3333355914,3354015456,1672632857,1672633393,536
10526,3469778316,3606688595,1672566183,1672567247,1064
9795,3235074007,3774822697,1672590647,1672591875,1228
10015,3756991235,3299052917,1672631476,1672633189,1713
10374,3780129338,3777041132,1672615210,1672616189,979
9860,3662522808,3979115924,1672543285,1672545203,1918
11527,3505845400,3664478769,1672622906,1672625972,3066
9914,3505173665,3395565040,1672533860,1672534016,156
11446,3518088154,3904004824,1672536689,1672539782,3093
9858,3512203553,3779415433,1672657567,1672658425,858
10143,3773161055,3776727271,1672663883,1672665290,1407
10691,3419648004,3770544738,1672630570,1672632992,2422
11269,3501927452,3713100169,1672637613,1672638563,950
10632,3336225953,3715441786,1672679975,1672681004,1029
11487,3756272704,3514508773,1672640103,1672642972,2869
10283,3755107521,3388830370,1672538823,1672542306,3483
10703,3851515560,3887502536,1672597274,1672599829,2555
11337,3513996288,3505491969,1672624010,1672626113,2103
10488,3701770921,3500555856,1672539086,1672540112,1026
10168,3470135167,3203172170,1672552599,1672554147,1548
10846,3381254180,3496591885,1672691009,1672691287,278
11464,3791617239,3792785261,1672591430,1672593605,2175
10902,3927181190,3882851213,1672531482,1672531570,88
11749,3716669659,3347172556,1672678631,1672680150,1519
10456,3511296895,3776068937,1672636356,1672639762,3406
9984,3207497598,3933731871,1672659397,1672661336,1939
11587,3815700240,3934280144,1672693100,1672695709,2609
10341,3501370430,3791434207,1672558875,1672561545,2670
11156,3622218289,3434452046,1672608166,1672611397,3231
11005,3278629965,3301369282,1672537522,1672538840,1318
10481,3628423403,3770019143,1672535493,1672536238,745
11398,3552309108,3791688526,1672590192,1672592147,1955
9950,3621591266,3976400190,1672546672,1672547211,539
11064,3738873928,3772968080,1672601422,1672601638,216
10123,3553694590,3738103378,1672614661,1672617601,2940
10542,3774946684,3915652382,1672650503,1672652182,1679
11286,3780298499,3271719569,1672579536,1672582745,3209
10817,3896615831,3776593726,1672654330,1672656961,2631
11408,3776348472,3333477908,1672640669,1672640999,330
11625,3534696810,3711671702,1672676013,1672679484,3471
9985,3902292032,3417431173,1672682418,1672685662,3244
9889,3755107521,3909822999,1672561789,1672563379,1590
11136,3755170743,3405303958,1672581075,1672583382,2307
11097,3500695402,3505502819,1672667532,1672668143,611
11549,3393543588,3374348845,1672569336,1672571597,2261
11442,3715750580,3520145112,1672677726,1672677808,82
10170,3756897029,3714838100,1672582143,1672585336,3193
10876,3852014884,3476416072,1672665829,1672669218,3389
11085,3351837521,3711755596,1672559442,1672560159,717
9824,3493047640,3857909328,1672581918,1672585054,3136
11648,3932955949,3714455496,1672648481,1672652067,3586
10298,3703588004,3932566114,1672624027,1672626925,2898
9879,3441737317,3666022373,1672597675,1672600240,2565
11451,3634670780,3716389356,1672693766,1672696335,2569
9903,3884934977,3621812406,1672662982,1672663458,476
10031,3436401020,3293553295,1672541207,1672544388,3181
11021,3779340538,3778924002,1672654926,1672657270,2344
11747,3442564712,3977666815,1672567202,1672568587,1385
10631,3512087090,3710680073,1672690422,1672693307,2885
10466,3739567072,3480108752,1672656809,1672660143,3334
10466,3285971415,3791074200,1672531406,1672533483,2077
10712,3304235700,3499343927,1672540401,1672541333,932
9842,3509394912,3770172119,1672658782,1672661025,2243
10152,3818904268,3282053097,1672580189,1672580258,69
11014,3774663639,3500421940,1672584097,1672587139,3042
10570,3348100657,3511095300,1672557402,1672560187,2785
10348,3772968080,3343767438,1672636009,1672637868,1859
11003,3275274182,3518088154,1672571462,1672573699,2237
10305,3760710525,3516586325,1672535991,1672536503,512
10592,3449233346,3518088154,1672658974,1672659221,247
10657,3235470567,3534531039,1672619160,1672620953,1793
11045,3343859998,3703659324,1672673969,1672676948,2979
10160,3479402555,3509297453,1672570547,1672574046,3499
10837,3601063076,3519922921,1672689630,1672689849,219
10755,3206853747,3716891903,1672583047,1672583683,636
10494,3316551382,3382670400,1672593568,1672595986,2418
11259,3500928990,3713373455,1672553347,1672555486,2139
10721,3516378356,3890194669,1672694476,1672696273,1797
11775,3513215373,3716160006,1672562064,1672562976,912
11193,3297100323,3666655293,1672667452,1672670597,3145
11766,3912181197,3514361485,1672689436,1672691312,1876
11446,3316821313,3792475476,1672697630,1672700798,3168
11407,3703737650,3284374600,1672671923,1672675168,3245
10467,3778100960,3298831109,1672650693,1672652905,2212
10339,3730115019,3610517436,1672590975,1672594409,3434
10355,3512802259,3501583486,1672544284,1672544910,626
10845,3622729771,3777439655,1672592086,1672594975,2889
10589,3604569804,3203151036,1672681106,1672683449,2343
10463,3334824744,3519463038,1672647791,1672650990,3199
10076,3715587520,3226913558,1672665102,1672667860,2758
10039,3710819760,3777263928,1672702039,1672704836,2797
10784,3716341323,3714902042,1672625482,1672627084,1602
11607,3713100169,3534374523,1672614809,1672618080,3271
10355,3736621212,3500927619,1672570654,1672572536,1882
11493,3505816624,3770530739,1672627824,1672631175,3351
11517,3810949170,3773017746,1672629369,1672630467,1098
11552,3716233100,3533440736,1672558526,1672560428,1902
11339,3714688409,3553321027,1672550960,1672551104,144
10419,3756647451,3703462221,1672623001,1672625511,2510
9865,3822634862,3772216305,1672564935,1672566838,1903
11328,3512072679,3500456339,1672607056,1672608393,1337
11757,3553321027,3711119575,1672564362,1672566193,1831
11675,3618024815,3892177203,1672597960,1672600580,2620
9864,3510454018,3711591464,1672653892,1672657357,3465
11643,3783554600,3738160394,1672565894,1672566766,872
11308,3899756737,3500741005,1672616619,1672619637,3018
11151,3533037906,3483701493,1672580024,1672580859,835
10087,3898592058,3510547682,1672649775,1672650931,1156
9996,3893950585,3343616490,1672668705,1672669989,1284
11357,3711599043,3760748418,1672643354,1672646942,3588
9904,3716179251,3756616853,1672609431,1672611825,2394
11089,3423217578,3220123678,1672633422,1672634135,713
11591,3425260097,3667072319,1672589464,1672590827,1363
10329,3777932225,3509370633,1672541577,1672541651,74
11097,3732312480,3510209505,1672572737,1672575815,3078
9874,3819400315,3443191792,1672698673,1672701470,2797
9825,3517136772,3370751461,1672575770,1672578920,3150
10152,3711258452,3373802545,1672546388,1672547343,955
10865,3909457959,3686853863,1672636423,1672636554,131
11537,3836090778,3773738817,1672540112,1672541355,1243
11308,3780467276,3732540636,1672678904,1672681345,2441
11138,3773953689,3619705594,1672616847,1672618831,1984
11040,3777204977,3500674240,1672574143,1672577493,3350
10073,3361711720,3224053074,1672634215,1672634349,134
11215,3926724515,3777932225,1672695122,1672696686,1564
9925,3770476738,3774359137,1672544779,1672547806,3027
11013,3510638085,3703415246,1672658241,1672658305,64
10805,3229465607,3513203127,1672669517,1672672648,3131
10902,3533473206,3553229537,1672702933,1672704722,1789
10099,3311409212,3829412384,1672569731,1672571772,2041
10683,3607583720,3804075198,1672614132,1672617139,3007
10741,3300810210,3471177177,1672619411,1672622169,2758
10937,3519997661,3517151644,1672534624,1672534931,307
10156,3703462221,3316821313,1672639432,1672642778,3346
10921,3713195480,3682673884,1672621849,1672623061,1212
10754,3359929534,3483701493,1672648427,1672649635,1208
10080,3515284733,3776953418,1672580348,1672581775,1427
10217,3884458862,3624872714,1672561535,1672564835,3300
11792,3500440602,3760385591,1672670711,1672671584,873
10208,3760420315,3205161801,1672562699,1672563896,1197
10840,3340897079,3500062408,1672607830,1672610043,2213
9877,3517045396,3515405509,1672565126,1672566868,1742
11356,3492056330,3791688526,1672556793,1672557057,264
11264,3488333295,3520832066,1672640853,1672642319,1466
10072,3714806574,3311045951,1672703424,1672706298,2874
9843,3791688526,3380281484,1672554318,1672557391,3073
10787,3394959062,3345954031,1672639756,1672641536,1780
10356,3366566029,3906260966,1672596940,1672597561,621
10818,3443004958,3977615973,1672595684,1672596028,344
10889,3233712975,3783095041,1672668889,1672669913,1024
9901,3505331083,3510291656,1672686195,1672686303,108
10384,3518478484,3513894659,1672681082,1672683695,2613
10016,3374348845,3435159896,1672679558,1672681943,2385
11102,3380167818,3715680249,1672661561,1672665063,3502
10298,3380628097,3458271585,1672642277,1672642680,403
11084,3513802404,3756437169,1672676558,1672676779,221
11437,3834980281,3428303756,1672540892,1672541728,836
10852,3519951586,3711243126,1672640161,1672643035,2874
11772,3428303756,3408828584,1672535246,1672537657,2411
11447,3770976984,3514327931,1672601384,1672602049,665
9988,3312946269,3510022922,1672652654,1672654802,2148
10074,3921736061,3518088154,1672656282,1672658536,2254
11674,3682086200,3711856534,1672613190,1672613859,669
10108,3755779925,3432762943,1672549919,1672552369,2450
11498,3825234433,3392010033,1672617147,1672617293,146
11421,3776581518,3367526113,1672591313,1672593231,1918
10564,3760979523,3972196462,1672579961,1672581275,1314
11034,3791548838,3793332600,1672692906,1672693840,934
11046,3444598583,3815700240,1672605467,1672608159,2692
10179,3461877104,3755203055,1672695206,1672696192,986
10606,3773878451,3711171132,1672562250,1672563923,1673
9845,3367262509,3450511428,1672645557,1672647212,1655
11751,3773534165,3793332600,1672608148,1672609145,997
10809,3783021859,3716460706,1672656231,1672657870,1639
10055,3510916875,3533340292,1672662334,1672665145,2811
10366,3624365837,3358211034,1672634827,1672636492,1665
11083,3534491112,3777758203,1672681882,1672684604,2722
9930,3714264759,3228033254,1672688324,1672690486,2162
11462,3379517265,3703694139,1672656615,1672658795,2180
10518,3770486161,3770457058,1672700905,1672701726,821
10938,3886837151,3713990030,1672651349,1672653234,1885
10418,3936486724,3716389356,1672679989,1672680998,1009
10936,3348100657,3755203055,1672665512,1672665980,468
10933,3701534043,3772786559,1672534341,1672535000,659
10966,3334708091,3760979523,1672680229,1672682917,2688
10496,3512477276,3755209597,1672574230,1672575665,1435
10098,3366433035,3533427742,1672605142,1672606458,1316
10541,3900766525,3779706467,1672536768,1672538121,1353
10245,3287920864,3311904032,1672695122,1672697465,2343
10680,3778986795,3499343927,1672540096,1672540916,820
11023,3770925016,3418367752,1672651867,1672653828,1961
10300,3385124073,3711015176,1672537256,1672539171,1915
11219,3514564903,3793569914,1672619447,1672621339,1892
11611,3500209015,3711430738,1672659716,1672661449,1733
11762,3756717136,3783357035,1672593343,1672596348,3005
11645,3512769522,3453519360,1672628418,1672628584,166
10244,3888523259,3352374868,1672537066,1672539419,2353
10617,3486824047,3393502004,1672580512,1672583558,3046
10750,3714903253,3243305367,1672583094,1672585778,2684
10505,3793783685,3803473387,1672688115,1672691447,3332
9830,3757199889,3733123020,1672570870,1672571295,425
10024,3305656670,3884394685,1672642629,1672644843,2214
10452,3711722554,3622654885,1672651002,1672653205,2203
11286,3533265491,3406238754,1672558986,1672561791,2805
11217,3736056340,3710919244,1672632191,1672633337,1146
10447,3778479297,3899970524,1672569688,1672571129,1441
11180,3882905311,3511750695,1672654529,1672655993,1464
11743,3791974273,3755369666,1672577735,1672578886,1151
9836,3895839169,3330188769,1672582461,1672585094,2633
10235,3680832669,3403738461,1672598903,1672600605,1702
9911,3688768189,3472173212,1672651924,1672653667,1743
11273,3505097206,3760541837,1672641201,1672644160,2959
11689,3772164469,3710223875,1672638030,1672639435,1405
11465,3776124041,3304661369,1672635287,1672636956,1669
10609,3730290851,3770715115,1672553477,1672553610,133
10006,3711852131,3622654885,1672662886,1672666023,3137
11644,3716891903,3344478603,1672687909,1672689476,1567
10713,3904045870,3783935976,1672563243,1672565674,2431
11166,3811503860,3461743188,1672636181,1672638316,2135
11610,3474350534,3477511446,1672550644,1672553809,3165
10622,3603682643,3972653129,1672564574,1672567275,2701
10339,3513850048,3510775046,1672634193,1672636267,2074
10103,3274239253,3290797257,1672656617,1672660012,3395
11593,3755175497,3714838100,1672531605,1672533995,2390
11692,3500544306,3855222429,1672608947,1672612399,3452
10838,3636885498,3450234157,1672652877,1672654736,1859
9872,3774598935,3793996996,1672640993,1672642600,1607
11657,3505502819,3711755596,1672590808,1672592592,1784
10689,3287734830,3855222429,1672547826,1672549477,1651
11218,3701769970,3511794841,1672555353,1672558200,2847
11639,3514801709,3792277399,1672538174,1672538785,611
10502,3371497614,3222364320,1672618523,1672619990,1467
11060,3614484939,3501927452,1672653362,1672656621,3259
11083,3474074188,3890638402,1672580751,1672583417,2666
10256,3434581257,3430032005,1672559202,1672559640,438
11444,3311904032,3777758203,1672675505,1672678675,3170
10546,3701596047,3715140418,1672597752,1672599410,1658
11613,3292936094,3711854614,1672552175,1672555178,3003
10090,3304447950,3783809405,1672536460,1672539390,2930
11005,3509701363,3633949990,1672634918,1672636807,1889
11088,3772112976,3703277359,1672673809,1672675942,2133
10644,3687024828,3438470128,1672544914,1672547036,2122
10496,3756113624,3626631210,1672651477,1672653865,2388
10417,3776732532,3807717766,1672641492,1672641969,477
11753,3311410533,3701291994,1672577999,1672579165,1166
10535,3450511428,3616242727,1672627481,1672629751,2270
10423,3927699036,3477582923,1672539366,1672542900,3534
11414,3347520239,3403738461,1672700259,1672700495,236
10115,3604908372,3976742903,1672671297,1672672739,1442
10714,3400793223,3661856558,1672560949,1672563146,2197
11608,3304592684,3505811269,1672674098,1672675571,1473
10165,3372236721,3621812406,1672606422,1672608083,1661
11506,3513250976,3732846295,1672537796,1672540600,2804
10775,3384151770,3414841458,1672552302,1672552850,548
10388,3235470567,3757032266,1672562679,1672566034,3355
10043,3518478484,3299743638,1672622139,1672625159,3020
10307,3553229537,3915962248,1672618677,1672620713,2036
10046,3431317400,3777112124,1672574515,1672575093,578
10448,3733243990,3309455369,1672596645,1672599331,2686
10529,3637522163,3209280342,1672632376,1672633950,1574
10510,3275274182,3730169449,1672651240,1672652579,1339
11482,3515939841,3454343398,1672577440,1672578791,1351
10749,3836586875,3760529327,1672656608,1672657147,539
10665,3777758203,3452878062,1672604232,1672606302,2070
10996,3829358750,3534937492,1672667386,1672669093,1707
10914,3886879696,3927202773,1672585821,1672588580,2759
10191,3791359168,3977880564,1672674420,1672674934,514
9863,3416474842,3773603836,1672688032,1672691244,3212
10889,3776468503,3820422111,1672582799,1672586081,3282
10130,3711287751,3756525103,1672667407,1672668776,1369
11702,3533876927,3757406215,1672700656,1672703871,3215
10304,3509394912,3716526314,1672589635,1672591077,1442
11338,3810584695,3510250740,1672694633,1672696679,2046
9829,3467232654,3445406685,1672582705,1672583656,951
11230,3509503263,3311142523,1672699510,1672703107,3597
10587,3773554767,3500342408,1672604811,1672608112,3301
11384,3635433296,3714287902,1672629447,1672629969,522
11432,3703481882,3311602936,1672546916,1672547394,478
11129,3791548838,3487779363,1672573079,1672574101,1022
10253,3774401596,3755209597,1672626549,1672628761,2212
11396,3438470128,3756367938,1672569373,1672572767,3394
9979,3710487368,3818570577,1672635956,1672637153,1197
11169,3517551721,3474350534,1672666706,1672668214,1508
10272,3479207976,3519712497,1672612155,1672614974,2819
9824,3206241691,3760416450,1672579256,1672581001,1745
10901,3432838598,3838423363,1672655835,1672656076,241
9909,3288675710,3780298499,1672592623,1672595582,2959
10863,3292050211,3972196462,1672702313,1672704159,1846
10608,3316406470,3515944817,1672677197,1672677412,215
10405,3925823748,3409514897,1672593303,1672594488,1185
9871,3757732853,3713416106,1672684576,1672684791,215
10536,3290060215,3716595760,1672559422,1672559615,193
11439,3285587972,3809194824,1672592362,1672592757,395
10775,3516026189,3772235668,1672601199,1672604010,2811
10602,3755924094,3770018912,1672642889,1672646077,3188
11712,3815440588,3445355677,1672570420,1672571457,1037
11244,3970775805,3755129708,1672539262,1672539665,403
11191,3793719515,3715246385,1672551759,1672552874,1115
11397,3512492332,3520339198,1672695565,1672695989,424
10453,3512490032,3601214648,1672670191,1672672010,1819
11417,3732440502,3760541837,1672620824,1672623847,3023
11278,3359880163,3783826338,1672603681,1672604787,1106
10157,3770574826,3685522474,1672660462,1672663709,3247
11752,3351153781,3760420315,1672630840,1672634099,3259
10237,3364683368,3601063076,1672538620,1672538888,268
11357,3510233949,3514361485,1672645760,1672646174,414
11733,3909457959,3512826895,1672600087,1672600619,532
11632,3514013999,3850005949,1672596032,1672598341,2309
10211,3493598658,3684651755,1672687476,1672690446,2970
10743,3512871568,3701529552,1672558113,1672558563,450
10748,3201957157,3514801709,1672613795,1672614883,1088
10833,3773852157,3938021614,1672571224,1672572602,1378
10596,3829761380,3278779955,1672669182,1672671689,2507
11178,3666022373,3515100211,1672625253,1672626341,1088
11244,3714516404,3714688409,1672577466,1672578873,1407
11230,3783368855,3979366845,1672601966,1672605455,3489
10667,3714838100,3826997668,1672621374,1672622428,1054
9851,3703611876,3713471446,1672542721,1672544695,1974
10980,3783238023,3369938668,1672544408,1672546528,2120
10849,3311409212,3366566029,1672610247,1672612537,2290
9974,3514508773,3302348002,1672643177,1672643881,704
10337,3701311947,3921736061,1672610509,1672612382,1873
11734,3770018912,3533009565,1672549694,1672551153,1459
10557,3791509881,3778824229,1672535133,1672537895,2762
10239,3510919509,3358434853,1672662860,1672665790,2930
11181,3792475476,3516585063,1672691176,1672692538,1362
10387,3837885956,3500922040,1672693785,1672695699,1914
11302,3514685272,3510535683,1672654780,1672657610,2830
10019,3233712975,3773826624,1672587495,1672588888,1393
11006,3409098014,3377446376,1672662426,1672665702,3276
10713,3282240901,3471177177,1672603750,1672605429,1679
9989,3438028077,3736885568,1672611150,1672612056,906
10597,3715111016,3778924002,1672537696,1672541086,3390
10820,3500928990,3730052916,1672562227,1672563287,1060
10375,3433902955,3520725149,1672682471,1672684883,2412
10773,3500342408,3716095450,1672533431,1672534564,1133
10011,3441737317,3509626590,1672685062,1672686622,1560
9956,3928508375,3533419409,1672584539,1672587372,2833
9813,3774236212,3779282072,1672695677,1672696889,1212
11659,3501171785,3813853446,1672687917,1672690289,2372
11112,3516668203,3515528947,1672538610,1672538845,235
11156,3772227820,3278430820,1672543124,1672546607,3483
11722,3473520701,3779561601,1672608908,1672612091,3183
11314,3626631210,3774359137,1672617317,1672618817,1500
11508,3510153173,3774627091,1672579751,1672580272,521
10407,3713954144,3513092056,1672689158,1672691908,2750
10037,3701171318,3779255367,1672695073,1672698278,3205
11110,3311142523,3454554552,1672653422,1672655534,2112
11141,3711854614,3780173788,1672702276,1672705293,3017
11207,3738160394,3480259863,1672636560,1672639895,3335
10001,3792627762,3444397804,1672555844,1672556670,826
11565,3666561358,3382696725,1672556617,1672558842,2225
11253,3779468781,3792719263,1672582183,1672585193,3010
10700,3757050615,3635433296,1672574703,1672577106,2403
9825,3611939581,3443191792,1672630314,1672630454,140
11706,3511078598,3513293711,1672579599,1672582856,3257
11011,3301449986,3831981073,1672570569,1672571737,1168
11098,3280208630,3311159418,1672557240,1672558567,1327
11499,3919494952,3400793223,1672589654,1672589857,203
10397,3757128722,3772980989,1672552736,1672555698,2962
10349,3792597493,3896840409,1672553937,1672555562,1625
10517,3905955166,3701675183,1672589127,1672592233,3106
10247,3739395381,3505472087,1672535462,1672537392,1930
10701,3791108593,3820422111,1672563307,1672564234,927
11308,3505887814,3755170743,1672617322,1672617769,447
11229,3832312129,3662794240,1672679594,1672680756,1162
10504,3730290851,3477951091,1672646330,1672647825,1495
10185,3714067998,3711591464,1672539545,1672540005,460
11768,3517253559,3471131277,1672684919,1672686600,1681
11539,3825526565,3774296721,1672689177,1672690129,952
10755,3276393542,3277061226,1672552379,1672555591,3212
10727,3791070926,3896615831,1672568225,1672568350,125
11746,3362385373,3368951504,1672620642,1672624081,3439
11661,3793822639,3711214982,1672692574,1672692780,206
10681,3233712975,3703742071,1672616917,1672618851,1934
10350,3515607283,3703462221,1672614692,1672616195,1503
11011,3394394262,3756066765,1672568001,1672568389,388
9885,3774304163,3778909412,1672670996,1672673990,2994
10322,3429587594,3615846003,1672532812,1672536376,3564
11124,3621960662,3732312480,1672563148,1672563981,833
11607,3394357241,3343511947,1672622993,1672626540,3547
10799,3201502111,3609644043,1672695819,1672696399,580
10808,3299847117,3908883591,1672546228,1672546848,620
10231,3791332226,3774822697,1672691408,1672692126,718
11370,3793232021,3534068874,1672554942,1672555261,319
10320,3424997707,3770544738,1672639069,1672641894,2825
10582,3505709407,3418367752,1672680729,1672682921,2192
10311,3509912164,3716994924,1672547759,1672549663,1904
11405,3520009158,3470997293,1672695832,1672698473,2641
11531,3206377955,3519356606,1672665181,1672666928,1747
11558,3505331083,3534667712,1672645330,1672646693,1363
10856,3518759318,3514306458,1672531857,1672532377,520
10547,3285515107,3520049965,1672643081,1672644915,1834
10019,3916955566,3783679478,1672679929,1672682551,2622
11680,3342495377,3330799389,1672632812,1672634497,1685
11666,3288346356,3909632424,1672648165,1672648995,830
11166,3395505794,3778817220,1672699008,1672699544,536
10737,3776166086,3513508737,1672628832,1672631530,2698
10760,3487231844,3463729805,1672606467,1672609646,3179
10059,3776124041,3368848936,1672638502,1672639986,1484
11193,3297684667,3856316719,1672642746,1672645249,2503
10344,3924583142,3773523569,1672629090,1672632211,3121
11538,3358959807,3710185376,1672640195,1672643676,3481
10765,3896859936,3374652108,1672626891,1672630219,3328
11343,3703168159,3372617110,1672674934,1672675102,168
10987,3371132167,3228477490,1672701623,1672701727,104
10175,3520009158,3517645656,1672674604,1672677201,2597
11373,3882851213,3893950585,1672645409,1672646815,1406
10241,3559125467,3369938668,1672582846,1672585662,2816
10621,3783947742,3519167605,1672546986,1672547719,733
9962,3824657614,3713807753,1672602203,1672604797,2594
10072,3520779124,3776279305,1672610072,1672612982,2910
11689,3364302157,3917243005,1672608999,1672611906,2907
9861,3509186338,3922430928,1672623738,1672626124,2386
10956,3932566114,3814770073,1672665326,1672667089,1763
9910,3509377714,3637522163,1672540461,1672542743,2282
11359,3925792265,3520057139,1672653747,1672656498,2751
9946,3756168814,3514571807,1672565791,1672565894,103
10786,3834311054,3501828287,1672580714,1672582475,1761
9968,3710147457,3779312237,1672641139,1672644021,2882
9852,3774304163,3888523259,1672691322,1672693649,2327
11586,3773432494,3409078869,1672614186,1672614726,540
10926,3934611532,3851451801,1672684573,1672687639,3066
10570,3832902787,3683677062,1672532735,1672535123,2388
9843,3400903513,3205161801,1672584404,1672586080,1676
10480,3295748489,3851515560,1672573562,1672575780,2218
11467,3774304163,3631444265,1672657308,1672660493,3185
11310,3621960662,3505291330,1672578879,1672582394,3515
10021,3517551721,3668955834,1672702903,1672703664,761
10475,3736010012,3236563828,1672587999,1672589741,1742
11401,3510968599,3774652449,1672645953,1672648068,2115
10956,3476308535,3851515560,1672539450,1672540676,1226
11126,3557653200,3517440258,1672567677,1672571220,3543
11560,3701449715,3468066881,1672617846,1672618381,535
9974,3736010012,3511750850,1672557990,1672560414,2424
10332,3361926328,3783176874,1672620281,1672623241,2960
11714,3533131937,3760854788,1672693586,1672696193,2607
10462,3778817220,3711349327,1672579558,1672581327,1769
10796,3291446384,3519848902,1672697547,1672699484,1937
10262,3501976169,3519260216,1672581901,1672582557,656
9825,3716233100,3935444008,1672632867,1672633721,854
11660,3519908593,3368176107,1672647962,1672650068,2106
11205,3291153514,3515259326,1672532327,1672533397,1070
11498,3760901975,3505173665,1672568088,1672568305,217
10962,3825526565,3518368900,1672589359,1672590976,1617
10400,3393376416,3714065165,1672703373,1672704369,996
11002,3534278019,3772648837,1672597958,1672601061,3103
11534,3710296607,3791074200,1672646409,1672647772,1363
9890,3472561941,3757497708,1672610973,1672611156,183
10943,3519831322,3736010012,1672646622,1672646934,312
10205,3736036532,3316406470,1672539125,1672542581,3456
11706,3371184929,3714731729,1672676335,1672677117,782
10992,3756843139,3229621693,1672694028,1672697357,3329
10359,3293553295,3660246433,1672634272,1672634461,189
11380,3715441777,3275751794,1672646232,1672647573,1341
11036,3495446254,3231654754,1672630374,1672633270,2896
10524,3791206902,3516535558,1672632581,1672633769,1188
11023,3837888196,3779561601,1672697017,1672698608,1591
10966,3511650296,3423217578,1672606806,1672610324,3518
10615,3509614126,3774221318,1672693058,1672694272,1214
11340,3443521234,3374348845,1672657278,1672657739,461
10551,3509252934,3202787155,1672617244,1672618813,1569
11292,3510022922,3897851509,1672684220,1672686615,2395
10212,3971996397,3520470646,1672657761,1672658524,763
10929,3756740153,3369810091,1672693970,1672695782,1812
10157,3500595432,3756675909,1672581667,1672581786,119
10952,3466620548,3355430975,1672696899,1672699357,2458
10891,3360783381,3500429731,1672675360,1672677646,2286
11131,3558264627,3519922921,1672685191,1672687002,1811
11133,3701956841,3514341451,1672690190,1672690731,541
11242,3517151644,3519055736,1672688385,1672688605,220
10426,3915460293,3390537737,1672702868,1672705891,3023
11316,3701171318,3296970170,1672540976,1672543005,2029
10574,3227059650,3450234157,1672604879,1672606147,1268
9804,3896840409,3884933821,1672675384,1672675904,520
10368,3615742989,3927202773,1672640729,1672642884,2155
11534,3791574640,3514353133,1672539578,1672541598,2020
10892,3514698862,3614944981,1672581445,1672583695,2250
11312,3770497768,3825234433,1672570486,1672572647,2161
10584,3791359168,3367109648,1672639170,1672640075,905
11239,3792851584,3406101720,1672546648,1672547796,1148
9994,3783695231,3714787207,1672665968,1672666630,662
11304,3703896751,3810584695,1672667757,1672670359,2602
11700,3372079985,3304028109,1672568866,1672572391,3525
11506,3613781977,3517253559,1672538198,1672538308,110
11725,3756066765,3777135415,1672648893,1672650549,1656
11327,3715680249,3783879023,1672580325,1672583440,3115
10189,3615742989,3756781024,1672570141,1672573600,3459
10156,3533822490,3424988692,1672549363,1672549636,273
11522,3689223632,3417223898,1672607369,1672610650,3281
11158,3208594306,3505908965,1672686682,1672689139,2457
9891,3519521903,3856975623,1672560744,1672562765,2021
11697,3505936495,3501171785,1672607658,1672608603,945
10486,3779723939,3244395841,1672543685,1672545509,1824
10400,3772188086,3605905645,1672604776,1672605610,834
10981,3510680251,3278779955,1672681625,1672682525,900
10248,3479207976,3711214982,1672582405,1672585537,3132
10728,3710861700,3855077502,1672532500,1672534871,2371
11509,3779255367,3792719263,1672577064,1672580440,3376
10279,3509208005,3287968403,1672566428,1672568558,2130
10758,3665431349,3792633495,1672561757,1672562405,648
11616,3714074120,3710515351,1672654986,1672656563,1577
10314,3912181197,3820280594,1672584634,1672587030,2396
10584,3822368676,3774483862,1672671735,1672675166,3431
9828,3371184929,3776950532,1672649579,1672652281,2702
9844,3458432407,3793822639,1672595538,1672596163,625
10081,3517448452,3714116241,1672609806,1672610941,1135
11500,3777706200,3776953418,1672623093,1672623388,295
11299,3615245840,3774939922,1672559140,1672561773,2633
11108,3449672240,3287753579,1672554506,1672557472,2966
11515,3777060250,3714838100,1672564232,1672565803,1571
11422,3756493561,3421674406,1672700825,1672703903,3078
11156,3776279305,3445077330,1672638014,1672640513,2499
11213,3927699036,3249771731,1672632474,1672633062,588
9798,3226761201,3509360869,1672664610,1672666455,1845
10634,3520473111,3779478448,1672640682,1672641093,411
10363,3511640720,3636852764,1672557791,1672558182,391
11507,3605101443,3511645260,1672590318,1672593790,3472
10001,3734233216,3711889178,1672592992,1672594650,1658
10460,3837378340,3344710271,1672581680,1672582835,1155
11016,3241567995,3408982612,1672533685,1672536297,2612
11271,3890211161,3663902064,1672663282,1672664810,1528
10096,3443102414,3467663782,1672558384,1672559977,1593
11522,3711131262,3359880163,1672557864,1672559459,1595
9846,3776304080,3244495586,1672697719,1672701262,3543
11243,3780050328,3619796619,1672557765,1672559761,1996
10016,3501205057,3701534043,1672575863,1672578981,3118
11514,3792627762,3388481990,1672667207,1672669802,2595
11004,3977615973,3779160052,1672696500,1672697612,1112
11014,3711196962,3311514075,1672654195,1672655894,1699
9795,3513661302,3899156705,1672637211,1672638658,1447
10901,3555215568,3791088014,1672668379,1672670492,2113
11230,3778544203,3534624672,1672691024,1672691688,664
10867,3792063616,3774822697,1672534135,1672536974,2839
11540,3711889178,3371184929,1672580483,1672581489,1006
10253,3316121649,3352374868,1672583852,1672583962,110
10890,3231271498,3770574826,1672659756,1672661501,1745
10488,3756437169,3711947828,1672666351,1672666484,133
10349,3500833053,3509377714,1672559918,1672560205,287
10022,3836090778,3920890008,1672703715,1672705969,2254
11412,3756428507,3517136772,1672645019,1672646752,1733
11093,3500640854,3517991042,1672597952,1672598757,805
10070,3852310652,3779174993,1672533862,1672534191,329
11569,3391612879,3777439655,1672692054,1672692556,502
10108,3779478448,3733836732,1672571687,1672573327,1640
10410,3772461583,3918981936,1672658824,1672660726,1902
11786,3511206717,3351949206,1672544037,1672544440,403
9957,3834980281,3500317923,1672649182,1672652241,3059
11618,3715106566,3445558740,1672537726,1672540913,3187
10734,3760966645,3366433035,1672665219,1672668118,2899
11630,3283785820,3710149975,1672588046,1672591065,3019
10622,3501963428,3637105495,1672579004,1672579281,277
11072,3907225070,3338187803,1672610866,1672612856,1990
10506,3499622352,3470962222,1672638171,1672640549,2378
10311,3773440794,3756948477,1672601068,1672603848,2780
11234,3829761380,3286862903,1672548955,1672551081,2126
10880,3703611876,3978417055,1672533359,1672534773,1414
11692,3404375908,3414841458,1672677673,1672678310,637
10515,3805831563,3976742903,1672655501,1672656594,1093
11587,3514685272,3379517265,1672667685,1672668401,716
10615,3772320856,3975799349,1672599200,1672601174,1974
10508,3229570647,3772556646,1672540324,1672541778,1454
9918,3734957248,3351949206,1672543263,1672544959,1696
10793,3519886257,3501174621,1672665155,1672668135,2980
11426,3501976169,3777932581,1672551534,1672554797,3263
11423,3396656251,3500674240,1672631323,1672633183,1860
10416,3772425253,3515699732,1672643221,1672643812,591
11358,3778731000,3279102372,1672614595,1672615907,1312
10966,3701769970,3756717136,1672685923,1672688412,2489
11490,3273758330,3285322570,1672612295,1672614205,1910
9796,3500864577,3513764665,1672657187,1672658913,1726
10427,3662307789,3713728777,1672662429,1672665177,2748
10195,3387388336,3826315540,1672645167,1672646668,1501
10868,3978643889,3780900318,1672563116,1672563870,754
10948,3896211741,3500057674,1672545914,1672546545,631
10692,3455955489,3714838100,1672617436,1672618803,1367
10427,3519922921,3732090606,1672633109,1672635356,2247
10807,3756536476,3505032644,1672589824,1672592910,3086
10609,3296970170,3837378340,1672617032,1672619303,2271
10013,3791587717,3287734830,1672607355,1672608066,711
11552,3773878451,3826068495,1672650301,1672652529,2228
9964,3495446254,3368176107,1672632401,1672635701,3300
9992,3514033319,3452677710,1672551105,1672553969,2864
10296,3777569538,3293553295,1672558786,1672561501,2715
10626,3511744756,3514389188,1672654482,1672654821,339
10545,3313392810,3511095300,1672688675,1672691149,2474
10024,3393128259,3500589560,1672648279,1672650334,2055
10889,3513203127,3481700413,1672685533,1672688020,2487
11698,3272827860,3293540333,1672659810,1672660196,386
10962,3274341934,3756536512,1672677311,1672679550,2239
11471,3714101349,3733836732,1672551695,1672554537,2842
10630,3505032773,3793689267,1672548594,1672550633,2039
11586,3517136772,3461630842,1672651245,1672653124,1879
10905,3519703964,3739387948,1672678549,1672679811,1262
10959,3852992961,3616403486,1672699393,1672700366,973
11519,3450735824,3919494952,1672647903,1672648297,394
10496,3505709407,3533627473,1672573883,1672576277,2394
10681,3511289729,3603682643,1672683913,1672685130,1217
11406,3509370016,3791509334,1672603019,1672603871,852
10670,3423353911,3501628472,1672556427,1672559493,3066
10739,3435342362,3832289185,1672685825,1672687650,1825
10494,3830962592,3533974355,1672602726,1672604282,1556
11318,3826997668,3714268380,1672595587,1672597815,2228
10720,3510680251,3501976169,1672682032,1672682151,119
10080,3713547793,3714116241,1672644120,1672646273,2153
10721,3358385652,3405435885,1672588871,1672590310,1439
11318,3885147558,3780563627,1672560498,1672563988,3490
11732,3662055682,3755209597,1672701459,1672703280,1821
10240,3832333115,3755670258,1672588866,1672589870,1004
10780,3347172556,3475090917,1672657467,1672658369,902
9951,3895839169,3238310644,1672700346,1672701027,681
10542,3935569749,3294164983,1672605096,1672606043,947
10426,3770180844,3817376705,1672693639,1672696398,2759
11202,3791382196,3715844082,1672696438,1672699477,3039
11350,3827981800,3533859712,1672564361,1672566563,2202
11091,3380444321,3832289185,1672536296,1672538626,2330
11239,3441683673,3776319560,1672552288,1672555868,3580
10004,3703031637,3856975355,1672533779,1672536483,2704
10560,3732540636,3778402454,1672665712,1672667559,1847
10875,3774195369,3623894390,1672643336,1672643687,351
10498,3713283029,3511907179,1672531454,1672533236,1782
10840,3514216460,3772659062,1672569118,1672572281,3163
11203,3554174421,3770631449,1672631602,1672635127,3525
11397,3244495586,3772114731,1672553045,1672554383,1338
10070,3203151036,3360309868,1672614622,1672616034,1412
10081,3620836520,3533859712,1672633983,1672636024,2041
11585,3467944159,3914926436,1672686552,1672690085,3533
10771,3713514933,3505173665,1672698749,1672699794,1045
10793,3515405509,3201957157,1672624659,1672625296,637
11431,3772909073,3516969689,1672546068,1672546519,451
9833,3520763492,3534102440,1672606757,1672609532,2775
10597,3500596577,3334461288,1672549720,1672551302,1582
11085,3533841983,3415840750,1672689787,1672693163,3376
10781,3810584695,3430399931,1672656140,1672658401,2261
11383,3772609551,3825082811,1672625463,1672626721,1258
10513,3516034245,3710807030,1672686766,1672688798,2032
10602,3514353133,3920155862,1672652791,1672653599,808
9934,3513740840,3352057037,1672560825,1672564013,3188
10052,3716197140,3919345990,1672540031,1672542102,2071
10362,3779604279,3791332226,1672572027,1672574749,2722
11517,3434581257,3316821313,1672536566,1672538609,2043
10575,3520160414,3793783685,1672537800,1672540066,2266
11709,3714312797,3555954355,1672644748,1672647326,2578
11622,3778318250,3922153821,1672545143,1672548594,3451
11202,3636605690,3801501384,1672632688,1672634093,1405
10136,3732223664,3534562354,1672574907,1672576546,1639
10502,3519997661,3209958726,1672578104,1672581196,3092
9845,3793274957,3909067335,1672559628,1672560838,1210
10235,3330318282,3201920708,1672585823,1672586032,209
10237,3711349327,3791698084,1672607994,1672610366,2372
11346,3209925780,3375905193,1672560099,1672561005,906
11685,3517627003,3715566511,1672696369,1672698864,2495
10334,3669418238,3201573194,1672672202,1672672651,449
11368,3666367524,3517132086,1672560319,1672561332,1013
11337,3311133296,3757089924,1672553893,1672555470,1577
11396,3894495222,3783727937,1672679708,1672680380,672
9817,3511864772,3290060215,1672536782,1672537991,1209
11477,3783095041,3500011591,1672672021,1672673789,1768
11305,3374147279,3517132086,1672678387,1672681074,2687
10404,3776950532,3505500665,1672630897,1672633634,2737
10296,3900195680,3289017988,1672638309,1672640870,2561
11679,3703415246,3517992521,1672621348,1672621681,333
10487,3792627762,3612042508,1672665596,1672668835,3239
10752,3311626308,3450511428,1672613408,1672614039,631
11538,3711862792,3713606829,1672552675,1672554071,1396
10634,3515706117,3885645840,1672680526,1672683339,2813
11376,3770285500,3701004302,1672551153,1672553132,1979
11785,3793442891,3715039960,1672665124,1672667808,2684
11130,3770424892,3302416197,1672541994,1672543843,1849
10230,3426207439,3519621901,1672607996,1672609006,1010
11002,3534562354,3779478448,1672602384,1672602789,405
10794,3509996827,3534531061,1672533778,1672534930,1152
9961,3247545468,3437108337,1672598039,1672601082,3043
10795,3239779992,3335139032,1672557517,1672557985,468
10897,3500145103,3710865678,1672552563,1672555257,2694
10407,3710271021,3760656396,1672609666,1672613201,3535
11129,3714101349,3919994216,1672550441,1672553475,3034
11159,3304672737,3923910914,1672659441,1672662464,3023
10986,3203457161,3713906305,1672602171,1672603181,1010
10970,3760481622,3500589560,1672660010,1672661157,1147
9854,3461931154,3713031958,1672584332,1672584829,497
11337,3710296607,3500145103,1672606641,1672607694,1053
11726,3830254808,3976225898,1672686296,1672688343,2047
10338,3779609338,3716197140,1672646315,1672648435,2120
10501,3437703650,3517756624,1672643174,1672643755,581
11494,3445077330,3533340292,1672560748,1672561404,656
10271,3220987526,3501261089,1672546069,1672547691,1622
10310,3295710494,3480270940,1672548413,1672548954,541
10330,3793920312,3687183789,1672674303,1672675435,1132
10509,3517810375,3817478012,1672546347,1672548754,2407
10756,3468281011,3301431129,1672615999,1672617201,1202
10152,3338195686,3774326754,1672606884,1672609204,2320
9861,3756740153,3404461403,1672602457,1672603963,1506
11662,3533703578,3755218683,1672689487,1672692154,2667
10679,3533703578,3221126799,1672575534,1672575982,448
10341,3273758330,3439651226,1672634516,1672637859,3343
10245,3429409539,3711862792,1672538464,1672539154,690
11409,3714640103,3393376416,1672682903,1672683818,915
10949,3793232021,3343859998,1672646528,1672646854,326
11743,3514776568,3783443095,1672700100,1672702142,2042
11787,3309455369,3402105276,1672614165,1672616410,2245
11284,3688870751,3227919286,1672596656,1672598511,1855
11304,3760390822,3534626053,1672677099,1672680652,3553
10250,3770972037,3755729826,1672578913,1672579591,678
11195,3730052916,3770486161,1672683969,1672685261,1292
11465,3792900315,3714718326,1672580724,1672581471,747
10290,3520305100,3516454693,1672546745,1672549686,2941
10101,3916924978,3773636983,1672657135,1672660270,3135
11006,3512251592,3773697080,1672556234,1672556648,414
11121,3730571757,3908464960,1672550482,1672553664,3182
10659,3778924002,3710695372,1672615914,1672616158,244
11657,3469778316,3730600658,1672561498,1672562848,1350
10038,3607583720,3359472956,1672672180,1672675061,2881
11570,3755736024,3820422111,1672631021,1672631827,806
11254,3500579482,3778838936,1672616584,1672617413,829
10280,3500456339,3619494735,1672605896,1672608795,2899
10524,3534578428,3757201538,1672608366,1672609645,1279
10316,3710223875,3516777819,1672675238,1672677080,1842
11679,3519228207,3505720915,1672539738,1672540118,380
10617,3755688231,3500833053,1672635313,1672637081,1768
10954,3780680252,3533265491,1672571058,1672571746,688
10054,3500544306,3929923442,1672622966,1672626152,3186
11273,3776710698,3380281484,1672665654,1672667315,1661
9801,3660496328,3905889514,1672693069,1672693703,634
10899,3292663993,3778125688,1672640233,1672642350,2117
10324,3633622298,3755411110,1672568797,1672571007,2210
9853,3833993674,3829412384,1672672011,1672673481,1470
10369,3463729805,3432838598,1672665486,1672667139,1653
10774,3776593726,3973138649,1672700758,1672704182,3424
11582,3930766276,3533473206,1672576215,1672578814,2599
10772,3305727497,3715249954,1672593521,1672596241,2720
11311,3756536476,3332124606,1672580883,1672581060,177
10217,3501208658,3804095239,1672636507,1672639780,3273
11334,3511526885,3515304526,1672598283,1672600369,2086
11405,3513432588,3533427742,1672587613,1672588533,920
9806,3400560073,3519689906,1672659024,1672659845,821
11671,3317190427,3534812391,1672635741,1672636384,643
11395,3517558635,3755075988,1672548648,1672549267,619
11625,3770480149,3484490325,1672608804,1672610772,1968
10925,3774251051,3509912164,1672672901,1672675152,2251
11212,3406132280,3511663572,1672635461,1672637590,2129
11520,3779169946,3500198430,1672631978,1672632951,973
10408,3500799617,3760966645,1672599956,1672603295,3339
10135,3203909360,3469778316,1672594369,1672597164,2795
10362,3756876537,3493515706,1672582029,1672583799,1770
11528,3427527462,3774606418,1672661153,1672662892,1739
11632,3736203662,3714903456,1672684583,1672687877,3294
10409,3387413950,3756668747,1672541919,1672544044,2125
10136,3783067048,3780576351,1672620570,1672621835,1265
11328,3814289471,3791574640,1672562689,1672564457,1768
10696,3500630465,3757944870,1672641976,1672644687,2711
10273,3519351747,3703737650,1672544566,1672545083,517
11413,3735422623,3511341866,1672550228,1672553352,3124
10274,3501835995,3711854614,1672546522,1672547708,1186
11224,3928508375,3780467276,1672624643,1672625277,634
9875,3505853594,3850005949,1672629441,1672631060,1619
10250,3534667712,3510373076,1672566246,1672566439,193
11594,3714264759,3757660578,1672634633,1672637676,3043
10979,3500741005,3520926977,1672634553,1672634762,209
11063,3770180844,3773134128,1672546325,1672546413,88
10399,3278779955,3779160052,1672637236,1672639096,1860
11423,3207307681,3440671139,1672616238,1672619642,3404
11000,3514013999,3510750299,1672643778,1672645320,1542
10329,3510836047,3779312237,1672593544,1672595274,1730
11767,3534499421,3739387948,1672654203,1672654810,607
11594,3534941710,3533419409,1672678312,1672680303,1991
10325,3760737203,3714838100,1672701388,1672701957,569
10247,3285587972,3602680347,1672592881,1672595140,2259
10627,3399504157,3394357241,1672608752,1672610118,1366
10117,3713621169,3516815069,1672608552,1672611777,3225
10621,3511341866,3511078598,1672662353,1672662826,473
11599,3515528947,3310712221,1672623635,1672625928,2293
11214,3520779124,3516517348,1672590241,1672591588,1347
10911,3711179193,3512492332,1672532867,1672533278,411
10982,3780050328,3418997135,1672671653,1672674397,2744
11106,3505685294,3855222429,1672613149,1672615024,1875
10196,3466492108,3783947742,1672563872,1672566103,2231
10336,3311432176,3895944547,1672652751,1672653564,813
11675,3711190257,3347760784,1672549380,1672550307,927
10119,3500589560,3770972037,1672625255,1672628529,3274
10432,3303772923,3777063455,1672636639,1672637122,483
10920,3703732445,3511907179,1672598273,1672599469,1196
11074,3774506868,3487278983,1672598069,1672600257,2188
11588,3505720915,3516535558,1672589494,1672590259,765
9799,3686860179,3919349138,1672689660,1672690292,632
10692,3669475165,3770780655,1672659853,1672661718,1865
10164,3711599043,3399430522,1672620115,1672622833,2718
10465,3710228292,3937299996,1672662503,1672665314,2811
9940,3332124606,3776249160,1672703487,1672704156,669
10941,3738760498,3380218091,1672626924,1672627678,754
10389,3371238318,3780576351,1672676099,1672676313,214
11666,3307521389,3480405740,1672553863,1672555417,1554
11229,3500062408,3500440602,1672592600,1672594231,1631
11168,3791617239,3774304163,1672562527,1672565051,2524
10379,3480560014,3825153408,1672653082,1672654428,1346
10299,3760271237,3554236075,1672597538,1672600336,2798
9808,3703168159,3739297004,1672604544,1672608008,3464
11059,3770780655,3505449070,1672600485,1672604041,3556
10559,3805704844,3533986052,1672692000,1672692443,443
9859,3817029483,3780238637,1672699937,1672701193,1256
9896,3774921252,3701311947,1672663730,1672666310,2580
11671,3419762444,3395610742,1672666215,1672667243,1028
9907,3622729771,3395610742,1672632571,1672634840,2269
9941,3360309868,3495427619,1672583046,1672585528,2482
11407,3209958726,3309178914,1672618616,1672620232,1616
10856,3779130507,3558203963,1672686638,1672689961,3323
11100,3500927619,3513143959,1672606936,1672610385,3449
11398,3287683210,3920116284,1672670583,1672672570,1987
11297,3756668747,3666561358,1672535986,1672536954,968
9979,3760346746,3384001094,1672697608,1672699630,2022
10609,3509996827,3235074007,1672567741,1672569679,1938
11553,3514341451,3905889514,1672533212,1672534669,1457
11501,3638018906,3701359045,1672587859,1672588956,1097
11268,3792475476,3513996288,1672550493,1672553693,3200
10120,3710119555,3815700240,1672544933,1672547491,2558
10365,3663505156,3932919664,1672560669,1672560939,270
11125,3357097510,3757407184,1672660113,1672660456,343
11205,3519357822,3274239253,1672671703,1672672010,307
11410,3552922094,3606804618,1672586040,1672586714,674
10985,3776968640,3304252969,1672632967,1672633481,514
11345,3703476890,3478937459,1672677416,1672680719,3303
10115,3713611960,3304447950,1672645493,1672647376,1883
10536,3380418745,3500356342,1672565961,1672569018,3057
11446,3807646028,3394976623,1672613156,1672616320,3164
11525,3756119976,3715111016,1672558784,1672561198,2414
9913,3716285196,3420854927,1672658671,1672661398,2727
10027,3201920708,3501370430,1672695938,1672699206,3268
10039,3235198316,3703168159,1672589940,1672593022,3082
11761,3304235700,3501992314,1672671694,1672672772,1078
10987,3512697456,3777304517,1672623480,1672624585,1105
9936,3777060250,3484490325,1672585404,1672586871,1467
10201,3668955834,3791574640,1672572381,1672573345,964
10034,3311410533,3402580733,1672676212,1672678271,2059
10419,3791698084,3501407804,1672678097,1672678592,495
11596,3505653701,3635599307,1672535688,1672536906,1218
11247,3501843187,3444453261,1672590239,1672590915,676
11769,3510836047,3772343750,1672581911,1672584185,2274
10275,3453519360,3783430498,1672580723,1672583219,2496
10939,3505449070,3756493561,1672638599,1672642102,3503
11403,3716609198,3511198566,1672584276,1672586020,1744
11702,3892487982,3307454562,1672690227,1672690856,629
10495,3887030182,3733423371,1672550469,1672553818,3349
10863,3755361692,3936851114,1672691734,1672695027,3293
10473,3600871715,3939422411,1672613350,1672614819,1469
10902,3970851830,3882905311,1672625924,1672626182,258
10910,3619494735,3783313202,1672581670,1672584842,3172
10075,3533131937,3454554552,1672596094,1672599369,3275
9909,3514611187,3770476738,1672642147,1672642770,623
9905,3854202447,3632094087,1672614955,1672617707,2752
9825,3370245766,3715249954,1672619930,1672620628,698
11785,3513186578,3779282072,1672592597,1672594106,1509
11467,3208962614,3772227820,1672579662,1672582034,2372
11762,3932491622,3239279744,1672574672,1672576454,1782
11718,3773041843,3319660530,1672580384,1672583203,2819
10839,3557653200,3730935770,1672672620,1672675771,3151
10449,3792107875,3501828287,1672589792,1672593220,3428
10648,3791581138,3776316903,1672696367,1672698237,1870
10260,3285971415,3911821258,1672648945,1672650728,1783
10128,3515939841,3302988745,1672616455,1672618107,1652
11692,3711176990,3375905193,1672542312,1672544363,2051
9918,3238796398,3400903513,1672702419,1672704199,1780
11524,3519357822,3445406685,1672542154,1672543064,910
11117,3516472352,3710865678,1672647382,1672648184,802
11046,3299847117,3512769522,1672558249,1672560845,2596
10590,3512337054,3772164469,1672615655,1672618178,2523
10399,3930501172,3447312353,1672667440,1672670984,3544
11191,3511750695,3519730914,1672610951,1672613307,2356
10755,3738103378,3838119022,1672547261,1672549022,1761
11567,3715680249,3452878062,1672633864,1672637302,3438
9983,3832745283,3511864772,1672640393,1672643285,2892
11118,3510694464,3776447604,1672623659,1672623829,170
11289,3908883591,3459694275,1672627858,1672628277,419
10620,3755769731,3830291558,1672696445,1672698008,1563
11322,3220123678,3201634072,1672598825,1672600982,2157
10541,3783611957,3279102372,1672560853,1672560919,66
10791,3773523569,3770976984,1672649810,1672652808,2998
10139,3793569914,3484739955,1672669066,1672670693,1627
11498,3714179543,3511750850,1672563796,1672566697,2901
10599,3770941125,3852992961,1672602943,1672603231,288
10611,3512965991,3505175620,1672637246,1672640039,2793
10577,3730226545,3774325486,1672547047,1672549877,2830
11768,3738132114,3783826338,1672669480,1672669809,329
10864,3517992521,3533037906,1672684769,1672687274,2505
11584,3511198566,3827836825,1672626023,1672628212,2189
10160,3773853619,3780982229,1672651168,1672654552,3384
10675,3439283360,3533036499,1672565305,1672566151,846
10106,3406169279,3511466117,1672556074,1672557703,1629
9844,3757994002,3756647451,1672579596,1672581842,2246
11625,3772251279,3443004958,1672650266,1672651287,1021
10379,3808849597,3517800171,1672698649,1672700174,1525
10132,3510111365,3780142207,1672551131,1672551426,295
11754,3613216900,3473520701,1672690596,1672694059,3463
11231,3512638952,3826068495,1672659197,1672660112,915
10853,3368339963,3467232654,1672602054,1672605519,3465
11019,3976742903,3408982612,1672570274,1672571286,1012
9942,3311569360,3222364320,1672634377,1672636530,2153
11659,3491527603,3240877710,1672581252,1672581666,414
11247,3778706119,3713726267,1672700413,1672703476,3063
11682,3495152069,3309415277,1672533084,1672533622,538
10884,3971996397,3478206139,1672627909,1672631103,3194
10099,3783172505,3516319492,1672537397,1672539593,2196
10152,3516103646,3922409420,1672566149,1672567051,902
10063,3617771673,3701028092,1672550919,1672554491,3572
11313,3367262509,3513293711,1672584373,1672585550,1177
10525,3666561358,3401215739,1672561084,1672563887,2803
9981,3518995270,3701521510,1672534436,1672536112,1676
10056,3550206045,3400545490,1672648183,1672649155,972
9832,3837885956,3824259677,1672552592,1672552681,89
10346,3500909455,3778713526,1672585154,1672587401,2247
11027,3471996194,3497904539,1672583306,1672585510,2204
10418,3423217578,3500776597,1672653427,1672655890,2463
11601,3466620548,3462985379,1672559783,1672560725,942
9952,3390537737,3450234157,1672644172,1672646115,1943
10148,3791994414,3660702754,1672587772,1672590040,2268
11521,3423217578,3681504869,1672573707,1672576297,2590
10956,3902357342,3777304517,1672538211,1672540275,2064
11274,3311924005,3519947298,1672608476,1672610530,2054
11173,3468066881,3309178914,1672656834,1672656906,72
10568,3205161801,3534770827,1672671675,1672672834,1159
11139,3777686966,3447938130,1672555242,1672558207,2965
11746,3534937492,3777569538,1672563514,1672566185,2671
11234,3628423403,3227956115,1672545566,1672547054,1488
11511,3338115824,3772802020,1672647181,1672649230,2049
11591,3931495845,3470135167,1672652882,1672653041,159
11430,3475090917,3387989658,1672549401,1672551727,2326
10257,3773878451,3443191792,1672531811,1672534278,2467
10969,3803473387,3731644240,1672645570,1672647564,1994
11517,3977337501,3625779003,1672533919,1672534086,167
10016,3922430928,3354968884,1672564297,1672564501,204
11633,3394357241,3278779955,1672553271,1672556007,2736
11453,3227956115,3358982831,1672632322,1672633928,1606
11717,3821082558,3519997661,1672621218,1672622386,1168
10874,3228997424,3505032644,1672672657,1672675693,3036
10363,3288791629,3294821709,1672689969,1672690327,358
9977,3520832066,3505173665,1672572478,1672573263,785
10751,3501174621,3931917809,1672600754,1672601057,303
10233,3430310785,3715039960,1672671741,1672672568,827
11187,3713996094,3342031426,1672661997,1672662622,625
10646,3896615831,3289258397,1672603279,1672604111,832
10285,3511466117,3370448531,1672661394,1672662375,981
10280,3512645289,3349475873,1672547357,1672550397,3040
11764,3739297004,3772844451,1672645145,1672647585,2440
10764,3897186782,3711171132,1672702437,1672703944,1507
10136,3772909073,3779975575,1672597669,1672599134,1465
11337,3495152069,3906075386,1672552703,1672555750,3047
10668,3774236212,3500456339,1672574982,1672575578,596
11408,3519948471,3773432494,1672559562,1672562507,2945
10218,3772131127,3792972270,1672618348,1672621211,2863
10647,3306491253,3714806574,1672595097,1672597008,1911
10837,3757513651,3407398464,1672650817,1672651504,687
11148,3757639274,3624164232,1672648624,1672651792,3168
10817,3665603628,3400560073,1672674685,1672677420,2735
10976,3428076194,3520049965,1672564245,1672566984,2739
10388,3318224774,3515470462,1672631551,1672631819,268
10124,3716095450,3270502801,1672663222,1672664428,1206
10700,3776124041,3730290851,1672695904,1672697142,1238
11141,3429047448,3881579907,1672581910,1672585192,3282
11507,3703624327,3342545285,1672604577,1672608167,3590
11630,3414841458,3713374884,1672585059,1672586285,1226
9965,3851737350,3518534560,1672638054,1672639281,1227
11268,3370401047,3374147279,1672615886,1672618819,2933
11392,3360837082,3710807030,1672562956,1672564960,2004
10864,3755378125,3512101369,1672558682,1672561245,2563
11006,3222357355,3520016705,1672690395,1672692557,2162
9885,3366164642,3517551721,1672606952,1672607617,665
11224,3916955566,3760731595,1672698976,1672701816,2840
11439,3398021818,3511580693,1672622102,1672622806,704
10399,3475560058,3409098014,1672648020,1672650123,2103
11378,3686081254,3688410383,1672671495,1672674136,2641
11126,3519341916,3760966645,1672654216,1672656644,2428
11109,3703749690,3384601925,1672690929,1672694456,3527
9958,3515804844,3370245766,1672666947,1672668435,1488
10542,3533113740,3281935691,1672610722,1672612342,1620
11355,3501574882,3714595459,1672652481,1672654873,2392
9873,3302929858,3760979523,1672560065,1672562262,2197
10886,3774436159,3792283334,1672629027,1672631886,2859
9860,3461630842,3757678397,1672655448,1672657818,2370
10935,3369558911,3756991235,1672545034,1672545757,723
11525,3780733404,3909504515,1672561962,1672564515,2553
11528,3711190257,3779415433,1672595391,1672596791,1400
10731,3392010033,3334936138,1672589406,1672589728,322
9802,3500018566,3776841808,1672549846,1672550665,819
9943,3287753579,3278071998,1672574959,1672575060,101
10985,3438818153,3458130310,1672654270,1672655055,785
10433,3388481990,3601214648,1672639567,1672641606,2039
10697,3639081201,3465227623,1672553031,1672554758,1727
10890,3902682060,3613936929,1672635080,1672637624,2544
11400,3792283334,3479207976,1672566519,1672568773,2254
10397,3711015176,3793442891,1672692185,1672695106,2921
11743,3778195766,3662354016,1672559810,1672560508,698
11339,3711040761,3516321814,1672558094,1672559759,1665
10058,3791289855,3510542303,1672695268,1672698402,3134
11712,3519831322,3713606829,1672680844,1672682360,1516
10960,3489205994,3399726243,1672537007,1672539166,2159
11267,3516586325,3711671702,1672566549,1672567138,589
10477,3770976984,3668855144,1672703164,1672706614,3450
10350,3313392810,3605591994,1672698416,1672700315,1899
10807,3904045870,3882580580,1672657179,1672658921,1742
10622,3208962614,3716922925,1672654762,1672655998,1236
11552,3517253559,3461741050,1672552837,1672556178,3341
10764,3755767856,3489212992,1672535530,1672538533,3003
11592,3463729805,3714806574,1672696113,1672696443,330
9889,3243651036,3378534521,1672676950,1672677559,609
10296,3395505794,3716733618,1672553198,1672556373,3175
11724,3713031958,3342495377,1672588008,1672589120,1112
10000,3384713976,3533154906,1672581419,1672583016,1597
10124,3304030474,3755779925,1672587375,1672588649,1274
11168,3519621901,3667814788,1672674594,1672675067,473
11532,3380185102,3516319492,1672616731,1672619241,2510
11018,3510824484,3732090606,1672585201,1672585350,149
11694,3433189219,3634766042,1672613075,1672615698,2623
10350,3533473206,3509297453,1672690091,1672692152,2061
11184,3756876537,3777204977,1672540042,1672542622,2580
11688,3512417724,3716209499,1672614028,1672615720,1692
10852,3304227085,3884001167,1672638916,1672638978,62
10652,3829761380,3778273230,1672651978,1672653028,1050
11417,3710185376,3533419409,1672574937,1672575354,417
10087,3276230295,3500057674,1672609123,1672609200,77
11117,3403738461,3917811545,1672598176,1672599102,926
11005,3715261950,3779561601,1672685978,1672687062,1084
10642,3505416534,3791088014,1672666420,1672668343,1923
9920,3737685967,3772461583,1672560269,1672561336,1067
11561,3467415939,3792289287,1672664082,1672666678,2596
11021,3714074120,3510758718,1672672364,1672672544,180
10655,3311771689,3777909822,1672662062,1672662804,742
11482,3639465750,3891586951,1672592571,1672594865,2294
11574,3633949990,3776309810,1672578056,1672579615,1559
11094,3733836732,3711755596,1672633718,1672634686,968
11255,3520273299,3298831109,1672695538,1672696839,1301
10290,3447938130,3206217657,1672615250,1672617907,2657
10900,3533929043,3413511621,1672596115,1672597736,1621
10336,3755170743,3613781977,1672571459,1672571780,321
10245,3793899166,3414510793,1672692080,1672694399,2319
11379,3912878303,3793081195,1672686784,1672689826,3042
11074,3760390822,3738429905,1672570822,1672573873,3051
10216,3738132114,3776200012,1672606067,1672608455,2388
9910,3306491253,3484490325,1672602930,1672604762,1832
10382,3510143850,3427527462,1672646009,1672646103,94
10639,3974400577,3791841318,1672541383,1672542546,1163
11766,3739844610,3776001441,1672591036,1672592544,1508
10098,3776732532,3446810761,1672563878,1672566027,2149
10493,3731644240,3774316305,1672541508,1672541807,299
10523,3417360319,3513563152,1672688529,1672691977,3448
11265,3713920790,3500544306,1672615729,1672617671,1942
11449,3791409441,3236512807,1672624037,1672626108,2071
11713,3772169046,3511744756,1672675696,1672677417,1721
10232,3505496725,3500062408,1672598304,1672600501,2197
11215,3815184540,3792627762,1672676598,1672677640,1042
10367,3510836047,3403870769,1672665763,1672668102,2339
11649,3223177147,3426207439,1672642219,1672645534,3315
10887,3512251592,3415562576,1672610809,1672613916,3107
11340,3791434207,3609335008,1672551779,1672552767,988
10234,3639465750,3778561231,1672676500,1672679833,3333
10416,3939882169,3514007122,1672665648,1672666325,677
10291,3519848902,3713374884,1672551956,1672552513,557
10305,3739075176,3422314045,1672597465,1672600352,2887
10631,3755192104,3711223297,1672571855,1672573389,1534
10250,3714903456,3780074082,1672667889,1672670621,2732
10547,3715140418,3311602936,1672626843,1672629868,3025
10251,3511198566,3313392810,1672703761,1672707356,3595
10095,3520515739,3701028092,1672626908,1672629013,2105
10169,3510547682,3715712376,1672544821,1672545670,849
9961,3773475506,3288920399,1672650783,1672652019,1236
11414,3930727474,3835262447,1672596627,1672597681,1054
10930,3970851830,3514515499,1672638964,1672642070,3106
11058,3516321993,3454343398,1672693873,1672696394,2521
10736,3774965463,3776183353,1672682672,1672683505,833
10219,3500440602,3710919244,1672697918,1672700936,3018
11632,3716095450,3793926338,1672647541,1672649561,2020
11584,3792987243,3714595459,1672587710,1672587862,152
10936,3776727271,3429333292,1672616162,1672617675,1513
11293,3701675183,3305657559,1672658121,1672659121,1000
10440,3443102414,3299847117,1672679731,1672680328,597
10423,3783313202,3829698950,1672585952,1672587970,2018
10693,3206241691,3370751461,1672595416,1672598219,2803
9845,3494748808,3278805844,1672655014,1672657382,2368
11269,3915035136,3686860179,1672627381,1672630479,3098
11633,3701065296,3516257130,1672582299,1672583689,1390
10345,3340723781,3701675183,1672660409,1672662102,1693
11245,3302879906,3631444265,1672579967,1672583468,3501
10717,3779413388,3772966919,1672596653,1672600109,3456
11722,3773032706,3783730769,1672653474,1672654996,1522
11643,3533440294,3791088014,1672593660,1672595846,2186
11135,3209958726,3613828705,1672584275,1672584931,656
10420,3534626053,3404187438,1672568952,1672570591,1639
10415,3636605690,3318220119,1672584166,1672587701,3535
11055,3418367752,3343767438,1672541858,1672543356,1498
10709,3505839395,3367109648,1672532859,1672533272,413
10059,3400186699,3755107521,1672644618,1672648066,3448
11099,3934611532,3484739955,1672650196,1672652901,2705
11680,3791289855,3515047288,1672622312,1672625500,3188
9849,3477582923,3206377955,1672545647,1672546995,1348
10715,3623113240,3780921044,1672666978,1672667200,222
10719,3630802959,3513293711,1672531447,1672534397,2950
10003,3623067708,3469370398,1672545594,1672548465,2871
10468,3818570577,3463729805,1672650279,1672652804,2525
10400,3774448657,3792719263,1672631631,1672634739,3108
10490,3489205994,3279102372,1672586380,1672588466,2086
9865,3618024815,3701668745,1672698764,1672699358,594
10575,3500640854,3203457161,1672635515,1672637651,2136
11413,3462153833,3850735936,1672658000,1672658876,876
10406,3701475090,3512203553,1672688687,1672690773,2086
10469,3559754304,3756759239,1672657602,1672659022,1420
10524,3772234939,3756113624,1672587111,1672589187,2076
10985,3279102372,3500049870,1672590496,1672590629,133
11790,3773798215,3519780867,1672646904,1672647990,1086
11565,3354405535,3201573194,1672613249,1672614714,1465
11301,3780173788,3512154443,1672590263,1672591506,1243
10627,3292936094,3613547091,1672605121,1672606358,1237
10028,3732104286,3892487982,1672691852,1672692403,551
11352,3206217657,3738734246,1672555014,1672556197,1183
10980,3927202773,3518067857,1672643141,1672645388,2247
10808,3436018575,3514329209,1672614753,1672615504,751
9821,3623113240,3773853619,1672596366,1672597515,1149
10922,3713807753,3205908584,1672636870,1672638340,1470
11183,3479585868,3533703578,1672588730,1672589796,1066
10839,3884369346,3773434690,1672568564,1672569538,974
10208,3387700451,3780213684,1672553200,1672555179,1979
10868,3396472026,3884394685,1672603785,1672604429,644
10791,3381055770,3783594729,1672540974,1672541104,130
11418,3514021667,3246804115,1672639477,1672641288,1811
10894,3415840750,3886957097,1672659076,1672662418,3342
11607,3780213684,3487278983,1672625125,1672627979,2854
11699,3278805844,3780127017,1672555489,1672558776,3287
11680,3288675710,3783611957,1672576187,1672578764,2577
9843,3792497486,3738132114,1672636359,1672637906,1547
10380,3703502114,3510781595,1672614243,1672615913,1670
10913,3399943757,3896622009,1672687938,1672690368,2430
11514,3201419050,3517652011,1672557588,1672559313,1725
11531,3515230715,3471585513,1672534221,1672537174,2953
11399,3855222429,3773798215,1672650753,1672652682,1929
10884,3711852131,3714718326,1672608767,1672611598,2831
11113,3400793223,3344778261,1672581351,1672583479,2128
10064,3463729805,3404375908,1672668424,1672669915,1491
10376,3516340010,3317887374,1672654491,1672657892,3401
10230,3711862792,3227647190,1672657002,1672657767,765
11456,3701475090,3278430820,1672598629,1672602217,3588
11688,3611939581,3511476353,1672610624,1672614072,3448
11490,3505502819,3516321814,1672542186,1672543586,1400
10284,3444168914,3777767907,1672605646,1672606720,1074
11328,3783368855,3756647451,1672694767,1672695299,532
11112,3774448657,3510882475,1672680146,1672683566,3420
10989,3533265491,3701770921,1672652943,1672654901,1958
10536,3291617477,3517652011,1672622747,1672626281,3534
10661,3500011591,3710891331,1672534391,1672535281,890
9816,3224053840,3467944159,1672660689,1672663760,3071
9938,3408408584,3887069914,1672598397,1672599996,1599
9926,3500909455,3714455496,1672671574,1672674806,3232
10469,3440770466,3883640454,1672533682,1672533816,134
10169,3367262509,3774316305,1672539918,1672542334,2416
10135,3311133296,3270607273,1672698682,1672702257,3575
11024,3510209505,3760390822,1672606397,1672609461,3064
11005,3710119555,3774359137,1672641905,1672642524,619
11244,3907390925,3302929858,1672662234,1672664551,2317
9885,3519831322,3203151036,1672622813,1672623718,905
11730,3783373085,3624872714,1672610128,1672612557,2429
11525,3447938130,3635433296,1672644742,1672646318,1576
10633,3830291558,3452878062,1672633783,1672634398,615
10649,3834643026,3533201269,1672533544,1672536343,2799
10334,3902775449,3829761380,1672593984,1672594690,706
11272,3910354786,3926724515,1672639588,1672640214,626
10137,3505684690,3935444008,1672575955,1672576486,531
9939,3977360666,3770105006,1672637474,1672639714,2240
10329,3755170743,3310702648,1672629835,1672632819,2984
10641,3715622084,3414841458,1672539472,1672540729,1257
9984,3716118473,3512768285,1672569851,1672570795,944
11343,3429587594,3714645218,1672652372,1672653515,1143
11610,3822368676,3359880163,1672593178,1672595121,1943
10128,3500909455,3509996827,1672677905,1672681405,3500
10142,3682906048,3896211741,1672663030,1672666046,3016
11371,3432050858,3714806574,1672587168,1672589864,2696
10811,3793442891,3311514075,1672582522,1672582712,190
11082,3818236682,3293553295,1672655189,1672657403,2214
11356,3811351746,3461630842,1672667286,1672668045,759
10228,3367262509,3793719515,1672626365,1672629703,3338
10084,3774304163,3931028233,1672536801,1672538253,1452
10708,3778824229,3514007122,1672544361,1672547079,2718
11688,3777767907,3373802545,1672540822,1672544141,3319
10866,3930766276,3395505794,1672562338,1672562959,621
11725,3897500723,3477248170,1672696885,1672699902,3017
10007,3493047640,3622218289,1672588487,1672590815,2328
10609,3770476738,3710051427,1672645001,1672646923,1922
11754,3733423371,3505032773,1672689319,1672690396,1077
10318,3619705594,3792012147,1672638160,1672640947,2787
9817,3716195780,3370961012,1672595625,1672597626,2001
9956,3352374868,3513629502,1672702080,1672704674,2594
11771,3620157388,3630802959,1672678191,1672679848,1657
11067,3703438617,3711076751,1672552035,1672553375,1340
10195,3604569804,3366801723,1672596042,1672597287,1245
11658,3517960740,3939882169,1672624255,1672626281,2026
10052,3424988692,3515637968,1672598443,1672600887,2444
11536,3792708936,3701493094,1672556169,1672559097,2928
10916,3855977674,3613547091,1672622232,1672624281,2049
10172,3713219299,3701359045,1672608272,1672609713,1441
10136,3714471069,3618024815,1672596747,1672598940,2193
11315,3555763674,3440743218,1672547662,1672550713,3051
11631,3935569749,3518931700,1672679218,1672681909,2691
11163,3341311972,3278805844,1672617144,1672619145,2001
11200,3512490032,3500720752,1672691449,1672695036,3587
10315,3909504515,3931319307,1672589814,1672592815,3001
11296,3285515107,3461931154,1672541232,1672544240,3008
9954,3791628263,3896840409,1672636469,1672638730,2261
10162,3802757611,3511296895,1672542808,1672546258,3450
10671,3757406215,3631444265,1672569389,1672570741,1352
10052,3825153408,3778182724,1672640155,1672640613,458
10172,3501873139,3770533675,1672689829,1672690752,923
11423,3512753567,3553321027,1672689233,1672690729,1496
11031,3513508737,3342252701,1672685069,1672687469,2400
10022,3772291207,3233965781,1672617340,1672619066,1726
11342,3755823805,3516340010,1672688567,1672689640,1073
10556,3756119976,3711718368,1672582988,1672585921,2933
11466,3241855333,3480560014,1672678727,1672681984,3257
11275,3520470646,3854957153,1672697440,1672697637,197
9813,3515974881,3209925780,1672672553,1672673584,1031
10961,3755729826,3755175497,1672571438,1672572472,1034
11293,3770105006,3757501067,1672621094,1672622934,1840
10948,3311959533,3485468650,1672551574,1672553284,1710
10347,3516335333,3622152515,1672690664,1672692156,1492
11759,3467415939,3311331205,1672584985,1672588488,3503
9846,3515284733,3611832288,1672694098,1672694941,843
11558,3276230295,3856601074,1672617628,1672618433,805
11366,3757406215,3513111053,1672645413,1672648204,2791
10585,3809871495,3517083465,1672697278,1672698615,1337
10440,3513384042,3509394912,1672534673,1672537955,3282
9794,3617771673,3491239350,1672558716,1672560118,1402
10715,3490804766,3714595459,1672574424,1672577722,3298
10235,3823307824,3515804844,1672667856,1672670352,2496
10354,3231859576,3424988692,1672638017,1672640055,2038
10645,3501550490,3227206772,1672652435,1672656033,3598
11300,3776901443,3716468783,1672631007,1672631983,976
10530,3793783685,3281970147,1672565525,1672567501,1976
10202,3979366845,3453464785,1672690265,1672690962,697
11249,3534168768,3512641538,1672697407,1672698961,1554
11402,3783373085,3233917789,1672547737,1672548563,826
10517,3793029132,3783408830,1672654821,1672655878,1057
11371,3505416534,3602054754,1672620013,1672621376,1363
10708,3733123020,3714806574,1672613164,1672614663,1499
10677,3406492167,3931319307,1672627502,1672631083,3581
11182,3755767856,3501356814,1672633523,1672636588,3065
10798,3773714494,3777767907,1672605957,1672608997,3040
11180,3701387745,3780435349,1672622870,1672624772,1902
11620,3500591274,3791031227,1672574854,1672576014,1160
10284,3770530739,3517136772,1672657694,1672658005,311
11177,3714116241,3509360869,1672569736,1672571240,1504
10853,3701887470,3505392452,1672548962,1672549872,910
10791,3406101720,3917905192,1672543563,1672545613,2050
11629,3511311554,3755273361,1672533919,1672535550,1631
10993,3500630465,3550887623,1672536992,1672538537,1545
10729,3358959807,3271762055,1672670426,1672673478,3052
11331,3552444228,3295748489,1672660494,1672661307,813
10026,3616403486,3920890008,1672632858,1672634826,1968
10025,3440582836,3223796145,1672594039,1672596839,2800
11421,3371564186,3773891827,1672662915,1672665098,2183
11362,3304661369,3780942505,1672560354,1672563041,2687
10844,3533440736,3243763209,1672574804,1672577730,2926
10583,3855629383,3520625600,1672685053,1672685314,261
10187,3376842515,3711258452,1672585337,1672586661,1324
11457,3512343029,3779815753,1672591298,1672591594,296
10925,3510335069,3514352989,1672616767,1672619857,3090
10931,3834311054,3373135211,1672625935,1672628978,3043
11264,3616242727,3805704844,1672611810,1672614425,2615
10001,3886896755,3637522163,1672598576,1672601288,2712
10623,3814289471,3318220119,1672597721,1672600876,3155
10373,3770846374,3387971464,1672690444,1672692929,2485
11426,3310702648,3505183641,1672574775,1672578226,3451
10447,3342252701,3559123082,1672624173,1672624991,818
11446,3358675021,3475090917,1672637225,1672637432,207
10891,3505482210,3510189563,1672690386,1672692035,1649
11497,3246804115,3886957097,1672703997,1672707254,3257
10308,3837887478,3517810375,1672693406,1672696874,3468
11694,3701841013,3779393140,1672643269,1672645342,2073
10709,3836136159,3613828705,1672559359,1672560182,823
11109,3908862092,3235578852,1672562898,1672565913,3015
11497,3824657614,3425646356,1672630341,1672632146,1805
11466,3387621912,3792411831,1672625124,1672628339,3215
9975,3605591994,3778909412,1672643118,1672643588,470
11668,3446810761,3755942724,1672613799,1672614088,289
10984,3976400190,3501734800,1672689244,1672692277,3033
9801,3777932581,3783554600,1672691742,1672695268,3526
10439,3688410383,3902775449,1672582637,1672584733,2096
9885,3755688231,3501574882,1672567594,1672569893,2299
11674,3711076751,3334488428,1672687683,1672688814,1131
10623,3755942724,3713636175,1672562647,1672566224,3577
11100,3559619861,3533201269,1672535060,1672536232,1172
10321,3359929534,3773891827,1672565528,1672567435,1907
9810,3293157673,3715196780,1672632325,1672632890,565
10750,3518157683,3701512498,1672585835,1672586110,275
11334,3240877710,3515637968,1672639061,1672640649,1588
9958,3756876537,3777135415,1672653267,1672654178,911
10541,3392010033,3510535683,1672633028,1672635937,2909
11728,3755922811,3887918622,1672652099,1672652668,569
10102,3715852330,3514498259,1672655877,1672656557,680
10389,3757855416,3520182275,1672540871,1672543881,3010
10662,3701385831,3471131277,1672655737,1672656565,828
10253,3664478769,3822634862,1672612217,1672614924,2707
10856,3226761201,3392482187,1672671233,1672673576,2343
11555,3505490878,3417969824,1672690391,1672691100,709
11303,3904004824,3474350534,1672563066,1672565731,2665
10132,3513850048,3404461403,1672561593,1672563786,2193
11129,3817120976,3353326305,1672690251,1672692534,2283
9851,3714897456,3755374000,1672548592,1672549784,1192
11545,3716676869,3533960602,1672618625,1672619620,995
11650,3515304526,3779478448,1672582040,1672585342,3302
11210,3360972732,3515706117,1672693169,1672695993,2824
10839,3822315407,3822315407,1672580239,1672580794,555
10728,3662794240,3783727937,1672542013,1672542931,918
11242,3500455935,3534426696,1672544255,1672545057,802
9988,3552261072,3757128722,1672617513,1672618840,1327
10529,3917467642,3738429905,1672561938,1672563215,1277
10820,3558203963,3925835590,1672675960,1672677878,1918
10388,3519000878,3776068937,1672568973,1672570534,1561
10481,3501628472,3287760230,1672629920,1672632624,2704
11202,3509317776,3922301238,1672632437,1672635291,2854
10866,3359418136,3334936138,1672589171,1672592008,2837
10004,3435652260,3500674240,1672644897,1672645031,134
11239,3801501384,3482519872,1672573609,1672574117,508
10200,3934070285,3757201538,1672605907,1672606232,325
11262,3369482983,3716460706,1672617303,1672619751,2448
9840,3779282072,3342545285,1672647582,1672650342,2760
11302,3367526113,3780050328,1672699818,1672701791,1973
11784,3509677530,3633949990,1672564681,1672564804,123
9903,3703737650,3710865678,1672590895,1672591556,661
10451,3375324190,3311264420,1672534521,1672536781,2260
10225,3500455935,3366501813,1672603705,1672607066,3361
10998,3282240901,3519463038,1672568753,1672568884,131
10811,3447267291,3824135033,1672614209,1672617504,3295
10029,3639503148,3715622084,1672608240,1672609254,1014
9867,3417223898,3822634862,1672701730,1672704389,2659
9894,3334488428,3376842515,1672670192,1672672303,2111
10225,3924963918,3738132114,1672679693,1672682033,2340
9812,3242149533,3777937949,1672582887,1672585059,2172
10170,3319862687,3476958001,1672608957,1672609505,548
10260,3519724388,3703336988,1672692371,1672693579,1208
11426,3757872458,3510864325,1672587903,1672590373,2470
10861,3886879696,3600302127,1672684323,1672685621,1298
10571,3221290808,3667072319,1672538019,1672538953,934
10483,3714640103,3776279305,1672571983,1672574051,2068
11431,3247545468,3680832669,1672639234,1672640250,1016
11206,3776600696,3600302127,1672690432,1672691088,656
11183,3510233949,3534696810,1672693907,1672695682,1775
11501,3311133296,3559754304,1672638116,1672639379,1263
9971,3716976932,3783942518,1672697930,1672699062,1132
10774,3352057037,3397972945,1672683834,1672685962,2128
10176,3319436533,3792107875,1672604250,1672605399,1149
10047,3511864772,3685522474,1672602890,1672604943,2053
9952,3476144563,3466655775,1672544749,1672547509,2760
10997,3440401725,3557528150,1672533633,1672535297,1664
11239,3773697080,3500015630,1672560905,1672564419,3514
10251,3732596503,3518425740,1672534904,1672535180,276
11356,3701685828,3440582836,1672626626,1672629694,3068
10373,3897186782,3793860209,1672667496,1672670342,2846
10405,3300238532,3384601925,1672589286,1672592321,3035
9837,3934991640,3380185102,1672694716,1672697652,2936
10534,3755942724,3285587972,1672699055,1672702359,3304
11579,3662794240,3755584983,1672573259,1672576370,3111
10195,3779748270,3501192566,1672551620,1672554942,3322
10498,3422081502,3929002318,1672626152,1672626283,131
11463,3711287751,3660980656,1672577355,1672579110,1755
11002,3445406685,3558203963,1672648737,1672650206,1469
10940,3623894390,3500589560,1672701812,1672705396,3584
10622,3776732532,3710185376,1672542786,1672546205,3419
10890,3452389513,3774205060,1672575259,1672575352,93
11717,3934980229,3510882475,1672603119,1672605798,2679
11372,3385416697,3826315540,1672608650,1672610868,2218
11051,3780900318,3201634072,1672683598,1672684850,1252
10807,3380285779,3685396470,1672617936,1672618727,791
11530,3638126174,3713285095,1672578777,1672581580,2803
11186,3534937492,3519997661,1672660212,1672660691,479
11062,3518989186,3811351746,1672635268,1672638318,3050
11530,3822315407,3515699732,1672673475,1672674292,817
10650,3515753241,3511286390,1672600681,1672603554,2873
10792,3791121243,3774792696,1672655534,1672657373,1839
10153,3738429905,3515607283,1672684337,1672685464,1127
11728,3533473206,3366961580,1672638849,1672639725,876
10557,3756850160,3470135167,1672563701,1672564426,725
10797,3738734246,3909399636,1672565937,1672566046,109
9816,3713224038,3520009158,1672648962,1672651442,2480
10097,3511907179,3776953418,1672615823,1672619031,3208
11190,3517756624,3713224038,1672635419,1672638931,3512
10191,3701296091,3971280379,1672547721,1672549026,1305
9917,3442462115,3770276815,1672646934,1672647500,566
10889,3900766525,3714923092,1672687130,1672689634,2504
10706,3505414878,3774702364,1672573977,1672577365,3388
11714,3394959062,3703206956,1672632193,1672632720,527
10661,3757446082,3333505404,1672551961,1672554675,2714
11097,3777290300,3711810268,1672658688,1672659024,336
10567,3716733618,3505624416,1672686167,1672687718,1551
11783,3311771689,3738429905,1672696989,1672698446,1457
11674,3419762444,3770012744,1672551656,1672554762,3106
9834,3297100323,3938409715,1672604764,1672607539,2775
11143,3701512498,3609166109,1672630603,1672632871,2268
10865,3319660530,3632189887,1672699515,1672699668,153
11509,3923910914,3374652108,1672631279,1672633628,2349
9817,3340723781,3345954031,1672554719,1672556141,1422
11164,3509457543,3774326754,1672618527,1672619845,1318
9993,3309178914,3778932673,1672592995,1672594385,1390
10551,3416474842,3612841103,1672685907,1672686578,671
10870,3780168985,3755502373,1672681420,1672682717,1297
10568,3802625412,3533628528,1672586480,1672589907,3427
10478,3308965136,3760541837,1672610763,1672611307,544
10218,3780941637,3533154906,1672622239,1672622481,242
10420,3783122313,3909822999,1672664103,1672666714,2611
10498,3716801088,3520395850,1672645840,1672649146,3306
10734,3393909269,3391854325,1672607647,1672608004,357
9861,3703168159,3509208005,1672682815,1672685320,2505
9909,3202740652,3770273459,1672536377,1672539037,2660
10888,3500596577,3533209168,1672601949,1672605110,3161
11662,3305727497,3791796190,1672650977,1672652180,1203
10884,3834949242,3509073025,1672601776,1672602498,722
11723,3856975355,3908883591,1672616399,1672618711,2312
11684,3207307681,3534984243,1672573893,1672574685,792
10039,3510153173,3433902955,1672565784,1672568124,2340
9964,3519948471,3270502801,1672539437,1672542537,3100
10361,3398862999,3470135167,1672633985,1672634842,857
10407,3637566026,3505234868,1672580871,1672584137,3266
11000,3777767907,3511004622,1672551757,1672554729,2972
11009,3912878303,3792797648,1672591213,1672593925,2712
11163,3515681585,3701453343,1672614877,1672618188,3311
11601,3886896755,3450679913,1672603624,1672604451,827
10173,3399943757,3756272704,1672618687,1672619483,796
10718,3332840671,3774316305,1672619138,1672622177,3039
10358,3774450494,3802625412,1672567126,1672570444,3318
10052,3204149913,3711223297,1672664546,1672666250,1704
11693,3793874490,3459694275,1672608782,1672609251,469
9794,3308744016,3854202447,1672571383,1672574906,3523
10525,3757064623,3330188769,1672660353,1672661187,834
10824,3301765144,3480560014,1672675749,1672678410,2661
9859,3710046567,3716179251,1672607454,1672609155,1701
11690,3779212271,3839417558,1672538966,1672540524,1558
10375,3519034304,3896123242,1672554183,1672554604,421
11194,3408982612,3772877723,1672581457,1672583968,2511
9919,3534204885,3519357822,1672681517,1672683025,1508
11307,3515637968,3446810761,1672696187,1672698141,1954
10251,3520926977,3361711720,1672621980,1672625540,3560
11680,3977666815,3311449914,1672537501,1672538375,874
11294,3361635547,3791509334,1672587780,1672588111,331
11517,3804095239,3793569914,1672560014,1672561355,1341
11548,3791584994,3915652382,1672696840,1672697488,648
10895,3490953301,3513777705,1672656044,1672656456,412
10341,3760080378,3900793652,1672542996,1672546026,3030
11497,3273242177,3927202773,1672583399,1672584118,719
10358,3512087090,3515304526,1672617867,1672618695,828
11740,3669497617,3776249160,1672665351,1672665926,575
10282,3703351452,3505786561,1672697039,1672697278,239
11176,3207748225,3516359146,1672640226,1672641090,864
10348,3517551721,3534770827,1672702051,1672703222,1171
11730,3310702648,3714838100,1672568577,1672571931,3354
10462,3713611960,3510795808,1672640783,1672643601,2818
11592,3772802020,3288346356,1672613117,1672615508,2391
9901,3533225084,3511003541,1672569164,1672570782,1618
10469,3371132167,3778702093,1672669561,1672671332,1771
10435,3479452888,3925208102,1672545041,1672545639,598
10532,3553008208,3770631449,1672651117,1672652487,1370
11093,3731905251,3359472956,1672686782,1672690084,3302
10377,3505007498,3305727497,1672681946,1672682037,91
10582,3933731871,3975796415,1672569839,1672571182,1343
10194,3310737478,3714951681,1672542748,1672544834,2086
10248,3407398464,3246395239,1672566462,1672566554,92
11427,3440743218,3760648750,1672605540,1672608780,3240
10935,3501583486,3732540636,1672543085,1672544421,1336
11218,3516586325,3661856558,1672554281,1672556173,1892
10107,3501977123,3770105006,1672613411,1672613616,205
11582,3520160414,3400025324,1672609239,1672612333,3094
10165,3309178914,3927365255,1672590745,1672592099,1354
10802,3393128259,3367121615,1672586747,1672588914,2167
9921,3400903513,3755688231,1672598541,1672601517,2976
10227,3249614888,3313502623,1672689117,1672690389,1272
10292,3716179251,3300810210,1672589533,1672590575,1042
11198,3519448648,3311514075,1672627329,1672629874,2545
11143,3291617477,3905889514,1672543364,1672545976,2612
11226,3466492108,3533976217,1672571325,1672572011,686
10929,3711176990,3387322545,1672620266,1672621699,1433
9987,3290060215,3770285500,1672674127,1672676715,2588
11552,3342031426,3686853863,1672681636,1672681784,148
10969,3533209168,3783651407,1672583327,1672583658,331
10952,3716463756,3703031637,1672587811,1672590759,2948
11053,3817120976,3739844610,1672571141,1672574227,3086
11787,3681737865,3505392452,1672600544,1672602099,1555
10966,3288346356,3713920790,1672698286,1672700938,2652
11686,3534204885,3398151217,1672599892,1672601586,1694
10444,3916656185,3711889178,1672603831,1672605883,2052
10017,3437023385,3509457543,1672532907,1672535855,2948
11297,3457249798,3421524698,1672702285,1672704410,2125
10471,3366501813,3437286595,1672666704,1672668578,1874
11292,3792337863,3711856534,1672688135,1672689715,1580
11224,3505521491,3688768189,1672583086,1672583813,727
10948,3463729805,3370751461,1672541245,1672543320,2075
11475,3380167818,3779468781,1672658188,1672659580,1392
9984,3235198316,3517021928,1672571255,1672573643,2388
11376,3311432176,3757446082,1672581495,1672583881,2386
10896,3308149799,3290797257,1672535436,1672537831,2395
9872,3355880028,3491250381,1672568925,1672570895,1970
9965,3780964089,3793814153,1672581430,1672582002,572
11156,3757584114,3364948616,1672646114,1672648084,1970
10261,3517380144,3278805844,1672532900,1672534953,2053
11732,3760966645,3701265238,1672534854,1672538034,3180
11236,3500356342,3770780655,1672593758,1672595591,1833
9921,3318056480,3498857406,1672691658,1672694801,3143
11690,3618895679,3715724166,1672670601,1672674152,3551
10268,3716095450,3834980281,1672566446,1672568044,1598
10154,3377446376,3710865678,1672558054,1672560350,2296
11683,3756717136,3713807459,1672594574,1672597499,2925
11415,3450164574,3774652449,1672696260,1672697528,1268
10966,3511580693,3512681214,1672620409,1672623774,3365
10769,3517440258,3773432494,1672633431,1672636979,3548
9948,3938398160,3770486161,1672592686,1672594312,1626
11617,3780749789,3757796416,1672661014,1672664279,3265
11077,3714919471,3442403264,1672652542,1672653413,871
10309,3920890008,3514145752,1672614636,1672617852,3216
11328,3221126799,3715750580,1672540749,1672543829,3080
11189,3660163550,3716467469,1672605924,1672607835,1911
9814,3534531039,3480270940,1672615969,1672616677,708
10824,3403150349,3307535495,1672601905,1672602887,982
10711,3353811455,3204149913,1672581569,1672584867,3298
10268,3398489033,3495482863,1672583374,1672583661,287
10228,3517551721,3374552204,1672533309,1672534224,915
11697,3661359073,3711029952,1672652863,1672656348,3485
10301,3830291558,3662495290,1672693546,1672693652,106
11630,3686860179,3792008302,1672618992,1672621294,2302
10008,3880637958,3520273299,1672694939,1672696128,1189
10553,3760096466,3703336988,1672616231,1672618812,2581
10552,3380628097,3713840946,1672623789,1672624820,1031
10091,3419648004,3760731595,1672668908,1672672261,3353
10689,3772980989,3424997707,1672538849,1672540170,1321
10928,3519463038,3778125688,1672615065,1672616449,1384
10265,3368951504,3319585148,1672556633,1672557265,632
11454,3516200419,3487231844,1672539738,1672542941,3203
11150,3387971464,3681701931,1672662636,1672662991,355
10430,3471585513,3514560138,1672576299,1672576704,405
9837,3500120676,3514980025,1672662503,1672664877,2374
10844,3827981800,3505097206,1672542781,1672545194,2413
9953,3852310652,3713416756,1672620201,1672622560,2359
9813,3887030182,3807111856,1672697765,1672698711,946
9811,3760731595,3518947256,1672653287,1672655569,2282
11634,3312946269,3755129708,1672649362,1672650892,1530
11785,3927675706,3309651238,1672542549,1672544755,2206
11326,3405221863,3919814073,1672637465,1672639264,1799
9833,3385124073,3497138014,1672626253,1672628963,2710
11431,3510301454,3602401154,1672583023,1672583705,682
9817,3311696372,3519065870,1672584269,1672587747,3478
11342,3338115824,3777564559,1672634057,1672636168,2111
11597,3936871734,3701377471,1672651855,1672654084,2229
11507,3791245127,3791688526,1672597782,1672599660,1878
10376,3394394262,3880549316,1672695101,1672696317,1216
10356,3377883705,3510987684,1672544748,1672546806,2058
11428,3505351253,3319660530,1672593430,1672596116,2686
11116,3857909328,3317190427,1672666972,1672670348,3376
11701,3349319959,3703104365,1672690296,1672692058,1762
11630,3713606829,3479585868,1672700600,1672703942,3342
11595,3637566026,3475560058,1672657574,1672659865,2291
9805,3415032547,3713514933,1672549598,1672550938,1340
11734,3837887478,3478915403,1672565648,1672567710,2062
9931,3505936495,3920116284,1672630737,1672633883,3146
10076,3445733121,3444646562,1672702640,1672706143,3503
11380,3494680853,3367526113,1672588422,1672590862,2440
9942,3716982179,3223177147,1672594735,1672596270,1535
11165,3416474842,3510189563,1672624476,1672626209,1733
9828,3772169046,3731905251,1672597216,1672597524,308
11625,3520182275,3499820963,1672612526,1672614708,2182
11712,3378172464,3308965136,1672562045,1672562346,301
11146,3770972037,3710783759,1672662536,1672664978,2442
11200,3710296607,3461877104,1672684229,1672685970,1741
11464,3372596013,3776319560,1672614082,1672616638,2556
10466,3355880028,3466149998,1672685379,1672687138,1759
9910,3686860179,3734233216,1672622486,1672625306,2820
11411,3885422379,3714883746,1672659542,1672662757,3215
9884,3499998389,3510824484,1672596152,1672597417,1265
11567,3494560663,3351856699,1672663554,1672663962,408
11765,3919349138,3415562576,1672703012,1672703523,511
10338,3512857020,3701519251,1672686009,1672686374,365
11566,3520339198,3442564712,1672622888,1672625843,2955
10472,3756363182,3424997707,1672567957,1672570952,2995
11101,3819400315,3482172065,1672598226,1672598383,157
11640,3715622084,3206241691,1672688814,1672689204,390
9867,3229621693,3701725839,1672703320,1672704112,792
11403,3808442442,3459163055,1672680337,1672683819,3482
11456,3475653510,3620157388,1672655320,1672656886,1566
11607,3516319492,3405200303,1672691331,1672693669,2338
10131,3437703650,3899903158,1672642940,1672646346,3406
9962,3519055736,3972847837,1672663858,1672666654,2796
10760,3756428507,3757311529,1672692507,1672693838,1331
11593,3517949586,3439662051,1672682012,1672683697,1685
9896,3313282478,3487395357,1672652442,1672654957,2515
11544,3534278019,3306491253,1672613684,1672617155,3471
9837,3505998260,3713694278,1672602203,1672604379,2176
10095,3791587717,3772877723,1672542892,1672543203,311
10155,3680988889,3505491969,1672534239,1672537741,3502
11642,3452090950,3711767051,1672532539,1672534982,2443
10118,3760481622,3449672240,1672559710,1672560920,1210
11612,3737622701,3380218091,1672662253,1672663458,1205
10454,3853188285,3367299721,1672555482,1672558687,3205
10323,3773024346,3970265139,1672576152,1672577389,1237
10863,3773432494,3716526314,1672673140,1672673686,546
10368,3756157377,3520824937,1672662467,1672663666,1199
11447,3534174363,3513432588,1672532511,1672535972,3461
10448,3500814753,3665478011,1672624032,1672626996,2964
10207,3239279744,3512555384,1672559486,1672559709,223
10690,3857344874,3385416697,1672675574,1672676313,739
11021,3423353911,3772251279,1672646642,1672647204,562
10849,3732312480,3557129226,1672569472,1672571103,1631
11373,3516731917,3517756624,1672536327,1672536983,656
10102,3404187438,3554236075,1672532441,1672533463,1022
11069,3464622743,3441840658,1672604914,1672607963,3049
10470,3920116284,3620836520,1672627447,1672630083,2636
11510,3612705426,3703415246,1672640295,1672643101,2806
10673,3931767736,3374147279,1672536301,1672539183,2882
10081,3388774559,3793719515,1672662562,1672664469,1907
11204,3710695372,3701493094,1672668916,1672669579,663
9795,3423353911,3776001441,1672672253,1672673990,1737
11202,3208594306,3349475873,1672648337,1672649398,1061
11355,3883640904,3714179543,1672652231,1672653352,1121
11316,3770391782,3224040894,1672615440,1672615613,173
10403,3468871103,3774401596,1672557746,1672560281,2535
10672,3822496670,3500329674,1672543448,1672546134,2686
11366,3311037445,3780982229,1672623949,1672626054,2105
10112,3516517348,3836586875,1672556979,1672557760,781
10730,3208519320,3773891827,1672605269,1672607813,2544
9935,3510775046,3773424266,1672687306,1672690439,3133
10045,3895422995,3517797610,1672568736,1672570316,1580
10340,3505037247,3682086200,1672562808,1672566156,3348
10301,3927504954,3505278562,1672542367,1672543330,963
10499,3757089924,3200785194,1672560856,1672562464,1608
10460,3817038422,3519322066,1672635616,1672638955,3339
11667,3505500523,3922430928,1672633067,1672636363,3296
10607,3411355804,3606804618,1672589549,1672591851,2302
10922,3283106998,3500671218,1672580997,1672583071,2074
10194,3285322570,3792987243,1672598084,1672599216,1132
10517,3737745988,3452982957,1672572943,1672575631,2688
11581,3415840750,3757032266,1672550010,1672552251,2241
10538,3501174621,3828354855,1672604460,1672607535,3075
10009,3774035405,3313795594,1672538311,1672540371,2060
11726,3776617627,3791841318,1672629391,1672630043,652
11038,3514980025,3773440794,1672679894,1672682703,2809
11065,3318056480,3919345990,1672669155,1672672039,2884
10555,3715441777,3626631210,1672607693,1672609773,2080
10987,3772893815,3714525519,1672637628,1672640600,2972
11294,3501356814,3902357342,1672691773,1672692600,827
10305,3500555856,3783967375,1672586966,1672587894,928
10884,3937854073,3278805844,1672654159,1672656641,2482
11336,3927181190,3792173463,1672547258,1672550544,3286
11541,3501515425,3975796415,1672579535,1672581777,2242
11042,3777992576,3474350534,1672632981,1672633673,692
11233,3661359073,3934980229,1672695741,1672698354,2613
10050,3711765138,3534941710,1672608419,1672612017,3598
11432,3500251781,3776309810,1672562926,1672565637,2711
10955,3415840750,3774598935,1672532815,1672533057,242
10981,3515548696,3896840409,1672693943,1672695121,1178
10974,3886837151,3770533675,1672700446,1672703806,3360
10378,3777729184,3423800775,1672594481,1672596423,1942
9928,3241682278,3311696372,1672685710,1672685793,83
9979,3228477490,3512527440,1672537587,1672538631,1044
10258,3514455363,3499622352,1672584940,1672585248,308
10021,3908862092,3446218191,1672643865,1672645368,1503
11235,3783939161,3885339157,1672578557,1672580855,2298
11080,3512492332,3396472026,1672542926,1672545872,2946
10043,3711076751,3519924982,1672573690,1672573933,243
10483,3516655509,3711196962,1672593339,1672594330,991
11402,3505331083,3779975575,1672626780,1672628364,1584
11363,3665841655,3282240901,1672631187,1672634656,3469
11093,3756345026,3447554599,1672544568,1672546886,2318
10465,3850993995,3814770073,1672652931,1672656453,3522
10852,3512871568,3388830370,1672590749,1672593820,3071
11155,3778382224,3612705426,1672593320,1672594461,1141
10014,3772019557,3501027795,1672673980,1672676476,2496
10576,3928076270,3509208005,1672683508,1672684684,1176
10595,3513213122,3715320359,1672666487,1672668849,2362
11067,3377446376,3500799617,1672653624,1672655867,2243
10644,3683677062,3703588004,1672582821,1672583855,1034
11646,3777931341,3780435349,1672634111,1672635402,1291
10358,3774589551,3714471069,1672607117,1672607443,326
9856,3852161626,3444453261,1672679089,1672680991,1902
10432,3444295435,3760748418,1672620643,1672621025,382
9895,3904004824,3466492108,1672545920,1672549195,3275
9858,3520471156,3334824744,1672531590,1672533992,2402
10953,3802757611,3777370601,1672617501,1672617575,74
10436,3516340010,3777387533,1672595755,1672597025,1270
11455,3233917789,3334488428,1672701403,1672704409,3006
10339,3791587717,3608973523,1672672780,1672672915,135
11483,3346755179,3612841103,1672658876,1672660516,1640
10032,3278071998,3517652011,1672644551,1672647794,3243
10201,3501574882,3336225953,1672563132,1672565013,1881
11341,3810584695,3501557463,1672644537,1672648027,3490
11076,3510819040,3487395357,1672700578,1672702540,1962
10925,3925098136,3368848936,1672686599,1672687050,451
10876,3287683210,3311414429,1672533985,1672535636,1651
10709,3730226545,3710865678,1672694133,1672697041,2908
9945,3505278562,3715101177,1672683308,1672685506,2198
9862,3711856534,3923910914,1672613162,1672614833,1671
11408,3479910993,3830599959,1672604497,1672605288,791
11720,3851737350,3238796398,1672647767,1672649221,1454
11249,3714283424,3364286028,1672615655,1672617215,1560
11369,3927763819,3783043770,1672670675,1672673811,3136
10268,3553640169,3303432071,1672582046,1672584937,2891
10038,3922786716,3777387533,1672701969,1672703470,1501
11056,3919719755,3380628097,1672552377,1672555967,3590
11028,3713416106,3772216305,1672560327,1672561587,1260
10969,3880030249,3627081426,1672661668,1672664299,2631
11572,3756272704,3810818108,1672640732,1672642343,1611
11459,3338642026,3854390432,1672676164,1672676370,206
10784,3362127525,3493047640,1672549155,1672551898,2743
11466,3668720465,3514455363,1672590454,1672593018,2564
10960,3896200048,3609925909,1672582757,1672583132,375
11099,3778924002,3472718723,1672610242,1672613150,2908
10681,3710819760,3793364952,1672610767,1672611915,1148
10078,3715490209,3231227362,1672644814,1672646695,1881
11487,3514737648,3773344258,1672677381,1672680939,3558
9794,3436018575,3500741534,1672543596,1672547183,3587
10940,3970851830,3899756737,1672675791,1672679011,3220
10222,3902023467,3455955489,1672581844,1672584817,2973
11333,3713476192,3850904092,1672661676,1672662919,1243
9916,3779723939,3203457161,1672652471,1672653871,1400
10738,3293553295,3793689267,1672629469,1672629936,467
11189,3395082458,3510856388,1672648107,1672648761,654
10992,3791031227,3520189871,1672692147,1672694498,2351
10125,3856147380,3513213122,1672652454,1672652856,402
10828,3518164450,3760749218,1672634114,1672635308,1194
9839,3299052917,3919345990,1672640514,1672640701,187
11512,3511650296,3334461288,1672696456,1672697317,861
10786,3516585063,3505853594,1672639305,1672642084,2779
9862,3291936679,3519046342,1672618311,1672619240,929
10577,3379400553,3330188769,1672690155,1672690496,341
10513,3838039092,3288791629,1672549220,1672552393,3173
10578,3805718871,3416105769,1672696166,1672698444,2278
10297,3832312129,3306066522,1672680983,1672682723,1740
11585,3277061226,3466655775,1672615607,1672617000,1393
11313,3908550561,3923524564,1672546639,1672548205,1566
10584,3801379377,3241855333,1672583486,1672584233,747
10692,3935256825,3714377201,1672583744,1672584235,491
9971,3429610195,3932566114,1672608661,1672609638,977
11229,3462985379,3517045396,1672662902,1672666176,3274
11528,3630462406,3730348493,1672639893,1672643078,3185
11269,3773523569,3791368349,1672626026,1672626607,581
11267,3517331746,3800434325,1672693414,1672695059,1645
10232,3249380931,3443521234,1672683481,1672686551,3070
11626,3792597493,3685877449,1672697973,1672701000,3027
11519,3703415246,3501208658,1672643124,1672646253,3129
10328,3757604311,3311260898,1672664704,1672667134,2430
10153,3783947742,3501873139,1672626318,1672628757,2439
10173,3703742071,3757030923,1672548132,1672550388,2256
10274,3410602007,3920155862,1672626192,1672626382,190
11159,3668681400,3277634944,1672533565,1672535312,1747
11736,3774450494,3909632424,1672691176,1672693276,2100
10962,3286938590,3302988745,1672635322,1672637398,2076
10021,3247545468,3716982179,1672538701,1672538899,198
11572,3519730914,3505032773,1672535320,1672537464,2144
11227,3902292032,3295787354,1672637511,1672640408,2897
10949,3293673220,3904184638,1672545541,1672546024,483
11259,3602680347,3500015630,1672655819,1672658824,3005
11376,3426468199,3410788026,1672689174,1672690962,1788
10671,3772055279,3357074700,1672606986,1672609711,2725
10290,3837887478,3371497614,1672535202,1672535363,161
10632,3930727474,3415562576,1672551781,1672554097,2316
11104,3826997668,3378430760,1672642990,1672644345,1355
11195,3511864772,3533017131,1672686578,1672689080,2502
11611,3791509881,3711119575,1672583408,1672585101,1693
10289,3733123020,3533986052,1672534933,1672536611,1678
11775,3476416072,3791688526,1672639472,1672640953,1481
10583,3519947298,3416105769,1672648841,1672649431,590
11634,3491335890,3757311529,1672676495,1672676753,258
10194,3737571883,3396656251,1672535922,1672537398,1476
10691,3311810583,3669283586,1672643483,1672644840,1357
10599,3516167000,3711076751,1672678755,1672679430,675
11771,3825234433,3910020031,1672574373,1672576627,2254
10304,3374147279,3228465044,1672641735,1672642615,880
11625,3931028233,3511526885,1672534025,1672537155,3130
11560,3227874229,3510206323,1672678422,1672680681,2259
10043,3276231633,3491758029,1672644099,1672644571,472
10987,3440991826,3774946684,1672660388,1672660997,609
10435,3500776597,3930501172,1672631998,1672635117,3119
11181,3716118473,3408111327,1672539589,1672542598,3009
11468,3884458862,3311515179,1672540840,1672541594,754
11316,3319585148,3274223335,1672680113,1672681767,1654
10674,3520725149,3519165527,1672681274,1672682449,1175
10273,3791644831,3736056340,1672621070,1672621186,116
11447,3773394570,3304447950,1672619077,1672621986,2909
11291,3770564547,3396656251,1672601194,1672601906,712
11422,3911376818,3714640103,1672562284,1672564643,2359
9861,3903879740,3852161626,1672571899,1672572111,212
11531,3701311947,3880030249,1672540411,1672541431,1020
10337,3500051606,3366433035,1672616501,1672617310,809
11201,3606688595,3935444008,1672622921,1672624477,1556
11056,3856147380,3757001552,1672547081,1672550283,3202
11578,3519463038,3510153173,1672551913,1672552742,829
11326,3289017988,3287403291,1672676623,1672678953,2330
11471,3510143850,3714435747,1672646731,1672646855,124
10795,3905955166,3880000841,1672551486,1672554495,3009
11099,3689420679,3517949586,1672532573,1672535468,2895
9963,3369108286,3905358065,1672600821,1672603319,2498
10245,3612705426,3499820963,1672666233,1672667554,1321
11309,3403257752,3689386663,1672600980,1672603282,2302
10900,3713740434,3500726347,1672662172,1672664918,2746
10864,3713416106,3667072319,1672566069,1672568199,2130
10661,3613216900,3299847117,1672676762,1672679351,2589
10825,3481019442,3774483862,1672685125,1672686006,881
10336,3757060033,3777060250,1672591379,1672592110,731
11243,3851810349,3792107875,1672575030,1672575454,424
11628,3336225953,3285515107,1672649924,1672651426,1502
11569,3300810210,3780294116,1672609729,1672610658,929
11023,3760656396,3516335333,1672663164,1672665530,2366
9916,3452878062,3501901313,1672670549,1672672883,2334
9890,3353335252,3403035480,1672698972,1672700688,1716
11387,3891586951,3783095041,1672554849,1672558181,3332
11373,3688768189,3388915945,1672622438,1672623578,1140
11598,3514673213,3682086200,1672658245,1672658524,279
11388,3221290808,3713031958,1672578873,1672580550,1677
10226,3512681214,3308744016,1672660640,1672663401,2761
11418,3432762943,3836136159,1672662032,1672664613,2581
10145,3669918958,3817315443,1672545249,1672545631,382
11023,3519000878,3505416534,1672671668,1672675202,3534
11622,3514107131,3283295213,1672680786,1672681785,999
10764,3505531432,3636857871,1672697404,1672699856,2452
11792,3517960157,3505998260,1672594017,1672597614,3597
10002,3793934396,3757497708,1672579363,1672581176,1813
10708,3430823498,3313392810,1672668468,1672669705,1237
10536,3757378286,3491758029,1672641895,1672644849,2954
10933,3501027795,3510916875,1672574336,1672577375,3039
9994,3510826414,3368441333,1672561207,1672561733,526
10800,3711938229,3779169946,1672595817,1672599306,3489
10808,3715140418,3395615598,1672611985,1672615136,3151
10816,3738160394,3773032706,1672539829,1672542998,3169
11730,3684651755,3419378107,1672533567,1672535668,2101
11603,3936851114,3518759318,1672636866,1672639081,2215
10418,3452024572,3279851026,1672606838,1672609339,2501
9981,3791584994,3710228292,1672596848,1672597834,986
10335,3791644831,3916924978,1672679500,1672681996,2496
10716,3894328297,3376487118,1672641910,1672642117,207
10146,3516249472,3780168985,1672623094,1672623457,363
10445,3821103640,3778125688,1672579837,1672580214,377
11484,3780969898,3930766276,1672656681,1672659851,3170
11091,3378729459,3434452046,1672616809,1672618174,1365
10125,3515974881,3501126057,1672571550,1672574211,2661
10453,3452878062,3776593726,1672572968,1672576237,3269
9821,3447202943,3500329674,1672564204,1672567758,3554
10745,3760232135,3760232135,1672562945,1672563831,886
11667,3462645981,3406169279,1672618710,1672621006,2296
10656,3910190872,3770172119,1672542614,1672544109,1495
11645,3411626917,3500555856,1672604921,1672607529,2608
11064,3666367524,3793920312,1672622843,1672625594,2751
11687,3856147380,3887030182,1672614775,1672615515,740
11066,3307216611,3906874577,1672583429,1672584924,1495
11085,3716179251,3780511388,1672617145,1672617530,385
11345,3511286390,3776291254,1672620699,1672621560,861
10844,3316117186,3714312797,1672701579,1672704724,3145
10982,3352295704,3421956717,1672551260,1672552612,1352
11156,3756536512,3710149975,1672619038,1672620982,1944
10347,3770019143,3713606829,1672550944,1672551813,869
10289,3817376705,3682802569,1672553686,1672554528,842
11627,3500833053,3515507526,1672560932,1672562529,1597
10930,3832312129,3440401725,1672647461,1672649462,2001
11557,3916656185,3387621912,1672540769,1672542413,1644
11102,3760979523,3534758256,1672616507,1672618896,2389
10312,3793926338,3715724166,1672574713,1672576768,2055
11630,3352057037,3757199889,1672645377,1672648836,3459
10015,3292936094,3756647451,1672609144,1672610344,1200
11461,3304030474,3716647407,1672665328,1672665715,387
10575,3305656670,3516517348,1672567432,1672570369,2937
11212,3559754304,3714065165,1672585929,1672588974,3045
10762,3345954031,3311774510,1672645721,1672647035,1314
9982,3435159896,3295748489,1672591799,1672593599,1800
10350,3710149975,3505248368,1672599914,1672602163,2249
10618,3760979523,3703697059,1672599736,1672600561,825
11750,3514926921,3518882056,1672599023,1672599477,454
9794,3716982179,3514297012,1672595983,1672598838,2855
11729,3780287649,3760397450,1672642720,1672644826,2106
11084,3824259677,3390368796,1672624999,1672625665,666
10235,3899156705,3793081195,1672585151,1672586110,959
9800,3516932899,3711287751,1672618854,1672621257,2403
10668,3378172464,3715008501,1672621711,1672623659,1948
11668,3311515179,3710147457,1672675172,1672677955,2783
10037,3817038422,3776407517,1672670525,1672672417,1892
9912,3793899166,3311264420,1672540026,1672541411,1385
11740,3319645922,3283106998,1672673794,1672675828,2034
10018,3850181934,3909822999,1672597072,1672598550,1478
10824,3713514933,3711844574,1672544948,1672547774,2826
11313,3620836520,3776193847,1672594949,1672598309,3360
10629,3342031426,3317887374,1672603947,1672607216,3269
10155,3818532143,3606688595,1672701244,1672702490,1246
10605,3856897914,3830962592,1672643963,1672646371,2408
10652,3901169230,3703336988,1672690676,1672693420,2744
10360,3352295704,3236512807,1672559605,1672563023,3418
10590,3713740434,3779503296,1672576225,1672578604,2379
9986,3756642173,3515528947,1672577927,1672579563,1636
10426,3755192104,3519712497,1672637368,1672640314,2946
11615,3793978936,3770925016,1672648072,1672650952,2880
11225,3850181934,3852461753,1672554458,1672557883,3425
10516,3755357292,3367262509,1672645948,1672649263,3315
10142,3439283360,3205948776,1672622662,1672625420,2758
11022,3613703906,3855077502,1672661925,1672665209,3284
10229,3971051020,3397527886,1672655626,1672658236,2610
11331,3278629965,3273242177,1672658954,1672660747,1793
11785,3776440009,3382308738,1672573502,1672574572,1070
11160,3533822490,3856147380,1672688616,1672691973,3357
11761,3891586951,3777928067,1672680194,1672681750,1556
10150,3907225070,3381254180,1672633150,1672636215,3065
10842,3770497768,3613940925,1672612278,1672615003,2725
10602,3715419141,3501835995,1672589595,1672590032,437
11289,3238310644,3974668678,1672565351,1672568590,3239
10835,3836757034,3367109648,1672666610,1672666785,175
11345,3415228763,3304661369,1672646154,1672649278,3124
10960,3776867553,3559221089,1672548580,1672549801,1221
9960,3520506192,3830599959,1672545627,1672548161,2534
11130,3514564903,3512480125,1672664894,1672667280,2386
10791,3505359060,3770976984,1672690590,1672693963,3373
10258,3910354786,3310961923,1672541379,1672542984,1605
10800,3701770921,3919345990,1672625510,1672628991,3481
10605,3512087090,3416105769,1672587703,1672588805,1102
10264,3517617472,3618024815,1672585187,1672585486,299
10442,3553321027,3509370016,1672579215,1672581586,2371
11731,3776309810,3398075553,1672596447,1672598099,1652
10826,3301332095,3810949170,1672552363,1672555239,2876
10160,3711947828,3776249160,1672639398,1672641130,1732
10500,3422205569,3669427589,1672560843,1672564003,3160
9879,3776309810,3756066765,1672692170,1672692711,541
11741,3505173665,3304028109,1672570106,1672573359,3253
9839,3514853709,3509317054,1672701541,1672703775,2234
11029,3793222045,3304252969,1672619491,1672619866,375
11577,3469780362,3436401020,1672678614,1672681189,2575
10987,3518335611,3311197635,1672680583,1672681977,1394
11711,3239082508,3715126587,1672557652,1672557752,100
11524,3505867821,3347996015,1672544111,1672545874,1763
10236,3446537819,3385481989,1672620285,1672622299,2014
10528,3774355339,3374348845,1672596344,1672598370,2026
11092,3486509752,3755767856,1672674603,1672677289,2686
10996,3772845364,3770976984,1672628822,1672630249,1427
11309,3291153514,3551972633,1672699685,1672701266,1581
10620,3612841103,3231654754,1672548607,1672550490,1883
11683,3307997700,3833993674,1672698187,1672698934,747
11175,3793783685,3447948483,1672595611,1672596104,493
10559,3665603628,3220123678,1672534435,1672537384,2949
10822,3424997707,3715897627,1672659918,1672660103,185
9981,3779478448,3441737317,1672644412,1672644501,89
10562,3488399075,3908550561,1672536295,1672538007,1712
11664,3757446082,3446218191,1672590376,1672591902,1526
10588,3501612813,3374147279,1672571649,1672572041,392
10748,3422081502,3920890008,1672535354,1672536048,694
11132,3444168914,3688845298,1672600081,1672601864,1783
11680,3513802404,3837271330,1672595115,1672597276,2161
11597,3662507634,3370961012,1672691720,1672691973,253
11464,3755107521,3446233783,1672554231,1672554770,539
10579,3780423516,3505936495,1672645521,1672646060,539
9933,3713191326,3909457959,1672645763,1672646751,988
10517,3636885498,3780238637,1672534288,1672535863,1575
9973,3515984911,3922786716,1672591340,1672591479,139
10694,3701865589,3283106998,1672677693,1672678632,939
10987,3304028109,3312800145,1672679769,1672683123,3354
11555,3338187803,3501192566,1672590711,1672591092,381
10656,3836090778,3394986304,1672586752,1672586999,247
9916,3633949990,3452878062,1672555871,1672558205,2334
10538,3779609338,3777060250,1672659016,1672660065,1049
10429,3287734830,3418367752,1672594108,1672596109,2001
11061,3609335008,3462153833,1672668233,1672670427,2194
10261,3908878965,3223512565,1672557430,1672558721,1291
11002,3207497598,3779415433,1672535157,1672536766,1609
11388,3857590978,3756759239,1672637690,1672639671,1981
11170,3772223331,3461877104,1672643644,1672643751,107
10035,3275975921,3770533675,1672660237,1672660918,681
10301,3371759126,3430296808,1672688374,1672689823,1449
10565,3936871734,3338465050,1672625816,1672626935,1119
11779,3757773786,3627081426,1672696855,1672698250,1395
11483,3701725839,3343698137,1672690685,1672690929,244
10991,3824135033,3713840946,1672586632,1672587013,381
10393,3449672240,3618895679,1672679127,1672679867,740
11405,3505351253,3772695548,1672651900,1672654270,2370
11573,3756761603,3756536476,1672577293,1672580370,3077
10519,3755670258,3714067998,1672576516,1672577324,808
10388,3303747093,3773891827,1672702955,1672703855,900
11170,3710397477,3773768643,1672670962,1672673150,2188
11153,3511004622,3505331083,1672690046,1672690309,263
10008,3516454693,3516103646,1672621398,1672624122,2724
11658,3773041843,3732090606,1672571988,1672572877,889
11474,3305612422,3366801723,1672687470,1672690770,3300
10437,3553008208,3518989186,1672542984,1672544382,1398
10055,3774483862,3292050211,1672701269,1672704090,2821
10890,3711599043,3776901443,1672568260,1672571768,3508
11651,3755924094,3730459093,1672554781,1672557273,2492
10802,3488333295,3403218814,1672620094,1672621997,1903
11426,3497138014,3273771395,1672702337,1672703010,673
11723,3683514731,3405221863,1672576703,1672577615,912
11583,3501901313,3499820963,1672572745,1672575921,3176
9964,3364286028,3933469838,1672573274,1672573867,593
11506,3203909360,3516965624,1672553800,1672555572,1772
11489,3856129522,3533620069,1672688163,1672689174,1011
10495,3375905193,3975799349,1672533358,1672534583,1225
11519,3454554552,3755465396,1672697128,1672698746,1618
9965,3777931341,3366961580,1672698127,1672698432,305
10186,3710783759,3337715675,1672702279,1672703421,1142
10486,3816184951,3774921252,1672685014,1672685960,946
11379,3772291207,3806471413,1672671198,1672671285,87
10496,3756616853,3517227599,1672623991,1672627354,3363
10134,3229615214,3311197635,1672583245,1672583346,101
11228,3362385373,3316551382,1672698997,1672701006,2009
11592,3340897079,3922786716,1672665853,1672666378,525
10980,3770012744,3413511621,1672563335,1672566187,2852
10799,3791581138,3898595916,1672565304,1672568301,2997
11665,3343193067,3899756737,1672563095,1672563290,195
11450,3505482210,3730459093,1672629896,1672630787,891
10013,3369810091,3682150740,1672570210,1672571466,1256
10041,3390438262,3819315404,1672596990,1672598912,1922
10981,3772320856,3755570137,1672549476,1672551347,1871
11487,3770018912,3830599959,1672552627,1672553407,780
11534,3883640454,3422205569,1672674487,1672674785,298
11662,3755849241,3332840671,1672657217,1672657882,665
10180,3791841318,3245245283,1672639516,1672641592,2076
11769,3303772923,3713858538,1672623278,1672624550,1272
9868,3511311554,3701412729,1672641190,1672643911,2721
11248,3703742071,3510209505,1672626203,1672629574,3371
11778,3220798451,3833993674,1672626692,1672629906,3214
11661,3511078598,3429409539,1672625688,1672629124,3436
11661,3337675386,3514576083,1672562923,1672564119,1196
10292,3446066492,3349573092,1672692529,1672692955,426
10442,3501515425,3703614781,1672674440,1672677123,2683
9879,3231271498,3756717136,1672611538,1672612118,580
11359,3510856388,3424425746,1672624893,1672626385,1492
11762,3487988841,3793783685,1672625838,1672626509,671
10446,3558264627,3739567072,1672644459,1672646850,2391
10035,3224824355,3512417028,1672654060,1672655818,1758
11681,3505007498,3937299996,1672593326,1672595222,1896
11372,3511004622,3437703650,1672692532,1672695887,3355
11348,3474074188,3500455935,1672695562,1672697268,1706
11604,3511069449,3419762444,1672547084,1672549213,2129
10844,3387706541,3613547091,1672640571,1672644011,3440
10715,3778924002,3972847837,1672558863,1672562238,3375
11269,3303552616,3248409083,1672542024,1672542697,673
10976,3519463038,3275057862,1672641041,1672643692,2651
10722,3511864772,3971289056,1672595418,1672598994,3576
10376,3388946581,3757030923,1672684449,1672687934,3485
11539,3733953055,3505665253,1672680839,1672683147,2308
10266,3273758330,3512395783,1672659282,1672662401,3119
11410,3446233783,3633860380,1672618781,1672621324,2543
11505,3939882169,3734233216,1672663841,1672664149,308
11396,3711367577,3505129296,1672532904,1672534195,1291
10348,3714142299,3516867729,1672583151,1672584486,1335
10564,3900766525,3280208630,1672697308,1672698738,1430
11710,3755218683,3850993995,1672676938,1672679795,2857
10656,3710119555,3716944983,1672573103,1672574519,1416
10721,3818904268,3505836431,1672614239,1672616198,1959
10991,3602401154,3292050211,1672644743,1672646484,1741
11041,3533620069,3772786559,1672671747,1672673574,1827
10780,3514853709,3331471764,1672537756,1672538520,764
10152,3783277159,3555215568,1672542077,1672545088,3011
11221,3519965717,3824259677,1672628709,1672629295,586
11591,3512087090,3510233949,1672669739,1672672023,2284
11725,3774316305,3770972037,1672596103,1672598833,2730
10339,3398489033,3600871715,1672547069,1672549974,2905
11654,3364718040,3249380931,1672656318,1672656768,450
10755,3935333166,3825932442,1672658077,1672661447,3370
9880,3498803823,3760656396,1672540746,1672543712,2966
10722,3689223632,3755942724,1672586932,1672587652,720
11597,3479402555,3778561231,1672555566,1672558616,3050
10693,3793732968,3533566754,1672646471,1672649474,3003
11388,3358434853,3310961923,1672581104,1672582680,1576
11313,3853182912,3317190427,1672653789,1672656720,2931
11094,3241567995,3932566114,1672620397,1672623268,2871
11361,3792063616,3715602742,1672605619,1672608084,2465
10530,3371497614,3353335252,1672541880,1672545359,3479
10562,3278430820,3482687604,1672548711,1672550554,1843
11539,3811503860,3281148858,1672565848,1672566331,483
10112,3701769970,3756717136,1672572014,1672572220,206
10094,3347760784,3519448648,1672682248,1672683522,1274
9795,3520022175,3901217668,1672567018,1672568600,1582
10668,3854390432,3500688476,1672633609,1672634875,1266
10602,3241567995,3369558911,1672664304,1672666198,1894
9884,3500342408,3760385591,1672566296,1672568835,2539
10532,3352044245,3500909455,1672639590,1672641474,1884
10449,3703849264,3778932673,1672568113,1672570644,2531
10365,3970265139,3773556853,1672647167,1672647787,620
10032,3500096103,3791547827,1672595323,1672597860,2537
10848,3505482210,3711187791,1672602595,1672604352,1757
10429,3387971464,3710695372,1672604182,1672607697,3515
10225,3384170206,3713807753,1672582987,1672583801,814
10737,3514698862,3310737478,1672692797,1672694711,1914
10167,3935569749,3711947828,1672542548,1672545460,2912
10160,3518478484,3713996094,1672575237,1672577959,2722
10727,3713170867,3756119976,1672649372,1672650731,1359
11679,3780213684,3636857871,1672545258,1672545801,543
10188,3435342362,3772609551,1672537368,1672538594,1226
10022,3773953689,3500073824,1672548921,1672549048,127
10843,3779255367,3792851584,1672662852,1672664116,1264
11521,3278629965,3370401047,1672645845,1672648587,2742
11217,3937747312,3978254945,1672597379,1672599628,2249
9951,3518989186,3777928067,1672606882,1672608867,1985
9969,3806034626,3515804844,1672602712,1672605182,2470
9947,3774221318,3791236983,1672630097,1672633352,3255
11286,3776581518,3760679372,1672666322,1672669142,2820
11792,3510916875,3468201976,1672592013,1672593097,1084
10169,3916673751,3780129338,1672550236,1672552923,2687
11418,3710173412,3510178791,1672615626,1672617916,2290
10971,3511729562,3830771832,1672656967,1672659398,2431
10230,3756717136,3231654754,1672689832,1672691306,1474
10638,3505164060,3791236983,1672620845,1672624439,3594
10977,3770630937,3311774510,1672628069,1672631236,3167
10368,3603452936,3500776597,1672671232,1672674042,2810
11265,3395565040,3221736756,1672671522,1672673208,1686
10700,3925792265,3385006834,1672603656,1672605538,1882
11675,3756536476,3512371853,1672568271,1672570082,1811
11786,3241593146,3491948594,1672558702,1672560427,1725
10264,3511004622,3474097405,1672591193,1672594301,3108
11779,3311037445,3772235668,1672672997,1672673468,471
10412,3682266017,3351856699,1672629873,1672631602,1729
11002,3793783685,3684199077,1672596665,1672599080,2415
10394,3274739459,3773434690,1672622803,1672624652,1849
11423,3402774497,3772968080,1672640909,1672643077,2168
11064,3200372897,3437023385,1672624917,1672628318,3401
10017,3554317844,3738160394,1672623412,1672624202,790
11765,3513092056,3334633634,1672571929,1672574932,3003
11150,3519924982,3932491622,1672701707,1672702165,458
9877,3780074082,3792930090,1672619492,1672621191,1699
11338,3505066871,3773041843,1672564876,1672567076,2200
11057,3510939082,3500776597,1672635293,1672638385,3092
11117,3972847837,3308965136,1672689252,1672691045,1793
9940,3711862792,3505291330,1672597971,1672599360,1389
10423,3737622701,3791584994,1672600161,1672600727,566
9983,3834949242,3450679913,1672559993,1672561260,1267
10501,3505011956,3434452046,1672655244,1672656432,1188
10134,3976742903,3923524564,1672632763,1672635112,2349
11152,3201634072,3939882169,1672570694,1672573952,3258
10485,3681504869,3480560014,1672591722,1672592254,532
10460,3803382101,3501554468,1672568733,1672569283,550
11129,3369270860,3514638555,1672611169,1672613783,2614
11563,3500456339,3307997700,1672558325,1672559462,1137
11362,3602570831,3288346356,1672702466,1672704437,1971
10611,3756991235,3534604516,1672614737,1672616086,1349
10232,3791245127,3449020351,1672573958,1672577303,3345
10818,3518368900,3278629965,1672626008,1672627400,1392
10621,3760748418,3711836873,1672554424,1672555835,1411
10376,3824259677,3311331205,1672585317,1672585422,105
10437,3663353552,3779609338,1672561666,1672562480,814
11622,3605591994,3756079870,1672626560,1672627033,473
11215,3783021859,3336501403,1672553300,1672554814,1514
11401,3884001167,3791841318,1672593974,1672595906,1932
10894,3422548081,3634670780,1672665425,1672667134,1709
10854,3791236983,3856699097,1672610259,1672610612,353
11555,3400793223,3773770134,1672562086,1672565331,3245
10151,3760966645,3755209597,1672658063,1672659650,1587
11008,3518794921,3236948071,1672548359,1672551728,3369
9874,3756345026,3554437212,1672646604,1672647959,1355
11440,3301449986,3220987526,1672579669,1672583131,3462
10319,3500178849,3517325365,1672645994,1672649045,3051
10886,3890211161,3533929043,1672639156,1672640481,1325
11667,3974400577,3501980730,1672552794,1672556085,3291
10749,3514698862,3780238637,1672672312,1672673392,1080
9808,3669283586,3778195766,1672648840,1672651478,2638
10734,3533822490,3908883591,1672678130,1672678922,792
10814,3353811455,3777135415,1672690515,1672692707,2192
11540,3429315500,3776279305,1672576151,1672579109,2958
10941,3773953689,3512417028,1672658347,1672661826,3479
9824,3850005949,3505331014,1672686799,1672689339,2540
10443,3487278983,3362368123,1672579927,1672583354,3427
11474,3333505404,3311188620,1672565958,1672566186,228
11071,3621629499,3414510793,1672570250,1672570421,171
11406,3715261950,3772250554,1672570363,1672573772,3409
10029,3511615015,3500444748,1672609364,1672611994,2630
10152,3710529628,3513894659,1672614755,1672616782,2027
10565,3703462221,3301369282,1672545576,1672546111,535
10251,3913746581,3510919509,1672575958,1672576962,1004
9841,3755584983,3757064623,1672596666,1672598912,2246
9884,3633860380,3334824744,1672641318,1672641952,634
10977,3512072679,3682241594,1672566655,1672567331,676
10491,3791222330,3297100323,1672597684,1672599593,1909
10275,3760997159,3810818108,1672666276,1672669027,2751
10929,3711367577,3413236071,1672609057,1672610479,1422
10561,3713444403,3637105495,1672623391,1672626660,3269
10531,3779340538,3820280594,1672620952,1672622658,1706
10662,3387413950,3338642026,1672667229,1672670135,2906
11539,3203151036,3516535558,1672669466,1672671540,2074
10421,3783408830,3339649817,1672596985,1672597794,809
10925,3938059867,3514007122,1672576507,1672578701,2194
10167,3357097510,3302348002,1672657564,1672660017,2453
10343,3514698862,3660980656,1672578435,1672580508,2073
11324,3791974273,3288791629,1672643805,1672647013,3208
10718,3791688526,3791088014,1672591147,1672594206,3059
11540,3354877289,3814672661,1672586747,1672589303,2556
10151,3365519448,3316537706,1672627388,1672630640,3252
11765,3500356342,3974264211,1672583401,1672584054,653
10518,3757032266,3370448531,1672693946,1672694072,126
11595,3342252701,3505624416,1672701862,1672703331,1469
10900,3774965463,3731644240,1672655877,1672657354,1477
10145,3774744663,3777767907,1672644215,1672644551,336
10254,3793949077,3387700451,1672643201,1672646310,3109
11488,3668720465,3920890008,1672613317,1672616083,2766
10650,3513508737,3733243990,1672651146,1672654423,3277
10943,3558349840,3928508375,1672672774,1672673383,609
10023,3505117019,3776455762,1672638590,1672639290,700
11080,3436018575,3713224038,1672676599,1672677385,786
10391,3630462406,3510750299,1672581552,1672583541,1989
11697,3774325486,3730459093,1672595349,1672596245,896
9807,3756675909,3206241691,1672567008,1672569914,2906
11253,3493679801,3711862792,1672606583,1672608897,2314
10446,3513508737,3280208630,1672532547,1672535782,3235
10257,3510856388,3340321384,1672538258,1672539256,998
9893,3619676231,3340321384,1672607236,1672610672,3436
11201,3715140418,3479910993,1672534647,1672536062,1415
10913,3294949958,3345954031,1672668583,1672669276,693
10541,3714312797,3297100323,1672611120,1672611642,522
11271,3559754304,3733915784,1672671283,1672672378,1095
11447,3974400577,3312946269,1672625387,1672628846,3459
9938,3778370462,3853182912,1672604080,1672606770,2690
11729,3475830203,3517426473,1672608149,1672608875,726
10359,3711862792,3791994414,1672634118,1672637170,3052
11186,3360972732,3384170206,1672658717,1672661704,2987
9958,3533365834,3479585868,1672656131,1672657872,1741
11746,3311739926,3201502111,1672613627,1672613865,238
10283,3756998113,3520016705,1672638308,1672639775,1467
10486,3229465607,3739567072,1672680579,1672683774,3195
10319,3519513219,3438818153,1672547476,1672548322,846
10051,3514341451,3701374160,1672661521,1672665073,3552
11610,3856316719,3308759754,1672585938,1672586697,759
11092,3520189871,3716492409,1672582916,1672585490,2574
10965,3500073824,3669497617,1672533566,1672534486,920
10374,3468201976,3394357241,1672686830,1672689966,3136
10088,3755779925,3779778679,1672637799,1672640941,3142
10990,3445172440,3505500665,1672582016,1672584626,2610
11444,3510262025,3804075198,1672676807,1672679421,2614
10124,3855077502,3855209450,1672673900,1672675415,1515
10341,3626631210,3772695548,1672595775,1672597319,1544
11546,3923524564,3783809405,1672644459,1672644741,282
11170,3780921044,3235578852,1672638385,1672639151,766
9877,3774221318,3755942724,1672562886,1672563008,122
11426,3716669659,3714074120,1672533394,1672534492,1098
11520,3486509752,3666823095,1672566788,1672567728,940
9927,3516777819,3779604279,1672622261,1672622989,728
11584,3459694275,3534204885,1672640360,1672640422,62
10143,3400186699,3472718723,1672566822,1672569004,2182
10714,3463892928,3515528947,1672693598,1672694059,461
11751,3533777032,3921138062,1672693788,1672695611,1823
10248,3342495377,3396472026,1672660119,1672662981,2862
9862,3458130310,3533265491,1672559447,1672560033,586
11549,3520697518,3274894848,1672690016,1672692804,2788
10159,3297100323,3756157377,1672700060,1672701020,960
9918,3755378125,3387971464,1672543570,1672543688,118
11576,3427741923,3245755569,1672602797,1672605230,2433
10999,3370448531,3338465050,1672677338,1672678193,855
10149,3352295704,3397330170,1672541614,1672545142,3528
10213,3736203662,3668720465,1672557119,1672558308,1189
10306,3519102732,3834980281,1672548130,1672548790,660
10687,3249380931,3475090917,1672549739,1672553332,3593
11665,3228575883,3358675021,1672696621,1672700021,3400
10162,3939422411,3371759044,1672666808,1672667776,968
9834,3514628916,3366566029,1672550853,1672552203,1350
11739,3713923960,3703502114,1672555990,1672558944,2954
10705,3908550561,3472018395,1672648890,1672650544,1654
11150,3445077330,3534174363,1672648790,1672650854,2064
10778,3388537708,3422959249,1672590055,1672592251,2196
11360,3517810375,3227874229,1672689708,1672691277,1569
10335,3241682278,3311774510,1672551438,1672554534,3096
9804,3927699036,3757407184,1672650121,1672653184,3063
10096,3500031401,3330318282,1672592617,1672595906,3289
10997,3883640454,3279851026,1672532411,1672534264,1853
10383,3450621820,3357496255,1672664372,1672665989,1617
10626,3772893815,3770172119,1672578283,1672579590,1307
9811,3772708314,3777878462,1672551458,1672553557,2099
10389,3385416697,3284483177,1672548393,1672550558,2165
10797,3246381831,3710228292,1672673670,1672676628,2958
10042,3716463756,3516359146,1672557016,1672558761,1745
11704,3500096103,3509701363,1672610805,1672612323,1518
11429,3776791436,3510750299,1672703902,1672706205,2303
11623,3701004302,3409078869,1672633187,1672636151,2964
11719,3245882008,3517632796,1672689051,1672690549,1498
11326,3226913558,3927763819,1672541541,1672543508,1967
10231,3417223898,3465227623,1672561777,1672564479,2702
10182,3500931474,3519000878,1672591427,1672592891,1464
9800,3853188285,3770972037,1672577561,1672580048,2487
10151,3496352027,3479207976,1672641786,1672644155,2369
11076,3780171640,3715881104,1672638636,1672640169,1533
10156,3792512768,3305093237,1672579662,1672582820,3158
10718,3241682278,3701887470,1672681644,1672684270,2626
10969,3239990061,3461630842,1672650627,1672653155,2528
10704,3793364952,3423940256,1672608161,1672610167,2006
11175,3710819760,3534988162,1672629864,1672632031,2167
11441,3311045951,3359351267,1672646432,1672647763,1331
11548,3512133625,3270502801,1672544356,1672545231,875
11205,3273771395,3510159441,1672636726,1672639698,2972
11456,3234445133,3783060739,1672641013,1672641261,248
10868,3714516404,3779503296,1672604270,1672606827,2557
9852,3730169449,3776183353,1672597792,1672600380,2588
9909,3416225867,3519621901,1672561852,1672564983,3131
11255,3791222330,3908177413,1672593762,1672596343,2581
11296,3854229296,3462153833,1672531827,1672532671,844
11526,3627431396,3916656185,1672620053,1672623090,3037
11286,3454924050,3203837944,1672597186,1672599822,2636
10125,3339649817,3423353911,1672589133,1672591091,1958
9930,3715923089,3896211741,1672591041,1672592986,1945
10599,3505121295,3358982831,1672655692,1672656922,1230
10995,3819024145,3452024572,1672621872,1672623019,1147
11394,3685877449,3757869138,1672595087,1672596424,1337
10664,3518511124,3452104161,1672657507,1672661068,3561
10132,3836136159,3793704155,1672641017,1672643551,2534
10609,3428878402,3701218904,1672553833,1672555343,1510
9870,3715320359,3272096922,1672635647,1672638558,2911
10056,3534374523,3793222045,1672558475,1672558847,372
11352,3669427589,3777290300,1672655288,1672657020,1732
10760,3770972037,3534206917,1672682315,1672682523,208
11160,3287403291,3714903253,1672664625,1672665297,672
10903,3501612813,3513486828,1672592631,1672595054,2423
11509,3512641538,3716633983,1672567502,1672568915,1413
10829,3822786416,3505826673,1672566613,1672568913,2300
9892,3773714494,3393955069,1672599505,1672600066,561
10640,3238056215,3931028233,1672599563,1672602321,2758
10833,3500442370,3463564410,1672619943,1672623176,3233
10917,3500994763,3905955166,1672683363,1672684386,1023
11663,3312651192,3512395783,1672697526,1672700152,2626
9969,3509394912,3925098136,1672652236,1672653589,1353
11617,3609925909,3511198566,1672629785,1672632082,2297
10850,3770457058,3501407804,1672701199,1672703185,1986
10096,3311432176,3908177413,1672658438,1672660064,1626
9821,3501734800,3239423794,1672696997,1672697603,606
9830,3733243990,3517960740,1672599168,1672602514,3346
11451,3810818108,3852310652,1672532820,1672535854,3034
10204,3791522832,3292050211,1672576711,1672579898,3187
9912,3714787207,3905889514,1672667705,1672670510,2805
10915,3513171472,3292663993,1672652614,1672655786,3172
11026,3816184951,3501208658,1672618492,1672618924,432
9954,3520725149,3924366353,1672543963,1672546024,2061
11276,3511615015,3358473096,1672691608,1672693581,1973
11266,3512802259,3783408469,1672573598,1672577044,3446
10570,3519841427,3701028092,1672639566,1672642829,3263
10723,3358385652,3354968884,1672637990,1672638300,310
10508,3858497718,3517195738,1672630783,1672632132,1349
10010,3276230295,3302929858,1672633192,1672636071,2879
10820,3929446196,3487779363,1672683765,1672685836,2071
10106,3780013266,3661856558,1672574354,1672574646,292
10041,3812261241,3711836873,1672693197,1672696673,3476
10366,3772235668,3928076270,1672550980,1672552460,1480
10386,3516497645,3857609616,1672578219,1672581571,3352
10177,3203172170,3609335008,1672568410,1672568867,457
11637,3519689906,3310737478,1672582531,1672583279,748
9929,3501574882,3429587594,1672652517,1672654867,2350
11214,3927181190,3533974355,1672630371,1672632767,2396
10323,3446233783,3732846295,1672558743,1672561424,2681
10892,3687024828,3711214982,1672582611,1672586095,3484
11359,3534937492,3509912164,1672673599,1672675878,2279
11760,3414510793,3515803462,1672660698,1672662473,1775
9966,3825082811,3238796398,1672647229,1672649980,2751
11143,3793274957,3468066881,1672560674,1672561427,753
11063,3793442891,3773852157,1672693784,1672694214,430
9985,3776455762,3249771731,1672696731,1672700321,3590
10007,3910354786,3714453773,1672559578,1672562526,2948
10026,3311924005,3755286041,1672662417,1672662680,263
9878,3770764940,3857344874,1672601671,1672602827,1156
10107,3408111327,3774682234,1672604091,1672605690,1599
11117,3756759239,3757549235,1672612630,1672615066,2436
10348,3411213032,3710316008,1672654188,1672654802,614
10220,3776593726,3359418136,1672593535,1672596020,2485
10985,3936486724,3776867553,1672617846,1672619169,1323
10906,3835599049,3630462406,1672636294,1672636410,116
11148,3439532406,3779415433,1672692046,1672692445,399
10267,3349475873,3500734346,1672570745,1672572194,1449
11411,3773603836,3703938162,1672671248,1672672180,932
10194,3667950469,3680939042,1672618741,1672619905,1164
11529,3400025324,3900766525,1672606520,1672609630,3110
10774,3774450494,3760416450,1672573405,1672576703,3298
10061,3683562111,3303772923,1672663091,1672663643,552
10910,3509996827,3776348472,1672672837,1672675733,2896
10636,3509252934,3773344258,1672560930,1672561166,236
11777,3319436533,3533841983,1672662570,1672664262,1692
11425,3917467642,3780740477,1672643069,1672643605,536
10641,3916924978,3512857020,1672587428,1672587852,424
11608,3500062408,3856129522,1672657571,1672658089,518
10575,3931164237,3770715115,1672650191,1672653277,3086
10600,3433902955,3517083465,1672620834,1672620902,68
9952,3510233949,3793442891,1672609991,1672612791,2800
10486,3919719755,3908331271,1672588984,1672589940,956
11618,3501977123,3887030182,1672620758,1672623846,3088
11135,3311231911,3772695548,1672577835,1672578699,864
11415,3713476192,3714525519,1672696869,1672699732,2863
11524,3710046567,3204473480,1672587070,1672587268,198
10100,3920155862,3792162098,1672668963,1672671626,2663
11337,3792708936,3533077580,1672587008,1672589544,2536
9939,3511645260,3510919509,1672691997,1672694157,2160
10117,3511458926,3207748225,1672536793,1672537769,976
10924,3511580693,3635433296,1672702150,1672702612,462
9963,3439662051,3302988745,1672580931,1672583351,2420
11467,3774109138,3909457959,1672551371,1672553397,2026
9855,3275735969,3500405175,1672675407,1672676430,1023
11162,3887382548,3512306195,1672614891,1672615539,648
11281,3774663639,3756428507,1672583296,1672586474,3178
9876,3605760561,3885674996,1672664339,1672667586,3247
10667,3770991234,3520165730,1672612030,1672613090,1060
10810,3793704155,3514455363,1672693162,1672694081,919
11390,3715320359,3912181197,1672538295,1672540562,2267
10690,3519712497,3304697982,1672580975,1672581766,791
11656,3779748270,3793364952,1672539494,1672540437,943
10809,3374195945,3245755569,1672631044,1672633596,2552
11476,3776291254,3834643026,1672556343,1672558439,2096
10621,3402105276,3415803494,1672548381,1672549987,1606
11119,3247845642,3711862792,1672568324,1672570872,2548
10539,3734233216,3970265139,1672689742,1672689837,95
10846,3241593146,3351856699,1672620867,1672621055,188
11291,3917467642,3760074281,1672630548,1672630873,325
10089,3703779674,3714903456,1672561255,1672564584,3329
10034,3756536512,3905358065,1672609983,1672611042,1059
11572,3467232654,3791547827,1672672526,1672675300,2774
11374,3334708091,3838039092,1672608650,1672611450,2800
11126,3701675183,3668063289,1672594635,1672597226,2591
10001,3281970147,3505853594,1672613939,1672616263,2324
11095,3855222429,3714951681,1672703353,1672705606,2253
11378,3757872458,3713906305,1672646276,1672646756,480
10626,3224824355,3496591885,1672540887,1672543049,2162
11191,3209417223,3515838621,1672633662,1672635723,2061
10789,3516731917,3772659062,1672549708,1672550819,1111
10998,3919342147,3778273230,1672674107,1672674832,725
10567,3204149913,3311231911,1672663035,1672664409,1374
11010,3701284535,3780500764,1672656111,1672658414,2303
10831,3815184540,3927365255,1672656941,1672659081,2140
10847,3519730914,3757514745,1672574877,1672575571,694
11666,3501853868,3397330170,1672682491,1672685919,3428
10648,3519167605,3627431396,1672577840,1672580957,3117
9802,3368848936,3298113026,1672599609,1672600049,440
11640,3807646028,3500595432,1672618652,1672620460,1808
10864,3500590302,3290097447,1672609921,1672612193,2272
10885,3347520239,3505502819,1672622415,1672622990,575
10714,3287403291,3500019810,1672645520,1672646496,976
9993,3970851830,3884458862,1672552301,1672555036,2735
10249,3711190257,3366801723,1672600658,1672601519,861
11328,3533593766,3791194984,1672659750,1672661487,1737
11558,3791206902,3511750850,1672577613,1672580535,2922
11346,3519059808,3208560443,1672613229,1672615043,1814
11489,3774401596,3500864577,1672627120,1672630272,3152
10499,3909822999,3791106473,1672547884,1672550522,2638
10550,3711171132,3517645656,1672585175,1672586797,1622
9953,3379666159,3510111365,1672623343,1672626310,2967
11434,3501261089,3923133978,1672666724,1672669041,2317
10661,3770424892,3716475340,1672548148,1672550421,2273
9796,3885545415,3221736756,1672703908,1672705614,1706
10836,3701956841,3770564547,1672614308,1672616252,1944
10704,3516904926,3783730769,1672613307,1672615773,2466
10931,3757407184,3517380144,1672700666,1672701275,609
11535,3490008012,3505032644,1672645219,1672646772,1553
10223,3837271330,3475090917,1672688687,1672690018,1331
10437,3472173212,3309455369,1672569120,1672570710,1590
10576,3360949039,3500654356,1672693350,1672693617,267
11494,3839744168,3382746533,1672630436,1672633154,2718
11058,3780050328,3500590302,1672605373,1672608858,3485
11256,3313392810,3757032266,1672568255,1672569286,1031
11110,3977337501,3621960662,1672658730,1672659892,1162
10918,3730348493,3341432459,1672589427,1672592261,2834
10487,3516815069,3760656396,1672574227,1672577579,3352
10889,3895422995,3713195480,1672701092,1672702471,1379
11030,3331471764,3559123082,1672546280,1672546831,551
10963,3773826624,3510916875,1672561442,1672565010,3568
11684,3715881104,3774029494,1672673389,1672675285,1896
10494,3519102732,3715246385,1672558019,1672558961,942
11214,3909067335,3387322545,1672584701,1672587259,2558
11515,3519322066,3469663062,1672572494,1672575216,2722
11512,3314363575,3534984243,1672558082,1672561457,3375
11225,3711810268,3793442891,1672698167,1672700074,1907
10891,3298706213,3279851026,1672695557,1672698109,2552
10642,3371497614,3900540310,1672581227,1672584323,3096
10242,3423346297,3668764192,1672534881,1672536159,1278
10348,3778382224,3510836047,1672590586,1672593605,3019
11079,3500120676,3519730914,1672651779,1672652389,610
10299,3772867078,3287689454,1672569823,1672573121,3298
10576,3637566026,3368339963,1672574037,1672575162,1125
10931,3450503086,3916673751,1672667632,1672667751,119
10648,3509912164,3831981073,1672614212,1672616014,1802
10852,3603452936,3783695231,1672616617,1672618093,1476
11656,3290060215,3382308738,1672593472,1672595078,1606
10423,3354405535,3774238066,1672666540,1672666722,182
11205,3856552205,3533593766,1672673504,1672674268,764
11772,3780142207,3793987483,1672638560,1672641882,3322
10089,3770275898,3780352400,1672535697,1672537993,2296
10941,3755203055,3760854788,1672641905,1672645034,3129
11252,3880549316,3825153408,1672660193,1672663503,3310
9964,3518376262,3779382417,1672662007,1672662902,895
10514,3730115019,3716209499,1672647349,1672650947,3598
11486,3229615214,3972847837,1672629708,1672630179,471
9857,3778817220,3710082615,1672687159,1672689972,2813
10947,3937636109,3510882475,1672698186,1672698367,181
11300,3505011956,3233712975,1672635290,1672638080,2790
11519,3500356342,3239423794,1672559150,1672562152,3002
10331,3912181197,3454554552,1672613706,1672614559,853
10219,3855077502,3244395841,1672611562,1672612897,1335
10077,3357074700,3632720032,1672670841,1672673360,2519
9809,3309178914,3510819040,1672662037,1672663444,1407
11335,3396453219,3772216305,1672633281,1672636269,2988
10787,3201502111,3354405535,1672565744,1672567582,1838
11298,3713906305,3520506192,1672696810,1672699672,2862
10035,3701540249,3500329674,1672691181,1672694734,3553
11488,3517331746,3475845921,1672645175,1672646295,1120
9812,3516706935,3385124073,1672679670,1672680650,980
10828,3474097405,3770564547,1672703434,1672706529,3095
9969,3205687719,3441737317,1672581159,1672582488,1329
10059,3511458926,3755465396,1672650441,1672653428,2987
11552,3685083275,3514306458,1672552002,1672555566,3564
10028,3880549316,3369558911,1672590753,1672594154,3401
11764,3701512498,3976400190,1672554896,1672558416,3520
11294,3452024572,3936486724,1672589909,1672591445,1536
10390,3379400553,3476308535,1672589717,1672591370,1653
11406,3611939581,3715249954,1672562517,1672563779,1262
11665,3515259326,3710695372,1672658854,1672659422,568
10557,3517144269,3298831109,1672594664,1672598251,3587
10631,3474074188,3774483862,1672658193,1672659869,1676
11510,3519448648,3510638085,1672595746,1672597468,1722
10845,3710296607,3819315404,1672552814,1672553277,463
10176,3441737317,3512857020,1672640639,1672644219,3580
10424,3236512807,3452677710,1672589572,1672591917,2345
10035,3311771689,3428303756,1672559644,1672560128,484
10524,3910190872,3228575883,1672574727,1672577242,2515
11283,3715282492,3533036499,1672667721,1672670117,2396
11128,3852161626,3703502114,1672665012,1672667885,2873
11350,3512288503,3311177439,1672549582,1672550804,1222
10395,3510206323,3358530225,1672626237,1672626992,755
10728,3832902787,3714268380,1672579297,1672580597,1300
11645,3635433296,3636877469,1672552852,1672555104,2252
10255,3517991042,3205324639,1672676308,1672677014,706
11617,3534775239,3899156705,1672653636,1672657105,3469
11277,3311463998,3501370430,1672588220,1672591293,3073
11174,3228218081,3302416197,1672665674,1672667979,2305
10300,3505994703,3935444008,1672675970,1672676325,355
11079,3733123020,3715680249,1672577595,1672578454,859
11112,3783238023,3929002318,1672628852,1672631678,2826
10001,3615846003,3772882440,1672646567,1672649435,2868
11437,3408982612,3791906680,1672552475,1672554054,1579
11300,3919994216,3447202943,1672631798,1672633818,2020
11239,3779312237,3919345990,1672673144,1672674482,1338
10229,3430310785,3293540333,1672557651,1672559357,1706
9888,3793978936,3505266343,1672703177,1672703871,694
10321,3334381941,3385124073,1672581313,1672582760,1447
10216,3703722212,3606688595,1672616300,1672617643,1343
11270,3509317776,3714453773,1672572827,1672573449,622
11235,3368441333,3347996015,1672695746,1672696758,1012
10036,3517617472,3810818108,1672686776,1672688305,1529
10627,3311774510,3620105539,1672563930,1672565086,1156
11712,3607583720,3291446384,1672566628,1672568442,1814
10626,3886896755,3445172440,1672559864,1672562107,2243
10242,3273771395,3200372897,1672640781,1672643656,2875
11426,3520305100,3778544203,1672682532,1672683842,1310
10621,3899756737,3710807030,1672629868,1672633465,3597
10639,3783611957,3780224882,1672573015,1672575821,2806
11050,3632094087,3209075485,1672654961,1672656766,1805
10051,3755369666,3484739955,1672576452,1672577065,613
10525,3774447975,3500734346,1672678837,1672679232,395
10160,3713906305,3637566026,1672701292,1672701490,198
9802,3853783593,3517756624,1672659631,1672659995,364
11153,3837435907,3715852330,1672662133,1672663828,1695
10713,3805831563,3772569860,1672540853,1672542060,1207
10261,3488399075,3387971464,1672695747,1672696043,296
11198,3793822639,3884180202,1672647026,1672649717,2691
11341,3638071975,3452802329,1672598698,1672600621,1923
9820,3515607283,3467415939,1672566982,1672569876,2894
10019,3493047640,3516167000,1672684721,1672685325,604
10006,3462985379,3514571807,1672666565,1672669180,2615
10616,3461931154,3371759126,1672576860,1672576963,103
11159,3533427742,3514450836,1672608828,1672611050,2222
10750,3373802545,3823600319,1672609068,1672609503,435
10900,3469780362,3907245259,1672690633,1672693932,3299
11761,3534459983,3389069291,1672689590,1672693172,3582
10976,3519754667,3884191432,1672604995,1672605610,615
10312,3739618347,3433902955,1672653369,1672653473,104
10634,3662495290,3888642876,1672681475,1672682707,1232
10576,3837888196,3780941637,1672568649,1672571292,2643
9954,3517960157,3756149282,1672688534,1672690670,2136
10071,3832002939,3773432494,1672589619,1672591493,1874
10236,3783408830,3479910993,1672663716,1672666195,2479
11481,3500251781,3512744657,1672544598,1672546844,2246
10376,3511969443,3776053981,1672677161,1672680288,3127
11140,3236206821,3715852330,1672569414,1672570988,1574
10061,3774145748,3710819760,1672573423,1672576998,3575
10039,3732540636,3311264420,1672541392,1672543508,2116
10807,3227339675,3518088154,1672594637,1672596176,1539
11122,3777405860,3501027795,1672682637,1672684302,1665
9873,3976225898,3856147380,1672582007,1672584098,2091
11461,3760801237,3601063076,1672573048,1672573964,916
10633,3770715115,3514389188,1672595895,1672597025,1130
10883,3424997707,3334936138,1672700994,1672702843,1849
10160,3756647451,3382670400,1672585875,1672586014,139
10981,3357026115,3714312797,1672696825,1672697674,849
11625,3398021818,3381055770,1672699301,1672701936,2635
11049,3505887814,3519780867,1672540664,1672542336,1672
9877,3713170867,3533593766,1672569920,1672570211,291
11625,3424988692,3224053840,1672539355,1672539559,204
11120,3822496670,3780626668,1672544768,1672547556,2788
11603,3824657614,3710919244,1672553481,1672555359,1878
10864,3231859576,3514341451,1672677048,1672679004,1956
11491,3938129916,3513293711,1672660641,1672663151,2510
11205,3303747093,3755736024,1672536071,1672537517,1446
10291,3602680347,3780467276,1672554415,1672555469,1054
11060,3714287902,3971422524,1672687182,1672687252,70
11135,3770018912,3454554552,1672696451,1672697288,837
10085,3516319492,3379517265,1672669448,1672672520,3072
10889,3935569749,3381254180,1672700179,1672700789,610
11249,3757869138,3381254180,1672538657,1672540120,1463
10643,3715204544,3387971464,1672626118,1672628641,2523
9822,3711076751,3381254180,1672618126,1672618534,408
11595,3910190872,3500688476,1672542880,1672545570,2690
10783,3462645981,3380167818,1672657104,1672657683,579
11723,3394976623,3510836047,1672587496,1672589653,2157
11308,3732128078,3443004958,1672623657,1672625181,1524
11219,3364302157,3500589560,1672649345,1672652436,3091
10199,3317190427,3466620548,1672638243,1672638945,702
10841,3919258737,3380281484,1672613731,1672613899,168
10797,3513890046,3501901313,1672676228,1672678504,2276
10553,3701004302,3353194923,1672638168,1672638232,64
11281,3474074188,3917905192,1672602229,1672603172,943
10439,3511296895,3559221089,1672604843,1672606793,1950
9975,3774238066,3682802569,1672547238,1672549403,2165
10134,3711430738,3441737317,1672616185,1672617084,899
10192,3832002939,3468066881,1672612230,1672613133,903
10164,3494157939,3391093411,1672655188,1672658786,3598
9977,3791205793,3609335008,1672570019,1672571854,1835
10841,3505697295,3777715675,1672664434,1672664673,239
10123,3533976217,3776593726,1672549916,1672550768,852
10328,3716183063,3479402555,1672654079,1672654608,529
11177,3208560443,3817076003,1672580221,1672580430,209
9948,3756781024,3379400553,1672646670,1672648005,1335
9946,3513740840,3431317400,1672653916,1672654894,978
11589,3275975921,3714951681,1672561447,1672563642,2195
9983,3396453219,3513624915,1672571958,1672572818,860
11009,3364718040,3715680249,1672545964,1672546884,920
11473,3770564547,3779382417,1672610918,1672614451,3533
10952,3884192843,3479585868,1672588867,1672590172,1305
11593,3513777705,3793783685,1672669862,1672671912,2050
11104,3209075485,3617135064,1672574789,1672576626,1837
9925,3387989658,3757872458,1672641352,1672641718,366
10131,3773378103,3936871734,1672678404,1672680383,1979
11026,3279731391,3515577866,1672567003,1672567814,811
10078,3337715675,3619538249,1672540751,1672543541,2790
10703,3487231844,3493598658,1672637955,1672639988,2033
11422,3777758203,3791031227,1672589917,1672591150,1233
10088,3780786276,3793274957,1672653590,1672654558,968
10883,3783086267,3238056215,1672677368,1672679389,2021
11103,3512087090,3776901443,1672553490,1672556059,2569
11140,3509297453,3662821438,1672697533,1672697635,102
10528,3701218904,3518209090,1672655605,1672658896,3291
11205,3511908639,3510209505,1672695330,1672698148,2818
10992,3770972037,3937747312,1672685310,1672688468,3158
10545,3688768189,3791332226,1672693256,1672694166,910
10736,3792497486,3778909412,1672586230,1672589303,3073
11468,3714883746,3896211741,1672639324,1672640189,865
10047,3557653200,3834643026,1672563279,1672565986,2707
10109,3490804766,3715196780,1672606059,1672609555,3496
10247,3713416756,3520694387,1672597005,1672597657,652
10130,3501963428,3492728794,1672662772,1672663128,356
11460,3511182297,3520155898,1672651760,1672651916,156
10441,3461630842,3817315443,1672656733,1672659276,2543
10606,3701956841,3757198930,1672569053,1672571217,2164
10086,3791574640,3623067708,1672653265,1672653946,681
11683,3437934509,3287753579,1672651133,1672651399,266
10399,3884369346,3703999217,1672635372,1672636511,1139
10898,3518335611,3714179543,1672590088,1672593482,3394
10528,3661359073,3510939082,1672630650,1672630901,251
10253,3979366845,3667072319,1672699062,1672700897,1835
10983,3890211161,3358434853,1672656823,1672658295,1472
11433,3827889533,3925792265,1672549555,1672551433,1878
10037,3400793223,3518164450,1672689921,1672690752,831
11455,3311449914,3204821370,1672555790,1672557746,1956
10558,3505994703,3713923960,1672659944,1672660516,572
10678,3512697456,3534459983,1672618914,1672622415,3501
11668,3515715968,3515096959,1672613009,1672614410,1401
10319,3760232135,3850993995,1672617641,1672620352,2711
10937,3760529327,3200320674,1672665182,1672668159,2977
11280,3636927297,3493679801,1672639774,1672641988,2214
10874,3447591143,3403738461,1672542533,1672545787,3254
10754,3778986795,3912915644,1672587010,1672589612,2602
10055,3714516404,3491948594,1672636748,1672639022,2274
10900,3371497614,3510939082,1672692839,1672695599,2760
9960,3713170867,3885422379,1672563407,1672566702,3295
9942,3778604070,3311479294,1672618227,1672621307,3080
11305,3792578118,3302879906,1672558921,1672560000,1079
11715,3273242177,3533628528,1672536978,1672539447,2469
11385,3774946684,3805831563,1672568860,1672570797,1937
10784,3287753579,3972196462,1672622883,1672625373,2490
11503,3715737742,3603682643,1672656750,1672657825,1075
10529,3701919083,3510244209,1672676364,1672679756,3392
10413,3408408584,3466149998,1672678913,1672680955,2042
9803,3515405509,3514541800,1672578050,1672579352,1302
10281,3462985379,3364067937,1672644160,1672647500,3340
11157,3283106998,3462645981,1672587579,1672589600,2021
10544,3447312353,3510233949,1672593089,1672596268,3179
9975,3755670258,3240877710,1672671489,1672674987,3498
9970,3755170743,3319529422,1672607657,1672607901,244
10996,3515284733,3510254698,1672605057,1672605384,327
10607,3711770773,3791644831,1672699870,1672703060,3190
10531,3373135211,3357026115,1672664735,1672666541,1806
9870,3756695502,3519322066,1672582172,1672583508,1336
10924,3514361485,3459163055,1672558190,1672561194,3004
9942,3780224882,3446764595,1672601182,1672601388,206
11683,3778125688,3519831322,1672632994,1672636265,3271
10223,3471177177,3703779674,1672699791,1672702318,2527
10862,3756297396,3226037966,1672616750,1672619746,2996
11703,3287753579,3770480149,1672686641,1672688691,2050
11037,3223512565,3793081195,1672578815,1672579783,968
11706,3513563152,3619676231,1672702548,1672702951,403
11364,3444598583,3902682060,1672590159,1672591091,932
11300,3933106901,3776407517,1672673732,1672674088,356
10539,3714870496,3512753567,1672673506,1672674988,1482
10244,3414841458,3534696810,1672699119,1672700447,1328
10616,3780942505,3713694278,1672602957,1672603999,1042
10929,3520012007,3701041860,1672540019,1672540705,686
11383,3206544535,3284865931,1672551157,1672553692,2535
10111,3396656251,3372778334,1672664238,1672664832,594
11250,3734957248,3773736248,1672653646,1672655176,1530
9853,3755107521,3373018943,1672593799,1672593923,124
11388,3505416534,3793822639,1672609569,1672611895,2326
10243,3622729771,3206853747,1672606989,1672608314,1325
10255,3791532324,3757198930,1672674283,1672677360,3077
11694,3687024828,3915652382,1672678531,1672681754,3223
10592,3791644831,3701448521,1672613464,1672614597,1133
10056,3516969689,3757944870,1672554528,1672555448,920
10846,3452024572,3423782420,1672632434,1672633289,855
10715,3330188769,3780238637,1672588751,1672589129,378
10546,3774589551,3774483862,1672647987,1672648765,778
11712,3469663062,3755369666,1672595993,1672599505,3512
10362,3491239350,3370961012,1672575050,1672578208,3158
11322,3793003432,3783201950,1672646227,1672647402,1175
10558,3505936495,3703896751,1672683637,1672686718,3081
10142,3773434690,3509828883,1672675335,1672675810,475
11654,3770671714,3783086267,1672633245,1672634791,1546
11152,3519465545,3231271498,1672565592,1672567989,2397
11025,3299743638,3791368349,1672544830,1672547071,2241
11289,3236206821,3371759126,1672588134,1672590088,1954
11142,3379517265,3770715115,1672655163,1672657607,2444
10346,3779102237,3505438826,1672657826,1672659735,1909
10340,3381244346,3403257752,1672602752,1672603874,1122
11714,3760749218,3817478012,1672552287,1672555058,2771
10494,3774447975,3714101349,1672680893,1672683261,2368
11625,3452982957,3792512768,1672667634,1672669503,1869
11141,3755769254,3407403080,1672558665,1672561973,3308
10014,3317887374,3519997661,1672610869,1672611662,793
11591,3855209450,3468871103,1672665733,1672667071,1338
10827,3911821258,3513661302,1672539480,1672540683,1203
11024,3604569804,3445077330,1672634284,1672635114,830
11411,3600171014,3505685294,1672698733,1672700533,1800
11530,3500799617,3389367628,1672575656,1672579162,3506
10374,3309455369,3979115924,1672546357,1672547182,825
10346,3517377614,3732871856,1672534505,1672535715,1210
11006,3518931700,3426468199,1672597567,1672598030,463
11281,3289017988,3639926564,1672624669,1672626585,1916
9863,3395069149,3971282455,1672648477,1672651130,2653
10038,3716595760,3247193800,1672699544,1672699615,71
10750,3623894390,3422460919,1672531468,1672531834,366
10297,3220976338,3711219767,1672544577,1672545708,1131
10138,3293673220,3756876537,1672676514,1672678093,1579
10093,3246381831,3398021818,1672533441,1672533805,364
10492,3505331014,3607288879,1672533037,1672535919,2882
11561,3607583720,3246971044,1672646160,1672647210,1050
10308,3465690527,3774326754,1672533057,1672536094,3037
10645,3979115924,3813853446,1672631322,1672631753,431
11702,3336225953,3399734748,1672556485,1672557066,581
11378,3783554600,3334708091,1672654901,1672656776,1875
10214,3516497645,3500317923,1672642100,1672642426,326
11065,3487988841,3777370992,1672683866,1672686545,2679
9945,3853188285,3406390503,1672699190,1672699632,442
9839,3716095450,3760397450,1672689112,1672692289,3177
10376,3306475287,3773688906,1672535234,1672535404,170
10635,3772968080,3344478603,1672538356,1672541052,2696
10421,3514021667,3367202274,1672560795,1672563875,3080
11509,3334633634,3510750299,1672641042,1672641531,489
11160,3509018337,3662307789,1672673078,1672675785,2707
10200,3495427619,3533113740,1672626483,1672629187,2704
9996,3614944981,3715724166,1672603213,1672605635,2422
11503,3220123678,3302879906,1672694648,1672695942,1294
10005,3929002318,3907039612,1672609915,1672613130,3215
11573,3553008208,3509433155,1672620677,1672622065,1388
10717,3701971784,3511199555,1672626997,1672630596,3599
11101,3613940925,3913746581,1672609700,1672611327,1627
10188,3515259326,3689420679,1672674282,1672675961,1679
10056,3483701493,3311037445,1672538947,1672540614,1667
10972,3760024021,3757497708,1672680267,1672681895,1628
10038,3890278838,3476308535,1672693582,1672694233,651
11519,3304592684,3517377614,1672546220,1672547636,1416
11715,3783157469,3516321814,1672588188,1672590525,2337
10491,3387388336,3716475340,1672638669,1672641428,2759
10486,3777569538,3730571757,1672666088,1672668805,2717
11673,3520022175,3513624915,1672638779,1672639249,470
10724,3881012415,3780142207,1672645692,1672648712,3020
11132,3770846374,3533009565,1672584848,1672584918,70
11181,3683677062,3855077502,1672676095,1672678478,2383
10441,3839308659,3839744168,1672609539,1672610168,629
11484,3703476890,3888409038,1672653203,1672656643,3440
11042,3501427691,3736941123,1672574598,1672576316,1718
10277,3382757142,3713373455,1672702011,1672704553,2542
11607,3806720019,3510439480,1672580859,1672581785,926
11569,3711722554,3663353552,1672601167,1672601413,246
10575,3791359168,3760979523,1672675568,1672675884,316
10943,3760396348,3465672238,1672574341,1672577821,3480
9955,3307791650,3715106566,1672648268,1672648820,552
10778,3710149975,3275975921,1672665896,1672667019,1123
10747,3333505404,3713416756,1672649423,1672652053,2630
9828,3896200048,3778604070,1672626690,1672627033,343
11566,3205687719,3469663062,1672580494,1672580828,334
11034,3776710698,3366433035,1672555717,1672558529,2812
11318,3533974355,3378747834,1672606330,1672608357,2027
10662,3713927376,3793920312,1672639939,1672641840,1901
10316,3416225867,3611298237,1672554590,1672555432,842
11711,3311037445,3812277991,1672697931,1672700693,2762
11577,3306037126,3373802545,1672608765,1672611977,3212
11210,3612042508,3682241594,1672533838,1672535902,2064
11327,3333505404,3669427589,1672623635,1672623857,222
10522,3615846003,3552261072,1672689665,1672689944,279
11665,3287734830,3916463490,1672669027,1672671463,2436
11145,3777931341,3800434325,1672625213,1672628279,3066
10601,3513545735,3831864108,1672563629,1672564368,739
10443,3515939841,3927202773,1672601764,1672602554,790
10377,3905889514,3783809405,1672673606,1672675464,1858
10325,3770023722,3342027511,1672534350,1672536501,2151
9949,3533017131,3716445184,1672649257,1672649737,480
11025,3928508375,3757513651,1672569597,1672570093,496
9882,3246567963,3510882475,1672536277,1672538645,2368
10746,3477248170,3600699873,1672650954,1672651739,785
10854,3774273260,3898595916,1672667394,1672669485,2091
10247,3515507526,3248409083,1672578408,1672581614,3206
10459,3435037864,3783942518,1672623823,1672624184,361
11630,3468871103,3469350379,1672621390,1672622192,802
10154,3411213032,3206377955,1672612575,1672613510,935
10590,3714250543,3392573386,1672550580,1672552460,1880
9996,3778695895,3233917789,1672603109,1672603875,766
11779,3311959533,3853783593,1672549042,1672550267,1225
10515,3505491969,3979115924,1672627311,1672630241,2930
11358,3432762943,3714731729,1672545698,1672548801,3103
10814,3399430522,3238779889,1672686167,1672686851,684
9905,3447312353,3513764665,1672568650,1672568746,96
9966,3203954795,3369558911,1672666014,1672667947,1933
10998,3813085701,3510218188,1672545555,1672548282,2727
10716,3498803823,3509317054,1672696355,1672698715,2360
10063,3778382224,3343859998,1672679847,1672682329,2482
10323,3371759126,3713069234,1672605148,1672605257,109
10999,3208962614,3433196933,1672641941,1672642677,736
11757,3435342362,3423147369,1672620165,1672621576,1411
10949,3738160394,3274739459,1672554105,1672557656,3551
10873,3703749690,3511663572,1672566366,1672567773,1407
10319,3512784888,3490008012,1672639355,1672639954,599
9899,3792627762,3755779925,1672543785,1672544651,866
11449,3335974305,3517499844,1672638507,1672640619,2112
11772,3287734830,3364683368,1672559821,1672562550,2729
11260,3390444181,3776600696,1672574583,1672576422,1839
10255,3739618347,3773134128,1672531459,1672534088,2629
9841,3501550490,3334488428,1672580176,1672580378,202
10661,3661856558,3711171132,1672635440,1672638184,2744
10286,3900793652,3387413950,1672565817,1672568995,3178
10748,3736056340,3916924978,1672594780,1672595868,1088
10968,3933106901,3466620548,1672604013,1672605586,1573
11172,3388463477,3403150349,1672551109,1672551999,890
10967,3517756624,3481700413,1672602184,1672605228,3044
11352,3519947298,3701028092,1672630810,1672633126,2316
11650,3710051427,3475033290,1672685100,1672686127,1027
11403,3505183641,3824259677,1672533812,1672535388,1576
10659,3558203963,3366961580,1672562457,1672563202,745
10015,3479402555,3558203963,1672600189,1672602492,2303
11776,3510439480,3505653701,1672677882,1672679381,1499
10739,3776953418,3390368796,1672532824,1672534406,1582
9854,3824657614,3516335333,1672686060,1672688806,2746
11382,3703502114,3505839395,1672685941,1672686415,474
11553,3922409420,3683514731,1672549029,1672549485,456
10373,3914740937,3634766042,1672614234,1672615092,858
10028,3832002939,3805831563,1672536570,1672537229,659
10952,3923524564,3738429905,1672594797,1672596021,1224
10774,3510826414,3512154443,1672680683,1672684204,3521
11124,3912862842,3397527886,1672656441,1672657566,1125
11294,3620836520,3510750299,1672630135,1672631937,1802
10769,3714424237,3770012744,1672563678,1672566539,2861
10733,3499820963,3773041843,1672602056,1672604965,2909
9821,3520926977,3688768189,1672699983,1672701704,1721
10254,3912862842,3779748270,1672558835,1672560897,2062
10570,3776316903,3896211741,1672636257,1672639673,3416
9934,3735838864,3783939161,1672631719,1672634639,2920
10625,3518408734,3457249798,1672702224,1672705176,2952
11120,3500015630,3520558137,1672585976,1672589329,3353
10117,3302348002,3309455369,1672608144,1672611176,3032
11622,3500799617,3622729771,1672616480,1672617128,648
10698,3516472352,3772251279,1672668612,1672670602,1990
10179,3777498160,3272827860,1672545809,1672549386,3577
10854,3600842635,3713224986,1672699303,1672699714,411
11777,3421040626,3483078667,1672599211,1672601006,1795
10096,3818570577,3515715968,1672566098,1672569093,2995
9945,3517132086,3517210356,1672700116,1672702243,2127
11260,3500931474,3463729805,1672536682,1672539431,2749
9913,3407734098,3516340010,1672614986,1672618087,3101
10309,3419378107,3311810583,1672619704,1672621051,1347
10702,3516819320,3467663782,1672693279,1672693494,215
9799,3519174861,3777932581,1672558073,1672559418,1345
10527,3780127017,3907225070,1672543332,1672544057,725
10171,3273242177,3733953055,1672640794,1672642588,1794
11387,3488931357,3519000878,1672651215,1672653416,2201
9839,3505032773,3378747834,1672556549,1672557388,839
11269,3757513651,3735679000,1672604503,1672608002,3499
11342,3772689657,3818532143,1672656047,1672658515,2468
10748,3760525465,3520155898,1672643363,1672644632,1269
9895,3482519872,3778561231,1672616144,1672617375,1231
11307,3628556590,3918981936,1672586166,1672587782,1616
11053,3701065296,3772845364,1672643989,1672645526,1537
10194,3773085258,3480405740,1672673998,1672677383,3385
10270,3760554453,3515096959,1672642334,1672644334,2000
9846,3515764058,3713475356,1672532172,1672532243,71
11490,3619494735,3308149799,1672589329,1672589616,287
10125,3303747093,3233917789,1672665484,1672667411,1927
10487,3756763585,3240622654,1672548618,1672550247,1629
10667,3509508477,3403738461,1672645907,1672649448,3541
10401,3636605690,3510916875,1672689967,1672692963,2996
9994,3779468781,3501407804,1672690374,1672693236,2862
10451,3619494735,3512596743,1672606058,1672609606,3548
10933,3444168914,3701041860,1672568379,1672571083,2704
10755,3309178914,3298831109,1672662333,1672664721,2388
11123,3441944896,3921138062,1672681558,1672682118,560
10732,3423147369,3334381941,1672620042,1672620534,492
10192,3435652260,3513384042,1672613455,1672616912,3457
10303,3772844451,3636927297,1672588776,1672591463,2687
10391,3555378248,3305612422,1672655732,1672657000,1268
11645,3453538201,3600871715,1672539840,1672542832,2992
10098,3898965585,3780142207,1672584793,1672587019,2226
11082,3311142523,3270607273,1672643307,1672644564,1257
10977,3924963918,3359929534,1672686195,1672689648,3453
11060,3226172318,3501843187,1672703856,1672706810,2954
10204,3713767153,3971282455,1672633738,1672633978,240
11238,3286938590,3509544691,1672560324,1672560460,136
11137,3311626308,3833993674,1672668803,1672669290,487
11083,3437023385,3512802259,1672557340,1672560339,2999
10048,3911431642,3443580855,1672638049,1672638700,651
9886,3756991235,3402105276,1672598100,1672601612,3512
10780,3465690527,3780142207,1672693922,1672696565,2643
9879,3515984911,3311739926,1672573903,1672574495,592
10101,3792107875,3713636175,1672587817,1672589620,1803
10679,3500473064,3906075386,1672579983,1672581644,1661
10259,3519341916,3357097510,1672654034,1672656567,2533
11040,3444397804,3458130310,1672664389,1672667895,3506
11261,3518794921,3511095300,1672685593,1672688238,2645
11430,3756675909,3207748225,1672645268,1672648372,3104
10618,3441737317,3290797257,1672666852,1672668849,1997
10509,3760679372,3772019557,1672687688,1672689567,1879
10889,3783277159,3461743188,1672619550,1672620401,851
10095,3514564903,3456795601,1672652335,1672654964,2629
10301,3424476995,3669283586,1672671614,1672673687,2073
11101,3313579674,3505811269,1672683035,1672686148,3113
11015,3517816581,3512794667,1672675994,1672677251,1257
10161,3382308738,3436774112,1672559275,1672559885,610
9886,3757064623,3205113625,1672691703,1672694999,3296
10500,3380444321,3680278447,1672687668,1672690357,2689
10907,3774035405,3756328353,1672649787,1672651562,1775
11487,3638823001,3519356606,1672593631,1672596499,2868
10892,3517960157,3398483531,1672558920,1672560754,1834
10314,3770273966,3519228207,1672593218,1672594708,1490
11593,3505786561,3778986795,1672567109,1672570241,3132
11050,3621629499,3416105769,1672634601,1672635866,1265
10246,3660163550,3714287902,1672612453,1672612558,105
10822,3335055096,3461743188,1672545248,1672546223,975
10980,3225371682,3978417055,1672628153,1672629997,1844
10757,3200372897,3500931474,1672679114,1672679752,638
11757,3517943697,3241855333,1672677770,1672681256,3486
9995,3776600696,3793978936,1672685933,1672686951,1018
10115,3715196780,3716633983,1672557828,1672559432,1604
10670,3519947298,3779723939,1672683278,1672683603,325
11462,3701377471,3703722212,1672584331,1672586185,1854
10797,3852461753,3711810268,1672636239,1672639138,2899
11629,3915460293,3783506190,1672688289,1672688870,581
10976,3776901443,3295691964,1672699168,1672702286,3118
11737,3319529422,3513293711,1672690105,1672693238,3133
11080,3627431396,3445355677,1672583529,1672583859,330
9849,3476416072,3226037966,1672649367,1672651361,1994
10812,3516706935,3616371564,1672691272,1672694155,2883
11250,3514685272,3915195160,1672605697,1672606687,990
10098,3680832669,3512857020,1672670482,1672671952,1470
11084,3933106901,3917811545,1672631439,1672634450,3011
11177,3513203127,3408982612,1672603087,1672605772,2685
10915,3773394570,3620836520,1672549668,1672552198,2530
10126,3836757034,3713444403,1672584282,1672584722,440
11461,3239401337,3505359060,1672540078,1672542547,2469
11730,3512681214,3703779674,1672546065,1672546366,301
11762,3902548260,3770019143,1672664309,1672667879,3570
11154,3776950532,3791994414,1672680217,1672681146,929
11770,3408111327,3344710271,1672679291,1672681243,1952
10333,3773697080,3340321384,1672616273,1672617462,1189
11706,3733123020,3927365255,1672677698,1672680242,2544
10175,3791584994,3374552204,1672679293,1672682820,3527
10770,3516777819,3394976623,1672632973,1672634790,1817
10323,3445733121,3510836047,1672655041,1672657821,2780
10091,3433196933,3735838864,1672694290,1672697198,2908
9821,3618672178,3514761434,1672566664,1672568263,1599
11486,3418997135,3518995270,1672620570,1672623868,3298
10496,3827981800,3501711464,1672565524,1672565693,169
11270,3334381941,3374652108,1672584277,1672584618,341
10784,3778100960,3791796190,1672556033,1672559185,3152
11499,3339649817,3793274846,1672648297,1672650119,1822
10365,3382746533,3482519872,1672553984,1672557013,3029
10902,3373802545,3716341323,1672593354,1672596867,3513
10718,3774682234,3757944870,1672662469,1672664655,2186
10820,3610723722,3713990030,1672556595,1672557860,1265
10325,3295748489,3513850048,1672656646,1672660007,3361
10745,3534174363,3815184540,1672538131,1672539916,1785
9897,3732128078,3501557463,1672532150,1672534590,2440
9963,3619676231,3614944981,1672567802,1672569046,1244
11301,3821103640,3518947256,1672687447,1672687809,362
10415,3760656396,3710316008,1672696850,1672700213,3363
11105,3405200303,3510939082,1672571288,1672571656,368
11111,3516067011,3501976169,1672602577,1672605574,2997
9890,3291617477,3911821258,1672549518,1672552644,3126
11618,3501171785,3780238637,1672566186,1672567126,940
11303,3772893815,3756647451,1672563534,1672566015,2481
11692,3399430522,3403257752,1672660459,1672663889,3430
10106,3682241594,3226172318,1672653379,1672655402,2023
10300,3756850160,3294164983,1672604678,1672605397,719
9897,3713611960,3734233216,1672656412,1672658906,2494
10538,3274223335,3509377714,1672661181,1672661458,277
11717,3453519360,3514638555,1672607227,1672609758,2531
10097,3364286028,3770180844,1672597590,1672599003,1413
10709,3510882576,3512819376,1672636031,1672638127,2096
10206,3806034626,3369938668,1672601597,1672603625,2028
9934,3404187438,3807646028,1672666304,1672669339,3035
10562,3772708314,3374147279,1672661112,1672664139,3027
11783,3715441786,3922480066,1672544460,1672547476,3016
9808,3830291558,3715106566,1672666856,1672668612,1756
10157,3505502819,3711187791,1672571706,1672572033,327
11082,3435342362,3792075871,1672672894,1672675357,2463
10732,3897003751,3512072679,1672549162,1672551121,1959
11689,3713858538,3716463756,1672660378,1672663723,3345
9938,3710865678,3660246433,1672643684,1672645604,1920
10776,3229621693,3757060033,1672698787,1672700612,1825
11129,3773408491,3778605154,1672651548,1672655089,3541
10477,3774029494,3366566029,1672699526,1672702820,3294
11244,3716633983,3713805968,1672568738,1672570566,1828
10604,3442564712,3311045951,1672593104,1672593968,864
11462,3439045964,3832333115,1672610538,1672612165,1627
11293,3480185839,3791664049,1672620719,1672622687,1968
10404,3772867078,3806471413,1672620926,1672624233,3307
9802,3224824355,3780900318,1672582242,1672584149,1907
9940,3776811587,3703896751,1672557136,1672560106,2970
9867,3500591274,3715008501,1672666837,1672668444,1607
9848,3777060250,3852275715,1672682612,1672683436,824
10949,3853182912,3319862687,1672593620,1672595921,2301
9806,3791121243,3611533094,1672607673,1672607880,207
11636,3301489209,3500221079,1672586666,1672589660,2994
10212,3776447604,3344478603,1672627567,1672628409,842
11597,3500444748,3500444748,1672627813,1672629321,1508
9867,3917243005,3505066871,1672584726,1672586764,2038
11132,3430823498,3837271330,1672554134,1672556317,2183
11133,3229734741,3555954355,1672625717,1672628954,3237
10199,3929355087,3516319492,1672669119,1672671191,2072
10322,3714903253,3791644831,1672653144,1672655076,1932
10567,3505278562,3938129916,1672585448,1672588943,3495
11262,3515715968,3818324410,1672579294,1672582143,2849
10117,3793920312,3716976932,1672639903,1672640340,437
10547,3701685828,3377883705,1672545570,1672547611,2041
10612,3363549860,3304592684,1672665742,1672667769,2027
10592,3515548696,3444295435,1672663098,1672665636,2538
10200,3922430928,3837378340,1672690276,1672690578,302
11047,3446764595,3934611532,1672655287,1672657298,2011
11441,3916673751,3907039612,1672604836,1672607824,2988
11580,3885147558,3791332226,1672683836,1672687038,3202
11725,3714897456,3716183063,1672613977,1672615479,1502
11051,3376487118,3513486828,1672682093,1672684434,2341
11234,3514244308,3791236983,1672601729,1672604135,2406
10908,3393955069,3226761201,1672559720,1672560943,1223
10947,3760537855,3510486220,1672532615,1672533242,627
10161,3713728777,3927181190,1672577673,1672580818,3145
9839,3772683155,3703336988,1672584565,1672586950,2385
10698,3884934977,3689386663,1672697243,1672698508,1265
10382,3505538902,3290797257,1672622889,1672623973,1084
11776,3713191326,3510535683,1672665444,1672668744,3300
10857,3413799143,3776901443,1672561696,1672565222,3526
10725,3496579251,3933106901,1672649601,1672650288,687
10416,3776455762,3922301238,1672569809,1672572887,3078
11777,3352057037,3669427589,1672643309,1672644858,1549
11353,3485468650,3514455363,1672608585,1672611017,2432
10416,3919984986,3500011591,1672662989,1672664990,2001
11530,3662507634,3710865678,1672664546,1672667397,2851
10256,3701041860,3792440162,1672675541,1672678264,2723
10701,3387700451,3500105301,1672621698,1672624536,2838
11128,3279851026,3492728794,1672662721,1672664032,1311
11604,3757001552,3711945923,1672609839,1672612462,2623
11023,3330318282,3533017131,1672603157,1672604156,999
10079,3505011956,3886837151,1672625914,1672627635,1721
10826,3711243126,3711938229,1672686605,1672689987,3382
9887,3500695402,3516517348,1672574091,1672576937,2846
11389,3515230715,3779604279,1672660426,1672662454,2028
9988,3384001094,3793732968,1672543025,1672545415,2390
11416,3377446376,3517991042,1672632449,1672633034,585
10563,3688410383,3209075485,1672602424,1672605650,3226
10408,3295787354,3519102732,1672651288,1672652017,729
10303,3512477276,3276393542,1672589353,1672591633,2280
10153,3773876312,3858497718,1672655570,1672657385,1815
10880,3442096275,3730226545,1672552445,1672554415,1970
11311,3701865589,3235578852,1672666593,1672666798,205
11000,3510939082,3804840997,1672605549,1672608977,3428
10724,3284374600,3757851680,1672588076,1672589723,1647
11672,3791332061,3777063455,1672684926,1672688523,3597
11557,3519000878,3517210356,1672640288,1672642001,1713
11538,3792851584,3933469838,1672573089,1672573234,145
10295,3791617239,3555764822,1672625681,1672628927,3246
10667,3757869138,3716160006,1672607193,1672609879,2686
10741,3534626053,3278805844,1672657793,1672658903,1110
11368,3715261950,3832289185,1672671496,1672671851,355
9802,3777204977,3200785194,1672563280,1672565723,2443
10757,3486509752,3481700413,1672540805,1672544278,3473
10947,3516321814,3311045951,1672600797,1672601275,478
10609,3490008012,3780982229,1672660881,1672664319,3438
11388,3713923960,3279731391,1672702766,1672704873,2107
10273,3341738186,3898595916,1672579280,1672581547,2267
11194,3832745283,3920155862,1672668925,1672671102,2177
9916,3511608609,3710783759,1672700912,1672701686,774
11688,3791581138,3774325486,1672595136,1672596977,1841
10399,3930727474,3207586072,1672626634,1672627200,566
10419,3482172065,3701725839,1672649503,1672650164,661
10377,3512769522,3714471069,1672675970,1672678810,2840
10201,3520763492,3853182912,1672672693,1672674430,1737
11444,3880030249,3513802404,1672533154,1672535211,2057
11171,3419789418,3791796190,1672620812,1672623157,2345
11522,3467415939,3501548163,1672691139,1672693051,1912
9834,3516429380,3520145112,1672549374,1672551297,1923
11020,3919494952,3497904539,1672629327,1672629842,515
11564,3534374523,3240443426,1672578080,1672579869,1789
10410,3773083407,3914947393,1672638867,1672641390,2523
11555,3514389188,3505685294,1672584352,1672585139,787
10149,3500051606,3310712221,1672586555,1672587953,1398
11106,3474097405,3366433035,1672590933,1672591365,432
11516,3923910914,3500536897,1672636815,1672637990,1175
10724,3792173463,3291153514,1672534291,1672537833,3542
10787,3486824047,3701534043,1672570185,1672573340,3155
11675,3428076194,3516497645,1672694648,1672696705,2057
10719,3703351452,3757869138,1672548316,1672551394,3078
10851,3851877325,3919342147,1672669704,1672669884,180
11335,3917467642,3737738751,1672639358,1672641722,2364
10787,3515764058,3825082811,1672573015,1672575690,2675
11345,3453464785,3703336988,1672577388,1672580344,2956
11593,3773161055,3733730342,1672593155,1672593993,838
11214,3223796145,3464622743,1672560816,1672564199,3383
11534,3907088952,3716371766,1672640847,1672642065,1218
10843,3493598658,3635599307,1672678944,1672679505,561
10034,3777751979,3711810268,1672539243,1672540404,1161
9853,3380218091,3976400190,1672580963,1672583676,2713
10466,3854229296,3779689733,1672552701,1672554704,2003
11047,3445406685,3474350534,1672609593,1672609917,324
11748,3605905645,3411626917,1672546113,1672546773,660
10801,3777932225,3778695895,1672622301,1672624991,2690
10037,3770709417,3757549235,1672656158,1672656662,504
9942,3249380931,3715111016,1672574781,1672574924,143
9996,3888642876,3924205112,1672663851,1672665267,1416
11160,3505828210,3311472321,1672584735,1672587461,2726
11344,3512417028,3604569804,1672549076,1672551983,2907
10085,3757393413,3774394000,1672667705,1672667904,199
10615,3518572231,3668202976,1672665199,1672665644,445
10928,3618895679,3494748808,1672691858,1672695240,3382
10574,3380444321,3911376818,1672650887,1672653581,2694
11650,3755357292,3398021818,1672607563,1672608888,1325
11624,3938059867,3473562779,1672690255,1672690476,221
10041,3755119166,3388463477,1672583139,1672586000,2861
10327,3519319233,3534284132,1672661302,1672662643,1341
10231,3311410533,3445896667,1672582643,1672584832,2189
11636,3783086267,3776122272,1672550627,1672551603,976
11676,3417268745,3807486812,1672670444,1672673160,2716
10180,3756525103,3437703650,1672617802,1672618355,553
10706,3716183063,3780900318,1672672083,1672675434,3351
11502,3307535495,3513777705,1672564933,1672565737,804
11117,3374195945,3896840409,1672553734,1672556857,3123
11600,3519065870,3714455496,1672640192,1672643777,3585
10623,3783357035,3204149913,1672639375,1672640331,956
11114,3895944547,3890211161,1672692520,1672693624,1104
11204,3282240901,3777552831,1672654247,1672655487,1240
11335,3495152069,3517943697,1672580962,1672582013,1051
11171,3774663639,3757584114,1672653031,1672655397,2366
9858,3902023467,3774221318,1672544986,1672546159,1173
11708,3512490032,3792900315,1672596213,1672598515,2302
9833,3533867833,3501253130,1672567069,1672569312,2243
11204,3716922925,3934991640,1672640098,1672642924,2826
9963,3756668747,3939851140,1672587406,1672589821,2415
11275,3856975355,3496591885,1672697943,1672701116,3173
10194,3639926564,3623953446,1672642841,1672643312,471
10118,3773408491,3516249472,1672593241,1672594900,1659
9910,3772070986,3770595035,1672564686,1672565747,1061
11256,3387700451,3516588277,1672599064,1672601053,1989
10136,3520832066,3555763674,1672551924,1672554858,2934
10667,3407403080,3755849241,1672534432,1672534699,267
10908,3520049965,3755790149,1672619794,1672619896,102
10353,3774325486,3519352855,1672621104,1672624568,3464
10243,3534696810,3505248368,1672539964,1672543542,3578
10895,3520471156,3774633364,1672654156,1672655459,1303
10361,3553640169,3896123242,1672663347,1672665058,1711
11559,3304227085,3770105006,1672584535,1672587413,2878
11323,3500251781,3371238318,1672548305,1672550046,1741
10577,3777992576,3777499535,1672664797,1672665188,391
10821,3436018575,3490953301,1672573312,1672575134,1822
10306,3600171014,3857609616,1672539046,1672539200,154
10255,3792824886,3925098136,1672632962,1672636380,3418
11225,3813276198,3441737317,1672575167,1672576769,1602
11301,3519948471,3909822999,1672603289,1672606790,3501
10762,3772282008,3422915648,1672542852,1672543685,833
10428,3917811545,3517325365,1672696143,1672697933,1790
10171,3516321814,3534941710,1672644028,1672647266,3238
10738,3472561941,3770486161,1672578394,1672580343,1949
10333,3772909073,3278443807,1672571569,1672573111,1542
10561,3703896751,3510454018,1672650802,1672652649,1847
10619,3713416106,3505416534,1672552697,1672553252,555
11727,3792475476,3922480066,1672598978,1672602031,3053
11006,3715897627,3239279744,1672565870,1672567217,1347
10807,3730571757,3370961012,1672615016,1672616362,1346
10387,3811351746,3554236075,1672621826,1672623339,1513
10701,3510250740,3518088154,1672599295,1672599638,343
11777,3505826673,3680939042,1672617235,1672617693,458
11329,3801379377,3534362749,1672575679,1672577738,2059
10397,3520471156,3505496725,1672547697,1672548755,1058
11508,3774145748,3701596047,1672684669,1672687409,2740
11768,3777641081,3471507117,1672611756,1672612475,719
11645,3780013266,3711844574,1672685106,1672685643,537
10011,3756428507,3773161055,1672617077,1672619363,2286
10958,3703742071,3512154443,1672531495,1672531610,115
11307,3803473387,3884001167,1672692451,1672695783,3332
11442,3793926338,3297684667,1672576694,1672579025,2331
10330,3776249160,3851877325,1672627500,1672629493,1993
10606,3793860209,3505155858,1672620925,1672622487,1562
11763,3760854788,3776583229,1672563609,1672563727,118
10427,3791509881,3817076003,1672618483,1672620106,1623
10543,3757030923,3701887470,1672620610,1672623117,2507
11208,3512638952,3636852764,1672626573,1672628246,1673
10909,3511286390,3516463579,1672672012,1672675099,3087
10961,3899756737,3450511428,1672650540,1672652152,1612
11307,3275171954,3202740652,1672695788,1672696879,1091
10068,3275274182,3406492167,1672550248,1672551089,841
11586,3772131127,3971996397,1672667926,1672669570,1644
11330,3305656670,3613703906,1672666826,1672669758,2932
11642,3496352027,3482172065,1672531702,1672534078,2376
10372,3533822490,3972653129,1672561261,1672564834,3573
10538,3609335008,3209280342,1672646637,1672647477,840
11698,3435037864,3516668203,1672642042,1672644971,2929
11043,3715008501,3501583486,1672686008,1672687720,1712
10927,3207586072,3510486220,1672647213,1672649979,2766
11204,3467944159,3390368796,1672642913,1672644132,1219
11201,3491104534,3439532406,1672614564,1672614796,232
9818,3760385591,3778605154,1672598860,1672600616,1756
11276,3513586642,3682086200,1672698732,1672700199,1467
11229,3311479294,3634670780,1672570139,1672570491,352
10170,3413236071,3668720465,1672536732,1672539582,2850
10577,3793407883,3510143850,1672618198,1672620673,2475
11698,3355430975,3519621901,1672650144,1672652050,1906
11008,3757604311,3501828287,1672545801,1672547300,1499
10024,3681701931,3779835734,1672539425,1672540439,1014
11591,3497732613,3801501384,1672564126,1672566453,2327
11772,3388946581,3500595432,1672644071,1672645396,1325
10741,3231654754,3792063616,1672628220,1672631625,3405
11159,3756695502,3347140733,1672648545,1672649709,1164
10917,3520182275,3425646356,1672566682,1672569102,2420
10112,3513586642,3513186622,1672599852,1672601431,1579
10678,3520182275,3518882056,1672539392,1672541303,1911
10424,3714903253,3558203963,1672612413,1672613456,1043
10854,3604908372,3791841318,1672534399,1672536703,2304
10736,3777290300,3516335333,1672603590,1672606976,3386
9873,3777655401,3779665641,1672598187,1672598361,174
11104,3609644043,3757855416,1672599630,1672601584,1954
10620,3385481989,3880788853,1672531847,1672533692,1845
11635,3558567160,3826997668,1672556062,1672558822,2760
11235,3827981800,3247193800,1672642989,1672645817,2828
11566,3813986705,3607583720,1672686037,1672686582,545
10236,3519260216,3774221318,1672578470,1672578892,422
11006,3760416450,3246971044,1672557636,1672559817,2181
11703,3755729826,3779454060,1672644929,1672646203,1274
10695,3497732613,3433189219,1672531611,1672534068,2457
11072,3933106901,3514455363,1672648643,1672650799,2156
10851,3519165527,3514515499,1672653677,1672654094,417
11527,3417360319,3780168985,1672610286,1672612792,2506
10022,3776968640,3534562354,1672647459,1672649142,1683
9947,3779174993,3897107253,1672642521,1672645653,3132
11670,3636877469,3497904539,1672640747,1672641074,327
10268,3519848902,3779503296,1672658824,1672660946,2122
11753,3534667712,3776183353,1672567608,1672570568,2960
10421,3291153514,3665478011,1672566696,1672568946,2250
11168,3716647407,3778402454,1672682669,1672684282,1613
9882,3777204977,3832333115,1672686720,1672688202,1482
10531,3703502114,3283295213,1672684706,1672685221,515
11201,3770533588,3236254381,1672655746,1672656636,890
9854,3309455369,3311739926,1672572016,1672575211,3195
10988,3701540249,3661543201,1672584064,1672586577,2513
10004,3701925712,3533037906,1672597644,1672601164,3520
11131,3518335611,3636885498,1672631560,1672632599,1039
11114,3505490878,3793232021,1672690497,1672693172,2675
9855,3616371564,3711196962,1672620060,1672620718,658
10924,3733836732,3512555384,1672553050,1672554801,1751
11081,3390438262,3603682643,1672698479,1672700544,2065
10868,3480259863,3340897079,1672540628,1672541396,768
11407,3447312353,3770476738,1672641219,1672642923,1704
11225,3703624327,3310021925,1672589856,1672590450,594
11640,3514941815,3701127475,1672572857,1672576219,3362
11447,3558264627,3772609551,1672622702,1672625728,3026
10862,3220123678,3804840997,1672548261,1672551739,3478
10690,3533440736,3339478490,1672603271,1672605755,2484
10057,3633622298,3716467469,1672667819,1672669919,2100
11491,3929002318,3972196462,1672699522,1672700254,732
11418,3774744663,3755378125,1672680978,1672682826,1848
11348,3773408491,3432762943,1672551763,1672554124,2361
9837,3636857871,3505490878,1672645002,1672646317,1315
10477,3235074007,3756761603,1672687343,1672688321,978
11660,3710487368,3297624618,1672633833,1672636446,2613
10445,3792337863,3509370016,1672565006,1672566380,1374
9906,3365519448,3776309810,1672600322,1672600867,545
10805,3428788958,3505887814,1672656289,1672656998,709
10705,3806034626,3235470567,1672668454,1672671500,3046
10053,3518164450,3337673625,1672702801,1672702963,162
10373,3970775805,3557129226,1672689901,1672693495,3594
10560,3514560138,3512700007,1672554552,1672555957,1405
10595,3501612813,3453164933,1672640963,1672643545,2582
10399,3711755596,3711223297,1672617705,1672618194,489
9853,3638018906,3805268739,1672645074,1672646343,1269
9949,3301403047,3505183641,1672667715,1672670324,2609
11037,3513111053,3430296808,1672632146,1672633764,1618
9959,3736010012,3205687719,1672647290,1672647600,310
10193,3534984243,3387388336,1672641166,1672641282,116
10297,3476431618,3711862792,1672679907,1672680775,868
11732,3292936094,3792063616,1672569759,1672570954,1195
11282,3715419141,3756668747,1672532050,1672535472,3422
10019,3534174363,3505653701,1672633646,1672634944,1298
9936,3772425253,3777655401,1672672141,1672672577,436
11078,3490804766,3463892928,1672634550,1672637928,3378
10061,3660163550,3776125503,1672639321,1672642421,3100
11332,3639503148,3313101243,1672685153,1672687403,2250
10885,3510882576,3519494023,1672633060,1672635029,1969
10110,3776291254,3665603628,1672622434,1672624645,2211
11701,3732440502,3456795601,1672675403,1672676304,901
11224,3500018566,3462985379,1672654341,1672657359,3018
11260,3905358065,3923910914,1672542433,1672543900,1467
11714,3884001167,3716475340,1672592949,1672595175,2226
11052,3715680249,3779748270,1672608802,1672611335,2533
10314,3734233216,3832312129,1672593649,1672594991,1342
11183,3359472956,3514638555,1672592429,1672595386,2957
11208,3919814073,3736987749,1672684166,1672686522,2356
11474,3703415246,3731905251,1672582345,1672582933,588
11576,3629869834,3733423371,1672554158,1672556231,2073
10016,3305656670,3909822999,1672563495,1672564654,1159
10776,3779130507,3907225070,1672654716,1672656688,1972
10702,3505811269,3854229296,1672613788,1672617133,3345
10029,3791368349,3283847934,1672662383,1672662825,442
11139,3668764192,3703896751,1672685855,1672687552,1697
10708,3512625661,3272838634,1672585068,1672585758,690
11741,3760420315,3500674240,1672557720,1672560163,2443
9838,3682086200,3497138014,1672554705,1672556812,2107
11142,3500624846,3334824744,1672696560,1672699823,3263
10173,3244397548,3516655509,1672548098,1672550398,2300
10107,3774035405,3468281011,1672691832,1672693804,1972
11211,3533642281,3278779955,1672604923,1672605674,751
10350,3341985886,3774627091,1672603961,1672604942,981
10236,3773688906,3468201976,1672590670,1672593577,2907
9986,3776468503,3772882440,1672606405,1672606944,539
9881,3756428507,3440305508,1672606442,1672606906,464
10943,3780142207,3686860179,1672618058,1672620394,2336
11513,3732846295,3501927452,1672631836,1672634534,2698
10457,3514980025,3225371682,1672655493,1672658350,2857
10254,3836757034,3311626308,1672650146,1672650708,562
9988,3783651407,3366164642,1672534440,1672537145,2705
11310,3227956115,3977666815,1672600352,1672602186,1834
10055,3490804766,3780900318,1672672157,1672675318,3161
9992,3783313202,3505234868,1672689214,1672691269,2055
9974,3387388336,3338195686,1672562470,1672562786,316
11186,3778819352,3884192843,1672570899,1672571861,962
10781,3513143959,3519848902,1672553230,1672556021,2791
10723,3777686966,3370245766,1672599332,1672601819,2487
11647,3455907179,3668855144,1672605487,1672606004,517
11732,3519908593,3825932442,1672605411,1672607167,1756
10187,3773376762,3421956717,1672649112,1672651541,2429
10400,3472774606,3883640904,1672580294,1672582479,2185
11098,3509614126,3501835995,1672655250,1672656987,1737
10581,3773891827,3793934396,1672702939,1672703482,543
11627,3505414878,3660176760,1672684189,1672685136,947
10557,3755924094,3519108639,1672634925,1672638507,3582
11363,3780127017,3392573386,1672536805,1672537734,929
10434,3928076270,3773017746,1672679418,1672681850,2432
10265,3439662051,3293673220,1672691102,1672692071,969
10598,3492728794,3414387263,1672580362,1672581601,1239
10199,3783043346,3976225898,1672532212,1672534059,1847
10361,3516378356,3368951504,1672670241,1672670453,212
10805,3517426473,3223177147,1672698836,1672700136,1300
10866,3734957248,3621439107,1672670676,1672673045,2369
10279,3910354786,3703697059,1672566002,1672568000,1998
11015,3509651954,3716994924,1672537781,1672539887,2106
10859,3516257130,3772282008,1672638356,1672640221,1865
11777,3792432763,3515548696,1672660607,1672661100,493
10388,3621439107,3307236682,1672612403,1672613529,1126
10106,3417268745,3703732445,1672557338,1672559854,2516
11624,3519513219,3311414429,1672544151,1672545107,956
11777,3239779992,3335974305,1672546100,1672548296,2196
10067,3518759318,3287734830,1672638099,1672639280,1181
9801,3229621693,3837885956,1672690610,1672692679,2069
11778,3755942724,3661359073,1672678802,1672678965,163
10448,3505936495,3703614781,1672681554,1672683769,2215
11454,3923524564,3755273361,1672618207,1672618372,165
10420,3689386663,3313579674,1672632905,1672636025,3120
10161,3500429731,3714264759,1672683969,1672686354,2385
11156,3514107131,3314965818,1672547383,1672547685,302
11550,3471585513,3714101349,1672600022,1672602574,2552
10156,3921138062,3780352400,1672640718,1672641897,1179
10508,3772234939,3389069291,1672591191,1672594527,3336
10245,3520763492,3287094447,1672543443,1672546690,3247
9942,3662794240,3342545285,1672675407,1672677447,2040
11785,3791269060,3738760498,1672606381,1672609937,3556
10320,3772250554,3777387533,1672620101,1672621946,1845
10062,3555764822,3516585063,1672532802,1672533453,651
11641,3882905311,3395082458,1672599933,1672602689,2756
11662,3772112976,3783408830,1672578022,1672578142,120
11221,3358211034,3421040626,1672577170,1672580521,3351
11047,3516819320,3755357292,1672651186,1672652025,839
10597,3231963246,3286862903,1672619625,1672623004,3379
10212,3509360869,3337675386,1672692111,1672693809,1698
9921,3681274982,3793920312,1672695809,1672699297,3488
10396,3979366845,3515558215,1672667285,1672669715,2430
11375,3518368900,3505438826,1672678003,1672680299,2296
10922,3514033319,3776348451,1672540697,1672542199,1502
11231,3365519448,3609997804,1672659003,1672661941,2938
11080,3757446082,3483347530,1672589014,1672592460,3446
11075,3804840997,3703999217,1672607527,1672610382,2855
9860,3854202447,3687024828,1672550957,1672553111,2154
10128,3375324190,3374147279,1672648871,1672652330,3459
9916,3473706746,3517499844,1672697208,1672699311,2103
11077,3296970170,3701893620,1672628113,1672631662,3549
11127,3367109648,3703725221,1672541681,1672541937,256
10554,3311479294,3779689733,1672638095,1672638997,902
10415,3515230715,3442096275,1672601539,1672604981,3442
10900,3513545735,3453464785,1672546296,1672548159,1863
11191,3533867833,3533419409,1672676536,1672679463,2927
11623,3783727937,3783238023,1672688446,1672690253,1807
11664,3606688595,3716633983,1672554969,1672556395,1426
10978,3812756400,3393376416,1672531444,1672533024,1580
10150,3772980989,3756736726,1672557297,1672559708,2411
11675,3779212271,3884191432,1672665974,1672669200,3226
10998,3716922925,3776968640,1672654109,1672657489,3380
9819,3713373455,3838748301,1672698205,1672699207,1002
10025,3354968884,3756685732,1672532833,1672536143,3310
9908,3686644062,3851737350,1672657600,1672659495,1895
10043,3732846295,3430399931,1672571215,1672573610,2395
11109,3714424237,3897500723,1672663666,1672664440,774
10949,3514628916,3737946004,1672614275,1672615421,1146
10399,3715858201,3424988692,1672672795,1672674732,1937
11183,3364718040,3403988682,1672584615,1672585936,1321
11544,3435342362,3975799349,1672679743,1672681131,1388
10264,3903088144,3505496725,1672702450,1672705029,2579
10925,3711854614,3663902064,1672630451,1672632829,2378
10473,3899205452,3516321814,1672661232,1672662498,1266
9930,3791108593,3245121919,1672629870,1672631417,1547
11575,3935569749,3415803494,1672577376,1672580951,3575
10729,3231227362,3534937492,1672602994,1672603624,630
10084,3226037966,3273242177,1672605477,1672606665,1188
11579,3974668678,3230250213,1672654570,1672656622,2052
10952,3716178116,3514941815,1672543525,1672546096,2571
11232,3857909328,3248061684,1672692519,1672692805,286
10999,3520182275,3777290300,1672592893,1672593722,829
10335,3481019442,3832333115,1672633193,1672634849,1656
11002,3755865626,3505472087,1672559064,1672559947,883
10540,3421524698,3293579860,1672544197,1672545583,1386
10756,3623113240,3738760498,1672595168,1672598726,3558
11469,3701567668,3395069149,1672564130,1672566799,2669
10813,3701925712,3924205112,1672670897,1672673582,2685
10753,3513545735,3481019442,1672588169,1672588685,516
10092,3514107131,3520779124,1672634968,1672636374,1406
10423,3714645218,3715622084,1672676015,1672679181,3166
11435,3731905251,3607288879,1672637808,1672638636,828
9821,3367262509,3403870769,1672666915,1672668405,1490
10294,3777909822,3896211741,1672619789,1672620265,476
11045,3514980025,3274341934,1672696069,1672696503,434
10165,3793497672,3755369666,1672596260,1672597473,1213
11247,3731644240,3311989687,1672607400,1672609763,2363
11456,3495152069,3517227599,1672608222,1672608789,567
10686,3509562377,3505392452,1672690870,1672693675,2805
10335,3494157939,3440991826,1672570560,1672572022,1462
11004,3378534521,3514145752,1672654345,1672656785,2440
11418,3514107131,3779415433,1672585960,1672588483,2523
10836,3779212271,3458271585,1672586935,1672588777,1842
10971,3623953446,3511466117,1672615643,1672617457,1814
10287,3487395357,3509433155,1672536497,1672538924,2427
10410,3426207439,3517992521,1672570786,1672571724,938
10710,3442403264,3271282663,1672655743,1672658372,2629
10256,3515470462,3822634862,1672548360,1672548907,547
11052,3701412729,3813853446,1672557911,1672559518,1607
10973,3817076003,3713514933,1672646975,1672647317,342
11158,3452175941,3703462221,1672664976,1672667608,2632
9973,3669497617,3343193067,1672669854,1672670108,254
11281,3472018395,3222364320,1672598633,1672600325,1692
11607,3311264420,3474097405,1672589893,1672589987,94
10952,3533009565,3406390503,1672627501,1672629425,1924
10218,3311989687,3505164060,1672536587,1672539137,2550
11235,3688845298,3330238204,1672647495,1672648488,993
10549,3447696555,3395565040,1672691744,1672693492,1748
10209,3368079099,3292936094,1672659310,1672662512,3202
11328,3821082558,3772980989,1672538557,1672541493,2936
11733,3557528150,3470962222,1672599439,1672602376,2937
11787,3701769970,3908883591,1672695462,1672695585,123
10535,3714903456,3505756991,1672546538,1672548090,1552
10489,3519102732,3433189219,1672633220,1672633441,221
10945,3884369346,3711196962,1672579754,1672580105,351
11067,3510781595,3770630937,1672611395,1672612160,765
10843,3793081195,3533859712,1672536554,1672537957,1403
10609,3931917809,3505836431,1672574451,1672575889,1438
11109,3884191432,3452175941,1672563351,1672565325,1974
11616,3757406215,3534081527,1672684510,1672684924,414
10321,3279731391,3516517348,1672680302,1672681771,1469
11604,3776193847,3519034304,1672561107,1672562295,1188
11500,3416079461,3885674996,1672699485,1672701026,1541
11285,3805616707,3755989680,1672545052,1672547862,2810
11512,3757201538,3224040894,1672614913,1672615791,878
10760,3732128078,3476308535,1672539063,1672542485,3422
11079,3804707712,3514021667,1672560711,1672563872,3161
10793,3505097206,3514564903,1672554914,1672556880,1966
11317,3279851026,3285971415,1672653663,1672655930,2267
11753,3360783381,3479402555,1672638339,1672640292,1953
10703,3973138649,3311739926,1672629353,1672631444,2091
11031,3334824744,3308965136,1672607528,1672609499,1971
10023,3637105495,3776841808,1672624877,1672628383,3506
11410,3934980229,3711854614,1672556645,1672556762,117
11724,3231654754,3902023467,1672629966,1672630503,537
9841,3760648750,3406390503,1672647455,1672648367,912
11005,3517797610,3791106473,1672532293,1672535751,3458
11639,3777931341,3711765138,1672633305,1672635223,1918
11588,3422205569,3499711458,1672620285,1672621712,1427
10368,3701865589,3791072829,1672541321,1672544221,2900
11140,3714264759,3405435885,1672584770,1672586155,1385
11143,3406390503,3319660530,1672672543,1672674445,1902
10022,3791121243,3347520239,1672615326,1672618755,3429
11515,3716647407,3713611960,1672687057,1672689180,2123
11484,3307236682,3914740937,1672630183,1672630932,749
11134,3510869438,3792497486,1672581592,1672582029,437
10787,3332124606,3240877710,1672672689,1672674513,1824
10835,3501004005,3372596013,1672675071,1672675666,595
11443,3512504247,3791236983,1672607852,1672609077,1225
11646,3516321993,3711171132,1672685673,1672686158,485
10196,3512769522,3715106566,1672564291,1672567410,3119
10872,3318250647,3235074007,1672700413,1672701705,1292
11683,3343616490,3791841318,1672599835,1672601872,2037
11717,3774238066,3459799131,1672549295,1672551909,2614
11071,3319061210,3220987526,1672578423,1672578718,295
11461,3779835734,3208560443,1672575292,1672578311,3019
11046,3347172556,3735497729,1672685810,1672688676,2866
11617,3513143959,3711176990,1672564253,1672567118,2865
10756,3335974305,3273537848,1672575540,1672576003,463
10574,3792432763,3397330170,1672571914,1672573259,1345
11059,3731644240,3855977674,1672558039,1672559294,1255
10091,3444881567,3887030182,1672590740,1672592499,1759
11247,3514560138,3880882684,1672682162,1672683257,1095
10848,3882905311,3534491112,1672594135,1672595019,884
10144,3447202943,3557528150,1672582674,1672586082,3408
10644,3480108752,3906075386,1672677247,1672679936,2689
10768,3777063455,3500928990,1672568412,1672568976,564
9978,3624307518,3519831322,1672703610,1672704414,804
11381,3509912164,3512965991,1672548961,1672551079,2118
9851,3922153821,3822496670,1672550491,1672553104,2613
10377,3344710271,3505839395,1672662285,1672665636,3351
10934,3636857871,3209280342,1672532506,1672533488,982
10789,3756781024,3779723939,1672535168,1672537668,2500
10280,3421524698,3834643026,1672691893,1672693447,1554
11402,3716183063,3534988162,1672656278,1672659650,3372
10163,3978643889,3760232135,1672573998,1672575608,1610
11493,3510750299,3791206902,1672611081,1672613065,1984
10827,3715566511,3778706119,1672569616,1672570489,873
10865,3856147380,3777387533,1672549912,1672551929,2017
10799,3793934396,3348100657,1672560640,1672562198,1558
10541,3352057037,3245245283,1672586559,1672587960,1401
10346,3402774497,3514341451,1672622276,1672623193,917
11521,3806720019,3899756737,1672678093,1672679369,1276
10936,3905358065,3971447562,1672604051,1672605879,1828
11302,3404187438,3716609198,1672553594,1672556725,3131
10801,3930766276,3307454562,1672615003,1672615970,967
11097,3533628528,3918126468,1672546669,1672549738,3069
11056,3710185376,3338187803,1672630529,1672630933,404
10203,3472774606,3439532406,1672573263,1672573825,562
10335,3780921044,3501927452,1672638275,1672641829,3554
10057,3792708936,3520012007,1672541327,1672544164,2837
10520,3311583437,3791628195,1672619128,1672619958,830
11196,3760416450,3341985886,1672683084,1672683985,901
11487,3791628263,3770105006,1672638666,1672639161,495
10416,3501554468,3511650296,1672577189,1672580033,2844
10965,3514980025,3453464785,1672593190,1672596306,3116
11367,3925208102,3500821475,1672632493,1672635807,3314
11774,3805831563,3837435907,1672589960,1672591310,1350
11482,3780576351,3203172170,1672602169,1672604820,2651
10645,3687445224,3480270940,1672597761,1672598374,613
11085,3381055770,3633622298,1672599104,1672601762,2658
11565,3756367938,3701865589,1672654103,1672656024,1921
10038,3776034313,3516867729,1672688181,1672690712,2531
10336,3776309810,3757064623,1672593673,1672597115,3442
9926,3227059650,3478455812,1672593616,1672595680,2064
10114,3770991234,3520362238,1672540145,1672541662,1517
11437,3425545115,3414510793,1672591778,1672593868,2090
11469,3853182912,3609166109,1672669040,1672671364,2324
11600,3755729826,3481019442,1672611556,1672612600,1044
9844,3289771213,3396453219,1672616041,1672617128,1087
11340,3441737317,3516321814,1672654401,1672656251,1850
10732,3791072829,3716740576,1672692447,1672694450,2003
10567,3884934977,3755942724,1672621165,1672623351,2186
9883,3519341916,3783594246,1672576173,1672576905,732
10645,3772751765,3772234939,1672609508,1672610813,1305
11154,3633294415,3804779247,1672604817,1672605545,728
10458,3337673625,3231859576,1672536539,1672538428,1889
11586,3760997159,3494680853,1672665886,1672667076,1190
11392,3898965585,3452024572,1672614875,1672617748,2873
10893,3780511388,3755570137,1672542906,1672543774,868
10737,3399734748,3336501403,1672703635,1672704268,633
10045,3664478769,3791863922,1672604549,1672607511,2962
11420,3773017746,3632189887,1672693867,1672696373,2506
11173,3516932899,3923910914,1672660845,1672661582,737
10445,3228997424,3774325486,1672615955,1672617509,1554
10001,3757584114,3623067708,1672566727,1672569411,2684
10032,3852461753,3757201538,1672624233,1672625901,1668
11070,3776968640,3938021614,1672702693,1672705839,3146
10894,3454924050,3372079985,1672617051,1672617604,553
11231,3779815753,3514450836,1672654757,1672655307,550
10090,3802625412,3407734098,1672581771,1672581834,63
11252,3274894848,3334633634,1672548074,1672550400,2326
11357,3358385652,3516034245,1672660111,1672661908,1797
10679,3500909455,3233712975,1672663381,1672663746,365
10691,3516486526,3399173821,1672590265,1672591980,1715
10492,3715622084,3375257546,1672703270,1672704960,1690
11234,3485151614,3716209499,1672643144,1672645435,2291
9803,3905571273,3519297683,1672698415,1672701306,2891
11645,3511412229,3928076270,1672688624,1672691091,2467
9837,3779665641,3853275529,1672679354,1672679458,104
9891,3534937492,3907245259,1672570446,1672571287,841
10926,3334461288,3757198930,1672536999,1672540473,3474
9848,3393955069,3831864108,1672636860,1672640079,3219
10778,3315094386,3446575109,1672639735,1672640408,673
11602,3515764058,3770476738,1672644220,1672645907,1687
9940,3309651238,3510189563,1672584054,1672584293,239
10641,3238310644,3817120976,1672582776,1672584516,1740
11112,3810949170,3534812391,1672660692,1672663432,2740
9838,3287760230,3510547682,1672644682,1672645351,669
9832,3850108828,3632303304,1672585211,1672586673,1462
10215,3776732532,3517331746,1672535038,1672535580,542
11455,3432050858,3360525513,1672658051,1672659304,1253
11594,3774702364,3483078667,1672584796,1672587983,3187
10702,3732596503,3783826338,1672648152,1672649348,1196
10066,3701567668,3896123242,1672546218,1672546625,407
10391,3505547832,3779393140,1672629011,1672631530,2519
11230,3714883746,3335055096,1672674741,1672676398,1657
10205,3304227085,3343859998,1672671802,1672674685,2883
10065,3342031426,3511069449,1672589390,1672589833,443
10282,3716183063,3665478011,1672548638,1672550685,2047
11480,3838423363,3388946581,1672636622,1672639503,2881
11462,3622458047,3534604516,1672635486,1672637899,2413
10585,3516586325,3623512088,1672620388,1672623446,3058
10220,3246395239,3757851680,1672675050,1672677466,2416
10423,3306066522,3971447562,1672557547,1672557879,332
10707,3607288879,3756897029,1672647736,1672648385,649
10967,3294952405,3757639274,1672689636,1672689947,311
10216,3533009565,3778731000,1672586759,1672588118,1359
10127,3783594246,3510153173,1672700119,1672702657,2538
11200,3735152111,3510291656,1672594910,1672596910,2000
11308,3313579674,3811419378,1672545369,1672547766,2397
10155,3783826338,3552261072,1672540507,1672543112,2605
11356,3776617627,3533628528,1672549739,1672551966,2227
11277,3517469005,3760267158,1672691999,1672695300,3301
10767,3233993993,3427049290,1672685266,1672687450,2184
10335,3837888196,3357074700,1672691908,1672694241,2333
11441,3406937294,3756363182,1672615689,1672616457,768
9912,3912181197,3915460293,1672613912,1672617317,3405
10250,3388774559,3285136057,1672647312,1672650264,2952
11543,3534589501,3755790149,1672573725,1672574636,911
10405,3829761380,3791351852,1672576764,1672577525,761
10743,3444881567,3806720019,1672594692,1672597348,2656
11555,3616242727,3970851830,1672575155,1672578364,3209
11013,3400112498,3360972732,1672556897,1672559676,2779
10215,3774316305,3347205332,1672596495,1672598579,2084
10338,3373135211,3305612422,1672641105,1672644668,3563
10228,3238056215,3443521234,1672552335,1672554884,2549
10638,3626631210,3770285500,1672701145,1672703217,2072
11627,3289771213,3273242177,1672550157,1672553698,3541
11146,3923524564,3807646028,1672545091,1672545888,797
11313,3359929534,3772751765,1672585534,1672587623,2089
10081,3716609198,3311810583,1672589403,1672589679,276
10137,3405221863,3533627473,1672582842,1672585601,2759
11624,3914353062,3780786276,1672673145,1672676154,3009
10425,3780466967,3880562532,1672575378,1672578135,2757
10813,3512794667,3224040894,1672647289,1672647707,418
10636,3914926436,3519055736,1672690670,1672691846,1176
11475,3601340045,3836757034,1672703954,1672705918,1964
11723,3900793652,3756168814,1672641406,1672641491,85
9905,3732596503,3278443807,1672559022,1672560598,1576
10392,3701655378,3452175941,1672554546,1672556569,2023
11405,3680988889,3971282455,1672551234,1672553359,2125
10263,3755238321,3778706119,1672680995,1672684298,3303
11513,3505007498,3500927619,1672557334,1672557703,369
10813,3509274030,3756066702,1672650295,1672651957,1662
10361,3487779363,3510244209,1672667014,1672667737,723
11764,3559754304,3515893948,1672581982,1672584585,2603
10042,3701887470,3519553933,1672643784,1672644933,1149
11462,3221736756,3487988841,1672691633,1672693546,1913
10952,3813276198,3305093237,1672690994,1672693679,2685
10255,3205908584,3791628195,1672640630,1672642586,1956
10874,3778695017,3510882576,1672625184,1672625585,401
10810,3760737203,3880882684,1672593455,1672594727,1272
9881,3317989975,3886837151,1672562987,1672565643,2656
10840,3666022373,3701534043,1672561131,1672562665,1534
10959,3774251051,3517617472,1672666355,1672668206,1851
11273,3681701931,3601340045,1672663819,1672667046,3227
10228,3909504515,3791587717,1672620422,1672622886,2464
11041,3776125503,3779169946,1672682464,1672682933,469
11058,3362385373,3520305100,1672663024,1672666606,3582
10744,3701291994,3505571800,1672549381,1672549994,613
9958,3449233346,3518794921,1672653571,1672655269,1698
10117,3230250213,3703336988,1672634671,1672634746,75
10841,3791587717,3735056027,1672665818,1672668904,3086
10706,3500927619,3361789225,1672585797,1672587544,1747
10203,3613828705,3711040761,1672674003,1672675371,1368
10517,3793783685,3505438826,1672608071,1672608834,763
9996,3533728729,3315094386,1672617647,1672617863,216
10138,3534667712,3662522808,1672600263,1672602195,1932
10276,3313298164,3313824913,1672680676,1672682155,1479
11692,3513859809,3777370992,1672681750,1672682877,1127
10365,3345954031,3620836520,1672582475,1672585041,2566
9847,3505521491,3774238066,1672553916,1672554987,1071
10602,3235074007,3716178116,1672648986,1672652224,3238
10985,3512477276,3934280144,1672617343,1672617571,228
9936,3777686966,3812880543,1672623792,1672624196,404
11301,3505351253,3514107131,1672696678,1672697358,680
11681,3600441934,3701663839,1672581391,1672583853,2462
10415,3344710271,3919349138,1672676453,1672678403,1950
11246,3760554453,3513661302,1672563466,1672566918,3452
11099,3783408830,3482687604,1672657981,1672658860,879
10798,3680278447,3518534560,1672607674,1672610554,2880
11019,3791841318,3534374523,1672693389,1672696854,3465
11765,3701387745,3510939082,1672668227,1672670420,2193
11234,3793332600,3347205332,1672659121,1672661135,2014
11100,3358211034,3770480149,1672614134,1672616125,1991
9897,3511415786,3510824484,1672539268,1672541032,1764
10542,3478052226,3366961580,1672555831,1672558727,2896
10610,3939422411,3505183641,1672557587,1672559888,2301
10838,3500931474,3617135064,1672688601,1672691545,2944
10772,3464622743,3505531432,1672658664,1672659448,784
10366,3774448657,3756736726,1672538575,1672538784,209
9955,3312800145,3352057037,1672642728,1672644604,1876
10339,3406238754,3770924034,1672563331,1672566751,3420
10386,3387971464,3774589551,1672699065,1672700294,1229
9849,3828354855,3342252701,1672658824,1672661868,3044
10937,3424425746,3937854073,1672698319,1672700513,2194
10124,3971051020,3772188086,1672652397,1672655759,3362
10388,3760801237,3500741534,1672646125,1672648399,2274
11191,3912625932,3971996397,1672548419,1672551309,2890
10416,3505140123,3609997804,1672658366,1672661839,3473
10886,3280208630,3810949170,1672565112,1672566113,1001
11146,3899205452,3714902042,1672623048,1672624281,1233
10078,3441336851,3227919286,1672660251,1672660615,364
10170,3500057674,3307521389,1672675338,1672678537,3199
11156,3687445224,3516454693,1672655435,1672656066,631
10118,3757497708,3440743218,1672597293,1672599755,2462
11232,3505684690,3773853619,1672681840,1672682822,982
11162,3774539067,3755238321,1672684391,1672685884,1493
11069,3710046567,3793497672,1672685014,1672687613,2599
11100,3938059867,3898595916,1672664308,1672665286,978
9994,3701770921,3390438262,1672559129,1672561323,2194
9983,3793497672,3516932899,1672699993,1672702825,2832
11030,3783368855,3380285779,1672614537,1672616120,1583
11138,3517552930,3420983899,1672574990,1672578387,3397
10167,3783238023,3711015176,1672546285,1672548041,1756
11298,3778318250,3299743638,1672683158,1672684092,934
10902,3509544691,3458432407,1672614649,1672617502,2853
10530,3235578852,3779689733,1672569854,1672571245,1391
10549,3501901313,3359880163,1672698236,1672701786,3550
11637,3711015176,3619676231,1672664678,1672667079,2401
10721,3886957097,3662821438,1672650763,1672651083,320
10028,3770976984,3505887814,1672653838,1672655355,1517
10811,3463892928,3338016147,1672660922,1672663308,2386
11748,3510894809,3770497768,1672702172,1672704845,2673
10649,3971422524,3713858538,1672625040,1672627856,2816
11535,3533365834,3638071975,1672625894,1672629423,3529
10670,3714883746,3500536897,1672692671,1672694676,2005
10715,3361711720,3733123020,1672609821,1672611494,1673
10173,3661856558,3519260216,1672628253,1672628633,380
10809,3350631472,3311409212,1672661635,1672663331,1696
11097,3312800145,3621629499,1672540793,1672543786,2993
11252,3501137133,3501843187,1672703658,1672707165,3507
10900,3756647451,3792987243,1672626379,1672628375,1996
10481,3313282478,3452090950,1672575882,1672579424,3542
9935,3387706541,3533209168,1672554744,1672558312,3568
11076,3272096922,3510694464,1672576827,1672579635,2808
11434,3520012007,3935256825,1672584521,1672587049,2528
10535,3715114417,3345954031,1672564505,1672567456,2951
10599,3464622743,3287094447,1672673432,1672675147,1715
10329,3505472087,3516319492,1672612387,1672612690,303
10891,3500793739,3465690527,1672553328,1672554373,1045
11723,3338465050,3520515739,1672575872,1672576407,535
10880,3520305100,3908550561,1672657260,1672659677,2417
9945,3245882008,3838119022,1672675911,1672677611,1700
10714,3516454693,3398483531,1672540112,1672540685,573
11129,3774946684,3444598583,1672577420,1672578986,1566
11271,3492728794,3450735824,1672622474,1672625878,3404
10016,3220987526,3311231911,1672613173,1672615874,2701
10108,3713547793,3783879023,1672699239,1672699719,480
10591,3358434853,3774627091,1672647498,1672648740,1242
10273,3515681585,3780423516,1672682686,1672684925,2239
11328,3311583437,3518425740,1672649087,1672650760,1673
9907,3307521389,3933106901,1672613477,1672614178,701
11273,3517083465,3358211034,1672590530,1672592743,2213
10684,3611298237,3776968640,1672578831,1672579118,287
10140,3553640169,3710125627,1672607015,1672607717,702
11611,3368951504,3685522474,1672649142,1672649260,118
10368,3621960662,3516153301,1672544804,1672545996,1192
10563,3352057037,3501356814,1672692175,1672692891,716
10572,3930727474,3813986705,1672543799,1672545259,1460
10793,3730414796,3517380144,1672610549,1672610809,260
10495,3710119555,3312946269,1672670643,1672671294,651
10012,3533822490,3285201542,1672678103,1672680210,2107
11402,3519494023,3499622352,1672672657,1672673212,555
11729,3897186782,3388481990,1672672126,1672673346,1220
10807,3518989186,3390368796,1672677231,1672679834,2603
11606,3979366845,3318590083,1672594067,1672594147,80
10642,3559619861,3501126057,1672698665,1672699697,1032
10837,3716095450,3228033254,1672680496,1672682545,2049
10552,3483347530,3505183641,1672576937,1672579679,2742
10829,3792682835,3773878451,1672532849,1672533709,860
11104,3714281795,3377311502,1672578560,1672579793,1233
10339,3443521234,3510795808,1672578872,1672582358,3486
9836,3359012188,3494748808,1672548301,1672549343,1042
10581,3630802959,3511311554,1672573447,1672573661,214
11326,3774109138,3406492167,1672596930,1672600431,3501
11522,3500062408,3349573092,1672688280,1672690385,2105
10307,3779212271,3501550490,1672548555,1672551166,2611
10032,3713159131,3713606829,1672645693,1672647532,1839
10225,3893950585,3783826338,1672602794,1672603612,818
9914,3449020351,3778318250,1672666680,1672667537,857
10057,3235578852,3701387745,1672643935,1672644889,954
10655,3716595760,3533225084,1672534116,1672536618,2502
11503,3793003432,3405303958,1672655477,1672657183,1706
10241,3916463490,3822315407,1672557553,1672559002,1449
10900,3463729805,3979366845,1672550582,1672553786,3204
11422,3757872458,3552261072,1672603029,1672604170,1141
10187,3664719070,3500654356,1672686833,1672689186,2353
11781,3353811455,3311602936,1672543647,1672543714,67
9985,3711367577,3915195160,1672668946,1672670423,1477
11401,3713996094,3929355087,1672674068,1672674301,233
9850,3308149799,3291446384,1672616230,1672616676,446
11389,3279102372,3783611957,1672556067,1672558607,2540
11594,3410602007,3423800775,1672537028,1672539099,2071
10862,3757501067,3479910993,1672616975,1672618024,1049
11683,3793699467,3809871495,1672605699,1672606919,1220
11476,3467232654,3388463477,1672536144,1672537510,1366
11721,3272838634,3820200446,1672676743,1672679784,3041
10311,3887502536,3303747093,1672543838,1672544784,946
11668,3772169046,3534562354,1672624832,1672626303,1471
10824,3779312237,3714116241,1672624482,1672626698,2216
9933,3805704844,3514737648,1672691337,1672693252,1915
10105,3757823215,3516819320,1672558984,1672559472,488
10836,3897003751,3505816624,1672533741,1672533967,226
10202,3701493094,3773411968,1672690244,1672693518,3274
9972,3514801709,3495482863,1672683946,1672687045,3099
10096,3772461583,3289771213,1672550419,1672550514,95
10098,3607583720,3520395850,1672685243,1672686351,1108
9920,3701655378,3313795594,1672688950,1672690350,1400
9962,3225371682,3778702093,1672666441,1672669263,2822
11181,3773041843,3505500665,1672647762,1672651189,3427
10918,3477951091,3609997804,1672562970,1672565295,2325
11167,3681274982,3778927933,1672669286,1672670692,1406
11309,3760979523,3856129522,1672613281,1672615160,1879
11385,3682241594,3513203127,1672663970,1672664601,631
10230,3444295435,3554236075,1672551103,1672551885,782
10278,3813276198,3360525513,1672700002,1672701452,1450
9920,3436774112,3715111016,1672638818,1672639223,405
11283,3627081426,3732128078,1672554502,1672557138,2636
11575,3760854788,3774316305,1672668142,1672670816,2674
10005,3714067998,3296970170,1672599983,1672601204,1221
10332,3638823001,3424476995,1672638257,1672640763,2506
10514,3424988692,3505839395,1672563341,1672565636,2295
9960,3399430522,3491335890,1672694998,1672698559,3561
11287,3365839890,3500145103,1672581216,1672583870,2654
9828,3385481989,3358473096,1672632118,1672632399,281
10432,3533960602,3382670400,1672686448,1672688644,2196
10832,3367121615,3388830370,1672677175,1672677977,802
9969,3247545468,3710852576,1672564032,1672565354,1322
11765,3701769970,3304592684,1672637819,1672639630,1811
10145,3534372899,3425545115,1672634575,1672636457,1882
10631,3309178914,3273242177,1672583095,1672583779,684
10416,3780308809,3397783490,1672550774,1672552447,1673
11526,3443580855,3770273459,1672669127,1672672169,3042
10964,3361952532,3420664407,1672582764,1672584004,1240
10581,3780576351,3919349138,1672574330,1672576403,2073
11481,3406132280,3783408469,1672609747,1672611965,2218
10101,3444881567,3459951739,1672692220,1672692886,666
9960,3519886257,3520925688,1672587432,1672588860,1428
10506,3222357355,3773579644,1672672962,1672674324,1362
11378,3356599815,3624307518,1672663763,1672665854,2091
10499,3384601925,3716197140,1672633017,1672634261,1244
11200,3791509334,3921138062,1672688620,1672690091,1471
11046,3380167818,3822496670,1672673896,1672674190,294
10530,3436099135,3810949170,1672625575,1672625712,137
10669,3773017746,3510795808,1672545701,1672545829,128
10146,3815440588,3284483177,1672660661,1672661920,1259
10944,3236360179,3903115138,1672650320,1672651755,1435
10386,3778273230,3774539067,1672645071,1672648396,3325
11426,3369558911,3622654885,1672613846,1672614444,598
10315,3902023467,3440401725,1672590834,1672593183,2349
10191,3760979523,3364660506,1672563425,1672564019,594
11252,3757823215,3906693728,1672546370,1672549706,3336
11085,3713476192,3342545285,1672532159,1672535006,2847
10431,3779930476,3406937294,1672570116,1672571054,938
10283,3510916875,3774965463,1672642559,1672643062,503
10515,3311904032,3913847876,1672614185,1672614768,583
10013,3826068495,3908862092,1672542982,1672544622,1640
10626,3501612813,3760267158,1672671686,1672672910,1224
11670,3817376705,3711219767,1672647569,1672650951,3382
9971,3406937294,3516067011,1672612225,1672613283,1058
9881,3757199889,3534168768,1672696816,1672697600,784
10381,3299052917,3287968403,1672650173,1672651643,1470
11662,3492728794,3716633983,1672565574,1672566045,471
10002,3426468199,3519689906,1672614124,1672614245,121
10801,3277061226,3498857406,1672557989,1672558142,153
10365,3792633495,3629869834,1672541898,1672542403,505
10028,3510291656,3732846295,1672636769,1672639575,2806
11619,3514007122,3716463756,1672563607,1672566413,2806
10912,3518117078,3970265139,1672626021,1672627907,1886
11569,3623067708,3421674406,1672542132,1672544564,2432
10324,3772882440,3934280144,1672658920,1672660123,1203
10325,3422081502,3756717136,1672684251,1672687498,3247
10792,3662507634,3770172119,1672630631,1672634000,3369
10008,3716463756,3792930090,1672580759,1672582452,1693
10133,3500356342,3511069449,1672564999,1672567062,2063
10608,3668681400,3441336851,1672638948,1672640343,1395
10677,3852310652,3245774173,1672539648,1672543188,3540
10031,3242082716,3778124514,1672679482,1672680275,793
11517,3714455496,3770574826,1672635372,1672637993,2621
11533,3480270940,3716118473,1672580374,1672582997,2623
11142,3307454562,3429333292,1672595707,1672599299,3592
10686,3304661369,3714268380,1672677913,1672679090,1177
11199,3368176107,3606688595,1672531615,1672533614,1999
10228,3714287902,3933562725,1672626754,1672629169,2415
10326,3857590978,3440743218,1672568740,1672570619,1879
10282,3894495222,3713416756,1672567442,1672570579,3137
9967,3295748489,3908883591,1672668647,1672668853,206
10035,3711430738,3927365255,1672612437,1672615117,2680
9842,3839308659,3505500665,1672605318,1672606352,1034
11787,3517902505,3688845298,1672538867,1672540792,1925
10536,3422314045,3886957097,1672606740,1672609642,2902
10852,3461931154,3935444008,1672556202,1672557955,1753
9932,3501370430,3505190512,1672546423,1672548613,2190
11632,3533841983,3350966326,1672603479,1672605051,1572
11081,3276209319,3662522808,1672588759,1672591941,3182
10711,3894756677,3505665253,1672608717,1672609615,898
9881,3533131937,3755584983,1672644294,1672646480,2186
10282,3303432071,3510022922,1672583602,1672583844,242
10632,3509360869,3512638952,1672649082,1672650315,1233
10327,3459163055,3385481989,1672581854,1672585034,3180
10061,3711287751,3207748225,1672570501,1672572808,2307
10185,3714718326,3397330170,1672697395,1672698438,1043
11760,3812756400,3303552616,1672640626,1672642727,2101
11720,3491948594,3620157388,1672545378,1672547100,1722
11666,3815440588,3832289185,1672582300,1672582881,581
9928,3710891331,3701377471,1672574293,1672576386,2093
9892,3246395239,3402774497,1672672903,1672674555,1652
10583,3710119555,3778253021,1672532255,1672533486,1231
10315,3858497718,3371132167,1672592359,1672594849,2490
10020,3534328311,3757030923,1672621782,1672621881,99
9975,3778273230,3346755179,1672533454,1672533861,407
10044,3783172505,3452104161,1672560896,1672561051,155
10224,3770441717,3791758175,1672591426,1672594282,2856
11045,3555215568,3201502111,1672564112,1672564342,230
11756,3896615831,3514628916,1672700690,1672703087,2397
10155,3435037864,3452175941,1672644879,1672645797,918
11480,3613828705,3908464960,1672666334,1672666763,429
10076,3783408469,3807646028,1672682734,1672685903,3169
10871,3440582836,3714179543,1672533656,1672534803,1147
11597,3534770827,3451757423,1672652322,1672654406,2084
9808,3519322066,3510750299,1672547917,1672549189,1272
10965,3716944983,3505908965,1672612584,1672616123,3539
11462,3510547682,3791070926,1672656585,1672656951,366
10021,3231153513,3350169064,1672670660,1672672521,1861
10870,3534543864,3339478490,1672621667,1672623257,1590
10364,3777118499,3511341866,1672620219,1672620318,99
10576,3778817220,3231654754,1672601435,1672601897,462
9929,3514776568,3514498259,1672536902,1672538568,1666
11206,3835262447,3858330969,1672610331,1672610655,324
10984,3804095239,3517810375,1672625599,1672626514,915
10549,3715844082,3514541800,1672599053,1672601259,2206
10398,3482519872,3427527462,1672670504,1672671029,525
10700,3419789418,3384001094,1672678892,1672682342,3450
10351,3452389513,3811351746,1672627673,1672629937,2264
11092,3424988692,3378534521,1672560561,1672563322,2761
11196,3307997700,3630462406,1672583563,1672585777,2214
11224,3308481706,3732223664,1672691060,1672694648,3588
10492,3349573092,3290097447,1672596204,1672597250,1046
11169,3227919286,3487278983,1672662260,1672665541,3281
11622,3779212271,3922409420,1672570342,1672572463,2121
10038,3922153821,3772905073,1672663469,1672664093,624
10463,3770780655,3772786559,1672595236,1672595668,432
11169,3732846295,3793719515,1672538802,1672541474,2672
11211,3780127017,3755119166,1672571538,1672573107,1569
10120,3516655509,3489205994,1672604062,1672604417,355
9887,3514941815,3505500523,1672631526,1672634088,2562
11637,3735152111,3714525519,1672543844,1672543988,144
11424,3294821709,3934564437,1672584314,1672584711,397
11506,3278251248,3518989186,1672691686,1672693843,2157
10065,3284483177,3422915648,1672660814,1672662644,1830
10060,3368339963,3205908584,1672694415,1672697399,2984
11258,3380628097,3791548838,1672544125,1672546080,1955
10979,3610517436,3730600658,1672636389,1672637587,1198
10895,3859191694,3342545285,1672630731,1672632610,1879
10378,3716389356,3703476890,1672645590,1672645788,198
10807,3343767438,3792008302,1672629449,1672631602,2153
11397,3515764058,3710223875,1672593272,1672596372,3100
10604,3516497645,3533830748,1672602612,1672604618,2006
10524,3450511428,3907225070,1672558808,1672560677,1869
11008,3480405740,3802374620,1672536134,1672538283,2149
10842,3515597467,3713728777,1672611863,1672614446,2583
10409,3471996194,3701521510,1672573862,1672575937,2075
11259,3511078598,3517617472,1672619963,1672621491,1528
11340,3512306195,3500674240,1672569311,1672571767,2456
11648,3777706200,3387989658,1672556396,1672559227,2831
10025,3509379617,3518947256,1672614522,1672616729,2207
11234,3518931700,3376487118,1672626993,1672627814,821
10719,3884192843,3201656220,1672655489,1672659034,3545
9951,3770424892,3778195766,1672620676,1672622101,1425
11541,3533822490,3772112976,1672578124,1672578227,103
10823,3431317400,3773202954,1672602773,1672604199,1426
11789,3733730342,3770564547,1672618587,1672621782,3195
10830,3406132280,3468343480,1672622993,1672623988,995
11187,3338187803,3505331083,1672651548,1672654887,3339
11600,3760322661,3512802259,1672636604,1672637345,741
10244,3554236075,3770012744,1672680457,1672681099,642
9797,3511003541,3459694275,1672603823,1672605995,2172
11732,3558264627,3207307681,1672557821,1672560272,2451
10564,3512337054,3938409715,1672679779,1672680710,931
9860,3888523259,3703031637,1672662462,1672663866,1404
10673,3793732968,3501407804,1672595554,1672596095,541
11344,3509355477,3447202943,1672639471,1672642170,2699
10985,3516167000,3500864577,1672544370,1672547415,3045
10933,3511969443,3633949990,1672575954,1672578499,2545
11201,3505825767,3462985379,1672616566,1672618964,2398
10067,3445733121,3623894390,1672571095,1672573350,2255
11505,3346755179,3517632796,1672570032,1672571227,1195
10766,3340723781,3351949206,1672698136,1672699449,1313
11701,3600171014,3432466467,1672606112,1672608204,2092
11718,3780921044,3681504869,1672639198,1672639772,574
11202,3318224774,3491104534,1672611205,1672611820,615
11367,3760656396,3710296607,1672545839,1672546514,675
10439,3703351452,3773848111,1672680038,1672681804,1766
11479,3710296607,3773895671,1672662592,1672666164,3572
9849,3760481622,3667654673,1672580843,1672584439,3596
10771,3311197635,3777118499,1672565070,1672568265,3195
11235,3791841318,3414841458,1672618204,1672621292,3088
11601,3512794667,3452878062,1672558238,1672559754,1516
10951,3404395454,3515974881,1672604938,1672605697,759
10938,3500145103,3703423962,1672645062,1672646271,1209
9977,3774355339,3247845642,1672617760,1672618926,1166
10437,3903115138,3971280379,1672556019,1672557346,1327
11145,3505836431,3396472026,1672622258,1672625744,3486
10503,3793364952,3512395783,1672536594,1672539611,3017
9829,3772112976,3901217668,1672676105,1672678123,2018
10254,3394959062,3439651226,1672602603,1672603215,612
11122,3388774559,3499820963,1672683925,1672684765,840
9883,3802374620,3730459093,1672654121,1672657443,3322
11325,3500776597,3711862792,1672532478,1672533711,1233
10444,3773161055,3246395239,1672544441,1672545085,644
11418,3881785069,3430310785,1672623263,1672623782,519
10838,3374147279,3609335008,1672544638,1672547060,2422
10325,3311774510,3402338011,1672688589,1672690258,1669
11176,3793569914,3353335252,1672657853,1672660934,3081
10707,3732533330,3757201538,1672546848,1672549073,2225
10482,3534604516,3501988762,1672557386,1672559623,2237
11563,3553694590,3703415246,1672593064,1672595980,2916
11735,3519465545,3611298237,1672563082,1672566431,3349
10488,3487395357,3780969898,1672593825,1672594650,825
11444,3511069449,3436018575,1672570318,1672573788,3470
10439,3855222429,3491335890,1672628592,1672631379,2787
10014,3710807030,3620836520,1672568326,1672570001,1675
10308,3516497645,3897500723,1672603531,1672605497,1966
11520,3793689267,3834311054,1672601930,1672604161,2231
10514,3778318250,3684651755,1672618827,1672619463,636
9839,3793822639,3519034304,1672649366,1672650120,754
11375,3935256825,3227874229,1672602827,1672604635,1808
10572,3477248170,3773878451,1672590098,1672593546,3448
10972,3682802569,3552444228,1672676432,1672677534,1102
10800,3850904092,3701041860,1672654421,1672654486,65
11236,3469370398,3373018943,1672573511,1672573975,464
9977,3822634862,3756695502,1672536532,1672537614,1082
10656,3202787155,3501573548,1672542507,1672542982,475
11092,3773032706,3783368855,1672621834,1672622807,973
10096,3311626308,3292936094,1672594092,1672595566,1474
10639,3516827471,3755688231,1672663499,1672666288,2789
11261,3475830203,3715008501,1672577357,1672580009,2652
10203,3519356606,3713100169,1672534581,1672535869,1288
10477,3777063455,3516731917,1672624712,1672627948,3236
9898,3890211161,3934070285,1672625391,1672627295,1904
11104,3514508773,3480560014,1672611398,1672613216,1818
11095,3360972732,3923910914,1672576420,1672578355,1935
11668,3366961580,3935256825,1672537906,1672539715,1809
11543,3331228758,3703031637,1672587747,1672589523,1776
11545,3825795004,3409098014,1672615755,1672617660,1905
10468,3500590302,3773636983,1672694291,1672694711,420
11650,3825795004,3360309868,1672642001,1672643374,1373
10082,3772962072,3500015630,1672575511,1672578726,3215
10017,3770480149,3371497614,1672662904,1672664605,1701
9876,3491527603,3813276198,1672701235,1672702746,1511
10000,3469370398,3471177177,1672647265,1672648084,819
11792,3533365834,3319660530,1672635109,1672637107,1998
9931,3440582836,3518368900,1672683988,1672684299,311
9886,3285201542,3221736756,1672533880,1672535745,1865
9878,3792972270,3804095239,1672632633,1672634403,1770
11126,3605905645,3600699873,1672674619,1672675416,797
10578,3855629383,3388463477,1672671105,1672672295,1190
11120,3715204544,3756066765,1672651507,1672655016,3509
11053,3311989687,3662507634,1672589769,1672589900,131
9796,3757549235,3791574640,1672656448,1672658904,2456
10319,3791206902,3880637958,1672667051,1672667504,453
11594,3505173665,3701218904,1672589107,1672590780,1673
11280,3227059650,3661543201,1672615093,1672617861,2768
10190,3451757423,3415840750,1672594842,1672598170,3328
10361,3403738461,3777706200,1672686099,1672687170,1071
11701,3359418136,3773770134,1672605454,1672608328,2874
10797,3396440259,3205948776,1672654720,1672657808,3088
11767,3517551721,3335055096,1672543917,1672544182,265
11468,3735152111,3773344258,1672548080,1672550772,2692
11491,3404461403,3500909455,1672556081,1672557123,1042
11584,3829358750,3907039612,1672695782,1672696700,918
11108,3492064037,3895507040,1672655590,1672658851,3261
10324,3791070926,3495446254,1672532843,1672534639,1796
11128,3802101760,3791289855,1672693793,1672694955,1162
10848,3757855416,3772980989,1672597155,1672598345,1190
10872,3777931341,3281935691,1672664172,1672666551,2379
11626,3366433035,3511526885,1672546350,1672546673,323
10424,3520832066,3739217535,1672553754,1672555403,1649
11365,3275735969,3931028233,1672542468,1672545466,2998
10046,3276231633,3777641081,1672579356,1672581018,1662
11190,3501004005,3783176874,1672605799,1672607428,1629
11451,3501244753,3792719263,1672572644,1672574313,1669
10193,3791368349,3273758330,1672627063,1672630248,3185
10964,3343859998,3710185376,1672671603,1672672974,1371
10194,3713195480,3221736756,1672689921,1672692343,2422
11303,3883640454,3668764192,1672619743,1672620742,999
10488,3516792348,3515838621,1672671910,1672673432,1522
11708,3820922991,3317989975,1672560709,1672561022,313
11217,3715249954,3891586951,1672571316,1672574057,2741
10287,3520926977,3736621212,1672688242,1672690801,2559
10280,3773876312,3514737648,1672670894,1672674089,3195
11452,3611533094,3512527440,1672561642,1672564476,2834
11690,3500720752,3533113740,1672612178,1672614149,1971
11070,3235470567,3812880543,1672558365,1672560667,2302
10857,3317190427,3501843187,1672644178,1672647202,3024
10293,3407403080,3374195945,1672701939,1672704261,2322
10508,3772320856,3756297396,1672661922,1672664371,2449
10333,3711131262,3737685967,1672545649,1672549242,3593
11711,3461630842,3429409539,1672540736,1672542430,1694
10277,3837435907,3888057649,1672685413,1672687097,1684
10466,3427741923,3511750695,1672579944,1672582738,2794
10110,3791224239,3289771213,1672608420,1672609486,1066
11275,3773714494,3755922811,1672677747,1672678135,388
10230,3733730342,3500079479,1672535264,1672537414,2150
10323,3442462115,3854957153,1672541222,1672542299,1077
10321,3513890046,3516572212,1672692852,1672693212,360
10738,3885674996,3779505358,1672562428,1672563500,1072
10619,3884458862,3301369282,1672608758,1672609713,955
10574,3207748225,3936486724,1672606489,1672607004,515
10399,3240622654,3435159896,1672627811,1672629268,1457
11129,3710316008,3516321814,1672694376,1672694453,77
10644,3662507634,3824259677,1672564129,1672565129,1000
11266,3247193800,3431317400,1672655217,1672657146,1929
11500,3366566029,3516585063,1672573563,1672574181,618
11644,3231271498,3915679140,1672669419,1672669943,524
10858,3374147279,3311264420,1672594803,1672597744,2941
11598,3305656670,3780050328,1672652141,1672655279,3138
10946,3514638555,3334936138,1672643050,1672645846,2796
10557,3756897029,3703697059,1672678280,1672678545,265
10446,3898595916,3757823215,1672643597,1672646048,2451
11236,3682241594,3519730914,1672613810,1672615605,1795
11059,3312959324,3245501577,1672702248,1672703537,1289
10412,3929391979,3619705594,1672553136,1672554223,1087
9889,3319660530,3273242177,1672535756,1672539158,3402
10939,3971422524,3880549316,1672698874,1672701488,2614
9813,3772689657,3755465396,1672614393,1672617029,2636
10730,3703779674,3791206902,1672577333,1672578149,816
11381,3514216460,3238779889,1672700943,1672704029,3086
10404,3505560793,3514853709,1672559674,1672560852,1178
10986,3285587972,3922430928,1672670566,1672673250,2684
11620,3500234771,3612841103,1672538457,1672539900,1443
11640,3404375908,3381055770,1672563683,1672563967,284
10576,3755729826,3774296721,1672602853,1672606225,3372
9874,3888409038,3514611187,1672583069,1672584251,1182
9977,3629248353,3435159896,1672558090,1672561370,3280
10199,3932491622,3756998113,1672637342,1672640782,3440
10319,3513171472,3505007498,1672549637,1672553166,3529
10206,3838039092,3501174621,1672602366,1672603505,1139
10973,3829412384,3510856388,1672692725,1672692906,181
10228,3756675909,3783313202,1672638848,1672639644,796
10270,3912181197,3222364320,1672611423,1672614054,2631
10380,3714806574,3294952405,1672657095,1672659681,2586
10560,3756675909,3437286595,1672632713,1672635058,2345
11181,3518058151,3701521510,1672597205,1672599136,1931
10189,3638018906,3780173788,1672693115,1672694430,1315
9972,3478052226,3341129425,1672545824,1672547690,1866
10485,3778044082,3500776597,1672544283,1672546773,2490
9946,3755767856,3222364320,1672585150,1672587206,2056
9917,3813986705,3931164237,1672581109,1672582112,1003
10751,3710046567,3513661302,1672644759,1672648267,3508
10693,3755790149,3485898181,1672563656,1672567250,3594
10409,3755736024,3511078598,1672551376,1672554642,3266
11445,3308965136,3509370016,1672605257,1672605519,262
10985,3619494735,3500922040,1672689570,1672690149,579
10060,3837888196,3755218683,1672642114,1672643918,1804
11481,3820280594,3345902033,1672686030,1672688138,2108
10311,3520832066,3533841983,1672602453,1672602906,453
10753,3935520819,3730935770,1672670319,1672672951,2632
11017,3310021925,3713840946,1672623869,1672624432,563
10157,3393128259,3312946269,1672603541,1672603888,347
10310,3899156705,3380167818,1672612100,1672613457,1357
11515,3713858538,3387700451,1672627143,1672629021,1878
11688,3711219767,3902300755,1672556308,1672558229,1921
11763,3236360179,3772869013,1672675512,1672676887,1375
11639,3920526713,3510864325,1672540127,1672542265,2138
11216,3620836520,3627431396,1672566103,1672567428,1325
10330,3517253559,3776053084,1672625203,1672626968,1765
10336,3887069914,3739395381,1672568734,1672571879,3145
9795,3683514731,3512596743,1672563334,1672566142,2808
11279,3516321993,3715790104,1672557072,1672558556,1484
9963,3354015456,3228218081,1672544659,1672547396,2737
11641,3770595035,3909067335,1672625691,1672628796,3105
9959,3912181197,3891272544,1672535272,1672537287,2015
11655,3856975623,3701519251,1672628581,1672629560,979
10448,3505496725,3493598658,1672543433,1672544863,1430
10029,3910020031,3514776568,1672688226,1672690582,2356
10307,3511341866,3399430522,1672634107,1672636504,2397
10722,3475653510,3780786276,1672534997,1672535758,761
10504,3760737203,3885147558,1672646596,1672647205,609
10297,3533859712,3435715962,1672567207,1672569729,2522
10131,3405435885,3791758175,1672602654,1672603601,947
10165,3711810752,3884934977,1672542686,1672542931,245
10356,3683562111,3890194669,1672555795,1672557891,2096
11591,3370401047,3354877289,1672532607,1672535238,2631
11445,3770480149,3488399075,1672646552,1672646632,80
10104,3534696810,3701412729,1672685000,1672686472,1472
10451,3792411831,3500624846,1672677567,1672678759,1192
11270,3338642026,3338187803,1672555520,1672558313,2793
9925,3800434325,3777149336,1672647442,1672649260,1818
10210,3688410383,3735838864,1672665199,1672668565,3366
10965,3517943697,3519908593,1672648536,1672650203,1667
11254,3904846341,3505811269,1672664709,1672667635,2926
10193,3774304163,3755989680,1672538833,1672541707,2874
11575,3808849597,3419762444,1672689332,1672691890,2558
10812,3533566754,3792972270,1672585750,1672586632,882
10373,3518067857,3514576083,1672672297,1672673417,1120
11438,3714903253,3516200419,1672701893,1672703687,1794
10926,3514698862,3245774173,1672641895,1672643732,1837
11033,3387870683,3776583229,1672641870,1672644313,2443
11221,3663902064,3291446384,1672591491,1672593220,1729
10374,3793569914,3454924050,1672533318,1672533942,624
11519,3783060739,3512490032,1672630917,1672634064,3147
11301,3777060250,3813986705,1672540036,1672541169,1133
10651,3773826624,3488887919,1672569699,1672573107,3408
11578,3413236071,3936871734,1672592321,1672595057,2736
10110,3900793652,3979115924,1672540080,1672543001,2921
10811,3472718723,3701978422,1672683261,1672684259,998
11119,3710223875,3513739060,1672703593,1672706418,2825
10543,3500720752,3733796228,1672571959,1672574726,2767
11114,3893043842,3755769731,1672628160,1672631281,3121
10822,3236948071,3791031227,1672598844,1672600286,1442
10448,3703999217,3760648750,1672671299,1672672492,1193
9966,3555954355,3430296808,1672588671,1672591248,2577
10125,3515939841,3500087325,1672576444,1672579588,3144
11764,3813276198,3344478603,1672695765,1672698652,2887
11503,3406390503,3774448657,1672619023,1672619931,908
10155,3633622298,3519831322,1672532931,1672534062,1131
11236,3736056340,3783277159,1672550601,1672553488,2887
11239,3512700007,3739395381,1672666911,1672667812,901
11247,3227339675,3501600785,1672572016,1672574842,2826
10473,3297684667,3500062408,1672663601,1672665860,2259
11558,3770671714,3756119976,1672605786,1672606944,1158
9961,3310712221,3773024346,1672559524,1672560795,1271
11419,3773878451,3773024346,1672589111,1672589866,755
11285,3245642576,3501759031,1672601742,1672601991,249
11039,3829698950,3205908584,1672614311,1672615772,1461
10663,3233965781,3778124514,1672699396,1672702003,2607
11374,3400545490,3435801763,1672546457,1672546791,334
10982,3511867383,3770275898,1672573430,1672575125,1695
11127,3534667712,3703938162,1672639375,1672642443,3068
11675,3613781977,3701385831,1672626029,1672629614,3585
11231,3780206849,3715106566,1672558654,1672560516,1862
11236,3975799349,3770925016,1672630841,1672632787,1946
10683,3971996397,3362368123,1672536375,1672536763,388
11754,3501515425,3227339675,1672556543,1672556994,451
11092,3514564903,3716994924,1672602509,1672602779,270
10476,3364286028,3760144712,1672606377,1672609578,3201
10417,3481019442,3909822999,1672658341,1672661354,3013
11157,3520155898,3774436159,1672588664,1672590412,1748
10533,3518368900,3500473064,1672546746,1672548397,1651
10671,3304252969,3716285196,1672694829,1672697014,2185
10777,3444168914,3662055682,1672532328,1672534261,1933
11552,3288920399,3443041059,1672619614,1672620265,651
10746,3770441717,3939851140,1672551622,1672552023,401
10766,3520625600,3755394177,1672675547,1672677127,1580
10911,3756437169,3386323728,1672692089,1672693905,1816
10347,3416079461,3520471156,1672578040,1672579270,1230
10136,3518511124,3713069234,1672597268,1672599212,1944
10673,3714516404,3779340538,1672677866,1672680659,2793
11348,3246804115,3439662051,1672669606,1672670465,859
10793,3312612693,3777370992,1672697856,1672699463,1607
10254,3361789225,3710813103,1672652192,1672653802,1610
9814,3935333166,3514926921,1672686147,1672687459,1312
9796,3856699097,3355899481,1672584347,1672586652,2305
10429,3833993674,3779160052,1672581747,1672583460,1713
11211,3287968403,3924205112,1672619891,1672622394,2503
10553,3972196462,3272328752,1672655965,1672657790,1825
10768,3311472321,3792900315,1672577750,1672580522,2772
10109,3501980730,3233712975,1672577123,1672579860,2737
11074,3714179543,3559754304,1672562343,1672564465,2122
11449,3311015817,3514673213,1672553029,1672553777,748
11346,3779454060,3701291994,1672542677,1672545514,2837
10468,3485151614,3791906680,1672626861,1672627905,1044
11450,3770276815,3249771731,1672652175,1672654770,2595
10192,3366433035,3435342362,1672689025,1672691350,2325
11219,3275735969,3490804766,1672669778,1672672330,2552
10219,3774325486,3780173788,1672648395,1672651485,3090
10972,3925835590,3710223875,1672658044,1672660765,2721
10405,3514673213,3684199077,1672656567,1672658636,2069
10529,3777304517,3470135167,1672567688,1672569736,2048
10530,3534459983,3519341916,1672581034,1672583032,1998
11639,3792255406,3791509881,1672548071,1672549081,1010
10064,3776125503,3756642173,1672640824,1672640969,145
11744,3711959141,3714116241,1672668772,1672672129,3357
10725,3393001196,3512744657,1672622149,1672622266,117
10126,3501115299,3505121295,1672597817,1672598464,647
11094,3379666159,3780733404,1672587904,1672590952,3048
11484,3924963918,3367299721,1672565709,1672568402,2693
10620,3513171472,3488333295,1672661992,1672665178,3186
10428,3701770921,3520339198,1672644100,1672646604,2504
11496,3465672238,3388937390,1672594011,1672596402,2391
10363,3732533330,3834456158,1672586040,1672589276,3236
11682,3509508477,3604569804,1672602565,1672603408,843
11782,3501657158,3509382404,1672660328,1672662312,1984
10405,3701475090,3249771731,1672697472,1672698411,939
11063,3895507040,3510894809,1672698226,1672700512,2286
10383,3778824229,3760537855,1672692497,1672694658,2161
10003,3613781977,3501027795,1672569296,1672569963,667
11027,3505266343,3461877104,1672569304,1672571885,2581
11024,3605591994,3364660506,1672544826,1672548100,3274
10639,3811629200,3505190512,1672685695,1672685833,138
10732,3903088144,3512288503,1672591602,1672592930,1328
10880,3519356606,3776561263,1672617068,1672618153,1085
11169,3662794240,3512490032,1672672301,1672674175,1874
11718,3821082558,3792597493,1672621098,1672623776,2678
11295,3355880028,3637522163,1672695164,1672698757,3593
10136,3312733562,3505331083,1672608839,1672610641,1802
11337,3311515179,3283295213,1672596186,1672597511,1325
9908,3756642173,3458271585,1672689116,1672691163,2047
10665,3780050328,3348343425,1672665347,1672666368,1021
10637,3783060739,3369108286,1672702534,1672703657,1123
11773,3533340292,3421956717,1672567539,1672570255,2716
10364,3534667712,3509457543,1672656332,1672657700,1368
11741,3772070986,3737946004,1672674739,1672677955,3216
10878,3776440009,3791289855,1672650297,1672652318,2021
10484,3793704155,3805831563,1672563023,1672564702,1679
10918,3917004141,3837885956,1672661049,1672663518,2469
10724,3388830370,3505756991,1672538653,1672541003,2350
10263,3276209319,3534426696,1672611806,1672615071,3265
10477,3713141087,3851877325,1672693192,1672694429,1237
9950,3912625932,3937636109,1672557719,1672558249,530
9842,3713476192,3459163055,1672620185,1672621046,861
10878,3445406685,3357074700,1672546543,1672547673,1130
9909,3613781977,3518511124,1672650073,1672653443,3370
11700,3910049345,3230250213,1672588591,1672591147,2556
10854,3517136772,3735152111,1672694855,1672695836,981
10818,3438028077,3435652260,1672682202,1672684082,1880
11335,3514761434,3515802579,1672637666,1672641242,3576
9879,3776778306,3284334297,1672545886,1672548334,2448
10822,3498803823,3735197034,1672574629,1672575702,1073
11584,3243763209,3858330969,1672596823,1672599413,2590
10376,3505414878,3779748270,1672561991,1672564103,2112
10700,3792930090,3517943697,1672661147,1672663055,1908
11525,3519831322,3821082558,1672657672,1672659259,1587
10624,3224053840,3393001196,1672671650,1672674413,2763
10318,3239423794,3783357035,1672686030,1672689383,3353
9825,3511640720,3285515107,1672595953,1672597870,1917
10353,3631444265,3780213684,1672691443,1672691808,365
9905,3364286028,3515507526,1672574602,1672576490,1888
11414,3533225084,3760737203,1672694051,1672694832,781
10126,3509556649,3791509334,1672690714,1672691849,1135
11368,3714787207,3819400315,1672559186,1672561863,2677
9836,3240683148,3755922811,1672646898,1672649169,2271
10265,3774359137,3516517348,1672548064,1672551279,3215
9979,3512802259,3334708091,1672658380,1672658774,394
10601,3349319959,3711938229,1672680405,1672683768,3363
10856,3732090606,3400545490,1672598220,1672600554,2334
11205,3500688476,3732090606,1672682876,1672684187,1311
10596,3714919471,3772962072,1672583035,1672584967,1932
11687,3319660530,3770981604,1672673494,1672675857,2363
9867,3467415939,3285322570,1672576431,1672579868,3437
11752,3511908639,3516463579,1672674276,1672676394,2118
10935,3930727474,3939422411,1672636005,1672637907,1902
11142,3511004622,3809207482,1672662216,1672664242,2026
10023,3475845921,3466492108,1672546453,1672546562,109
10644,3856552205,3713219299,1672651695,1672654085,2390
10173,3774706478,3236563828,1672598532,1672600858,2326
10921,3334482021,3350631472,1672689683,1672689907,224
11622,3517469005,3778479297,1672599644,1672600927,1283
10133,3520182275,3911431642,1672565547,1672566924,1377
10339,3500555856,3793948300,1672672214,1672672789,575
11338,3272838634,3773891827,1672544759,1672545024,265
11455,3515284733,3755502373,1672614641,1672616528,1887
10012,3731644240,3519689906,1672541432,1672541690,258
9880,3711196962,3513186578,1672586018,1672589058,3040
10553,3240443426,3474074188,1672700702,1672702921,2219
11365,3783043346,3511500932,1672690676,1672691815,1139
11512,3515607283,3620105539,1672621755,1672624422,2667
9800,3518205307,3511615015,1672579666,1672580213,547
11530,3428303756,3710397477,1672568818,1672570446,1628
10402,3756647451,3780173788,1672575854,1672577505,1651
11011,3882851213,3505826673,1672619965,1672620348,383
10965,3505685294,3494680853,1672681760,1672684928,3168
11541,3908464960,3361789225,1672692932,1672694912,1980
10646,3367202274,3468343480,1672647683,1672651188,3505
10342,3520022175,3493598658,1672581848,1672583055,1207
11003,3713514933,3517083465,1672551649,1672553096,1447
11249,3710865678,3701567668,1672647516,1672650041,2525
10079,3735497729,3780148144,1672599450,1672602466,3016
11622,3379517265,3533365834,1672654131,1672655935,1804
11267,3205687719,3760748418,1672687984,1672690960,2976
10018,3520344592,3387322545,1672692912,1672693037,125
10102,3701521510,3777041132,1672689540,1672692870,3330
10851,3760382349,3360309868,1672547181,1672549419,2238
11554,3825234433,3408982612,1672613751,1672615035,1284
10607,3735838864,3638018906,1672541447,1672542941,1494
10158,3289771213,3772893815,1672636514,1672639974,3460
10967,3772114731,3755378125,1672556385,1672558778,2393
10381,3857389270,3774325486,1672695441,1672697418,1977
11123,3791688526,3811419378,1672572282,1672574044,1762
10952,3714142299,3402105276,1672669135,1672672506,3371
11471,3394364348,3235578852,1672598118,1672600694,2576
10173,3509508477,3810818108,1672641398,1672642196,798
11402,3495637721,3905571273,1672544717,1672545337,620
9873,3607288879,3713219299,1672554638,1672556351,1713
10098,3520057139,3772683155,1672626414,1672629072,2658
10826,3377883705,3353326305,1672531597,1672534036,2439
11094,3617771673,3520832066,1672604944,1672607609,2665
10195,3477511446,3772867078,1672579587,1672582065,2478
10374,3520470646,3755394177,1672621581,1672622146,565
9991,3458130310,3893527651,1672632217,1672635334,3117
10824,3243305367,3632720032,1672660882,1672664013,3131
11777,3772867078,3818570577,1672554129,1672555603,1474
10619,3432050858,3468066881,1672615138,1672615875,737
10963,3780142207,3510795808,1672571273,1672573169,1896
9802,3776182849,3400560073,1672542425,1672545139,2714
11505,3208894215,3812677669,1672534158,1672535045,887
10574,3773840321,3933731871,1672689986,1672690058,72
11045,3780511388,3533986052,1672533467,1672534408,941
9893,3311989687,3511864772,1672555261,1672555520,259
10809,3701475090,3516777819,1672702394,1672705435,3041
11311,3636015050,3510919509,1672616340,1672617719,1379
11693,3533627473,3792008302,1672537096,1672539560,2464
9868,3453164933,3783043770,1672589463,1672591206,1743
10681,3467663782,3515706117,1672638922,1672641879,2957
10498,3776617627,3534081527,1672635236,1672636163,927
11498,3335353798,3505032773,1672610425,1672611483,1058
11058,3714595459,3608973523,1672630424,1672631429,1005
11694,3505119470,3908177413,1672632218,1672632851,633
10364,3464622743,3710147457,1672651672,1672654249,2577
10852,3500889287,3293553295,1672635290,1672636553,1263
11408,3391854325,3915195160,1672580699,1672583844,3145
10061,3519435459,3278251248,1672654924,1672655263,339
11275,3513215373,3509996827,1672547887,1672549088,1201
10054,3777672363,3906693728,1672671577,1672672462,885
9801,3461743188,3393376416,1672702122,1672705560,3438
11015,3780466967,3235198316,1672556243,1672559099,2856
10582,3777928067,3885339157,1672552433,1672553880,1447
10065,3318250647,3372617110,1672594705,1672597164,2459
9976,3398151217,3895839169,1672624856,1672626231,1375
10947,3684199077,3492064037,1672685021,1672688559,3538
10493,3701060732,3701350519,1672670581,1672671275,694
11300,3278629965,3430032005,1672569276,1672571309,2033
10801,3933106901,3270607273,1672699333,1672702253,2920
10712,3666958814,3315094386,1672686430,1672688515,2085
10837,3714179543,3772019557,1672601608,1672605004,3396
11011,3770480149,3774325486,1672632463,1672632981,518
10090,3516969689,3520832066,1672564038,1672565195,1157
10635,3770019143,3850735936,1672558819,1672561445,2626
10303,3285322570,3533225084,1672625310,1672625926,616
11488,3605905645,3238997746,1672653826,1672656160,2334
11441,3441683673,3496591885,1672535695,1672536834,1139
11368,3419762444,3837271330,1672607213,1672607729,516
10612,3558264627,3600842635,1672689358,1672689501,143
10172,3730115019,3400545490,1672548835,1672550456,1621
9864,3305656670,3886957097,1672567420,1672570969,3549
10697,3927675706,3711223297,1672670149,1672673682,3533
11133,3668154066,3716179251,1672533798,1672536941,3143
9890,3226037966,3772461583,1672589965,1672592162,2197
9948,3664719070,3511004622,1672600292,1672601695,1403
10153,3830291558,3509317776,1672534839,1672536658,1819
9884,3783176874,3811351746,1672586317,1672588403,2086
11173,3224040894,3899294071,1672664776,1672667376,2600
11031,3710865678,3777204977,1672611162,1672613009,1847
10536,3200785194,3774109138,1672652574,1672653854,1280
11034,3686885442,3511199555,1672634233,1672635218,985
11687,3600302127,3491948594,1672636017,1672638067,2050
10592,3500590302,3773408491,1672604767,1672607338,2571
11215,3471555057,3736885568,1672549797,1672549941,144
10809,3519297683,3710008760,1672539489,1672540437,948
11160,3291617477,3636857871,1672664953,1672668162,3209
10688,3703031637,3636877469,1672540404,1672543905,3501
11756,3701663839,3632189887,1672536326,1672538223,1897
10444,3793442891,3611298237,1672600740,1672604058,3318
10276,3783563043,3359418136,1672676806,1672677558,752
10675,3713805968,3509445318,1672639185,1672641104,1919
11045,3558203963,3837885956,1672650753,1672653550,2797
9797,3510178791,3884001167,1672565593,1672568841,3248
10322,3555763674,3455955489,1672677157,1672678298,1141
10883,3896859936,3909457959,1672588848,1672590155,1307
11693,3517632796,3687024828,1672555400,1672558448,3048
11159,3835599049,3500671218,1672700120,1672702050,1930
11596,3236254381,3222357355,1672631558,1672634113,2555
11409,3501557463,3368176107,1672638853,1672639851,998
11384,3516668203,3510250740,1672561832,1672564489,2657
11289,3384151770,3455907179,1672692421,1672695783,3362
11441,3484483775,3701291994,1672541624,1672541790,166
10048,3514611187,3272581469,1672596882,1672599422,2540
11791,3805926853,3755507566,1672600649,1672601644,995
11641,3730115019,3777937949,1672690277,1672693559,3282
11278,3716468783,3512726649,1672615791,1672617788,1997
10525,3701377471,3387621912,1672636619,1672638666,2047
10999,3520515739,3355880028,1672653514,1672654932,1418
10618,3306491253,3783408830,1672691496,1672694022,2526
11076,3275975921,3757050615,1672676512,1672679589,3077
9959,3755411110,3301489209,1672650489,1672651918,1429
11711,3518117078,3972442654,1672551721,1672553533,1812
11753,3832333115,3774436159,1672637866,1672641016,3150
10906,3732128078,3777641081,1672559212,1672561431,2219
10447,3811503860,3277634944,1672618657,1672618870,213
10503,3701841013,3512480125,1672598766,1672601720,2954
10217,3430310785,3660246433,1672631568,1672633172,1604
10841,3682150740,3551972633,1672689550,1672693050,3500
10317,3858497718,3518794921,1672603835,1672605410,1575
11510,3466492108,3662307789,1672623330,1672625836,2506
11759,3512769522,3510209505,1672653134,1672656575,3441
11493,3270502801,3715712376,1672607591,1672610499,2908
10955,3791532324,3473562779,1672561927,1672563289,1362
10407,3388946581,3515405509,1672688593,1672689229,636
11553,3715039960,3793407883,1672545089,1672546692,1603
11605,3553694590,3703438617,1672589067,1672590313,1246
10647,3791994414,3625400710,1672589363,1672591334,1971
11526,3240877710,3779503296,1672634936,1672636009,1073
11769,3294821709,3453519360,1672644468,1672645973,1505
11624,3715261950,3500251781,1672561506,1672562193,687
11675,3510535683,3975799349,1672629136,1672630802,1666
11394,3686853863,3406169279,1672636385,1672638929,2544
10398,3500720752,3362706073,1672585305,1672587701,2396
9977,3370245766,3447267291,1672563407,1672564158,751
10324,3739567072,3303432071,1672608147,1672610597,2450
11277,3774029494,3534562354,1672595156,1672598473,3317
10431,3772169046,3777135415,1672543398,1672544366,968
10552,3281935691,3209958726,1672597944,1672601304,3360
10215,3319529422,3349475873,1672641706,1672644883,3177
10787,3248409083,3776901443,1672643343,1672646320,2977
9891,3335055096,3792012147,1672567862,1672570023,2161
11499,3353335252,3514361485,1672616590,1672616953,363
11223,3510335069,3509382404,1672622581,1672625711,3130
10982,3819400315,3792008302,1672607158,1672610369,3211
11227,3778479297,3355430975,1672701514,1672703017,1503
10474,3246804115,3558567160,1672613630,1672614041,411
11029,3244098077,3909504515,1672534824,1672536394,1570
9893,3817029483,3937299996,1672560129,1672561891,1762
9819,3714435747,3505392452,1672637898,1672638859,961
11050,3512251592,3226913558,1672559440,1672559681,241
10471,3308759754,3395082458,1672682274,1672685191,2917
11385,3793874490,3900195680,1672533876,1672534358,482
10878,3370401047,3510301454,1672620852,1672622867,2015
10939,3439283360,3716976932,1672660670,1672662816,2146
10003,3317887374,3491390365,1672565047,1672565821,774
10638,3774447975,3779174993,1672696491,1672699517,3026
11364,3238056215,3736203662,1672559514,1672559763,249
10128,3519255644,3927504954,1672604039,1672606538,2499
11177,3906075386,3452175941,1672624216,1672625437,1221
10535,3755342153,3772882440,1672620302,1672621081,779
11400,3422460919,3519886257,1672567074,1672570594,3520
10519,3552922094,3812880543,1672565171,1672568448,3277
10719,3732540636,3505121295,1672686482,1672687849,1367
10708,3755736024,3776407517,1672687880,1672691082,3202
10998,3616403486,3499820963,1672565380,1672567601,2221
10456,3714658474,3835262447,1672687676,1672689586,1910
10264,3500251781,3836586875,1672561221,1672563317,2096
9895,3915035136,3511883778,1672566490,1672568115,1625
10803,3245245283,3773408491,1672623241,1672625379,2138
10182,3772556646,3832745283,1672572943,1672574915,1972
10086,3713159131,3484490325,1672651143,1672651929,786
11203,3469780362,3716460706,1672586623,1672589926,3303
11129,3783563043,3791289855,1672692153,1672695611,3458
9864,3511286390,3665603628,1672605090,1672606017,927
11474,3822315407,3517195738,1672567621,1672569895,2274
10560,3627081426,3500221079,1672576309,1672578617,2308
10640,3500695402,3736621212,1672601535,1672601805,270
10425,3711367577,3515715968,1672547444,1672547693,249
9889,3500221079,3509433155,1672610759,1672611709,950
10417,3667814788,3475845921,1672683974,1672685428,1454
10620,3792512768,3407403080,1672662196,1672664459,2263
10726,3605905645,3505593034,1672660294,1672662748,2454
9980,3791236983,3313579674,1672605007,1672605980,973
9867,3778273230,3772343750,1672593898,1672597395,3497
9879,3452024572,3461877104,1672546857,1672550241,3384
10551,3464622743,3899205452,1672685162,1672685896,734
10963,3915652382,3893527651,1672686492,1672688077,1585
11609,3494748808,3710807030,1672684689,1672686212,1523
11342,3512343029,3311414429,1672678275,1672680088,1813
10971,3890278838,3555954355,1672701799,1672702074,275
11753,3856601074,3902357342,1672679223,1672679640,417
10627,3444168914,3505037247,1672596867,1672598076,1209
10439,3756525103,3449020351,1672531656,1672534891,3235
11538,3500922040,3510240661,1672551723,1672552996,1273
10399,3236563828,3500198430,1672542574,1672543655,1081
10406,3206217657,3772556646,1672535683,1672538230,2547
10225,3668764192,3803996569,1672594438,1672595125,687
10852,3772882440,3299847117,1672532289,1672532839,550
10464,3711755596,3703588004,1672637357,1672640330,2973
11036,3319061210,3833993674,1672570321,1672573353,3032
10445,3510368377,3756736726,1672586668,1672587135,467
10968,3534578428,3912915644,1672572929,1672573855,926
11288,3857847527,3487779363,1672583047,1672584478,1431
9953,3716118473,3241682278,1672600576,1672602384,1808
10605,3299845453,3710149975,1672638750,1672641114,2364
10522,3501126057,3405435885,1672646656,1672649635,2979
11456,3443041059,3534081527,1672666146,1672667702,1556
10299,3760776967,3476416072,1672533320,1672535931,2611
9924,3284334297,3513840186,1672690614,1672693829,3215
10857,3517816581,3515804844,1672684057,1672684390,333
9943,3520182275,3755229631,1672647025,1672647265,240
9939,3777074709,3534984243,1672559327,1672562476,3149
10402,3710680073,3894495222,1672675787,1672676935,1148
10160,3406029706,3770780655,1672563204,1672563515,311
11621,3458432407,3500674240,1672631840,1672633407,1567
9868,3342027511,3610517436,1672635377,1672636928,1551
11163,3512871568,3622458047,1672613624,1672616474,2850
11211,3710807030,3553321027,1672623734,1672626451,2717
10066,3500093945,3755192104,1672629861,1672630363,502
11076,3461877104,3500198430,1672684681,1672687335,2654
11666,3611533094,3792633495,1672672002,1672675014,3012
11046,3511004622,3341311972,1672615388,1672617082,1694
10413,3828568868,3732104286,1672638443,1672639185,742
10425,3680278447,3737738751,1672608949,1672611553,2604
9995,3238779889,3703742071,1672672124,1672675551,3427
10171,3511969443,3883640454,1672610494,1672613397,2903
10611,3770276815,3515558215,1672570680,1672572026,1346
10211,3774090455,3474350534,1672648047,1672648248,201
11259,3500720752,3716179251,1672544129,1672547592,3463
10596,3452802329,3223512565,1672593469,1672594414,945
10295,3437023385,3780563627,1672627755,1672630002,2247
11766,3505155858,3922786716,1672607467,1672607672,205
10133,3228477490,3714453773,1672670739,1672671078,339
10551,3776455762,3686860179,1672690721,1672692398,1677
11012,3459799131,3625400710,1672656546,1672657253,707
10566,3714806574,3516965624,1672626663,1672629036,2373
10799,3444295435,3319585148,1672597766,1672600561,2795
10124,3901217668,3516706121,1672630195,1672630770,575
10891,3927699036,3912915644,1672677550,1672680819,3269
11602,3793364952,3471555057,1672555750,1672556125,375
10039,3512527440,3510262025,1672572865,1672574705,1840
10003,3714471069,3703419800,1672649621,1672651383,1762
10337,3435652260,3780129338,1672687716,1672689062,1346
10438,3934070285,3358385652,1672645184,1672646788,1604
10278,3669497617,3500596577,1672647881,1672649031,1150
11702,3817478012,3388537708,1672657719,1672659454,1735
10646,3311409212,3828354855,1672620361,1672623644,3283
10643,3778731000,3428325402,1672620023,1672621886,1863
11564,3402774497,3364660506,1672554255,1672557084,2829
10317,3880549316,3774652449,1672583201,1672586111,2910
10185,3977337501,3518995270,1672540313,1672541745,1432
11358,3601063076,3511206717,1672568152,1672568801,649
11643,3907039612,3791584994,1672571987,1672575249,3262
11587,3780013266,3776001441,1672658759,1672659236,477
10242,3294326116,3701841013,1672555716,1672556707,991
9975,3500974385,3515804844,1672592604,1672593271,667
11744,3505482210,3627081426,1672672590,1672675521,2931
11169,3511458926,3510240661,1672609084,1672610222,1138
10260,3760232135,3334488428,1672580019,1672583331,3312
10298,3703697059,3220976338,1672538903,1672540298,1395
11055,3791121243,3686853863,1672583497,1672584835,1338
10444,3805616707,3500543341,1672622404,1672625831,3427
10990,3510189563,3509073025,1672652624,1672653934,1310
10175,3509651954,3277061226,1672638666,1672639436,770
11753,3403870769,3235313062,1672649083,1672649502,419
11760,3756066702,3505901826,1672557897,1672558548,651
10337,3812677669,3736010012,1672613565,1672616657,3092
10330,3777149336,3714471069,1672643748,1672644801,1053
10442,3756168814,3890194669,1672556894,1672559189,2295
10634,3773714494,3512417724,1672599769,1672601522,1753
11307,3533113740,3851737350,1672693121,1672693853,732
10813,3461931154,3711179193,1672605601,1672608046,2445
11341,3714806574,3776319560,1672692739,1672693842,1103
10361,3461877104,3614944981,1672545524,1672545781,257
10311,3933731871,3427741923,1672549893,1672551916,2023
10077,3509663119,3314363575,1672649386,1672650025,639
10265,3713434898,3495446254,1672636401,1672638929,2528
10468,3312800145,3417969824,1672532764,1672533823,1059
10364,3792008302,3239279744,1672696210,1672697054,844
10110,3701311947,3906693728,1672570462,1672572340,1878
11662,3716445184,3423940256,1672590831,1672592850,2019
11160,3897003751,3505867821,1672597541,1672601106,3565
11428,3390438262,3437934509,1672540841,1672543118,2277
9870,3713969196,3689420679,1672568520,1672572090,3570
10131,3332840671,3370401047,1672566344,1672568660,2316
10637,3315432466,3711671702,1672691811,1672692980,1169
11633,3248061684,3554317844,1672597871,1672601325,3454
9950,3514685272,3772556646,1672590884,1672592243,1359
11408,3450679913,3777063455,1672625168,1672627870,2702
11003,3792012147,3757872458,1672648239,1672649744,1505
10405,3736010012,3822315407,1672579322,1672580398,1076
10191,3662821438,3340321384,1672563365,1672566641,3276
11516,3406101720,3774447975,1672586854,1672589320,2466
9878,3703999217,3825153408,1672562982,1672565806,2824
11053,3358982831,3713224986,1672584713,1672586147,1434
11109,3888903181,3395565040,1672648370,1672649408,1038
11662,3912181197,3715249954,1672659399,1672659719,320
11559,3600699873,3513508737,1672590950,1672591831,881
10823,3397972945,3778713526,1672633909,1672634273,364
9875,3972856326,3501550490,1672627842,1672628197,355
10399,3772882440,3345896913,1672682551,1672683323,772
10708,3714892312,3226037966,1672623073,1672624349,1276
10007,3500105301,3898989233,1672619607,1672622820,3213
11063,3757393413,3515405509,1672681697,1672681856,159
10758,3333505404,3890638402,1672620006,1672622698,2692
10873,3770941125,3491239350,1672551761,1672552107,346
10781,3519848902,3900766525,1672570040,1672570895,855
10825,3774090455,3685877449,1672669073,1672669302,229
10875,3703423962,3886879696,1672631901,1672634028,2127
10986,3385124073,3311231911,1672647090,1672649220,2130
10014,3779975575,3935256825,1672547044,1672547199,155
11059,3380285779,3777909822,1672541844,1672543065,1221
10625,3274341934,3778819352,1672659613,1672661800,2187
10495,3774273260,3500011591,1672643642,1672644868,1226
11237,3619676231,3402020492,1672567510,1672568398,888
11784,3909067335,3776279305,1672554372,1672557775,3403
10582,3778819352,3468343480,1672653588,1672657127,3539
11171,3703818358,3884001167,1672695652,1672697945,2293
11570,3714287902,3284374600,1672696719,1672699834,3115
10361,3318224774,3703737650,1672544533,1672546704,2171
10917,3701060732,3711722554,1672574529,1672576052,1523
11101,3793732968,3301369282,1672691984,1672693345,1361
10611,3500251781,3792432763,1672693958,1672695662,1704
10312,3287403291,3358982831,1672671301,1672673660,2359
11587,3397783490,3534624672,1672588405,1672590544,2139
10567,3230612965,3621591266,1672636112,1672637518,1406
10249,3791289855,3247845642,1672592203,1672592313,110
10462,3500590302,3716647407,1672567484,1672569143,1659
10447,3449020351,3714312797,1672593986,1672597186,3200
11148,3311472321,3505786561,1672543644,1672546857,3213
10244,3770544738,3703737650,1672646160,1672648913,2753
11295,3701284535,3533427742,1672553547,1672554655,1108
10650,3313502623,3428303756,1672549031,1672550723,1692
9799,3222364320,3378534521,1672592745,1672593286,541
10350,3517991042,3308149799,1672583328,1672585145,1817
11227,3500863429,3730600658,1672538425,1672540015,1590
10165,3331471764,3462645981,1672595130,1672598592,3462
11519,3423147369,3780127017,1672620018,1672623106,3088
10970,3710585241,3500178849,1672668937,1672669045,108
10113,3533867833,3514801709,1672589669,1672590588,919
11786,3935444008,3713285095,1672607298,1672608903,1605
11405,3334381941,3603452936,1672594081,1672595730,1649
10070,3912878303,3701359045,1672612944,1672615520,2576
11179,3711770773,3445077330,1672662210,1672665288,3078
11332,3714435747,3777063455,1672579080,1672581665,2585
10389,3247193800,3855977674,1672605384,1672605553,169
9960,3319660530,3703732445,1672538371,1672538874,503
10090,3703031637,3760420315,1672698702,1672700560,1858
11781,3776316903,3534102440,1672564352,1672567223,2871
11426,3714838100,3339478490,1672667077,1672667857,780
11630,3275057862,3755175497,1672677294,1672677376,82
10110,3359929534,3303747093,1672654781,1672656322,1541
9816,3505538902,3497138014,1672698256,1672701321,3065
10300,3371759126,3470135167,1672593803,1672595169,1366
11676,3935569749,3300238532,1672564708,1672568078,3370
10628,3533201269,3517325365,1672580869,1672582172,1303
10513,3392573386,3294952405,1672657842,1672660630,2788
10939,3757592622,3939422411,1672640528,1672643787,3259
10021,3757869138,3773434690,1672549449,1672551835,2386
10891,3399504157,3825082811,1672550703,1672552867,2164
11002,3773738817,3770764940,1672561411,1672564663,3252
10615,3208560443,3368441333,1672570527,1672573195,2668
10722,3638050763,3716891903,1672597840,1672600318,2478
10993,3831864108,3385481989,1672641012,1672642326,1314
11223,3450735824,3362368123,1672560968,1672562358,1390
11573,3917905192,3776732532,1672699542,1672701390,1848
11649,3450679913,3500057674,1672684677,1672685632,955
10575,3779975575,3500079479,1672624691,1672626324,1633
10696,3417969824,3488988274,1672693978,1672697523,3545
10856,3917811545,3776953418,1672614929,1672617318,2389
11781,3818532143,3519351747,1672653819,1672656101,2282
10447,3609925909,3517499844,1672673736,1672677314,3578
9877,3713224986,3220798451,1672581711,1672583509,1798
11505,3513186622,3400903513,1672547108,1672548822,1714
10364,3515528947,3350966326,1672596383,1672596481,98
11624,3776727271,3511500932,1672557209,1672559915,2706
10527,3779130507,3715246385,1672649949,1672653449,3500
11617,3778741325,3236512807,1672548639,1672551481,2842
11299,3510795808,3914740937,1672644779,1672645465,686
10208,3857847527,3711613085,1672664492,1672667669,3177
10507,3492728794,3777405860,1672669302,1672671141,1839
11107,3623953446,3306475287,1672602935,1672605340,2405
11744,3619538249,3512768285,1672601351,1672604732,3381
11125,3776193847,3505853594,1672531569,1672532431,862
10466,3533642281,3558203963,1672542712,1672546029,3317
10335,3716609198,3733423371,1672624726,1672625072,346
10474,3505936495,3301332095,1672641536,1672642344,808
10609,3514560138,3294949958,1672608570,1672609820,1250
10777,3233993993,3345896913,1672589164,1672589829,665
10803,3520395850,3738160394,1672623942,1672625979,2037
10232,3511458926,3351949206,1672566177,1672568582,2405
10505,3519947298,3856552205,1672678657,1672681170,2513
10890,3757201538,3512417028,1672683186,1672685326,2140
10462,3770424892,3770976984,1672590402,1672593265,2863
10660,3623067708,3756345026,1672668985,1672669511,526
9911,3682150740,3733796228,1672562134,1672564384,2250
10505,3760541837,3600441934,1672614444,1672617406,2962
9827,3382670400,3776125503,1672681438,1672681848,410
11709,3511289729,3354015456,1672547442,1672548138,696
11638,3760648750,3380285779,1672610128,1672612775,2647
11161,3703725221,3311432176,1672593292,1672594104,812
11554,3756998113,3853182912,1672598768,1672599088,320
11693,3772648837,3500693568,1672673233,1672675266,2033
11656,3476431618,3231963246,1672673574,1672675398,1824
11113,3713159131,3311602936,1672585061,1672587914,2853
10673,3505351253,3820422111,1672588479,1672589254,775
11504,3247545468,3519228207,1672663113,1672665450,2337
11003,3851877325,3311924005,1672591797,1672592077,280
10388,3776001441,3334708091,1672659384,1672662127,2743
11267,3360783381,3757924067,1672554741,1672556654,1913
11566,3277634944,3533830748,1672537564,1672540330,2766
11388,3711767051,3628423403,1672613032,1672616363,3331
11029,3713141087,3776034313,1672635353,1672637848,2495
10546,3505248368,3972196462,1672555305,1672556743,1438
11022,3201573194,3779975575,1672623806,1672625864,2058
11011,3780050328,3780500331,1672634079,1672636014,1935
9823,3500178849,3500630465,1672608628,1672610394,1766
9801,3668720465,3884458862,1672579434,1672581041,1607
10914,3703818358,3711770773,1672540643,1672544136,3493
11107,3760069457,3501253130,1672649314,1672650818,1504
11179,3228218081,3902548260,1672558884,1672561917,3033
11176,3500251781,3534499421,1672625734,1672627474,1740
10490,3715261950,3710515351,1672636035,1672639172,3137
11414,3713726267,3900195680,1672566480,1672567697,1217
10158,3511078598,3713906305,1672673063,1672675656,2593
11590,3331471764,3780238637,1672645419,1672648558,3139
11701,3792682835,3368339963,1672594018,1672594103,85
11173,3337673625,3361926328,1672532736,1672532851,115
10218,3680832669,3510484107,1672674454,1672675693,1239
9992,3928076270,3701841013,1672658481,1672661215,2734
10318,3773697080,3818236682,1672577864,1672580283,2419
11672,3520182275,3440401725,1672652437,1672655234,2797
11750,3792930090,3715700639,1672663238,1672664269,1031
10880,3772751765,3512477276,1672560607,1672561404,797
10255,3756525103,3818236682,1672573900,1672575554,1654
10512,3703104365,3353194923,1672654897,1672654963,66
10541,3933562725,3776600696,1672669613,1672670371,758
10127,3285201542,3505266343,1672681257,1672683563,2306
11764,3776187150,3369558911,1672533750,1672535244,1494
10069,3239082508,3436099135,1672560243,1672560656,413
10386,3770273459,3437108337,1672657015,1672659817,2802
10036,3972196462,3619705594,1672660343,1672663416,3073
10824,3452024572,3510882576,1672652205,1672654988,2783
11264,3905571273,3792337863,1672658137,1672661278,3141
10458,3288920399,3925835590,1672688556,1672690305,1749
9809,3710695372,3683514731,1672677402,1672678786,1384
10568,3755989680,3783695231,1672698992,1672700715,1723
10511,3716179251,3884191432,1672571984,1672572728,744
11479,3387700451,3311188620,1672630941,1672631381,440
10081,3780749789,3817376705,1672601758,1672602452,694
11310,3779169946,3505032644,1672672214,1672675568,3354
10659,3417431173,3760080378,1672630908,1672632507,1599
11589,3393543588,3513250976,1672585258,1672586098,840
11619,3509297453,3490953301,1672692448,1672695867,3419
10806,3498803823,3770976984,1672559360,1672560144,784
10905,3703474558,3437108337,1672538356,1672540487,2131
9936,3516655509,3446218191,1672637063,1672637420,357
10006,3772893815,3302929858,1672552240,1672554945,2705
11580,3505502819,3772556646,1672673040,1672673106,66
10960,3755374000,3973138649,1672658642,1672660063,1421
10573,3773891827,3520558137,1672541808,1672543408,1600
10333,3701385831,3928076270,1672645858,1672646463,605
10942,3776953418,3893043842,1672544338,1672547570,3232
11008,3509663119,3735056027,1672668490,1672671449,2959
11581,3832289185,3625931630,1672683872,1672685917,2045
10282,3662507634,3466492108,1672546114,1672547681,1567
10292,3442462115,3533976217,1672585212,1672586705,1493
11288,3438818153,3776291254,1672678501,1672679347,846
11418,3456795601,3770018912,1672649220,1672651371,2151
10974,3739297004,3715844082,1672589355,1672589504,149
10615,3632720032,3801501384,1672642921,1672643596,675
11098,3776200012,3533642281,1672569179,1672570644,1465
11508,3515284733,3514776568,1672650654,1672653480,2826
9974,3791382196,3311037445,1672609843,1672613064,3221
10759,3701291994,3227498870,1672684812,1672685909,1097
10965,3517766135,3711591464,1672651740,1672653892,2152
11028,3783879023,3500444748,1672661654,1672664675,3021
11265,3713100169,3482172065,1672571555,1672574455,2900
11243,3405221863,3701004302,1672573483,1672574221,738
10615,3510439480,3716944983,1672696693,1672696947,254
11186,3471177177,3710695372,1672548369,1672548805,436
11376,3500544306,3472718723,1672610985,1672611233,248
10575,3802101760,3509445318,1672638842,1672640993,2151
9905,3755989680,3755989680,1672554214,1672557140,2926
11067,3449672240,3615447269,1672533238,1672535905,2667
11786,3927181190,3515726910,1672612889,1672616334,3445
11351,3559759778,3664523809,1672576582,1672577882,1300
11722,3505490878,3469778316,1672650687,1672651993,1306
11352,3471996194,3825526565,1672685344,1672688482,3138
10185,3773394570,3780482864,1672590911,1672592623,1712
10801,3534491112,3487278983,1672669472,1672672508,3036
11520,3792255406,3711131262,1672672850,1672676244,3394
10927,3760271237,3449020351,1672608064,1672609444,1380
11494,3301489209,3431317400,1672559020,1672561553,2533
11659,3809207482,3396472026,1672550574,1672551988,1414
10456,3500456339,3904485393,1672538461,1672541411,2950
10431,3856552205,3229465607,1672594990,1672596832,1842
10471,3668063289,3513764665,1672540542,1672542969,2427
10314,3310712221,3603682643,1672546613,1672547485,872
10279,3703104365,3881785069,1672689402,1672691247,1845
11528,3202740652,3638823001,1672677099,1672680023,2924
10425,3779478448,3515802579,1672593041,1672594635,1594
11183,3307454562,3900195680,1672673922,1672674101,179
11423,3606804618,3311805161,1672672779,1672673833,1054
10679,3714870496,3701919083,1672548829,1672549180,351
11120,3925823748,3620836520,1672657018,1672659046,2028
10237,3903088144,3713416756,1672607930,1672608853,923
10496,3638823001,3450735824,1672631029,1672633768,2739
10302,3701412729,3777564559,1672689474,1672692654,3180
10776,3282240901,3353811455,1672606389,1672609651,3262
10433,3231654754,3711179193,1672676359,1672677467,1108
10318,3278430820,3701512498,1672589732,1672591137,1405
11012,3774195369,3770574826,1672655749,1672657039,1290
10944,3394976623,3904184638,1672567601,1672570882,3281
11451,3472561941,3397783490,1672586594,1672589981,3387
10811,3772320856,3623512088,1672585455,1672587422,1967
10701,3347760784,3534111498,1672551347,1672552852,1505
11560,3664523809,3423217578,1672618780,1672619945,1165
11283,3791905743,3780435349,1672652589,1672655315,2726
10436,3553694590,3930475498,1672598917,1672599994,1077
10907,3757796416,3519162582,1672571385,1672572056,671
9975,3977209952,3756680289,1672626565,1672627180,615
9824,3713954144,3636927297,1672675841,1672676300,459
10451,3772055279,3778702093,1672557612,1672560842,3230
10866,3930766276,3772188086,1672641263,1672643979,2716
11147,3688870751,3778273230,1672629080,1672630073,993
11093,3821103640,3447948483,1672615382,1672617731,2349
11277,3791074200,3369108286,1672614136,1672615860,1724
10299,3480405740,3511615015,1672554392,1672555977,1585
11129,3293540333,3811354125,1672665246,1672666248,1002
9842,3205908584,3505901826,1672563850,1672564522,672
11330,3518157683,3438818153,1672690530,1672693373,2843
10534,3354877289,3505665788,1672656565,1672656713,148
11063,3319862687,3920526713,1672534518,1672537061,2543
11764,3716541851,3318590083,1672643582,1672645485,1903
11701,3377446376,3516321814,1672682386,1672683007,621
11440,3711591464,3772802020,1672696218,1672699654,3436
10737,3360949039,3452878062,1672579709,1672581405,1696
11702,3777937949,3760901975,1672652968,1672654421,1453
11443,3396453219,3615742989,1672645773,1672649238,3465
10481,3665841655,3776193847,1672566372,1672568936,2564
10520,3773534165,3360525513,1672548358,1672549451,1093
11138,3711947828,3417268745,1672538297,1672539213,916
10753,3903088144,3618672178,1672559810,1672561173,1363
10999,3513186622,3500057674,1672682327,1672682525,198
10469,3334461288,3358385652,1672555267,1672556135,868
9848,3304661369,3701448521,1672614548,1672615037,489
10339,3776125503,3716740576,1672548599,1672551216,2617
11325,3501759031,3367202274,1672565455,1672567286,1831
10095,3885339157,3625931630,1672660132,1672663678,3546
11312,3553229537,3550405857,1672608317,1672610279,1962
9935,3914947393,3701448521,1672554337,1672557690,3353
11191,3714065165,3783506190,1672546820,1672548020,1200
9901,3917467642,3685645561,1672626261,1672629224,2963
10463,3514107131,3931028233,1672590735,1672592553,1818
11654,3500693568,3925823748,1672571168,1672573601,2433
10061,3447948483,3511969443,1672572840,1672573306,466
10198,3689420679,3421674406,1672630931,1672634027,3096
11741,3228465044,3919342147,1672626443,1672628669,2226
10014,3839744168,3244397548,1672644247,1672646726,2479
10336,3613828705,3471555057,1672542850,1672543213,363
10938,3436774112,3703277359,1672572181,1672573945,1764
10579,3772556646,3388937390,1672677782,1672681178,3396
10743,3476958001,3374652108,1672665038,1672668119,3081
10205,3911376818,3757514745,1672550249,1672551282,1033
10939,3703722212,3311045951,1672622979,1672624879,1900
10571,3935256825,3481365330,1672613232,1672615818,2586
11510,3510987684,3773085258,1672535024,1672535933,909
11273,3514341451,3832312129,1672632561,1672633400,839
10848,3703415246,3291617477,1672565177,1672565589,412
9938,3516019206,3608973523,1672587248,1672587874,626
11303,3801379377,3710813103,1672610716,1672612317,1601
10473,3793783685,3851810349,1672651109,1672653183,2074
10752,3505266343,3223512565,1672641124,1672644413,3289
11657,3738760498,3791106473,1672585595,1672588135,2540
11227,3739618347,3310021925,1672678520,1672679371,851
11275,3755767856,3776447604,1672696288,1672698236,1948
9847,3313502623,3621439107,1672681907,1672684988,3081
10974,3757823215,3897186782,1672627109,1672629895,2786
10530,3919814073,3509544691,1672590417,1672591332,915
11526,3291617477,3500342408,1672614358,1672617293,2935
10995,3774946684,3776291254,1672582747,1672584128,1381
11733,3515699732,3818532143,1672624947,1672626122,1175
10701,3823307824,3783809405,1672616045,1672619034,2989
11574,3779312237,3701475090,1672691585,1672692226,641
10198,3774744663,3756616853,1672564121,1672566145,2024
11690,3737685967,3517645656,1672627319,1672628516,1197
10483,3773688906,3760731595,1672532823,1672532961,138
10590,3512337054,3534174363,1672601772,1672602917,1145
9918,3711959141,3241567995,1672571842,1672571949,107
11000,3774029494,3978417055,1672590143,1672591448,1305
10021,3505786561,3518931700,1672572457,1672572762,305
11332,3505500523,3701655378,1672561700,1672562209,509
11236,3817076003,3311989687,1672618575,1672619645,1070
10024,3472774606,3773899531,1672535849,1672538493,2644
11601,3681274982,3793860209,1672587718,1672589368,1650
9930,3772188086,3890278838,1672562918,1672563355,437
9948,3520339198,3342031426,1672665861,1672667471,1610
9886,3803996569,3776593726,1672591906,1672594305,2399
11309,3886879696,3505665253,1672621262,1672623429,2167
10062,3533473206,3881579907,1672587782,1672588145,363
11513,3715923089,3931319307,1672588140,1672591701,3561
11299,3773669001,3514698862,1672674267,1672674749,482
11672,3774633364,3713285095,1672587134,1672587542,408
10965,3505482210,3972729768,1672666534,1672670050,3516
9900,3509370633,3520625600,1672538651,1672538942,291
11152,3533627473,3716160006,1672618496,1672619278,782
9970,3501734800,3826315540,1672649676,1672650946,1270
9997,3711856534,3205687719,1672657855,1672658029,174
10119,3500968729,3461877104,1672600070,1672600942,872
11158,3341985886,3222364320,1672659248,1672661895,2647
10622,3919814073,3760648750,1672578006,1672578305,299
9944,3621629499,3791108593,1672690513,1672692342,1829
11171,3444680955,3350169064,1672616223,1672617291,1068
10241,3714268380,3791698084,1672605985,1672606273,288
10527,3520155898,3335974305,1672607484,1672608786,1302
11715,3608973523,3446810761,1672571009,1672574245,3236
10358,3558264627,3809871495,1672678396,1672680878,2482
10465,3710296607,3625952981,1672648791,1672651673,2882
10641,3462985379,3341738186,1672683414,1672685193,1779
9908,3388923880,3509677530,1672559721,1672562285,2564
10756,3777263928,3760737203,1672639144,1672642283,3139
10058,3301369282,3517617472,1672672565,1672674276,1711
11744,3238796398,3755107521,1672618711,1672622030,3319
11307,3499142934,3534168768,1672551999,1672553456,1457
10445,3510022922,3385481989,1672542128,1672543263,1135
10181,3739297004,3778817220,1672650838,1672653085,2247
11508,3611533094,3400112498,1672672321,1672673673,1352
9854,3410602007,3919994216,1672602105,1672605608,3503
9958,3516429380,3559754304,1672594288,1672597202,2914
10238,3517499844,3780013266,1672644386,1672647918,3532
10063,3716492409,3778544203,1672554726,1672558051,3325
11539,3493598658,3777200549,1672557477,1672560935,3458
11025,3613940925,3444881567,1672596071,1672598712,2641
11599,3635433296,3783651407,1672643829,1672644651,822
11355,3441683673,3756843139,1672660106,1672661796,1690
11738,3338642026,3367299721,1672669104,1672672448,3344
10263,3624164232,3415032547,1672613334,1672614899,1565
10515,3220660616,3466620548,1672592725,1672596165,3440
11093,3773376762,3736056340,1672543903,1672546302,2399
11627,3772893815,3513111053,1672572418,1672575905,3487
11404,3780500764,3505331083,1672531337,1672531817,480
10709,3388830370,3435037864,1672662350,1672665256,2906
11625,3421956717,3228033254,1672633342,1672635672,2330
10056,3295530454,3247545468,1672580340,1672581319,979
10165,3922786716,3907039612,1672564143,1672564222,79
10034,3757001552,3477511446,1672652662,1672654070,1408
11731,3475090917,3511794841,1672531244,1672532425,1181
10813,3604908372,3793699467,1672543541,1672545771,2230
11611,3757872458,3334633634,1672573726,1672574921,1195
10899,3779454060,3344478603,1672628698,1672630146,1448
10101,3533036499,3489205994,1672557391,1672559570,2179
9967,3732596503,3791245127,1672567684,1672569958,2274
11654,3669475165,3773953689,1672616784,1672619331,2547
11146,3716095450,3380285779,1672586825,1672588148,1323
10582,3791587717,3308149799,1672594594,1672595840,1246
9866,3495427619,3272581469,1672564197,1672565981,1784
11341,3609644043,3850735936,1672551644,1672553787,2143
11753,3500720752,3500536897,1672677054,1672680262,3208
11108,3780148144,3284334297,1672638384,1672641224,2840
11003,3756297396,3772343750,1672562704,1672564543,1839
11244,3760416450,3834456158,1672559600,1672562766,3166
10656,3511218261,3609997804,1672580338,1672581568,1230
10422,3880788853,3978417055,1672536532,1672537277,745
10565,3513629502,3489340327,1672532996,1672535419,2423
10021,3417223898,3304697982,1672648844,1672651719,2875
11695,3818324410,3355880028,1672588352,1672590765,2413
11195,3510262025,3505490878,1672688580,1672691471,2891
10789,3311264420,3760541837,1672655338,1672656523,1185
10489,3358675021,3933469838,1672651343,1672653797,2454
11781,3772234939,3770476738,1672616521,1672618700,2179
11151,3239082508,3509828883,1672596185,1672597863,1678
11737,3907088952,3389069291,1672686795,1672687069,274
10946,3414841458,3783157469,1672635088,1672637927,2839
9987,3772234939,3792497486,1672693852,1672694802,950
10406,3534604516,3624872714,1672578983,1672581677,2694
11593,3664719070,3500234771,1672588404,1672590190,1786
10203,3209958726,3737571883,1672587663,1672589482,1819
11253,3900793652,3783935976,1672635818,1672637533,1715
10778,3445896667,3505901826,1672539265,1672541552,2287
10427,3713471446,3285587972,1672627975,1672629904,1929
10481,3419378107,3559123082,1672589533,1672590272,739
10270,3760107540,3791548838,1672649590,1672652809,3219
10741,3713416756,3902775449,1672703762,1672705499,1737
11065,3927202773,3276230295,1672633896,1672635996,2100
11630,3512101369,3423782420,1672660910,1672663078,2168
10462,3936486724,3621629499,1672620321,1672621001,680
11054,3770486161,3505624416,1672543871,1672544651,780
11050,3275751794,3710008760,1672657534,1672660250,2716
10258,3856316719,3757212744,1672574536,1672575011,475
10236,3791031227,3224053840,1672682520,1672682890,370
11791,3505414878,3778842400,1672600858,1672601332,474
10011,3498803823,3972847837,1672583890,1672587426,3536
10076,3928076270,3820422111,1672676983,1672680460,3477
10080,3333505404,3887502536,1672603257,1672604647,1390
9906,3472774606,3275274182,1672676940,1672677115,175
11305,3509508477,3519352855,1672585284,1672588823,3539
10206,3496352027,3851451801,1672616949,1672619167,2218
11648,3485468650,3376842515,1672537642,1672539739,2097
11535,3703104365,3287403291,1672683752,1672684037,285
10001,3221736756,3519947298,1672560442,1672563326,2884
10954,3703336988,3414841458,1672546219,1672549386,3167
10931,3710316008,3770780655,1672611328,1672613166,1838
10819,3772844451,3711076751,1672618890,1672621408,2518
10296,3509018337,3514353133,1672645430,1672646190,760
10490,3477951091,3282240901,1672685706,1672688161,2455
10909,3757032266,3509355477,1672599643,1672600550,907
9896,3770424892,3534206917,1672570324,1672571081,757
11254,3471131277,3475653510,1672620309,1672620597,288
9905,3780298499,3780941637,1672632972,1672634614,1642
11102,3701218904,3855077502,1672636773,1672638920,2147
10450,3492728794,3783172505,1672624161,1672626420,2259
11281,3491390365,3520558137,1672682153,1672684807,2654
10564,3925792265,3557324887,1672564559,1672566426,1867
10072,3423782420,3334936138,1672651898,1672654115,2217
10224,3342495377,3489212992,1672616295,1672616924,629
11584,3814378625,3293579860,1672633468,1672635431,1963
11093,3773440794,3852310652,1672681125,1672681246,121
10107,3303432071,3404375908,1672593510,1672597088,3578
10378,3773603836,3701265238,1672703790,1672704763,973
11287,3791351852,3772019557,1672667278,1672670216,2938
11242,3902682060,3359929534,1672649463,1672649905,442
10918,3701028092,3534068874,1672578351,1672580202,1851
11138,3533225084,3297624618,1672691431,1672692312,881
9970,3444453261,3510781595,1672645933,1672649469,3536
10779,3857909328,3756066765,1672603921,1672604507,586
9970,3856699097,3279102372,1672678388,1672681669,3281
10470,3437703650,3388537708,1672544227,1672546584,2357
9868,3777370992,3367242388,1672672870,1672673900,1030
10575,3202740652,3516335333,1672548103,1672548401,298
10531,3882851213,3359351267,1672683995,1672686955,2960
11257,3772869013,3780740477,1672535587,1672537533,1946
10610,3442073613,3976742903,1672663999,1672665731,1732
11143,3436018575,3710082615,1672614828,1672615676,848
9989,3469663062,3361952532,1672586990,1672590175,3185
10778,3772968080,3777200549,1672537430,1672538629,1199
10954,3772112976,3315432466,1672574921,1672576157,1236
10206,3701567668,3519848902,1672587659,1672589052,1393
10472,3511466117,3450342110,1672581541,1672582979,1438
11007,3279731391,3713444403,1672682649,1672686102,3453
10912,3352057037,3773554767,1672595860,1672599092,3232
9993,3859191694,3438818153,1672619051,1672620173,1122
10237,3713471446,3773032706,1672534710,1672537196,2486
10474,3636877469,3773434690,1672645604,1672645664,60
10638,3776309810,3238056215,1672641267,1672643041,1774
11040,3791269060,3203876438,1672645924,1672649301,3377
10977,3316121649,3447696555,1672682691,1672683431,740
10767,3468343480,3778932673,1672537025,1672539138,2113
10186,3397330170,3391093411,1672587658,1672590428,2770
10998,3774627091,3716595760,1672671179,1672674218,3039
11071,3632094087,3334461288,1672595979,1672599134,3155
9906,3635433296,3439045964,1672652577,1672656011,3434
10733,3703277359,3812261241,1672559741,1672563166,3425
10443,3239401337,3604908372,1672665412,1672667712,2300
11678,3896200048,3505867821,1672620352,1672622893,2541
10614,3930727474,3756717136,1672537668,1672541237,3569
9924,3792633495,3773895671,1672690870,1672693755,2885
11503,3340897079,3516444589,1672593102,1672595101,1999
11149,3686211958,3806720019,1672565548,1672568857,3309
10039,3701893620,3342056927,1672609875,1672611255,1380
10952,3714870496,3823600319,1672542199,1672543034,835
11152,3310961923,3500444748,1672675379,1672675557,178
11750,3305612422,3303772923,1672655338,1672655887,549
10386,3422915648,3201419050,1672563503,1672566836,3333
10481,3909067335,3228218081,1672569987,1672570239,252
10875,3605905645,3755394177,1672644734,1672645483,749
11221,3367242388,3884001167,1672699578,1672701655,2077
10796,3378747834,3783942518,1672674860,1672675509,649
11189,3780466967,3760648750,1672594762,1672596627,1865
10130,3339478490,3500922040,1672588475,1672591058,2583
10702,3517551721,3519255644,1672694870,1672697155,2285
11063,3885545415,3792578118,1672596202,1672598919,2717
10863,3773434690,3220798451,1672570839,1672573498,2659
10038,3604569804,3249380931,1672546182,1672546897,715
10375,3711258452,3510680251,1672551122,1672554060,2938
10616,3772235668,3435715962,1672545501,1672547418,1917
10200,3518425740,3701284535,1672647345,1672647757,412
11239,3247193800,3224053074,1672535699,1672537364,1665
10381,3511245705,3711767051,1672531766,1672532036,270
10244,3792708936,3939882169,1672558041,1672558614,573
10565,3773736248,3284374600,1672531597,1672534291,2694
9922,3907225070,3711029952,1672590512,1672593668,3156
11260,3971051020,3509073025,1672594097,1672596181,2084
11760,3533726421,3519947298,1672551051,1672554638,3587
10960,3278779955,3824135033,1672616856,1672617829,973
11638,3711613085,3777706200,1672581981,1672582987,1006
10364,3514389188,3710865678,1672585129,1672586112,983
11512,3491758029,3711856534,1672619639,1672621565,1926
11705,3813111107,3756149282,1672571438,1672572518,1080
9994,3836090778,3515577866,1672574169,1672575925,1756
10365,3886879696,3301431129,1672554965,1672555342,377
11224,3397527886,3518759318,1672623110,1672626516,3406
10458,3373802545,3701359045,1672548491,1672552025,3534
10413,3203172170,3279851026,1672668373,1672670293,1920
10598,3500209015,3243305367,1672586453,1672589596,3143
11024,3406238754,3515974881,1672585691,1672586627,936
10900,3467663782,3235578852,1672608477,1672611069,2592
10942,3424997707,3354015456,1672536999,1672539491,2492
10836,3639465750,3534984243,1672623924,1672624411,487
10236,3517632796,3512480125,1672548617,1672549703,1086
10594,3470135167,3703423962,1672592267,1672593569,1302
10283,3520725149,3514450836,1672635992,1672639327,3335
10767,3776593726,3811629200,1672637539,1672639333,1794
10274,3517426473,3358211034,1672606349,1672608489,2140
9862,3235578852,3440770466,1672680108,1672682077,1969
11769,3380444321,3209280342,1672699964,1672701837,1873
9915,3622218289,3915679140,1672634789,1672635611,822
10059,3780213684,3777149336,1672534196,1672535581,1385
11405,3701725839,3345954031,1672614611,1672614870,259
10165,3703588004,3390537737,1672564934,1672566052,1118
10586,3487278983,3511028193,1672585439,1672585702,263
11307,3310021925,3388937390,1672659724,1672663050,3326
10219,3756647451,3832902787,1672586958,1672587876,918
10660,3977157565,3377311502,1672553773,1672554257,484
11543,3347996015,3809871495,1672574261,1672576803,2542
11274,3509379617,3246804115,1672588382,1672590216,1834
10462,3316117186,3429409539,1672638726,1672640760,2034
10631,3283295213,3235313062,1672691789,1672692033,244
10154,3887918622,3358675021,1672690895,1672693118,2223
10380,3552261072,3509370633,1672590091,1672590548,457
10697,3403988682,3755119166,1672582743,1672585694,2951
11531,3851737350,3760396348,1672664033,1672665196,1163
10580,3779454060,3519924982,1672555317,1672555919,602
10271,3777112124,3511341866,1672541699,1672542467,768
11010,3714067998,3496407500,1672620831,1672622932,2101
10538,3380628097,3505119470,1672623193,1672625816,2623
11241,3512769522,3311583437,1672668135,1672668931,796
10791,3375257546,3684651755,1672616057,1672618228,2171
10043,3791245127,3462645981,1672613925,1672617260,3335
11759,3311810583,3500793739,1672558257,1672559549,1292
11447,3501261089,3344710271,1672700267,1672703491,3224
9818,3272827860,3517325365,1672541687,1672543991,2304
11631,3773032706,3778195766,1672645752,1672648239,2487
10167,3929923442,3793081195,1672610167,1672610639,472
10976,3288791629,3447202943,1672598983,1672599225,242
11685,3732846295,3688870751,1672558326,1672561682,3356
11726,3514352989,3777729184,1672567094,1672567525,431
11459,3533929043,3881012415,1672697045,1672699799,2754
11429,3928508375,3713805968,1672678871,1672679915,1044
11646,3275735969,3819315404,1672582231,1672583561,1330
11090,3780048608,3716841469,1672604210,1672607311,3101
10920,3773895671,3304227085,1672687246,1672690597,3351
10554,3514941815,3500544306,1672587891,1672589048,1157
11463,3245121919,3444168914,1672633510,1672634715,1205
9839,3442073613,3520926977,1672652700,1672654807,2107
10864,3776593726,3510824484,1672687867,1672689014,1147
10475,3896200048,3711804184,1672677778,1672678663,885
11787,3408982612,3342368576,1672614395,1672616319,1924
11504,3378729459,3777686966,1672602428,1672603476,1048
10761,3425646356,3612841103,1672642293,1672645317,3024
10585,3287753579,3376487118,1672645314,1672645595,281
11353,3825795004,3500591274,1672656407,1672659285,2878
10918,3509073025,3505148522,1672539307,1672540819,1512
11066,3428878402,3435801763,1672694511,1672696924,2413
10588,3791245127,3501657158,1672548649,1672551622,2973
10105,3774939922,3445355677,1672632936,1672636487,3551
11626,3760416450,3500624846,1672631495,1672632035,540
10048,3683562111,3534374523,1672676373,1672678586,2213
10109,3501734800,3491390365,1672602993,1672603337,344
10785,3343698137,3422460919,1672625319,1672625671,352
10691,3397783490,3534328311,1672634816,1672637934,3118
10478,3458432407,3513111053,1672642936,1672643624,688
11196,3500833053,3406492167,1672639242,1672639541,299
10252,3933106901,3791108593,1672556920,1672558072,1152
10033,3793222045,3241682278,1672699642,1672703085,3443
10744,3511750850,3511750850,1672584366,1672585781,1415
11334,3896123242,3514571807,1672599922,1672602356,2434
10346,3777135415,3368339963,1672664800,1672668125,3325
10089,3853275529,3533642281,1672576231,1672576753,522
11596,3780435349,3501977123,1672601924,1672602827,903
11523,3711959141,3554437212,1672571194,1672573690,2496
11752,3757050615,3206926634,1672543156,1672544756,1600
10892,3757446082,3501557463,1672688980,1672689401,421
10603,3778479297,3533365834,1672566713,1672569893,3180
10861,3334708091,3803473387,1672609331,1672610491,1160
10121,3715923089,3909457959,1672564012,1672566174,2162
10146,3886896755,3757604311,1672637599,1672639538,1939
10665,3516359146,3518408734,1672598845,1672601881,3036
10436,3505502819,3478937459,1672611844,1672611991,147
11709,3520506192,3554437212,1672654226,1672655919,1693
11497,3713170867,3312651192,1672539469,1672539549,80
10961,3520925688,3552444228,1672568178,1672570577,2399
11495,3515284733,3500405175,1672620860,1672622334,1474
11282,3793274846,3737467358,1672548880,1672552447,3567
11257,3558567160,3755924094,1672650757,1672651187,430
11225,3533566754,3711219767,1672556493,1672558007,1514
11413,3778125688,3393128259,1672698607,1672700709,2102
11273,3776867553,3814770073,1672534498,1672536284,1786
9878,3479585868,3509445318,1672613081,1672614238,1157
9869,3710046567,3777074709,1672667814,1672668052,238
11323,3275661834,3755154460,1672580327,1672582406,2079
10478,3907245259,3501828287,1672610072,1672610798,726
10502,3511218261,3906874577,1672564616,1672567402,2786
10462,3757001552,3454151554,1672575082,1672575240,158
11456,3205948776,3716994924,1672591407,1672593103,1696
10508,3774589551,3505665788,1672680695,1672682035,1340
11592,3919494952,3757773786,1672662558,1672663248,690
11628,3402020492,3519730914,1672652093,1672654047,1954
10936,3856601074,3899294071,1672626592,1672629073,2481
11207,3621960662,3519046342,1672539394,1672541804,2410
10664,3485468650,3896840409,1672635948,1672638968,3020
11273,3881579907,3392010033,1672699198,1672700615,1417
10587,3488333295,3733411026,1672655377,1672655647,270
10164,3205113625,3301431129,1672540084,1672543539,3455
11680,3516655509,3710622746,1672544582,1672544866,284
10582,3284407073,3777149336,1672565501,1672566071,570
10578,3391612879,3234445133,1672574408,1672576346,1938
10676,3906874577,3352493805,1672615382,1672617204,1822
11031,3472718723,3757201138,1672598222,1672599176,954
11441,3772867078,3888903181,1672579546,1672582488,2942
10047,3733123020,3814378625,1672629527,1672630132,605
11142,3903994989,3511199555,1672622829,1672623043,214
10672,3495152069,3287968403,1672609548,1672611037,1489
9805,3770671714,3715852330,1672546178,1672546668,490
10979,3450342110,3776122272,1672667848,1672671439,3591
11623,3832902787,3813111107,1672566790,1672568543,1753
11780,3757944870,3518368900,1672549859,1672550406,547
11237,3501126057,3701512498,1672572211,1672574843,2632
9902,3395069149,3812261241,1672681709,1672685029,3320
10352,3857909328,3715724166,1672547894,1672550371,2477
10769,3516572212,3730115019,1672656341,1672658229,1888
9883,3462645981,3238796398,1672703662,1672705549,1887
9887,3701493094,3918981936,1672659649,1672662866,3217
10930,3757311529,3778253021,1672643783,1672646402,2619
11559,3500596577,3772070986,1672669223,1672670387,1164
10172,3613940925,3450735824,1672612185,1672614314,2129
9857,3604908372,3246381831,1672650582,1672652612,2030
10467,3368339963,3780969898,1672699985,1672702767,2782
10725,3773083407,3500785888,1672644855,1672645877,1022
11732,3505032644,3715111016,1672610874,1672611091,217
10555,3804707712,3236254381,1672609442,1672609901,459
11615,3776034313,3517756624,1672536911,1672539123,2212
10544,3776304080,3367109648,1672555498,1672556184,686
10245,3926065090,3669427589,1672572094,1672575458,3364
11234,3701060732,3836586875,1672675746,1672678287,2541
9878,3619676231,3311305760,1672556269,1672557984,1715
10656,3770476738,3389069291,1672583339,1672585232,1893
11389,3885645840,3774506868,1672680648,1672682745,2097
10140,3772234939,3479585868,1672622775,1672623671,896
10894,3711810752,3382308738,1672676128,1672677529,1401
11210,3977360666,3757598610,1672696271,1672698291,2020
11385,3783809405,3550206045,1672637554,1672640740,3186
11561,3778932673,3633294415,1672536055,1672537216,1161
11161,3330188769,3510178791,1672605531,1672605734,203
9924,3398021818,3514353133,1672674126,1672676887,2761
10788,3792633495,3730459093,1672616650,1672619274,2624
11515,3939851140,3756079870,1672628496,1672630568,2072
11497,3716541851,3289771213,1672585637,1672586544,907
11698,3779706467,3373135211,1672677528,1672679228,1700
10542,3936486724,3776034313,1672584236,1672586796,2560
10578,3903065952,3201634072,1672575253,1672576153,900
9941,3512480125,3379517265,1672560809,1672564051,3242
10376,3934280144,3500019810,1672697841,1672698428,587
10064,3890194669,3500079479,1672633326,1672633928,602
11691,3792682835,3516463579,1672627690,1672628723,1033
11256,3381055770,3518368900,1672610321,1672612411,2090
9905,3777060250,3430296808,1672551674,1672552021,347
10015,3516020922,3500596577,1672551982,1672553764,1782
9923,3359418136,3534284132,1672621236,1672622137,901
11472,3511311554,3825795004,1672540662,1672541849,1187
11744,3713969196,3737050849,1672586034,1672589093,3059
10311,3773534165,3459163055,1672670118,1672670503,385
11713,3710861700,3501628472,1672695111,1672698205,3094
11508,3360949039,3511311554,1672648517,1672651657,3140
10351,3303432071,3770564547,1672632379,1672632539,160
10533,3480108752,3757406215,1672540526,1672543788,3262
9844,3514560138,3509996827,1672643368,1672646724,3356
10272,3301431129,3552261072,1672590444,1672592179,1735
10380,3757128722,3703423962,1672580777,1672583590,2813
10643,3804840997,3501225887,1672619333,1672622876,3543
10451,3701265238,3516335333,1672690216,1672692325,2109
11066,3629248353,3606804618,1672558751,1672558914,163
10422,3896840409,3805831563,1672603320,1672605717,2397
10826,3492350318,3505538902,1672695180,1672698457,3277
11429,3756890980,3669283586,1672548109,1672550151,2042
10101,3520344592,3239401337,1672562474,1672564614,2140
11372,3476144563,3510454018,1672680477,1672681112,635
11023,3366566029,3778124514,1672567514,1672569394,1880
11127,3472561941,3755218683,1672641975,1672643183,1208
10924,3757198930,3972442654,1672630058,1672630601,543
11175,3406492167,3311514075,1672609638,1672610210,572
9838,3896840409,3713107380,1672654242,1672657050,2808
10563,3665603628,3512395783,1672599151,1672601406,2255
9937,3419762444,3500444748,1672647919,1672651258,3339
9990,3271719569,3919994216,1672550534,1672552499,1965
10629,3510250740,3505685294,1672577446,1672579545,2099
11224,3912915644,3228056289,1672690517,1672691090,573
9858,3352044245,3774326754,1672579443,1672581293,1850
9821,3772489471,3701978422,1672594544,1672594676,132
10983,3510189563,3855209450,1672644770,1672648105,3335
11200,3559619861,3512477276,1672549105,1672552461,3356
11176,3533859712,3447554599,1672638861,1672639842,981
11182,3714731729,3553229537,1672624189,1672627461,3272
10978,3435342362,3272827860,1672672762,1672676211,3449
9872,3701971784,3701925712,1672673549,1672673755,206
11399,3899294071,3772966919,1672562520,1672563929,1409
11235,3792719263,3533867833,1672675559,1672675843,284
11031,3792797648,3853275529,1672602874,1672606341,3467
9833,3364067937,3501126057,1672637765,1672640805,3040
11690,3757513651,3551833298,1672696768,1672697729,961
10981,3909457959,3517377614,1672659622,1672661611,1989
10319,3938059867,3505786561,1672653057,1672655586,2529
11714,3838748301,3233712975,1672653270,1672656861,3591
10856,3776950532,3368339963,1672619438,1672620645,1207
10081,3711219767,3516249472,1672690352,1672692887,2535
9964,3513250976,3636885498,1672560946,1672561811,865
9857,3783086267,3755203055,1672587023,1672588322,1299
10790,3499142934,3774205060,1672632851,1672635621,2770
10499,3339649817,3515944817,1672549466,1672552686,3220
9868,3447591143,3714312797,1672685271,1672688768,3497
11615,3511003541,3462985379,1672694288,1672697806,3518
9852,3342056927,3776348451,1672612082,1672614906,2824
10380,3792411831,3701171318,1672533562,1672534177,615
11322,3737685967,3473562779,1672578651,1672579830,1179
9852,3681504869,3343698137,1672589135,1672590979,1844
10668,3519260216,3240877710,1672677268,1672677452,184
10316,3505720915,3902548260,1672686786,1672687713,927
11399,3812677669,3857389270,1672590089,1672593048,2959
10429,3780466967,3701311947,1672575224,1672577483,2259
11301,3489212992,3311959533,1672671424,1672672624,1200
11342,3517440258,3450234157,1672584492,1672585167,675
11176,3822315407,3514007122,1672699790,1672701899,2109
10961,3756367938,3779169946,1672562440,1672565782,3342
9817,3519521903,3792432094,1672653035,1672655319,2284
10573,3665603628,3791522832,1672554893,1672555920,1027
10116,3803996569,3716195780,1672568011,1672569956,1945
9903,3203457161,3505547832,1672560254,1672562188,1934
10603,3224053840,3467944159,1672624501,1672627823,3322
9877,3770480149,3379076106,1672688848,1672689764,916
11575,3235578852,3884933821,1672602282,1672604034,1752
10438,3896840409,3711862792,1672617489,1672618129,640
10020,3925792265,3780969898,1672669920,1672670921,1001
11198,3511412229,3471177177,1672659944,1672662427,2483
11030,3756668747,3777706200,1672650621,1672651651,1030
10493,3974400577,3491948594,1672586809,1672587726,917
11621,3478937459,3207748225,1672622878,1672625545,2667
10507,3517558635,3910049345,1672550305,1672551434,1129
11688,3288791629,3760901975,1672629894,1672632414,2520
10344,3505414878,3311197635,1672630869,1672631850,981
11634,3773556853,3495446254,1672688601,1672689307,706
11299,3557653200,3853783593,1672595634,1672596844,1210
9961,3501027795,3791072829,1672618835,1672619141,306
11723,3783201950,3472018395,1672561219,1672562665,1446
11735,3710316008,3512819376,1672570948,1672572251,1303
11585,3783060739,3500927619,1672611448,1672614568,3120
10119,3418367752,3511004622,1672553102,1672556047,2945
11337,3505245692,3779723939,1672636521,1672637928,1407
11387,3311515179,3510680251,1672587689,1672591270,3581
9953,3783067048,3519341916,1672554665,1672556602,1937
11493,3774251051,3623113240,1672649772,1672649884,112
9888,3770574826,3500864577,1672546924,1672548488,1564
10794,3427741923,3703742071,1672587013,1672589946,2933
10477,3774946684,3755865626,1672694169,1672694314,145
9991,3534758256,3920155862,1672629446,1672631407,1961
9822,3417223898,3701028092,1672543116,1672544692,1576
10573,3505414878,3703438617,1672628734,1672630921,2187
11228,3755378125,3479452888,1672671306,1672672090,784
10185,3755107521,3909399636,1672640666,1672643224,2558
10814,3710125627,3780148144,1672620905,1672622976,2071
9866,3773853619,3777729184,1672588327,1672588751,424
9863,3520763492,3683562111,1672663975,1672667325,3350
11028,3929923442,3519435459,1672641008,1672642395,1387
11633,3435715962,3452878062,1672541860,1672545401,3541
10947,3274341934,3512625661,1672636428,1672637501,1073
10725,3510694464,3500674240,1672549473,1672551881,2408
10713,3319436533,3512794667,1672625262,1672628236,2974
10202,3559754304,3446810761,1672544965,1672547992,3027
10480,3770595035,3303432071,1672539963,1672542206,2243
10797,3755465396,3837885956,1672664909,1672667489,2580
10007,3611939581,3804840997,1672641282,1672643388,2106
10782,3224824355,3476958001,1672660963,1672661256,293
10449,3304235700,3778125688,1672553136,1672553906,770
9900,3310961923,3505482210,1672601892,1672605045,3153
11540,3814378625,3755286041,1672664042,1672665866,1824
11300,3342545285,3932566114,1672552892,1672554545,1653
10752,3776348472,3389367628,1672626786,1672630165,3379
11563,3737745988,3439045964,1672671071,1672671741,670
11583,3500927619,3903994989,1672653685,1672657239,3554
10209,3756998113,3395565040,1672633267,1672635428,2161
10563,3685877449,3510939082,1672556213,1672557216,1003
10268,3534758256,3406169279,1672659236,1672662738,3502
11177,3277061226,3520926977,1672635468,1672636113,645
10665,3792021895,3515507526,1672699431,1672701548,2117
10281,3205908584,3772169046,1672585902,1672586929,1027
11731,3452677710,3809216145,1672583490,1672584019,529
10830,3477248170,3770424941,1672600396,1672602962,2566
10927,3757497708,3308744016,1672651701,1672653966,2265
10403,3801501384,3755342153,1672643628,1672646218,2590
9924,3608214600,3807646028,1672695560,1672695708,148
10986,3772751765,3343193067,1672633983,1672634737,754
10079,3510153173,3760074281,1672645891,1672649138,3247
11358,3515970536,3510262025,1672532442,1672533550,1108
11183,3776841808,3518882056,1672653874,1672656123,2249
9993,3514698862,3783313202,1672641132,1672641219,87
11028,3517469005,3279102372,1672605070,1672606376,1306
11224,3483347530,3279726491,1672573890,1672576872,2982
10650,3515726910,3518368900,1672694831,1672697771,2940
9904,3783935976,3757639274,1672620265,1672623486,3221
11179,3711131262,3236563828,1672703073,1672704464,1391
10784,3513890046,3246296769,1672628561,1672631051,2490
10078,3793874490,3516706121,1672698747,1672699321,574
11044,3368848936,3453164933,1672698975,1672699822,847
10855,3372079985,3513624915,1672554687,1672557991,3304
11094,3716526314,3773798215,1672561238,1672562442,1204
11346,3500356342,3701065296,1672635654,1672635944,290
10792,3716492409,3894328297,1672588923,1672591108,2185
10502,3662794240,3850904092,1672535895,1672536585,690
11728,3311264420,3713858538,1672671794,1672674441,2647
10391,3510869438,3778044082,1672579819,1672580011,192
10188,3793814153,3713416756,1672578460,1672579353,893
11014,3404461403,3713875941,1672575963,1672578655,2692
10144,3605078841,3291153514,1672622084,1672623650,1566
10078,3520155898,3910190872,1672607635,1672610046,2411
10611,3555764822,3239401337,1672575560,1672576473,913
10833,3756647451,3373802545,1672689491,1672691076,1585
10090,3454554552,3711770853,1672596040,1672599050,3010
11700,3471177177,3341985886,1672628590,1672630473,1883
11581,3511182297,3756761603,1672676607,1672680008,3401
11583,3270607273,3369108286,1672670618,1672673830,3212
10275,3426207439,3276231633,1672678030,1672680395,2365
11422,3783157469,3519513219,1672577468,1672577981,513
9856,3792173463,3311479294,1672613882,1672615268,1386
10256,3897003751,3772569860,1672648755,1672650078,1323
10093,3701596047,3240877710,1672608958,1672611660,2702
10727,3533830748,3908464960,1672688045,1672689708,1663
10696,3710082615,3792075871,1672669510,1672670413,903
11362,3776348451,3856147380,1672668847,1672669699,852
11599,3815440588,3520470646,1672557984,1672558188,204
9971,3492350318,3288920399,1672591204,1672591944,740
11214,3203876438,3311904032,1672658844,1672658942,98
11317,3277061226,3534284132,1672643824,1672644940,1116
11781,3910354786,3226037966,1672694091,1672694604,513
10913,3500889287,3517210356,1672627687,1672630295,2608
10306,3837885956,3334708091,1672593334,1672596704,3370
10089,3791574640,3357026115,1672669554,1672670826,1272
11646,3505119470,3810818108,1672569571,1672572533,2962
10375,3475033290,3247193800,1672683003,1672685248,2245
10182,3919342147,3772296376,1672572879,1672575537,2658
11066,3680939042,3837885956,1672684895,1672687121,2226
10057,3518209090,3714718326,1672676321,1672679776,3455
10347,3354015456,3770273966,1672585734,1672586566,832
10648,3308759754,3776447604,1672646395,1672649882,3487
9942,3756897029,3510795808,1672605023,1672608138,3115
10752,3510454018,3516200419,1672600060,1672600520,460
11393,3393376416,3465672238,1672657168,1672659889,2721
10333,3555378248,3512681214,1672666350,1672668187,1837
10294,3772343750,3397972945,1672597666,1672598183,517
11469,3757549235,3239779992,1672602484,1672603814,1330
11090,3415803494,3509018337,1672615215,1672618657,3442
10013,3452024572,3311904032,1672684649,1672687843,3194
9891,3853182912,3756157377,1672687502,1672689881,2379
9863,3793274846,3369108286,1672643184,1672645640,2456
11295,3734233216,3774702364,1672596518,1672599676,3158
11116,3533830748,3519297683,1672669879,1672672547,2668
11112,3273537848,3511286390,1672606158,1672608703,2545
9926,3715114417,3360525513,1672655319,1672658335,3016
11673,3776440009,3556684272,1672626499,1672629729,3230
11608,3811629200,3359929534,1672685880,1672687749,1869
10067,3227059650,3485151614,1672648157,1672651187,3030
10676,3665603628,3714883746,1672560449,1672563440,2991
11714,3243651036,3971447562,1672550364,1672551292,928
11173,3703277359,3772019557,1672649364,1672650059,695
10725,3783935976,3474852115,1672537597,1672540502,2905
10634,3418367752,3358959807,1672701505,1672702695,1190
11439,3406101720,3447202943,1672632177,1672634599,2422
11239,3815700240,3662507634,1672647486,1672647986,500
11568,3780168985,3739075176,1672620288,1672621201,913
10527,3487988841,3516359146,1672701815,1672704788,2973
11769,3850181934,3384601925,1672700480,1672701747,1267
10629,3793274846,3402774497,1672701941,1672703532,1591
9796,3510795808,3624365837,1672569939,1672570900,961
10343,3429333292,3802374620,1672645508,1672646237,729
10025,3710223875,3915195160,1672544586,1672545188,602
9795,3553321027,3970775805,1672679310,1672680009,699
9870,3701512498,3783947742,1672632861,1672633141,280
11451,3240622654,3757607649,1672655544,1672655981,437
9967,3611533094,3500104976,1672604671,1672606108,1437
10478,3777118499,3429610195,1672657847,1672660860,3013
11457,3928076270,3703351452,1672635917,1672638876,2959
11156,3515100211,3812261241,1672627005,1672629766,2761
11389,3331471764,3755729826,1672701425,1672703919,2494
11517,3517627003,3777569538,1672636155,1672639637,3482
10580,3777878462,3772223331,1672542794,1672545791,2997
10665,3809194824,3791332061,1672554709,1672557950,3241
10193,3665841655,3500178849,1672622861,1672625867,3006
10463,3703206956,3519352855,1672596339,1672596855,516
10434,3714142299,3711287751,1672596908,1672598341,1433
11502,3756363182,3441737317,1672617455,1672620542,3087
11293,3929002318,3374652108,1672632671,1672633011,340
11281,3347140733,3908878965,1672559666,1672562552,2886
10153,3776053084,3664523809,1672686319,1672688002,1683
10983,3511296895,3505392452,1672635003,1672635911,908
10705,3780308809,3429333292,1672555865,1672557181,1316
10938,3806034626,3364948616,1672547503,1672548689,1186
9882,3703474558,3776867553,1672556223,1672558603,2380
11510,3703818358,3899156705,1672553670,1672557156,3486
10205,3207497598,3301369282,1672670992,1672672090,1098
11072,3914926436,3297624618,1672693559,1672694337,778
10514,3793497672,3505121295,1672531848,1672535156,3308
11782,3424476995,3513802404,1672548846,1672551225,2379
10609,3777672363,3509360869,1672665232,1672666810,1578
10990,3772909073,3480405740,1672655964,1672659407,3443
10671,3385124073,3391093411,1672663922,1672664591,669
10632,3517756624,3360972732,1672556247,1672556731,484
11487,3228477490,3919349138,1672674157,1672675185,1028
10970,3827889533,3716445184,1672620527,1672622568,2041
9992,3379400553,3310021925,1672585573,1672587005,1432
11345,3972442654,3304030474,1672636281,1672637074,793
11259,3912878303,3701412729,1672614236,1672615940,1704
10994,3515548696,3308149799,1672594458,1672596083,1625
10054,3505266343,3422205569,1672677286,1672679691,2405
11100,3357496255,3276230295,1672653535,1672655480,1945
11686,3362368123,3518534560,1672634049,1672637164,3115
10438,3396656251,3661543201,1672545281,1672545598,317
9927,3220798451,3440401725,1672598507,1672600110,1603
10043,3516153301,3616242727,1672577098,1672578475,1377
10223,3716467469,3660980656,1672558183,1672561562,3379
10547,3607288879,3483701493,1672553821,1672554876,1055
11698,3778986795,3822368676,1672684527,1672684954,427
10412,3701291994,3831864108,1672592869,1672595642,2773
10244,3505697295,3515607283,1672566832,1672570213,3381
10091,3600441934,3467232654,1672570447,1672570912,465
10554,3295710494,3287689454,1672594813,1672597094,2281
11548,3457249798,3201957157,1672547093,1672548828,1735
11737,3465690527,3715039960,1672600074,1672600354,280
10994,3505011956,3511969443,1672617359,1672620627,3268
11710,3419829238,3686644062,1672556002,1672556634,632
10845,3303432071,3703048107,1672536821,1672538242,1421
11259,3792411831,3514515499,1672635873,1672639019,3146
11777,3791368349,3792277399,1672695606,1672696808,1202
10623,3517227599,3518368900,1672541431,1672541557,126
10989,3379400553,3890194669,1672541469,1672543622,2153
10699,3501554468,3299587876,1672590762,1672590906,144
9923,3770408300,3772980989,1672585392,1672585532,140
10663,3711131262,3387413950,1672608431,1672609214,783
11326,3388537708,3774316305,1672681051,1672681888,837
11143,3638018906,3391612879,1672596744,1672597400,656
11189,3890211161,3793783685,1672662601,1672664730,2129
11573,3301489209,3223512565,1672534030,1672536546,2516
10774,3715490209,3313298164,1672575678,1672578273,2595
10900,3452024572,3774316305,1672636773,1672638971,2198
10373,3669497617,3380444321,1672534356,1672537047,2691
9816,3349573092,3397783490,1672608147,1672608625,478
11578,3710082615,3236512807,1672654799,1672655570,771
11556,3926724515,3662307789,1672656863,1672659393,2530
10525,3509317054,3533703578,1672586991,1672590097,3106
9964,3201634072,3510233949,1672693768,1672696568,2800
10307,3793222045,3896615831,1672624282,1672626339,2057
11748,3476308535,3520470646,1672584450,1672585078,628
11159,3793232021,3805926853,1672539168,1672542644,3476
10172,3760096466,3501734800,1672619575,1672621385,1810
10741,3201573194,3505351253,1672571005,1672574075,3070
10548,3478052226,3618672178,1672627630,1672628323,693
10081,3349475873,3801501384,1672556412,1672557880,1468
11770,3500821475,3791434207,1672560083,1672561353,1270
10709,3817120976,3772112976,1672567496,1672570703,3207
11246,3226913558,3376842515,1672648115,1672649884,1769
11582,3395610742,3715039960,1672567128,1672567956,828
11738,3770715115,3417969824,1672659911,1672662031,2120
10317,3555764822,3316121649,1672668558,1672669104,546
10817,3356599815,3916955566,1672653544,1672655169,1625
10328,3710223875,3714903253,1672660424,1672661723,1299
10985,3427741923,3778817220,1672640762,1672644046,3284
11669,3605101443,3635599307,1672634253,1672635973,1720
11213,3416105769,3510254698,1672639558,1672642814,3256
10957,3509470194,3756345026,1672636890,1672637396,506
10715,3480108752,3517627003,1672689379,1672689593,214
10865,3791509334,3397330170,1672588951,1672592100,3149
10973,3687024828,3756536476,1672571333,1672571955,622
9826,3736885568,3512411326,1672664092,1672667578,3486
9850,3713434898,3501427691,1672674341,1672675374,1033
10935,3395082458,3478052226,1672579446,1672582759,3313
11085,3977360666,3209958726,1672610464,1672610563,99
11136,3637522163,3555954355,1672698837,1672700072,1235
10125,3713923960,3780013266,1672641436,1672644693,3257
11781,3713475356,3932955949,1672553945,1672554398,453
10723,3701841013,3447591143,1672596048,1672599208,3160
10834,3510291656,3317190427,1672618025,1672619630,1605
10470,3341985886,3780298499,1672623825,1672624514,689
11005,3311583437,3826997668,1672691284,1672694037,2753
11381,3772343750,3510373076,1672680630,1672683638,3008
10438,3229615214,3711430738,1672607210,1672608844,1634
10363,3344778261,3517627003,1672694640,1672695160,520
11466,3710147457,3422205569,1672599206,1672600505,1299
11054,3913746581,3501370430,1672627023,1672628098,1075
10326,3465227623,3908550561,1672616503,1672617184,681
11487,3686853863,3902548260,1672668919,1672672120,3201
10954,3792597493,3772968080,1672618132,1672620404,2272
10213,3909822999,3756297396,1672590946,1672594224,3278
11540,3341311972,3894495222,1672625444,1672628087,2643
10572,3932566114,3501843187,1672557896,1672558693,797
11518,3686860179,3501828287,1672582424,1672583548,1124
11396,3756079870,3311432176,1672540662,1672543867,3205
10075,3774304163,3227339675,1672689888,1672691052,1164
10700,3349475873,3899294071,1672578150,1672580510,2360
11250,3342545285,3804779247,1672680028,1672680134,106
11328,3475653510,3776600696,1672585072,1672587320,2248
9854,3390444181,3792008302,1672582506,1672583019,513
10588,3557324887,3505314920,1672697212,1672699169,1957
10857,3514450836,3366961580,1672535932,1672536353,421
9895,3739395381,3710919244,1672621837,1672622862,1025
9922,3443191792,3514005973,1672562250,1672564536,2286
11739,3420664407,3755229631,1672634790,1672637896,3106
10281,3533777032,3330318282,1672604036,1672607385,3349
10058,3703481882,3240683148,1672539422,1672539853,431
10871,3793860209,3369938668,1672561059,1672563484,2425
10801,3777767907,3805926853,1672580884,1672584439,3555
11704,3387870683,3921736061,1672565012,1672567520,2508
9811,3611298237,3683677062,1672607072,1672608309,1237
11154,3615846003,3311037445,1672656072,1672657951,1879
11398,3715566511,3291617477,1672700087,1672700183,96
10603,3805831563,3755823805,1672666117,1672666445,328
11644,3615245840,3520305100,1672669552,1672670534,982
11347,3778824229,3372617110,1672539513,1672540471,958
11145,3662055682,3927805949,1672580319,1672582440,2121
11790,3703206956,3533816813,1672670080,1672672786,2706
10438,3806720019,3792432094,1672589754,1672591057,1303
11338,3510919509,3774782065,1672615799,1672618623,2824
10955,3447078933,3791351852,1672691769,1672691859,90
10451,3665603628,3773853619,1672649040,1672650098,1058
10877,3703438617,3373018943,1672573828,1672574347,519
10460,3710008760,3512417028,1672638272,1672639711,1439
9961,3703476890,3435715962,1672614806,1672615218,412
10415,3517551721,3516819320,1672595895,1672598067,2172
10919,3533593766,3334633634,1672592350,1672593479,1129
10282,3432762943,3501963428,1672605332,1672605727,395
10395,3385006834,3856897914,1672659235,1672661924,2689
10414,3813986705,3916463490,1672701929,1672703178,1249
11405,3716633983,3607583720,1672651952,1672654986,3034
10575,3757311529,3442462115,1672547602,1672550267,2665
10487,3714516404,3779706467,1672662170,1672662388,218
11713,3756763585,3834311054,1672599071,1672600411,1340
11590,3820280594,3447696555,1672606752,1672609704,2952
11642,3505756991,3500579482,1672670008,1672672889,2881
10674,3791382196,3825795004,1672669926,1672672072,2146
11611,3509377714,3341311972,1672625443,1672627885,2442
10080,3773899531,3533703578,1672674871,1672676644,1773
10656,3778402454,3757406215,1672630205,1672630280,75
10099,3711243126,3824259677,1672624823,1672627123,2300
10766,3621439107,3554437212,1672583412,1672584419,1007
11362,3792475476,3201656220,1672676091,1672679352,3261
11619,3514564903,3793987483,1672683424,1672683497,73
10340,3249771731,3318220119,1672593598,1672596092,2494
11273,3701685828,3387388336,1672606815,1672607949,1134
10323,3711770853,3368079099,1672539766,1672541880,2114
11113,3512641538,3512697456,1672689807,1672692473,2666
10884,3505491969,3534278019,1672547363,1672549007,1644
10003,3703168159,3509377714,1672675294,1672677771,2477
11764,3713807459,3602570831,1672638205,1672638774,569
11317,3921138062,3711870537,1672592209,1672593203,994
11229,3684651755,3715490209,1672684864,1672685440,576
11362,3774355339,3713728777,1672690778,1672691283,505
11402,3505392452,3350169064,1672661588,1672663440,1852
10634,3534111498,3711029952,1672646648,1672646863,215
10269,3454924050,3711131262,1672682073,1672685074,3001
11527,3513186578,3732223664,1672587248,1672589815,2567
9920,3509018337,3711810752,1672582378,1672584086,1708
10338,3417431173,3509470194,1672653154,1672654444,1290
11478,3779706467,3501734800,1672581203,1672584060,2857
10587,3619796619,3802101760,1672591985,1672592400,415
10976,3755767856,3893527651,1672554930,1672556600,1670
11618,3534372899,3501253130,1672670566,1672673894,3328
10075,3735056027,3621812406,1672688600,1672691537,2937
11496,3755378125,3415562576,1672585465,1672587171,1706
10480,3514244308,3716976932,1672559993,1672560530,537
11659,3624365837,3519754667,1672578389,1672578710,321
10989,3783176874,3776600696,1672646369,1672649306,2937
10488,3817076003,3227956115,1672695776,1672698197,2421
10075,3779723939,3710260848,1672610377,1672612505,2128
10971,3373851012,3388937390,1672532405,1672534643,2238
10066,3711770773,3665431349,1672656667,1672658299,1632
10393,3307236682,3634670780,1672590884,1672591462,578
10068,3777263928,3201957157,1672568906,1672569429,523
11014,3703999217,3510244209,1672653325,1672655970,2645
10424,3927805949,3776122272,1672682725,1672684797,2072
10155,3805831563,3792682835,1672660152,1672661547,1395
10813,3551833298,3791121243,1672679688,1672681652,1964
11174,3903115138,3513432588,1672695115,1672697413,2298
9945,3227647190,3715724166,1672575849,1672577457,1608
10714,3978254945,3755192104,1672635293,1672635624,331
9942,3512101369,3773378103,1672698680,1672698919,239
11365,3514007122,3701925712,1672533448,1672534910,1462
10991,3501988762,3733836732,1672656174,1672657072,898
10432,3207748225,3514341451,1672616171,1672617047,876
10905,3885339157,3600871715,1672657665,1672660121,2456
10443,3755286041,3730169449,1672553565,1672554697,1132
11383,3936486724,3703999217,1672569655,1672572965,3310
10530,3228997424,3501557463,1672555591,1672558994,3403
11147,3731905251,3792008302,1672557085,1672558546,1461
11273,3680278447,3342495377,1672612926,1672613496,570
11227,3711852131,3835262447,1672672020,1672675383,3363
10630,3409514897,3783730769,1672551126,1672552627,1501
10979,3805704844,3500595432,1672687693,1672690684,2991
11128,3835262447,3446066492,1672693595,1672696802,3207
9966,3714435747,3370448531,1672583328,1672586791,3463
11179,3791628195,3534937492,1672647787,1672651252,3465
10645,3772962072,3624164232,1672589387,1672591245,1858
10317,3312651192,3303747093,1672578968,1672581940,2972
10582,3209925780,3500415589,1672573588,1672574003,415
11235,3638823001,3660980656,1672576114,1672577107,993
11211,3888523259,3311774510,1672696762,1672698634,1872
9837,3777074709,3471507117,1672651731,1672652922,1191
10542,3715039960,3716891903,1672661953,1672663228,1275
10534,3500455935,3772683155,1672628056,1672630784,2728
11754,3711223297,3510244209,1672614330,1672615126,796
10689,3318224774,3770976984,1672578407,1672580341,1934
9922,3499142934,3793978936,1672602923,1672604522,1599
11530,3732467455,3776304080,1672588351,1672590839,2488
11387,3493515706,3285201542,1672615642,1672618257,2615
10537,3372079985,3850735936,1672642636,1672644382,1746
10962,3710185376,3330318282,1672595541,1672598251,2710
10532,3714902042,3519689906,1672618117,1672621172,3055
11775,3791542842,3500234771,1672613910,1672614278,368
10849,3432838598,3385124073,1672562006,1672564476,2470
11445,3733243990,3715320359,1672658030,1672659456,1426
10596,3793003432,3487779363,1672696927,1672699947,3020
11158,3516655509,3783563043,1672602909,1672603133,224
11236,3890638402,3477511446,1672695841,1672697748,1907
10088,3309651238,3447948483,1672680607,1672682264,1657
10511,3703742071,3756066702,1672547137,1672548147,1010
10552,3311331205,3287734830,1672570165,1672573239,3074
10145,3510987684,3400025324,1672668562,1672671343,2781
10760,3776193847,3337715675,1672669106,1672672192,3086
10495,3386323728,3760687922,1672614517,1672614651,134
9994,3430399931,3884933821,1672677262,1672677493,231
11176,3828354855,3500785888,1672662710,1672665341,2631
10182,3811503860,3307236682,1672661225,1672663945,2720
11216,3505129296,3384001094,1672547470,1672548284,814
10661,3500922040,3311569360,1672545270,1672548092,2822
11673,3236360179,3773032706,1672662398,1672663709,1311
10836,3770276815,3773714494,1672595232,1672596959,1727
10906,3467232654,3358262975,1672629626,1672631508,1882
9964,3806034626,3755790149,1672700027,1672700805,778
10353,3340321384,3625952981,1672547121,1672547500,379
9842,3517718901,3505032773,1672699054,1672699149,95
10774,3713996094,3482687604,1672621376,1672621935,559
10996,3282240901,3713606829,1672650479,1672652168,1689
10997,3520182275,3354968884,1672690596,1672691256,660
10136,3714142299,3756761603,1672536816,1672537228,412
10826,3305657559,3500922040,1672553639,1672556840,3201
10141,3711404205,3688870751,1672546013,1672548800,2787
11650,3299743638,3792597493,1672568678,1672570919,2241
11029,3829358750,3683514731,1672669144,1672672419,3275
11328,3716633983,3977360666,1672694611,1672695917,1306
10083,3409514897,3757050615,1672628985,1672629968,983
11725,3491758029,3896859936,1672697945,1672701107,3162
9945,3972856326,3912878303,1672535363,1672538857,3494
10825,3682241594,3505839395,1672564035,1672565771,1736
10072,3243056734,3513890046,1672644645,1672644791,146
10390,3701028092,3243651036,1672683094,1672685609,2515
9819,3318590083,3512681214,1672543713,1672546219,2506
11170,3501980730,3888409038,1672692144,1672695663,3519
10716,3304592684,3309528048,1672596005,1672598751,2746
10303,3711223297,3825526565,1672656954,1672657980,1026
10388,3500049870,3885147558,1672551759,1672552448,689
10580,3832333115,3856552205,1672570348,1672573015,2667
11281,3278430820,3347520239,1672656009,1672656312,303
10431,3930501172,3638823001,1672652158,1672652501,343
10793,3760525465,3755630085,1672681046,1672684374,3328
11386,3505331083,3479585868,1672673595,1672674896,1301
9855,3760537855,3406132280,1672573482,1672577063,3581
10837,3511069449,3851810349,1672570090,1672572914,2824
10461,3893629892,3446575109,1672603169,1672606699,3530
11515,3459163055,3515804844,1672550049,1672553450,3401
10827,3405200303,3713767153,1672585151,1672585356,205
11622,3776593726,3292050211,1672688168,1672691364,3196
9807,3517045396,3500591274,1672621968,1672622666,698
11598,3897851509,3773798215,1672659669,1672660147,478
10851,3773432494,3791031227,1672604033,1672606545,2512
9846,3682673884,3511289729,1672601129,1672603878,2749
10493,3435715962,3311989687,1672660631,1672662649,2018
11605,3890194669,3385124073,1672641980,1672643469,1489
11124,3533265491,3505351253,1672574872,1672575160,288
10433,3534372899,3417969824,1672673071,1672673693,622
11402,3772251279,3916463490,1672555411,1672558942,3531
11042,3778819352,3772223331,1672686639,1672689012,2373
9945,3612042508,3501901313,1672687155,1672690547,3392
11336,3688768189,3558567160,1672609086,1672611852,2766
11328,3791409441,3660257653,1672616774,1672618433,1659
10313,3511663572,3780148144,1672607078,1672609177,2099
11442,3774663639,3927805949,1672650168,1672651874,1706
10881,3236563828,3500073824,1672643432,1672643704,272
11502,3856147380,3550887623,1672575038,1672577619,2581
9908,3881579907,3501192566,1672693347,1672696392,3045
11779,3972196462,3519780867,1672657897,1672658245,348
9958,3605078841,3511364193,1672565120,1672566004,884
10512,3519948471,3533419409,1672681593,1672684804,3211
10114,3206926634,3634670780,1672699815,1672699921,106
9974,3480185839,3711591464,1672595719,1672598618,2899
11372,3298831109,3333477908,1672672775,1672673066,291
10701,3660163550,3884388188,1672607831,1672611147,3316
10189,3605905645,3627358016,1672665951,1672669336,3385
11427,3856699097,3311771689,1672660666,1672663850,3184
11261,3738132114,3756536476,1672672688,1672672885,197
10538,3550405857,3310737478,1672630715,1672633751,3036
10866,3501004005,3829412384,1672682981,1672683846,865
11478,3311159418,3772251279,1672546012,1672547677,1665
11022,3776304080,3534869444,1672580061,1672580253,192
11469,3509186338,3462985379,1672691142,1672693162,2020
11315,3783277159,3978254945,1672565586,1672567072,1486
11333,3778731000,3311037445,1672552019,1672554878,2859
10150,3410602007,3500087325,1672592151,1672592296,145
9916,3662055682,3602401154,1672569348,1672572770,3422
10833,3431317400,3636885498,1672675194,1672677961,2767
11565,3920116284,3501208658,1672586768,1672588675,1907
10465,3505901826,3774652449,1672680889,1672683935,3046
11791,3478206139,3555763674,1672646058,1672647318,1260
9867,3791382196,3510547682,1672692169,1672693829,1660
9993,3711767051,3505500523,1672671668,1672672131,463
10590,3770273966,3770285500,1672575490,1672577896,2406
9920,3623512088,3360949039,1672604467,1672606686,2219
11023,3770972037,3231227362,1672594044,1672596658,2614
11516,3415840750,3516586325,1672536049,1672536612,563
10341,3359929534,3513508737,1672683009,1672685092,2083
9821,3902775449,3623894390,1672687072,1672689910,2838
10054,3361952532,3716183063,1672612747,1672614857,2110
11747,3829761380,3534937492,1672604897,1672606104,1207
10000,3319436533,3911431642,1672578512,1672581415,2903
11337,3756680289,3512343029,1672651115,1672652006,891
9988,3792021895,3224040894,1672573969,1672574723,754
10889,3282053097,3236360179,1672628425,1672631427,3002
9800,3227059650,3716733618,1672603446,1672605383,1937
9921,3931319307,3534459983,1672642831,1672643857,1026
11245,3557528150,3511615015,1672578091,1672579102,1011
10896,3226913558,3452677710,1672548727,1672551329,2602
10932,3919345990,3423217578,1672625224,1672626881,1657
9950,3429333292,3533017131,1672609882,1672610837,955
9902,3367121615,3600699873,1672632588,1672635063,2475
10417,3454554552,3358530225,1672638264,1672640609,2345
11368,3410602007,3711852131,1672698172,1672700096,1924
10597,3908464960,3516572212,1672599178,1672601792,2614
9835,3283847934,3603740088,1672644588,1672646977,2389
11699,3665603628,3755584983,1672657036,1672659035,1999
11282,3736036532,3662307789,1672542506,1672545309,2803
10456,3714074120,3455955489,1672621319,1672621772,453
10256,3513111053,3780941637,1672587301,1672587645,344
10480,3220987526,3396440259,1672630969,1672633810,2841
10544,3511907179,3770023722,1672645541,1672647712,2171
10790,3418382025,3777370992,1672631192,1672632214,1022
10450,3509317776,3505531432,1672564058,1672566235,2177
10976,3716994924,3512417724,1672574813,1672577500,2687
9946,3534111498,3472272792,1672635376,1672638196,2820
11469,3512417724,3366501813,1672531729,1672534907,3178
11171,3295530454,3512417724,1672605241,1672605459,218
11521,3605905645,3901217668,1672619880,1672623037,3157
10354,3510856388,3755865626,1672678856,1672679152,296
11335,3792012147,3811629200,1672596151,1672596916,765
10350,3710529628,3512784888,1672543965,1672544383,418
11107,3510022922,3856129522,1672584910,1672584987,77
11228,3393909269,3337903727,1672600280,1672602995,2715
10438,3371759126,3351949206,1672692848,1672693572,724
11447,3757823215,3358434853,1672659793,1672660953,1160
9832,3512784888,3738132114,1672569588,1672572431,2843
10190,3510819040,3783443095,1672670286,1672672921,2635
11594,3509912164,3511245705,1672660131,1672662327,2196
11085,3713606829,3755342153,1672634358,1672637286,2928
11459,3284407073,3439532406,1672633148,1672636082,2934
10005,3512784888,3783430498,1672675743,1672678579,2836
10252,3485151614,3367299721,1672570732,1672574009,3277
11655,3715897627,3925835590,1672623676,1672624479,803
11012,3338115824,3756525103,1672579680,1672582133,2453
10366,3823307824,3377883705,1672566199,1672569179,2980
9910,3755823805,3905889514,1672702821,1672704072,1251
10254,3976225898,3607583720,1672570796,1672572787,1991
10419,3501927452,3505164060,1672584483,1672587927,3444
10858,3710585241,3342837214,1672641104,1672644416,3312
10262,3905934770,3337675386,1672572194,1672572350,156
9909,3533974355,3387706541,1672622520,1672623404,884
10568,3713219299,3934991640,1672653966,1672655976,2010
10929,3669475165,3832312129,1672670375,1672673538,3163
9973,3710891331,3513545735,1672546931,1672548702,1771
10873,3711187791,3363549860,1672694875,1672697267,2392
11015,3931028233,3242149533,1672590780,1672592197,1417
10318,3442096275,3715246385,1672682322,1672683070,748
10498,3510916875,3760537855,1672624202,1672624264,62
11508,3311463998,3452389513,1672646203,1672649700,3497
10570,3517083465,3289258397,1672588461,1672591966,3505
10419,3714435747,3713336088,1672679595,1672682152,2557
10859,3418683594,3839417558,1672586088,1672587082,994
10873,3783176874,3791664049,1672673406,1672676754,3348
10789,3854957153,3793783685,1672654756,1672657374,2618
11326,3972653129,3514980025,1672647423,1672650950,3527
10225,3409514897,3290060215,1672685305,1672686189,884
10544,3970265139,3243056734,1672663153,1672666501,3348
10632,3517800171,3756157377,1672700937,1672704009,3072
10684,3625931630,3783408830,1672551060,1672552868,1808
10302,3602680347,3315094386,1672606601,1672607984,1383
10820,3499622352,3514541800,1672676258,1672678911,2653
11121,3858330969,3686081254,1672544655,1672545180,525
10129,3513213122,3332124606,1672662373,1672662597,224
11400,3505129296,3791332061,1672610562,1672613014,2452
10413,3835509670,3777041132,1672614903,1672615785,882
10756,3713514933,3916656185,1672656702,1672658525,1823
10294,3714294005,3462153833,1672555815,1672555953,138
10653,3925792265,3517045396,1672637542,1672638377,835
10140,3342426430,3923133978,1672636616,1672637152,536
11167,3382670400,3303772923,1672602668,1672604646,1978
11042,3711131262,3792289287,1672583527,1672584597,1070
11107,3777932225,3501115299,1672665596,1672666940,1344
9894,3770564547,3755790149,1672695989,1672696457,468
11265,3792475476,3773770134,1672596300,1672599563,3263
9881,3511526885,3350169064,1672612401,1672612823,422
11533,3618024815,3206377955,1672623706,1672627245,3539
10614,3716160006,3791224239,1672632541,1672635082,2541
9986,3791587717,3770391782,1672594887,1672598263,3376
10157,3776778306,3353194923,1672626470,1672629105,2635
10141,3353811455,3203172170,1672623413,1672625865,2452
11559,3337673625,3686644062,1672602030,1672603845,1815
11756,3509562377,3972442654,1672683199,1672685309,2110
11169,3711947828,3514361485,1672691212,1672692104,892
11451,3733915784,3395082458,1672621428,1672623653,2225
10319,3379517265,3338187803,1672658286,1672658771,485
10902,3930727474,3245642576,1672676148,1672677332,1184
10647,3501619113,3783176874,1672606430,1672609993,3563
11112,3488931357,3534174363,1672622520,1672624928,2408
9925,3335139032,3793375825,1672653753,1672657008,3255
9822,3346755179,3404375908,1672578885,1672582271,3386
11269,3908177413,3517551721,1672657379,1672659947,2568
9923,3245121919,3829412384,1672647814,1672649078,1264
10282,3713906305,3830599959,1672623687,1672625752,2065
11746,3777204977,3505547832,1672597202,1672597275,73
9854,3352493805,3517469005,1672694791,1672697127,2336
11505,3501583486,3342495377,1672600953,1672604414,3461
11677,3757660578,3510159441,1672562362,1672563230,868
11293,3701311947,3856699097,1672665696,1672666314,618
11227,3357496255,3347760784,1672643681,1672646359,2678
11789,3505500523,3488399075,1672631996,1672633130,1134
11735,3637105495,3770966950,1672703616,1672705674,2058
11709,3622218289,3287403291,1672553203,1672556647,3444
10935,3716922925,3511671476,1672586985,1672590006,3021
10486,3378172464,3776348451,1672643494,1672645719,2225
11047,3713224986,3633949990,1672539896,1672542538,2642
10877,3902292032,3899294071,1672646783,1672648231,1448
10309,3607288879,3513384042,1672671688,1672673614,1926
11415,3770976984,3783967375,1672615127,1672617685,2558
11742,3205908584,3714294005,1672682039,1672682580,541
11147,3667814788,3757994002,1672649478,1672652163,2685
10644,3511289729,3313579674,1672665140,1672665679,539
9901,3777909822,3533876927,1672669546,1672672813,3267
10464,3509651954,3311529105,1672620185,1672623318,3133
11653,3387989658,3392573386,1672564853,1672565052,199
11057,3517325365,3510894809,1672554607,1672556276,1669
11226,3473562779,3476144563,1672600437,1672600533,96
10400,3245882008,3791587717,1672546232,1672549244,3012
10766,3757851680,3516904926,1672662856,1672664500,1644
10381,3856316719,3703818358,1672541932,1672544060,2128
9971,3342495377,3516034245,1672652911,1672653336,425
11282,3415228763,3834311054,1672588114,1672589237,1123
10668,3854957153,3311583437,1672668300,1672668678,378
9974,3493679801,3236563828,1672565694,1672566525,831
10760,3512087090,3711119575,1672679894,1672679992,98
10644,3682241594,3851737350,1672623772,1672623940,168
9947,3792267993,3793364952,1672676215,1672678768,2553
10205,3364948616,3893527651,1672610975,1672613483,2508
10376,3770780655,3755584983,1672680577,1672683762,3185
11254,3802374620,3730348493,1672537617,1672538257,640
10712,3774145748,3791532324,1672665081,1672667533,2452
10535,3465107990,3501192566,1672619240,1672622382,3142
10194,3330188769,3802757611,1672537973,1672540003,2030
11611,3910049345,3827836825,1672619951,1672621424,1473
11630,3459694275,3760901975,1672539484,1672540214,730
11152,3851737350,3380285779,1672681803,1672684274,2471
11651,3534068874,3827889533,1672561856,1672564013,2157
11563,3515803462,3385481989,1672659025,1672660085,1060
10721,3715140418,3713996094,1672542416,1672544155,1739
11122,3776193847,3884458862,1672554183,1672555872,1689
10742,3243056734,3710891331,1672683231,1672684117,886
11778,3313298164,3898989233,1672700938,1672702251,1313
10424,3534081527,3380444321,1672617272,1672620037,2765
11284,3246567963,3855674398,1672573910,1672575542,1632
10382,3513293711,3452677710,1672695622,1672697699,2077
10938,3505183641,3441683673,1672577368,1672580150,2782
10932,3516904926,3471555057,1672602860,1672603077,217
10695,3757869138,3394357241,1672631525,1672633709,2184
10752,3304592684,3776440009,1672624096,1672624854,758
10192,3912811715,3243763209,1672538859,1672541058,2199
9911,3756272704,3668063289,1672703332,1672705811,2479
10012,3916656185,3793003432,1672555597,1672555799,202
11541,3236360179,3733836732,1672630778,1672631431,653
10414,3837435907,3516200419,1672612665,1672615859,3194
10339,3446537819,3224053074,1672550307,1672552254,1947
11030,3780942505,3517797610,1672544366,1672547318,2952
11021,3203954795,3505117019,1672700296,1672703183,2887
11584,3427527462,3461137945,1672559028,1672559864,836
11585,3552444228,3495427619,1672646519,1672649363,2844
10818,3701668745,3226761201,1672599973,1672603427,3454
10835,3711810268,3483701493,1672541588,1672543759,2171
10398,3713805968,3206544535,1672657802,1672659437,1635
11458,3713728777,3550887623,1672571367,1672572805,1438
10448,3280208630,3275735969,1672562775,1672563562,787
11125,3518117078,3778817220,1672596598,1672598473,1875
11583,3496591885,3774296721,1672642027,1672644409,2382
11775,3778318250,3408828584,1672620721,1672623196,2475
11548,3500221079,3817120976,1672538977,1672542294,3317
9963,3783651407,3934564437,1672553844,1672557113,3269
10712,3512726649,3974668678,1672584234,1672587627,3393
10703,3780435349,3509167758,1672616084,1672618034,1950
10407,3319862687,3770424892,1672574916,1672577806,2890
10320,3239990061,3777564559,1672649109,1672649390,281
10171,3334381941,3380418745,1672682040,1672682658,618
10207,3756168814,3683677062,1672596426,1672596673,247
10660,3515548696,3514216460,1672623650,1672623994,344
10092,3822634862,3418382025,1672644919,1672647349,2430
11177,3206926634,3517902505,1672583301,1672585978,2677
10566,3509167758,3791532324,1672669786,1672672990,3204
10786,3900766525,3666958814,1672681128,1672682245,1117
10468,3509252934,3316117186,1672674970,1672678344,3374
10016,3429333292,3738547113,1672614403,1672616927,2524
11587,3371238318,3505438826,1672570265,1672572651,2386
11503,3807584987,3445733121,1672564806,1672568060,3254
10021,3881012415,3830771832,1672618057,1672618257,200
11658,3770019143,3776440009,1672680045,1672682658,2613
11547,3450503086,3319061210,1672601835,1672602200,365
9940,3500405175,3311774510,1672693272,1672695007,1735
11464,3505901826,3801379377,1672682409,1672685380,2971
10577,3925823748,3517652011,1672650052,1672652377,2325
11344,3501027795,3512641538,1672597719,1672599105,1386
11254,3510826414,3388915945,1672561611,1672562150,539
11590,3500624846,3757311529,1672686016,1672687633,1617
9882,3774326754,3716468783,1672606887,1672609101,2214
9967,3351949206,3505980138,1672554739,1672557085,2346
11443,3396472026,3755075988,1672540289,1672540920,631
10587,3777937949,3493047640,1672585588,1672586816,1228
10410,3701028092,3632303304,1672636180,1672636383,203
11669,3457249798,3421040626,1672616003,1672618865,2862
11257,3716389356,3835262447,1672543048,1672546640,3592
11464,3533960602,3714268380,1672534287,1672536506,2219
10563,3792578118,3494560663,1672567826,1672569293,1467
11309,3793783685,3819024145,1672576547,1672577061,514
9897,3776534957,3774682234,1672644537,1672646502,1965
11080,3774035405,3505291330,1672701543,1672702132,589
10844,3510638085,3505331014,1672618645,1672622238,3593
9959,3360525513,3828354855,1672684722,1672688031,3309
11734,3714870496,3500079479,1672703692,1672703832,140
10487,3736621212,3922409420,1672686199,1672689299,3100
11113,3701004302,3714516404,1672591904,1672594727,2823
10676,3778605154,3518794921,1672616867,1672617788,921
11777,3755374000,3519351747,1672563564,1672567154,3590
10870,3425646356,3809871495,1672634068,1672635073,1005
10516,3805268739,3755203055,1672698139,1672700005,1866
10032,3850904092,3602570831,1672631083,1672633619,2536
11669,3358675021,3925098136,1672622438,1672623846,1408
11438,3668720465,3520155898,1672648232,1672648610,378
11345,3426207439,3509394912,1672628657,1672631762,3105
11124,3839308659,3779255367,1672574970,1672577630,2660
10663,3482687604,3515047288,1672667762,1672670330,2568
10969,3735056027,3897186782,1672680552,1672681744,1192
11061,3417969824,3287683210,1672581600,1672584794,3194
10581,3311924005,3239279744,1672688135,1672689835,1700
10582,3368848936,3249771731,1672555255,1672556851,1596
10990,3756890980,3488887919,1672629923,1672632315,2392
9898,3393543588,3635599307,1672557531,1672560690,3159
9876,3662354016,3513213122,1672690394,1672691541,1147
11638,3757944870,3669475165,1672693556,1672695485,1929
11788,3512596743,3791532324,1672568481,1672571920,3439
10852,3520273299,3716197140,1672580324,1672581797,1473
11541,3738873928,3512087090,1672651845,1672654262,2417
10449,3510233949,3793719515,1672590855,1672592964,2109
10602,3304697982,3605101443,1672635014,1672637656,2642
11204,3517469005,3334936138,1672589354,1672590971,1617
10619,3756428507,3701218904,1672600466,1672603421,2955
10352,3811351746,3311188620,1672660536,1672663692,3156
11243,3885147558,3371132167,1672554284,1672557035,2751
10740,3627431396,3660246433,1672573482,1672573928,446
10096,3735056027,3620105539,1672567083,1672569926,2843
11568,3922301238,3772648837,1672657922,1672659214,1292
11087,3375905193,3403870769,1672702844,1672703390,546
10113,3716160006,3616371564,1672535615,1672538745,3130
10659,3279851026,3501600785,1672657079,1672660065,2986
11177,3780050328,3440305508,1672650491,1672653032,2541
10808,3516321993,3615742989,1672608372,1672611721,3349
9968,3240877710,3534578428,1672637463,1672638438,975
11665,3807584987,3297100323,1672586956,1672590552,3596
11710,3227956115,3793274957,1672581122,1672584102,2980
10346,3397972945,3511466117,1672645363,1672647974,2611
9808,3517499844,3342056927,1672566002,1672567604,1602
10020,3884001167,3937636109,1672633764,1672633924,160
10908,3455955489,3283847934,1672597919,1672600780,2861
10304,3793081195,3200372897,1672687185,1672689720,2535
11195,3711755596,3715724166,1672540976,1672544178,3202
10358,3714142299,3533728729,1672690089,1672690471,382
11553,3715680249,3793003432,1672574781,1672575136,355
11511,3500209015,3228575883,1672549849,1672550964,1115
11108,3417969824,3935256825,1672645106,1672647419,2313
11142,3510882475,3715419141,1672662053,1672664179,2126
11079,3516454693,3509370633,1672627548,1672629153,1605
11351,3514980025,3366433035,1672582221,1672583292,1071
11648,3703476890,3384713976,1672590895,1672593915,3020
10833,3243651036,3760396348,1672545052,1672548492,3440
10877,3428198021,3917004141,1672533337,1672536536,3199
11255,3715897627,3435037864,1672538795,1672539214,419
11721,3777878462,3207586072,1672608910,1672610313,1403
11218,3516932899,3772070986,1672545519,1672546384,865
10740,3880549316,3501137133,1672608399,1672611211,2812
9796,3730290851,3513111053,1672692513,1672693996,1483
9799,3713336088,3415032547,1672540258,1672542605,2347
9798,3976225898,3835509670,1672596706,1672597340,634
10700,3428303756,3932955949,1672649056,1672651034,1978
11492,3500104976,3756113624,1672684063,1672687288,3225
11370,3205113625,3792432094,1672600522,1672602209,1687
11507,3629248353,3311602936,1672640741,1672643467,2726
11039,3772227820,3505066871,1672606660,1672609952,3292
9920,3475033290,3896211741,1672542682,1672545955,3273
10322,3701385831,3239990061,1672536956,1672537527,571
10279,3387971464,3755218683,1672624385,1672626664,2279
10286,3555954355,3434052463,1672667817,1672668280,463
10626,3467944159,3780900318,1672679090,1672680635,1545
11195,3311015817,3534984243,1672601521,1672604804,3283
10610,3971422524,3633294415,1672656192,1672659291,3099
10503,3773876312,3756991235,1672650031,1672652750,2719
11209,3484490325,3515803462,1672629505,1672632362,2857
10506,3791245127,3711119575,1672640140,1672642475,2335
9879,3793987483,3600171014,1672643074,1672644656,1582
11274,3804840997,3353326305,1672578943,1672580873,1930
10593,3791435852,3515803462,1672538882,1672539959,1077
11149,3701865589,3757201538,1672609173,1672612023,2850
10497,3711367577,3443041059,1672614677,1672616780,2103
10722,3482639402,3500927619,1672639053,1672640477,1424
9797,3473520701,3756157377,1672612487,1672614300,1813
10722,3914947393,3439662051,1672601820,1672603593,1773
10225,3505836431,3432050858,1672660441,1672661319,878
10729,3921736061,3518157683,1672690412,1672693626,3214
10004,3760382349,3902357342,1672616975,1672617412,437
10021,3615447269,3776617627,1672556376,1672556747,371
11306,3513850048,3905955166,1672648467,1672651953,3486
11032,3622152515,3318224774,1672691866,1672692353,487
11674,3391612879,3514638555,1672686276,1672687098,822
11632,3756991235,3609335008,1672702245,1672702386,141
10499,3370401047,3510882475,1672636426,1672636723,297
10736,3501115299,3756363182,1672685029,1672685963,934
10055,3479910993,3665431349,1672634235,1672634933,698
9816,3915679140,3701529552,1672676236,1672677074,838
10889,3682150740,3715249954,1672693040,1672694376,1336
10407,3886837151,3813853446,1672697802,1672698783,981
10282,3555954355,3519937708,1672659395,1672662316,2921
11736,3445172440,3850904092,1672660952,1672664009,3057
11109,3311472321,3779665641,1672579956,1672582007,2051
11101,3279851026,3334824744,1672552592,1672555162,2570
10304,3510795808,3243763209,1672531719,1672533292,1573
10959,3341432459,3783373085,1672592696,1672594081,1385
10874,3927699036,3517358336,1672546856,1672547798,942
11527,3793926338,3500057674,1672599036,1672599596,560
10497,3772251279,3778932673,1672554858,1672556886,2028
10844,3715008501,3701265238,1672573855,1672574341,486
11681,3783430498,3500317923,1672547415,1672548613,1198
10327,3792277399,3774652449,1672702575,1672704681,2106
10143,3510206323,3823600319,1672620639,1672623207,2568
11072,3514515499,3914947393,1672623529,1672624520,991
10233,3333505404,3495152069,1672619467,1672622107,2640
11646,3449020351,3774145748,1672585102,1672586781,1679
10218,3555763674,3234445133,1672558522,1672560877,2355
10680,3777564559,3755361692,1672556815,1672557880,1065
10093,3760801237,3227339675,1672531342,1672533905,2563
10194,3311449914,3933731871,1672574733,1672575768,1035
10002,3247193800,3511412229,1672568790,1672571434,2644
10193,3517325365,3238056215,1672592903,1672595795,2892
11733,3774273260,3713374884,1672609088,1672612072,2984
10248,3770631449,3772695548,1672694432,1672695537,1105
10312,3454343398,3491104534,1672630299,1672632909,2610
10399,3912915644,3772905073,1672632483,1672635405,2922
10326,3513800589,3904846341,1672645906,1672649163,3257
10227,3689386663,3713606829,1672586683,1672588227,1544
10632,3512477276,3377250778,1672623140,1672624693,1553
9801,3500814753,3227956115,1672682863,1672683826,963
11294,3807717766,3605905645,1672638914,1672640760,1846
9840,3511864772,3687183789,1672555449,1672556720,1271
10709,3311529105,3770715115,1672674374,1672675655,1281
11709,3776122272,3509167758,1672585639,1672587577,1938
10138,3667814788,3275751794,1672630397,1672633029,2632
10257,3558203963,3756642173,1672612585,1672613751,1166
10688,3909504515,3519351747,1672532140,1672534362,2222
10501,3512492332,3774598935,1672660881,1672661518,637
11596,3443004958,3703104365,1672546571,1672548816,2245
10571,3499142934,3500726347,1672613014,1672616296,3282
11148,3714294005,3511883778,1672666089,1672666925,836
11641,3770925016,3711518637,1672640217,1672642592,2375
11665,3238796398,3778100960,1672593553,1672594182,629
10668,3773579644,3793332600,1672614757,1672615869,1112
10073,3927504954,3429610195,1672538673,1672538893,220
10739,3838039092,3487988841,1672576891,1672577243,352
10290,3500062408,3792277399,1672599154,1672600538,1384
11404,3715140418,3825877848,1672554451,1672557927,3476
11355,3603452936,3772169046,1672590742,1672592337,1595
9795,3427527462,3309651238,1672607436,1672609553,2117
11279,3550405857,3509208005,1672668134,1672668487,353
10072,3608214600,3513092056,1672633532,1672635900,2368
11193,3500105301,3896859936,1672625018,1672628535,3517
10539,3501657158,3760656396,1672571113,1672571181,68
10942,3500974385,3238310644,1672637314,1672637733,419
10454,3293540333,3714455496,1672591872,1672593320,1448
10819,3733730342,3519730914,1672683143,1672684637,1494
11307,3372236721,3779340538,1672582721,1672583822,1101
11070,3760997159,3345896913,1672614884,1672618039,3155
10617,3791289855,3520049965,1672536340,1672538666,2326
10461,3924366353,3662055682,1672629477,1672631753,2276
9891,3756157377,3517499844,1672655358,1672657660,2302
10960,3609103278,3305727497,1672643296,1672646365,3069
10690,3713875941,3813853446,1672631095,1672632157,1062
11402,3229734741,3343767438,1672580246,1672581598,1352
10331,3517810375,3391093411,1672551905,1672555420,3515
11525,3783021859,3500415589,1672634409,1672637719,3310
10428,3338115824,3388537708,1672687521,1672689676,2155
11669,3509186338,3703737650,1672694853,1672695587,734
9924,3512769522,3382746533,1672575304,1672575985,681
10893,3385124073,3856601074,1672553276,1672556294,3018
11560,3685522474,3772131127,1672625476,1672627157,1681
11634,3510758718,3820200446,1672660551,1672663785,3234
10783,3602054754,3756363182,1672617202,1672619942,2740
10905,3553640169,3438028077,1672583008,1672583595,587
11166,3857847527,3760232135,1672602723,1672605065,2342
10006,3403257752,3408111327,1672602766,1672603591,825
11677,3517426473,3355903597,1672598732,1672599283,551
9985,3484739955,3481019442,1672572572,1672573624,1052
11535,3466620548,3716475340,1672543430,1672546531,3101
11167,3880562532,3667654673,1672687615,1672689897,2282
9985,3777200549,3280208630,1672590769,1672593315,2546
10793,3792063616,3772905073,1672689103,1672691194,2091
11685,3773798215,3791382196,1672600604,1672603029,2425
9861,3519494023,3713195480,1672570343,1672572443,2100
10241,3286938590,3791205793,1672682858,1672683949,1091
10835,3884934977,3756168814,1672563075,1672564494,1419
10293,3773798215,3777304517,1672583308,1672585244,1936
11637,3517151644,3392010033,1672593114,1672596048,2934
10841,3442403264,3668764192,1672532287,1672533707,1420
11318,3733243990,3518995270,1672548294,1672549358,1064
11486,3757311529,3514761434,1672631648,1672633319,1671
10153,3416474842,3809207482,1672596944,1672597813,869
11309,3500863429,3333505404,1672577291,1672578908,1617
11191,3362706073,3302988745,1672535356,1672538721,3365
10297,3422915648,3773798215,1672565944,1672567612,1668
11006,3711870537,3896622009,1672661316,1672661414,98
11240,3856129522,3225554956,1672572194,1672572514,320
10577,3711258452,3500589560,1672622067,1672623713,1646
10170,3290097447,3275171954,1672701849,1672702515,666
11369,3815700240,3899294071,1672628886,1672629994,1108
10792,3772320856,3424988692,1672593692,1672596191,2499
10571,3730459093,3501554468,1672536153,1672537533,1380
10812,3773554767,3773394570,1672545813,1672546309,496
10836,3347996015,3811354125,1672647883,1672650275,2392
11727,3755779925,3273537848,1672538954,1672540399,1445
9835,3450164574,3274223335,1672640304,1672640825,521
10829,3287683210,3774673193,1672543270,1672546562,3292
10447,3388830370,3515715968,1672634618,1672636784,2166
10068,3440770466,3714101349,1672667687,1672669298,1611
10534,3760274119,3931164237,1672567070,1672567819,749
11605,3514853709,3933469838,1672642038,1672645604,3566
10029,3420881591,3505175620,1672584523,1672586458,1935
10040,3804095239,3774946684,1672615484,1672618582,3098
11296,3520009158,3501657158,1672608504,1672610467,1963
11384,3307454562,3558349840,1672556378,1672558412,2034
11505,3276209319,3791245127,1672687465,1672687999,534
10903,3555764822,3476416072,1672653895,1672657472,3577
11540,3381055770,3817478012,1672563379,1672563964,585
11634,3917243005,3443521234,1672652066,1672652414,348
11202,3275975921,3776122272,1672587061,1672587514,453
11229,3912625932,3972847837,1672641542,1672643758,2216
11037,3512794667,3513186622,1672570368,1672570956,588
11239,3352057037,3760731595,1672545881,1672547690,1809
10346,3515764058,3893950585,1672611898,1672614567,2669
10628,3422314045,3534758256,1672577633,1672578399,766
10227,3836090778,3776122272,1672702839,1672703984,1145
11225,3488988274,3512625661,1672602302,1672603937,1635
10144,3476416072,3514361485,1672645539,1672646942,1403
10961,3714283424,3791628263,1672661961,1672663996,2035
10601,3205948776,3224053840,1672666356,1672666607,251
10168,3277634944,3274739459,1672552890,1672555443,2553
9991,3713726267,3511671476,1672538899,1672542249,3350
10651,3770019143,3770630937,1672574048,1672576900,2852
11712,3680988889,3423217578,1672639168,1672642661,3493
10287,3512411326,3898965585,1672609618,1672610034,416
10798,3533419409,3776468503,1672647929,1672650184,2255
10244,3203837944,3500440602,1672609452,1672611214,1762
11415,3783942518,3884180202,1672540043,1672541886,1843
11601,3662307789,3245755569,1672693848,1672694601,753
11662,3971289056,3500931474,1672565065,1672568145,3080
10261,3908550561,3500198430,1672681669,1672683264,1595
11244,3513661302,3732596503,1672583677,1672584918,1241
10622,3421956717,3505331083,1672655629,1672656016,387
10046,3331471764,3815700240,1672599340,1672602906,3566
10109,3755230010,3500234771,1672537879,1672540903,3024
11648,3206544535,3533841983,1672626421,1672626654,233
11295,3732846295,3366433035,1672675225,1672676409,1184
11270,3778706119,3500440602,1672617466,1672618136,670
10420,3830962592,3756536476,1672610977,1672612155,1178
11759,3609103278,3307236682,1672570872,1672572163,1291
10562,3772867078,3817120976,1672647307,1672648461,1154
9799,3907390925,3770846374,1672531289,1672534199,2910
10503,3625779003,3394394262,1672676786,1672678100,1314
11302,3374147279,3812677669,1672689058,1672689660,602
11031,3757514745,3505007498,1672614296,1672617857,3561
10161,3294952405,3488887919,1672570835,1672571792,957
10096,3757089924,3773161055,1672674798,1672676333,1535
10227,3501977123,3302416197,1672634204,1672635334,1130
11399,3520155898,3730600658,1672590435,1672592176,1741
11237,3715852330,3703104365,1672604168,1672604997,829
10408,3779706467,3487395357,1672576306,1672577393,1087
10343,3604569804,3773134128,1672636292,1672638703,2411
10017,3813853446,3520362238,1672611982,1672612652,670
10694,3665431349,3610806770,1672635580,1672638068,2488
11783,3886957097,3396440259,1672571630,1672572140,510
11370,3351153781,3772867078,1672568667,1672569046,379
11045,3505826673,3519465545,1672537126,1672537725,599
10561,3520057139,3858429342,1672683096,1672686360,3264
10012,3517021928,3500087325,1672637701,1672641049,3348
11721,3271762055,3776166086,1672546143,1672548957,2814
11623,3791245127,3664523809,1672652760,1672655342,2582
9984,3555764822,3818236682,1672547728,1672549653,1925
11314,3619538249,3500968729,1672554284,1672555086,802
10969,3301489209,3715282492,1672666168,1672666793,625
11535,3466655775,3519730914,1672558510,1672561107,2597
10294,3510869438,3332840671,1672634117,1672635808,1691
10380,3518572231,3446066492,1672638379,1672640342,1963
10417,3935333166,3515974881,1672658607,1672659204,597
10623,3756890980,3514306458,1672533460,1672534886,1426
10917,3792627762,3295530454,1672576087,1672577806,1719
10291,3887382548,3512794667,1672560184,1672563328,3144
10290,3505867821,3224053840,1672611630,1672611901,271
10856,3610806770,3288675710,1672607653,1672608325,672
10889,3316406470,3619705594,1672570539,1672573475,2936
10667,3778731000,3520694387,1672561416,1672563053,1637
10282,3305093237,3793081195,1672618706,1672620760,2054
11084,3439532406,3509677530,1672552852,1672556332,3480
10950,3637522163,3491335890,1672625098,1672628150,3052
9797,3714268380,3776791436,1672666010,1672669257,3247
10429,3896615831,3421674406,1672611991,1672614797,2806
10219,3933106901,3487231844,1672568721,1672569326,605
10359,3505490878,3777263928,1672690535,1672691683,1148
11066,3791245127,3311569360,1672653939,1672657084,3145
11307,3301449986,3855674398,1672555444,1672557491,2047
10855,3887030182,3812559393,1672591287,1672593102,1815
10482,3515528947,3716160006,1672557229,1672557532,303
11772,3352493805,3776727271,1672583920,1672586054,2134
11360,3838039092,3713283029,1672573899,1672575984,2085
11064,3783594246,3732846295,1672566861,1672568514,1653
11075,3701675183,3509186338,1672539338,1672542778,3440
9860,3515259326,3500889287,1672628327,1672630385,2058
11488,3505490878,3534531061,1672589174,1672589837,663
10443,3439036305,3318220119,1672537497,1672538651,1154
10387,3774506868,3515804844,1672642493,1672643190,697
10454,3714142299,3220987526,1672583382,1672583928,546
11467,3304252969,3605078841,1672697909,1672701399,3490
11423,3710316008,3713475356,1672614879,1672615684,805
9859,3924963918,3894495222,1672683108,1672685631,2523
11711,3395069149,3834949242,1672606970,1672610139,3169
11163,3394986304,3428198021,1672573858,1672576198,2340
11637,3515706117,3410602007,1672620304,1672620445,141
11608,3227059650,3827889533,1672702893,1672704953,2060
11325,3898965585,3770391782,1672651245,1672652597,1352
11249,3770273966,3756119976,1672689420,1672691575,2155
11427,3380444321,3778044082,1672547698,1672550442,2744
11518,3755411110,3335055096,1672666661,1672667776,1115
10817,3737622701,3623512088,1672639599,1672641787,2188
9965,3312612693,3408111327,1672703401,1672705043,1642
11212,3511003541,3770276815,1672624296,1672627433,3137
9852,3379517265,3600978954,1672636563,1672639545,2982
10208,3791584994,3304661369,1672682221,1672684930,2709
9918,3812559393,3357074700,1672577918,1672581480,3562
11460,3534102440,3472272792,1672572618,1672574201,1583
10459,3714951681,3735056027,1672622727,1672624675,1948
10977,3713514933,3774744663,1672612474,1672615554,3080
10603,3888057649,3501004005,1672574146,1672574564,418
11470,3611533094,3776581518,1672647351,1672648646,1295
11758,3510968599,3898989233,1672632425,1672635017,2592
11032,3779748270,3512784888,1672596347,1672598233,1886
10284,3247545468,3778182724,1672692662,1672694446,1784
9858,3858429342,3513840186,1672635244,1672636440,1196
10047,3275735969,3792900315,1672552216,1672555288,3072
9887,3500674240,3519015940,1672602643,1672604658,2015
9967,3757855416,3756149282,1672656370,1672658792,2422
11126,3512101369,3335055096,1672579958,1672581316,1358
9837,3505278562,3455430943,1672634349,1672635967,1618
11746,3931319307,3922430928,1672608297,1672610802,2505
10402,3755273361,3912878303,1672668657,1672670757,2100
11545,3416474842,3235373942,1672591251,1672592959,1708
11352,3293157673,3715587520,1672663526,1672664210,684
10311,3352044245,3273758330,1672610446,1672613213,2767
10063,3493679801,3774355339,1672582084,1672584235,2151
10398,3514515499,3500785888,1672643532,1672643926,394
10803,3509651954,3514498259,1672658413,1672661748,3335
11448,3755394177,3487622510,1672602425,1672605328,2903
11697,3716492409,3780482864,1672670740,1672670996,256
11694,3278443807,3500590302,1672580636,1672583967,3331
10546,3496352027,3915679140,1672668247,1672670136,1889
11017,3311805161,3520558137,1672636016,1672636745,729
9851,3472901378,3500087325,1672563150,1672563505,355
9854,3736941123,3505266343,1672637289,1672639525,2236
10399,3773714494,3713923960,1672595174,1672597279,2105
9840,3783563043,3287753579,1672541481,1672542152,671
10401,3851737350,3305612422,1672533250,1672536583,3333
10786,3520022175,3291936679,1672604776,1672606746,1970
10280,3939422411,3407734098,1672680164,1672681453,1289
10475,3886837151,3517810375,1672549103,1672549363,260
11779,3681504869,3779282072,1672666264,1672666603,339
10561,3511412229,3701448521,1672635113,1672637879,2766
10140,3509457543,3390537737,1672557562,1672559327,1765
11013,3772689657,3510775046,1672650677,1672652617,1940
10405,3774304163,3818532143,1672592474,1672594010,1536
9936,3299847117,3908177413,1672608554,1672609677,1123
11738,3505853594,3516249472,1672559303,1672561874,2571
10044,3620836520,3778909412,1672630715,1672630853,138
10837,3517469005,3449233346,1672636765,1672639042,2277
10815,3318220119,3852161626,1672656755,1672659886,3131
10885,3773826624,3458130310,1672540199,1672542337,2138
10472,3476416072,3393001196,1672642763,1672645055,2292
11572,3703476890,3519435459,1672696532,1672696708,176
10880,3885674996,3791758175,1672574212,1672576870,2658
11232,3406101720,3703168159,1672541631,1672542402,771
10333,3245882008,3514145752,1672546200,1672549791,3591
10434,3618024815,3730290851,1672548420,1672549932,1512
11268,3336501403,3245882008,1672603098,1672604777,1679
10677,3639465750,3772320856,1672568912,1672569034,122
11706,3513894659,3815700240,1672594817,1672598229,3412
10875,3791587717,3559112196,1672613311,1672614802,1491
10405,3311449914,3668720465,1672558532,1672561514,2982
10716,3711287751,3715441786,1672567004,1672567542,538
11256,3301403047,3792008302,1672689442,1672689649,207
10334,3812756400,3703737650,1672586975,1672588264,1289
10657,3510439480,3372617110,1672625583,1672627763,2180
10173,3774448657,3501600785,1672694090,1672697318,3228
10528,3311774510,3837378340,1672629028,1672629521,493
11154,3417268745,3454343398,1672534113,1672537631,3518
11362,3233965781,3909822999,1672690467,1672690685,218
10255,3714453773,3517227599,1672565630,1672568991,3361
11434,3801501384,3483347530,1672679894,1672682456,2562
10739,3317887374,3701385831,1672568353,1672569321,968
10047,3716460706,3463883997,1672591379,1672593538,2159
11333,3756536512,3893629892,1672589864,1672591841,1977
11031,3777439655,3776727271,1672559492,1672560060,568
9980,3791758175,3734957248,1672622591,1672624403,1812
11432,3499998389,3857389270,1672610883,1672612331,1448
10830,3714250543,3512645289,1672626260,1672628273,2013
11634,3469780362,3519513219,1672542659,1672544469,1810
9900,3496579251,3776249160,1672585500,1672588303,2803
10418,3515655024,3770533675,1672657307,1672657822,515
11725,3756079870,3220987526,1672575530,1672575690,160
10139,3713141087,3760529327,1672668134,1672671143,3009
9849,3433902955,3228056289,1672576895,1672577208,313
11743,3838423363,3756616853,1672626188,1672627838,1650
10620,3660163550,3925208102,1672699806,1672701557,1751
10005,3505531432,3373851012,1672532540,1672535158,2618
11200,3205908584,3272838634,1672593652,1672594440,788
10954,3637522163,3777564559,1672673893,1672676217,2324
9920,3555215568,3835509670,1672576779,1672576998,219
11605,3533473206,3733411026,1672644294,1672645861,1567
10787,3498857406,3512819376,1672546708,1672547171,463
10107,3459951739,3515838621,1672577368,1672580644,3276
10669,3505117019,3778986795,1672612161,1672613023,862
11292,3500049870,3780500331,1672625955,1672626199,244
10236,3298831109,3792824886,1672556705,1672558495,1790
10367,3398862999,3420664407,1672695766,1672696277,511
11026,3919342147,3514980025,1672658430,1672661680,3250
11405,3513186578,3713514933,1672577273,1672578527,1254
10780,3355903597,3779503296,1672572862,1672574126,1264
11184,3714453773,3701675183,1672578799,1672579911,1112
11413,3513586642,3773770134,1672638066,1672640761,2695
10154,3715566511,3625952981,1672575802,1672579273,3471
10148,3826315540,3445172440,1672619950,1672621862,1912
11525,3444598583,3403150349,1672575291,1672577608,2317
10361,3776901443,3777405860,1672551978,1672552208,230
10862,3500674240,3447938130,1672627881,1672630696,2815
11507,3439045964,3241567995,1672696216,1672697863,1647
10250,3244397548,3316551382,1672698425,1672700638,2213
10052,3447312353,3770276815,1672590373,1672591340,967
11774,3501557463,3373802545,1672632210,1672633780,1570
10075,3497904539,3515699732,1672640496,1672643776,3280
10188,3791905743,3714281210,1672601375,1672601916,541
10528,3511286390,3517210356,1672554725,1672555662,937
11119,3834643026,3500863429,1672664757,1672666012,1255
10025,3515507526,3715039960,1672547993,1672550060,2067
11255,3403395712,3793719515,1672655466,1672658932,3466
10115,3777204977,3275661834,1672645810,1672646545,735
11279,3368441333,3356972733,1672693103,1672696175,3072
11185,3757598610,3715196780,1672701271,1672701525,254
10064,3385481989,3421674406,1672695731,1672696781,1050
10383,3511466117,3760748418,1672626037,1672628977,2940
9990,3734233216,3272581469,1672694383,1672695136,753
11607,3366566029,3480560014,1672617733,1672618456,723
10838,3791382196,3760267158,1672696804,1672697217,413
11095,3413511621,3780173788,1672685346,1672687198,1852
10004,3666823095,3732846295,1672679523,1672681310,1787
10241,3515939841,3493598658,1672601401,1672603312,1911
10283,3884862164,3470997293,1672552435,1672553745,1310
11179,3501583486,3342031426,1672562832,1672563085,253
10252,3689386663,3890278838,1672691656,1672693137,1481
10778,3755369666,3892177203,1672701326,1672701667,341
10892,3804779247,3895944547,1672688074,1672690212,2138
10987,3516497645,3318224774,1672593530,1672596491,2961
10432,3470135167,3238796398,1672544337,1672545283,946
10658,3514033319,3701971784,1672577818,1672580223,2405
11267,3311414429,3518511124,1672679091,1672680420,1329
11791,3388923880,3388481990,1672546272,1672549010,2738
10299,3832289185,3517021928,1672686024,1672687013,989
10558,3791825536,3776593726,1672573548,1672576080,2532
11094,3903115138,3388923880,1672668907,1672670295,1388
9952,3299845453,3509996827,1672572940,1672576466,3526
10297,3533440736,3208560443,1672663582,1672666297,2715
11523,3779818784,3533593766,1672614507,1672617363,2856
11035,3668154066,3349319959,1672548510,1672548996,486
11014,3511883778,3611570003,1672595740,1672598504,2764
10294,3206262649,3755922811,1672565125,1672566277,1152
10011,3519465545,3417268745,1672550556,1672553345,2789
11788,3780127017,3976742903,1672602158,1672602619,461
11628,3834424604,3500057674,1672646240,1672648996,2756
10191,3756437169,3363549860,1672685372,1672685788,416
9914,3369810091,3246062632,1672591765,1672592132,367
10674,3515304526,3778544203,1672640635,1672641739,1104
10616,3713170867,3928421417,1672555916,1672556654,738
11225,3519046342,3716095450,1672542766,1672546285,3519
9902,3756066702,3458753033,1672568895,1672571854,2959
11361,3510968599,3501927452,1672535105,1672536738,1633
11782,3780206849,3511412229,1672698501,1672699741,1240
11112,3630802959,3520473111,1672698005,1672699110,1105
11703,3334482021,3791664049,1672700640,1672703373,2733
10137,3472774606,3756363182,1672642580,1672642664,84
10353,3711223297,3418367752,1672537876,1672541371,3495
10424,3500073824,3500015630,1672686593,1672686772,179
10379,3433196933,3517756624,1672593813,1672594641,828
11478,3368951504,3614944981,1672641383,1672644605,3222
10098,3791236983,3977880564,1672602306,1672604057,1751
11242,3777370992,3484483775,1672701829,1672703675,1846
10860,3639503148,3228477490,1672550546,1672553014,2468
11206,3756413374,3773411968,1672592556,1672593954,1398
9954,3714903253,3934980229,1672589527,1672592678,3151
10029,3976742903,3613703906,1672551197,1672554554,3357
9924,3360783381,3834980281,1672650760,1672651147,387
11329,3760776967,3791245127,1672682990,1672684579,1589
10644,3440305508,3346755179,1672612893,1672614518,1625
10148,3514698862,3624872714,1672585408,1672586349,941
10284,3778819352,3452175941,1672594222,1672595577,1355
9880,3902300755,3660702754,1672565544,1672568215,2671
11706,3468871103,3236948071,1672531870,1672535199,3329
10580,3380281484,3927805949,1672669492,1672671952,2460
11710,3312800145,3500057674,1672639201,1672640555,1354
11750,3756413374,3971422524,1672703472,1672704423,951
10583,3311924005,3601340045,1672648965,1672650218,1253
11656,3773714494,3920155862,1672687816,1672688666,850
10701,3703896751,3462153833,1672630626,1672634172,3546
10280,3517991042,3783563043,1672610651,1672611363,712
11266,3395615598,3633622298,1672613120,1672615815,2695
10637,3776125503,3516867729,1672574477,1672577227,2750
9961,3931164237,3276209319,1672565458,1672565647,189
11500,3913847876,3516359146,1672686818,1672689951,3133
11159,3313282478,3517552930,1672611095,1672611661,566
11691,3713694278,3635599307,1672612154,1672613037,883
11208,3639465750,3406101720,1672580943,1672583731,2788
10597,3688870751,3201634072,1672578396,1672581353,2957
10682,3348343425,3780074082,1672549668,1672552835,3167
10548,3499998389,3772131127,1672589060,1672589921,861
10911,3557129226,3304447950,1672603976,1672605123,1147
11135,3896200048,3455430943,1672637450,1672640391,2941
11085,3510250740,3703031637,1672679209,1672680467,1258
10021,3272096922,3514013999,1672532066,1672535176,3110
11167,3792432094,3906693728,1672562733,1672563457,724
11087,3701865589,3203630241,1672599943,1672602257,2314
10165,3221736756,3439651226,1672698794,1672701563,2769
10563,3511412229,3479910993,1672624483,1672625660,1177
11135,3908331271,3779454060,1672671501,1672674104,2603
9935,3701887470,3809860102,1672620629,1672621057,428
10796,3623894390,3243056734,1672539111,1672541648,2537
11749,3793232021,3272096922,1672672877,1672673911,1034
11770,3554174421,3533325993,1672664802,1672666924,2122
10225,3516827471,3224053840,1672655491,1672659012,3521
10683,3299052917,3517632796,1672684909,1672687864,2955
9982,3515893948,3358530225,1672692252,1672692633,381
10255,3793783685,3434452046,1672583952,1672586253,2301
10866,3407403080,3757497708,1672651486,1672652493,1007
11464,3501137133,3931319307,1672604965,1672606890,1925
10742,3512395783,3516815069,1672599318,1672602761,3443
11444,3783373085,3703351452,1672679243,1672680658,1415
11437,3783939161,3778909412,1672650471,1672650773,302
9943,3791368349,3934070285,1672667968,1672668544,576
11576,3686885442,3710125627,1672685814,1672688759,2945
10938,3701475090,3517810375,1672692611,1672695339,2728
10512,3710119555,3500741005,1672697845,1672701246,3401
10939,3701387745,3793902476,1672549260,1672550755,1495
10668,3737738751,3409514897,1672673872,1672677351,3479
11521,3926724515,3392573386,1672639832,1672640356,524
10764,3512306195,3884180202,1672610426,1672611235,809
11278,3756168814,3757201538,1672683931,1672686127,2196
11344,3776710698,3791031227,1672544569,1672546632,2063
10650,3505155858,3974668678,1672650606,1672651879,1273
9840,3687024828,3491390365,1672600643,1672602311,1668
10070,3533929043,3894495222,1672667735,1672670774,3039
10376,3793860209,3830254808,1672649530,1672651423,1893
10386,3760069457,3780786276,1672661543,1672664896,3353
10338,3807717766,3516103646,1672617199,1672619228,2029
11263,3713139039,3493047640,1672703838,1672706621,2783
11275,3275274182,3711243126,1672646769,1672649913,3144
9977,3755357292,3682150740,1672613501,1672614963,1462
11746,3666655293,3367299721,1672630988,1672633792,2804
10983,3310702648,3713514933,1672611125,1672614640,3515
11019,3894756677,3422915648,1672691955,1672694791,2836
10391,3513764665,3396440259,1672623924,1672624237,313
10131,3246567963,3307997700,1672558530,1672560234,1704
11184,3445896667,3308965136,1672540817,1672541048,231
10525,3716285196,3760656396,1672645875,1672647620,1745
11269,3394394262,3509544691,1672664515,1672664888,373
11707,3817376705,3711015176,1672637097,1672639381,2284
11378,3242082716,3285971415,1672678663,1672681069,2406
9824,3245121919,3304227085,1672660004,1672662943,2939
10280,3468871103,3780148144,1672631566,1672634226,2660
11334,3779930476,3778544203,1672681964,1672685455,3491
10294,3710865678,3772114731,1672572252,1672573861,1609
11561,3550206045,3534372899,1672702578,1672705972,3394
11438,3703999217,3434052463,1672545031,1672547347,2316
10620,3925208102,3757212744,1672589831,1672592211,2380
10762,3516497645,3854202447,1672700985,1672703379,2394
10041,3755378125,3313101243,1672683883,1672685714,1831
9833,3816184951,3854390432,1672630711,1672634175,3464
10688,3922480066,3335139032,1672659786,1672659887,101
11024,3368951504,3896840409,1672633556,1672633984,428
11576,3772055279,3377446376,1672606439,1672608528,2089
10424,3621960662,3827836825,1672650381,1672653027,2646
10380,3517960740,3287920864,1672648796,1672651533,2737
11447,3714142299,3772844451,1672534361,1672535540,1179
11144,3779393140,3402774497,1672611679,1672613330,1651
11054,3756695502,3226761201,1672631648,1672635171,3523
11025,3304235700,3505164060,1672532259,1672533563,1304
11411,3224040894,3311569360,1672694323,1672696124,1801
9808,3512527440,3432050858,1672697174,1672699270,2096
10374,3716475340,3228218081,1672655135,1672656135,1000
9938,3710060386,3603740088,1672659487,1672661600,2113
10150,3935256825,3804707712,1672572515,1672575038,2523
11459,3514685272,3711856534,1672541720,1672544306,2586
10712,3443004958,3355430975,1672670463,1672673875,3412
9957,3772234939,3518511124,1672702748,1672704238,1490
10125,3510819040,3923524564,1672600988,1672602376,1388
11537,3660257653,3241855333,1672598320,1672601686,3366
10790,3276209319,3776053981,1672581925,1672583742,1817
10314,3444453261,3249771731,1672592899,1672595982,3083
10618,3925823748,3711862792,1672641435,1672644791,3356
10488,3736621212,3430823498,1672677031,1672680210,3179
10439,3405200303,3403870769,1672678168,1672681632,3464
10276,3318250647,3406238754,1672532449,1672534112,1663
10800,3298113026,3469663062,1672634147,1672635920,1773
10834,3493598658,3899756737,1672631634,1672633330,1696
10760,3512490032,3710807030,1672579998,1672582795,2797
11059,3505786561,3247075753,1672563557,1672563957,400
9867,3774782065,3377446376,1672551076,1672553596,2520
10355,3817120976,3903088144,1672600599,1672601084,485
11076,3756328353,3907088952,1672595210,1672595812,602
11156,3406937294,3776182849,1672580494,1672580635,141
10345,3818570577,3832902787,1672638943,1672640917,1974
10336,3703779674,3509073025,1672589429,1672590954,1525
11400,3519831322,3684199077,1672657986,1672659895,1909
11248,3558567160,3555954355,1672669127,1672671383,2256
10467,3447312353,3373851012,1672693152,1672693352,200
11104,3682906048,3624872714,1672551783,1672553595,1812
10019,3500640854,3421956717,1672665282,1672667260,1978
10185,3334381941,3783357035,1672532948,1672535358,2410
11156,3772877723,3927365255,1672544878,1672546209,1331
10284,3496352027,3501271930,1672547408,1672548261,853
11532,3774627091,3780982229,1672575038,1672578606,3568
10378,3500922040,3662055682,1672613903,1672617150,3247
10875,3477951091,3701841013,1672550817,1672551655,838
10566,3825932442,3776727271,1672607518,1672610705,3187
10504,3921138062,3393001196,1672701681,1672704644,2963
11420,3791905743,3310021925,1672575569,1672575683,114
10759,3792008302,3772648837,1672556417,1672558998,2581
10476,3757089924,3739395381,1672639085,1672641619,2534
9856,3610806770,3791108593,1672556846,1672559171,2325
11688,3896622009,3455430943,1672554532,1672556113,1581
11428,3760801237,3229570647,1672643056,1672643810,754
10794,3282053097,3623113240,1672617558,1672620315,2757
11344,3902300755,3239082508,1672685740,1672687303,1563
11561,3427049290,3687183789,1672625025,1672628565,3540
10079,3923524564,3311696372,1672559930,1672563143,3213
11426,3509208005,3519165527,1672626870,1672627279,409
10098,3779609338,3274894848,1672594404,1672596653,2249
10071,3772786559,3359929534,1672690046,1672691863,1817
11457,3519886257,3500031401,1672675872,1672676095,223
11141,3378729459,3701841013,1672702466,1672704815,2349
11316,3533593766,3505980138,1672604992,1672606440,1448
11476,3293553295,3445355677,1672589253,1672592102,2849
10347,3505449070,3907225070,1672545892,1672548627,2735
10754,3302879906,3631444265,1672694350,1672696941,2591
10554,3505665788,3342426430,1672631832,1672635058,3226
11553,3505066871,3534491112,1672641489,1672644687,3198
11535,3711029952,3804779247,1672695090,1672697492,2402
11327,3515379622,3276393542,1672570959,1672573065,2106
10829,3501137133,3908883591,1672649767,1672650329,562
10900,3358530225,3780294116,1672697556,1672699553,1997
10238,3306475287,3505684690,1672586249,1672586895,646
11535,3634670780,3309528048,1672667478,1672669527,2049
10169,3773840321,3501612813,1672678468,1672681365,2897
11773,3229615214,3856552205,1672655062,1672657396,2334
10763,3932919664,3470135167,1672551987,1672552322,335
10615,3371238318,3307535495,1672543234,1672543732,498
10681,3517949586,3468871103,1672673721,1672677133,3412
10868,3470997293,3776581518,1672596023,1672598435,2412
10088,3372617110,3400025324,1672580820,1672581547,727
9915,3715008501,3444646562,1672685428,1672686890,1462
11102,3402105276,3814672661,1672586347,1672586863,516
11483,3622152515,3710487368,1672576605,1672579409,2804
11195,3884394685,3936486724,1672574525,1672576011,1486
10193,3205948776,3303747093,1672561702,1672564098,2396
10097,3792063616,3667950469,1672586501,1672588253,1752
10292,3714268380,3908331271,1672569815,1672571285,1470
11037,3807646028,3774448657,1672578719,1672580090,1371
10056,3772648837,3880030249,1672690377,1672690698,321
10523,3481019442,3620836520,1672603534,1672606908,3374
9845,3716467469,3779427180,1672599480,1672600514,1034
10160,3713373455,3713923960,1672612530,1672614239,1709
9809,3450621820,3455955489,1672586949,1672588201,1252
10254,3369270860,3638050763,1672703284,1672704467,1183
11556,3793719515,3791409441,1672612160,1672613592,1432
11368,3405303958,3505291330,1672661177,1672664242,3065
11184,3520824937,3918126468,1672586709,1672589768,3059
9942,3476958001,3716982179,1672571334,1672571697,363
11245,3778100960,3360309868,1672698820,1672700582,1762
10460,3834311054,3757713457,1672538565,1672541666,3101
11567,3520558137,3534696810,1672566728,1672569583,2855
11037,3510781595,3302416197,1672576008,1672578262,2254
10207,3512744657,3756066702,1672596274,1672599206,2932
10183,3515715968,3301369282,1672680882,1672683776,2894
10651,3733915784,3757732853,1672571762,1672574245,2483
10274,3714264759,3500433278,1672641096,1672642584,1488
10770,3505032644,3231654754,1672569683,1672571395,1712
11339,3886837151,3393128259,1672641107,1672642134,1027
11617,3931028233,3772845364,1672621220,1672624652,3432
11364,3776841808,3453464785,1672616405,1672616562,157
10772,3896200048,3773826624,1672626692,1672627550,858
10311,3555763674,3773688906,1672651382,1672651612,230
10013,3509370633,3793899166,1672552150,1672554780,2630
11167,3822496670,3686885442,1672626288,1672627279,991
11488,3439662051,3518572231,1672578438,1672580328,1890
10603,3403988682,3351949206,1672584259,1672584604,345
10101,3455907179,3783122313,1672564720,1672568040,3320
11563,3770780655,3304592684,1672614421,1672615413,992
10309,3452090950,3925098136,1672643791,1672647341,3550
10629,3465227623,3533703578,1672674655,1672674889,234
11413,3837378340,3301489209,1672558913,1672560333,1420
10951,3515804844,3756668747,1672533964,1672535398,1434
9900,3245245283,3772489471,1672537350,1672539598,2248
10532,3713611960,3534531061,1672589931,1672590204,273
9845,3937854073,3391093411,1672640023,1672641438,1415
10718,3710228292,3292663993,1672542657,1672543117,460
11012,3776249160,3710147457,1672603228,1672605423,2195
10636,3810949170,3512744657,1672650227,1672652248,2021
11708,3713740434,3404395454,1672536918,1672538540,1622
9836,3760748418,3890211161,1672567582,1672569670,2088
10060,3352493805,3777290300,1672683802,1672684695,893
10354,3776193847,3501261089,1672585804,1672587629,1825
11583,3681701931,3519341916,1672559447,1672560233,786
11511,3713621169,3701978422,1672575476,1672576392,916
10458,3510919509,3817076003,1672694021,1672696326,2305
11601,3778702093,3900540310,1672665419,1672668732,3313
11388,3533017131,3513890046,1672658714,1672661836,3122
11219,3479207976,3207586072,1672641697,1672645275,3578
10653,3756850160,3791269060,1672692898,1672694824,1926
10782,3517766135,3854229296,1672652122,1672654625,2503
10843,3701004302,3855977674,1672555439,1672558021,2582
11547,3511218261,3760144712,1672559268,1672562144,2876
10244,3830291558,3314965818,1672659457,1672660103,646
11251,3519165527,3534174363,1672565192,1672565258,66
11745,3512641538,3783021859,1672662301,1672662998,697
10052,3518534560,3319660530,1672656373,1672658485,2112
10531,3311805161,3519553933,1672683777,1672685353,1576
10194,3557129226,3710891331,1672582121,1672582747,626
10840,3559125467,3621629499,1672579554,1672581431,1877
9961,3534122907,3774965463,1672658089,1672659097,1008
10125,3852275715,3514306458,1672650425,1672650712,287
11078,3937299996,3366164642,1672552670,1672553939,1269
10753,3711119575,3755922811,1672603520,1672604656,1136
9881,3516651799,3533017131,1672674407,1672677896,3489
9962,3828906027,3468871103,1672649651,1672651952,2301
9952,3306066522,3802625412,1672613998,1672617061,3063
11157,3619538249,3405435885,1672546683,1672549381,2698
11200,3500104976,3822786416,1672614299,1672616517,2218
10819,3444168914,3307236682,1672558368,1672560574,2206
11491,3973134902,3669418238,1672575529,1672576442,913
9867,3837888196,3510968599,1672569805,1672572705,2900
10784,3684108920,3916463490,1672638427,1672641750,3323
9882,3509503263,3512154443,1672698561,1672698729,168
11212,3611832288,3918126468,1672610041,1672611764,1723
11264,3500821475,3701685828,1672646138,1672649128,2990
11757,3804779247,3899903158,1672617867,1672619682,1815
9990,3500833053,3611298237,1672592514,1672595336,2822
11564,3711029952,3238056215,1672605090,1672607848,2758
10438,3755361692,3715039960,1672652347,1672655145,2798
11060,3778706119,3493679801,1672629697,1672633188,3491
11331,3514515499,3701824335,1672566752,1672569398,2646
11380,3309528048,3395069149,1672568974,1672570689,1715
10842,3926724515,3710807030,1672596870,1672598054,1184
10805,3886957097,3517113478,1672587493,1672588089,596
10004,3485521840,3472018395,1672598526,1672600445,1919
10582,3356972733,3714645218,1672585869,1672587399,1530
10854,3791841318,3805704844,1672663902,1672664319,417
10427,3792267993,3773669001,1672579730,1672579854,124
10525,3510547682,3812261241,1672627096,1672628095,999
10606,3276209319,3493679801,1672594361,1672594444,83
10745,3516153301,3701725839,1672626703,1672627714,1011
10218,3822634862,3303747093,1672673245,1672676462,3217
10188,3509274030,3372079985,1672663327,1672665910,2583
11481,3703694139,3513508737,1672631425,1672632424,999
10888,3278805844,3319645922,1672615778,1672617257,1479
11055,3621591266,3602680347,1672641621,1672642767,1146
10877,3275057862,3554437212,1672554694,1672554993,299
11493,3388537708,3756843139,1672589328,1672590757,1429
10766,3777060250,3713031958,1672610692,1672611556,864
10785,3793029132,3519908593,1672602688,1672604589,1901
11067,3377883705,3776187150,1672542272,1672544754,2482
10631,3505816624,3437023385,1672624606,1672626516,1910
10515,3556684272,3500015630,1672699072,1672700496,1424
9964,3367109648,3450621820,1672674555,1672676565,2010
10653,3301403047,3330188769,1672595374,1672597665,2291
10030,3893932944,3605101443,1672622891,1672625682,2791
10777,3452175941,3231654754,1672683058,1672683922,864
11788,3756428507,3801501384,1672699569,1672702118,2549
11519,3516034245,3685396470,1672541870,1672543947,2077
10799,3519712497,3710783759,1672694966,1672697133,2167
10284,3777686966,3499343927,1672660148,1672661647,1499
10408,3358530225,3772962072,1672594300,1672594562,262
10090,3511245705,3518989186,1672675995,1672676662,667
11248,3760107540,3519689906,1672692893,1672694038,1145
10630,3295691964,3515753241,1672599323,1672600998,1675
10974,3933106901,3774090455,1672663809,1672666775,2966
10065,3445733121,3517949586,1672535315,1672537352,2037
11585,3776053981,3660702754,1672572718,1672572880,162
10711,3312651192,3505129296,1672550186,1672550420,234
10205,3892177203,3393543588,1672680555,1672683636,3081
11035,3245501577,3714142299,1672559318,1672562841,3523
9802,3516815069,3703206956,1672566900,1672570230,3330
10184,3491104534,3339649817,1672572970,1672575589,2619
10017,3520779124,3932955949,1672626627,1672626735,108
11153,3711947828,3703849264,1672579487,1672580972,1485
10633,3737467358,3716179251,1672622650,1672625523,2873
10604,3489340327,3755209597,1672643539,1672645372,1833
10239,3809871495,3377250778,1672582287,1672584964,2677
10386,3501171785,3777552831,1672586072,1672588055,1983
11281,3772509599,3500415589,1672556959,1672559217,2258
10428,3773840321,3440743218,1672681373,1672684706,3333
10542,3792851584,3220123678,1672676510,1672678171,1661
10074,3514941815,3773041843,1672534440,1672535838,1398
10970,3358530225,3533427742,1672660491,1672664025,3534
11285,3791031227,3372617110,1672655566,1672656604,1038
10044,3625931630,3515984911,1672655525,1672658455,2930
11275,3272096922,3278443807,1672553500,1672554115,615
9904,3488988274,3756493561,1672607314,1672608054,740
10719,3772695548,3415803494,1672655711,1672658949,3238
11049,3772235668,3851877325,1672690930,1672694315,3385
11779,3832902787,3513213122,1672610768,1672612065,1297
10140,3221126799,3756759239,1672629026,1672630433,1407
10922,3711015176,3884192843,1672552579,1672553773,1194
11389,3440991826,3534426696,1672628918,1672631927,3009
10386,3434052463,3201573194,1672604220,1672605959,1739
9839,3793274846,3756149282,1672677311,1672679409,2098
10857,3519059808,3818324410,1672567021,1672569444,2423
11299,3910354786,3715566511,1672691300,1672693234,1934
11161,3622218289,3371132167,1672662527,1672663587,1060
10263,3716994924,3513777705,1672569577,1672569999,422
11630,3378747834,3450621820,1672651188,1672653274,2086
10568,3773697080,3301489209,1672635988,1672636499,511
10252,3714897456,3714923092,1672658824,1672660496,1672
9969,3447938130,3500591274,1672661097,1672661259,162
10386,3756328353,3793978936,1672679941,1672682121,2180
9986,3276231633,3514145752,1672646991,1672649665,2674
10251,3613781977,3514216460,1672538730,1672539331,601
11658,3813853446,3884394685,1672673395,1672676484,3089
11567,3774447975,3423782420,1672552658,1672555745,3087
11782,3516777819,3439662051,1672544124,1672547038,2914
10606,3534589501,3517136772,1672644317,1672644663,346
10574,3550887623,3909067335,1672535162,1672535945,783
11014,3271719569,3518931700,1672653055,1672656163,3108
10416,3519352855,3301332095,1672600795,1672602678,1883
10682,3616403486,3757639274,1672611602,1672612091,489
9908,3770715115,3512753567,1672595161,1672597832,2671
11746,3713807753,3776581518,1672559992,1672563524,3532
11108,3814289471,3284374600,1672616125,1672618884,2759
10244,3500931474,3516904926,1672628551,1672630616,2065
10377,3512343029,3791409441,1672668496,1672670726,2230
10845,3510159441,3618895679,1672541421,1672542119,698
11127,3774447975,3366566029,1672545017,1672548118,3101
11766,3777672363,3510795808,1672654449,1672656807,2358
11152,3446218191,3818461836,1672698337,1672698810,473
10778,3273537848,3737738751,1672609847,1672610350,503
11120,3519494023,3343859998,1672610997,1672612144,1147
10111,3777439655,3738103378,1672663501,1672664625,1124
11722,3701655378,3335139032,1672677049,1672680289,3240
10740,3520725149,3520395850,1672631332,1672633623,2291
10287,3443041059,3760232135,1672698424,1672698836,412
9845,3892177203,3772569860,1672564776,1672566402,1626
11599,3772216305,3791088014,1672643498,1672645517,2019
11227,3227647190,3245245283,1672638786,1672640807,2021
10261,3201573194,3909220912,1672577202,1672578698,1496
11122,3714116241,3791289855,1672555120,1672555438,318
9878,3715602742,3971280379,1672593031,1672595917,2886
9935,3295787354,3971996397,1672683754,1672684439,685
11108,3243305367,3510262025,1672577353,1672578594,1241
10684,3516965624,3732871856,1672544401,1672547980,3579
10255,3688845298,3511218261,1672700791,1672702932,2141
11754,3755989680,3343767438,1672533825,1672535917,2092
10072,3777686966,3270502801,1672592590,1672594081,1491
10391,3519055736,3826068495,1672590785,1672592335,1550
10863,3382696725,3509167758,1672664980,1672665976,996
10021,3311989687,3772556646,1672539172,1672539321,149
11620,3713102459,3714453773,1672541178,1672544342,3164
11171,3897003751,3519297683,1672588900,1672589848,948
11030,3513143959,3774706478,1672671061,1672673209,2148
10017,3890813040,3450234157,1672615033,1672615628,595
11049,3828568868,3391612879,1672540071,1672543610,3539
11251,3292936094,3661543201,1672533586,1672536002,2416
9843,3783172505,3403150349,1672580672,1672583573,2901
11744,3444646562,3971051020,1672635309,1672638034,2725
11314,3515100211,3776447604,1672681660,1672684303,2643
10601,3884369346,3276230295,1672618896,1672621840,2944
10976,3885147558,3389367628,1672553161,1672554507,1346
10062,3714892312,3289258397,1672641932,1672645378,3446
11576,3514685272,3713954144,1672614119,1672617519,3400
10503,3920526713,3909457959,1672571667,1672574502,2835
11200,3368441333,3440770466,1672569192,1672570579,1387
10051,3505697295,3478052226,1672652012,1672654366,2354
10365,3909632424,3285971415,1672554336,1672557050,2714
10661,3390368796,3621591266,1672587396,1672590788,3392
10566,3517627003,3772648837,1672599923,1672601004,1081
10568,3520553959,3204149913,1672676736,1672678488,1752
11038,3791628195,3663902064,1672587615,1672588289,674
9945,3701041860,3817478012,1672550315,1672553569,3254
11134,3927805949,3446066492,1672649556,1672651450,1894
11610,3505007498,3715844082,1672683244,1672684087,843
10480,3342056927,3910049345,1672641276,1672644090,2814
11028,3488749569,3513186578,1672616203,1672618553,2350
10155,3908550561,3206241691,1672678365,1672681448,3083
11503,3925823748,3444453261,1672675140,1672678155,3015
11292,3811629200,3400545490,1672549414,1672552897,3483
11347,3735422623,3716733618,1672667341,1672670814,3473
11198,3627358016,3380444321,1672616179,1672616888,709
11372,3515577866,3520339198,1672548196,1672549007,811
9987,3444646562,3534626053,1672659333,1672661352,2019
9890,3303747093,3518989186,1672582812,1672584359,1547
11100,3701663839,3514801709,1672571889,1672573885,1996
11662,3505183641,3373677765,1672648336,1672650848,2512
9962,3739820448,3513840186,1672699673,1672702667,2994
11541,3922301238,3516815069,1672664580,1672668000,3420
11429,3701841013,3716669659,1672666085,1672669269,3184
10523,3618672178,3511640720,1672628129,1672630097,1968
11097,3715111016,3505173665,1672541167,1672542574,1407
11456,3375324190,3378534521,1672699677,1672700653,976
10828,3938129916,3818236682,1672643250,1672646241,2991
11123,3757584114,3500640854,1672668271,1672670072,1801
11711,3509274030,3760232135,1672639348,1672641193,1845
11686,3519465545,3559759778,1672608263,1672608476,213
9988,3732440502,3683514731,1672616508,1672619851,3343
11217,3227206772,3551972633,1672638250,1672639756,1506
11118,3511341866,3625779003,1672620094,1672620962,868
11518,3638018906,3777552831,1672580196,1672581334,1138
9894,3443191792,3638126174,1672567088,1672568089,1001
10285,3793364952,3780749789,1672664222,1672665149,927
11477,3511476353,3888523259,1672644585,1672645857,1272
10303,3791796190,3774706478,1672536553,1672539971,3418
11095,3615245840,3811351746,1672551980,1672553018,1038
11026,3469780362,3777706200,1672652736,1672655385,2649
11152,3714595459,3517756624,1672538290,1672539055,765
11271,3973582279,3297684667,1672672375,1672675858,3483
11589,3903115138,3402338011,1672568258,1672570064,1806
10966,3534190196,3783373085,1672625428,1672628091,2663
11516,3505665788,3713996094,1672615594,1672618846,3252
11615,3534362749,3774744663,1672678459,1672681726,3267
9841,3429587594,3715261950,1672684903,1672685581,678
10309,3516867729,3791351852,1672544091,1672546507,2416
9855,3680832669,3438818153,1672637277,1672640474,3197
10397,3714453773,3505697295,1672637424,1672640552,3128
10966,3783443095,3884458862,1672649610,1672652392,2782
11579,3294821709,3514853709,1672626646,1672629319,2673
11688,3779609338,3757407184,1672653067,1672653913,846
11259,3615846003,3778402454,1672646225,1672646500,275
10896,3351949206,3713107380,1672620775,1672624326,3551
11045,3776124041,3760966645,1672670578,1672673217,2639
11393,3715114417,3600699873,1672552719,1672555373,2654
11174,3501370430,3639926564,1672538731,1672541603,2872
11432,3776291254,3772114731,1672632996,1672635847,2851
10657,3839744168,3820280594,1672645517,1672645689,172
10974,3209958726,3776316903,1672660520,1672662556,2036
11136,3505117019,3776600696,1672648588,1672649412,824
9794,3485521840,3510968599,1672635485,1672637243,1758
9998,3801501384,3495427619,1672693037,1672696313,3276
10527,3793860209,3495637721,1672569463,1672571153,1690
11788,3278430820,3505482210,1672539099,1672542243,3144
9815,3228465044,3516867729,1672551103,1672551402,299
10244,3224053840,3757198930,1672551147,1672552830,1683
10876,3339478490,3928421417,1672697403,1672700503,3100
10555,3519848902,3229465607,1672557910,1672559611,1701
11415,3311331205,3309528048,1672597174,1672598454,1280
10381,3247075753,3389069291,1672668720,1672668933,213
9977,3516167000,3778702093,1672574332,1672574550,218
11054,3885545415,3510758718,1672632397,1672633596,1199
11321,3774939922,3713621169,1672637411,1672640794,3383
10786,3520057139,3715039960,1672609407,1672612557,3150
10029,3519351747,3500438542,1672683199,1672685587,2388
10776,3607583720,3354405535,1672596342,1672599239,2897
10454,3278443807,3468343480,1672676154,1672679127,2973
11230,3512638952,3309415277,1672627591,1672629565,1974
11749,3337903727,3703732445,1672675214,1672675925,711
11767,3485898181,3778370462,1672591302,1672593641,2339
9870,3512638952,3710819760,1672563081,1672566572,3491
11388,3774627091,3616242727,1672604029,1672604943,914
11252,3515681585,3501370430,1672595453,1672597170,1717
10608,3416105769,3880882684,1672546477,1672547036,559
10860,3616403486,3312959324,1672612362,1672614634,2272
10156,3272096922,3627377299,1672690555,1672692603,2048
10871,3783935976,3516026189,1672640266,1672640569,303
10267,3515378306,3505183641,1672635705,1672637638,1933
10967,3512072679,3501205057,1672703421,1672703488,67
9841,3417223898,3287094447,1672587591,1672587863,272
11538,3500073824,3778924002,1672652035,1672655507,3472
10590,3439045964,3710149975,1672694079,1672694989,910
11482,3454343398,3533113740,1672625081,1672626712,1631
11539,3441683673,3516167000,1672634129,1672635660,1531
10633,3791664049,3802101760,1672642073,1672642253,180
11154,3701377471,3804095239,1672677111,1672679683,2572
10273,3779604279,3516827471,1672657245,1672657364,119
11510,3660496328,3755175497,1672634919,1672637893,2974
9924,3915035136,3406132280,1672546452,1672546601,149
10691,3366961580,3829412384,1672652236,1672655350,3114
11767,3715291931,3686853863,1672564578,1672566662,2084
9823,3835262447,3667950469,1672584692,1672586692,2000
10423,3534988162,3512826895,1672617042,1672618388,1346
11383,3635599307,3517469005,1672601312,1672604900,3588
10160,3299052917,3778124514,1672653936,1672654139,203
9811,3408408584,3517021928,1672658062,1672658917,855
11657,3364286028,3783594246,1672602494,1672604829,2335
11612,3884458862,3442403264,1672630115,1672632950,2835
10675,3423217578,3774589551,1672603107,1672605042,1935
11036,3774109138,3710585241,1672616581,1672619847,3266
10937,3510335069,3829358750,1672664827,1672666185,1358
11206,3511663572,3440770466,1672579547,1672582223,2676
10630,3793822639,3516572212,1672618842,1672620004,1162
9928,3349573092,3359351267,1672620746,1672623824,3078
10476,3272838634,3779415433,1672588739,1672590993,2254
10870,3516444589,3760748418,1672632054,1672634577,2523
10701,3516034245,3813276198,1672580931,1672581157,226
10487,3979366845,3534190196,1672556282,1672558034,1752
10433,3757823215,3755924094,1672545342,1672547313,1971
10670,3937854073,3501137133,1672650403,1672650682,279
9853,3306475287,3711718368,1672599673,1672600239,566
11188,3287920864,3731644240,1672613105,1672615363,2258
11359,3353335252,3509912164,1672676947,1672677510,563
10349,3900540310,3515284733,1672590750,1672594010,3260
10208,3273242177,3902682060,1672650383,1672652629,2246
10361,3613781977,3413799143,1672537800,1672541344,3544
10906,3757713457,3505811269,1672647115,1672648065,950
10749,3909457959,3444598583,1672557773,1672560972,3199
11402,3793934396,3487779363,1672672455,1672674623,2168
11702,3478052226,3485151614,1672549206,1672551894,2688
11477,3778838936,3486509752,1672640717,1672643852,3135
9934,3247193800,3534770827,1672626335,1672627246,911
10568,3701685828,3516588277,1672661993,1672663885,1892
10855,3780626668,3837271330,1672615247,1672617208,1961
10634,3773579644,3499711458,1672645470,1672646525,1055
10871,3756536512,3454554552,1672592685,1672594241,1556
11722,3227206772,3938129916,1672633905,1672634122,217
10998,3432838598,3400545490,1672690032,1672692980,2948
10621,3793375825,3512371853,1672675287,1672677755,2468
10787,3519108639,3736010012,1672686078,1672688530,2452
11338,3770019143,3756345026,1672587721,1672591311,3590
11546,3456795601,3701971784,1672531203,1672533657,2454
10913,3510758718,3791548838,1672590633,1672590782,149
10626,3600302127,3936851114,1672541023,1672544544,3521
10570,3505500665,3776841808,1672586602,1672590122,3520
10170,3479207976,3483347530,1672675416,1672676973,1557
10429,3733423371,3415840750,1672700974,1672701295,321
10448,3410602007,3231153513,1672609236,1672612116,2880
10201,3703938162,3505531432,1672550541,1672553249,2708
10119,3773688906,3772869013,1672610315,1672611120,805
10183,3757713457,3347172556,1672670110,1672671616,1506
10660,3519228207,3417360319,1672636372,1672639819,3447
10926,3206377955,3776348451,1672607974,1672608629,655
11254,3513215373,3779975575,1672675130,1672676006,876
10907,3520012007,3284374600,1672688438,1672689891,1453
9848,3500145103,3334482021,1672556881,1672558130,1249
11085,3701567668,3238310644,1672668992,1672669852,860
10050,3887502536,3273771395,1672619889,1672622318,2429
10383,3518205307,3459799131,1672550252,1672552520,2268
9996,3520470646,3481365330,1672553144,1672554940,1796
11338,3853386575,3613216900,1672612106,1672613494,1388
10856,3311739926,3330238204,1672703895,1672706122,2227
10395,3811351746,3292050211,1672651768,1672655331,3563
10102,3903088144,3906075386,1672553202,1672556079,2877
10147,3341432459,3609103278,1672602042,1672605072,3030
10937,3428878402,3203172170,1672612372,1672615456,3084
10234,3701284535,3533960602,1672562516,1672564954,2438
10555,3701004302,3337715675,1672690931,1672691954,1023
10276,3518368900,3820422111,1672557836,1672561154,3318
11605,3713416756,3236254381,1672669418,1672672163,2745
10318,3369558911,3662307789,1672665391,1672665623,232
10149,3662055682,3206241691,1672694256,1672696516,2260
10754,3201419050,3355880028,1672617139,1672617265,126
10400,3505245692,3510775046,1672555064,1672557689,2625
10945,3201573194,3916656185,1672688830,1672691418,2588
11335,3226761201,3282240901,1672694705,1672697922,3217
10719,3203172170,3518478484,1672656366,1672659727,3361
11133,3376487118,3667814788,1672667320,1672668114,794
11339,3779609338,3610723722,1672667164,1672668900,1736
10097,3711219767,3774589551,1672568595,1672569102,507
10712,3780168985,3760096466,1672681006,1672681696,690
11170,3509828883,3533830748,1672587527,1672589181,1654
10340,3511729562,3807800457,1672664939,1672665385,446
10810,3805704844,3730115019,1672601589,1672602439,850
11673,3739820448,3780142207,1672639190,1672640091,901
11121,3688410383,3492350318,1672655185,1672658333,3148
11397,3284334297,3209075485,1672612553,1672614039,1486
10687,3774273260,3505502819,1672672966,1672673618,652
10764,3818904268,3624365837,1672590294,1672592300,2006
11010,3716733618,3614112171,1672616880,1672620299,3419
11276,3779427180,3714688409,1672663899,1672664093,194
10313,3701668745,3474879231,1672635542,1672637741,2199
9852,3906693728,3495427619,1672648325,1672649359,1034
10533,3337715675,3247075753,1672568510,1672570105,1595
10214,3730169449,3757501067,1672696358,1672697348,990
10972,3774316305,3716195780,1672563154,1672563500,346
11321,3777112124,3272838634,1672647199,1672649572,2373
11579,3468201976,3500015630,1672593321,1672596183,2862
10035,3776561263,3912878303,1672647681,1672650169,2488
10928,3939851140,3519165527,1672569216,1672571972,2756
10080,3501988762,3780612543,1672554798,1672556899,2101
9821,3893932944,3688768189,1672580968,1672581177,209
10746,3701028092,3739844610,1672661374,1672662428,1054
10196,3606688595,3241855333,1672550223,1672553568,3345
11318,3378172464,3408408584,1672553223,1672556175,2952
11240,3245501577,3517617472,1672614454,1672614926,472
10086,3417268745,3509186338,1672701195,1672702647,1452
11626,3662821438,3247845642,1672576128,1672576343,215
11070,3438470128,3736987749,1672606549,1672607868,1319
11786,3500674240,3660702754,1672664507,1672666439,1932
10311,3437934509,3364302157,1672628386,1672630972,2586
11762,3710296607,3714838100,1672650781,1672654050,3269
11189,3772055279,3511794841,1672570171,1672572572,2401
10732,3906260966,3780013266,1672620753,1672622812,2059
10320,3391854325,3534624672,1672598073,1672598143,70
9859,3367299721,3773848111,1672697668,1672698595,927
11749,3516444589,3791106473,1672607221,1672607521,300
11394,3711852131,3517816581,1672604270,1672604670,400
10813,3716994924,3777931341,1672701336,1672701446,110
11661,3533201269,3534531039,1672612848,1672613667,819
11474,3452024572,3520344592,1672670778,1672670843,65
11203,3770023722,3512411326,1672582372,1672582860,488
10853,3481700413,3513624915,1672693344,1672695677,2333
9970,3757773786,3203954795,1672634184,1672636681,2497
10921,3756113624,3730052916,1672629897,1672632339,2442
10334,3500105301,3342252701,1672700774,1672704000,3226
10618,3757796416,3516340010,1672569036,1672569774,738
9814,3406169279,3433189219,1672554464,1672557172,2708
11732,3899756737,3468201976,1672604643,1672605381,738
10785,3601063076,3487622510,1672635781,1672637326,1545
9988,3772882440,3884180202,1672565141,1672567668,2527
10093,3600978954,3519034304,1672685188,1672687204,2016
11635,3533225084,3274894848,1672697474,1672697736,262
10391,3711810268,3511286390,1672689409,1672691036,1627
9994,3853386575,3780287649,1672535607,1672536114,507
11597,3792627762,3516444589,1672542436,1672543953,1517
10270,3422460919,3246296769,1672688596,1672691342,2746
11066,3311410533,3774822697,1672574899,1672576429,1530
11246,3897851509,3435652260,1672555506,1672556578,1072
10756,3770631449,3713283029,1672632708,1672634431,1723
10716,3485521840,3510819040,1672580606,1672582460,1854
10253,3505811269,3793704155,1672646739,1672648622,1883
10274,3773394570,3372596013,1672540148,1672542149,2001
10367,3819024145,3772216305,1672631141,1672632489,1348
10011,3534102440,3391612879,1672537790,1672541161,3371
9975,3710316008,3443521234,1672566305,1672568209,1904
9999,3207586072,3703206956,1672615042,1672617682,2640
11265,3713102459,3235373942,1672668473,1672669491,1018
11773,3932955949,3757064623,1672652793,1672655449,2656
11165,3814378625,3298113026,1672620387,1672620964,577
10230,3505155858,3770564547,1672658984,1672662537,3553
10171,3779561601,3519356606,1672577611,1672578982,1371
11283,3307535495,3792289287,1672700680,1672702706,2026
11608,3780563627,3519297683,1672624104,1672624268,164
10467,3774448657,3435342362,1672694105,1672694274,169
11093,3778909412,3276231633,1672681339,1672683696,2357
10897,3534624672,3713107380,1672554285,1672557394,3109
11480,3778195766,3756948477,1672634800,1672636964,2164
9893,3292050211,3613940925,1672603031,1672604972,1941
10916,3500405175,3311432176,1672703532,1672704023,491
11620,3757064623,3512638952,1672625652,1672627829,2177
10519,3500421940,3283785820,1672614867,1672616606,1739
9870,3804095239,3804840997,1672633743,1672636923,3180
11753,3710397477,3977337501,1672673443,1672674894,1451
11017,3452389513,3514244308,1672548265,1672550386,2121
10217,3333355914,3730052916,1672581635,1672583568,1933
11380,3711718368,3711518637,1672554566,1672556010,1444
11717,3276230295,3416474842,1672702175,1672705112,2937
9817,3773878451,3776407517,1672618582,1672621537,2955
10919,3500693568,3779478448,1672697329,1672697738,409
11568,3509470194,3912625932,1672555158,1672556840,1682
10941,3825526565,3661543201,1672636113,1672637375,1262
10547,3533037906,3403120725,1672587355,1672590357,3002
10825,3777641081,3805718871,1672544940,1672546052,1112
11735,3756428507,3713636175,1672542697,1672544671,1974
10065,3339478490,3443521234,1672543654,1672545601,1947
10464,3495427619,3884388188,1672540752,1672542581,1829
10482,3449672240,3836586875,1672600853,1672602224,1371
9962,3791332061,3780626668,1672664212,1672665510,1298
10599,3510189563,3666367524,1672690791,1672693722,2931
11572,3285587972,3703737650,1672686326,1672688898,2572
9842,3278071998,3515984911,1672651076,1672651647,571
10990,3791509881,3776125503,1672675095,1672678179,3084
11206,3517766135,3362368123,1672591418,1672592952,1534
10953,3201634072,3505560793,1672691909,1672692467,558
10414,3342545285,3821087562,1672681224,1672682590,1366
10661,3239423794,3342027511,1672674804,1672675476,672
10633,3500317923,3730052916,1672699314,1672699781,467
11141,3884192843,3428325402,1672596425,1672597264,839
10593,3812261241,3756843139,1672577350,1672577565,215
10133,3505291330,3739395381,1672629555,1672631747,2192
10113,3912862842,3421040626,1672601735,1672603741,2006
10525,3774921252,3669283586,1672669644,1672672483,2839
10774,3476431618,3634766042,1672541778,1672542297,519
10113,3783730769,3620105539,1672533784,1672535027,1243
10798,3898989233,3770564547,1672573738,1672574692,954
10312,3713514933,3756843139,1672607858,1672610165,2307
11496,3311959533,3736203662,1672593748,1672595995,2247
11031,3300238532,3285587972,1672612536,1672613230,694
9965,3505032644,3403870769,1672586508,1672587958,1450
9926,3512072679,3343859998,1672699470,1672700453,983
11759,3713547793,3465107990,1672542982,1672546252,3270
10838,3812516461,3773768643,1672656341,1672659167,2826
9897,3688410383,3275661834,1672623944,1672625880,1936
10814,3516815069,3514576083,1672665146,1672666395,1249
10304,3340897079,3515470462,1672563402,1672564482,1080
11431,3424988692,3557528150,1672532959,1672535101,2142
10521,3222364320,3710228292,1672638197,1672638415,218
10865,3711176990,3505119470,1672633475,1672634542,1067
10406,3314363575,3352057037,1672572796,1672573107,311
11145,3820280594,3825526565,1672656632,1672659744,3112
11527,3760416450,3770019143,1672595248,1672596115,867
11147,3425646356,3516359146,1672625783,1672626959,1176
9819,3517045396,3205113625,1672595299,1672598791,3492
9923,3514576083,3466620548,1672624865,1672626124,1259
11400,3534941710,3520057139,1672638197,1672640446,2249
10966,3714074120,3890211161,1672572543,1672573271,728
11681,3777387533,3510775046,1672665762,1672668111,2349
10860,3447312353,3880637958,1672551584,1672552576,992
9803,3362127525,3774401596,1672542403,1672544817,2414
10034,3832745283,3710865678,1672639844,1672642926,3082
11199,3440401725,3934991640,1672583816,1672584686,870
10766,3423147369,3667950469,1672562464,1672565618,3154
11126,3519108639,3509457543,1672648069,1672648244,175
10890,3554174421,3491239350,1672610314,1672610744,430
11374,3778741325,3737050849,1672594330,1672595849,1519
11786,3773579644,3825234433,1672554275,1672557114,2839
10633,3513850048,3245774173,1672554917,1672557823,2906
11206,3513850048,3509073025,1672566983,1672567327,344
10439,3424997707,3835982340,1672580286,1672581274,988
10773,3375324190,3228465044,1672660964,1672663920,2956
11377,3776125503,3930475498,1672649268,1672651233,1965
11685,3513800589,3778817220,1672536710,1672537788,1078
10655,3385124073,3883640904,1672661707,1672663798,2091
10444,3558567160,3513171472,1672615114,1672616188,1074
10980,3739395381,3837378340,1672557846,1672558778,932
11500,3520832066,3447267291,1672686106,1672687062,956
10741,3774921252,3757513651,1672538755,1672541890,3135
11344,3371497614,3780423516,1672551687,1672554291,2604
11264,3458130310,3275171954,1672541855,1672545374,3519
9929,3711810268,3517440258,1672692791,1672694069,1278
10612,3617135064,3287094447,1672698064,1672700454,2390
10182,3495446254,3519937708,1672538192,1672541246,3054
10441,3395565040,3888409038,1672600770,1672602010,1240
10049,3832333115,3909067335,1672542765,1672545074,2309
11711,3793860209,3203172170,1672672338,1672674382,2044
11503,3509614126,3716460706,1672619624,1672622661,3037
10663,3447202943,3509556649,1672591640,1672594599,2959
11085,3519351747,3911431642,1672693163,1672695419,2256
10449,3449672240,3228997424,1672534802,1672536746,1944
11673,3556684272,3235578121,1672588384,1672589012,628
11579,3500455935,3500104976,1672568790,1672570058,1268
10210,3716733618,3374147279,1672569393,1672571987,2594
11636,3715204544,3791644831,1672660093,1672663321,3228
10745,3422915648,3358262975,1672642786,1672644986,2200
10366,3296970170,3200785194,1672616194,1672619171,2977
11419,3778731000,3780786276,1672641499,1672642950,1451
10357,3791194984,3737946004,1672668852,1672670270,1418
10169,3467944159,3852014884,1672659466,1672661175,1709
11282,3512784888,3233917789,1672585226,1672587711,2485
10240,3711404205,3500654356,1672562586,1672565357,2771
11389,3778182724,3406101720,1672586840,1672589958,3118
10634,3516706121,3204149913,1672645274,1672645724,450
10121,3639503148,3737745988,1672624183,1672625053,870
11193,3382696725,3505155858,1672627891,1672630169,2278
11538,3792597493,3513111053,1672543323,1672546157,2834
11705,3533929043,3534531039,1672695402,1672697178,1776
10420,3444397804,3815184540,1672599740,1672600070,330
11083,3828354855,3812277991,1672547122,1672548178,1056
11411,3438028077,3397783490,1672655511,1672656822,1311
11205,3703277359,3792900315,1672686482,1672687589,1107
11182,3859191694,3791547827,1672596332,1672599844,3512
10758,3714453773,3334482021,1672570805,1672570948,143
11477,3777686966,3774682234,1672621373,1672621716,343
11634,3755465396,3307521389,1672551736,1672553836,2100
10992,3452104161,3406937294,1672638162,1672638586,424
11635,3774447975,3703697059,1672687315,1672688790,1475
10251,3783826338,3732223664,1672668713,1672669544,831
10518,3513384042,3760420315,1672595501,1672598047,2546
9978,3756759239,3715246385,1672680819,1672680960,141
11046,3513764665,3375906394,1672621533,1672624003,2470
10863,3776581518,3293540333,1672667034,1672669050,2016
11017,3834424604,3770533588,1672552745,1672553069,324
10938,3509360869,3855077502,1672686644,1672687878,1234
11229,3760554453,3936851114,1672646906,1672647398,492
10094,3757446082,3337903727,1672596747,1672598674,1927
10081,3352057037,3779815753,1672649413,1672651392,1979
11442,3361865467,3894328297,1672577486,1672579874,2388
11667,3407734098,3513508737,1672557514,1672557774,260
10668,3501901313,3710125627,1672545074,1672546560,1486
10945,3792162098,3247545468,1672602463,1672605340,2877
11530,3516067011,3760979523,1672541176,1672542304,1128
10013,3663353552,3300238532,1672682386,1672683094,708
10160,3854957153,3455907179,1672636856,1672638424,1568
10803,3757678397,3716467469,1672702881,1672706077,3196
10181,3519521903,3555215568,1672645308,1672647069,1761
10339,3371238318,3534869444,1672650673,1672652487,1814
11288,3509614126,3462645981,1672681810,1672684064,2254
10442,3557129226,3780969898,1672611413,1672613471,2058
10597,3393001196,3514853709,1672532526,1672535533,3007
11270,3715261950,3533593766,1672581141,1672581578,437
11060,3357026115,3433196933,1672544038,1672546908,2870
10664,3710529628,3773876312,1672697933,1672698759,826
11554,3611533094,3434581257,1672703356,1672706279,2923
10124,3500145103,3711518637,1672599470,1672601071,1601
11188,3783809405,3291936679,1672674393,1672676211,1818
11185,3490804766,3882580580,1672696923,1672700195,3272
11596,3311810583,3760096466,1672591010,1672594355,3345
10887,3312800145,3337715675,1672600442,1672601858,1416
10747,3236563828,3900766525,1672672504,1672674240,1736
11000,3509431396,3701887470,1672606187,1672608395,2208
9980,3517021928,3914353062,1672661797,1672663434,1637
9867,3627081426,3756157377,1672641054,1672642826,1772
11117,3427049290,3361926328,1672692177,1672694219,2042
10279,3912915644,3474879231,1672692897,1672695143,2246
11250,3735422623,3711718368,1672552802,1672553657,855
11107,3305612422,3476144563,1672543256,1672545431,2175
9907,3291446384,3772250554,1672695925,1672697606,1681
10931,3225356349,3512306195,1672619578,1672620525,947
10021,3755129708,3501126057,1672566121,1672567180,1059
10322,3425260097,3455955489,1672546664,1672547647,983
11003,3777564559,3501515425,1672668452,1672671972,3520
10686,3703502114,3436018575,1672587209,1672587871,662
11043,3770424892,3385416697,1672595288,1672595509,221
10106,3518794921,3339331632,1672573495,1672576195,2700
10328,3780969898,3291617477,1672652494,1672655058,2564
10805,3711404205,3294326116,1672643473,1672645349,1876
9873,3378172464,3755342153,1672623688,1672623884,196
10398,3271780525,3350631472,1672610156,1672613259,3103
9824,3246971044,3911821258,1672582933,1672585054,2121
10059,3756759239,3772962072,1672559136,1672561584,2448
11606,3791368349,3896200048,1672674114,1672675991,1877
10483,3330318282,3777041132,1672665099,1672666487,1388
10325,3970775805,3770497768,1672592032,1672592596,564
11324,3239082508,3899903158,1672573377,1672575098,1721
11648,3783430498,3338016147,1672604063,1672607167,3104
10848,3555215568,3311142523,1672558921,1672561953,3032
10029,3465107990,3357074700,1672562031,1672564569,2538
11730,3779382417,3736987749,1672561389,1672562905,1516
10154,3415803494,3505011956,1672578558,1672578648,90
11232,3639503148,3403257752,1672687071,1672688966,1895
10744,3929355087,3274341934,1672668630,1672671810,3180
10386,3513140146,3701655378,1672554618,1672555828,1210
10272,3701978422,3756998113,1672669401,1672671204,1803
10800,3791509334,3711889178,1672701853,1672704260,2407
10443,3240683148,3792411831,1672556825,1672558600,1775
10062,3519621901,3246395239,1672639021,1672640109,1088
10121,3776319560,3368079099,1672680509,1672683055,2546
10336,3757855416,3516792348,1672587628,1672588796,1168
10657,3515753241,3714516404,1672631769,1672632700,931
10654,3819400315,3755342153,1672680960,1672683653,2693
11620,3773826624,3432838598,1672591933,1672593908,1975
11119,3770018912,3410788026,1672685948,1672689148,3200
11579,3491250381,3519831322,1672657948,1672660759,2811
11616,3716676869,3897003751,1672541611,1672544426,2815
10454,3445896667,3701769970,1672602090,1672605530,3440
11623,3730414796,3783277159,1672636265,1672638413,2148
10933,3394364348,3509297453,1672650407,1672653418,3011
10437,3221126799,3516019206,1672574365,1672574660,295
10534,3732128078,3970775805,1672582210,1672584568,2358
10078,3772164469,3308481706,1672623121,1672625059,1938
10498,3760385591,3370245766,1672688864,1672692049,3185
10370,3770846374,3377311502,1672600461,1672601743,1282
10145,3517426473,3760529327,1672597288,1672599620,2332
11076,3602570831,3817315443,1672540852,1672542324,1472
11433,3793948300,3429047448,1672538214,1672541005,2791
11333,3484483775,3409078869,1672534146,1672534521,375
10298,3442073613,3822368676,1672703882,1672706210,2328
10003,3379666159,3405200303,1672634869,1672635700,831
11248,3680832669,3500317923,1672693384,1672694697,1313
10306,3774273260,3505709407,1672626134,1672629033,2899
9966,3308965136,3443191792,1672656166,1672658136,1970
11738,3485151614,3393001196,1672620700,1672623973,3273
10242,3357496255,3779930476,1672591703,1672593298,1595
11258,3779102237,3514673213,1672535446,1672536480,1034
10371,3275057862,3222357355,1672684546,1672684741,195
11030,3976400190,3311159418,1672538344,1672539446,1102
10684,3406238754,3606804618,1672544832,1672546138,1306
11474,3912878303,3756876537,1672562064,1672564229,2165
10156,3607288879,3380218091,1672661369,1672662118,749
10230,3518376262,3509626590,1672647802,1672649642,1840
11663,3773411968,3793407883,1672702054,1672704082,2028
10387,3513840186,3713107380,1672660540,1672661858,1318
10603,3703779674,3904184638,1672632953,1672636139,3186
10772,3778819352,3779951373,1672613915,1672615932,2017
10437,3756149282,3221290808,1672623726,1672626344,2618
11692,3773432494,3510484107,1672624037,1672625779,1742
11065,3808442442,3755394177,1672619161,1672621661,2500
11755,3236360179,3516586325,1672666315,1672668875,2560
11304,3534491112,3714264759,1672568571,1672569786,1215
11515,3483078667,3660176760,1672533700,1672536008,2308
10803,3779665641,3505547832,1672660844,1672661026,182
10549,3533628528,3773697080,1672608628,1672608815,187
11505,3418791124,3713990030,1672561606,1672563083,1477
10776,3977337501,3501548163,1672542538,1672542816,278
10141,3609997804,3689223632,1672587574,1672587761,187
11193,3888057649,3516472352,1672692114,1672695177,3063
11757,3515558215,3783021859,1672671920,1672672357,437
10724,3358473096,3490953301,1672558719,1672559634,915
11013,3440743218,3338195686,1672582332,1672584928,2596
10040,3295530454,3858497718,1672552256,1672553676,1420
10246,3520824937,3755670258,1672623143,1672624548,1405
10068,3614112171,3711947828,1672575829,1672578133,2304
11210,3757604311,3830254808,1672659377,1672662941,3564
10178,3515558215,3517021928,1672687168,1672687510,342
10628,3283295213,3501963428,1672588622,1672588753,131
11130,3924963918,3908883591,1672665060,1672665612,552
9914,3701668745,3853182912,1672588162,1672590229,2067
11145,3778986795,3919994216,1672533891,1672535804,1913
10067,3906693728,3910354786,1672667744,1672668542,798
11333,3783967375,3715419141,1672658849,1672659610,761
10758,3439283360,3496591885,1672581534,1672583382,1848
10122,3716183063,3772235668,1672702956,1672704411,1455
11755,3773798215,3701779683,1672584103,1672587582,3479
10421,3971447562,3387413950,1672576724,1672579995,3271
10338,3609335008,3791088014,1672658197,1672658947,750
9860,3505248368,3791435852,1672649152,1672652009,2857
10497,3423782420,3512395783,1672672856,1672673311,455
11157,3558264627,3204821370,1672666246,1672669680,3434
11342,3772234939,3553008208,1672580531,1672582254,1723
10297,3791617239,3336501403,1672666503,1672669971,3468
11604,3239779992,3367299721,1672633854,1672635250,1396
11097,3303747093,3278779955,1672532795,1672533961,1166
10275,3770441717,3819315404,1672573479,1672575654,2175
11106,3912625932,3806471413,1672577433,1672581016,3583
11532,3511078598,3516321814,1672599109,1672600926,1817
11009,3555215568,3820280594,1672666917,1672667007,90
10610,3814672661,3783157469,1672595046,1672596107,1061
10792,3349475873,3760979523,1672547102,1672550521,3419
11082,3301332095,3711065081,1672701297,1672701721,424
11636,3514007122,3620836520,1672669564,1672672301,2737
11212,3498803823,3446233783,1672602541,1672603010,469
10921,3344778261,3488333295,1672614539,1672617394,2855
10701,3519908593,3895944547,1672673349,1672675621,2272
10693,3387989658,3341985886,1672630126,1672633165,3039
10205,3208894215,3515047288,1672624713,1672625175,462
11779,3713566527,3701675183,1672671816,1672675395,3579
10100,3686644062,3922786716,1672662817,1672662963,146
10434,3275735969,3300810210,1672555810,1672556372,562
10154,3203630241,3631444265,1672545804,1672549272,3468
11038,3714179543,3515655024,1672538298,1672538811,513
11218,3516429380,3510939082,1672668934,1672671982,3048
11447,3773017746,3509470194,1672605217,1672606748,1531
11771,3710397477,3734233216,1672544855,1672545571,716
10136,3534604516,3421524698,1672683353,1672683867,514
10723,3827836825,3512697456,1672667964,1672669204,1240
11613,3513800589,3701311947,1672681234,1672681344,110
10220,3612705426,3711770773,1672644504,1672646400,1896
11180,3517448452,3206853747,1672587679,1672589581,1902
11050,3388937390,3791542842,1672632807,1672635393,2586
10655,3495446254,3370448531,1672594290,1672595970,1680
11121,3408828584,3247075753,1672540074,1672541675,1601
10619,3857244486,3484483775,1672668292,1672671154,2862
11178,3814289471,3368848936,1672567902,1672570212,2310
11598,3505011956,3792075871,1672686576,1672689424,2848
10384,3701311947,3534284132,1672661969,1672662415,446
10260,3514515499,3780900318,1672597304,1672598515,1211
11281,3472018395,3685877449,1672672570,1672675137,2567
11322,3701655378,3337673625,1672541594,1672544378,2784
11259,3903065952,3449020351,1672697432,1672699219,1787
11449,3714377201,3365839890,1672589044,1672590339,1295
10028,3393955069,3973138649,1672664035,1672664894,859
9993,3534362749,3701841013,1672607185,1672610154,2969
11437,3501004005,3437108337,1672618810,1672620439,1629
11784,3516167000,3440743218,1672643641,1672645028,1387
11347,3520395850,3773826624,1672647547,1672650398,2851
10120,3446764595,3299743638,1672685722,1672687412,1690
10092,3822496670,3516517348,1672621548,1672621646,98
9868,3730935770,3770012744,1672587042,1672588971,1929
10730,3489340327,3906693728,1672578211,1672578583,372
10708,3924366353,3534696810,1672639790,1672641692,1902
11278,3773798215,3357496255,1672599931,1672601289,1358
11267,3930475498,3519174861,1672627757,1672629174,1417
10754,3277634944,3358530225,1672686888,1672687268,380
10480,3489212992,3512750313,1672697761,1672699697,1936
10361,3780941637,3336501403,1672603218,1672603887,669
10828,3703443664,3514585995,1672549970,1672550902,932
9845,3224053074,3515699732,1672699916,1672703216,3300
10484,3701865589,3817029483,1672689118,1672691395,2277
9960,3792267993,3432050858,1672689983,1672692178,2195
10668,3680939042,3517136772,1672584564,1672587291,2727
10867,3275975921,3515944817,1672685041,1672686963,1922
11247,3388537708,3818324410,1672541352,1672543481,2129
11317,3684199077,3511296895,1672596842,1672597328,486
10876,3514353133,3513586642,1672658521,1672661480,2959
10576,3899156705,3934564437,1672577634,1672578757,1123
11338,3977880564,3365519448,1672535690,1672535993,303
10150,3454343398,3908883591,1672684281,1672685544,1263
10872,3904184638,3519108639,1672635220,1672636312,1092
11021,3638823001,3780941637,1672608392,1672608877,485
11303,3812277991,3791688526,1672575241,1672577235,1994
11278,3710585241,3368441333,1672537414,1672538480,1066
11621,3777564559,3501873139,1672637266,1672639388,2122
10755,3447696555,3755849241,1672670115,1672670389,274
10451,3304447950,3500073824,1672601898,1672604116,2218
10845,3915035136,3939882169,1672571963,1672572368,405
9874,3516359146,3510240661,1672564121,1672567364,3243
10707,3520515739,3793978936,1672603389,1672603669,280
10120,3515753241,3304447950,1672621429,1672624768,3339
11273,3403150349,3297684667,1672681175,1672683325,2150
11259,3500234771,3714377201,1672589277,1672591257,1980
10055,3619796619,3515607283,1672664695,1672668279,3584
10367,3303552616,3203909360,1672558613,1672560303,1690
11486,3715291931,3516535558,1672667982,1672671445,3463
11118,3836757034,3472561941,1672564423,1672566879,2456
11589,3233965781,3501927452,1672697874,1672698016,142
10599,3779815753,3209417223,1672667825,1672670007,2182
10911,3895507040,3896859936,1672651881,1672655288,3407
10076,3757639274,3757064623,1672639497,1672642141,2644
11355,3428198021,3510159441,1672588223,1672591806,3583
11683,3519463038,3756536512,1672698479,1672699133,654
10223,3514926921,3732596503,1672634672,1672635688,1016
9799,3772262649,3440401725,1672703818,1672707045,3227
11431,3226913558,3364683368,1672629959,1672630087,128
10767,3424425746,3509073025,1672588184,1672589515,1331
11459,3311515179,3714287902,1672647346,1672649694,2348
10839,3513293711,3238997746,1672626232,1672627397,1165
10904,3805616707,3518794921,1672532881,1672535397,2516
11245,3933562725,3791532324,1672681831,1672684794,2963
11450,3500031401,3901217668,1672649359,1672651800,2441
10404,3773953689,3922430928,1672623138,1672626634,3496
9908,3919994216,3357097510,1672655446,1672658719,3273
11373,3519046342,3534758256,1672697730,1672698776,1046
10130,3703423962,3437023385,1672550594,1672551614,1020
10600,3772695548,3832902787,1672586889,1672589685,2796
10678,3420881591,3774921252,1672599161,1672601098,1937
10146,3737946004,3770981604,1672601434,1672603294,1860
10489,3516257130,3390537737,1672692838,1672695075,2237
10001,3716118473,3224040894,1672630206,1672633667,3461
10394,3313795594,3933872044,1672689747,1672692332,2585
10183,3681274982,3534102440,1672584990,1672586471,1481
11193,3512857020,3510856388,1672541926,1672542385,459
11034,3756759239,3505839395,1672678429,1672680252,1823
10189,3449233346,3793332600,1672680013,1672680284,271
11291,3505786561,3713927376,1672550572,1672550914,342
10838,3515100211,3770709417,1672554047,1672554788,741
10950,3414510793,3208894215,1672571886,1672572052,166
10116,3778927933,3858497718,1672638561,1672642076,3515
9939,3417969824,3857590978,1672605809,1672609069,3260
10066,3330466913,3715196780,1672557613,1672559492,1879
11106,3480108752,3971282455,1672628002,1672629202,1200
11716,3509208005,3756168814,1672670510,1672671802,1292
10720,3773953689,3884388188,1672607043,1672609559,2516
10602,3896615831,3792930090,1672669331,1672670941,1610
10444,3905934770,3804075198,1672626211,1672628162,1951
10859,3932955949,3345896913,1672539686,1672541978,2292
10980,3783176874,3778838936,1672648492,1672651985,3493
10992,3665603628,3826997668,1672639746,1672640879,1133
11219,3701685828,3885422379,1672678753,1672680855,2102
11404,3371564186,3887382548,1672629935,1672633120,3185
11358,3444168914,3518931700,1672576908,1672578602,1694
11084,3711836873,3489212992,1672576728,1672579328,2600
10393,3429333292,3336501403,1672676111,1672679535,3424
11466,3732540636,3777992576,1672532363,1672533059,696
9930,3683562111,3533017131,1672536080,1672538272,2192
11706,3500473064,3475653510,1672579715,1672580712,997
10494,3388923880,3517440258,1672624941,1672625701,760
11316,3926065090,3755922811,1672680521,1672683216,2695
10801,3357496255,3715441786,1672679102,1672679504,402
10121,3809871495,3682906048,1672585575,1672586101,526
11540,3772343750,3279851026,1672595060,1672596874,1814
10315,3439532406,3779102237,1672622933,1672623217,284
10717,3406132280,3230612965,1672664349,1672665336,987
11388,3277634944,3793364952,1672613598,1672616349,2751
11084,3438028077,3665841655,1672564437,1672564638,201
11594,3802101760,3361635547,1672684120,1672686611,2491
11714,3716922925,3403870769,1672632084,1672633621,1537
10042,3513213122,3757030923,1672597129,1672599879,2750
11178,3387870683,3780298499,1672566543,1672567158,615
9866,3688870751,3756119976,1672569997,1672571663,1666
10181,3514341451,3792012147,1672683476,1672684812,1336
10423,3203909360,3309651238,1672642699,1672645513,2814
11359,3425260097,3534667712,1672549772,1672551709,1937
10800,3792719263,3666367524,1672703101,1672704309,1208
11577,3636605690,3429315500,1672696702,1672697455,753
11601,3934280144,3304028109,1672535048,1672537605,2557
10770,3685396470,3919258737,1672626353,1672628334,1981
10607,3783157469,3201634072,1672604020,1672606530,2510
11311,3710296607,3311904032,1672638632,1672639102,470
11146,3505685294,3755394177,1672593973,1672594757,784
10293,3500864577,3881012415,1672646806,1672647650,844
9910,3442564712,3835262447,1672617426,1672619915,2489
10414,3517021928,3491239350,1672572636,1672575780,3144
10204,3715490209,3732871856,1672702300,1672704994,2694
11637,3505547832,3636927297,1672664623,1672665332,709
11742,3387989658,3930766276,1672692801,1672695911,3110
10459,3516651799,3292663993,1672577451,1672579809,2358
10401,3380357490,3381055770,1672661721,1672663857,2136
10999,3780148144,3501873139,1672549897,1672553400,3503
10125,3783373085,3362368123,1672611510,1672613501,1991
11167,3356599815,3381254180,1672589584,1672592040,2456
10863,3776791436,3402105276,1672557460,1672558289,829
11230,3738160394,3909220912,1672639036,1672642363,3327
10196,3517800171,3615245840,1672555812,1672557553,1741
10673,3909504515,3447696555,1672571541,1672572667,1126
10225,3710807030,3756493561,1672543272,1672546409,3137
9811,3774029494,3926724515,1672656554,1672657348,794
10925,3227339675,3245774173,1672665920,1672666437,517
11157,3716341323,3207748225,1672559407,1672560425,1018
9932,3413236071,3773394570,1672542211,1672543780,1569
9962,3851737350,3770991234,1672549726,1672552500,2774
11012,3773085258,3972729768,1672677245,1672677875,630
10342,3337675386,3393909269,1672600622,1672603769,3147
9843,3755769731,3770846374,1672699351,1672702945,3594
11205,3669918958,3760385591,1672546197,1672547528,1331
10892,3496352027,3360837082,1672632244,1672632325,81
11151,3619494735,3500473064,1672668306,1672668915,609
11668,3367109648,3340321384,1672601400,1672602365,965
10736,3470997293,3505560793,1672637116,1672637630,514
10464,3930766276,3776468503,1672665662,1672666822,1160
10171,3755107521,3783357035,1672552303,1672552412,109
9936,3701004302,3519703964,1672573035,1672574971,1936
9824,3730115019,3780173788,1672702797,1672703497,700
10392,3904485393,3476431618,1672596429,1672598291,1862
11723,3534531061,3714074120,1672603243,1672606328,3085
10086,3238056215,3374652108,1672581566,1672584155,2589
11484,3701453343,3551833298,1672632978,1672634748,1770
9890,3453538201,3505266343,1672593445,1672594309,864
10400,3500974385,3517960157,1672628679,1672632181,3502
10397,3710852576,3760232135,1672643636,1672645101,1465
11238,3738760498,3404461403,1672598785,1672599762,977
11099,3500073824,3510209505,1672669547,1672672311,2764
9977,3519465545,3403150349,1672616536,1672619909,3373
11590,3755924094,3801501384,1672570265,1672570650,385
10470,3732467455,3710622746,1672673856,1672676421,2565
10000,3770480149,3779427180,1672565295,1672567613,2318
11370,3516463579,3378534521,1672634935,1672637155,2220
10864,3756079870,3491239350,1672586876,1672590191,3315
10769,3534068874,3246567963,1672560438,1672561542,1104
9898,3850005949,3885674996,1672537508,1672539648,2140
10844,3533929043,3317887374,1672597628,1672598928,1300
10963,3683514731,3300810210,1672677034,1672678962,1928
9934,3779778679,3513293711,1672604345,1672605485,1140
9803,3364718040,3824135033,1672671229,1672674267,3038
11355,3716982179,3613940925,1672651936,1672654931,2995
10005,3660163550,3939882169,1672681448,1672682490,1042
11547,3432050858,3821087562,1672640634,1672641528,894
11609,3405221863,3501550490,1672682826,1672683893,1067
10298,3298706213,3501657158,1672574394,1672574932,538
10395,3755361692,3406132280,1672568869,1672569557,688
10813,3711938229,3666367524,1672657478,1672659451,1973
11173,3803382101,3734233216,1672687799,1672690274,2475
10209,3772251279,3287403291,1672558452,1672558823,371
11252,3773024346,3405221863,1672595506,1672597007,1501
9894,3239423794,3511907179,1672547108,1672548034,926
10947,3814672661,3755175497,1672564812,1672567317,2505
10456,3910190872,3307535495,1672561501,1672561763,262
10673,3509508477,3888903181,1672674049,1672674607,558
11015,3514776568,3773768643,1672584392,1672586481,2089
10809,3435159896,3452677710,1672562512,1672563739,1227
10739,3292936094,3514564903,1672607824,1672610690,2866
11218,3520515739,3479910993,1672594996,1672596065,1069
10837,3516103646,3340321384,1672563441,1672566606,3165
11088,3716633983,3760420315,1672555699,1672557720,2021
10094,3490008012,3776053084,1672621492,1672624103,2611
10268,3710223875,3239401337,1672643592,1672645805,2213
10700,3418791124,3499820963,1672703068,1672705602,2534
11237,3534362749,3830962592,1672677075,1672677996,921
11189,3291936679,3336501403,1672548879,1672550159,1280
10481,3311924005,3275057862,1672599969,1672600790,821
11287,3701521510,3903115138,1672623926,1672624820,894
10847,3423217578,3756525103,1672651263,1672653327,2064
10457,3534459983,3501550490,1672537439,1672538069,630
10104,3915652382,3736036532,1672624614,1672625390,776
10049,3240877710,3500455935,1672533393,1672536452,3059
10659,3403150349,3423353911,1672623432,1672626461,3029
11491,3501988762,3470135167,1672599409,1672602100,2691
10212,3777290300,3370245766,1672667132,1672668460,1328
11020,3534696810,3289771213,1672580513,1672581005,492
10338,3918981936,3808849597,1672579679,1672580701,1022
10669,3793860209,3520763492,1672605836,1672607936,2100
11166,3477951091,3500785888,1672633418,1672634137,719
10133,3701127475,3894328297,1672593756,1672594162,406
9855,3236206821,3520160414,1672570374,1672573229,2855
9840,3792277399,3278805844,1672642232,1672645238,3006
10411,3494680853,3815184540,1672636252,1672639537,3285
10980,3688768189,3308965136,1672594069,1672596806,2737
10601,3513171472,3520339198,1672572993,1672573688,695
11632,3406169279,3496579251,1672686327,1672687759,1432
10736,3711131262,3899294071,1672657930,1672659152,1222
11129,3370245766,3669418238,1672568252,1672569822,1570
9980,3516429380,3513432588,1672606676,1672607456,780
10645,3934280144,3907390925,1672619751,1672621166,1415
11156,3620836520,3450234157,1672678001,1672680245,2244
10815,3396440259,3491250381,1672571022,1672571486,464
11027,3917467642,3390537737,1672577320,1672578509,1189
11284,3710695372,3380185102,1672621017,1672623907,2890
11566,3461741050,3509663119,1672638241,1672638564,323
10753,3514306458,3430823498,1672684280,1672684676,396
10382,3454554552,3776455762,1672585660,1672588819,3159
10128,3515577866,3558203963,1672564022,1672567018,2996
10501,3497732613,3440671139,1672606277,1672607553,1276
11109,3533037906,3756668747,1672641201,1672641392,191
10715,3623067708,3701512498,1672703047,1672703978,931
10160,3791236983,3493047640,1672651040,1672653960,2920
10961,3275171954,3285587972,1672650663,1672651299,636
10207,3899903158,3792851584,1672576961,1672577358,397
9861,3355880028,3534168768,1672658710,1672659825,1115
10378,3776348451,3466655775,1672593087,1672594239,1152
11004,3514216460,3246395239,1672686302,1672686882,580
11718,3427741923,3489340327,1672649236,1672650612,1376
10235,3500329674,3818236682,1672690549,1672693028,2479
10913,3430296808,3520012007,1672659684,1672660931,1247
11226,3497138014,3779130507,1672535554,1672536058,504
11451,3791974273,3755119166,1672610765,1672612447,1682
9994,3392482187,3711171132,1672668805,1672671705,2900
11756,3400903513,3209075485,1672673224,1672673964,740
11429,3208594306,3519255644,1672569167,1672570898,1731
11361,3422959249,3417268745,1672597765,1672598915,1150
11110,3534941710,3776122272,1672571730,1672574646,2916
11047,3249771731,3500105301,1672615466,1672617915,2449
10570,3235074007,3511640720,1672561425,1672563119,1694
9801,3475560058,3243056734,1672544175,1672547237,3062
10604,3500455935,3201656220,1672611515,1672613239,1724
10826,3500595432,3716994924,1672588575,1672590129,1554
10037,3701311947,3760979523,1672583024,1672583404,380
11083,3275274182,3770972037,1672581203,1672583125,1922
11738,3371132167,3447554599,1672537952,1672540220,2268
10792,3515379622,3816184951,1672562008,1672563400,1392
10326,3447253775,3379400553,1672577127,1672579913,2786
10722,3756685732,3776187150,1672625600,1672627266,1666
10912,3387322545,3520824937,1672698046,1672699352,1306
11720,3505416534,3739297004,1672699952,1672700695,743
10885,3368339963,3512417028,1672567942,1672571285,3343
11150,3818461836,3518995270,1672579732,1672581024,1292
11709,3738526914,3358982831,1672588253,1672589379,1126
11140,3361865467,3778819352,1672693729,1672695669,1940
10364,3510775046,3669497617,1672694609,1672697229,2620
10378,3757660578,3425545115,1672542330,1672542619,289
10744,3497138014,3404461403,1672693542,1672697000,3458
9875,3774221318,3733411026,1672681425,1672684327,2902
10641,3434452046,3516497645,1672668130,1672668231,101
11703,3732540636,3484739955,1672588516,1672589547,1031
11621,3919984986,3774822697,1672568048,1672568461,413
11530,3500211484,3777932581,1672638713,1672640796,2083
11349,3804840997,3558264627,1672547850,1672550528,2678
10247,3500415589,3710813103,1672611050,1672611432,382
10630,3517227599,3850904092,1672701198,1672703663,2465
11385,3517377614,3343698137,1672543989,1672546604,2615
11767,3311200541,3272328752,1672680523,1672684060,3537
10470,3501573548,3778100960,1672554411,1672556627,2216
10697,3608214600,3710107905,1672657140,1672659869,2729
10755,3755922811,3760648750,1672559551,1672562349,2798
10965,3855674398,3703415246,1672570811,1672573331,2520
10041,3828906027,3516167000,1672605713,1672607340,1627
9878,3455955489,3441737317,1672561514,1672563221,1707
10890,3701359045,3374652108,1672659124,1672659411,287
10610,3703999217,3686885442,1672688188,1672690234,2046
11475,3934564437,3756616853,1672690115,1672693061,2946
10497,3855077502,3307791650,1672636637,1672637233,596
11662,3371759126,3519059808,1672634704,1672637798,3094
11001,3827836825,3777928067,1672694984,1672697022,2038
10340,3776455762,3701519251,1672697790,1672700808,3018
10096,3925175853,3793860209,1672540706,1672542142,1436
11229,3367242388,3855209450,1672602296,1672603472,1176
10613,3613216900,3772251279,1672656898,1672659814,2916
10554,3505825767,3406029706,1672571945,1672575318,3373
9818,3534206917,3716647407,1672679984,1672682553,2569
10299,3777405860,3919984986,1672562114,1672564790,2676
9925,3510206323,3398151217,1672686911,1672689813,2902
11289,3517136772,3770441717,1672632666,1672635485,2819
10481,3297684667,3793920312,1672567580,1672569975,2395
11427,3716669659,3468871103,1672697190,1672698800,1610
10141,3826315540,3780142207,1672558281,1672560993,2712
11266,3661543201,3776407517,1672566035,1672567637,1602
11093,3686081254,3509379617,1672594364,1672595033,669
10896,3711367577,3509544691,1672531696,1672534546,2850
10810,3774652449,3773394570,1672647412,1672648719,1307
10238,3553694590,3520725149,1672542658,1672544953,2295
10323,3701529552,3716676869,1672697537,1672697757,220
11312,3779413388,3534499421,1672697167,1672699983,2816
10057,3465690527,3756113624,1672611062,1672611577,515
10788,3419829238,3286862903,1672629489,1672630668,1179
10528,3808442442,3505173665,1672652507,1672655241,2734
9933,3469663062,3715700639,1672560683,1672563420,2737
10464,3453464785,3802625412,1672603400,1672606290,2890
9812,3476308535,3512826895,1672535745,1672538802,3057
11346,3461743188,3834311054,1672682580,1672683504,924
10071,3391854325,3780749789,1672697174,1672699083,1909
11367,3319061210,3444295435,1672561714,1672565273,3559
10411,3445896667,3344778261,1672681403,1672683580,2177
10310,3433196933,3780982229,1672584375,1672586926,2551
11586,3519886257,3227647190,1672559292,1672562452,3160
11746,3757199889,3534562354,1672680928,1672681856,928
10846,3396453219,3517195738,1672659725,1672660331,606
11559,3904004824,3512395783,1672582669,1672584197,1528
9856,3636015050,3278805844,1672561987,1672564882,2895
11013,3358982831,3559221089,1672553087,1672553151,64
9962,3512154443,3716183063,1672651426,1672652137,711
11460,3244495586,3792075871,1672695329,1672698495,3166
11349,3637522163,3924583142,1672547414,1672548510,1096
10048,3905934770,3520165730,1672604288,1672604485,197
11610,3477582923,3518425740,1672565072,1672568154,3082
10571,3248409083,3310021925,1672626080,1672626690,610
10028,3792008302,3469350379,1672575222,1672577384,2162
10652,3438028077,3369558911,1672631478,1672633310,1832
10003,3475090917,3772867078,1672667349,1672668542,1193
10268,3311159418,3774822697,1672579310,1672579873,563
10841,3793569914,3770780655,1672598686,1672599690,1004
10538,3287968403,3516731917,1672618881,1672621120,2239
11643,3500821475,3779835734,1672604565,1672607164,2599
10273,3910190872,3806034626,1672671498,1672672302,804
11645,3776447604,3836586875,1672537872,1672541450,3578
10412,3776001441,3710185376,1672678052,1672681111,3059
10308,3776581518,3438204844,1672620419,1672623766,3347
10487,3703725221,3405221863,1672591678,1672594641,2963
10065,3226913558,3351856699,1672638190,1672639884,1694
11076,3230250213,3834980281,1672671334,1672671892,558
11557,3756998113,3450342110,1672548264,1672548638,374
10376,3881785069,3890638402,1672534746,1672536671,1925
11458,3337673625,3510454018,1672654696,1672657463,2767
11187,3772695548,3235074007,1672535804,1672539211,3407
11211,3714806574,3233965781,1672625596,1672626394,798
11553,3311959533,3777992576,1672703863,1672705100,1237
10800,3934611532,3780287649,1672694331,1672694948,617
9971,3517136772,3714731729,1672551614,1672553209,1595
10688,3315094386,3509317776,1672689980,1672690305,325
10152,3396472026,3423147369,1672671361,1672673650,2289
11491,3229465607,3855629383,1672556080,1672558267,2187
9996,3711870537,3534562354,1672700337,1672703532,3195
11111,3519351747,3337675386,1672596352,1672597227,875
10280,3756876537,3890211161,1672677136,1672680578,3442
11742,3228477490,3510638085,1672544559,1672546233,1674
11442,3500776597,3520012007,1672671822,1672672137,315
11298,3396440259,3772869013,1672540471,1672542941,2470
11439,3407734098,3774304163,1672699430,1672699619,189
10214,3813111107,3932566114,1672614976,1672618032,3056
10697,3208519320,3473706746,1672596282,1672598913,2631
11426,3783967375,3422205569,1672542337,1672545749,3412
10756,3311260898,3610806770,1672616922,1672617000,78
10132,3774539067,3514389188,1672584035,1672585639,1604
10753,3511003541,3513545735,1672696623,1672698265,1642
11308,3773853619,3636885498,1672690395,1672693988,3593
11634,3714377201,3774325486,1672589811,1672592766,2955
11180,3774195369,3477511446,1672689477,1672691246,1769
11009,3886837151,3807584987,1672615176,1672617684,2508
9799,3686644062,3468343480,1672558399,1672560176,1777
11066,3247193800,3417431173,1672649998,1672652498,2500
11360,3772962072,3494680853,1672537795,1672540736,2941
10363,3887382548,3308149799,1672579627,1672579835,208
10025,3770715115,3501927452,1672670451,1672672803,2352
10053,3783594246,3627377299,1672602715,1672603422,707
10464,3388946581,3772262649,1672598349,1672600246,1897
11709,3883640454,3205113625,1672635294,1672638283,2989
9872,3896859936,3880562532,1672664006,1672665116,1110
10842,3791332061,3497904539,1672621848,1672624573,2725
9968,3305656670,3296970170,1672664786,1672666875,2089
11260,3772689657,3500356342,1672599725,1672601443,1718
11346,3902775449,3455907179,1672606019,1672609176,3157
11171,3559221089,3293579860,1672607170,1672608284,1114
10823,3793899166,3783506190,1672587305,1672589400,2095
11321,3500455935,3317989975,1672611330,1672614738,3408
10099,3684651755,3713920790,1672565077,1672566345,1268
10412,3621960662,3505097206,1672586696,1672589398,2702
11183,3919984986,3520558137,1672543816,1672545226,1410
11678,3777060250,3760656396,1672578328,1672579676,1348
10581,3910354786,3774221318,1672576755,1672577925,1170
11699,3501370430,3793407883,1672566100,1672569273,3173
11555,3755229631,3793822639,1672631591,1672634283,2692
10275,3777706200,3520344592,1672666653,1672668326,1673
11722,3302416197,3892487982,1672579736,1672583061,3325
10503,3756759239,3929002318,1672650771,1672651755,984
10665,3713906305,3791758175,1672591100,1672591621,521
11187,3501574882,3519841427,1672552486,1672554611,2125
10561,3899156705,3613936929,1672669363,1672669654,291
11758,3512251592,3880549316,1672678747,1672679776,1029
10580,3909457959,3440401725,1672554479,1672556002,1523
11322,3711836873,3667950469,1672586704,1672587113,409
9891,3511412229,3853182912,1672653853,1672657305,3452
11595,3510454018,3513563152,1672664212,1672667113,2901
9892,3461630842,3518511124,1672550070,1672553515,3445
9967,3500536897,3343698137,1672562751,1672563971,1220
10430,3516321814,3511969443,1672560767,1672561291,524
10051,3803473387,3917467642,1672653011,1672656275,3264
11275,3793978936,3916463490,1672618263,1672618550,287
11109,3515304526,3493679801,1672595702,1672596873,1171
11347,3854957153,3820422111,1672650880,1672651103,223
11312,3334824744,3462153833,1672694539,1672697206,2667
11251,3236948071,3452090950,1672576065,1672576398,333
10908,3518058151,3858429342,1672533450,1672535005,1555
10554,3478455812,3804840997,1672584304,1672586230,1926
10085,3388830370,3410788026,1672654342,1672657151,2809
11153,3755378125,3772962072,1672684509,1672686599,2090
11031,3713954144,3501554468,1672685626,1672687054,1428
9882,3780294116,3732533330,1672549964,1672550237,273
10265,3519165527,3470997293,1672559716,1672560726,1010
11254,3335974305,3387388336,1672547411,1672549604,2193
10740,3714902042,3512306195,1672703225,1672704246,1021
11784,3756784813,3510758718,1672664472,1672667518,3046
10112,3510301454,3520625600,1672668770,1672668842,72
11657,3928421417,3500726347,1672673987,1672676496,2509
11521,3516792348,3774436159,1672615754,1672617344,1590
9861,3483701493,3832745283,1672540691,1672542203,1512
11724,3713858538,3770631449,1672665933,1672668760,2827
10251,3714435747,3713141087,1672547759,1672549853,2094
10950,3495446254,3634670780,1672576033,1672578557,2524
11599,3338016147,3714179543,1672692637,1672693051,414
9813,3364660506,3497904539,1672667804,1672669593,1789
10446,3416474842,3755075988,1672589923,1672592828,2905
10356,3384601925,3624307518,1672700598,1672702439,1841
10810,3778702093,3501835995,1672580620,1672581957,1337
9983,3713840946,3228218081,1672620613,1672621516,903
11074,3880030249,3807486812,1672532540,1672534082,1542
11485,3856975623,3624365837,1672625849,1672628398,2549
9799,3716179251,3881785069,1672683682,1672685493,1811
11147,3359012188,3711938229,1672585109,1672586497,1388
9994,3772489471,3776200012,1672579221,1672580134,913
10452,3358262975,3349573092,1672581935,1672584393,2458
11524,3976225898,3770276815,1672603459,1672603545,86
11638,3665841655,3514571807,1672625585,1672627061,1476
11573,3760416450,3639503148,1672569806,1672573378,3572
10689,3776593726,3415228763,1672622975,1672623969,994
11561,3779604279,3828354855,1672605312,1672606789,1477
11242,3737050849,3505438826,1672568383,1672570628,2245
11287,3738132114,3773738817,1672589845,1672592495,2650
11322,3713767153,3302879906,1672630015,1672632687,2672
10732,3778731000,3247845642,1672571220,1672574708,3488
11405,3509651954,3780969898,1672680784,1672681051,267
10488,3500968729,3810584695,1672547598,1672548462,864
10128,3379400553,3501573548,1672534240,1672537740,3500
9993,3245245283,3534491112,1672545734,1672547956,2222
10805,3311159418,3715284599,1672598208,1672598893,685
11090,3977337501,3757773786,1672566812,1672567891,1079
11303,3780213684,3711671702,1672627217,1672630269,3052
11176,3756647451,3299587876,1672701161,1672704440,3279
11510,3756616853,3777405860,1672678788,1672680640,1852
11599,3755075988,3779468781,1672610943,1672611780,837
11300,3733796228,3424476995,1672538185,1672538560,375
10627,3487278983,3716197140,1672580152,1672582810,2658
10756,3735422623,3335353798,1672592547,1672594190,1643
10596,3501208658,3272096922,1672599297,1672600766,1469
11211,3434581257,3509186338,1672618554,1672620140,1586
10195,3410602007,3911821258,1672554745,1672555308,563
10204,3519997661,3774436159,1672646873,1672650447,3574
10183,3914740937,3347760784,1672620266,1672620637,371
11619,3710622746,3446233783,1672649962,1672650618,656
11247,3713475356,3666823095,1672534562,1672536621,2059
10580,3381254180,3469370398,1672684154,1672687698,3544
9892,3711836873,3311200541,1672608226,1672610414,2188
10702,3342368576,3624164232,1672554366,1672555088,722
11725,3772343750,3301431129,1672560044,1672562288,2244
11472,3288920399,3316551382,1672534396,1672535609,1213
11509,3760096466,3511206717,1672657788,1672659200,1412
10367,3513508737,3803382101,1672609873,1672611257,1384
11003,3686081254,3791224239,1672701940,1672705190,3250
11318,3386323728,3714281795,1672595083,1672596669,1586
10442,3244098077,3825526565,1672692599,1672695197,2598
11118,3713031958,3896859936,1672652063,1672654248,2185
11556,3443191792,3853275529,1672609687,1672610277,590
9930,3760801237,3681504869,1672566377,1672568226,1849
11622,3715852330,3773738817,1672627048,1672627835,787
10876,3891272544,3519947298,1672677671,1672679996,2325
10978,3622729771,3350631472,1672678374,1672679968,1594
10043,3520926977,3899156705,1672680239,1672680696,457
9888,3519352855,3755823805,1672703652,1672704728,1076
10236,3355899481,3295748489,1672588834,1672589115,281
10508,3773738817,3757199889,1672676799,1672680008,3209
10008,3776468503,3779282072,1672631684,1672633677,1993
10316,3760537855,3615846003,1672557268,1672559072,1804
10424,3500695402,3777200549,1672640670,1672642161,1491
11706,3791222330,3359880163,1672676964,1672679367,2403
10733,3493679801,3770018912,1672586450,1672587710,1260
10409,3701685828,3382757142,1672668027,1672669213,1186
9960,3288675710,3374348845,1672559963,1672563526,3563
9938,3364067937,3533960602,1672672630,1672675541,2911
11654,3516321814,3417360319,1672699593,1672702763,3170
10389,3511864772,3413236071,1672605467,1672608691,3224
11357,3770530739,3913847876,1672592027,1672593180,1153
10863,3711258452,3972729768,1672700300,1672701011,711
11513,3755584983,3831864108,1672654561,1672655876,1315
11094,3505119470,3516586325,1672703903,1672704079,176
10110,3609644043,3757994002,1672609700,1672610587,887
10771,3793899166,3638018906,1672551289,1672554059,2770
11509,3770012744,3500073824,1672594268,1672594952,684
10323,3406029706,3760420315,1672601953,1672602454,501
10030,3835599049,3791289855,1672687708,1672689034,1326
11268,3793902476,3207586072,1672636397,1672637031,634
10443,3513293711,3515699732,1672639714,1672643090,3376
10353,3716341323,3299587876,1672617484,1672618910,1426
10881,3517331746,3660257653,1672664067,1672664789,722
11347,3890278838,3614112171,1672649507,1672653068,3561
11537,3760267158,3520395850,1672679824,1672682474,2650
11425,3500145103,3513890046,1672548664,1672549128,464
10195,3505121295,3534543864,1672610851,1672611400,549
10612,3469780362,3632189887,1672624678,1672627421,2743
11701,3514244308,3834311054,1672659300,1672661172,1872
11282,3294326116,3534426696,1672691074,1672694117,3043
10362,3227206772,3793003432,1672540482,1672543350,2868
10877,3363549860,3780733404,1672681311,1672684561,3250
10415,3334708091,3760074281,1672646072,1672647544,1472
10062,3812880543,3666022373,1672648540,1672651266,2726
10836,3514306458,3478206139,1672552714,1672555365,2651
10563,3926065090,3716285196,1672670711,1672671479,768
9865,3730935770,3203172170,1672703004,1672705659,2655
9841,3680278447,3892177203,1672611916,1672614046,2130
10881,3500211484,3710852576,1672627751,1672628030,279
11041,3275057862,3760322661,1672673299,1672674289,990
11023,3908883591,3339478490,1672638759,1672640766,2007
9968,3229615214,3886837151,1672669257,1672672713,3456
11357,3238779889,3895839169,1672678582,1672681037,2455
11700,3452982957,3403738461,1672703011,1672705580,2569
10881,3756119976,3436018575,1672637240,1672640195,2955
10496,3780969898,3491250381,1672661082,1672662900,1818
11541,3773475506,3756157377,1672566849,1672567952,1103
10135,3770715115,3755989680,1672678590,1672680821,2231
11010,3501370430,3713906305,1672646004,1672648504,2500
11330,3820922991,3713069234,1672596033,1672598270,2237
9837,3603167427,3335139032,1672679291,1672681188,1897
10862,3783313202,3777706200,1672650469,1672652527,2058
10540,3772291207,3666022373,1672660572,1672663200,2628
10057,3805926853,3791121243,1672685159,1672685313,154
9991,3449020351,3208519320,1672556974,1672559978,3004
11457,3533077580,3311264420,1672668098,1672669569,1471
9875,3665478011,3481365330,1672534633,1672538029,3396
11104,3467232654,3779413388,1672629770,1672630706,936
10819,3779130507,3926724515,1672651345,1672653652,2307
10758,3505331083,3701359045,1672677178,1672680135,2957
11092,3971282455,3760144712,1672699814,1672702238,2424
10454,3520625600,3838748301,1672676744,1672677669,925
11474,3933872044,3466620548,1672648786,1672652375,3589
10429,3818570577,3807584987,1672546929,1672550019,3090
10331,3760420315,3711065081,1672605916,1672608385,2469
10305,3897500723,3703031637,1672620781,1672622686,1905
11116,3515528947,3703462221,1672618228,1672620664,2436
9860,3512753567,3925175853,1672591358,1672594375,3017
10434,3613940925,3783730769,1672586521,1672587497,976
10185,3757201538,3291153514,1672634853,1672635603,750
11282,3243763209,3703588004,1672537050,1672537829,779
10449,3636927297,3710051427,1672560600,1672563461,2861
10129,3716526314,3505119470,1672608031,1672609629,1598
10946,3351728355,3534696810,1672688562,1672688913,351
11090,3896123242,3621812406,1672587289,1672588095,806
9956,3919494952,3335055096,1672626824,1672630238,3414
10558,3505697295,3311414429,1672695156,1672697041,1885
11670,3230250213,3349573092,1672561410,1672563354,1944
10152,3614484939,3703938162,1672552504,1672552948,444
10651,3505416534,3777937949,1672675245,1672676089,844
10565,3715282492,3609166109,1672569151,1672571125,1974
10943,3755209597,3713606829,1672647446,1672648940,1494
9869,3398483531,3714870496,1672567149,1672568083,934
9937,3231227362,3736941123,1672610805,1672610896,91
10830,3701449715,3227647190,1672663068,1672664805,1737
10996,3760966645,3352374868,1672634006,1672634067,61
11044,3436018575,3514941815,1672568846,1672570004,1158
10010,3756781024,3515984911,1672646866,1672647182,316
10288,3836136159,3509382404,1672616762,1672619225,2463
10621,3770544738,3274239253,1672685967,1672687126,1159
11753,3398483531,3631444265,1672647645,1672648179,534
9900,3500596577,3505756991,1672609168,1672611957,2789
11091,3791581138,3621591266,1672689277,1672690801,1524
10989,3757523596,3686853863,1672696498,1672699611,3113
10950,3390438262,3516965624,1672651685,1672653885,2200
11407,3485151614,3730935770,1672537866,1672540062,2196
10805,3896615831,3757199889,1672700988,1672701824,836
11396,3929923442,3625931630,1672601946,1672603037,1091
10763,3468871103,3779665641,1672661602,1672663592,1990
9950,3777878462,3914947393,1672691548,1672692772,1224
10154,3206262649,3617135064,1672669551,1672670347,796
11774,3510781595,3791628195,1672702470,1672704185,1715
11002,3516932899,3505769529,1672591093,1672593532,2439
11537,3738103378,3826418889,1672675572,1672678213,2641
10072,3756428507,3391854325,1672608070,1672609657,1587
10680,3497562878,3221126799,1672533967,1672535961,1994
10786,3404461403,3413799143,1672657101,1672657348,247
10526,3760656396,3505786561,1672588435,1672589526,1091
11601,3855209450,3774251051,1672568031,1672571490,3459
9841,3916924978,3701412729,1672677908,1672679464,1556
9912,3376842515,3791532324,1672700918,1672702069,1151
11635,3511969443,3710119555,1672617132,1672619990,2858
11689,3406492167,3885645840,1672631796,1672634712,2916
10624,3714435747,3777655401,1672552185,1672552478,293
11030,3500543341,3783967375,1672612195,1672615037,2842
10592,3512769522,3791351852,1672615875,1672617929,2054
10520,3520925688,3631444265,1672633589,1672635029,1440
11015,3683677062,3397972945,1672679925,1672681353,1428
10314,3730115019,3770631449,1672649185,1672650682,1497
11292,3733423371,3774663639,1672623906,1672624590,684
11648,3780964089,3793569914,1672621446,1672623922,2476
10497,3390368796,3514564903,1672565231,1672567989,2758
10013,3227059650,3772980989,1672627975,1672629090,1115
10636,3756149282,3772216305,1672607477,1672609810,2333
10166,3519059808,3520022175,1672619328,1672621784,2456
11586,3822368676,3293579860,1672630442,1672630515,73
10511,3773556853,3710051427,1672670766,1672671225,459
11562,3240622654,3820280594,1672625758,1672627308,1550
10103,3756536512,3271762055,1672597549,1672598548,999
10396,3453164933,3811503860,1672699362,1672699452,90
11000,3776407517,3783679478,1672703511,1672705573,2062
10767,3510775046,3791841318,1672646437,1672648111,1674
10502,3553694590,3389069291,1672671107,1672671490,383
10930,3713416106,3515100211,1672684623,1672688107,3484
10611,3416225867,3514455363,1672660714,1672662974,2260
11158,3287683210,3783563043,1672585992,1672586927,935
11711,3436401020,3756113624,1672623331,1672626049,2718
10294,3710149975,3517440258,1672551900,1672554927,3027
10373,3380628097,3807800457,1672607542,1672608800,1258
10735,3770972037,3773579644,1672584133,1672584532,399
10681,3701685828,3278805844,1672645188,1672646038,850
11722,3685396470,3370401047,1672684660,1672684730,70
11048,3533419409,3791031227,1672635193,1672635362,169
11596,3358530225,3278071998,1672667741,1672668406,665
11130,3475845921,3805831563,1672596831,1672597468,637
11378,3830291558,3293157673,1672539416,1672540937,1521
11748,3711854614,3515096959,1672619538,1672620604,1066
11318,3517499844,3713195480,1672540393,1672543699,3306
10203,3500211484,3534362749,1672592809,1672595605,2796
10943,3516586325,3380281484,1672581399,1672581635,236
9818,3760397450,3633622298,1672621914,1672625392,3478
10780,3533620069,3330466913,1672593573,1672595922,2349
11175,3689386663,3852461753,1672560958,1672561296,338
10455,3468066881,3972729768,1672695345,1672698843,3498
11756,3306491253,3916463490,1672574419,1672576827,2408
10848,3666958814,3773378103,1672687760,1672689243,1483
10682,3311414429,3480418192,1672615372,1672617827,2455
9828,3776867553,3778838936,1672659056,1672661038,1982
9998,3714919471,3856601074,1672632621,1672634119,1498
11155,3730226545,3898592058,1672544407,1672544758,351
11384,3480185839,3668720465,1672606802,1672606882,80
11544,3203172170,3358675021,1672582911,1672585857,2946
11346,3559112196,3756525103,1672543457,1672545123,1666
10027,3501734800,3628556590,1672560126,1672560473,347
11392,3732223664,3240443426,1672677087,1672680447,3360
11156,3201502111,3447591143,1672613506,1672613610,104
10898,3512101369,3737738751,1672675900,1672677444,1544
11485,3779835734,3229734741,1672646461,1672647418,957
9884,3838748301,3390438262,1672662874,1672663203,329
11424,3516827471,3701412729,1672691526,1672694067,2541
10364,3505416534,3896211741,1672582269,1672582624,355
10110,3660702754,3890211161,1672581277,1672584103,2826
11530,3472718723,3534374523,1672562062,1672565080,3018
10176,3533036499,3832002939,1672691283,1672693511,2228
10885,3516340010,3533037906,1672588611,1672589668,1057
11533,3518117078,3882851213,1672663374,1672664744,1370
10208,3348343425,3231153513,1672560579,1672561145,566
10685,3882905311,3516965624,1672572594,1672575888,3294
11141,3221290808,3500015630,1672543362,1672545967,2605
9811,3617771673,3513432588,1672568379,1672570180,1801
10411,3773161055,3518408734,1672625982,1672629052,3070
10731,3780148144,3971447562,1672620325,1672622660,2335
10240,3791664049,3533017131,1672636175,1672638460,2285
11040,3498857406,3777715675,1672628200,1672629210,1010
11483,3492728794,3519351747,1672598430,1672601931,3501
10576,3714718326,3755865626,1672637705,1672641271,3566
10731,3510233949,3420664407,1672597938,1672601278,3340
10715,3316121649,3780467276,1672625265,1672626603,1338
11276,3272328752,3772867078,1672697315,1672699884,2569
9843,3303552616,3778253021,1672669658,1672670305,647
11135,3807584987,3711015176,1672566416,1672568845,2429
10487,3755218683,3850993995,1672632496,1672634448,1952
11516,3772489471,3975799349,1672557706,1672559743,2037
10622,3715320359,3229615214,1672569564,1672572544,2980
11553,3361635547,3500734346,1672587038,1672589498,2460
11484,3755273361,3518572231,1672544567,1672547932,3365
10071,3227339675,3711938229,1672666976,1672667059,83
10635,3825234433,3907923381,1672625117,1672625587,470
11143,3757128722,3714250543,1672570456,1672572576,2120
11163,3500864577,3236254381,1672603505,1672606147,2642
10037,3343511947,3510836047,1672561216,1672564776,3560
10373,3610517436,3701385831,1672565689,1672567296,1607
10496,3774939922,3351856699,1672623446,1672626306,2860
10084,3394357241,3419378107,1672696301,1672698025,1724
11003,3447312353,3885147558,1672668837,1672670207,1370
11052,3389069291,3772968080,1672539148,1672539238,90
10814,3513215373,3605905645,1672665636,1672667622,1986
9805,3534775239,3686644062,1672626070,1672626856,786
11490,3301489209,3776778306,1672654904,1672656627,1723
10811,3715790104,3229621693,1672569937,1672573090,3153
11445,3703732445,3310712221,1672656982,1672658595,1613
10965,3511466117,3553321027,1672590901,1672591537,636
10511,3271719569,3899903158,1672572054,1672574128,2074
9984,3343616490,3295691964,1672677266,1672679763,2497
9802,3505867821,3757064623,1672579811,1672581616,1805
11227,3247845642,3505266343,1672621581,1672621796,215
9943,3777569538,3773376762,1672562492,1672565625,3133
11659,3517499844,3791072829,1672563652,1672566224,2572
11544,3711591464,3509445318,1672607325,1672609997,2672
11232,3410602007,3825877848,1672633825,1672636626,2801
10594,3609997804,3638050763,1672638721,1672641702,2981
10744,3510758718,3444680955,1672627573,1672627731,158
10062,3926065090,3777135415,1672621531,1672621998,467
10503,3713906305,3812277991,1672663594,1672664347,753
10749,3439651226,3772250554,1672624916,1672626379,1463
10298,3817376705,3701971784,1672679141,1672681740,2599
10139,3757393413,3756890980,1672569078,1672570183,1105
11704,3282053097,3732540636,1672552915,1672554611,1696
10175,3924963918,3518408734,1672674844,1672675099,255
10568,3772234939,3918126468,1672565057,1672566142,1085
11040,3912915644,3909399636,1672666783,1672667248,465
10665,3776182849,3776710698,1672699413,1672699876,463
9975,3498857406,3509626590,1672625413,1672626608,1195
11366,3318056480,3774436159,1672545071,1672545151,80
9913,3884458862,3774035405,1672612308,1672613685,1377
11523,3359351267,3428325402,1672570827,1672571433,606
11117,3836090778,3716841469,1672618955,1672620570,1615
11142,3791664049,3621812406,1672654689,1672656608,1919
10340,3311805161,3514926921,1672606385,1672606898,513
10047,3613216900,3444598583,1672571045,1672574185,3140
10523,3779340538,3395610742,1672603375,1672606432,3057
11564,3480185839,3518947256,1672598095,1672600024,1929
10423,3201573194,3513840186,1672674993,1672676771,1778
10023,3825153408,3716994924,1672671860,1672673990,2130
11294,3791796190,3777074709,1672557458,1672559806,2348
10831,3441336851,3793699467,1672684494,1672684723,229
10289,3755570137,3780733404,1672598811,1672600089,1278
10177,3450342110,3425260097,1672614368,1672616092,1724
10660,3792283334,3738734246,1672691804,1672694243,2439
10024,3513486828,3780142207,1672679709,1672680453,744
10678,3779340538,3505490878,1672661433,1672662740,1307
11702,3534174363,3419762444,1672645927,1672648143,2216
10262,3896615831,3882905311,1672598747,1672599944,1197
11087,3757032266,3934280144,1672689698,1672690214,516
11620,3776953418,3534770827,1672563061,1672563203,142
10218,3938021614,3664478769,1672607609,1672611013,3404
10223,3777387533,3408828584,1672576309,1672578744,2435
11741,3393502004,3621439107,1672690895,1672692747,1852
11408,3903115138,3636605690,1672647517,1672647943,426
11650,3512700007,3773017746,1672688818,1672690413,1595
10128,3370961012,3756157377,1672551912,1672554025,2113
10698,3311771689,3292050211,1672682891,1672685346,2455
11309,3487278983,3774744663,1672701152,1672703370,2218
11105,3374195945,3505119470,1672600178,1672600333,155
9981,3311959533,3512480125,1672632633,1672636225,3592
9899,3458130310,3830254808,1672616664,1672618345,1681
11631,3286862903,3386323728,1672633971,1672634309,338
10625,3780500331,3313795594,1672657112,1672657582,470
11338,3333355914,3880882684,1672615513,1672616353,840
11058,3279726491,3512744657,1672583816,1672584679,863
11279,3313101243,3436401020,1672612537,1672612875,338
10806,3773768643,3313298164,1672532799,1672536355,3556
10170,3276499910,3282053097,1672685601,1672686534,933
10623,3377883705,3760443176,1672668335,1672671440,3105
11585,3458271585,3511907179,1672643174,1672645132,1958
11634,3760710525,3238310644,1672643249,1672643898,649
10219,3930727474,3311260898,1672678800,1672679797,997
10376,3760443176,3774483862,1672664292,1672665747,1455
10150,3777931341,3415228763,1672555437,1672558894,3457
10993,3614944981,3791698084,1672644995,1672645077,82
11733,3514244308,3246381831,1672655864,1672657025,1161
10305,3939882169,3776600696,1672671828,1672673558,1730
10098,3603452936,3459799131,1672673190,1672674706,1516
10078,3711518637,3475090917,1672676004,1672678168,2164
9881,3791841318,3500442370,1672620445,1672621725,1280
10215,3512871568,3243763209,1672627889,1672628650,761
10681,3937747312,3455907179,1672639354,1672639751,397
11742,3501137133,3517380144,1672609042,1672610481,1439
11433,3500734346,3689223632,1672681900,1672684592,2692
10733,3517797610,3825082811,1672598935,1672599562,627
10181,3791359168,3792824886,1672623532,1672625033,1501
10464,3285201542,3310737478,1672682933,1672686337,3404
10923,3608214600,3369482983,1672646389,1672648299,1910
9888,3716020849,3534374523,1672679012,1672682183,3171
10423,3516815069,3757060033,1672641617,1672643318,1701
10788,3856316719,3779818784,1672646570,1672650138,3568
10386,3518931700,3683047199,1672532286,1672534463,2177
9876,3378172464,3430310785,1672571190,1672572606,1416
9961,3609335008,3341311972,1672625145,1672627103,1958
11202,3360309868,3791206902,1672648404,1672649969,1565
11127,3505853594,3683677062,1672578992,1672579776,784
10279,3294949958,3223512565,1672568079,1672569451,1372
10198,3534531061,3755075988,1672599974,1672600832,858
10068,3515284733,3275274182,1672663483,1672665711,2228
9860,3519356606,3227206772,1672674954,1672675227,273
11543,3776867553,3716341323,1672639676,1672642932,3256
10193,3710082615,3234445133,1672703174,1672705193,2019
11108,3834643026,3979366845,1672665338,1672668709,3371
11305,3783043346,3500734346,1672612956,1672613926,970
11596,3819024145,3755769731,1672546520,1672548862,2342
11412,3831864108,3899970524,1672594477,1672595678,1201
10535,3755154460,3533209168,1672691947,1672694983,3036
10482,3783373085,3466655775,1672694856,1672696355,1499
10681,3714903456,3518088154,1672569931,1672570149,218
9967,3716609198,3854957153,1672637958,1672638292,334
10960,3367121615,3701374160,1672619202,1672621558,2356
10183,3476144563,3450234157,1672539580,1672541371,1791
11441,3510882576,3756119976,1672629195,1672630176,981
11780,3373851012,3701291994,1672672344,1672672908,564
10474,3501988762,3403395712,1672566111,1672568348,2237
10329,3445896667,3408982612,1672689083,1672690211,1128
11249,3701668745,3517440258,1672566573,1672567931,1358
11541,3703896751,3332010532,1672628475,1672630517,2042
11637,3791796190,3438470128,1672660452,1672662528,2076
10263,3901217668,3622729771,1672621577,1672624348,2771
9806,3896200048,3445406685,1672618027,1672621336,3309
11164,3422205569,3477248170,1672598598,1672601591,2993
10662,3243651036,3518205307,1672549117,1672551730,2613
10105,3305727497,3909399636,1672549312,1672552205,2893
10264,3682802569,3511199555,1672679296,1672680441,1145
9980,3606804618,3732128078,1672625726,1672626931,1205
10589,3511969443,3880882684,1672540834,1672543824,2990
10681,3834424604,3482786946,1672652187,1672653630,1443
11704,3510819040,3757032266,1672557698,1672561138,3440
10682,3500433278,3489212992,1672650878,1672652488,1610
10833,3804095239,3716633983,1672572859,1672576068,3209
11643,3519322066,3622152515,1672624627,1672626755,2128
9827,3711287751,3684108920,1672537298,1672538003,705
10543,3920526713,3793902476,1672701432,1672703708,2276
10810,3610517436,3311305760,1672533266,1672534138,872
9959,3480405740,3714287902,1672644215,1672644326,111
11125,3737738751,3779818784,1672577547,1672579223,1676
9864,3791368349,3416079461,1672669430,1672671632,2202
11784,3249614888,3935569749,1672660035,1672660429,394
11686,3446066492,3513629502,1672534117,1672536635,2518
11197,3519513219,3711015176,1672698327,1672700969,2642
11387,3484483775,3288920399,1672679094,1672681948,2854
10178,3710585241,3760801237,1672641832,1672643815,1983
9806,3777729184,3633860380,1672690811,1672691886,1075
11792,3334482021,3311305760,1672685127,1672686783,1656
10802,3605760561,3454924050,1672600306,1672603371,3065
10461,3413511621,3404187438,1672567325,1672569310,1985
10597,3311739926,3468343480,1672634010,1672636107,2097
11195,3911821258,3515577866,1672633430,1672636083,2653
10044,3770018912,3234445133,1672666423,1672669064,2641
11042,3243763209,3534667712,1672622108,1672623635,1527
10614,3898989233,3791581138,1672694838,1672697254,2416
10812,3514571807,3737738751,1672596994,1672597782,788
10748,3444598583,3736621212,1672580682,1672581212,530
11584,3928076270,3516319492,1672667761,1672670711,2950
10683,3500062408,3773083407,1672547103,1672549116,2013
11189,3897500723,3802625412,1672654144,1672654991,847
10305,3516200419,3362127525,1672701231,1672703430,2199
10166,3509556649,3779160052,1672573024,1672574402,1378
10433,3510373076,3515607283,1672600564,1672603896,3332
10106,3357026115,3519167605,1672544411,1672547709,3298
11498,3970775805,3736621212,1672587204,1672587902,698
11534,3638050763,3783060739,1672595904,1672597897,1993
11145,3711852131,3933731871,1672559560,1672560380,820
11172,3287734830,3500863429,1672570857,1672571046,189
10176,3777672363,3514776568,1672635370,1672636604,1234
10012,3880882684,3534102440,1672635511,1672637636,2125
9899,3773434690,3757064623,1672593412,1672594989,1577
10443,3274341934,3204149913,1672633622,1672634373,751
10224,3419378107,3231963246,1672624867,1672625481,614
10796,3505786561,3615742989,1672586173,1672588780,2607
11180,3501370430,3533427742,1672565147,1672566103,956
11109,3714281795,3772962072,1672644921,1672646206,1285
11194,3241682278,3464622743,1672676098,1672679651,3553
11604,3310702648,3713159131,1672577624,1672580364,2740
11399,3757796416,3716541851,1672600337,1672602409,2072
10825,3494157939,3929002318,1672554705,1672556725,2020
11610,3500864577,3514515499,1672636156,1672636886,730
11686,3637522163,3907390925,1672682015,1672685174,3159
11568,3369108286,3500062408,1672610130,1672612626,2496
11692,3710680073,3397783490,1672623501,1672625593,2092
10398,3238779889,3621960662,1672563286,1672565351,2065
10949,3509503263,3703476890,1672533388,1672535058,1670
10748,3855440101,3703351452,1672616384,1672616562,178
10751,3793987483,3500442370,1672580758,1672581966,1208
11539,3445896667,3422460919,1672548061,1672548827,766
10556,3450679913,3887030182,1672680640,1672681946,1306
10216,3828354855,3464622743,1672658530,1672659823,1293
9912,3716976932,3610806770,1672569345,1672572847,3502
11180,3518931700,3364286028,1672676237,1672678664,2427
9958,3636605690,3715724166,1672642303,1672644852,2549
9839,3710680073,3292663993,1672602311,1672605581,3270
10561,3834424604,3622458047,1672628472,1672630326,1854
9884,3390368796,3500785888,1672590492,1672590761,269
10750,3857244486,3295530454,1672553946,1672556606,2660
11010,3400793223,3755357292,1672675976,1672677376,1400
11327,3777439655,3711770853,1672566246,1672568065,1819
10419,3686885442,3273674596,1672561845,1672563052,1207
10231,3511969443,3715111016,1672619304,1672622405,3101
9935,3779778679,3379666159,1672653984,1672656480,2496
10306,3349319959,3855629383,1672554994,1672558568,3574
11306,3462153833,3519000878,1672609753,1672611975,2222
10311,3477951091,3825234433,1672631965,1672634131,2166
10361,3292936094,3711404205,1672559144,1672560707,1563
11280,3510233949,3353335252,1672615687,1672617711,2024
10471,3837887478,3514801709,1672595267,1672596433,1166
10319,3304592684,3229734741,1672676972,1672680409,3437
11210,3405221863,3500438542,1672632643,1672633348,705
10582,3780435349,3739075176,1672532215,1672532804,589
11111,3776407517,3810584695,1672689026,1672689450,424
11359,3381055770,3738160394,1672584513,1672585610,1097
11379,3505414878,3510801769,1672643874,1672645376,1502
10902,3605078841,3438818153,1672545732,1672548222,2490
11779,3512638952,3978643889,1672628221,1672631526,3305
10191,3311739926,3791644831,1672627900,1672629897,1997
10854,3404187438,3776319560,1672626795,1672628106,1311
10213,3806034626,3783879023,1672650957,1672651244,287
10116,3615846003,3463564410,1672543238,1672543397,159
11786,3780142207,3510919509,1672582595,1672585713,3118
11154,3509018337,3511744756,1672664636,1672666684,2048
10115,3334936138,3773394570,1672614439,1672615271,832
10906,3205113625,3783043346,1672658285,1672659343,1058
11171,3760710525,3429333292,1672676540,1672676888,348
11144,3710173412,3435715962,1672635644,1672636104,460
10457,3275057862,3919719755,1672689198,1672692249,3051
10891,3493515706,3512504247,1672572281,1672573987,1706
10786,3909457959,3238779889,1672551929,1672554609,2680
11452,3459951739,3500015630,1672675933,1672676354,421
10881,3710228292,3619796619,1672673858,1672676441,2583
11718,3791532324,3888523259,1672674045,1672675531,1486
9834,3780467276,3715291931,1672647280,1672650483,3203
9948,3714074120,3500720752,1672587424,1672589681,2257
11421,3774652449,3533325993,1672555206,1672556992,1786
11302,3773738817,3812559393,1672602554,1672604348,1794
11313,3519055736,3755736024,1672657212,1672659334,2122
11714,3776407517,3379666159,1672697092,1672698661,1569
10516,3737571883,3422460919,1672536579,1672539514,2935
9934,3400545490,3623512088,1672575250,1672577244,1994
10250,3701028092,3897186782,1672635341,1672636812,1471
10462,3688768189,3834456158,1672616375,1672617783,1408
11204,3534531039,3902300755,1672577612,1672580242,2630
9841,3774436159,3780048608,1672643559,1672644763,1204
10595,3906693728,3683514731,1672649747,1672650073,326
11369,3776124041,3772695548,1672546948,1672549202,2254
10886,3701291994,3404375908,1672582307,1672583962,1655
10136,3452802329,3201419050,1672532072,1672533035,963
11407,3880562532,3517380144,1672546310,1672546931,621
11534,3777304517,3511864772,1672685132,1672688020,2888
10332,3600978954,3533976217,1672631634,1672633433,1799
10017,3510368377,3662354016,1672621984,1672625195,3211
10408,3701529552,3615245840,1672566255,1672568107,1852
11302,3512417028,3703048107,1672669960,1672670741,781
11721,3309528048,3899294071,1672591054,1672592253,1199
10216,3778195766,3302988745,1672655362,1672655525,163
9804,3906075386,3714268380,1672633271,1672636267,2996
11474,3386323728,3534499421,1672675025,1672678237,3212
10101,3714897456,3314965818,1672647785,1672649621,1836
10048,3238779889,3274341934,1672568867,1672571167,2300
11792,3772227820,3606688595,1672541381,1672542782,1401
9909,3287683210,3471131277,1672674415,1672677358,2943
10412,3779505358,3757549235,1672690036,1672690368,332
10087,3907390925,3780982229,1672578650,1672578891,241
10375,3703722212,3971289056,1672564339,1672566141,1802
9995,3534081527,3517992521,1672561375,1672562991,1616
10283,3378534521,3760416450,1672546659,1672547355,696
10951,3852275715,3304030474,1672661759,1672661834,75
11303,3369108286,3616242727,1672609971,1672612707,2736
11681,3856897914,3515804844,1672547704,1672550241,2537
10534,3933469838,3511289729,1672546507,1672549913,3406
10893,3792107875,3711287751,1672679207,1672680951,1744
10387,3384001094,3701493094,1672550627,1672552100,1473
10245,3701171318,3513800589,1672576905,1672577749,844
10799,3714919471,3755230010,1672665180,1672666070,890
10394,3307236682,3276499910,1672538605,1672539341,736
11032,3715602742,3411355804,1672572913,1672575231,2318
11731,3713336088,3779665641,1672685758,1672688928,3170
9856,3365839890,3404461403,1672670313,1672671540,1227
10287,3393909269,3358675021,1672645952,1672648026,2074
11036,3452175941,3519046342,1672666785,1672669165,2380
11486,3757598610,3779503296,1672612703,1672614270,1567
10636,3512625661,3282053097,1672585770,1672588867,3097
11126,3465672238,3730290851,1672600819,1672601403,584
10358,3666823095,3826542169,1672580243,1672581577,1334
9795,3501550490,3334488428,1672691204,1672692680,1476
10050,3822496670,3701475090,1672588366,1672588881,515
9880,3668369938,3978417055,1672612903,1672614344,1441
10422,3884934977,3501244753,1672652154,1672654293,2139
10562,3520925688,3730414796,1672651495,1672653846,2351
10322,3439045964,3689386663,1672606600,1672609236,2636
10532,3613936929,3780435349,1672537062,1672539815,2753
11474,3514353133,3910354786,1672573699,1672575361,1662
10596,3284483177,3559221089,1672668509,1672669729,1220
11423,3822634862,3714870496,1672538353,1672541070,2717
10021,3517645656,3896200048,1672641566,1672643269,1703
11777,3903994989,3516486526,1672563653,1672564619,966
11575,3517949586,3517499844,1672628375,1672631081,2706
10312,3710060386,3359012188,1672545773,1672547671,1898
9824,3772802020,3367299721,1672584812,1672586472,1660
9901,3375905193,3732104286,1672555697,1672557108,1411
11693,3441683673,3534206917,1672610179,1672613425,3246
10313,3827981800,3311410533,1672647451,1672650061,2610
11723,3715441777,3511382748,1672616377,1672618266,1889
10770,3830254808,3791547827,1672628095,1672631244,3149
10367,3311197635,3519513219,1672606150,1672607589,1439
10584,3713636175,3616371564,1672571540,1672571992,452
10500,3738547113,3505190512,1672675421,1672678166,2745
11527,3793822639,3934070285,1672595658,1672596300,642
10108,3436018575,3415228763,1672652477,1672654063,1586
11128,3772609551,3792255406,1672618882,1672620378,1496
9959,3757623259,3505097206,1672561517,1672562060,543
10580,3439036305,3807111856,1672541408,1672543687,2279
11775,3783043770,3703779674,1672611696,1672612037,341
10617,3511182297,3435342362,1672647363,1672648879,1516
11251,3716740576,3342837214,1672679037,1672681904,2867
11476,3810949170,3715923089,1672562335,1672563452,1117
10298,3441840658,3304030474,1672615360,1672615875,515
10168,3791522832,3293553295,1672623507,1672625513,2006
11538,3930475498,3774448657,1672666836,1672667978,1142
11588,3361952532,3683562111,1672672387,1672673066,679
10370,3783939161,3713069234,1672588486,1672591052,2566
10286,3783695231,3636015050,1672541044,1672544108,3064
10431,3510484107,3551972633,1672691969,1672694685,2716
11393,3755502373,3774109138,1672532300,1672533083,783
10524,3501988762,3703476890,1672614878,1672617994,3116
11251,3500889287,3342495377,1672572333,1672573923,1590
10983,3466620548,3439283360,1672686346,1672686922,576
10587,3616403486,3633622298,1672628428,1672630709,2281
10757,3783730769,3716160006,1672688533,1672690418,1885
10243,3419648004,3358982831,1672582392,1672582907,515
10305,3361926328,3317887374,1672564462,1672567254,2792
10429,3621591266,3515984911,1672702951,1672703743,792
10553,3517440258,3518534560,1672560812,1672561470,658
10608,3406390503,3620105539,1672619706,1672620588,882
10677,3485521840,3352044245,1672531279,1672534347,3068
10756,3319862687,3336225953,1672611577,1672611784,207
10622,3777405860,3783277159,1672545180,1672548760,3580
10422,3774627091,3236206821,1672588869,1672591464,2595
9996,3391612879,3201502111,1672644607,1672645391,784
11391,3474879231,3500442370,1672584008,1672586385,2377
10838,3517797610,3806034626,1672545833,1672548321,2488
9989,3515378306,3342545285,1672588175,1672591602,3427
11358,3505148522,3304697982,1672678976,1672680465,1489
10271,3777932581,3316537706,1672635047,1672636403,1356
10563,3519162582,3301369282,1672573236,1672576692,3456
10138,3776348451,3780294116,1672653850,1672654420,570
10002,3346755179,3227059650,1672538727,1672540465,1738
10413,3938059867,3500442370,1672612564,1672612723,159
11449,3772980989,3756413374,1672553184,1672554519,1335
10433,3756066765,3204473480,1672675558,1672678957,3399
11767,3834980281,3772609551,1672555528,1672558409,2881
11504,3893932944,3511004622,1672686818,1672687353,535
10536,3780921044,3812559393,1672610222,1672611964,1742
11051,3280208630,3793902476,1672560622,1672561310,688
10916,3600699873,3438204844,1672688779,1672690167,1388
11505,3488749569,3857344874,1672633397,1672634708,1311
10219,3925175853,3450621820,1672531687,1672535141,3454
11436,3516904926,3791070926,1672594456,1672597683,3227
11700,3353811455,3512726649,1672699336,1672701625,2289
11278,3791106473,3407403080,1672662928,1672664972,2044
10958,3501828287,3857344874,1672621064,1672623698,2634
10746,3602570831,3500031401,1672682694,1672682926,232
10634,3534941710,3377446376,1672703006,1672704326,1320
11139,3496352027,3773134128,1672594764,1672596936,2172
11241,3714453773,3509377714,1672642495,1672643438,943
11394,3780142207,3519848902,1672538933,1672539909,976
11125,3632189887,3683677062,1672568008,1672569324,1316
9825,3359012188,3918981936,1672598660,1672600961,2301
10190,3491335890,3229615214,1672676888,1672679714,2826
11655,3887382548,3402020492,1672648727,1672649614,887
10599,3385124073,3701841013,1672700588,1672703140,2552
10197,3361952532,3931164237,1672565878,1672565990,112
11577,3396656251,3345954031,1672664224,1672667776,3552
10441,3519059808,3304661369,1672615950,1672617996,2046
10894,3887382548,3514508773,1672693909,1672696897,2988
11203,3774706478,3806720019,1672701985,1672704523,2538
10792,3687445224,3807111856,1672611338,1672611512,174
10538,3307791650,3304028109,1672659630,1672660122,492
10773,3792900315,3755942724,1672647034,1672647127,93
10241,3201634072,3835509670,1672677480,1672679143,1663
10114,3500695402,3732467455,1672695997,1672696359,362
11442,3783157469,3378729459,1672627139,1672630188,3049
11498,3893950585,3853386575,1672634161,1672634805,644
11701,3774946684,3304697982,1672561721,1672562935,1214
11565,3469780362,3487988841,1672580432,1672580724,292
9845,3703048107,3441683673,1672647095,1672648978,1883
11432,3897107253,3518205307,1672681283,1672682475,1192
10909,3400186699,3732871856,1672540390,1672541969,1579
10249,3713728777,3716160006,1672635517,1672638339,2822
10814,3494748808,3665841655,1672536985,1672539234,2249
9910,3430399931,3316406470,1672643068,1672645372,2304
11571,3372079985,3791644831,1672590922,1672593854,2932
10064,3714424237,3780786276,1672642486,1672644909,2423
11391,3428303756,3683677062,1672703154,1672706082,2928
10584,3422205569,3910049345,1672647654,1672648851,1197
10218,3358434853,3756695502,1672598187,1672601129,2942
10744,3791409441,3716733618,1672605789,1672607779,1990
9887,3783563043,3501174621,1672588563,1672590494,1931
10136,3274239253,3311904032,1672628727,1672628883,156
10438,3512697456,3757089924,1672538105,1672540860,2755
11453,3440582836,3792785261,1672576065,1672576138,73
10540,3511580693,3516588277,1672621801,1672624823,3022
11531,3500442370,3426468199,1672608108,1672610283,2175
11554,3772164469,3773848111,1672636905,1672637628,723
10432,3466655775,3779706467,1672543942,1672546114,2172
11664,3505769529,3474879231,1672544309,1672547356,3047
10891,3515715968,3420854927,1672620432,1672622195,1763
10421,3384151770,3701493094,1672618502,1672621137,2635
9865,3687024828,3772802020,1672653076,1672655202,2126
10919,3770457058,3774221318,1672536676,1672540108,3432
10559,3714074120,3406492167,1672663817,1672664407,590
9902,3603682643,3711856534,1672696902,1672697374,472
10810,3287094447,3776440009,1672585951,1672589160,3209
10788,3481365330,3777498160,1672543169,1672545807,2638
10177,3318056480,3817120976,1672698854,1672701748,2894
10777,3732871856,3770023722,1672539488,1672541352,1864
9972,3777715675,3778124514,1672688203,1672688839,636
10519,3755394177,3371759044,1672592874,1672593654,780
10552,3735152111,3703611876,1672604726,1672607440,2714
11610,3703502114,3312959324,1672554918,1672556364,1446
11094,3331228758,3713514933,1672559391,1672560777,1386
9982,3505032644,3915195160,1672678139,1672678572,433
10351,3485898181,3393376416,1672657887,1672660874,2987
11536,3703999217,3505828210,1672680941,1672682398,1457
10259,3276393542,3372617110,1672588716,1672590830,2114
11586,3366801723,3713927376,1672701763,1672702160,397
10437,3467663782,3332840671,1672688371,1672688441,70
9883,3469663062,3510919509,1672572242,1672572903,661
10988,3205948776,3468201976,1672674324,1672674900,576
11464,3486509752,3703614781,1672641833,1672645357,3524
11086,3281970147,3780626668,1672701755,1672702944,1189
10961,3925792265,3937747312,1672543111,1672545710,2599
11168,3714065165,3380185102,1672621155,1672624261,3106
11427,3430296808,3510153173,1672543458,1672545688,2230
11768,3774145748,3291936679,1672562205,1672565733,3528
10379,3701529552,3440671139,1672661565,1672664522,2957
11355,3515100211,3500433278,1672555965,1672559247,3282
10725,3297100323,3791368349,1672683889,1672685779,1890
9984,3288675710,3815440588,1672543881,1672546652,2771
10726,3505811269,3776124041,1672601472,1672604213,2741
10756,3500630465,3776732532,1672567258,1672567811,553
11229,3737745988,3756647451,1672586005,1672586638,633
11122,3792255406,3360525513,1672594844,1672596468,1624
10199,3516655509,3773534165,1672567434,1672568927,1493
10451,3774394000,3510775046,1672644171,1672644687,516
11480,3314363575,3293579860,1672601032,1672604486,3454
11516,3533017131,3373135211,1672541449,1672544010,2561
11181,3432762943,3774355339,1672671199,1672674693,3494
11393,3303772923,3517499844,1672532086,1672535550,3464
9841,3483347530,3475845921,1672685437,1672687573,2136
11268,3898965585,3756843139,1672697494,1672700749,3255
11013,3510335069,3359472956,1672668921,1672671776,2855
11629,3977209952,3909220912,1672544840,1672548371,3531
9929,3779102237,3783067048,1672587915,1672588400,485
11021,3519831322,3701865589,1672668950,1672671235,2285
10206,3427049290,3442564712,1672610504,1672612539,2035
11441,3515548696,3520012007,1672556462,1672556547,85
9978,3711518637,3501901313,1672631952,1672633841,1889
9845,3778738044,3369270860,1672641780,1672643918,2138
10831,3519513219,3510240661,1672653729,1672654552,823
11338,3855629383,3776581518,1672565428,1672565616,188
10651,3519322066,3421524698,1672643686,1672644699,1013
10810,3515507526,3512306195,1672625276,1672626238,962
10322,3512802259,3715140418,1672669457,1672670148,691
11070,3600978954,3359418136,1672566493,1672567303,810
10758,3468871103,3818904268,1672578429,1672580581,2152
10742,3801379377,3500198430,1672574905,1672576392,1487
11520,3302988745,3780733404,1672647815,1672647963,148
11173,3534168768,3467232654,1672578543,1672580812,2269
10470,3774706478,3818570577,1672571314,1672572197,883
11660,3505908965,3757212744,1672702750,1672705621,2871
10478,3793081195,3783086267,1672592046,1672592339,293
10295,3454343398,3774205060,1672628236,1672629925,1689
10902,3520553959,3716197140,1672670390,1672671757,1367
10948,3358262975,3902023467,1672654793,1672656772,1979
9843,3505811269,3515974881,1672682268,1672684687,2419
10668,3916673751,3820922991,1672667115,1672668715,1600
10377,3505190512,3760966645,1672699524,1672701099,1575
10520,3716341323,3337715675,1672595437,1672598350,2913
11078,3711856534,3834980281,1672602225,1672602385,160
10628,3316551382,3884192843,1672680649,1672683899,3250
10028,3716095450,3927675706,1672591840,1672593793,1953
10036,3311197635,3304661369,1672698682,1672702061,3379
11158,3715712376,3855440101,1672551714,1672554208,2494
9811,3772223331,3505825767,1672653490,1672656102,2612
10082,3446764595,3703849264,1672553983,1672554340,357
11151,3827889533,3837888196,1672700204,1672703405,3201
11488,3505173665,3711856534,1672555473,1672558589,3116
9918,3505853594,3513802404,1672677996,1672681057,3061
11040,3756876537,3621960662,1672599193,1672600746,1553
11727,3780206849,3620836520,1672577841,1672581352,3511
11134,3770276815,3602401154,1672576821,1672579098,2277
11114,3517991042,3932955949,1672639917,1672643398,3481
11026,3713139039,3971282455,1672653974,1672655167,1193
9838,3738526914,3629869834,1672538115,1672541687,3572
11055,3972729768,3444646562,1672565994,1672566960,966
10764,3776561263,3778741325,1672646385,1672647937,1552
11577,3501205057,3311521176,1672586687,1672589590,2903
10051,3701350519,3791532324,1672691083,1672692775,1692
10785,3500864577,3465227623,1672686183,1672686722,539
10637,3770105006,3756066702,1672548790,1672550495,1705
10041,3361711720,3905889514,1672577199,1672578612,1413
10723,3519703964,3778318250,1672652126,1672652802,676
10680,3425545115,3809216145,1672580460,1672583596,3136
11771,3853783593,3714787207,1672564701,1672567711,3010
10880,3715320359,3757796416,1672680443,1672681396,953
10816,3778706119,3755230010,1672676628,1672678526,1898
10752,3505500523,3205948776,1672664968,1672665555,587
10976,3505011956,3511458926,1672686596,1672689531,2935
10896,3422081502,3304447950,1672678556,1672679354,798
11338,3703732445,3336225953,1672657844,1672660006,2162
11659,3892177203,3738760498,1672532883,1672534251,1368
10111,3703614781,3793899166,1672562387,1672565082,2695
10226,3382670400,3755507566,1672585812,1672587253,1441
10371,3711287751,3774965463,1672633683,1672633965,282
10948,3380628097,3511311554,1672659678,1672659991,313
11632,3512337054,3441737317,1672666396,1672668101,1705
9928,3311463998,3701374160,1672676796,1672677820,1024
11527,3900793652,3793332600,1672672515,1672675926,3411
10380,3501977123,3500624846,1672572203,1672573068,865
10185,3500994763,3533929043,1672548497,1672550338,1841
10360,3716733618,3737571883,1672683037,1672686500,3463
10552,3305093237,3828354855,1672593968,1672594573,605
11239,3474097405,3496407500,1672663156,1672664173,1017
10356,3701725839,3534770827,1672698596,1672701798,3202
10273,3900766525,3500057674,1672534722,1672537246,2524
10245,3510240661,3701127475,1672681198,1672683935,2737
10695,3600842635,3235373942,1672659113,1672660472,1359
11287,3358385652,3519948471,1672548322,1672551663,3341
10168,3773840321,3505786561,1672680206,1672681304,1098
11544,3285971415,3850181934,1672539670,1672541935,2265
9931,3459694275,3783942518,1672647779,1672648546,767
9834,3802625412,3409514897,1672639988,1672642502,2514
11537,3510882576,3209958726,1672598528,1672599840,1312
10400,3416474842,3311904032,1672591131,1672592401,1270
9976,3977360666,3684108920,1672606476,1672609888,3412
11186,3772569860,3333477908,1672615684,1672618762,3078
11514,3701887470,3500440602,1672597846,1672599788,1942
11220,3480185839,3534204885,1672593458,1672596667,3209
11663,3533974355,3380285779,1672689614,1672690293,679
10963,3714525519,3417431173,1672565508,1672567614,2106
10545,3533830748,3713514933,1672653087,1672655843,2756
10321,3665841655,3393543588,1672670523,1672672046,1523
10459,3713191326,3514455363,1672559242,1672559453,211
11715,3483078667,3908883591,1672607846,1672609211,1365
9899,3703104365,3516153301,1672610112,1672612368,2256
10871,3302929858,3513293711,1672648985,1672651666,2681
10219,3533209168,3609925909,1672697496,1672698283,787
10753,3447267291,3302348002,1672599757,1672601850,2093
11755,3486509752,3922301238,1672634515,1672637974,3459
11496,3919719755,3783408469,1672587130,1672589726,2596
11037,3312959324,3927805949,1672667183,1672667790,607
11148,3703742071,3400560073,1672635133,1672635446,313
10456,3450679913,3500630465,1672647600,1672649169,1569
11011,3514013999,3715737742,1672577412,1672580986,3574
10101,3422460919,3774792696,1672554397,1672557841,3444
11723,3446764595,3471131277,1672673677,1672673993,316
11606,3272581469,3452878062,1672637621,1672640584,2963
10964,3533440736,3839308659,1672565208,1672567198,1990
11619,3510454018,3505248368,1672649344,1672650503,1159
10429,3826997668,3488988274,1672627474,1672627692,218
10283,3793274846,3779818784,1672701375,1672702538,1163
10587,3927202773,3553694590,1672680584,1672681221,637
11532,3701296091,3601340045,1672678192,1672679695,1503
11309,3479452888,3777204977,1672576194,1672578377,2183
10699,3344478603,3772131127,1672551515,1672552253,738
9845,3515970536,3398862999,1672652910,1672653856,946
11324,3248409083,3463564410,1672664161,1672667035,2874
9805,3802374620,3238796398,1672679920,1672682659,2739
9888,3757311529,3519997661,1672646610,1672648281,1671
11118,3716976932,3204473480,1672649972,1672650879,907
10789,3783809405,3714718326,1672614264,1672614637,373
11629,3505173665,3929002318,1672611963,1672613207,1244
11176,3602680347,3824259677,1672662610,1672664233,1623
10739,3201502111,3772169046,1672682912,1672685550,2638
11197,3814672661,3755107521,1672660766,1672661943,1177
11232,3701655378,3907088952,1672543116,1672545762,2646
11490,3970265139,3776034313,1672551173,1672552865,1692
11200,3249614888,3501208658,1672673473,1672674386,913
10109,3880562532,3286938590,1672588413,1672590804,2391
10353,3384713976,3777909822,1672668211,1672670758,2547
10029,3555763674,3480418192,1672655622,1672657769,2147
10170,3924366353,3341129425,1672640969,1672643186,2217
10459,3628423403,3517144269,1672550389,1672553553,3164
10678,3500720752,3638126174,1672681696,1672684845,3149
10275,3220798451,3757201138,1672667426,1672670725,3299
11254,3517325365,3777932581,1672650511,1672653634,3123
10016,3715622084,3770276815,1672625959,1672627062,1103
11534,3716801088,3304030474,1672550538,1672550719,181
10666,3427049290,3772968080,1672539390,1672540008,618
10880,3505998260,3896200048,1672640421,1672642463,2042
11636,3361952532,3302929858,1672607658,1672610150,2492
11553,3882905311,3351837521,1672642072,1672643037,965
10962,3833520635,3776183353,1672680408,1672683992,3584
10468,3500438542,3778713526,1672608982,1672610949,1967
10751,3688845298,3854202447,1672634804,1672637479,2675
11036,3516486526,3510486220,1672667694,1672669510,1816
11062,3710119555,3514107131,1672701450,1672704617,3167
9970,3399504157,3500440602,1672697950,1672699446,1496
11041,3534459983,3552922094,1672588805,1672590031,1226
11557,3518067857,3856699097,1672571191,1672572249,1058
11292,3820922991,3922301238,1672620939,1672622228,1289
10230,3501901313,3668154066,1672559566,1672561169,1603
11455,3520697518,3970775805,1672616600,1672619385,2785
10112,3774195369,3285515107,1672562960,1672565589,2629
11702,3778561231,3770709417,1672617902,1672618903,1001
10927,3290797257,3501253130,1672555065,1672558111,3046
11578,3282053097,3375257546,1672615952,1672617991,2039
10965,3777063455,3830254808,1672607240,1672609375,2135
11389,3342056927,3533077580,1672641765,1672644955,3190
10088,3364660506,3223177147,1672658838,1672660544,1706
10036,3382757142,3438028077,1672649670,1672651503,1833
10365,3443521234,3513432588,1672670315,1672672061,1746
11263,3779609338,3770846374,1672532783,1672536175,3392
10202,3780213684,3318224774,1672663749,1672663856,107
11737,3533816813,3307791650,1672558543,1672559636,1093
11063,3239401337,3397527886,1672531596,1672532056,460
11269,3517083465,3738160394,1672639820,1672642583,2763
10995,3791905743,3552261072,1672611453,1672613876,2423
11747,3374147279,3495427619,1672588490,1672588684,194
10973,3793689267,3777672363,1672559955,1672561956,2001
10894,3660163550,3701374160,1672578678,1672579180,502
11131,3375906394,3311463998,1672621353,1672624134,2781
11139,3760537855,3452802329,1672641683,1672644041,2358
10701,3361635547,3233917789,1672627232,1672628450,1218
10531,3783947742,3428303756,1672647396,1672648651,1255
11477,3912862842,3710852576,1672606489,1672607430,941
11653,3505500665,3519108639,1672633104,1672633268,164
11571,3756345026,3505010941,1672633452,1672636825,3373
11499,3207586072,3777200549,1672538116,1672541635,3519
10693,3757623259,3711518637,1672651829,1672655377,3548
9936,3313392810,3517949586,1672571067,1672573299,2232
11079,3929002318,3452802329,1672573355,1672575927,2572
11695,3500049870,3826542169,1672576908,1672578945,2037
9939,3510149298,3380628097,1672541053,1672543226,2173
11685,3501174621,3533419409,1672667941,1672668180,239
11587,3517227599,3773475506,1672694745,1672697641,2896
10627,3626631210,3770533675,1672610453,1672613213,2760
10895,3916924978,3886896755,1672670380,1672673699,3319
9831,3682086200,3792107875,1672532789,1672533660,871
10628,3471996194,3609335008,1672664158,1672664912,754
10187,3791758175,3500211484,1672576483,1672578305,1822
11620,3278443807,3710271021,1672637834,1672641323,3489
11473,3461630842,3792455305,1672627371,1672629794,2423
10681,3475090917,3627081426,1672557572,1672559823,2251
10497,3713224038,3533726421,1672592040,1672594930,2890
11656,3510149298,3534081527,1672616800,1672617847,1047
11048,3760397450,3703818358,1672682263,1672683968,1705
10481,3783021859,3911821258,1672556936,1672560364,3428
10413,3430296808,3715246385,1672606901,1672608392,1491
10877,3340897079,3223177147,1672695862,1672699284,3422
11750,3222364320,3510547682,1672634404,1672636259,1855
10553,3409078869,3387870683,1672652901,1672653274,373
10854,3688130094,3226172318,1672664918,1672667492,2574
11475,3558264627,3512726649,1672654308,1672656918,2610
9796,3922153821,3924583142,1672660277,1672663212,2935
10867,3490008012,3856975623,1672689307,1672690545,1238
11023,3275171954,3446537819,1672648305,1672649950,1645
11605,3936486724,3500640854,1672650123,1672653096,2973
10089,3554174421,3772980989,1672582656,1672583674,1018
10660,3713476192,3710695372,1672672372,1672675147,2775
10115,3776867553,3355899481,1672656609,1672657160,551
10562,3513143959,3916955566,1672564729,1672566429,1700
10518,3370961012,3444397804,1672690417,1672692268,1851
11359,3774483862,3384151770,1672598245,1672598552,307
11446,3778402454,3919494952,1672604564,1672605170,606
11570,3703031637,3390444181,1672626939,1672628767,1828
9913,3440991826,3703419800,1672699817,1672700516,699
10786,3850005949,3791359168,1672684885,1672686510,1625
11055,3388937390,3287403291,1672574799,1672577666,2867
10439,3773876312,3373018943,1672551060,1672552290,1230
10904,3898989233,3701655378,1672649095,1672650694,1599
9832,3231963246,3409078869,1672637035,1672637167,132
11074,3977157565,3475830203,1672656979,1672659023,2044
11297,3392482187,3686885442,1672550113,1672550826,713
10369,3802625412,3279731391,1672538839,1672541162,2323
10965,3792900315,3773738817,1672692594,1672693695,1101
11676,3636885498,3836586875,1672614551,1672617435,2884
10423,3703277359,3739567072,1672638756,1672640570,1814
10248,3916924978,3755394177,1672571406,1672574125,2719
10483,3415840750,3885339157,1672654589,1672655717,1128
11771,3757406215,3475653510,1672552083,1672554948,2865
10928,3518534560,3780982229,1672564497,1672567723,3226
10690,3516969689,3205161801,1672642454,1672644852,2398
10641,3452878062,3837378340,1672591727,1672592273,546
9874,3770285500,3791224239,1672613156,1672613958,802
10757,3894328297,3755502373,1672687359,1672690404,3045
10877,3318590083,3512965991,1672665499,1672666883,1384
10166,3375906394,3387413950,1672657512,1672659204,1692
10301,3550206045,3403120725,1672669294,1672672340,3046
9959,3434052463,3472561941,1672617498,1672619282,1784
10191,3770424941,3776187150,1672666422,1672666893,471
11780,3822634862,3533703578,1672653530,1672656626,3096
10019,3770023722,3735838864,1672626413,1672627734,1321
11113,3778824229,3501192566,1672652553,1672653730,1177
10536,3713954144,3201656220,1672694826,1672695797,971
11103,3510795808,3334708091,1672637530,1672639805,2275
10404,3791587717,3379666159,1672540484,1672541417,933
11535,3283785820,3518478484,1672566995,1672570075,3080
10037,3345954031,3501927452,1672578167,1672580918,2751
10581,3837271330,3772251279,1672619912,1672621977,2065
10521,3917004141,3387700451,1672628321,1672629501,1180
11454,3685645561,3757311529,1672667217,1672670693,3476
10257,3711836873,3770574826,1672690660,1672691761,1101
9795,3927805949,3777041132,1672534451,1672535062,611
11581,3778402454,3756272704,1672621143,1672622640,1497
11701,3311305760,3688870751,1672653516,1672653825,309
11399,3440991826,3338195686,1672594856,1672595494,638
11300,3713920790,3359012188,1672601528,1672604564,3036
10104,3814378625,3358211034,1672539336,1672539972,636
10406,3977880564,3202740652,1672693729,1672696805,3076
11405,3805616707,3837435907,1672582687,1672585187,2500
10723,3713767153,3791074200,1672641120,1672643377,2257
10690,3711591464,3776304080,1672683083,1672686459,3376
10348,3919211457,3770441717,1672701769,1672702355,586
10435,3437108337,3461931154,1672699635,1672701349,1714
10483,3616403486,3832902787,1672702294,1672705835,3541
11109,3505066871,3713878219,1672626417,1672628162,1745
10137,3682673884,3275661834,1672625281,1672628181,2900
11509,3770019143,3760710525,1672683186,1672685509,2323
11664,3501628472,3475033290,1672648607,1672650328,1721
10720,3505811269,3295691964,1672586327,1672588504,2177
10712,3520016705,3520506192,1672655036,1672655604,568
11634,3450511428,3516019206,1672599764,1672599934,170
10986,3505756991,3510869438,1672701072,1672701238,166
11685,3939851140,3710891331,1672653471,1672653902,431
9896,3501927452,3411213032,1672581988,1672583790,1802
9939,3601063076,3711171132,1672586802,1672590109,3307
11594,3884388188,3505066871,1672616306,1672619885,3579
10231,3770764940,3515753241,1672551732,1672552066,334
10144,3774205060,3779609338,1672532348,1672534527,2179
10795,3515230715,3311410533,1672549253,1672550603,1350
11219,3773876312,3301449986,1672617702,1672619737,2035
11649,3839417558,3514455363,1672659488,1672661289,1801
11288,3897500723,3509382404,1672665959,1672668819,2860
10853,3783947742,3403257752,1672553180,1672556128,2948
11496,3337673625,3887502536,1672657610,1672658619,1009
11311,3757639274,3200785194,1672657816,1672661339,3523
11221,3402580733,3716595760,1672664043,1672667182,3139
10985,3780294116,3511526885,1672666837,1672669667,2830
10672,3932491622,3774682234,1672626733,1672627818,1085
9902,3332124606,3500693568,1672649383,1672651677,2294
11606,3311188620,3713923960,1672699941,1672700116,175
10520,3909822999,3622654885,1672638996,1672639514,518
9823,3462645981,3776348472,1672577839,1672579547,1708
10207,3736010012,3464622743,1672685496,1672687719,2223
10202,3513140146,3776901443,1672573561,1672574101,540
10060,3680988889,3755286041,1672662308,1672663851,1543
11167,3533265491,3821103640,1672635208,1672637490,2282
10653,3667654673,3780467276,1672561993,1672563732,1739
11619,3275735969,3553694590,1672659879,1672662324,2445
10127,3770285500,3288791629,1672537190,1672540390,3200
10903,3534491112,3732467455,1672595580,1672597373,1793
10841,3780050328,3220987526,1672665062,1672665875,813
10389,3912811715,3830771832,1672625608,1672628799,3191
11067,3701841013,3853275529,1672539084,1672540340,1256
11725,3793822639,3760656396,1672610539,1672612186,1647
11074,3934070285,3230250213,1672671034,1672673674,2640
10558,3313392810,3738526914,1672690444,1672693035,2591
11522,3701978422,3319660530,1672627009,1672629658,2649
10478,3757660578,3703336988,1672627788,1672630383,2595
11337,3772250554,3730115019,1672553341,1672556786,3445
11139,3703048107,3715622084,1672569825,1672571685,1860
10844,3221736756,3366433035,1672584834,1672586560,1726
10843,3519059808,3773953689,1672703677,1672704403,726
10249,3600978954,3501356814,1672694754,1672697866,3112
10304,3716285196,3304672737,1672637489,1672640031,2542
10674,3711171132,3225356349,1672533290,1672533814,524
11025,3773579644,3501901313,1672686649,1672688827,2178
10789,3701519251,3509355477,1672616385,1672617232,847
11645,3352295704,3773434690,1672660954,1672663842,2888
10543,3912625932,3496579251,1672625607,1672627493,1886
11460,3713990030,3779478448,1672572960,1672574996,2036
10821,3361952532,3311410533,1672581509,1672584819,3310
10537,3710813103,3438204844,1672579884,1672581051,1167
10445,3660246433,3780982229,1672534309,1672536491,2182
10382,3757030923,3285201542,1672611192,1672612350,1158
10118,3505500523,3501557463,1672573853,1672575945,2092
10007,3241682278,3533340292,1672627260,1672630768,3508
10339,3915460293,3500120676,1672587047,1672590573,3526
11241,3533265491,3714283424,1672627514,1672628314,800
11726,3931917809,3884862164,1672634812,1672638357,3545
11265,3501548163,3514585995,1672687284,1672689213,1929
11093,3311583437,3516429380,1672612605,1672616033,3428
9950,3792107875,3760385591,1672603186,1672606113,2927
10612,3661543201,3783594729,1672584296,1672586921,2625
10429,3713805968,3755107521,1672622087,1672625666,3579
11689,3513213122,3713283029,1672557639,1672559647,2008
10375,3793987483,3755989680,1672670825,1672672779,1954
11373,3776447604,3398151217,1672649322,1672652873,3551
11787,3603682643,3501828287,1672696887,1672697744,857
11082,3364302157,3760416450,1672570739,1672572231,1492
10970,3838119022,3513777705,1672673993,1672675559,1566
10023,3760997159,3711196962,1672637566,1672639180,1614
11214,3516572212,3791106473,1672651745,1672653721,1976
10895,3607288879,3713069234,1672567007,1672569785,2778
11422,3304592684,3288920399,1672601347,1672602221,874
10181,3716475340,3300810210,1672594811,1672596891,2080
10556,3817029483,3206926634,1672534782,1672536678,1896
11734,3505685294,3792455305,1672589046,1672589904,858
10303,3609166109,3780786276,1672612052,1672613798,1746
11449,3511095300,3770764940,1672703255,1672706030,2775
9870,3409078869,3660702754,1672699524,1672701707,2183
9953,3274239253,3760554453,1672614563,1672615666,1103
11290,3737946004,3760390822,1672542592,1672546022,3430
10541,3716676869,3701284535,1672696209,1672698290,2081
10102,3701028092,3335974305,1672593891,1672597457,3566
10977,3793232021,3364067937,1672595979,1672599027,3048
10492,3832333115,3512490032,1672599101,1672602207,3106
11100,3311810583,3443102414,1672639873,1672642767,2894
11250,3516655509,3332124606,1672571785,1672573286,1501
10780,3374348845,3715126587,1672640308,1672643470,3162
11675,3533974355,3311197635,1672643947,1672644415,468
10542,3393128259,3411355804,1672621258,1672622117,859
9928,3824135033,3244098077,1672639686,1672641897,2211
10827,3362385373,3436774112,1672637189,1672637549,360
11133,3780148144,3854957153,1672553163,1672555669,2506
10020,3511640720,3282053097,1672630118,1672631896,1778
10172,3716944983,3770533588,1672616518,1672618465,1947
10820,3399734748,3332124606,1672685555,1672687335,1780
10505,3713139039,3500456339,1672552700,1672553079,379
11237,3513250976,3512750313,1672540451,1672543346,2895
11229,3884933821,3361865467,1672554462,1672555503,1041
10006,3899205452,3311583437,1672564005,1672565384,1379
11789,3305656670,3791194984,1672647824,1672650836,3012
11535,3711770773,3509431396,1672574895,1672576675,1780
11143,3501828287,3290797257,1672595095,1672596055,960
11073,3780287649,3910049345,1672601451,1672602398,947
10065,3533703578,3715441777,1672678557,1672680978,2421
11638,3773697080,3509445318,1672593646,1672596582,2936
10637,3773768643,3801501384,1672537136,1672537524,388
11724,3824657614,3513186578,1672663377,1672664958,1581
11521,3515558215,3304227085,1672641172,1672643770,2598
10880,3512411326,3760656396,1672583935,1672585586,1651
10957,3711810752,3756763585,1672642802,1672645695,2893
11206,3911821258,3221126799,1672698573,1672701590,3017
11726,3512072679,3352044245,1672624048,1672624541,493
10171,3371132167,3792267993,1672695707,1672698147,2440
10765,3895507040,3907923381,1672624845,1672628241,3396
10034,3701655378,3715419141,1672669428,1672669895,467
11611,3505414878,3512251592,1672691139,1672691454,315
11541,3773475506,3284865931,1672584804,1672586856,2052
11011,3757598610,3517469005,1672542336,1672545232,2896
10544,3791332061,3770276815,1672636322,1672639113,2791
11617,3756119976,3246567963,1672629187,1672632449,3262
11542,3482172065,3511650296,1672604971,1672608083,3112
11220,3515974881,3776034313,1672672009,1672672849,840
11547,3233712975,3505472087,1672678352,1672678628,276
10270,3756157377,3602680347,1672615941,1672619193,3252
10998,3772216305,3318220119,1672642817,1672643027,210
9899,3361865467,3783651407,1672655035,1672657031,1996
10449,3234445133,3285136057,1672660685,1672662237,1552
10244,3461877104,3908878965,1672533805,1672534806,1001
11644,3733423371,3533017131,1672662170,1672663097,927
11638,3713336088,3364660506,1672666612,1672669553,2941
10673,3909220912,3500456339,1672550240,1672551090,850
10962,3520697518,3505980138,1672641233,1672643053,1820
11718,3622218289,3371564186,1672656091,1672657077,986
10055,3514737648,3917004141,1672664486,1672666500,2014
11217,3818904268,3893932944,1672577014,1672577115,101
11343,3703659324,3415032547,1672656948,1672659359,2411
10044,3978643889,3436774112,1672668956,1672669197,241
10026,3703443664,3332010532,1672576703,1672578888,2185
11165,3458432407,3773394570,1672645223,1672647643,2420
10978,3701779683,3370961012,1672679080,1672681014,1934
10174,3393502004,3488988274,1672686323,1672688345,2022
10603,3278805844,3714903253,1672566720,1672567968,1248
10613,3755229631,3733411026,1672666422,1672667002,580
10295,3778713526,3777655401,1672601569,1672603770,2201
10224,3208962614,3917004141,1672634366,1672637908,3542
10549,3757150421,3334936138,1672667527,1672670787,3260
9794,3515047288,3361926328,1672614914,1672616249,1335
10820,3804707712,3500221079,1672655547,1672656685,1138
10010,3732223664,3311696372,1672595984,1672597069,1085
10137,3236563828,3515047288,1672589027,1672589734,707
9877,3520763492,3500444748,1672575199,1672577941,2742
10228,3412605548,3331471764,1672620677,1672621820,1143
11620,3714892312,3435652260,1672669390,1672669988,598
11761,3838423363,3774483862,1672623682,1672623830,148
10433,3811503860,3616403486,1672556445,1672558278,1833
9833,3774359137,3520553959,1672595706,1672597475,1769
10867,3733836732,3388830370,1672575450,1672578474,3024
11032,3715106566,3341985886,1672613436,1672615208,1772
10031,3367262509,3770480149,1672562514,1672564436,1922
11403,3859191694,3605760561,1672547294,1672550151,2857
10451,3783373085,3520832066,1672670322,1672671166,844
11423,3443521234,3500909455,1672648098,1672649329,1231
10975,3513624915,3205161801,1672696945,1672697490,545
11609,3977666815,3933872044,1672636966,1672637821,855
10511,3730348493,3436018575,1672659859,1672660113,254
10634,3559754304,3513586642,1672686576,1672688493,1917
11094,3777370992,3314965818,1672588865,1672591494,2629
10114,3777387533,3703462221,1672667702,1672669460,1758
11641,3303552616,3459694275,1672552931,1672553507,576
9855,3716982179,3716285196,1672631640,1672634214,2574
10460,3624872714,3465690527,1672643777,1672647082,3305
10729,3756761603,3915195160,1672647744,1672648672,928
10764,3891272544,3516965624,1672538184,1672540504,2320
10744,3500590302,3415803494,1672626269,1672627010,741
11448,3280208630,3247845642,1672545256,1672545631,375
10514,3520362238,3428198021,1672639637,1672642068,2431
11743,3510795808,3513171472,1672608912,1672612346,3434
11264,3703423962,3819315404,1672572188,1672574442,2254
10902,3439532406,3716841469,1672653060,1672656227,3167
9802,3716676869,3780648744,1672659916,1672662474,2558
10202,3202740652,3371132167,1672558462,1672560106,1644
10161,3852461753,3291936679,1672701838,1672703277,1439
9932,3533209168,3716467469,1672696583,1672699656,3073
11668,3716020849,3411355804,1672563811,1672564677,866
9957,3510484107,3509377714,1672579694,1672580072,378
9908,3520395850,3738526914,1672673592,1672677062,3470
11442,3510535683,3793497672,1672680705,1672680885,180
10084,3352295704,3902300755,1672643173,1672644298,1125
11589,3513215373,3971280379,1672564730,1672566437,1707
11763,3225554956,3857590978,1672601243,1672603812,2569
11531,3279851026,3227206772,1672591689,1672592029,340
11136,3475653510,3220987526,1672562077,1672562597,520
11544,3779818784,3516249472,1672649728,1672651354,1626
9978,3236886943,3778731000,1672563112,1672566119,3007
9958,3715284599,3229734741,1672666656,1672667666,1010
10009,3519059808,3515378306,1672606899,1672607334,435
10865,3609644043,3505010941,1672643226,1672645977,2751
11252,3760737203,3793442891,1672678900,1672680937,2037
10093,3226913558,3520725149,1672638296,1672640158,1862
9906,3701685828,3813276198,1672551756,1672552843,1087
10558,3447696555,3662522808,1672666151,1672666726,575
10349,3377311502,3491758029,1672640240,1672641261,1021
10612,3715196780,3780467276,1672555418,1672558612,3194
11769,3710223875,3777672363,1672648515,1672648722,207
10589,3737467358,3352374868,1672641535,1672641668,133
11413,3429610195,3513800589,1672566330,1672568032,1702
10996,3395615598,3276230295,1672611223,1672612047,824
11499,3510882576,3364067937,1672607145,1672609169,2024
10545,3939422411,3701893620,1672685624,1672686165,541
10574,3793732968,3309178914,1672697321,1672699989,2668
11506,3838039092,3279731391,1672608572,1672609867,1295
10424,3450342110,3739395381,1672698312,1672698592,280
11243,3614484939,3716389356,1672694095,1672694569,474
11302,3732533330,3518989186,1672585506,1672588015,2509
11476,3421040626,3668154066,1672678428,1672679011,583
9891,3533593766,3509556649,1672648533,1672651340,2807
11454,3896123242,3755688231,1672645912,1672647261,1349
10716,3429047448,3908464960,1672616205,1672617190,985
10642,3534531061,3309455369,1672658160,1672658599,439
10849,3498857406,3511671476,1672576716,1672579236,2520
11102,3715441777,3278443807,1672535844,1672537988,2144
9981,3779930476,3810818108,1672618038,1672619414,1376
10961,3770180844,3407734098,1672677312,1672680005,2693
10354,3500073824,3800434325,1672609387,1672611451,2064
11188,3403395712,3533726421,1672617054,1672618804,1750
11398,3825234433,3353194923,1672579789,1672581087,1298
11131,3505482210,3756272704,1672543405,1672543584,179
11018,3609166109,3206544535,1672694001,1672694317,316
10881,3638823001,3520155898,1672545180,1672547876,2696
11182,3381254180,3519997661,1672679847,1672683296,3449
10895,3688410383,3367242388,1672601702,1672604189,2487
10770,3815700240,3514329209,1672660104,1672660699,595
9978,3290060215,3311264420,1672618099,1672619242,1143
11291,3318220119,3515378306,1672576367,1672576576,209
11283,3393128259,3780786276,1672595559,1672597735,2176
9859,3770631449,3478052226,1672594739,1672597509,2770
11194,3511744756,3397527886,1672693140,1672696192,3052
10718,3971282455,3630462406,1672648066,1672650437,2371
11196,3760382349,3501004005,1672576848,1672577164,316
10030,3821103640,3385416697,1672622991,1672623743,752
10757,3710060386,3711870537,1672592225,1672595580,3355
11178,3621812406,3534604516,1672589861,1672591949,2088
10836,3783176874,3443191792,1672692157,1672692336,179
10278,3908883591,3756168814,1672664113,1672665842,1729
11471,3500356342,3399430522,1672553987,1672554791,804
10960,3421674406,3505010941,1672681627,1672684191,2564
10804,3430032005,3380357490,1672563923,1672564020,97
9899,3500438542,3371184929,1672656982,1672660254,3272
11385,3773424266,3200785194,1672616291,1672618241,1950
10820,3403218814,3710695372,1672627642,1672629577,1935
11279,3208560443,3423940256,1672541758,1672543158,1400
10495,3686860179,3606804618,1672587044,1672590236,3192
10432,3807486812,3478052226,1672616137,1672617083,946
11737,3519848902,3494560663,1672699354,1672701177,1823
10352,3667654673,3422081502,1672694422,1672697536,3114
10044,3441840658,3516321814,1672563808,1672566737,2929
10521,3933106901,3511794841,1672554897,1672557628,2731
11479,3514508773,3519046342,1672606536,1672609241,2705
10731,3907225070,3701060732,1672555158,1672558588,3430
10658,3730571757,3852461753,1672559881,1672563395,3514
10808,3464622743,3701529552,1672688772,1672689092,320
11415,3715039960,3783594246,1672535769,1672538767,2998
10140,3380281484,3500234771,1672621627,1672624612,2985
10357,3423800775,3776407517,1672698635,1672701134,2499
11397,3778695895,3792107875,1672531928,1672533699,1771
10169,3510547682,3820200446,1672547288,1672548575,1287
10243,3710147457,3701769970,1672531336,1672533871,2535
11503,3399430522,3511476353,1672659394,1672661663,2269
10469,3511296895,3804707712,1672532811,1672536218,3407
11523,3418683594,3773432494,1672533571,1672534228,657
11108,3779478448,3821082558,1672688701,1672690891,2190
10540,3779427180,3517992521,1672666142,1672666240,98
10881,3613781977,3516651799,1672581489,1672584991,3502
10746,3553321027,3519922921,1672656458,1672659834,3376
10615,3423217578,3857344874,1672554263,1672555280,1017
10172,3880562532,3757639274,1672641849,1672643787,1938
11749,3287734830,3773697080,1672576707,1672579509,2802
11008,3306037126,3689223632,1672647325,1672649019,1694
10940,3515970536,3774450494,1672572309,1672573342,1033
10538,3500543341,3734957248,1672578241,1672579040,799
10986,3711287751,3469663062,1672674532,1672675058,526
9808,3830771832,3682241594,1672531730,1672532632,902
10636,3779393140,3513764665,1672703130,1672704856,1726
11507,3461630842,3338187803,1672666074,1672669635,3561
10957,3517551721,3447267291,1672676239,1672679059,2820
10729,3755374000,3505936495,1672535772,1672536942,1170
10371,3487395357,3505359060,1672669995,1672670622,627
10936,3513545735,3501515425,1672544973,1672547677,2704
9897,3354015456,3755736024,1672573338,1672576214,2876
10455,3760481622,3774238066,1672687162,1672688384,1222
11518,3469663062,3755238321,1672591602,1672592089,487
11371,3971280379,3756781024,1672605620,1672608746,3126
11726,3519513219,3773848111,1672697372,1672698948,1576
10848,3783506190,3513661302,1672576628,1672577983,1355
11283,3703697059,3236563828,1672567957,1672571082,3125
10898,3792063616,3427049290,1672663907,1672665526,1619
10353,3929446196,3505032773,1672689016,1672690050,1034
10342,3512769522,3780238637,1672551941,1672555538,3597
11266,3714074120,3228477490,1672648120,1672650847,2727
9832,3756695502,3513629502,1672568677,1672570739,2062
10611,3334488428,3446764595,1672532162,1672533024,862
11627,3505547832,3360525513,1672633708,1672635023,1315
10264,3715419141,3609997804,1672626504,1672626957,453
11037,3453538201,3973582279,1672559867,1672563307,3440
11728,3772262649,3603452936,1672568027,1672570266,2239
10396,3473520701,3388537708,1672670146,1672671128,982
11654,3512645289,3404187438,1672559367,1672561019,1652
10563,3278443807,3780224882,1672563724,1672566183,2459
9877,3780900318,3713514933,1672535687,1672538602,2915
9929,3487779363,3283847934,1672538094,1672541529,3435
10310,3490804766,3501873139,1672539274,1672540427,1153
9928,3669427589,3821087562,1672668024,1672668311,287
10725,3509562377,3780050146,1672600985,1672602594,1609
11130,3510542303,3480185839,1672632506,1672634529,2023
10858,3713195480,3534372899,1672649895,1672652337,2442
11168,3805926853,3621960662,1672539680,1672540684,1004
10338,3711258452,3760748418,1672614400,1672615711,1311
10868,3713100169,3221736756,1672621779,1672625174,3395
11539,3856897914,3519228207,1672554265,1672557663,3398
11395,3277634944,3774109138,1672594927,1672596577,1650
11336,3777641081,3713219299,1672634504,1672637126,2622
9886,3755507566,3511750850,1672588117,1672590368,2251
10986,3757201138,3714645218,1672589234,1672592264,3030
10003,3514685272,3772320856,1672588831,1672591984,3153
10397,3491758029,3791205793,1672662893,1672664140,1247
9862,3881012415,3770544738,1672552617,1672555337,2720
10051,3304661369,3774539067,1672637161,1672637599,438
11604,3738734246,3500922040,1672616279,1672619474,3195
10685,3241855333,3791435852,1672642144,1672645351,3207
10496,3715790104,3780435349,1672548154,1672549103,949
10669,3249380931,3733730342,1672665438,1672666000,562
10853,3779174993,3369270860,1672605758,1672605819,61
10215,3519260216,3714264759,1672582293,1672585661,3368
10175,3814378625,3606688595,1672691207,1672693515,2308
11192,3306475287,3972856326,1672701992,1672704458,2466
10791,3703732445,3519297683,1672574710,1672576651,1941
9861,3371132167,3402774497,1672612172,1672614362,2190
10322,3916955566,3838748301,1672687921,1672688057,136
11382,3439045964,3791574640,1672647298,1672649173,1875
10593,3416105769,3809871495,1672564780,1672566110,1330
11135,3287689454,3462985379,1672556533,1672559896,3363
10109,3895839169,3235198316,1672592250,1672593510,1260
10542,3429047448,3792972270,1672609211,1672612486,3275
11673,3882905311,3791841318,1672617328,1672617715,387
11236,3770019143,3919349138,1672563090,1672563302,212
10339,3510159441,3311472321,1672623074,1672624231,1157
10138,3792512768,3935333166,1672624977,1672627478,2501
11505,3509317776,3893932944,1672533595,1672536641,3046
10025,3812559393,3500104976,1672559821,1672563217,3396
10083,3793029132,3400793223,1672642242,1672645024,2782
10627,3714065165,3512555384,1672550912,1672554132,3220
9836,3485898181,3896123242,1672581205,1672583894,2689
10638,3714883746,3230250213,1672558920,1672562395,3475
10803,3309528048,3491239350,1672602360,1672603632,1272
10772,3857244486,3817478012,1672619128,1672621686,2558
10046,3756536476,3500051606,1672615778,1672617758,1980
11401,3701512498,3501835995,1672561275,1672561859,584
11659,3664478769,3780786276,1672604790,1672605493,703
9847,3533030343,3715737742,1672576535,1672578456,1921
10307,3834456158,3791382196,1672552648,1672555163,2515
9863,3770671714,3511744756,1672621556,1672624722,3166
9877,3774273260,3831981073,1672548543,1672549928,1385
10673,3611939581,3805704844,1672679072,1672682602,3530
10127,3779282072,3500356342,1672657203,1672658737,1534
10613,3315432466,3379517265,1672665136,1672668368,3232
10580,3515558215,3972196462,1672598450,1672599489,1039
9955,3343511947,3779282072,1672532388,1672534557,2169
9946,3378534521,3200320674,1672562062,1672562616,554
10912,3284334297,3500087325,1672543724,1672544296,572
10454,3893629892,3716118473,1672671782,1672673121,1339
11108,3621591266,3516321814,1672656556,1672659628,3072
10771,3896200048,3715622084,1672531346,1672534316,2970
11134,3770715115,3757549235,1672560479,1672560743,264
11520,3770533675,3713547793,1672533145,1672533274,129
10414,3773688906,3770408300,1672576304,1672578388,2084
10420,3207307681,3510826414,1672616835,1672617001,166
10978,3614484939,3914947393,1672677308,1672680209,2901
10375,3444680955,3398151217,1672702528,1672702639,111
11219,3780168985,3519730914,1672684784,1672687370,2586
9935,3780224882,3783176874,1672569308,1672570822,1514
10895,3468343480,3466149998,1672591678,1672594246,2568
10116,3505502819,3626631210,1672665096,1672666664,1568
10262,3757549235,3510882576,1672601130,1672604558,3428
10749,3773554767,3534491112,1672582892,1672584710,1818
11267,3500596577,3510250740,1672567229,1672569614,2385
10512,3897500723,3370448531,1672657742,1672660813,3071
10509,3701028092,3713471446,1672566068,1672568627,2559
11695,3203151036,3776732532,1672614518,1672617867,3349
11759,3511415786,3858330969,1672546086,1672548743,2657
10440,3884191432,3791796190,1672572786,1672574568,1782
10339,3770631449,3500793739,1672702719,1672703168,449
11146,3517151644,3814672661,1672572311,1672573075,764
9929,3514306458,3773032706,1672691996,1672694410,2414
11751,3780298499,3711243126,1672675807,1672676046,239
10015,3515939841,3703588004,1672640854,1672641726,872
11451,3430296808,3938021614,1672597813,1672600963,3150
10902,3516359146,3517253559,1672659954,1672661700,1746
11322,3756948477,3902357342,1672693995,1672697034,3039
10871,3774273260,3793948300,1672571757,1672575079,3322
10218,3715923089,3533566754,1672677596,1672677972,376
11669,3760679372,3760648750,1672535660,1672537149,1489
9975,3710852576,3780467276,1672667875,1672669767,1892
10032,3971282455,3304447950,1672675338,1672675624,286
10660,3519922921,3511750695,1672550958,1672551120,162
10083,3533703578,3505164060,1672564146,1672565589,1443
11731,3817029483,3377883705,1672577874,1672581196,3322
11437,3792987243,3480108752,1672548413,1672549241,828
10678,3316551382,3610806770,1672656268,1672656646,378
9812,3438470128,3420854927,1672621314,1672622607,1293
11555,3778044082,3519908593,1672665521,1672666607,1086
10971,3428325402,3804707712,1672593251,1672596277,3026
10578,3825153408,3772905073,1672564065,1672564766,701
10817,3516668203,3404375908,1672670328,1672673200,2872
9804,3238779889,3293553295,1672539228,1672541264,2036
10326,3715008501,3714787207,1672693050,1672693844,794
11249,3366961580,3757592622,1672599912,1672602120,2208
10514,3783067048,3505011956,1672584049,1672587583,3534
9854,3772968080,3241593146,1672659177,1672662507,3330
9956,3505183641,3501992314,1672632991,1672634727,1736
10296,3380285779,3240622654,1672621079,1672622078,999
11020,3620105539,3939882169,1672686917,1672688794,1877
10690,3361952532,3512087090,1672547107,1672548341,1234
11226,3505908965,3233917789,1672693892,1672696454,2562
10453,3894756677,3500011591,1672564718,1672565017,299
10033,3206544535,3663902064,1672609086,1672611255,2169
11050,3493679801,3200320674,1672579804,1672582830,3026
11241,3294326116,3367299721,1672579553,1672579651,98
11346,3908464960,3633860380,1672664804,1672665951,1147
10048,3534506090,3270502801,1672579327,1672581826,2499
10510,3915652382,3805718871,1672685377,1672688323,2946
11304,3780511388,3368951504,1672689116,1672690303,1187
11693,3638050763,3534174363,1672672112,1672672982,870
11609,3500654356,3792440162,1672634528,1672635745,1217
10256,3773688906,3393543588,1672657998,1672659847,1849
10103,3518088154,3500433278,1672666732,1672669008,2276
10525,3487231844,3293540333,1672652216,1672652717,501
11707,3716492409,3247545468,1672611513,1672613288,1775
11102,3716341323,3756717136,1672655882,1672658671,2789
9876,3793332600,3519951586,1672669755,1672672184,2429
11319,3779102237,3204149913,1672578683,1672582235,3552
11602,3484483775,3971051020,1672636529,1672639061,2532
9882,3509508477,3660163550,1672701802,1672704073,2271
11558,3501205057,3772216305,1672610774,1672611026,252
10958,3933731871,3713969196,1672642000,1672644010,2010
10774,3381244346,3913847876,1672656064,1672658841,2777
11761,3639926564,3783357035,1672693949,1672697118,3169
10637,3792900315,3776407517,1672600867,1672604243,3376
11661,3837887478,3380281484,1672629851,1672632904,3053
10279,3611298237,3662495290,1672631478,1672633608,2130
10989,3772648837,3480259863,1672655766,1672658099,2333
10783,3622654885,3972847837,1672546688,1672547509,821
11696,3813111107,3299847117,1672595830,1672597463,1633
10564,3710919244,3616371564,1672565228,1672566920,1692
10903,3441944896,3772905073,1672628563,1672630836,2273
10873,3471131277,3668955834,1672616665,1672618132,1467
11131,3776841808,3776447604,1672578268,1672579030,762
10162,3221126799,3511963020,1672634991,1672637383,2392
9914,3424988692,3683677062,1672676831,1672679035,2204
9881,3245642576,3839308659,1672677228,1672680631,3403
10778,3714690161,3444295435,1672684434,1672687609,3175
9807,3205687719,3505011956,1672677098,1672679265,2167
10897,3382757142,3756297396,1672632687,1672633851,1164
11443,3534937492,3669418238,1672550122,1672551559,1437
10757,3820280594,3832745283,1672633032,1672635180,2148
10432,3666561358,3422548081,1672553076,1672554704,1628
9816,3534168768,3715282492,1672562735,1672563380,645
11588,3428076194,3558203963,1672547402,1672548839,1437
10941,3516517348,3773876312,1672699252,1672701880,2628
11670,3667814788,3511069449,1672577420,1672578344,924
9922,3511729562,3378430760,1672573787,1672576917,3130
10675,3919349138,3714377201,1672603283,1672606782,3499
10302,3403738461,3770408300,1672602029,1672603147,1118
10546,3550405857,3374652108,1672586122,1672589295,3173
9963,3396472026,3783277159,1672621509,1672624075,2566
11790,3776732532,3388915945,1672695617,1672698265,2648
10062,3469350379,3622458047,1672567063,1672569170,2107
10669,3399943757,3505825767,1672549236,1672551517,2281
10463,3500456339,3302879906,1672622878,1672623526,648
11761,3837271330,3273242177,1672637566,1672637884,318
10199,3443191792,3500018566,1672558067,1672560400,2333
9979,3334633634,3922786716,1672611717,1672614194,2477
10451,3890211161,3534506090,1672665464,1672666497,1033
10212,3342837214,3886879696,1672656123,1672658189,2066
11610,3244495586,3278251248,1672679711,1672681353,1642
10910,3415562576,3914947393,1672619184,1672620705,1521
10423,3622729771,3534374523,1672580862,1672580983,121
11364,3780511388,3714951681,1672700489,1672701493,1004
11256,3483701493,3783594246,1672627082,1672629879,2797
11126,3760096466,3683047199,1672644593,1672646932,2339
11737,3682241594,3465227623,1672638838,1672640668,1830
11349,3245755569,3444598583,1672701595,1672702808,1213
11537,3929391979,3319645922,1672630426,1672633258,2832
11268,3500019810,3334936138,1672666734,1672669884,3150
9992,3520553959,3358982831,1672545305,1672546430,1125
10274,3703697059,3831981073,1672680195,1672680283,88
11031,3334488428,3975796415,1672690016,1672691853,1837
10673,3310737478,3738429905,1672676923,1672678045,1122
10869,3856975623,3501835995,1672638904,1672641912,3008
10345,3371184929,3791841318,1672562867,1672564673,1806
10189,3711179193,3497562878,1672624716,1672626170,1454
11691,3231963246,3666823095,1672686927,1672686994,67
10318,3512596743,3450503086,1672665242,1672665928,686
10113,3380285779,3499622352,1672554140,1672555040,900
10998,3665431349,3509677530,1672648186,1672650973,2787
10158,3514033319,3306066522,1672571183,1672572961,1778
10782,3780921044,3779312237,1672589904,1672591922,2018
10783,3660980656,3242082716,1672559596,1672560479,883
11304,3711119575,3713954144,1672581680,1672582835,1155
11504,3426207439,3559123082,1672664526,1672666836,2310
10898,3370512945,3510680251,1672581619,1672582064,445
10507,3777149336,3778817220,1672601364,1672602701,1337
9825,3458753033,3422548081,1672654562,1672656622,2060
11495,3713471446,3500079479,1672561764,1672562826,1062
10313,3200785194,3703999217,1672560199,1672563522,3323
11005,3444646562,3501927452,1672535545,1672536392,847
11691,3713954144,3783506190,1672608907,1672608968,61
11037,3501835995,3662495290,1672532056,1672533047,991
10127,3485468650,3431317400,1672675494,1672676901,1407
10893,3406492167,3342252701,1672532807,1672535946,3139
11099,3414510793,3925835590,1672696959,1672699607,2648
10122,3716841469,3534111498,1672619224,1672622177,2953
10801,3388774559,3519780867,1672652174,1672652256,82
10472,3301332095,3620836520,1672626816,1672628922,2106
10640,3512826895,3710819760,1672618621,1672620820,2199
11340,3711258452,3760416450,1672678379,1672679189,810
10067,3359880163,3604569804,1672699960,1672702620,2660
10693,3682150740,3921138062,1672685865,1672688688,2823
10235,3783021859,3881012415,1672557561,1672559764,2203
9965,3510218188,3619494735,1672554147,1672555265,1118
11134,3514007122,3801501384,1672703253,1672703997,744
10049,3703443664,3774633364,1672647108,1672648700,1592
10788,3421674406,3208519320,1672536462,1672538755,2293
11476,3515379622,3757199889,1672576200,1672578314,2114
10152,3664719070,3377250778,1672634632,1672635800,1168
10624,3533974355,3226913558,1672653457,1672654432,975
11507,3776778306,3703732445,1672583878,1672587008,3130
10686,3938021614,3817038422,1672660483,1672661857,1374
10018,3351728355,3793699467,1672640625,1672644190,3565
11537,3755286041,3802374620,1672680362,1672682559,2197
10074,3501927452,3500536897,1672698749,1672702085,3336
10351,3927181190,3812559393,1672695382,1672695899,517
10987,3836090778,3776316903,1672693296,1672695576,2280
11660,3812277991,3772251279,1672558533,1672558908,375
10877,3439651226,3273242177,1672577067,1672579402,2335
11763,3500793739,3519754667,1672568158,1672569183,1025
11535,3297684667,3514685272,1672656613,1672659642,3029
11760,3760854788,3247845642,1672594300,1672595491,1191
10486,3783122313,3500049870,1672637261,1672640056,2795
10808,3316551382,3701770921,1672700613,1672703612,2999
11258,3711770773,3394959062,1672658459,1672660795,2336
9975,3713990030,3313392810,1672689970,1672690087,117
10731,3776034313,3403870769,1672575921,1672577237,1316
11641,3661856558,3311305760,1672610643,1672613248,2605
10456,3701887470,3505521491,1672542192,1672545049,2857
9820,3853386575,3482687604,1672571383,1672571659,276
11720,3367242388,3611533094,1672669155,1672671478,2323
10966,3714595459,3760656396,1672546397,1672549080,2683
10758,3756736726,3516454693,1672633239,1672635357,2118
9855,3773603836,3395082458,1672543222,1672544602,1380
10569,3809194824,3756675909,1672551629,1672554861,3232
10390,3783594729,3838119022,1672569050,1672571915,2865
10374,3812261241,3623953446,1672609092,1672609213,121
11300,3311810583,3900766525,1672677473,1672680644,3171
10087,3912181197,3714424237,1672638781,1672640979,2198
10600,3713954144,3778479297,1672584762,1672586718,1956
10287,3428788958,3510750299,1672578668,1672581685,3017
10514,3939882169,3813111107,1672599138,1672599812,674
10831,3559619861,3517151644,1672572166,1672574798,2632
10867,3465107990,3246062632,1672628484,1672631780,3296
11578,3513111053,3703104365,1672581039,1672581954,915
11660,3710149975,3936851114,1672549161,1672552375,3214
10726,3701893620,3334824744,1672596851,1672597948,1097
10770,3498803823,3716445184,1672533181,1672535275,2094
10010,3515655024,3714892312,1672651095,1672651836,741
10661,3398075553,3738547113,1672689748,1672691833,2085
11277,3792337863,3770780655,1672641278,1672642432,1154
11704,3809216145,3419829238,1672618922,1672618982,60
9951,3505438826,3715923089,1672576637,1672577003,366
10841,3776053084,3519228207,1672601853,1672604564,2711
9826,3512072679,3439036305,1672573888,1672576277,2389
9849,3533030343,3501271930,1672685900,1672687209,1309
10425,3209075485,3510335069,1672629496,1672632365,2869
10945,3436774112,3783809405,1672636486,1672637594,1108
11431,3511069449,3471585513,1672697382,1672699684,2302
9898,3515230715,3731905251,1672622090,1672624680,2590
10693,3701971784,3791236983,1672702002,1672703755,1753
10705,3304592684,3780680252,1672623082,1672625572,2490
9931,3519055736,3777387533,1672634234,1672635785,1551
11657,3716609198,3447253775,1672642594,1672644173,1579
10635,3334482021,3780941637,1672593406,1672595030,1624
11276,3275171954,3559619861,1672677031,1672678303,1272
11158,3713566527,3447312353,1672639757,1672640584,827
10838,3301449986,3772905073,1672586987,1672589955,2968
10199,3701127475,3500555856,1672682931,1672684449,1518
10522,3489205994,3791435852,1672575580,1672577339,1759
11752,3633949990,3711179193,1672563412,1672565069,1657
11545,3755411110,3344778261,1672695503,1672696745,1242
11292,3791222330,3770972037,1672683936,1672687527,3591
11514,3793274957,3757089924,1672611606,1672612527,921
10010,3272096922,3715680249,1672666150,1672669330,3180
10525,3703206956,3774744663,1672622744,1672625817,3073
9868,3756759239,3778125688,1672701814,1672701976,162
11291,3703048107,3777498160,1672597921,1672601499,3578
9897,3760801237,3613940925,1672551374,1672551488,114
11618,3319862687,3553640169,1672556201,1672558648,2447
9906,3701685828,3973138649,1672625265,1672625594,329
10399,3793232021,3884394685,1672700822,1672702683,1861
9930,3304592684,3756079870,1672621604,1672624230,2626
10024,3755286041,3755729826,1672554067,1672554739,672
11030,3792633495,3776316903,1672612195,1672612552,357
10953,3780298499,3472561941,1672605465,1672608676,3211
10646,3552922094,3713170867,1672568404,1672570143,1739
10060,3701453343,3714718326,1672552282,1672554348,2066
10579,3881785069,3293540333,1672546119,1672546353,234
11262,3783935976,3609335008,1672699943,1672703138,3195
11671,3299052917,3777060250,1672665637,1672666891,1254
11443,3368951504,3613936929,1672556388,1672557324,936
11210,3713805968,3715724166,1672697449,1672698715,1266
11405,3792627762,3519352855,1672617974,1672621232,3258
10361,3409098014,3774483862,1672579009,1672579586,577
11099,3311331205,3382746533,1672609146,1672611190,2044
11729,3359351267,3496352027,1672640544,1672641921,1377
9970,3534937492,3908883591,1672618558,1672619763,1205
10004,3779815753,3510542303,1672660095,1672661691,1596
10786,3791409441,3505665253,1672538218,1672540821,2603
11776,3246062632,3551833298,1672671909,1672675072,3163
10907,3513840186,3402580733,1672602841,1672606233,3392
11481,3304592684,3683562111,1672698045,1672698531,486
10327,3352044245,3500688476,1672580158,1672582828,2670
9975,3318250647,3500674240,1672550365,1672552843,2478
10949,3614484939,3472173212,1672545604,1672546750,1146
11277,3713920790,3680832669,1672692235,1672692432,197
11788,3900793652,3896200048,1672541253,1672543858,2605
11295,3760679372,3783506190,1672695992,1672697662,1670
10423,3394986304,3424997707,1672662999,1672664585,1586
11534,3909822999,3534589501,1672572416,1672575527,3111
10459,3533419409,3512819376,1672630119,1672631248,1129
10949,3713807753,3662055682,1672563453,1672566085,2632
10242,3828354855,3278251248,1672612225,1672614793,2568
10734,3792008302,3373851012,1672559681,1672561604,1923
11669,3361635547,3393543588,1672685379,1672686111,732
10440,3241682278,3853182912,1672578004,1672578448,444
11541,3501548163,3757592622,1672685657,1672687336,1679
9960,3760541837,3716020849,1672698916,1672699555,639
10347,3516454693,3780626668,1672555702,1672557931,2229
10953,3553229537,3804840997,1672676977,1672677584,607
11706,3512417724,3510916875,1672641099,1672641567,468
10053,3662307789,3711947828,1672531440,1672534370,2930
10750,3899205452,3273758330,1672631345,1672632135,790
10137,3755790149,3773032706,1672568302,1672570045,1743
10081,3515802579,3733243990,1672682783,1672686382,3599
10909,3770285500,3470997293,1672611965,1672613568,1603
10551,3662507634,3505980138,1672544900,1672547215,2315
10599,3770480149,3776304080,1672542637,1672543357,720
10406,3225371682,3736056340,1672544477,1672547303,2826
10825,3357026115,3301332095,1672550339,1672551391,1052
11437,3922153821,3500695402,1672538117,1672539711,1594
10304,3681701931,3757393413,1672572217,1672575464,3247
9800,3423940256,3505531432,1672575125,1672577197,2072
11416,3773523569,3408828584,1672651267,1672654476,3209
10675,3856897914,3714690161,1672546021,1672549389,3368
11627,3447591143,3909457959,1672595762,1672595834,72
10436,3881579907,3554317844,1672569310,1672571792,2482
10918,3783554600,3625931630,1672639904,1672642928,3024
10396,3480270940,3226172318,1672654174,1672657623,3449
11733,3760069457,3497562878,1672617482,1672619883,2401
10772,3773876312,3783430498,1672544835,1672547861,3026
11479,3714525519,3515655024,1672596764,1672598479,1715
10447,3319436533,3804779247,1672560814,1672560923,109
10861,3517448452,3666022373,1672598047,1672598628,581
9913,3330799389,3505867821,1672624129,1672625055,926
11482,3621629499,3512638952,1672613152,1672614668,1516
10062,3938021614,3755378125,1672588682,1672589962,1280
10225,3514926921,3247845642,1672622197,1672625047,2850
10679,3517448452,3279102372,1672658290,1672661274,2984
10673,3634670780,3478052226,1672631044,1672634458,3414
10121,3701567668,3791688526,1672546584,1672546877,293
11171,3760731595,3433189219,1672692392,1672694891,2499
10665,3520012007,3713954144,1672682822,1672683677,855
9936,3824259677,3778402454,1672552436,1672552979,543
10034,3331471764,3513140146,1672635231,1672637818,2587
10749,3777909822,3780942505,1672698549,1672698992,443
11462,3368848936,3350966326,1672639136,1672641243,2107
10341,3354405535,3534624672,1672551824,1672554601,2777
11387,3669475165,3919984986,1672567622,1672569639,2017
10897,3515764058,3447554599,1672587268,1672589242,1974
11631,3489340327,3770457058,1672556635,1672558336,1701
10511,3885674996,3534278019,1672614144,1672615994,1850
10762,3884001167,3780298499,1672566549,1672567795,1246
10626,3792107875,3918981936,1672543597,1672544641,1044
10829,3273242177,3760274119,1672533333,1672535160,1827
9817,3375324190,3500031401,1672595982,1672598357,2375
10190,3757924067,3244395841,1672609858,1672611683,1825
11091,3682241594,3632303304,1672684121,1672686949,2828
10562,3403988682,3517552930,1672615636,1672618345,2709
11388,3404375908,3307521389,1672645307,1672647806,2499
11446,3313824913,3807111856,1672596844,1672600160,3316
10005,3453464785,3906693728,1672615527,1672616613,1086
11616,3824135033,3395565040,1672688010,1672691596,3586
10113,3822496670,3481019442,1672536580,1672537522,942
11241,3792255406,3311626308,1672624384,1672627620,3236
10442,3732104286,3512480125,1672618158,1672621539,3381
11510,3374195945,3757851680,1672609857,1672610442,585
11749,3479910993,3286938590,1672697284,1672699879,2595
11153,3711187791,3387413950,1672542884,1672545585,2701
10155,3500221079,3476308535,1672592678,1672593886,1208
10173,3623113240,3516668203,1672688524,1672690944,2420
10508,3517469005,3500589560,1672686643,1672688026,1383
11184,3756297396,3452024572,1672597649,1672600569,2920
10780,3756998113,3520362238,1672625283,1672626914,1631
11591,3812880543,3496591885,1672702580,1672702668,88
10149,3316121649,3511671476,1672697981,1672700987,3006
10266,3510535683,3779689733,1672629073,1672630611,1538
10012,3791205793,3639465750,1672543801,1672547243,3442
11026,3680075399,3710819760,1672643243,1672644712,1469
10787,3715750580,3711179193,1672696629,1672697571,942
11059,3512371853,3533325993,1672618990,1672620818,1828
11746,3501873139,3703725221,1672610885,1672614105,3220
11763,3760748418,3338115824,1672544099,1672544209,110
10732,3713224986,3703611876,1672533876,1672536786,2910
9932,3701978422,3467415939,1672680979,1672683734,2755
10297,3518368900,3406132280,1672591736,1672593519,1783
10194,3821082558,3757128722,1672663323,1672666269,2946
10164,3471177177,3287920864,1672571545,1672574245,2700
11582,3407398464,3341432459,1672593234,1672595890,2656
10306,3517377614,3603740088,1672677669,1672680469,2800
11259,3518425740,3390368796,1672579409,1672582275,2866
10598,3804707712,3685522474,1672665992,1672666095,103
11330,3307236682,3501657158,1672632575,1672635183,2608
10019,3295748489,3973134902,1672676994,1672680488,3494
10419,3783947742,3517797610,1672580999,1672584553,3554
10221,3557129226,3505720915,1672539420,1672542676,3256
10731,3488931357,3207307681,1672691821,1672695296,3475
11567,3517551721,3240877710,1672599190,1672602011,2821
10629,3890813040,3509355477,1672596571,1672596720,149
10776,3772659062,3442073613,1672624665,1672627005,2340
11626,3318224774,3660163550,1672599243,1672601824,2581
10128,3770457058,3444646562,1672678564,1672679770,1206
10915,3883640454,3780224882,1672610902,1672614224,3322
10773,3355903597,3475653510,1672601098,1672603305,2207
10346,3884934977,3773554767,1672595289,1672597952,2663
10554,3909504515,3792107875,1672550010,1672553000,2990
9888,3394959062,3505560793,1672699045,1672699781,736
10707,3703048107,3534578428,1672558769,1672560617,1848
9830,3387989658,3380185102,1672582802,1672583303,501
10686,3233917789,3500889287,1672671450,1672672510,1060
11126,3622654885,3891586951,1672532171,1672534217,2046
10555,3684108920,3517800171,1672682421,1672683979,1558
10590,3404375908,3605905645,1672565677,1672566856,1179
11132,3774355339,3511364193,1672634603,1672635877,1274
11067,3533867833,3715126587,1672657306,1672660198,2892
10776,3239279744,3501205057,1672649048,1672652111,3063
11611,3714264759,3558264627,1672644793,1672647778,2985
10574,3737622701,3520697518,1672610333,1672611295,962
11429,3733796228,3430296808,1672601689,1672605246,3557
10085,3419648004,3381244346,1672593933,1672596304,2371
11530,3714281795,3289258397,1672591035,1672591109,74
10546,3369558911,3447253775,1672669909,1672671924,2015
11772,3835982340,3516585063,1672619584,1672621524,1940
11780,3777200549,3534531039,1672580036,1672580577,541
10158,3509828883,3932491622,1672648884,1672650516,1632
11629,3774296721,3922430928,1672666465,1672668117,1652
10084,3202740652,3387700451,1672684286,1672687486,3200
10541,3774296721,3505392452,1672645909,1672649133,3224
10764,3518209090,3403035480,1672661065,1672662637,1572
11482,3392573386,3713990030,1672628222,1672630161,1939
11676,3512480125,3886957097,1672597756,1672599081,1325
10471,3290797257,3501759031,1672608622,1672609067,445
9811,3516777819,3500968729,1672657963,1672661475,3512
11414,3604908372,3500974385,1672533479,1672533686,207
11262,3716178116,3483078667,1672539954,1672543544,3590
11540,3730600658,3977209952,1672540853,1672543607,2754
11036,3909399636,3220987526,1672538101,1672538764,663
10330,3516429380,3311177439,1672579272,1672581849,2577
11024,3519947298,3776901443,1672565853,1672567156,1303
10752,3805268739,3300238532,1672643082,1672646510,3428
9992,3703048107,3971996397,1672565672,1672566401,729
10699,3805926853,3393543588,1672625870,1672628180,2310
11534,3639926564,3238310644,1672676177,1672676787,610
9913,3793407883,3618672178,1672686272,1672689083,2811
10866,3490804766,3780298499,1672540301,1672542914,2613
10164,3602680347,3347760784,1672556491,1672557760,1269
9827,3316117186,3385124073,1672548660,1672550816,2156
10031,3312800145,3713100169,1672559759,1672562363,2604
9914,3361926328,3510484107,1672644452,1672645288,836
11356,3491239350,3757549235,1672629564,1672631953,2389
11052,3780626668,3514685272,1672583612,1672584849,1237
10913,3927699036,3909504515,1672659848,1672663313,3465
10724,3793442891,3463892928,1672651198,1672652598,1400
11141,3342031426,3246296769,1672569147,1672569696,549
11255,3772708314,3396472026,1672549630,1672551319,1689
11754,3517797610,3904045870,1672682095,1672685402,3307
9872,3919345990,3516904926,1672542928,1672544392,1464
10395,3906075386,3501205057,1672604957,1672608449,3492
11511,3505709407,3711810752,1672584317,1672585185,868
10130,3374552204,3441737317,1672672122,1672673673,1551
9946,3774965463,3716183063,1672628708,1672629019,311
10931,3772343750,3512527440,1672625358,1672626721,1363
10974,3501600785,3311449914,1672647354,1672648136,782
10711,3444453261,3714471069,1672700309,1672702192,1883
11284,3770631449,3792432763,1672673766,1672675341,1575
10294,3505665253,3805718871,1672663096,1672663178,82
11376,3429047448,3484483775,1672648884,1672650914,2030
11364,3772296376,3755218683,1672538802,1672540034,1232
10466,3351153781,3711804184,1672691109,1672691592,483
10163,3236563828,3227059650,1672701906,1672702833,927
11329,3902300755,3227339675,1672605777,1672606538,761
10290,3305612422,3500741534,1672703485,1672706479,2994
11622,3701519251,3779174993,1672666341,1672667419,1078
10306,3373018943,3512641538,1672692747,1672693983,1236
10763,3500630465,3227874229,1672634305,1672634513,208
10082,3515970536,3500356342,1672636484,1672637580,1096
10687,3360972732,3914740937,1672563730,1672564050,320
10393,3449233346,3780298499,1672623889,1672626217,2328
11048,3499343927,3500793739,1672580827,1672581614,787
11788,3736056340,3534081527,1672612841,1672613487,646
11587,3664523809,3416105769,1672577005,1672577952,947
10800,3492350318,3290060215,1672659669,1672662772,3103
11491,3791409441,3703572036,1672661657,1672663082,1425
11369,3419789418,3711804184,1672633769,1672636495,2726
11172,3281148858,3432050858,1672535770,1672538479,2709
9954,3714951681,3482687604,1672652017,1672654384,2367
10098,3319645922,3616242727,1672584418,1672587094,2676
11689,3358434853,3519356606,1672574401,1672576805,2404
11706,3499622352,3510254698,1672661494,1672662530,1036
11439,3791121243,3793081195,1672648112,1672650264,2152
10328,3516827471,3364718040,1672625994,1672626356,362
11562,3228056289,3518408734,1672651239,1672653573,2334
10964,3773688906,3510111365,1672699701,1672701793,2092
10683,3442564712,3223177147,1672700948,1672703968,3020
10135,3209075485,3857344874,1672540545,1672541818,1273
11531,3500405175,3760541837,1672622023,1672624009,1986
11607,3516321993,3715790104,1672532111,1672535672,3561
9903,3616242727,3777074709,1672618196,1672620808,2612
11712,3516777819,3703502114,1672675166,1672676006,840
10250,3225356349,3701385831,1672676723,1672678910,2187
10952,3774326754,3713606829,1672565138,1672568221,3083
10329,3919349138,3533017131,1672536599,1672538848,2249
10827,3347760784,3551972633,1672561337,1672564909,3572
9986,3774606418,3780466967,1672627146,1672627712,566
11236,3449233346,3477248170,1672543083,1672546503,3420
10335,3516588277,3516359146,1672558324,1672561205,2881
10331,3755922811,3935569749,1672652091,1672653026,935
10194,3519059808,3511883778,1672549683,1672550533,850
10422,3887382548,3490008012,1672661006,1672664013,3007
11008,3518117078,3311449914,1672553130,1672554583,1453
11709,3517558635,3405221863,1672620580,1672621164,584
10167,3534374523,3917243005,1672545892,1672547609,1717
11080,3835599049,3371564186,1672628569,1672629248,679
11109,3519341916,3388830370,1672619625,1672620951,1326
11719,3510149298,3421956717,1672543930,1672544060,130
10518,3400186699,3681274982,1672626315,1672629396,3081
10092,3686860179,3455430943,1672701816,1672703953,2137
11043,3475560058,3245121919,1672612611,1672613843,1232
10872,3606804618,3885339157,1672600538,1672603310,2772
10694,3624164232,3613940925,1672558414,1672560267,1853
10238,3288920399,3935569749,1672659914,1672660018,104
11081,3509370633,3421524698,1672588692,1672589486,794
11111,3805718871,3774682234,1672580988,1672581407,419
10418,3884180202,3893527651,1672675163,1672675338,175
10578,3354405535,3347760784,1672559234,1672559414,180
10761,3433196933,3500536897,1672613505,1672616308,2803
10741,3500421940,3825877848,1672617192,1672619906,2714
11354,3793689267,3621960662,1672670499,1672670698,199
11771,3461931154,3899756737,1672589745,1672593018,3273
10487,3505804611,3885545415,1672544412,1672546815,2403
9952,3388463477,3783021859,1672602918,1672603421,503
10403,3558349840,3623953446,1672590018,1672591766,1748
9891,3557653200,3770941125,1672598281,1672599124,843
11787,3484739955,3638035545,1672564023,1672567477,3454
10129,3517136772,3836757034,1672601110,1672603469,2359
10164,3904045870,3713767153,1672544213,1672544849,636
10365,3500695402,3517132086,1672616936,1672620409,3473
11499,3403257752,3774447975,1672553180,1672555169,1989
10075,3776732532,3755203055,1672623813,1672625676,1863
10465,3774448657,3515607283,1672679423,1672680946,1523
10590,3450164574,3808849597,1672537709,1672538915,1206
11389,3711770853,3520860199,1672612246,1672615190,2944
10467,3375905193,3773714494,1672641820,1672642574,754
10561,3778318250,3514021667,1672694907,1672698131,3224
11158,3773688906,3505173665,1672538242,1672539872,1630
10238,3735838864,3500429731,1672567234,1672570612,3378
10245,3505560793,3755238321,1672670062,1672672142,2080
11750,3345902033,3275975921,1672610515,1672613909,3394
11767,3615742989,3780213684,1672652212,1672654747,2535
11264,3629248353,3772216305,1672663067,1672664979,1912
11751,3780733404,3703104365,1672532785,1672535438,2653
11461,3713444403,3477951091,1672688594,1672691974,3380
10584,3689386663,3774394000,1672562174,1672564017,1843
10533,3714902042,3783122313,1672667382,1672668300,918
11393,3779778679,3701127475,1672538648,1672541536,2888
11458,3780050328,3714142299,1672544096,1672546703,2607
11705,3779505358,3370961012,1672602110,1672604194,2084
11167,3292050211,3510775046,1672559888,1672562595,2707
10932,3735422623,3776316903,1672587527,1672590642,3115
10311,3938021614,3711862792,1672546635,1672549359,2724
10946,3778738044,3701377471,1672548780,1672552165,3385
11237,3520625600,3353194923,1672593662,1672596394,2732
10902,3279726491,3620157388,1672583811,1672586495,2684
11374,3447591143,3885674996,1672559746,1672561606,1860
11306,3395082458,3770105006,1672609493,1672611562,2069
10375,3228477490,3516904926,1672546162,1672547443,1281
11336,3406390503,3513624915,1672634890,1672638116,3226
10554,3919719755,3428878402,1672585299,1672587484,2185
10079,3907088952,3447938130,1672579254,1672579834,580
10846,3811354125,3500429731,1672541357,1672544072,2715
10446,3511028193,3637522163,1672536343,1672537413,1070
10716,3369482983,3534204885,1672626883,1672628986,2103
10046,3500444748,3755175497,1672618156,1672621208,3052
11460,3730052916,3666655293,1672595101,1672595721,620
11361,3422548081,3714377201,1672547990,1672548071,81
10829,3357496255,3500031401,1672646285,1672648620,2335
11747,3791245127,3457249798,1672657409,1672660883,3474
10288,3393543588,3206377955,1672602698,1672606000,3302
9981,3834643026,3779930476,1672575552,1672577505,1953
10677,3857609616,3776122272,1672583179,1672586608,3429
11507,3755357292,3772867078,1672606477,1672609606,3129
10583,3938059867,3517469005,1672536996,1672538290,1294
10727,3825234433,3500209015,1672659874,1672663445,3571
10013,3776407517,3534988162,1672585646,1672585912,266
9980,3344710271,3792255406,1672600984,1672601360,376
10753,3246804115,3505148522,1672534194,1672535151,957
10507,3756297396,3757607649,1672572463,1672572831,368
10099,3937747312,3774744663,1672580580,1672581522,942
10720,3703462221,3933106901,1672696103,1672696870,767
11564,3777149336,3756761603,1672574605,1672575201,596
11292,3239990061,3770023722,1672607142,1672608600,1458
10813,3715712376,3206377955,1672593152,1672595301,2149
10903,3374147279,3778318250,1672691469,1672691886,417
10328,3533265491,3510254698,1672552841,1672555191,2350
11164,3901217668,3500317923,1672543987,1672544367,380
11124,3757201538,3360972732,1672583637,1672585127,1490
10563,3438028077,3916955566,1672684019,1672687490,3471
10641,3664719070,3779706467,1672548887,1672551504,2617
9890,3299845453,3715790104,1672608980,1672609256,276
10116,3520832066,3907390925,1672557931,1672559030,1099
11039,3757851680,3510775046,1672599313,1672602122,2809
10495,3774145748,3977666815,1672662878,1672665162,2284
9999,3243651036,3667654673,1672547682,1672550181,2499
11224,3471507117,3341311972,1672670855,1672674073,3218
10772,3774304163,3446233783,1672561954,1672563926,1972
10618,3615846003,3226172318,1672637792,1672641185,3393
10358,3398862999,3312612693,1672687946,1672689940,1994
9857,3313795594,3423353911,1672686065,1672689512,3447
10273,3337903727,3772966919,1672564644,1672565067,423
10852,3403988682,3452175941,1672669959,1672672972,3013
10417,3520145112,3715441777,1672671126,1672672370,1244
11335,3396453219,3710783759,1672567095,1672568861,1766
11159,3662794240,3511500932,1672563849,1672564336,487
10902,3701978422,3628423403,1672605569,1672608348,2779
11454,3301489209,3815700240,1672617167,1672620390,3223
11257,3805704844,3701567668,1672616110,1672618892,2782
10303,3710149975,3703048107,1672563875,1672564747,872
10407,3533154906,3770476738,1672533423,1672535715,2292
11038,3512477276,3419762444,1672592686,1672593653,967
10798,3973134902,3978254945,1672621304,1672622598,1294
10529,3711065081,3509297453,1672616478,1672619775,3297
9844,3715126587,3403395712,1672607607,1672610340,2733
11484,3510894809,3669283586,1672612503,1672614098,1595
10094,3229621693,3398489033,1672639083,1672640196,1113
10040,3770981604,3772695548,1672602203,1672604068,1865
11420,3711131262,3505190512,1672621695,1672623281,1586
10354,3444598583,3514576083,1672559155,1672560794,1639
10544,3509355477,3802101760,1672557437,1672559509,2072
10463,3736885568,3479402555,1672686218,1672686858,640
10222,3973134902,3756876537,1672563163,1672564623,1460
11716,3755229631,3501192566,1672541443,1672544323,2880
11448,3505994703,3716341323,1672676725,1672676888,163
10043,3516429380,3220123678,1672589360,1672592730,3370
11477,3714883746,3304252969,1672614158,1672616466,2308
11638,3809871495,3839417558,1672628269,1672630558,2289
11305,3351949206,3890211161,1672534099,1672534495,396
10632,3713875941,3206262649,1672556348,1672559620,3272
10665,3609925909,3555378248,1672615142,1672617000,1858
10053,3534984243,3701218904,1672588776,1672590763,1987
11188,3701350519,3497904539,1672543397,1672543495,98
10530,3304672737,3773083407,1672580732,1672584006,3274
9851,3853783593,3511526885,1672535081,1672535781,700
11121,3773688906,3308481706,1672690226,1672693777,3551
10492,3338642026,3501853868,1672547327,1672547557,230
10109,3534374523,3393955069,1672546943,1672548729,1786
11575,3636605690,3668955834,1672557001,1672559197,2196
11445,3432466467,3514611187,1672635921,1672636334,413
10164,3293553295,3432762943,1672689791,1672692041,2250
11249,3300810210,3333355914,1672700870,1672702994,2124
10135,3689386663,3311569360,1672545144,1672547118,1974
10794,3791584994,3513996288,1672594816,1672596805,1989
10350,3519322066,3828568868,1672634970,1672636018,1048
10757,3442096275,3513143959,1672620667,1672620965,298
10531,3495637721,3472901378,1672666198,1672668806,2608
9905,3246567963,3516588277,1672557518,1672557901,383
10705,3367202274,3437934509,1672663400,1672665957,2557
11754,3774965463,3817029483,1672651363,1672653722,2359
10200,3917905192,3615742989,1672691117,1672693208,2091
11020,3932919664,3772980989,1672617641,1672620378,2737
10159,3701291994,3288791629,1672654182,1672657627,3445
11295,3447938130,3270502801,1672646611,1672647005,394
10648,3792824886,3908331271,1672656017,1672658155,2138
10008,3701265238,3511963020,1672559050,1672560817,1767
10374,3639503148,3520057139,1672608257,1672609527,1270
11554,3418683594,3620836520,1672702436,1672703437,1001
10992,3228465044,3294949958,1672630238,1672633392,3154
10335,3432762943,3512638952,1672625640,1672627626,1986
11340,3518408734,3920526713,1672625515,1672628670,3155
10292,3505245692,3755119166,1672632610,1672634979,2369
10178,3760069457,3513777705,1672595731,1672598963,3232
10028,3703614781,3534589501,1672681727,1672681869,142
11680,3533365834,3783043770,1672679015,1672681345,2330
11722,3716976932,3472272792,1672561096,1672564424,3328
10154,3770172119,3716423829,1672613569,1672615283,1714
9955,3402020492,3815184540,1672603116,1672605814,2698
10375,3551972633,3903994989,1672691204,1672694786,3582
10094,3715724166,3615447269,1672598980,1672602149,3169
10037,3791368349,3739387948,1672648448,1672648672,224
11252,3306491253,3394357241,1672531886,1672532604,718
11077,3403120725,3351153781,1672557621,1672560799,3178
9845,3221126799,3780964089,1672580923,1672583122,2199
10069,3776447604,3512819376,1672546558,1672547597,1039
11439,3713636175,3533365834,1672574097,1672574596,499
11057,3773085258,3353326305,1672702116,1672704906,2790
11297,3808442442,3713159131,1672649430,1672650179,749
11368,3701311947,3516167000,1672593081,1672596650,3569
11769,3353326305,3381055770,1672649273,1672652287,3014
10607,3511245705,3425260097,1672552861,1672556005,3144
11666,3896859936,3793902476,1672558689,1672560265,1576
9902,3778927933,3778924002,1672578096,1672579866,1770
11364,3632720032,3825526565,1672561840,1672562861,1021
11199,3511289729,3716609198,1672629024,1672630193,1169
9961,3515304526,3495152069,1672698092,1672698576,484
10367,3713100169,3776319560,1672573158,1672576627,3469
10931,3274894848,3791532324,1672694105,1672696129,2024
9845,3760748418,3404187438,1672665781,1672666917,1136
11751,3773024346,3760525465,1672590410,1672590612,202
11697,3375905193,3713805968,1672647696,1672651244,3548
10008,3780298499,3772291207,1672616124,1672618912,2788
10429,3757604311,3897851509,1672684040,1672686092,2052
10250,3500674240,3793332600,1672624891,1672628399,3508
11567,3513171472,3773669001,1672543509,1672545475,1966
10965,3852014884,3275975921,1672624657,1672626019,1362
10489,3319660530,3793814153,1672542790,1672543824,1034
10340,3509274030,3805831563,1672570466,1672571803,1337
11426,3716183063,3970265139,1672588818,1672592182,3364
10916,3912181197,3715844082,1672648924,1672651858,2934
10505,3713224986,3347172556,1672591492,1672592084,592
11407,3401215739,3755374000,1672620290,1672623022,2732
10550,3505278562,3779169946,1672647746,1672648541,795
9875,3850904092,3505653701,1672541052,1672541575,523
10019,3710228292,3228575883,1672540597,1672540904,307
10003,3793332600,3777992576,1672558048,1672559119,1071
9983,3399943757,3906874577,1672649011,1672651375,2364
9872,3455907179,3685083275,1672533493,1672534263,770
10113,3783967375,3711862792,1672688154,1672688391,237
10960,3514450836,3715700639,1672537809,1672539898,2089
11144,3275274182,3465227623,1672589724,1672592589,2865
11422,3934280144,3811503860,1672654236,1672656821,2585
10860,3924583142,3342837214,1672642072,1672642235,163
10956,3362368123,3663505156,1672564049,1672566983,2934
10645,3778817220,3421674406,1672694968,1672696230,1262
11259,3505502819,3515944817,1672610819,1672613768,2949
11436,3341311972,3505449070,1672603406,1672606687,3281
10088,3435715962,3773738817,1672562029,1672562667,638
10818,3393909269,3923524564,1672578171,1672578701,530
10139,3511412229,3701459978,1672557792,1672558834,1042
11723,3824657614,3931319307,1672552505,1672553730,1225
11352,3512625661,3316121649,1672661358,1672662763,1405
10162,3283785820,3510218188,1672589701,1672591006,1305
10657,3701387745,3353335252,1672605166,1672605690,524
10289,3780467276,3770441717,1672547121,1672549618,2497
11044,3311529105,3836090778,1672613101,1672613864,763
9840,3518931700,3711755596,1672576809,1672579153,2344
11026,3914947393,3780466967,1672587216,1672588492,1276
11519,3511864772,3703502114,1672640681,1672641445,764
10802,3505117019,3311774510,1672644242,1672644997,755
11399,3479910993,3711810268,1672683390,1672686058,2668
10997,3436774112,3776200012,1672541984,1672544994,3010
11696,3552922094,3899205452,1672675422,1672678789,3367
10106,3931917809,3703474558,1672587198,1672588354,1156
10406,3710185376,3500671218,1672650695,1672652194,1499
10826,3282240901,3361711720,1672682316,1672685576,3260
10803,3414510793,3400793223,1672590353,1672593471,3118
11063,3757407184,3774682234,1672648196,1672650725,2529
10659,3501619113,3445733121,1672645862,1672647258,1396
10260,3716982179,3792283334,1672643150,1672645402,2252
11281,3516572212,3509433155,1672608722,1672611928,3206
10052,3905889514,3533703578,1672573273,1672574467,1194
11123,3773738817,3533974355,1672550073,1672552095,2022
10724,3779454060,3661856558,1672573806,1672575906,2100
10487,3975796415,3779665641,1672539897,1672542366,2469
10319,3552444228,3519724388,1672674745,1672676221,1476
10089,3449672240,3713514933,1672650350,1672653502,3152
10414,3715602742,3517797610,1672632822,1672634889,2067
11467,3610723722,3284407073,1672553807,1672554225,418
10796,3638018906,3907039612,1672636696,1672640217,3521
11063,3777060250,3225371682,1672655105,1672658041,2936
10031,3757944870,3779561601,1672695706,1672697884,2178
11767,3939851140,3500654356,1672551465,1672551852,387
10697,3821087562,3774109138,1672590004,1672591479,1475
10185,3244395841,3701449715,1672610490,1672612275,1785
11173,3830254808,3512203553,1672563277,1672565033,1756
9868,3927675706,3517151644,1672548782,1672549446,664
10905,3714951681,3371759126,1672578636,1672580648,2012
11466,3813986705,3855222429,1672609735,1672610952,1217
11761,3793569914,3859191694,1672574801,1672574875,74
11212,3776279305,3715196780,1672681031,1672682606,1575
11397,3533037906,3760748418,1672693289,1672695915,2626
11179,3245755569,3375905193,1672546277,1672549532,3255
9877,3301765144,3438470128,1672659674,1672662449,2775
10211,3351837521,3499820963,1672595618,1672597614,1996
10796,3533628528,3500543341,1672546340,1672548159,1819
11291,3505811269,3886896755,1672579544,1672581250,1706
10553,3888523259,3791088014,1672665523,1672665846,323
10009,3630802959,3351728355,1672617445,1672617617,172
11643,3505121295,3783021859,1672677194,1672680149,2955
11388,3202740652,3885422379,1672637320,1672638507,1187
10901,3772569860,3501980730,1672583117,1672583464,347
10336,3757598610,3713514933,1672613511,1672614138,627
11616,3295530454,3791584994,1672569217,1672570738,1521
10546,3205113625,3791644831,1672535669,1672536435,766
10896,3500209015,3778100960,1672589046,1672592126,3080
11554,3505720915,3519260216,1672619365,1672621320,1955
10155,3415840750,3520160414,1672622933,1672623603,670
10595,3777909822,3908878965,1672606078,1672607077,999
9897,3736941123,3380444321,1672531568,1672532302,734
10747,3884388188,3701296091,1672685731,1672688959,3228
9963,3456795601,3713374884,1672658388,1672659086,698
11088,3534174363,3629248353,1672618799,1672620703,1904
11786,3500120676,3283106998,1672634533,1672635240,707
11127,3446810761,3288346356,1672681567,1672681894,327
10374,3837378340,3202787155,1672576327,1672577712,1385
10591,3516463579,3472774606,1672686228,1672687900,1672
10974,3777499535,3240877710,1672565753,1672567718,1965
11528,3603452936,3919342147,1672652934,1672656383,3449
10538,3633860380,3514673213,1672656658,1672657230,572
11122,3778044082,3774792696,1672692680,1672693801,1121
11722,3778124514,3774606418,1672593096,1672594179,1083
11468,3553321027,3275274182,1672579498,1672580045,547
11538,3476431618,3283295213,1672557614,1672559507,1893
9816,3447202943,3783651407,1672608967,1672609213,246
11414,3493598658,3534068874,1672558603,1672558667,64
11142,3478052226,3500931474,1672619394,1672620447,1053
11345,3284374600,3500889287,1672587830,1672590732,2902
11622,3482687604,3411213032,1672632306,1672635567,3261
11302,3703742071,3755369666,1672640770,1672643037,2267
10598,3823600319,3534284132,1672537401,1672539460,2059
11318,3474074188,3313579674,1672560941,1672562879,1938
9941,3446764595,3515804844,1672644522,1672647806,3284
11515,3248061684,3934611532,1672626732,1672629577,2845
10456,3778479297,3910020031,1672695938,1672698019,2081
11403,3510301454,3238310644,1672601323,1672601859,536
11454,3791841318,3443102414,1672642241,1672644260,2019
10045,3710891331,3500814753,1672564084,1672565794,1710
10975,3384001094,3710149975,1672560126,1672561932,1806
10127,3512417028,3779930476,1672565194,1672566569,1375
11157,3241682278,3454554552,1672565075,1672568207,3132
9797,3510240661,3755170743,1672675255,1672678678,3423
9849,3372596013,3716233100,1672650655,1672653354,2699
9989,3770424892,3713416106,1672588594,1672589699,1105
9998,3970775805,3791509334,1672670632,1672671089,457
11675,3416079461,3478206139,1672564034,1672567066,3032
10688,3358473096,3533419409,1672648351,1672648894,543
11684,3714883746,3779478448,1672556152,1672558088,1936
10645,3512288503,3971996397,1672582770,1672583165,395
11104,3516651799,3316121649,1672641218,1672644801,3583
11677,3533077580,3295748489,1672551857,1672553704,1847
10761,3311774510,3780500331,1672600375,1672601094,719
11437,3304697982,3360309868,1672635619,1672637066,1447
10723,3701725839,3447312353,1672557061,1672560242,3181
10434,3319585148,3792785261,1672605114,1672608593,3479
10920,3838423363,3461137945,1672670178,1672672245,2067
11488,3435037864,3509377714,1672700125,1672703713,3588
11359,3809207482,3520057139,1672562312,1672562402,90
10883,3884394685,3916955566,1672663114,1672664699,1585
9952,3517045396,3480560014,1672625628,1672627986,2358
9799,3774355339,3757407184,1672624677,1672626683,2006
11235,3519341916,3881785069,1672555208,1672558228,3020
10666,3397972945,3509018337,1672556437,1672557024,587
11592,3501126057,3403150349,1672680672,1672683911,3239
10953,3760997159,3756297396,1672616979,1672619150,2171
11097,3703048107,3511286390,1672655962,1672658570,2608
10765,3607288879,3480259863,1672683773,1672685676,1903
9969,3665431349,3792075871,1672641716,1672643382,1666
11426,3494157939,3377250778,1672569305,1672570752,1447
10903,3403395712,3520155898,1672668537,1672671759,3222
11182,3774744663,3398483531,1672532168,1672534761,2593
10589,3929391979,3884180202,1672672000,1672673401,1401
10528,3501628472,3505816624,1672671499,1672673846,2347
9796,3316406470,3435715962,1672545024,1672545863,839
10693,3505351253,3505496725,1672574430,1672576681,2251
11330,3778706119,3285136057,1672583994,1672587467,3473
10623,3500544306,3277061226,1672651853,1672653864,2011
10607,3974264211,3501208658,1672646282,1672647205,923
9884,3500221079,3611298237,1672572747,1672574392,1645
10237,3391854325,3909399636,1672550077,1672552176,2099
9951,3421956717,3379517265,1672573027,1672575681,2654
10147,3288920399,3340723781,1672630795,1672634155,3360
10476,3710185376,3737745988,1672538183,1672539768,1585
10114,3246567963,3738103378,1672699192,1672701147,1955
11050,3780749789,3772802020,1672564531,1672566617,2086
10818,3850108828,3534081527,1672652337,1672654567,2230
10426,3434581257,3475653510,1672582375,1672584668,2293
10193,3467944159,3514352989,1672690755,1672690945,190
11490,3755767856,3710316008,1672572163,1672575375,3212
10808,3839744168,3298831109,1672551161,1672554433,3272
11024,3660980656,3760080378,1672612537,1672612738,201
11119,3476144563,3299845453,1672549616,1672551367,1751
11552,3514352989,3906260966,1672669166,1672672333,3167
10221,3924205112,3757497708,1672536594,1672537903,1309
11118,3533225084,3294326116,1672655491,1672655653,162
10739,3515803462,3836757034,1672549763,1672551219,1456
11232,3534589501,3777686966,1672537438,1672539774,2336
9871,3757311529,3517991042,1672631771,1672634868,3097
10747,3783067048,3493679801,1672667537,1672669177,1640
10186,3558264627,3520049965,1672545384,1672548706,3322
9955,3517718901,3755584983,1672617098,1672620036,2938
9995,3713476192,3500544306,1672635678,1672638275,2597
10873,3501427691,3757393413,1672636021,1672637751,1730
10340,3779130507,3611570003,1672560816,1672562354,1538
10668,3505011956,3277061226,1672659155,1672660749,1594
10690,3533419409,3791974273,1672641733,1672643724,1991
11398,3813085701,3739395381,1672625644,1672626446,802
11745,3893527651,3510159441,1672549660,1672551781,2121
10209,3770595035,3458753033,1672625307,1672626925,1618
9828,3243056734,3446764595,1672577402,1672579949,2547
11099,3516429380,3710807030,1672638502,1672641969,3467
10459,3791758175,3505164060,1672678291,1672680303,2012
11015,3510968599,3783809405,1672640396,1672643057,2661
10840,3513764665,3419829238,1672617799,1672620820,3021
11198,3710046567,3783611957,1672678871,1672680031,1160
10127,3387971464,3774394000,1672601639,1672604329,2690
10224,3510240661,3711854614,1672589042,1672589187,145
11060,3757623259,3410788026,1672550830,1672553867,3037
10471,3902548260,3793978936,1672663308,1672663998,690
11068,3334633634,3934070285,1672612210,1672614182,1972
10777,3713374884,3716197140,1672571450,1672573081,1631
10985,3605591994,3500640854,1672544932,1672545588,656
10429,3820280594,3479910993,1672583175,1672585224,2049
10956,3614112171,3703725221,1672602412,1672605665,3253
10736,3772223331,3247075753,1672631394,1672634343,2949
11404,3533867833,3206262649,1672587520,1672589141,1621
9807,3469780362,3779665641,1672571306,1672574674,3368
11452,3295787354,3519724388,1672652238,1672653974,1736
9925,3441737317,3711076751,1672544444,1672547695,3251
11762,3238310644,3423800775,1672660247,1672660395,148
11489,3340321384,3500863429,1672650773,1672652763,1990
11440,3783176874,3500928990,1672686446,1672687490,1044
11106,3338465050,3778370462,1672544763,1672546165,1402
10520,3369482983,3701284535,1672588235,1672590165,1930
11490,3902357342,3429409539,1672603032,1672605323,2291
9949,3245245283,3200785194,1672533730,1672536817,3087
11709,3760096466,3533427742,1672622290,1672624098,1808
11468,3792708936,3714435747,1672642983,1672644306,1323
10393,3491390365,3885339157,1672557657,1672560989,3332
10543,3505066871,3397783490,1672601505,1672603159,1654
11691,3391854325,3520009158,1672616706,1672619806,3100
10277,3772216305,3971280379,1672655012,1672655480,468
11765,3437703650,3422915648,1672541871,1672544129,2258
11584,3465227623,3757050615,1672611024,1672613139,2115
10532,3290797257,3501612813,1672610565,1672612176,1611
11098,3384170206,3908331271,1672545993,1672547108,1115
10816,3275661834,3516020922,1672572115,1672573126,1011
11028,3303747093,3703104365,1672676137,1672679243,3106
10930,3505129296,3776811587,1672675007,1672677470,2463
10140,3512645289,3602054754,1672662961,1672663411,450
11670,3415562576,3792289287,1672684346,1672686716,2370
10812,3716475340,3345902033,1672552605,1672553867,1262
11656,3519341916,3890813040,1672562324,1672562931,607
10532,3533131937,3463729805,1672532345,1672532594,249
10185,3636857871,3757201538,1672688413,1672688493,80
11642,3791224239,3928076270,1672629125,1672631193,2068
10847,3908331271,3447948483,1672685724,1672688202,2478
11701,3387700451,3519357822,1672572572,1672572636,64
11592,3778986795,3714897456,1672656556,1672657440,884
10914,3756345026,3510178791,1672568590,1672571188,2598
11666,3920155862,3972442654,1672640357,1672641869,1512
11465,3516792348,3793003432,1672643860,1672644328,468
11020,3445355677,3501600785,1672620056,1672621372,1316
10307,3501628472,3780171640,1672615099,1672618297,3198
11618,3380357490,3977209952,1672589158,1672589639,481
11584,3715039960,3516321993,1672651374,1672654903,3529
10868,3714870496,3811629200,1672541132,1672542230,1098
10887,3669418238,3807584987,1672564252,1672564553,301
10305,3908331271,3512490032,1672590268,1672593500,3232
11538,3850005949,3776583229,1672631558,1672632060,502
11789,3311260898,3713606829,1672647598,1672651065,3467
10780,3311959533,3711854614,1672632585,1672635155,2570
10036,3534362749,3791031227,1672550897,1672553417,2520
11450,3701596047,3919719755,1672663161,1672663863,702
10210,3791863922,3493679801,1672695434,1672696327,893
11526,3552922094,3514515499,1672541045,1672543602,2557
10886,3554236075,3439036305,1672688215,1672690915,2700
10974,3500695402,3780740477,1672697358,1672698295,937
11460,3713606829,3703588004,1672699999,1672702757,2758
10633,3776968640,3852310652,1672542893,1672545961,3068
10677,3207748225,3442403264,1672628644,1672629155,511
11128,3501828287,3910190872,1672608845,1672610708,1863
10754,3756642173,3630802959,1672677158,1672679748,2590
11120,3512726649,3760481622,1672559200,1672561260,2060
10388,3509912164,3680832669,1672688091,1672689521,1430
10904,3395505794,3713694278,1672682155,1672685408,3253
11068,3710296607,3500356342,1672646274,1672648019,1745
9868,3927202773,3714731729,1672652618,1672653299,681
11393,3395615598,3770441717,1672625278,1672626949,1671
11216,3500630465,3405221863,1672571934,1672572603,669
10287,3509252934,3505066871,1672589316,1672591456,2140
9861,3370401047,3850005949,1672688781,1672691205,2424
11409,3505449070,3664478769,1672653326,1672656252,2926
10158,3241682278,3311260898,1672628910,1672630545,1635
10576,3756759239,3713807753,1672534441,1672535889,1448
11248,3783506190,3467232654,1672536594,1672539871,3277
11221,3778182724,3380628097,1672633355,1672634441,1086
11214,3513850048,3287760230,1672671140,1672672866,1726
11676,3776291254,3710149975,1672541718,1672545205,3487
11515,3514541800,3757851680,1672643759,1672646217,2458
11448,3896200048,3304447950,1672689769,1672690338,569
10599,3516067011,3757851680,1672702537,1672703908,1371
10495,3513092056,3307791650,1672630038,1672631081,1043
9935,3669475165,3553321027,1672539780,1672541696,1916
10212,3412605548,3347140733,1672603802,1672606410,2608
10881,3239082508,3922153821,1672624956,1672625123,167
10326,3770574826,3660163550,1672695857,1672696162,305
10905,3701685828,3783651407,1672567700,1672570905,3205
9928,3311197635,3833520635,1672637539,1672637708,169
10388,3975796415,3227956115,1672639954,1672641670,1716
10837,3427527462,3533642281,1672633248,1672634578,1330
10190,3290060215,3534984243,1672578929,1672580799,1870
11332,3755286041,3444680955,1672578235,1672579421,1186
11421,3636885498,3778124514,1672601129,1672603797,2668
11049,3553229537,3444598583,1672672102,1672672468,366
11666,3517617472,3501573548,1672560979,1672562020,1041
10393,3484483775,3509651954,1672546818,1672547166,348
10229,3201957157,3791825536,1672655954,1672657251,1297
9856,3757150421,3516486526,1672695693,1672699092,3399
11225,3897107253,3711223297,1672630955,1672634050,3095
10031,3636927297,3381244346,1672687813,1672690960,3147
11217,3773853619,3505037247,1672637171,1672637389,218
11629,3505331014,3474350534,1672647978,1672648295,317
9936,3511466117,3793822639,1672574507,1672577746,3239
10225,3534122907,3783201950,1672676817,1672677193,376
11301,3915460293,3927675706,1672575245,1672575891,646
11542,3405303958,3311188620,1672615542,1672618415,2873
10026,3669427589,3716492409,1672668934,1672671621,2687
11320,3777405860,3689223632,1672609471,1672611178,1707
10338,3278430820,3777499535,1672629003,1672631872,2869
11392,3378747834,3512417028,1672588855,1672589089,234
11003,3910049345,3201920708,1672539245,1672540369,1124
11294,3776732532,3517210356,1672541385,1672543000,1615
9894,3511311554,3609644043,1672572423,1672573198,775
11523,3387322545,3403177609,1672566067,1672566174,107
11336,3713636175,3662307789,1672578717,1672578883,166
11390,3880882684,3293898029,1672572060,1672573328,1268
10198,3919345990,3395565040,1672660285,1672661777,1492
10948,3274894848,3715008501,1672609002,1672610092,1090
10792,3500785888,3772802020,1672611119,1672614482,3363
9822,3802374620,3364683368,1672674072,1672674431,359
10633,3489205994,3317190427,1672614788,1672615608,820
10659,3330238204,3512638952,1672595483,1672597250,1767
11519,3915652382,3516965624,1672606501,1672609686,3185
10042,3755465396,3856316719,1672680766,1672684169,3403
11623,3714516404,3975799349,1672701037,1672702828,1791
10838,3710585241,3463883997,1672564745,1672567428,2683
11054,3517151644,3791031227,1672654978,1672657154,2176
10947,3668955834,3366801723,1672566394,1672567484,1090
10105,3714902042,3452175941,1672563152,1672563884,732
10195,3909457959,3519102732,1672614586,1672615676,1090
11478,3398075553,3770172119,1672631787,1672635118,3331
11159,3822368676,3516026189,1672619968,1672622777,2809
10884,3668681400,3510368377,1672670980,1672674449,3469
10980,3774744663,3510758718,1672661769,1672665313,3544
11216,3896840409,3623953446,1672547102,1672549548,2446
11545,3778924002,3733423371,1672550462,1672554058,3596
11614,3500473064,3778819352,1672643272,1672645147,1875
11038,3760966645,3791698084,1672592203,1672594034,1831
10532,3500051606,3733730342,1672676757,1672678704,1947
10068,3792432094,3856552205,1672625533,1672629123,3590
11550,3459694275,3207586072,1672547351,1672548784,1433
10676,3223177147,3533929043,1672568900,1672569349,449
10742,3444881567,3491250381,1672632612,1672635679,3067
11291,3273758330,3715724166,1672648234,1672650963,2729
11538,3338465050,3281970147,1672628493,1672631825,3332
10233,3390537737,3388937390,1672559877,1672559957,80
10939,3688410383,3455955489,1672555215,1672556023,808
11721,3636852764,3780013266,1672577726,1672580771,3045
11336,3779561601,3773344258,1672697710,1672699900,2190
10071,3533566754,3756685732,1672670457,1672672556,2099
10485,3274341934,3819315404,1672703026,1672704844,1818
10893,3500433278,3207497598,1672629166,1672632368,3202
9874,3856552205,3910049345,1672607465,1672610240,2775
10058,3783238023,3272827860,1672574100,1672574407,307
11117,3220987526,3711591464,1672691860,1672692644,784
11631,3441944896,3774539067,1672540364,1672543155,2791
11243,3772282008,3520925688,1672542372,1672543490,1118
10165,3972729768,3772893815,1672624633,1672626194,1561
11421,3519754667,3435037864,1672657513,1672659092,1579
10784,3558567160,3715284599,1672580607,1672583593,2986
9889,3238310644,3756272704,1672641839,1672643909,2070
11658,3404461403,3380444321,1672595402,1672596724,1322
11551,3756890980,3776561263,1672552488,1672555488,3000
10459,3894495222,3500654356,1672645376,1672646644,1268
11119,3246395239,3738526914,1672677961,1672680685,2724
10498,3488988274,3703476890,1672574169,1672576316,2147
11046,3791205793,3715111016,1672626639,1672629510,2871
9879,3393955069,3760966645,1672699781,1672701699,1918
10066,3517045396,3500178849,1672584776,1672584858,82
11686,3666561358,3318590083,1672689267,1672692442,3175
10243,3856699097,3297100323,1672563807,1672565072,1265
10856,3516827471,3755570137,1672536686,1672540025,3339
10925,3509379617,3935569749,1672663905,1672664984,1079
10953,3390537737,3817076003,1672627783,1672628422,639
10930,3496352027,3279731391,1672565891,1672567084,1193
11573,3429587594,3716944983,1672693805,1672695255,1450
11419,3703694139,3505291330,1672546444,1672546915,471
11097,3664523809,3501550490,1672649853,1672650561,708
11370,3416225867,3779689733,1672634190,1672635197,1007
11344,3533017131,3512641538,1672582339,1672585459,3120
11414,3501271930,3513203127,1672627840,1672628356,516
11020,3511526885,3908464960,1672685372,1672685956,584
10675,3770595035,3756149282,1672635625,1672637029,1404
10812,3514341451,3756897029,1672648873,1672650433,1560
11010,3493598658,3737946004,1672633367,1672633713,346
10850,3510250740,3619676231,1672582461,1672585973,3512
10675,3273758330,3780213684,1672559970,1672563219,3249
9942,3534626053,3773899531,1672621145,1672623057,1912
11717,3533009565,3457249798,1672535298,1672537159,1861
11419,3780050146,3313502623,1672701668,1672703499,1831
10691,3311305760,3689386663,1672695899,1672699192,3293
10756,3438028077,3703896751,1672686964,1672689123,2159
11383,3235470567,3660257653,1672547241,1672549723,2482
9906,3244098077,3613936929,1672676577,1672677164,587
10488,3501427691,3445406685,1672540216,1672540786,570
10270,3437934509,3689386663,1672662128,1672663692,1564
11688,3755942724,3404395454,1672690273,1672692440,2167
10044,3550405857,3277634944,1672627910,1672630231,2321
10586,3342426430,3855977674,1672658341,1672659730,1389
11448,3291936679,3810818108,1672640012,1672641320,1308
11406,3520016705,3919345990,1672661864,1672662522,658
11346,3779130507,3534988162,1672692214,1672694714,2500
10868,3823600319,3534531039,1672571599,1672572206,607
9842,3757549235,3201920708,1672607109,1672608878,1769
9951,3512133625,3738873928,1672648755,1672648840,85
11028,3716595760,3423217578,1672552657,1672553603,946
9805,3534168768,3832902787,1672547408,1672550102,2694
10490,3667814788,3248409083,1672622916,1672623701,785
11171,3604569804,3703694139,1672599730,1672601997,2267
9986,3774145748,3791194984,1672559088,1672560862,1774
11240,3904485393,3634766042,1672617985,1672619344,1359
11274,3701841013,3470997293,1672640410,1672641584,1174
10831,3517469005,3378747834,1672571483,1672572543,1060
11666,3823307824,3733915784,1672632654,1672634040,1386
10774,3533726421,3636852764,1672627643,1672629540,1897
10367,3770709417,3635433296,1672537325,1672540501,3176
9961,3512819376,3773554767,1672600232,1672602054,1822
10903,3220660616,3756685732,1672696642,1672698840,2198
10525,3375905193,3884388188,1672647316,1672648577,1261
9797,3791716170,3832002939,1672660153,1672661282,1129
10719,3291617477,3710046567,1672564003,1672564087,84
10414,3223144610,3973582279,1672627018,1672627768,750
9882,3880882684,3353326305,1672691929,1672694662,2733
11355,3358262975,3557129226,1672679608,1672682791,3183
10481,3534531061,3927504954,1672657730,1672658423,693
11775,3716526314,3554174421,1672649168,1672652045,2877
11337,3482786946,3515558215,1672607809,1672611280,3471
10936,3756740153,3820280594,1672583339,1672585311,1972
10216,3229890340,3714283424,1672600618,1672601237,619
11283,3291153514,3715602742,1672582297,1672583968,1671
11456,3884394685,3791088014,1672574208,1672577774,3566
10768,3402105276,3927699036,1672559675,1672562974,3299
10966,3605905645,3632720032,1672612713,1672613725,1012
11657,3342837214,3513802404,1672648115,1672651321,3206
10364,3783430498,3711065081,1672648381,1672650944,2563
11764,3632094087,3774448657,1672697409,1672698779,1370
9870,3791905743,3703351452,1672565894,1672567223,1329
11282,3774436159,3756695502,1672536764,1672539974,3210
10035,3713740434,3491239350,1672681849,1672683105,1256
10046,3223796145,3774589551,1672690801,1672692267,1466
10250,3229570647,3627081426,1672562413,1672564606,2193
9800,3801379377,3387413950,1672596205,1672598676,2471
11714,3778182724,3513764665,1672663162,1672666632,3470
10633,3783277159,3304447950,1672629827,1672630696,869
10061,3310737478,3774702364,1672634427,1672635884,1457
11552,3393502004,3711852131,1672534585,1672537522,2937
10334,3240877710,3778100960,1672703849,1672704790,941
11094,3510233949,3715249954,1672596807,1672597368,561
10939,3856975355,3777041132,1672617974,1672620552,2578
11461,3760096466,3907088952,1672611651,1672612162,511
11340,3791688526,3495427619,1672701842,1672703440,1598
11752,3293898029,3770631449,1672552311,1672555733,3422
10433,3205687719,3513203127,1672682472,1672683349,877
11528,3385481989,3505416534,1672588750,1672591035,2285
10901,3825526565,3610806770,1672673711,1672677007,3296
10936,3793934396,3638018906,1672659059,1672660636,1577
11706,3713694278,3783043346,1672574314,1672575841,1527
9969,3850904092,3481365330,1672622731,1672625996,3265
10717,3757639274,3611939581,1672603725,1672603894,169
10470,3473706746,3395610742,1672674818,1672676208,1390
11571,3424997707,3701971784,1672541651,1672545018,3367
10095,3713373455,3358434853,1672543664,1672546740,3076
9987,3911821258,3856147380,1672569082,1672572522,3440
11556,3938129916,3701296091,1672648122,1672649210,1088
10081,3776593726,3235578121,1672691735,1672695234,3499
11279,3465107990,3515507526,1672624400,1672626434,2034
10755,3772216305,3500104976,1672648838,1672652386,3548
10736,3534204885,3716801088,1672617231,1672619506,2275
11321,3783947742,3501244753,1672672428,1672674285,1857
10148,3208894215,3513840186,1672586299,1672586575,276
10014,3500062408,3686211958,1672598272,1672600171,1899
11437,3773603836,3511883778,1672617383,1672617679,296
9860,3378172464,3512411326,1672670746,1672672042,1296
11762,3520824937,3831981073,1672542388,1672543612,1224
11186,3380185102,3430310785,1672589856,1672593094,3238
9829,3469778316,3349319959,1672690670,1672691181,511
10710,3757501067,3811629200,1672623496,1672625264,1768
10800,3500863429,3492056330,1672610808,1672611716,908
10488,3716733618,3477248170,1672591852,1672594405,2553
10596,3229570647,3774236212,1672680686,1672684132,3446
11486,3615742989,3372778334,1672558503,1672559729,1226
11357,3439283360,3382670400,1672666193,1672667166,973
11298,3629869834,3831864108,1672560659,1672561714,1055
11150,3410788026,3312612693,1672625677,1672628695,3018
10929,3384001094,3910049345,1672681744,1672682362,618
10254,3837888196,3500178849,1672617044,1672618123,1079
11699,3242149533,3347996015,1672654261,1672654623,362
10334,3805616707,3511341866,1672646380,1672647784,1404
10582,3919719755,3519357822,1672701857,1672702448,591
11234,3757407184,3340897079,1672697515,1672698662,1147
11126,3791409441,3837378340,1672690986,1672693522,2536
11757,3770012744,3206217657,1672696185,1672698266,2081
9840,3353194923,3773085258,1672647542,1672649921,2379
11167,3757030923,3515715968,1672656789,1672659613,2824
11549,3450735824,3461630842,1672623144,1672623591,447
10838,3772188086,3286862903,1672540779,1672540870,91
10145,3757592622,3686211958,1672658433,1672659970,1537
11180,3446233783,3910190872,1672609554,1672612979,3425
11379,3756437169,3976400190,1672559490,1672560333,843
10371,3447696555,3783095041,1672540778,1672543754,2976
10825,3772112976,3505351253,1672575180,1672577325,2145
10204,3904485393,3283847934,1672543721,1672546645,2924
10188,3895944547,3915195160,1672639215,1672639674,459
11781,3618895679,3349475873,1672627937,1672628057,120
10899,3242149533,3776841808,1672650477,1672652477,2000
10498,3493679801,3938021614,1672682050,1672682873,823
9942,3501253130,3906260966,1672600592,1672601240,648
10946,3791031227,3559112196,1672582181,1672584215,2034
10103,3715008501,3892487982,1672582380,1672584807,2427
10263,3887382548,3514352989,1672649383,1672651308,1925
11287,3517652011,3417223898,1672572707,1672575165,2458
11001,3442073613,3979115924,1672661082,1672663710,2628
11754,3312651192,3714718326,1672663577,1672665814,2237
11608,3713767153,3271780525,1672569184,1672571258,2074
11382,3636877469,3514560138,1672581664,1672584784,3120
10874,3683514731,3408111327,1672536961,1672539105,2144
10126,3791905743,3446575109,1672612531,1672613097,566
10388,3791628263,3632094087,1672541842,1672544636,2794
10390,3468343480,3361711720,1672670435,1672673255,2820
10055,3310961923,3446537819,1672617898,1672620898,3000
10631,3274739459,3601340045,1672677973,1672678728,755
10996,3446537819,3898592058,1672607514,1672608160,646
10672,3770630937,3311159418,1672617674,1672619772,2098
10861,3553229537,3338187803,1672587406,1672589443,2037
10129,3366566029,3206377955,1672678759,1672678839,80
10507,3272328752,3770976984,1672666748,1672668610,1862
10459,3438204844,3512480125,1672548733,1672552095,3362
11711,3311159418,3311989687,1672619874,1672620273,399
10952,3517756624,3776034313,1672661181,1672664236,3055
11426,3518794921,3478206139,1672656179,1672658282,2103
11042,3926724515,3276209319,1672535307,1672538122,2815
9812,3416105769,3516429380,1672701125,1672704321,3196
10509,3773534165,3428325402,1672597579,1672599526,1947
10548,3714287902,3713858538,1672640289,1672642768,2479
10060,3311188620,3333477908,1672599785,1672601818,2033
11477,3512477276,3772909073,1672589577,1672591325,1748
11060,3770476738,3924583142,1672551496,1672552280,784
11301,3518425740,3703048107,1672576205,1672579756,3551
10417,3732104286,3512492332,1672598169,1672599566,1397
9974,3505845400,3757592622,1672611719,1672614524,2805
11167,3760144712,3499142934,1672605974,1672609174,3200
9943,3500671218,3825795004,1672554075,1672554813,738
10837,3735152111,3817120976,1672695600,1672696835,1235
11071,3500221079,3201656220,1672551204,1672554060,2856
11103,3534068874,3619796619,1672667680,1672668510,830
9944,3703694139,3773083407,1672553483,1672556598,3115
10087,3756297396,3780563627,1672640379,1672641375,996
11730,3612705426,3714787207,1672633090,1672636408,3318
11003,3519831322,3517960157,1672670287,1672671178,891
11473,3239423794,3491250381,1672598028,1672600900,2872
11641,3403035480,3501583486,1672622529,1672625004,2475
10275,3518368900,3757030923,1672625797,1672627580,1783
10086,3505183641,3510486220,1672684791,1672686644,1853
9936,3430032005,3429409539,1672694253,1672696175,1922
10855,3716944983,3825082811,1672534255,1672535654,1399
10100,3388937390,3440401725,1672623062,1672623170,108
10843,3793704155,3610517436,1672667363,1672669676,2313
10604,3779169946,3732090606,1672591389,1672593376,1987
9979,3509379617,3926065090,1672560468,1672562056,1588
10326,3469663062,3793442891,1672567455,1672569917,2462
10387,3773603836,3432838598,1672684482,1672685693,1211
10671,3776122272,3755584983,1672623061,1672623764,703
10983,3387322545,3913746581,1672542202,1672543765,1563
11417,3774355339,3755229631,1672623977,1672624404,427
10760,3911431642,3783679478,1672590376,1672591250,874
10983,3510335069,3430310785,1672535277,1672538707,3430
11477,3435037864,3246296769,1672532396,1672533168,772
10463,3900195680,3514341451,1672668110,1672669828,1718
11475,3374552204,3519174861,1672555439,1672555634,195
10067,3773579644,3303552616,1672602328,1672605322,2994
11414,3662495290,3627431396,1672675479,1672677454,1975
9891,3907039612,3403257752,1672534234,1672537635,3401
10261,3483701493,3710515351,1672538199,1672540965,2766
10726,3773852157,3770273459,1672627532,1672629904,2372
11032,3779415433,3827889533,1672673939,1672675493,1554
10683,3820280594,3311810583,1672668640,1672668792,152
11430,3533816813,3792455305,1672641605,1672642982,1377
9934,3774627091,3500591274,1672591234,1672593295,2061
10628,3515378306,3505414878,1672660070,1672662556,2486
10784,3467756698,3760443176,1672697444,1672699467,2023
10185,3488399075,3500440602,1672546253,1672549013,2760
10331,3417431173,3772019557,1672693150,1672693718,568
10740,3510335069,3512417028,1672676742,1672677752,1010
10864,3347760784,3381244346,1672647965,1672651347,3382
11556,3453164933,3520470646,1672606275,1672607781,1506
10421,3510484107,3620836520,1672668718,1672670634,1916
10973,3479452888,3335055096,1672665074,1672665891,817
9854,3519015940,3512417724,1672553309,1672555153,1844
11787,3701296091,3791688526,1672662599,1672665305,2706
10842,3295530454,3779561601,1672640197,1672640584,387
10324,3815440588,3902357342,1672644080,1672644383,303
10426,3501271930,3202740652,1672678198,1672678506,308
11099,3756843139,3534531061,1672634167,1672636657,2490
11592,3520049965,3475033290,1672689363,1672692745,3382
11169,3931495845,3486509752,1672537429,1672540013,2584
11091,3915460293,3209925780,1672622097,1672624854,2757
9820,3755769731,3667814788,1672692569,1672693320,751
10376,3505769529,3907088952,1672622357,1672623467,1110
10192,3311514075,3888642876,1672688394,1672691834,3440
10803,3478052226,3827836825,1672669149,1672670069,920
11418,3512480125,3293579860,1672581013,1672583982,2969
11265,3826315540,3881012415,1672693112,1672693514,402
10529,3500031401,3668154066,1672673098,1672675604,2506
10548,3433189219,3516321814,1672640519,1672643221,2702
11439,3800434325,3780294116,1672608440,1672610355,1915
10781,3207307681,3479452888,1672543841,1672546402,2561
9841,3884394685,3618895679,1672629045,1672631948,2903
9871,3276499910,3778924002,1672619852,1672622982,3130
11086,3342495377,3519322066,1672703800,1672706162,2362
10508,3836090778,3773408491,1672602513,1672603269,756
10694,3510916875,3701493094,1672678935,1672681162,2227
10316,3974264211,3711844574,1672632163,1672634071,1908
11147,3756680289,3447938130,1672654760,1672657081,2321
11440,3475653510,3774782065,1672634965,1672638127,3162
10955,3419378107,3554317844,1672692058,1672694069,2011
10622,3435652260,3701668745,1672604357,1672606222,1865
11136,3236360179,3517331746,1672618946,1672620542,1596
11766,3461931154,3777204977,1672663429,1672664233,804
11572,3918126468,3602570831,1672667146,1672667419,273
10043,3513432588,3852992961,1672633084,1672636326,3242
10660,3773899531,3896622009,1672574605,1672577454,2849
10281,3623953446,3517992521,1672553386,1672554243,857
10874,3772943811,3933469838,1672570904,1672572777,1873
11362,3470962222,3510968599,1672701745,1672704323,2578
10673,3505816624,3513894659,1672668662,1672672015,3353
10133,3711959141,3519922921,1672538131,1672540347,2216
9993,3811351746,3505853594,1672633564,1672636504,2940
11359,3850993995,3756761603,1672621434,1672624822,3388
10156,3669427589,3207497598,1672613437,1672615786,2349
9974,3335055096,3516867729,1672624402,1672625523,1121
10124,3791584994,3208519320,1672601351,1672603125,1774
11172,3499622352,3850993995,1672597619,1672599636,2017
10088,3430823498,3500590302,1672532939,1672534090,1151
10079,3792597493,3500720752,1672606105,1672609552,3447
10675,3780423516,3534174363,1672703393,1672706919,3526
11429,3756717136,3855629383,1672665116,1672668520,3404
10575,3222364320,3931164237,1672663836,1672666869,3033
10489,3501612813,3800434325,1672542981,1672543844,863
10388,3760144712,3514005973,1672606062,1672607273,1211
10002,3310961923,3858330969,1672601305,1672601666,361
11595,3393955069,3835982340,1672643872,1672647257,3385
10091,3971289056,3715111016,1672659714,1672662876,3162
11373,3519357822,3779212271,1672695031,1672697897,2866
10549,3792627762,3818904268,1672675424,1672678694,3270
10127,3425545115,3512625661,1672550826,1672552412,1586
10581,3793934396,3714919471,1672598545,1672599767,1222
10549,3312946269,3379400553,1672613069,1672616271,3202
10624,3501992314,3467415939,1672655996,1672656487,491
9879,3772877723,3377883705,1672566385,1672569674,3289
10684,3770976984,3850108828,1672627654,1672628444,790
10946,3520470646,3716209499,1672649264,1672651523,2259
11094,3714516404,3936851114,1672680494,1672682434,1940
10955,3476144563,3770486161,1672666093,1672669185,3092
10434,3666561358,3491948594,1672675579,1672677984,2405
10508,3856601074,3404187438,1672656502,1672658551,2049
10525,3533225084,3464622743,1672675769,1672677426,1657
11496,3533566754,3505828210,1672558618,1672561780,3162
10220,3604569804,3443041059,1672594906,1672595104,198
10690,3519000878,3772282008,1672575674,1672576534,860
10426,3813085701,3514033319,1672603892,1672606366,2474
10944,3350966326,3505482210,1672673849,1672676761,2912
11090,3231654754,3355899481,1672667207,1672667537,330
11775,3275171954,3505351253,1672634420,1672637943,3523
10615,3808442442,3402105276,1672531934,1672534417,2483
9851,3666022373,3382757142,1672600059,1672602286,2227
10924,3358385652,3626631210,1672703518,1672706422,2904
10213,3438028077,3307236682,1672594881,1672595801,920
11253,3885147558,3885339157,1672615923,1672617440,1517
10818,3511794841,3669918958,1672596868,1672599094,2226
10376,3773697080,3927763819,1672636830,1672640257,3427
11517,3534491112,3756066765,1672676455,1672678072,1617
10318,3602680347,3533365834,1672631149,1672633139,1990
11000,3555764822,3780511388,1672608929,1672611160,2231
11731,3514007122,3770285500,1672606777,1672608345,1568
10144,3388937390,3493598658,1672665354,1672668284,2930
10565,3505351253,3285322570,1672675733,1672676871,1138
10304,3241855333,3366566029,1672693234,1672694351,1117
11699,3341129425,3391612879,1672676234,1672678154,1920
10036,3711214982,3716463756,1672580176,1672581748,1572
9972,3820280594,3779312237,1672551119,1672552957,1838
11712,3755286041,3755229631,1672550097,1672550708,611
11046,3447948483,3886957097,1672703259,1672704303,1044
9992,3710260848,3510022922,1672671395,1672674347,2952
10027,3202740652,3453164933,1672624072,1672626664,2592
10270,3760525465,3292663993,1672607775,1672608915,1140
10695,3755361692,3911821258,1672656461,1672658377,1916
11074,3713283029,3519494023,1672669453,1672672448,2995
9909,3713694278,3514576083,1672578700,1672579658,958
11209,3520165730,3307997700,1672664958,1672668167,3209
10479,3773840321,3973138649,1672577156,1672577914,758
11361,3468871103,3776348451,1672533694,1672534323,629
11494,3206544535,3514980025,1672562501,1672566084,3583
11471,3307535495,3777686966,1672696114,1672697590,1476
10816,3248061684,3792708936,1672642134,1672643226,1092
11494,3977880564,3520471156,1672540599,1672541434,835
10970,3388937390,3492350318,1672692256,1672694610,2354
10536,3977157565,3301403047,1672637958,1672641554,3596
10004,3772251279,3776125503,1672693820,1672697022,3202
11679,3333355914,3534941710,1672583161,1672586461,3300
10851,3308149799,3291153514,1672616932,1672617926,994
11535,3452389513,3600871715,1672566457,1672569995,3538
10035,3689420679,3701663839,1672585116,1672585924,808
11302,3614484939,3856316719,1672658583,1672660344,1761
11412,3665603628,3817029483,1672536911,1672538184,1273
10503,3703415246,3520165730,1672562692,1672565205,2513
10126,3774921252,3510824484,1672702043,1672705512,3469
10563,3244098077,3395615598,1672634505,1672636267,1762
11075,3770976984,3938409715,1672622832,1672624489,1657
9947,3510262025,3294164983,1672629030,1672631170,2140
9863,3827836825,3666823095,1672563604,1672565740,2136
10624,3501550490,3774589551,1672601365,1672603539,2174
10408,3500440602,3274239253,1672599656,1672601258,1602
11717,3773408491,3425545115,1672650519,1672653565,3046
11526,3905889514,3285587972,1672561395,1672563864,2469
9870,3701893620,3534562354,1672663412,1672665687,2275
11671,3311414429,3400560073,1672532392,1672534985,2593
10988,3501126057,3519341916,1672606181,1672606973,792
10281,3509996827,3805616707,1672660729,1672663264,2535
11600,3500145103,3387388336,1672698014,1672700071,2057
11302,3793899166,3201634072,1672699626,1672702016,2390
11346,3639503148,3288346356,1672531517,1672534829,3312
10423,3664719070,3792851584,1672673983,1672674122,139
10419,3400112498,3931495845,1672533649,1672535429,1780
11477,3303432071,3776309810,1672624802,1672625927,1125
10682,3275751794,3365839890,1672576220,1672579689,3469
11014,3774221318,3628556590,1672647066,1672650140,3074
11111,3385481989,3489340327,1672620483,1672621814,1331
10324,3318250647,3294949958,1672671134,1672674184,3050
11373,3512527440,3514685272,1672652500,1672654087,1587
10181,3515802579,3287753579,1672587859,1672590549,2690
10862,3496352027,3310961923,1672533621,1672534133,512
11510,3777672363,3279102372,1672534663,1672535693,1030
11662,3474097405,3512417724,1672577876,1672578250,374
10650,3534206917,3505117019,1672642664,1672643374,710
11022,3621591266,3501171785,1672595486,1672597617,2131
10545,3773826624,3738429905,1672560820,1672562374,1554
11141,3895944547,3347760784,1672679625,1672681924,2299
10625,3515715968,3737685967,1672539965,1672541551,1586
9846,3904485393,3638823001,1672568933,1672572092,3159
11371,3668720465,3273537848,1672614476,1672617827,3351
11541,3823307824,3791088014,1672667945,1672669095,1150
10542,3519947298,3519255644,1672608107,1672610828,2721
9875,3779454060,3236563828,1672597436,1672600005,2569
10161,3774326754,3755779925,1672536526,1672540043,3517
10781,3839744168,3469350379,1672682969,1672685178,2209
11351,3500909455,3555378248,1672679089,1672681544,2455
11480,3501992314,3793899166,1672621166,1672623236,2070
10244,3510484107,3829358750,1672694191,1672696445,2254
10122,3339331632,3444295435,1672627401,1672627606,205
10132,3519712497,3236948071,1672680780,1672683684,2904
10443,3826542169,3534459983,1672587776,1672591089,3313
11036,3230612965,3497138014,1672583561,1672586078,2517
10963,3490804766,3505190512,1672653742,1672656126,2384
11509,3550206045,3367109648,1672531678,1672532019,341
11047,3313392810,3421674406,1672665971,1672668943,2972
10925,3689420679,3427527462,1672611587,1672612072,485
10847,3703737650,3519922921,1672547828,1672547917,89
10937,3701596047,3393909269,1672676773,1672678159,1386
11676,3776183353,3395505794,1672648522,1672649250,728
11765,3701374160,3505828210,1672559933,1672560750,817
11574,3495482863,3711176990,1672535035,1672538047,3012
10940,3243305367,3915652382,1672562752,1672564103,1351
10388,3851515560,3510826414,1672605923,1672607445,1522
11619,3277634944,3703474558,1672651914,1672652817,903
11783,3533728729,3520160414,1672604742,1672606972,2230
11697,3513816744,3514628916,1672695265,1672695423,158
10518,3396440259,3931917809,1672568548,1672569619,1071
10771,3779951373,3927805949,1672570745,1672574260,3515
11388,3756685732,3515304526,1672608543,1672611360,2817
11129,3915195160,3756066765,1672570810,1672573994,3184
10500,3510882475,3342235058,1672645550,1672647535,1985
11540,3510291656,3495482863,1672610896,1672612039,1143
10590,3760346746,3349475873,1672673774,1672674604,830
10222,3631444265,3509912164,1672569511,1672569598,87
11672,3713636175,3501225887,1672582387,1672585850,3463
11470,3287968403,3793874490,1672652319,1672655587,3268
11303,3517325365,3295530454,1672697983,1672701189,3206
10341,3518408734,3278251248,1672551483,1672552953,1470
11275,3519102732,3517652011,1672622402,1672624639,2237
11159,3779665641,3600978954,1672589150,1672592060,2910
10487,3233917789,3533419409,1672586306,1672589834,3528
9973,3443580855,3739387948,1672610919,1672611251,332
11754,3533929043,3505234868,1672698365,1672699726,1361
10540,3445896667,3776183353,1672616869,1672619330,2461
10736,3379076106,3461877104,1672564961,1672566617,1656
10196,3757660578,3600302127,1672692611,1672693595,984
10188,3304447950,3777370601,1672685751,1672687868,2117
9832,3637105495,3495637721,1672621835,1672625385,3550
9826,3466620548,3814289471,1672655325,1672657020,1695
11251,3973582279,3835599049,1672553861,1672554065,204
11039,3518088154,3500329674,1672605279,1672608347,3068
11023,3792440162,3714923092,1672686007,1672688302,2295
11214,3755779925,3770486161,1672678040,1672680021,1981
11092,3783277159,3511004622,1672571879,1672572972,1093
10333,3340897079,3774483862,1672599166,1672602456,3290
10023,3520009158,3820922991,1672635110,1672637615,2505
10445,3755218683,3701171318,1672624089,1672625999,1910
10228,3511466117,3440401725,1672630487,1672630959,472
11294,3779818784,3820200446,1672586618,1672588696,2078
10553,3975799349,3756717136,1672594151,1672596773,2622
10100,3714455496,3534937492,1672689474,1672691794,2320
9810,3510153173,3915652382,1672666934,1672667139,205
11721,3783939161,3510864325,1672563710,1672564231,521
10088,3778253021,3772055279,1672584793,1672587664,2871
10666,3505665788,3500863429,1672611225,1672611436,211
10993,3305657559,3895839169,1672658633,1672660648,2015
10321,3398075553,3755229631,1672654499,1672656076,1577
10741,3605905645,3429333292,1672679862,1672680057,195
10952,3520694387,3509614126,1672579989,1672580484,495
10415,3710051427,3900766525,1672567199,1672570252,3053
10120,3299845453,3760737203,1672682387,1672684528,2141
11366,3416079461,3770981604,1672679930,1672682024,2094
9959,3501853868,3374552204,1672696793,1672699784,2991
11721,3711223297,3735197034,1672557042,1672559575,2533
10312,3519167605,3272328752,1672640646,1672643903,3257
10550,3491527603,3517617472,1672602821,1672605208,2387
11069,3783939161,3301449986,1672547594,1672549878,2284
11434,3533841983,3779427180,1672545364,1672545511,147
10641,3770574826,3364067937,1672566223,1672568720,2497
10055,3777498160,3852275715,1672551739,1672554442,2703
10836,3203172170,3556684272,1672678366,1672681571,3205
10975,3812277991,3757728121,1672592153,1672593161,1008
10501,3716195780,3711258452,1672671120,1672671686,566
10093,3772802020,3682802569,1672554808,1672555490,682
9810,3852461753,3489340327,1672601010,1672602512,1502
9827,3884934977,3519780867,1672551185,1672554124,2939
10398,3711219767,3510795808,1672630744,1672633123,2379
11547,3463883997,3483701493,1672646792,1672648083,1291
11188,3756363182,3520515739,1672555506,1672556299,793
9817,3774221318,3505234868,1672654629,1672657380,2751
11346,3613781977,3407403080,1672548956,1672551672,2716
10654,3778927933,3518157683,1672618823,1672620357,1534
9849,3203630241,3398021818,1672533088,1672535606,2518
9946,3284374600,3894495222,1672702528,1672702914,386
11077,3424988692,3371759126,1672673883,1672674603,720
10926,3850005949,3206377955,1672640521,1672642541,2020
10504,3505901826,3287403291,1672605991,1672608425,2434
9935,3505482210,3618895679,1672701509,1672703605,2096
11531,3825795004,3881579907,1672700465,1672702124,1659
10493,3206262649,3500693568,1672670941,1672673331,2390
11282,3558349840,3519351747,1672586018,1672587600,1582
10285,3685877449,3665603628,1672656470,1672656888,418
10594,3505248368,3361711720,1672648673,1672651343,2670
11282,3380185102,3510869438,1672646582,1672646930,348
10957,3772234939,3738429905,1672564391,1672567407,3016
10909,3493598658,3514389188,1672549610,1672551047,1437
9978,3501711464,3703737650,1672553275,1672553648,373
11015,3519494023,3856601074,1672633461,1672635889,2428
10172,3510439480,3393543588,1672582396,1672583974,1578
10382,3444646562,3803382101,1672651153,1672651640,487
11461,3446233783,3893043842,1672539348,1672539434,86
9799,3338465050,3483078667,1672696396,1672697244,848
10655,3500799617,3783695231,1672606110,1672608345,2235
11481,3440582836,3736941123,1672702316,1672704737,2421
10924,3444453261,3776001441,1672672480,1672672695,215
11630,3515577866,3293553295,1672547211,1672547446,235
11618,3783879023,3275735969,1672694326,1672696174,1848
11208,3734957248,3776593726,1672643243,1672644933,1690
10485,3757198930,3299845453,1672682367,1672683886,1519
9842,3922430928,3505234868,1672670215,1672673116,2901
10875,3430310785,3780213684,1672699507,1672701493,1986
11427,3812677669,3511198566,1672598252,1672601578,3326
10978,3931164237,3778544203,1672645093,1672646617,1524
11792,3552444228,3777263928,1672589712,1672591667,1955
10082,3248061684,3756363182,1672601334,1672603108,1774
11157,3380185102,3880788853,1672573084,1672574168,1084
10030,3319585148,3770018912,1672647931,1672651371,3440
10905,3756272704,3533209168,1672567768,1672568637,869
11528,3756850160,3231963246,1672616949,1672620036,3087
10838,3613781977,3472774606,1672534137,1672534529,392
9916,3829761380,3501711464,1672567011,1672568024,1013
11474,3519297683,3515259326,1672595363,1672598772,3409
10788,3880000841,3220123678,1672578496,1672579373,877
10137,3517718901,3443041059,1672644061,1672647585,3524
11422,3288675710,3701284535,1672543439,1672544417,978
11286,3909632424,3455955489,1672574756,1672576959,2203
11379,3243305367,3684199077,1672566431,1672568598,2167
10725,3714516404,3511963020,1672672711,1672676036,3325
10133,3938129916,3616242727,1672569977,1672572854,2877
10167,3779102237,3802625412,1672697636,1672698258,622
11159,3276209319,3518759318,1672571886,1672573428,1542
11542,3911376818,3711430738,1672677502,1672680855,3353
11039,3435037864,3776901443,1672573032,1672574843,1811
10173,3793822639,3793822639,1672680552,1672681046,494
11459,3802101760,3441840658,1672653579,1672656985,3406
10093,3662354016,3533113740,1672531717,1672532136,419
11636,3792107875,3516668203,1672634078,1672635021,943
10321,3773636983,3464622743,1672685471,1672687998,2527
11346,3783826338,3776068937,1672642097,1672643282,1185
9865,3520049965,3512072679,1672655116,1672657037,1921
11726,3515230715,3491390365,1672618200,1672620844,2644
9956,3755203055,3555215568,1672608780,1672609877,1097
11216,3392573386,3516359146,1672679300,1672682232,2932
10147,3519065870,3519015940,1672696237,1672697210,973
10285,3302879906,3666561358,1672549061,1672552027,2966
10031,3880637958,3880000841,1672696268,1672698303,2035
10415,3780467276,3813111107,1672672646,1672674632,1986
11330,3510262025,3510758718,1672543049,1672545947,2898
10654,3494157939,3803382101,1672618930,1672620375,1445
11601,3368951504,3777655401,1672576504,1672578910,2406
9903,3684108920,3318250647,1672602781,1672605717,2936
10530,3400545490,3308759754,1672610578,1672613109,2531
10929,3703423962,3388923880,1672687903,1672690910,3007
10674,3772320856,3739395381,1672637751,1672640570,2819
11284,3713416106,3663353552,1672562119,1672564642,2523
9979,3760271237,3403150349,1672602184,1672604262,2078
10188,3239779992,3517253559,1672671887,1672675048,3161
11202,3501253130,3358530225,1672662496,1672663337,841
10937,3338016147,3458130310,1672625748,1672629276,3528
10799,3813111107,3500415589,1672635413,1672636602,1189
10525,3779503296,3436099135,1672591218,1672593957,2739
9866,3716423829,3772708314,1672662165,1672664095,1930
10520,3974264211,3488988274,1672554496,1672555927,1431
11288,3511907179,3456795601,1672539667,1672543053,3386
9971,3388915945,3511415786,1672552349,1672555900,3551
10136,3703336988,3518335611,1672594704,1672595249,545
10683,3311989687,3534626053,1672631859,1672633223,1364
11127,3774394000,3437023385,1672617184,1672619367,2183
10303,3513777705,3776727271,1672636488,1672638854,2366
11547,3512726649,3780563627,1672651457,1672654493,3036
9919,3783368855,3519255644,1672698397,1672698859,462
11483,3379517265,3716178116,1672541946,1672543389,1443
9979,3235578121,3481365330,1672622111,1672622187,76
10737,3783554600,3318220119,1672652333,1672655636,3303
11626,3314965818,3336225953,1672636391,1672636564,173
11508,3514801709,3710919244,1672667658,1672668204,546
11565,3715140418,3810584695,1672653341,1672656253,2912
11521,3292050211,3311133296,1672629752,1672630991,1239
11293,3802101760,3500688476,1672634115,1672636838,2723
10657,3713840946,3793569914,1672559434,1672563020,3586
10464,3501115299,3826542169,1672607726,1672607904,178
11211,3482786946,3624307518,1672605564,1672606681,1117
11236,3400793223,3773017746,1672643547,1672646077,2530
10359,3976742903,3285322570,1672536379,1672537235,856
11782,3465690527,3713920790,1672665736,1672667316,1580
10820,3936486724,3517943697,1672648584,1672650232,1648
10726,3446218191,3393376416,1672608529,1672609492,963
10166,3380444321,3815184540,1672592326,1672593939,1613
10948,3516819320,3518572231,1672637788,1672637871,83
9963,3500438542,3755507566,1672540940,1672543075,2135
10715,3519513219,3859191694,1672547130,1672550109,2979
10099,3510819040,3311264420,1672541193,1672544032,2839
11364,3358434853,3422915648,1672583922,1672586306,2384
10208,3505140123,3714065165,1672684951,1672687873,2922
10137,3730571757,3313282478,1672649165,1672649516,351
10249,3520779124,3515405509,1672579141,1672581499,2358
11447,3311774510,3772962072,1672615315,1672616059,744
9997,3476416072,3304447950,1672646286,1672649358,3072
11074,3778695895,3928076270,1672547483,1672549466,1983
10287,3857909328,3205161801,1672695268,1672695332,64
10148,3509167758,3440991826,1672695396,1672697334,1938
10553,3778479297,3818324410,1672575629,1672578837,3208
11195,3392482187,3429409539,1672555587,1672558344,2757
10843,3714595459,3519046342,1672682214,1672683114,900
10966,3426468199,3772235668,1672565208,1672567795,2587
11345,3770476738,3423346297,1672588821,1672592414,3593
10783,3774304163,3516454693,1672697595,1672700382,2787
9994,3665431349,3772509599,1672545560,1672547806,2246
10558,3514685272,3900195680,1672569654,1672571784,2130
11556,3688130094,3435652260,1672590730,1672592251,1521
10386,3330799389,3500543341,1672675930,1672676097,167
9996,3313579674,3488749569,1672629749,1672629884,135
10412,3233965781,3343767438,1672540436,1672541165,729
11356,3516319492,3792432763,1672609449,1672611994,2545
11063,3736885568,3390438262,1672691091,1672691336,245
10940,3496591885,3774782065,1672638563,1672641683,3120
10966,3803473387,3713100169,1672590850,1672592413,1563
11014,3313392810,3294949958,1672573970,1672576774,2804
10998,3710185376,3757924067,1672610577,1672613287,2710
10543,3501759031,3512288503,1672547579,1672548198,619
11556,3772250554,3636927297,1672619135,1672620358,1223
11159,3514611187,3703588004,1672616880,1672618998,2118
11251,3755849241,3231227362,1672575646,1672577511,1865
9993,3272827860,3500624846,1672690817,1672692385,1568
11681,3703423962,3773041843,1672569630,1672572325,2695
10221,3780148144,3756168814,1672677872,1672679165,1293
10410,3893527651,3793719515,1672591411,1672594379,2968
9994,3732090606,3757032266,1672544958,1672546472,1514
11104,3512417028,3272096922,1672660145,1672663705,3560
11551,3760776967,3519055736,1672614409,1672616459,2050
10766,3738547113,3682673884,1672575671,1672575870,199
11117,3776791436,3902300755,1672668157,1672670501,2344
11560,3278629965,3440671139,1672631568,1672632377,809
11136,3715204544,3755192104,1672658001,1672660912,2911
10893,3778731000,3713694278,1672690201,1672690372,171
9957,3334824744,3803473387,1672620489,1672622649,2160
11384,3774921252,3777672363,1672681335,1672684362,3027
11530,3201573194,3444680955,1672580053,1672582925,2872
10626,3776166086,3534626053,1672545935,1672548348,2413
10548,3468281011,3715196780,1672632000,1672634926,2926
11119,3516167000,3791205793,1672572872,1672574974,2102
10274,3617771673,3756761603,1672690479,1672693065,2586
9861,3773669001,3834424604,1672544731,1672545656,925
10356,3505502819,3231654754,1672689783,1672690051,268
10882,3333477908,3778909412,1672595182,1672596698,1516
11550,3780500764,3487231844,1672557061,1672558951,1890
10757,3711836873,3792797648,1672563414,1672566825,3411
10481,3624872714,3716341323,1672562751,1672562846,95
10967,3387413950,3283106998,1672687213,1672690731,3518
10742,3778695895,3519167605,1672701468,1672703699,2231
10122,3510826414,3243305367,1672602344,1672602756,412
11786,3337675386,3757201538,1672609694,1672612117,2423
10815,3809860102,3500421940,1672598314,1672600780,2466
10832,3514352989,3894756677,1672612565,1672614238,1673
11299,3836136159,3302348002,1672602063,1672603037,974
10668,3278779955,3792283334,1672598247,1672601748,3501
11119,3229615214,3518511124,1672658607,1672661474,2867
10004,3770023722,3307997700,1672673596,1672676751,3155
11174,3473562779,3446575109,1672609492,1672610868,1376
11675,3384151770,3778986795,1672661836,1672662620,784
10094,3467944159,3760529327,1672544965,1672548311,3346
11598,3512306195,3534206917,1672674797,1672675388,591
11179,3773424266,3776583229,1672697400,1672700271,2871
11543,3713100169,3512768285,1672664384,1672667673,3289
10587,3779815753,3455955489,1672615108,1672617389,2281
11057,3604569804,3367262509,1672665131,1672665991,860
10581,3780648744,3511415786,1672655954,1672656486,532
11563,3517902505,3316821313,1672658976,1672660549,1573
9970,3382670400,3472774606,1672635607,1672637075,1468
11371,3518067857,3770457058,1672703353,1672704287,934
11166,3512546783,3370751461,1672674605,1672675217,612
10744,3713475356,3715111016,1672558513,1672561987,3474
11662,3732440502,3805926853,1672551574,1672555070,3496
11708,3335055096,3510149298,1672676699,1672678973,2274
10028,3684199077,3817029483,1672642457,1672643690,1233
10349,3220987526,3436401020,1672685140,1672688118,2978
11761,3936486724,3284829602,1672688973,1672689285,312
10032,3509651954,3439532406,1672695167,1672698092,2925
11682,3915679140,3774822697,1672615186,1672618064,2878
10605,3791664049,3770981604,1672558301,1672559062,761
11384,3777932225,3509317776,1672554057,1672557530,3473
10537,3930727474,3701725839,1672622335,1672623024,689
10328,3683562111,3512555384,1672540705,1672542242,1537
10434,3812261241,3736885568,1672615529,1672615881,352
11394,3791522832,3714283424,1672626801,1672627121,320
10728,3457249798,3714281795,1672593103,1672593992,889
10297,3711065081,3300238532,1672572856,1672573089,233
10411,3791688526,3473706746,1672617929,1672619527,1598
11672,3715106566,3491390365,1672598491,1672598855,364
10185,3703502114,3359880163,1672539140,1672542399,3259
11642,3977880564,3780142207,1672627155,1672628348,1193
10673,3756948477,3450503086,1672662669,1672664694,2025
11096,3509508477,3735679000,1672673492,1672676988,3496
11730,3780740477,3780482864,1672560534,1672562289,1755
11055,3793407883,3227206772,1672650755,1672651127,372
10572,3701978422,3466620548,1672693553,1672695853,2300
9806,3282053097,3500555856,1672672558,1672676124,3566
10527,3711404205,3904184638,1672680579,1672683439,2860
11787,3490008012,3791289855,1672597098,1672598555,1457
9989,3512477276,3247193800,1672700983,1672703305,2322
9989,3333355914,3518067857,1672616593,1672620119,3526
10315,3733870816,3760396348,1672629792,1672631340,1548
11456,3756367938,3932491622,1672628053,1672628530,477
11621,3825526565,3247075753,1672544823,1672546447,1624
11460,3760710525,3829358750,1672697311,1672698052,741
11267,3505121295,3519730914,1672574912,1672575236,324
10135,3511476353,3730600658,1672567154,1672569141,1987
10448,3228477490,3666823095,1672698332,1672698646,314
11450,3475653510,3286938590,1672623746,1672624975,1229
9846,3553008208,3510856388,1672541828,1672544769,2941
11293,3384601925,3604908372,1672622326,1672624517,2191
9906,3517797610,3665431349,1672548266,1672550568,2302
11213,3703419800,3777304517,1672648604,1672650972,2368
11619,3793407883,3780921044,1672656707,1672659804,3097
11125,3510916875,3335139032,1672609563,1672612872,3309
10360,3713285095,3772131127,1672629183,1672629692,509
10702,3364067937,3777135415,1672665261,1672667621,2360
11626,3364718040,3446218191,1672574583,1672575453,870
10112,3714435747,3510218188,1672646415,1672649460,3045
9880,3429610195,3835982340,1672534430,1672534921,491
11540,3505129296,3512768285,1672596455,1672597320,865
11685,3710046567,3231227362,1672691970,1672694566,2596
10647,3807646028,3372236721,1672622996,1672624284,1288
11639,3519924982,3514685272,1672563613,1672566570,2957
10432,3935520819,3239401337,1672693541,1672694036,495
9977,3516249472,3777112124,1672604023,1672605065,1042
9976,3331471764,3369938668,1672648629,1672649935,1306
10658,3301765144,3442181067,1672577608,1672578461,853
10282,3421524698,3209075485,1672645417,1672648429,3012
10241,3510244209,3935256825,1672552407,1672555615,3208
10786,3509663119,3615245840,1672621379,1672622892,1513
10836,3779975575,3895944547,1672588216,1672589309,1093
11450,3735056027,3512417724,1672625018,1672627533,2515
10309,3418791124,3475653510,1672701676,1672704529,2853
11610,3511415786,3285587972,1672576998,1672578557,1559
11758,3343193067,3207307681,1672640182,1672641471,1289
11059,3667950469,3660702754,1672666367,1672668568,2201
10307,3772609551,3514571807,1672613597,1672614491,894
10352,3770480149,3915460293,1672601058,1672603572,2514
11715,3774965463,3295748489,1672578781,1672581274,2493
11101,3500018566,3517943697,1672616142,1672616440,298
11772,3760274119,3609925909,1672661834,1672664728,2894
10395,3519831322,3919719755,1672663083,1672665689,2606
10751,3634766042,3352057037,1672559021,1672561503,2482
10118,3203457161,3388915945,1672535416,1672538929,3513
9826,3914947393,3907039612,1672623369,1672626338,2969
10379,3516019206,3402105276,1672593440,1672594511,1071
10976,3770276815,3276393542,1672691520,1672693637,2117
11670,3710173412,3408408584,1672683474,1672686255,2781
10757,3760541837,3619796619,1672627523,1672629019,1496
10234,3519712497,3665603628,1672685775,1672688956,3181
11381,3779312237,3284407073,1672648348,1672649941,1593
10693,3713139039,3713636175,1672654677,1672655864,1187
10116,3793814153,3505786561,1672627654,1672628538,884
10980,3501619113,3891586951,1672618523,1672619158,635
10220,3299587876,3552922094,1672535883,1672538153,2270
9813,3514576083,3636605690,1672596068,1672598573,2505
11709,3778842400,3902682060,1672595942,1672596258,316
10950,3501583486,3518058151,1672531456,1672531526,70
10472,3780900318,3756168814,1672621077,1672621270,193
10249,3930766276,3880562532,1672533441,1672535719,2278
11608,3516497645,3837888196,1672611632,1672614769,3137
10306,3926065090,3509360869,1672580457,1672581830,1373
10542,3819315404,3756437169,1672625639,1672628646,3007
10664,3791509881,3517021928,1672672962,1672673511,549
10828,3500438542,3716118473,1672540009,1672542424,2415
10237,3737745988,3829698950,1672581364,1672582315,951
10442,3815440588,3885339157,1672647628,1672649076,1448
9923,3551972633,3432050858,1672667720,1672669152,1432
11197,3971282455,3517440258,1672681029,1672681850,821
9911,3472561941,3271282663,1672576362,1672578465,2103
10940,3778817220,3910049345,1672557251,1672557679,428
11222,3929391979,3772802020,1672567242,1672567467,225
10789,3512784888,3554236075,1672633912,1672635044,1132
10846,3779609338,3311331205,1672688701,1672690818,2117
11659,3773434690,3770991234,1672587198,1672589602,2404
10021,3279731391,3821087562,1672658165,1672660352,2187
11720,3505697295,3903994989,1672538309,1672539308,999
11208,3760687922,3793081195,1672648664,1672651237,2573
11633,3773475506,3519965717,1672563836,1672564593,757
11384,3714116241,3893629892,1672698740,1672699301,561
11005,3898595916,3488749569,1672699435,1672702299,2864
10271,3500455935,3358982831,1672683559,1672684623,1064
10383,3513215373,3291446384,1672623160,1672625757,2597
10299,3624307518,3440401725,1672691949,1672693497,1548
11477,3611298237,3247193800,1672585927,1672589381,3454
11613,3367202274,3927181190,1672552191,1672552724,533
11549,3838119022,3896859936,1672551595,1672554257,2662
9943,3518572231,3972196462,1672676871,1672677805,934
10870,3509508477,3703749690,1672578842,1672580103,1261
11425,3931319307,3282053097,1672576334,1672577929,1595
10845,3519937708,3756079870,1672684730,1672687334,2604
11007,3715126587,3510916875,1672531396,1672531886,490
11739,3422915648,3243763209,1672569868,1672572443,2575
9863,3552309108,3501370430,1672568387,1672570675,2288
11275,3774236212,3615846003,1672674916,1672677930,3014
10347,3780127017,3713224038,1672617378,1672620913,3535
10434,3435801763,3757773786,1672681772,1672683156,1384
10005,3760648750,3334461288,1672631258,1672634103,2845
9966,3682241594,3732846295,1672671907,1672672780,873
10577,3778838936,3347205332,1672599724,1672602964,3240
9884,3669475165,3681274982,1672582862,1672583904,1042
10697,3732440502,3501515425,1672666972,1672670243,3271
10357,3853386575,3621591266,1672682484,1672682610,126
10774,3487231844,3757406215,1672688945,1672692473,3528
10292,3933106901,3713434898,1672658079,1672660464,2385
10409,3776593726,3711029952,1672575518,1672576166,648
9861,3394976623,3512697456,1672658027,1672658954,927
10407,3471507117,3793497672,1672554899,1672555493,594
9846,3822315407,3534624672,1672671671,1672674878,3207
11619,3892177203,3472272792,1672583359,1672586235,2876
10571,3773440794,3224053840,1672679627,1672681040,1413
10813,3914740937,3380218091,1672581879,1672582745,866
11701,3459951739,3295691964,1672644809,1672646934,2125
10951,3833993674,3500079479,1672631739,1672633888,2149
11696,3793874490,3385481989,1672699116,1672701957,2841
11476,3714923092,3713611960,1672656887,1672657524,637
10097,3783067048,3446218191,1672633218,1672636729,3511
9984,3713285095,3519167605,1672539771,1672543150,3379
10945,3880882684,3811351746,1672559940,1672560024,84
11644,3500671218,3493047640,1672607099,1672610507,3408
10860,3714516404,3884191432,1672557905,1672560572,2667
10973,3714951681,3736036532,1672550005,1672551431,1426
10182,3701770921,3394976623,1672554750,1672554890,140
11445,3472561941,3783408830,1672699307,1672700941,1634
11087,3979115924,3730290851,1672621571,1672622564,993
11571,3509828883,3485521840,1672579421,1672579633,212
11022,3612042508,3486824047,1672647211,1672648080,869
11404,3409098014,3898989233,1672691312,1672694565,3253
10334,3756328353,3469663062,1672559200,1672562268,3068
10623,3906693728,3783939161,1672552343,1672555412,3069
10841,3511296895,3205948776,1672604287,1672605843,1556
10130,3534499421,3311197635,1672582342,1672585371,3029
10433,3400025324,3505769529,1672591204,1672594232,3028
10819,3772296376,3714287902,1672554783,1672555613,830
9964,3821082558,3318224774,1672587658,1672588355,697
10618,3284374600,3669497617,1672663886,1672666737,2851
10694,3233712975,3478937459,1672579271,1672581220,1949
10983,3517253559,3880562532,1672562618,1672563071,453
10810,3779665641,3488931357,1672635284,1672638292,3008
9926,3701041860,3917905192,1672534005,1672537278,3273
10466,3715249954,3500057674,1672687692,1672688252,560
10126,3977157565,3505756991,1672570532,1672572948,2416
10896,3711404205,3774273260,1672649192,1672650136,944
11420,3318590083,3420664407,1672562957,1672565258,2301
10080,3270502801,3510638085,1672598099,1672598610,511
11229,3715790104,3760679372,1672631113,1672634415,3302
10330,3668369938,3406492167,1672678665,1672680655,1990
9981,3311264420,3514564903,1672599773,1672601875,2102
10616,3912811715,3520165730,1672550809,1672552138,1329
9852,3510836047,3939851140,1672665227,1672666554,1327
10582,3360837082,3837885956,1672653329,1672654149,820
11024,3714883746,3826315540,1672609087,1672609676,589
11427,3714250543,3312612693,1672596073,1672596332,259
11680,3701540249,3780435349,1672634080,1672634161,81
11211,3534775239,3713726267,1672595744,1672597250,1506
9983,3710228292,3505867821,1672538812,1672539769,957
10901,3701521510,3358262975,1672697226,1672700546,3320
10716,3501225887,3500049870,1672661207,1672663041,1834
10933,3452024572,3888523259,1672631155,1672631488,333
10025,3917004141,3443004958,1672630932,1672631518,586
9823,3793987483,3512203553,1672617006,1672619468,2462
11310,3452175941,3667950469,1672550762,1672552260,1498
11080,3505665253,3512641538,1672543410,1672543619,209
10553,3511382748,3510864325,1672582589,1672583512,923
10549,3500596577,3779468781,1672541730,1672544475,2745
10161,3511476353,3477248170,1672548900,1672549684,784
11169,3629869834,3557528150,1672623696,1672626779,3083
9888,3783095041,3710060386,1672680720,1672681500,780
10969,3783176874,3710919244,1672548585,1672551472,2887
10871,3377446376,3519065870,1672627658,1672629025,1367
11159,3703659324,3907245259,1672619143,1672620639,1496
10144,3755922811,3738160394,1672692878,1672695809,2931
10222,3814289471,3772648837,1672634605,1672635702,1097
10194,3779818784,3773440794,1672680735,1672681258,523
10890,3915679140,3311188620,1672678042,1672680709,2667
10832,3422314045,3360837082,1672591849,1672592366,517
10021,3235074007,3245774173,1672692700,1672696002,3302
11569,3203457161,3516572212,1672669147,1672670948,1801
11551,3716740576,3343859998,1672604799,1672606592,1793
10108,3278443807,3311463998,1672701858,1672704855,2997
11680,3311449914,3238310644,1672661375,1672663232,1857
10244,3276209319,3730600658,1672628297,1672629761,1464
11390,3773738817,3271762055,1672663098,1672665814,2716
11051,3791222330,3273771395,1672604940,1672605273,333
10715,3831981073,3287760230,1672543887,1672545613,1726
10881,3403150349,3246062632,1672675990,1672678167,2177
11587,3715008501,3512417724,1672612868,1672613810,942
10991,3370448531,3780648744,1672605026,1672607745,2719
10336,3890813040,3972847837,1672566705,1672567814,1109
10097,3907390925,3911431642,1672571087,1672574418,3331
11104,3500928990,3856552205,1672626434,1672629082,2648
11540,3500640854,3424425746,1672638773,1672640618,1845
11381,3512477276,3970265139,1672535357,1672536230,873
10957,3661856558,3772131127,1672579191,1672580182,991
11358,3437108337,3710529628,1672560953,1672561312,359
11181,3773017746,3835509670,1672608677,1672612069,3392
11255,3756740153,3455907179,1672684337,1672686196,1859
10923,3914947393,3774506868,1672670947,1672673474,2527
10229,3856129522,3230250213,1672610759,1672613049,2290
11500,3755154460,3711770853,1672589048,1672589171,123
10672,3394976623,3888523259,1672571634,1672572466,832
9876,3295710494,3509445318,1672658687,1672662110,3423
10936,3487231844,3519848902,1672702998,1672704794,1796
10780,3238310644,3517426473,1672577772,1672581162,3390
11480,3903994989,3897500723,1672560996,1672563557,2561
10851,3278430820,3332124606,1672579935,1672581595,1660
9849,3634670780,3714142299,1672674573,1672677801,3228
11319,3515100211,3276393542,1672571974,1672575350,3376
11234,3515838621,3826315540,1672664736,1672665137,401
11370,3730414796,3510864325,1672650684,1672650856,172
11110,3902682060,3428076194,1672682641,1672684484,1843
11760,3271762055,3756991235,1672629069,1672630703,1634
10176,3636857871,3511794841,1672562249,1672564637,2388
11250,3891586951,3513171472,1672541216,1672542654,1438
10425,3511069449,3519754667,1672613684,1672615925,2241
10255,3290797257,3927675706,1672663208,1672666412,3204
11650,3501843187,3509317054,1672532380,1672532581,201
11106,3501004005,3793920312,1672532472,1672534091,1619
10665,3713476192,3207497598,1672646339,1672648121,1782
11546,3701311947,3777932581,1672659000,1672661343,2343
10830,3554317844,3756759239,1672691903,1672694634,2731
9882,3511198566,3810949170,1672673478,1672676817,3339
10725,3714455496,3354015456,1672670583,1672671866,1283
9905,3420881591,3301369282,1672664424,1672666407,1983
11429,3934991640,3839308659,1672569451,1672570656,1205
11692,3500654356,3433189219,1672573347,1672576536,3189
10221,3279851026,3275661834,1672565395,1672567584,2189
10888,3515047288,3608214600,1672612555,1672613355,800
11637,3447202943,3934280144,1672544617,1672547324,2707
10437,3774627091,3236254381,1672555465,1672558226,2761
11510,3311529105,3299845453,1672683219,1672684170,951
11082,3534696810,3500579482,1672693452,1672696512,3060
10957,3772966919,3713621169,1672564512,1672565567,1055
11131,3669427589,3620836520,1672626506,1672627964,1458
11188,3534491112,3733836732,1672534845,1672537101,2256
11241,3791628263,3444646562,1672575107,1672576950,1843
10774,3701769970,3756998113,1672563336,1672565188,1852
11583,3417223898,3534491112,1672695128,1672698110,2982
10211,3756328353,3602570831,1672604529,1672607380,2851
10608,3832333115,3920606331,1672666567,1672668352,1785
10199,3757198930,3500473064,1672604559,1672605544,985
9976,3361865467,3615447269,1672580427,1672581914,1487
10604,3367262509,3817029483,1672628362,1672630303,1941
10687,3366801723,3715897627,1672552770,1672553620,850
10811,3619494735,3755119166,1672666370,1672669026,2656
11576,3512133625,3511645260,1672661291,1672663982,2691
10949,3476431618,3510801769,1672634701,1672637822,3121
11489,3791224239,3533037906,1672533400,1672535702,2302
11431,3510801769,3837888196,1672659149,1672660584,1435
10469,3416474842,3505502819,1672571082,1672574520,3438
10248,3931319307,3780050328,1672541845,1672543923,2078
11309,3239401337,3500720752,1672576287,1672577302,1015
10302,3716801088,3361952532,1672703808,1672707175,3367
10112,3516497645,3903994989,1672700169,1672702854,2685
10840,3793364952,3313795594,1672542801,1672543623,822
10964,3512337054,3555763674,1672661170,1672663743,2573
10498,3500536897,3505665788,1672627284,1672627724,440
10577,3893932944,3306037126,1672603561,1672606492,2931
11583,3291153514,3703779674,1672677630,1672677930,300
10101,3779212271,3471555057,1672561246,1672561684,438
11345,3932491622,3792432763,1672619672,1672620229,557
11576,3302348002,3776001441,1672601602,1672604494,2892
11347,3442403264,3396656251,1672576238,1672578891,2653
10107,3779503296,3480270940,1672638304,1672641539,3235
10675,3533628528,3909067335,1672606619,1672607707,1088
10868,3514306458,3755129708,1672679018,1672681951,2933
11577,3757001552,3519065870,1672686065,1672686947,882
11227,3774447975,3514638555,1672594104,1672597292,3188
11371,3783935976,3514216460,1672568689,1672569380,691
11233,3402105276,3685396470,1672646060,1672649453,3393
11658,3335055096,3778561231,1672581578,1672582611,1033
10614,3533154906,3509470194,1672665171,1672668014,2843
11485,3793949077,3403035480,1672574088,1672576428,2340
11590,3227919286,3514244308,1672690779,1672691762,983
11013,3500928990,3760554453,1672647199,1672648421,1222
10403,3208560443,3299587876,1672700338,1672703933,3595
9914,3454924050,3716341323,1672567741,1672569317,1576
11544,3444598583,3755769254,1672562446,1672563159,713
11340,3519965717,3818532143,1672656093,1672656852,759
11478,3311626308,3421524698,1672571883,1672575258,3375
11436,3287821258,3386323728,1672656341,1672658290,1949
11333,3509562377,3639503148,1672543346,1672545844,2498
11216,3410788026,3452175941,1672612822,1672614818,1996
10400,3774822697,3852161626,1672566910,1672568882,1972
10016,3370961012,3755570137,1672620674,1672623678,3004
10463,3714283424,3517113478,1672596556,1672599460,2904
10173,3853275529,3442073613,1672673639,1672676365,2726
10681,3612705426,3776727271,1672679697,1672682614,2917
10125,3703749690,3450735824,1672690872,1672692154,1282
11452,3772882440,3361865467,1672551061,1672554558,3497
10094,3395505794,3446537819,1672549646,1672551343,1697
10034,3806034626,3971996397,1672685929,1672689371,3442
10566,3881579907,3513432588,1672571107,1672572384,1277
10805,3239779992,3777931341,1672673473,1672675017,1544
9897,3510254698,3791409441,1672566101,1672568855,2754
11377,3701374160,3791072829,1672594643,1672597592,2949
10252,3557324887,3773161055,1672578905,1672579593,688
10847,3701127475,3517960157,1672556075,1672558152,2077
11105,3711404205,3449233346,1672668075,1672668346,271
10462,3445558740,3500415589,1672575597,1672576288,691
10052,3480259863,3660246433,1672596279,1672596569,290
9994,3491250381,3776183353,1672686878,1672687016,138
11590,3534362749,3520057139,1672599448,1672602624,3176
11630,3902300755,3662495290,1672593032,1672596183,3151
11543,3714883746,3665478011,1672667513,1672670308,2795
10884,3713434898,3469778316,1672700400,1672703075,2675
9902,3319529422,3938021614,1672688228,1672690059,1831
11519,3838423363,3342235058,1672569835,1672570534,699
10487,3515984911,3711722554,1672651981,1672654068,2087
10988,3823600319,3755273361,1672614552,1672616471,1919
10359,3793822639,3519260216,1672606780,1672608350,1570
10876,3714645218,3209280342,1672630912,1672633256,2344
10583,3514611187,3776468503,1672646178,1672648901,2723
9985,3454151554,3774682234,1672682585,1672685736,3151
10939,3811629200,3497562878,1672606489,1672609118,2629
10434,3501628472,3516706935,1672681928,1672684705,2777
10201,3778842400,3713728777,1672702193,1672702439,246
10961,3509394912,3499343927,1672600593,1672601505,912
10386,3713170867,3509394912,1672544230,1672544786,556
10311,3756695502,3512857020,1672640221,1672642231,2010
11311,3760420315,3856975355,1672624058,1672627229,3171
10024,3417223898,3513739060,1672568513,1672568998,485
11656,3435652260,3713416106,1672536410,1672539283,2873
10894,3520339198,3851737350,1672545658,1672547836,2178
10780,3896859936,3368176107,1672582281,1672585850,3569
10462,3716460706,3888903181,1672603052,1672606489,3437
11160,3330799389,3760232135,1672640419,1672643469,3050
9936,3500317923,3710397477,1672562272,1672563688,1416
10114,3335055096,3227206772,1672673838,1672674110,272
10120,3403870769,3513140146,1672679192,1672679586,394
11153,3368441333,3318056480,1672552153,1672552519,366
10119,3735152111,3512965991,1672544073,1672547549,3476
10820,3791547827,3302348002,1672562442,1672563554,1112
10726,3738873928,3284865931,1672550707,1672554053,3346
10823,3520362238,3512681214,1672599609,1672600487,878
10296,3275735969,3518368900,1672692642,1672693165,523
10693,3379517265,3681701931,1672626454,1672626733,279
11403,3238310644,3428878402,1672686350,1672688795,2445
10856,3501515425,3439532406,1672539809,1672541063,1254
10768,3760274119,3639926564,1672547682,1672549781,2099
10643,3661856558,3347172556,1672583660,1672583754,94
10635,3309455369,3757796416,1672654425,1672657466,3041
10771,3466492108,3447696555,1672617562,1672618432,870
11131,3703659324,3515753241,1672598255,1672599226,971
10619,3500640854,3517718901,1672606438,1672608107,1669
11427,3898965585,3772648837,1672556856,1672557400,544
11162,3505140123,3735152111,1672557796,1672557978,182
11594,3772164469,3441944896,1672630366,1672633484,3118
11428,3516067011,3459163055,1672555405,1672555747,342
11578,3927805949,3855674398,1672691158,1672692629,1471
11371,3772343750,3519948471,1672608261,1672609972,1711
10190,3739297004,3703423962,1672665774,1672666971,1197
10001,3760710525,3519886257,1672561808,1672563718,1910
10680,3760481622,3738873928,1672542094,1672544449,2355
10822,3733423371,3703462221,1672680860,1672683880,3020
10924,3518425740,3715587520,1672683524,1672685627,2103
10150,3830291558,3780921044,1672546717,1672548279,1562
11176,3505291330,3342235058,1672676353,1672678050,1697
10006,3774589551,3517426473,1672667112,1672670593,3481
10936,3240877710,3505936495,1672681879,1672684033,2154
9968,3511908639,3509996827,1672554577,1672557516,2939
10229,3492728794,3452175941,1672609572,1672611635,2063
10516,3772235668,3783611957,1672547180,1672549283,2103
10689,3285201542,3342031426,1672552848,1672555224,2376
11708,3513203127,3271719569,1672645004,1672647945,2941
11089,3755769254,3511199555,1672660372,1672660456,84
10880,3783443095,3770981604,1672613654,1672615927,2273
10012,3703168159,3935569749,1672578783,1672580712,1929
10445,3499343927,3756363182,1672641394,1672643128,1734
10669,3284374600,3534775239,1672588413,1672590131,1718
10653,3713726267,3500968729,1672702715,1672706314,3599
11324,3755273361,3370401047,1672549727,1672551187,1460
10077,3976400190,3518157683,1672662881,1672664791,1910
10164,3661543201,3519174861,1672609287,1672610668,1381
10718,3513293711,3223796145,1672536509,1672538307,1798
10115,3348100657,3669918958,1672544695,1672546208,1513
9921,3902023467,3688768189,1672612185,1672613821,1636
10467,3311696372,3760966645,1672558846,1672561595,2749
11622,3760710525,3500015630,1672691058,1672693614,2556
10798,3345028045,3510547682,1672617704,1672620315,2611
11698,3515681585,3739395381,1672607206,1672607908,702
10709,3710149975,3934070285,1672651462,1672652624,1162
10185,3713726267,3779468781,1672652191,1672653783,1592
11427,3739387948,3820280594,1672603158,1672606479,3321
10542,3226037966,3792972270,1672558984,1672561057,2073
10983,3736010012,3314363575,1672673878,1672676416,2538
10930,3337673625,3375906394,1672619106,1672620033,927
11555,3713475356,3601214648,1672614428,1672617470,3042
11222,3387388336,3520016705,1672563209,1672564137,928
9810,3792627762,3662507634,1672629517,1672630417,900
11527,3512343029,3602680347,1672644803,1672646328,1525
10801,3501711464,3510781595,1672652545,1672654658,2113
10423,3701377471,3760382349,1672643298,1672646446,3148
10386,3494560663,3856975623,1672577402,1672580406,3004
11276,3555764822,3514776568,1672702521,1672703946,1425
10399,3517627003,3710865678,1672640322,1672642024,1702
11219,3756066702,3516200419,1672632562,1672632942,380
11535,3776561263,3688845298,1672639903,1672641200,1297
10316,3756437169,3636927297,1672618725,1672619942,1217
11525,3910020031,3519937708,1672625182,1672627029,1847
10928,3223144610,3236254381,1672560309,1672560726,417
11533,3931028233,3760687922,1672594773,1672595403,630
10772,3903994989,3979115924,1672615364,1672616398,1034
11700,3405221863,3703697059,1672547127,1672549146,2019
9949,3710260848,3510111365,1672630633,1672633571,2938
10285,3311472321,3636852764,1672614692,1672615236,544
11787,3610723722,3394986304,1672566244,1672569530,3286
11520,3387322545,3774447975,1672622917,1672623434,517
11630,3238779889,3367526113,1672577132,1672578900,1768
9948,3310702648,3395565040,1672647170,1672648942,1772
10839,3600302127,3715441777,1672558226,1672559333,1107
11424,3818324410,3780287649,1672598455,1672600267,1812
11719,3505119470,3757678397,1672618858,1672619869,1011
11576,3932955949,3777304517,1672623483,1672626546,3063
10050,3713374884,3500209015,1672659633,1672661887,2254
10798,3855674398,3773434690,1672562330,1672563690,1360
9810,3755779925,3509508477,1672557761,1672558565,804
11596,3711938229,3534537581,1672695210,1672698639,3429
10035,3317190427,3757728121,1672582760,1672584850,2090
11591,3711404205,3774598935,1672632012,1672634275,2263
9854,3738132114,3520016705,1672699890,1672701692,1802
10303,3484739955,3444168914,1672686890,1672688318,1428
11182,3519435459,3893950585,1672579231,1672579963,732
10996,3393502004,3606688595,1672541306,1672544647,3341
10538,3349319959,3479585868,1672579185,1672579321,136
10733,3501711464,3413799143,1672648782,1672648953,171
11320,3337673625,3917467642,1672640412,1672641054,642
10158,3613216900,3732312480,1672533739,1672535491,1752
11091,3505032773,3812677669,1672673880,1672676852,2972
10519,3793949077,3837435907,1672590961,1672591728,767
11281,3614944981,3776950532,1672553463,1672556716,3253
9934,3515047288,3505482210,1672658103,1672659563,1460
10515,3793926338,3855222429,1672662646,1672664988,2342
11080,3770480149,3311197635,1672613783,1672617193,3410
11070,3356972733,3793497672,1672686580,1672686702,122
10698,3711947828,3281148858,1672644234,1672647606,3372
11394,3703659324,3757407184,1672655714,1672658885,3171
11371,3853783593,3359418136,1672596086,1672598752,2666
11614,3534531039,3274739459,1672641059,1672641578,519
10752,3776600696,3513215373,1672558114,1672560263,2149
11095,3512744657,3517558635,1672687657,1672690202,2545
10533,3372236721,3235578121,1672693578,1672696362,2784
10948,3373677765,3609103278,1672629487,1672629789,302
11249,3884388188,3701824335,1672667137,1672668183,1046
11472,3335055096,3607583720,1672657095,1672658568,1473
9891,3559123082,3920155862,1672689666,1672692809,3143
11198,3715700639,3856147380,1672587273,1672589698,2425
11577,3510439480,3830771832,1672674395,1672676270,1875
11623,3415803494,3773953689,1672626446,1672629027,2581
10321,3359012188,3777932225,1672639847,1672640164,317
11511,3780900318,3278443807,1672638854,1672641755,2901
11552,3923910914,3483078667,1672617243,1672620239,2996
10585,3505278562,3534190196,1672591591,1672593825,2234
11224,3755203055,3341432459,1672628677,1672632061,3384
10523,3505811269,3606688595,1672611197,1672612416,1219
11372,3856975355,3407398464,1672693829,1672696366,2537
10633,3231963246,3916656185,1672686139,1672689199,3060
10207,3776440009,3515047288,1672549714,1672552339,2625
10036,3505129296,3713740434,1672603322,1672603597,275
10195,3513171472,3341985886,1672660258,1672661093,835
10515,3285515107,3513624915,1672535082,1672537534,2452
10442,3517325365,3469350379,1672686398,1672688078,1680
10656,3833993674,3701041860,1672562318,1672563278,960
11046,3777370601,3272827860,1672642101,1672645320,3219
10331,3481019442,3783826338,1672663755,1672666353,2598
9907,3979366845,3334381941,1672635556,1672636901,1345
10223,3534459983,3515802579,1672677875,1672678628,753
11055,3896200048,3710228292,1672592388,1672593319,931
10849,3858497718,3772489471,1672666355,1672666648,293
10468,3419789418,3915962248,1672680535,1672682781,2246
10260,3513661302,3501115299,1672654754,1672656971,2217
10886,3442181067,3316821313,1672681983,1672683076,1093
11001,3633294415,3783157469,1672574148,1672576302,2154
10367,3378172464,3633860380,1672662225,1672662683,458
11077,3512154443,3756647451,1672534833,1672534999,166
10773,3317887374,3505994703,1672595206,1672598128,2922
10840,3620836520,3442073613,1672563178,1672564226,1048
11416,3505148522,3921736061,1672610940,1672614446,3506
11175,3774251051,3688410383,1672596359,1672598638,2279
10150,3935569749,3446218191,1672690795,1672692232,1437
9951,3514341451,3710260848,1672616522,1672619175,2653
11184,3852161626,3716233100,1672538545,1672539238,693
10348,3917811545,3710529628,1672567331,1672568400,1069
10324,3772909073,3919342147,1672662455,1672663046,591
11513,3613703906,3422205569,1672653696,1672655165,1469
9818,3500544306,3600302127,1672585020,1672586915,1895
11161,3514628916,3756297396,1672564660,1672565160,500
10167,3783368855,3929391979,1672535340,1672536520,1180
10080,3517766135,3919349138,1672594544,1672597643,3099
10708,3681274982,3500968729,1672678445,1672678971,526
11118,3276499910,3852310652,1672647156,1672650471,3315
9859,3770671714,3850904092,1672695485,1672698547,3062
11021,3701865589,3611570003,1672572128,1672573685,1557
11728,3780352400,3354877289,1672576258,1672578722,2464
11647,3804095239,3335353798,1672700486,1672702801,2315
10672,3516335333,3716445184,1672667594,1672670066,2472
9807,3400186699,3757446082,1672655417,1672657691,2274
11127,3319585148,3361865467,1672544023,1672546078,2055
11070,3736056340,3518157683,1672701076,1672702364,1288
11272,3774326754,3714471069,1672611085,1672613094,2009
11011,3516103646,3518376262,1672551415,1672552895,1480
10269,3517132086,3509663119,1672536323,1672537832,1509
10500,3820422111,3452677710,1672583958,1672586779,2821
10632,3422314045,3516340010,1672663587,1672666487,2900
10440,3500221079,3773953689,1672533529,1672535222,1693
11072,3616242727,3352057037,1672626857,1672627737,880
11727,3505853594,3791194984,1672647516,1672649840,2324
10582,3496579251,3516454693,1672578623,1672579143,520
11137,3772802020,3384151770,1672616067,1672619507,3440
10450,3778544203,3422915648,1672554429,1672557630,3201
10765,3336225953,3929391979,1672666029,1672669300,3271
10121,3514737648,3716020849,1672607964,1672610526,2562
10503,3371497614,3701725839,1672575333,1672578513,3180
9829,3500415589,3792277399,1672536095,1672537289,1194
11449,3783172505,3420664407,1672608057,1672608152,95
9806,3516463579,3716341323,1672557528,1672560041,2513
11506,3774921252,3514737648,1672657597,1672658853,1256
10883,3288346356,3851737350,1672547035,1672547728,693
10190,3777498160,3302416197,1672563839,1672565229,1390
10973,3505010941,3774035405,1672670380,1672672676,2296
11475,3905955166,3793332600,1672600890,1672603496,2606
10662,3779413388,3517227599,1672681637,1672684396,2759
11180,3776617627,3534206917,1672677908,1672678841,933
10860,3701448521,3731905251,1672535653,1672538307,2654
10097,3714806574,3773440794,1672628636,1672629546,910
10079,3491948594,3779312237,1672555159,1672556443,1284
11585,3776001441,3484739955,1672576122,1672577172,1050
11186,3770019143,3636605690,1672624619,1672627357,2738
9873,3505901826,3770715115,1672613019,1672614557,1538
11301,3271762055,3738132114,1672644506,1672646232,1726
10799,3512794667,3510244209,1672568860,1672571148,2288
11597,3701065296,3245121919,1672665867,1672669359,3492
10387,3715858201,3818904268,1672552358,1672552980,622
10429,3510206323,3770023722,1672613232,1672616494,3262
11125,3511650296,3446537819,1672660522,1672664096,3574
9895,3971280379,3622458047,1672626149,1672628767,2618
11768,3401215739,3783157469,1672561970,1672564066,2096
11738,3760731595,3931319307,1672643026,1672645343,2317
11033,3713139039,3487779363,1672598609,1672600452,1843
9947,3779706467,3534770827,1672649318,1672650007,689
10634,3854229296,3459694275,1672698442,1672698979,537
10472,3701028092,3533030343,1672656438,1672658449,2011
10812,3774447975,3304661369,1672696735,1672698951,2216
11355,3776166086,3974264211,1672618204,1672619791,1587
10793,3774822697,3352057037,1672604352,1672605483,1131
10079,3517149023,3516067011,1672583649,1672586887,3238
10471,3832745283,3738160394,1672610429,1672610870,441
11583,3780467276,3713336088,1672563229,1672566757,3528
10911,3660163550,3514926921,1672702367,1672703944,1577
11118,3776001441,3737622701,1672591891,1672592621,730
10410,3732104286,3713923960,1672672985,1672675885,2900
11638,3533566754,3852992961,1672632408,1672635694,3286
9827,3515548696,3500741534,1672594561,1672595489,928
10468,3239279744,3933731871,1672670491,1672671190,699
9975,3688410383,3233712975,1672574104,1672576021,1917
10122,3625400710,3757060033,1672602150,1672602706,556
11755,3405200303,3534531039,1672692339,1672693257,918
10770,3633294415,3621439107,1672652323,1672652923,600
11203,3792851584,3809871495,1672683580,1672684546,966
11555,3511078598,3666561358,1672687862,1672688996,1134
11664,3514498259,3510916875,1672604974,1672607492,2518
11438,3501244753,3513563152,1672690776,1672693455,2679
11560,3909457959,3713923960,1672570773,1672573449,2676
11322,3518067857,3774939922,1672661712,1672662864,1152
10931,3509828883,3929446196,1672610503,1672611853,1350
10172,3417360319,3358982831,1672542972,1672546001,3029
11621,3457249798,3342545285,1672569331,1672569663,332
11428,3827889533,3334482021,1672556907,1672557973,1066
9965,3855629383,3715441777,1672545827,1672546440,613
11579,3732440502,3517797610,1672681659,1672682098,439
10991,3760080378,3500087325,1672593428,1672595474,2046
11657,3715897627,3419648004,1672536581,1672538270,1689
11540,3906260966,3359351267,1672676677,1672680154,3477
10834,3514980025,3760737203,1672700041,1672701172,1131
11644,3922786716,3666561358,1672687145,1672690401,3256
10139,3287683210,3701824335,1672650097,1672653147,3050
10181,3398489033,3514352989,1672680431,1672680656,225
10806,3463883997,3519165527,1672597666,1672599985,2319
11456,3774965463,3500120676,1672616534,1672619308,2774
10254,3337903727,3480185839,1672633020,1672634888,1868
11213,3904184638,3509457543,1672583982,1672586985,3003
10538,3777112124,3776901443,1672702983,1672704969,1986
11271,3500994763,3737685967,1672571017,1672571095,78
10356,3501271930,3330188769,1672679726,1672681763,2037
9848,3450511428,3238796398,1672670870,1672673204,2334
11746,3778273230,3509508477,1672583851,1672585434,1583
10676,3517325365,3756717136,1672570231,1672571174,943
10798,3713416106,3807646028,1672576046,1672577944,1898
11502,3373135211,3737745988,1672577869,1672579110,1241
10635,3976742903,3274739459,1672638877,1672640191,1314
10350,3896211741,3972653129,1672573325,1672575358,2033
10364,3637522163,3662507634,1672694551,1672695313,762
10122,3388481990,3340321384,1672630811,1672634393,3582
11048,3437108337,3735197034,1672672354,1672674392,2038
10748,3318250647,3501115299,1672540526,1672541815,1289
11526,3756428507,3474350534,1672702864,1672704178,1314
10513,3855077502,3624365837,1672559467,1672559952,485
11249,3311739926,3366961580,1672681318,1672684269,2951
11214,3770391782,3400903513,1672548887,1672552382,3495
11716,3701978422,3303772923,1672632692,1672634001,1309
10975,3713224038,3884934977,1672701068,1672701641,573
10969,3397330170,3519435459,1672542187,1672542249,62
11599,3370751461,3496591885,1672681249,1672681546,297
10684,3311159418,3517645656,1672666592,1672667623,1031
11689,3760069457,3776534957,1672697201,1672699946,2745
9892,3779282072,3281970147,1672578167,1672579287,1120
9917,3611533094,3760385591,1672537118,1672539256,2138
11005,3711854614,3755865626,1672617591,1672620419,2828
11423,3511078598,3977666815,1672573935,1672576810,2875
10164,3202740652,3462153833,1672669558,1672670528,970
10386,3855629383,3366433035,1672652408,1672653335,927
9968,3422205569,3772867078,1672560402,1672560471,69
11556,3500073824,3895422995,1672585544,1672586403,859
9910,3505331083,3520763492,1672628624,1672631747,3123
11708,3347172556,3639465750,1672666044,1672669370,3326
9925,3686885442,3520925688,1672688751,1672691003,2252
10536,3520160414,3777060250,1672564508,1672566579,2071
11609,3926065090,3517377614,1672558683,1672561654,2971
11336,3776068937,3703351452,1672610151,1672611008,857
10472,3820922991,3465227623,1672663384,1672666891,3507
11064,3853188285,3774035405,1672650206,1672653389,3183
11319,3780612543,3382670400,1672555557,1672559157,3600
10999,3776187150,3777439655,1672689589,1672693089,3500
10567,3480270940,3780740477,1672655457,1672656389,932
11786,3372778334,3482786946,1672597583,1672600061,2478
10803,3318250647,3358530225,1672540094,1672541609,1515
10961,3714455496,3424997707,1672625888,1672627112,1224
10395,3316537706,3802101760,1672606886,1672609123,2237
10596,3384001094,3371497614,1672595922,1672599024,3102
11088,3884001167,3791121243,1672585598,1672586417,819
11458,3464622743,3834980281,1672556554,1672556762,208
11228,3792432763,3491250381,1672644394,1672644573,179
11752,3480418192,3756066765,1672605747,1672606123,376
10149,3494680853,3637105495,1672542321,1672544782,2461
10898,3904485393,3513432588,1672672050,1672674250,2200
11403,3514638555,3477248170,1672559849,1672562912,3063
10588,3897186782,3701041860,1672691041,1672692883,1842
10377,3792797648,3756328353,1672667845,1672669900,2055
11397,3856699097,3205908584,1672649378,1672651192,1814
9994,3311771689,3512784888,1672532435,1672535898,3463
10085,3501027795,3498857406,1672586981,1672590033,3052
11007,3465672238,3452175941,1672640978,1672641632,654
11010,3500974385,3463729805,1672652728,1672654716,1988
10550,3972442654,3505438826,1672623432,1672625863,2431
10811,3791106473,3451757423,1672599193,1672602723,3530
10514,3517756624,3387388336,1672564345,1672566666,2321
11790,3713547793,3792008302,1672603253,1672604289,1036
11450,3770764940,3908878965,1672573526,1672576999,3473
11047,3336501403,3711065081,1672682655,1672682903,248
11334,3292050211,3612042508,1672582419,1672584195,1776
10630,3770976984,3330799389,1672672170,1672672706,536
10772,3792173463,3409514897,1672580605,1672580999,394
10719,3387413950,3311479294,1672631371,1672632991,1620
10001,3791974273,3421040626,1672578255,1672580099,1844
10603,3780500331,3514698862,1672645146,1672646870,1724
11298,3837885956,3773432494,1672644874,1672646813,1939
11138,3713840946,3393543588,1672651241,1672653427,2186
11450,3710919244,3780206849,1672569600,1672571779,2179
10440,3773024346,3513764665,1672687282,1672688166,884
10153,3505164060,3367202274,1672656477,1672657746,1269
10873,3703849264,3235074007,1672645339,1672645465,126
10954,3500356342,3332124606,1672534831,1672535979,1148
10575,3793364952,3366433035,1672548338,1672551669,3331
11207,3467415939,3811354125,1672649215,1672649790,575
9855,3458130310,3307216611,1672648556,1672649601,1045
11788,3441944896,3393909269,1672638404,1672640402,1998
9975,3370401047,3378747834,1672575604,1672576877,1273
11778,3533627473,3511286390,1672682597,1672683407,810
10875,3500854711,3505994703,1672703207,1672703322,115
10635,3880637958,3515803462,1672558579,1672560977,2398
10165,3760731595,3792597493,1672698538,1672702083,3545
11095,3779778679,3710813103,1672637994,1672639641,1647
10444,3774236212,3429315500,1672703678,1672705266,1588
11736,3669427589,3492728794,1672684640,1672686896,2256
10940,3534122907,3511198566,1672551714,1672552038,324
10728,3435715962,3477248170,1672660038,1672661710,1672
10445,3317887374,3518157683,1672576646,1672576969,323
10081,3390368796,3285587972,1672703276,1672704870,1594
10866,3770972037,3920890008,1672680309,1672680751,442
11515,3442564712,3421524698,1672582484,1672583951,1467
10143,3703481882,3757796416,1672699504,1672702371,2867
10622,3828354855,3468343480,1672674412,1672675606,1194
10941,3736941123,3501171785,1672697698,1672699863,2165
11021,3777263928,3711065081,1672586201,1672588484,2283
10151,3686885442,3520344592,1672536341,1672537304,963
10370,3393001196,3337673625,1672615365,1672617927,2562
11349,3791194984,3803382101,1672660067,1672662391,2324
10223,3774939922,3245774173,1672541158,1672542859,1701
11458,3780294116,3778824229,1672578154,1672578593,439
10693,3924366353,3809207482,1672686154,1672687455,1301
10883,3829412384,3500198430,1672644809,1672645193,384
10973,3302348002,3756119976,1672633887,1672634428,541
11779,3485898181,3393128259,1672534038,1672534783,745
11111,3209280342,3315432466,1672548012,1672548464,452
10468,3512480125,3714074120,1672657179,1672657590,411
11251,3827836825,3713927376,1672553900,1672557193,3293
11789,3512546783,3511069449,1672572112,1672575027,2915
10191,3666367524,3520725149,1672655764,1672657830,2066
9853,3899903158,3499622352,1672696575,1672699238,2663
11604,3780213684,3501977123,1672595344,1672595877,533
9982,3978643889,3533419409,1672689641,1672690204,563
10601,3756493561,3308149799,1672554078,1672554538,460
10582,3710783759,3235470567,1672684370,1672684982,612
9986,3203876438,3611533094,1672613614,1672616230,2616
11542,3514853709,3820200446,1672551639,1672554218,2579
11599,3500579482,3533440736,1672669144,1672670859,1715
10000,3792497486,3703048107,1672661284,1672662365,1081
10674,3420664407,3398021818,1672620515,1672623056,2541
11689,3505119470,3467944159,1672558949,1672561561,2612
10509,3512826895,3711518637,1672690076,1672692514,2438
10073,3501027795,3422081502,1672606969,1672609447,2478
10705,3715490209,3274239253,1672627339,1672629861,2522
10220,3757851680,3780511388,1672617132,1672620494,3362
11736,3227206772,3935444008,1672570862,1672572606,1744
11572,3286938590,3851810349,1672551387,1672553483,2096
10901,3516463579,3703697059,1672702111,1672703757,1646
10089,3203909360,3428076194,1672631443,1672632815,1372
10656,3533077580,3826997668,1672592916,1672594212,1296
10795,3512154443,3770764940,1672620937,1672622777,1840
11733,3776279305,3905358065,1672648318,1672650130,1812
10819,3701567668,3776034313,1672533689,1672536381,2692
11247,3776187150,3834311054,1672686783,1672688306,1523
10293,3558567160,3776581518,1672676787,1672678520,1733
10318,3494748808,3710051427,1672650815,1672652639,1824
10410,3393955069,3304227085,1672676254,1672678392,2138
11675,3730290851,3938059867,1672626558,1672629122,2564
10535,3301403047,3892177203,1672541102,1672542321,1219
10056,3416079461,3711190257,1672632956,1672636147,3191
10409,3514107131,3609997804,1672702484,1672702987,503
9832,3770275898,3514508773,1672547093,1672548868,1775
9874,3701041860,3305727497,1672670223,1672671609,1386
9916,3279731391,3714287902,1672702735,1672705970,3235
10860,3513213122,3427049290,1672687279,1672688597,1318
9883,3360949039,3774633364,1672575669,1672578513,2844
11788,3344478603,3855077502,1672542740,1672544882,2142
9972,3777118499,3639465750,1672551377,1672554425,3048
11433,3684108920,3248061684,1672703668,1672703928,260
10988,3342495377,3440401725,1672679940,1672682911,2971
9897,3288346356,3760069457,1672624213,1672624442,229
11123,3516378356,3852310652,1672558894,1672559942,1048
10873,3440582836,3716371766,1672645770,1672649150,3380
10396,3792255406,3351949206,1672549140,1672551800,2660
9870,3756763585,3772962072,1672595257,1672595550,293
9821,3501828287,3793407883,1672672174,1672675704,3530
11572,3772893815,3513840186,1672582001,1672582351,350
9889,3511640720,3772689657,1672542761,1672545134,2373
11485,3613703906,3358385652,1672570031,1672573449,3418
10240,3715750580,3778479297,1672612818,1672615876,3058
11516,3884001167,3515507526,1672547697,1672549408,1711
10477,3922786716,3518425740,1672550106,1672552863,2757
10874,3447078933,3632189887,1672547105,1672548174,1069
10387,3368848936,3783611957,1672683089,1672686538,3449
11622,3553694590,3808442442,1672672693,1672675618,2925
10950,3713373455,3533440294,1672666117,1672668946,2829
11646,3730600658,3272838634,1672646019,1672648270,2251
10487,3887382548,3779169946,1672572303,1672574791,2488
10402,3834643026,3756680289,1672625658,1672629055,3397
11167,3202787155,3778986795,1672534034,1672535144,1110
9865,3518164450,3362706073,1672600659,1672603899,3240
11477,3757994002,3490008012,1672594858,1672597776,2918
10965,3780048608,3510454018,1672547388,1672548343,955
9977,3703624327,3515096959,1672531663,1672534147,2484
11588,3911431642,3811351746,1672583552,1672583761,209
10165,3452389513,3779951373,1672534082,1672537461,3379
11132,3439283360,3711854614,1672539561,1672540230,669
10382,3660702754,3494748808,1672625627,1672628346,2719
10438,3791072829,3715923089,1672576431,1672578162,1731
10048,3902357342,3780576351,1672607435,1672610942,3507
10073,3511069449,3510547682,1672663326,1672663626,300
10592,3701412729,3755209597,1672565882,1672567157,1275
10553,3783506190,3344478603,1672666567,1672668173,1606
9856,3377311502,3452090950,1672543949,1672544460,511
11768,3773669001,3756328353,1672647900,1672650389,2489
11021,3703572036,3505351253,1672647894,1672649501,1607
10127,3409078869,3755790149,1672644100,1672647433,3333
10640,3472561941,3623512088,1672602346,1672603985,1639
10750,3633860380,3757732853,1672642311,1672645712,3401
10311,3817038422,3609925909,1672694516,1672696848,2332
11444,3511458926,3246062632,1672674274,1672676269,1995
11454,3713170867,3318056480,1672553764,1672553830,66
11601,3760397450,3971289056,1672676481,1672677585,1104
11432,3208962614,3520049965,1672625945,1672629515,3570
10228,3623067708,3516585063,1672556201,1672557496,1295
10293,3618672178,3334461288,1672701459,1672704011,2552
10422,3284865931,3857244486,1672596795,1672599761,2966
9856,3294164983,3505234868,1672585267,1672585902,635
10476,3730226545,3515753241,1672585057,1672585616,559
9797,3908177413,3341738186,1672547472,1672550664,3192
10716,3776953418,3367242388,1672531551,1672533897,2346
11649,3371132167,3756272704,1672599618,1672602873,3255
10338,3792008302,3533728729,1672597682,1672600476,2794
10594,3515802579,3773878451,1672556605,1672558387,1782
10290,3681737865,3756367938,1672579545,1672583136,3591
10260,3638050763,3311529105,1672610090,1672610218,128
11483,3403150349,3974668678,1672557973,1672559966,1993
10225,3513384042,3351856699,1672646435,1672649528,3093
9835,3663902064,3228033254,1672592665,1672592972,307
11412,3780500331,3384151770,1672639250,1672639890,640
11122,3352057037,3710173412,1672703366,1672703742,376
10459,3778605154,3791542842,1672645032,1672647432,2400
10808,3701065296,3713283029,1672651448,1672654290,2842
10797,3501126057,3715622084,1672682612,1672684832,2220
10343,3423353911,3714595459,1672640265,1672642563,2298
10035,3487395357,3715680249,1672649537,1672650862,1325
9862,3772425253,3554437212,1672543563,1672543643,80
9852,3404375908,3509677530,1672645865,1672647664,1799
11402,3279726491,3613781977,1672565931,1672566072,141
11500,3715140418,3311904032,1672641915,1672642650,735
10241,3829412384,3713107380,1672697504,1672700112,2608
10137,3778044082,3635433296,1672652625,1672655844,3219
11518,3777931341,3783443095,1672634250,1672636235,1985
10494,3609925909,3505521491,1672573514,1672574487,973
11238,3714281795,3515681585,1672613277,1672616502,3225
10186,3516486526,3757089924,1672703444,1672706360,2916
11655,3229615214,3271282663,1672673358,1672675274,1916
9955,3500543341,3519494023,1672583188,1672585877,2689
10383,3772291207,3713969196,1672654260,1672655492,1232
11746,3783594246,3470135167,1672691525,1672691851,326
9891,3558203963,3902357342,1672580282,1672583236,2954
11266,3714294005,3510968599,1672555694,1672556393,699
10444,3714453773,3340321384,1672576656,1672579691,3035
10996,3703423962,3735497729,1672558227,1672561438,3211
11405,3500087325,3505980138,1672550387,1672552269,1882
9836,3533976217,3970775805,1672570731,1672572672,1941
10356,3534102440,3313282478,1672550534,1672553887,3353
11321,3223177147,3770019143,1672552006,1672555531,3525
11033,3514628916,3510368377,1672648392,1672648656,264
11220,3272328752,3518572231,1672686643,1672688559,1916
10899,3663505156,3228997424,1672604149,1672605978,1829
11515,3755688231,3275274182,1672607433,1672610665,3232
11707,3421040626,3509912164,1672703892,1672705882,1990
9842,3390444181,3916656185,1672676367,1672679949,3582
10153,3770630937,3714142299,1672599091,1672599967,876
10717,3703614781,3713476192,1672584514,1672586794,2280
11402,3444295435,3512645289,1672654022,1672656108,2086
10084,3895422995,3513624915,1672619061,1672622098,3037
11359,3452175941,3732846295,1672539934,1672541691,1757
10820,3500317923,3520016705,1672637814,1672639482,1668
10816,3466492108,3279726491,1672615677,1672616073,396
11655,3512726649,3505129296,1672546585,1672548485,1900
11256,3715111016,3500049870,1672623345,1672625395,2050
11410,3773024346,3244395841,1672597775,1672599679,1904
11321,3477582923,3901217668,1672607537,1672610549,3012
10992,3701512498,3520832066,1672610282,1672611273,991
10836,3284334297,3903088144,1672606139,1672606293,154
11202,3619538249,3222357355,1672576322,1672578784,2462
10914,3822496670,3760648750,1672591778,1672594627,2849
11453,3422205569,3624872714,1672682771,1672682981,210
10708,3701060732,3285971415,1672677470,1672679794,2324
11189,3760554453,3780941637,1672546884,1672548792,1908
11263,3505183641,3243305367,1672642790,1672643157,367
10016,3908883591,3777135415,1672551659,1672554820,3161
10482,3512744657,3311188620,1672607598,1672608877,1279
11296,3331228758,3783611957,1672540827,1672543002,2175
10223,3290797257,3832745283,1672589079,1672591249,2170
10848,3519059808,3701296091,1672640329,1672642380,2051
10893,3516378356,3319436533,1672591426,1672594951,3525
11567,3299052917,3896123242,1672658365,1672660752,2387
9917,3206241691,3515753241,1672674696,1672676540,1844
11483,3353811455,3772609551,1672702668,1672705377,2709
10619,3713840946,3415228763,1672698274,1672701342,3068
10841,3805718871,3491390365,1672653142,1672656297,3155
10571,3418367752,3341738186,1672548816,1672552010,3194
10504,3352044245,3505097206,1672609188,1672611412,2224
11158,3287753579,3515753241,1672650154,1672651969,1815
10557,3757150421,3275751794,1672560506,1672563984,3478
10455,3472272792,3922409420,1672591958,1672592222,264
10582,3513293711,3517645656,1672540851,1672544146,3295
10986,3447078933,3603167427,1672595724,1672596074,350
9953,3439045964,3454554552,1672561096,1672563668,2572
10244,3804707712,3366961580,1672575528,1672576582,1054
10733,3714883746,3701971784,1672630443,1672632928,2485
11624,3410602007,3513545735,1672703878,1672705511,1633
10664,3780224882,3518534560,1672612188,1672613669,1481
11163,3669918958,3757050615,1672557794,1672559031,1237
10128,3625952981,3364683368,1672638287,1672639116,829
11480,3500799617,3430032005,1672533478,1672536760,3282
10459,3756850160,3429047448,1672695649,1672698488,2839
10252,3716541851,3716801088,1672609609,1672610198,589
10995,3779427180,3534459983,1672542398,1672542880,482
10283,3513764665,3533728729,1672680446,1672683359,2913
11020,3714718326,3776600696,1672549006,1672551457,2451
11210,3514980025,3713954144,1672682046,1672682128,82
11577,3756297396,3356972733,1672623238,1672626760,3522
10402,3792719263,3485468650,1672626241,1672627905,1664
11354,3516969689,3519228207,1672599065,1672600406,1341
9859,3533036499,3905955166,1672647349,1672650393,3044
11241,3780423516,3394364348,1672703954,1672706017,2063
10165,3366961580,3330318282,1672663335,1672666835,3500
10351,3916656185,3792930090,1672639851,1672642173,2322
11300,3390444181,3347172556,1672633576,1672634008,432
11563,3760420315,3770180844,1672625356,1672626932,1576
11593,3519965717,3760107540,1672609569,1672610105,536
11668,3685645561,3513739060,1672620511,1672620719,208
10257,3533427742,3514685272,1672617015,1672617481,466
11533,3928421417,3500356342,1672578018,1672578356,338
11259,3500695402,3501557463,1672577797,1672580486,2689
11170,3777074709,3519102732,1672648675,1672650395,1720
11766,3301369282,3311515179,1672641794,1672643522,1728
9986,3772188086,3439045964,1672604338,1672605058,720
11092,3491239350,3732467455,1672550524,1672553917,3393
10208,3420983899,3701841013,1672574235,1672574552,317
11644,3888057649,3304028109,1672682863,1672685597,2734
11285,3517960740,3757639274,1672565699,1672567540,1841
9947,3533929043,3773408491,1672653137,1672656207,3070
11381,3510149298,3756367938,1672682006,1672683078,1072
10766,3778741325,3318220119,1672614826,1672615969,1143
11218,3512288503,3778125688,1672571623,1672571766,143
10215,3555215568,3479910993,1672652877,1672654188,1311
11694,3505414878,3703722212,1672575696,1672578997,3301
10023,3500221079,3435159896,1672660725,1672663727,3002
10282,3703168159,3515944817,1672689987,1672690283,296
10273,3611570003,3779212271,1672647983,1672650699,2716
11030,3311959533,3416474842,1672675644,1672677862,2218
11585,3713170867,3534168768,1672660035,1672661953,1918
11587,3515655024,3284407073,1672553920,1672556847,2927
9905,3510680251,3315432466,1672556788,1672559224,2436
11594,3711836873,3772695548,1672634412,1672635454,1042
9954,3975796415,3471177177,1672597264,1672599749,2485
11446,3913847876,3812677669,1672650276,1672650950,674
10014,3730169449,3632189887,1672701570,1672703952,2382
11696,3937636109,3533841983,1672584362,1672585770,1408
10512,3907245259,3517132086,1672586353,1672586802,449
10107,3424988692,3208594306,1672561634,1672562131,497
11485,3783408469,3908464960,1672545226,1672545564,338
10073,3776583229,3915460293,1672542071,1672544423,2352
10529,3733870816,3247545468,1672680334,1672682966,2632
11650,3606688595,3447267291,1672559366,1672561392,2026
10568,3337903727,3515753241,1672531900,1672533155,1255
10950,3836586875,3311739926,1672601932,1672602536,604
10094,3770941125,3369558911,1672664011,1672667330,3319
10173,3505490878,3514005973,1672662645,1672664052,1407
11511,3337715675,3337673625,1672681727,1672683686,1959
11734,3514926921,3311959533,1672563682,1672565517,1835
11170,3813085701,3378534521,1672672431,1672673841,1410
9887,3780956975,3425545115,1672559895,1672559979,84
10296,3715712376,3685645561,1672661001,1672661578,577
11308,3369938668,3701893620,1672655939,1672657473,1534
10753,3403988682,3450164574,1672603337,1672606547,3210
10660,3512871568,3516321814,1672535915,1672537001,1086
11053,3850005949,3714870496,1672597653,1672600153,2500
10648,3471996194,3701004302,1672622110,1672624598,2488
11783,3907245259,3791368349,1672625784,1672627882,2098
10431,3440671139,3791628263,1672652065,1672653419,1354
11097,3510919509,3714065165,1672602257,1672605278,3021
11094,3701377471,3350631472,1672534453,1672536382,1929
11774,3623512088,3400112498,1672648799,1672650411,1612
10229,3770497768,3446066492,1672548446,1672548730,284
10948,3490953301,3855674398,1672610012,1672611043,1031
11487,3633622298,3241567995,1672572515,1672573743,1228
10658,3517766135,3380418745,1672619676,1672620778,1102
11688,3501711464,3380628097,1672675138,1672675488,350
9868,3299052917,3817076003,1672662998,1672665412,2414
10476,3418382025,3783651407,1672585893,1672586328,435
10933,3533473206,3701385831,1672590884,1672593673,2789
11295,3834643026,3300810210,1672634821,1672636098,1277
11757,3611533094,3387388336,1672538956,1672540226,1270
10581,3399943757,3513740840,1672632076,1672633865,1789
10413,3792930090,3756897029,1672543716,1672544553,837
11114,3773636983,3778924002,1672548372,1672548851,479
10694,3417969824,3450342110,1672591448,1672593929,2481
10436,3713636175,3854202447,1672667589,1672670955,3366
10696,3773736248,3732596503,1672673501,1672673859,358
10256,3711349327,3275057862,1672645832,1672646541,709
10872,3713954144,3517021928,1672700636,1672703724,3088
10127,3772216305,3909504515,1672588891,1672589600,709
10428,3776447604,3783611957,1672629039,1672629185,146
10017,3334461288,3773161055,1672584496,1672586932,2436
10334,3501853868,3307791650,1672660167,1672661608,1441
11280,3716492409,3777149336,1672554519,1672555895,1376
10417,3908177413,3600842635,1672566799,1672568118,1319
10029,3311771689,3813853446,1672626790,1672627355,565
9975,3780612543,3277061226,1672572560,1672575223,2663
11687,3334936138,3478052226,1672637308,1672639029,1721
11625,3286938590,3558349840,1672572056,1672572932,876
11127,3370245766,3609925909,1672677190,1672680168,2978
10555,3505119470,3885645840,1672567491,1672567856,365
11034,3462153833,3479910993,1672607998,1672611121,3123
10469,3639503148,3772869013,1672583418,1672585213,1795
10250,3364660506,3515804844,1672671525,1672672937,1412
11705,3780148144,3518425740,1672645804,1672647374,1570
10465,3882905311,3773083407,1672651819,1672652046,227
11185,3505140123,3774436159,1672648109,1672650571,2462
11783,3422205569,3783122313,1672585401,1672588766,3365
10779,3559759778,3791382196,1672692996,1672694955,1959
11631,3710852576,3778604070,1672555683,1672557422,1739
11486,3791409441,3393955069,1672579874,1672580977,1103
10060,3227874229,3422548081,1672636406,1672639262,2856
11521,3927202773,3776053981,1672554275,1672554565,290
10632,3783430498,3611570003,1672597032,1672599748,2716
10837,3478455812,3368848936,1672692574,1672696105,3531
10280,3369938668,3452104161,1672662547,1672663305,758
10834,3856699097,3791974273,1672568569,1672571955,3386
10648,3770285500,3773024346,1672532460,1672535610,3150
11017,3774029494,3804707712,1672597794,1672600164,2370
10024,3793822639,3471585513,1672552736,1672554052,1316
11166,3772802020,3400560073,1672683593,1672683794,201
9857,3779130507,3227206772,1672592235,1672594060,1825
10180,3519435459,3756168814,1672645757,1672646173,416
10710,3792255406,3601063076,1672611672,1672614325,2653
11046,3807584987,3514685272,1672633047,1672634171,1124
11414,3618024815,3791994414,1672631028,1672634304,3276
11436,3446537819,3516535558,1672656509,1672660025,3516
10238,3732467455,3518478484,1672567244,1672569351,2107
9801,3511206717,3880562532,1672556840,1672559098,2258
10305,3818532143,3920526713,1672623541,1672624300,759
10746,3780050328,3491948594,1672638969,1672641387,2418
11770,3511794841,3805268739,1672613161,1672613624,463
10733,3311463998,3902292032,1672611466,1672614531,3065
10002,3342495377,3732871856,1672543752,1672545780,2028
11373,3760382349,3978254945,1672673180,1672676455,3275
10589,3892177203,3429047448,1672693661,1672695892,2231
11558,3906075386,3272096922,1672603843,1672605759,1916
10461,3500209015,3231963246,1672557069,1672559597,2528
10433,3227874229,3734233216,1672679429,1672682395,2966
9803,3519521903,3293673220,1672616649,1672617345,696
10861,3773475506,3703725221,1672622875,1672624827,1952
11175,3452024572,3220660616,1672547420,1672549667,2247
10525,3370245766,3801379377,1672688585,1672690981,2396
10783,3714067998,3756717136,1672626861,1672627662,801
11109,3440991826,3450679913,1672670996,1672673532,2536
10283,3780173788,3517149023,1672547723,1672550221,2498
10504,3919719755,3510143850,1672633803,1672633943,140
9895,3703737650,3293553295,1672693136,1672694485,1349
10514,3792987243,3682086200,1672656344,1672658694,2350
10101,3772751765,3779169946,1672670529,1672673664,3135
11370,3309528048,3901169230,1672654859,1672655688,829
11199,3923524564,3509167758,1672647317,1672650515,3198
11256,3497562878,3977615973,1672576839,1672579870,3031
10417,3715790104,3559123082,1672648659,1672650713,2054
10805,3715737742,3512681214,1672648845,1672652331,3486
11024,3466492108,3423940256,1672569772,1672570795,1023
10036,3500209015,3283847934,1672555472,1672556590,1118
11407,3500444748,3378172464,1672646553,1672646637,84
10349,3533131937,3514638555,1672582558,1672583548,990
11242,3851451801,3520022175,1672581326,1672581891,565
11365,3683562111,3791074200,1672680795,1672681307,512
11102,3533728729,3459799131,1672554661,1672557309,2648
11262,3445172440,3418382025,1672543804,1672546254,2450
11632,3501657158,3505500665,1672532468,1672534471,2003
10472,3979115924,3497732613,1672622976,1672624771,1795
11231,3519948471,3293579860,1672595611,1672596751,1140
11489,3381254180,3444680955,1672569865,1672573421,3556
10085,3510250740,3512477276,1672570386,1672570991,605
10398,3793375825,3714101349,1672561280,1672563722,2442
11151,3854202447,3930501172,1672659923,1672661501,1578
10420,3465107990,3281935691,1672692733,1672694983,2250
10816,3774195369,3686885442,1672577876,1672579364,1488
10227,3701448521,3474350534,1672618807,1672620023,1216
10556,3688870751,3770924034,1672600021,1672600308,287
11329,3500221079,3715724166,1672540561,1672541923,1362
11695,3203172170,3505007498,1672534766,1672537121,2355
11229,3343698137,3938129916,1672545358,1672547571,2213
11672,3778604070,3730115019,1672689334,1672691385,2051
11070,3406169279,3710147457,1672640506,1672641709,1203
9960,3309455369,3371759126,1672538133,1672541444,3311
11085,3935256825,3513802404,1672703430,1672704990,1560
10202,3924205112,3931767736,1672661502,1672662395,893
10827,3977157565,3509370633,1672664578,1672667455,2877
11636,3287094447,3517991042,1672596889,1672598912,2023
10501,3777672363,3500720752,1672662167,1672662610,443
11043,3855077502,3510373076,1672643271,1672643939,668
10679,3470135167,3355880028,1672635180,1672636343,1163
10182,3774965463,3500145103,1672604842,1672606790,1948
9874,3520470646,3713858538,1672567578,1672568431,853
9830,3294949958,3279731391,1672534246,1672535957,1711
10183,3701475090,3755170743,1672580819,1672582051,1232
10692,3349319959,3356972733,1672590384,1672593245,2861
10651,3478455812,3770275898,1672550309,1672550798,489
11184,3495152069,3755942724,1672622172,1672623251,1079
11121,3713416106,3714903456,1672672747,1672673583,836
10944,3505685294,3274739459,1672538070,1672538935,865
10580,3316537706,3319645922,1672568755,1672569062,307
9941,3355880028,3713476192,1672543822,1672546352,2530
10636,3682150740,3760554453,1672628302,1672631566,3264
10815,3914947393,3354405535,1672579418,1672580024,606
10920,3423217578,3908331271,1672642791,1672643625,834
9897,3757639274,3520515739,1672605928,1672607288,1360
10964,3301765144,3512072679,1672588375,1672591534,3159
9868,3716195780,3770457058,1672622723,1672625716,2993
10193,3272096922,3716733618,1672698627,1672701269,2642
9807,3813276198,3760416450,1672676266,1672677693,1427
10780,3309455369,3713636175,1672576550,1672579907,3357
11175,3770275898,3384713976,1672666105,1672667093,988
10230,3976225898,3791547827,1672643231,1672644175,944
10436,3680832669,3518368900,1672693400,1672695114,1714
10845,3434052463,3420854927,1672569801,1672570775,974
11564,3680278447,3304235700,1672552396,1672555992,3596
11689,3792719263,3517943697,1672675140,1672677107,1967
10796,3422460919,3792440162,1672585260,1672588371,3111
10129,3226037966,3408111327,1672684417,1672686585,2168
11171,3207307681,3711755596,1672659745,1672661264,1519
11226,3831981073,3505998260,1672680721,1672684045,3324
11586,3505010941,3832333115,1672604340,1672607622,3282
11488,3243056734,3306491253,1672583114,1672586426,3312
11755,3512072679,3515726910,1672682911,1672686116,3205
11096,3510189563,3514761434,1672675297,1672678773,3476
11090,3407734098,3500928990,1672684525,1672687380,2855
10111,3714264759,3515974881,1672649954,1672651981,2027
11737,3429047448,3519341916,1672629836,1672630952,1116
9977,3689386663,3310737478,1672572534,1672576085,3551
11707,3703031637,3518058151,1672678248,1672679464,1216
10219,3757728121,3772461583,1672620422,1672620771,349
10302,3513850048,3511412229,1672541143,1672544026,2883
10151,3711349327,3510159441,1672540820,1672544323,3503
11244,3623067708,3384001094,1672577435,1672579336,1901
11689,3778125688,3220987526,1672621676,1672625246,3570
11340,3772905073,3825526565,1672632875,1672633578,703
9874,3793987483,3710147457,1672548494,1672550740,2246
9923,3489212992,3519108639,1672676774,1672678576,1802
11260,3271389160,3500854711,1672622663,1672625634,2971
11329,3907923381,3517632796,1672553035,1672554880,1845
10789,3776304080,3409098014,1672603068,1672603903,835
11243,3715249954,3668369938,1672546727,1672549673,2946
10744,3774506868,3733870816,1672673865,1672676908,3043
10078,3757851680,3713621169,1672605767,1672608329,2562
10434,3533867833,3686885442,1672538435,1672540999,2564
11235,3423147369,3365519448,1672624866,1672625806,940
11369,3512490032,3856897914,1672666477,1672669822,3345
9949,3437286595,3801379377,1672643626,1672646879,3253
11406,3517426473,3711767051,1672702205,1672705538,3333
9903,3732312480,3715320359,1672596275,1672599082,2807
10922,3827981800,3683562111,1672668266,1672671112,2846
9992,3776811587,3472718723,1672596861,1672596930,69
10425,3755465396,3433902955,1672620291,1672620952,661
11261,3757501067,3665603628,1672583458,1672586172,2714
10865,3770924034,3716197140,1672565773,1672565940,167
11352,3903994989,3505500523,1672562370,1672562661,291
11276,3908862092,3883640904,1672680031,1672681333,1302
10185,3432466467,3445172440,1672566434,1672568554,2120
10332,3307997700,3335055096,1672564467,1672565601,1134
10489,3902023467,3609335008,1672556765,1672559353,2588
10501,3483701493,3365519448,1672572719,1672574997,2278
10073,3518759318,3274894848,1672675226,1672678759,3533
11036,3703732445,3478052226,1672656652,1672658589,1937
11154,3931028233,3792289287,1672586222,1672588820,2598
11191,3461137945,3501115299,1672641680,1672644342,2662
11185,3511608609,3282053097,1672596882,1672598958,2076
9996,3770941125,3777074709,1672571429,1672574030,2601
9849,3711770853,3368339963,1672613925,1672614802,877
11168,3713996094,3907225070,1672690944,1672693025,2081
11199,3553229537,3353326305,1672651829,1672653036,1207
10947,3397527886,3777767907,1672695993,1672697024,1031
11224,3716468783,3205161801,1672581614,1672581888,274
9985,3501557463,3792900315,1672667367,1672670826,3459
10192,3662794240,3509677530,1672619712,1672621530,1818
10122,3454343398,3757089924,1672647241,1672648688,1447
11271,3227498870,3792075871,1672618248,1672618546,298
10826,3520697518,3459163055,1672681667,1672683267,1600
10436,3533325993,3973582279,1672669074,1672670518,1444
11477,3286938590,3716095450,1672677930,1672680208,2278
11342,3295748489,3517253559,1672660976,1672663173,2197
11647,3903065952,3516444589,1672665519,1672667175,1656
10678,3516827471,3713475356,1672613154,1672614018,864
10653,3711518637,3446537819,1672619950,1672620686,736
10142,3500693568,3715441777,1672694585,1672696385,1800
10478,3715111016,3791532324,1672654311,1672655247,936
11310,3829761380,3714455496,1672639136,1672642561,3425
10515,3519754667,3501225887,1672564100,1672564551,451
11174,3505804611,3515939841,1672562334,1672562965,631
11433,3851737350,3684108920,1672701448,1672704354,2906
11358,3779778679,3976225898,1672591059,1672592070,1011
9826,3359012188,3387870683,1672636421,1672637938,1517
9854,3510801769,3661359073,1672684472,1672684822,350
10745,3557129226,3713373455,1672678259,1672679795,1536
11303,3613940925,3755361692,1672655229,1672656727,1498
11792,3773534165,3501612813,1672689707,1672692311,2604
10244,3780294116,3479402555,1672670567,1672672577,2010
11623,3730290851,3801501384,1672604468,1672607540,3072
9914,3616371564,3442096275,1672615236,1672615528,292
10324,3776583229,3910049345,1672562700,1672562835,135
10910,3379400553,3336225953,1672666595,1672668089,1494
10027,3444881567,3513213122,1672545062,1672545635,573
10753,3519108639,3755374000,1672581994,1672584529,2535
10918,3513186578,3358530225,1672582755,1672586142,3387
11169,3287753579,3760529327,1672535813,1672538028,2215
9801,3520182275,3459163055,1672615528,1672617358,1830
11696,3701769970,3777932225,1672575381,1672578190,2809
10772,3377311502,3494157939,1672583692,1672585054,1362
10992,3436018575,3757001552,1672566187,1672569100,2913
10370,3714903253,3485898181,1672681567,1672683808,2241
11746,3791108593,3716633983,1672602556,1672604097,1541
11504,3880030249,3614944981,1672657922,1672659106,1184
10101,3298831109,3511867383,1672598007,1672601386,3379
11739,3793822639,3793274846,1672701927,1672703856,1929
11285,3533642281,3519922921,1672599065,1672602205,3140
11679,3817315443,3515726910,1672560983,1672563780,2797
10179,3669497617,3792851584,1672613324,1672616442,3118
11484,3760656396,3772966919,1672682182,1672682243,61
10281,3713636175,3714101349,1672690498,1672692379,1881
11489,3916463490,3669475165,1672669770,1672670482,712
10382,3792682835,3552444228,1672670220,1672672691,2471
11135,3857847527,3888903181,1672677243,1672678849,1606
10923,3668154066,3760481622,1672641291,1672642409,1118
11659,3249771731,3511028193,1672663167,1672666077,2910
10078,3312733562,3415840750,1672533002,1672534749,1747
10696,3891272544,3509317776,1672612634,1672615598,2964
11403,3533473206,3491758029,1672680406,1672681950,1544
11727,3777304517,3880000841,1672606900,1672610329,3429
11494,3509208005,3364286028,1672541573,1672544544,2971
10530,3715602742,3517440258,1672658093,1672660388,2295
10346,3973582279,3634766042,1672670653,1672672344,1691
11513,3395082458,3228218081,1672583887,1672586456,2569
11386,3783430498,3558349840,1672555363,1672558426,3063
11296,3517816581,3822496670,1672697751,1672701278,3527
10907,3510209505,3755374000,1672617022,1672618607,1585
9879,3777552831,3855209450,1672612761,1672615817,3056
10088,3461630842,3715680249,1672533502,1672534416,914
10576,3553640169,3770457058,1672675239,1672677161,1922
9947,3515715968,3284334297,1672589160,1672591852,2692
10815,3500433278,3520155898,1672650474,1672652742,2268
10661,3511412229,3680832669,1672612106,1672614245,2139
10523,3243651036,3710819760,1672556672,1672557713,1041
10864,3710260848,3850108828,1672545322,1672548162,2840
11256,3514564903,3533986052,1672621396,1672621691,295
11306,3294164983,3341432459,1672669977,1672673087,3110
11058,3770530739,3406169279,1672541344,1672544718,3374
11593,3711854614,3313502623,1672608431,1672611181,2750
11510,3755507566,3388946581,1672619397,1672621569,2172
10928,3774673193,3495152069,1672575136,1672576369,1233
10056,3299845453,3476144563,1672559904,1672561639,1735
10970,3770925016,3632189887,1672564045,1672565906,1861
9838,3802374620,3276231633,1672669972,1672670760,788
10451,3331228758,3201920708,1672631726,1672635191,3465
11570,3491104534,3517943697,1672687234,1672687958,724
10668,3772556646,3334482021,1672666122,1672667279,1157
10501,3605905645,3805704844,1672648148,1672651004,2856
11103,3885147558,3518117078,1672645200,1672645616,416
10337,3972856326,3513171472,1672638592,1672641748,3156
10979,3221126799,3406937294,1672669637,1672669773,136
10575,3514737648,3491239350,1672576259,1672578322,2063
11775,3778706119,3756998113,1672645328,1672648553,3225
11120,3246296769,3367202274,1672693126,1672694033,907
11591,3730348493,3600978954,1672620158,1672620674,516
10054,3971280379,3701218904,1672671116,1672671511,395
11014,3207586072,3701675183,1672697743,1672699096,1353
10912,3714903253,3501927452,1672556776,1672558530,1754
10262,3201573194,3714595459,1672649902,1672651169,1267
11043,3713606829,3908331271,1672609464,1672611916,2452
9973,3711196962,3773669001,1672619704,1672620763,1059
11394,3471996194,3711844574,1672693247,1672695686,2439
11474,3757032266,3515230715,1672688425,1672688856,431
10480,3779468781,3755502373,1672562874,1672563589,715
10775,3606688595,3791108593,1672597884,1672600840,2956
10770,3772055279,3895422995,1672571076,1672571451,375
11645,3533960602,3898965585,1672606506,1672609446,2940
10155,3533113740,3857609616,1672598384,1672599738,1354
10515,3305093237,3472561941,1672571324,1672573369,2045
10758,3772251279,3533340292,1672667707,1672669634,1927
11210,3511415786,3914947393,1672537025,1672537915,890
10556,3312800145,3776068937,1672667058,1672667281,223
10448,3493047640,3373018943,1672669504,1672669814,310
10692,3394357241,3852461753,1672545506,1672546777,1271
10625,3233993993,3307236682,1672592462,1672593386,924
10190,3703481882,3701925712,1672594124,1672595449,1325
10556,3711804184,3884369346,1672700581,1672703690,3109
10178,3423217578,3311432176,1672537912,1672540891,2979
11531,3505665253,3783594729,1672589467,1672590925,1458
11592,3518794921,3473706746,1672596540,1672599888,3348
10444,3779975575,3714883746,1672699926,1672700123,197
11108,3335139032,3757855416,1672607859,1672610147,2288
11148,3774355339,3686081254,1672549180,1672552728,3548
11566,3791509881,3517992521,1672625476,1672626908,1432
11353,3514776568,3773826624,1672546131,1672548996,2865
10284,3886837151,3923910914,1672565114,1672565243,129
10681,3713224038,3701127475,1672643440,1672645860,2420
10542,3533566754,3925792265,1672598835,1672599359,524
11714,3638050763,3370401047,1672655785,1672658725,2940
9905,3711219767,3757032266,1672564998,1672568337,3339
9838,3714903253,3413799143,1672640958,1672641522,564
11020,3637566026,3612042508,1672689504,1672691924,2420
11108,3899294071,3701663839,1672558843,1672561981,3138
10223,3755342153,3755688231,1672578186,1672579460,1274
10126,3282053097,3276393542,1672702628,1672703534,906
10781,3488887919,3394976623,1672641970,1672645263,3293
11762,3559619861,3778195766,1672551472,1672554164,2692
10507,3467415939,3235578121,1672642552,1672642616,64
11216,3701841013,3439662051,1672633648,1672634827,1179
10515,3884192843,3491948594,1672685028,1672685715,687
10268,3311159418,3703481882,1672602641,1672605927,3286
10257,3757773786,3791031227,1672541254,1672541898,644
10228,3228218081,3713621169,1672652367,1672655468,3101
11395,3233993993,3711722554,1672635802,1672637558,1756
11288,3501554468,3533201269,1672596835,1672597459,624
9965,3701919083,3513996288,1672569581,1672572807,3226
10887,3757378286,3772223331,1672699721,1672700853,1132
10373,3714455496,3711770773,1672679404,1672682840,3436
10886,3424425746,3808442442,1672591183,1672594351,3168
10775,3852275715,3639926564,1672658967,1672660086,1119
11208,3398021818,3361635547,1672598751,1672599300,549
11530,3516535558,3360949039,1672615853,1672617762,1909
11245,3512133625,3609103278,1672653632,1672655208,1576
11625,3533986052,3514576083,1672681053,1672683800,2747
10074,3238310644,3632189887,1672588474,1672588669,195
10053,3929391979,3513894659,1672544495,1672546126,1631
10991,3499820963,3424425746,1672610417,1672610955,538
9966,3510278533,3703659324,1672599243,1672599940,697
11480,3500928990,3886837151,1672673625,1672676543,2918
10456,3628556590,3911376818,1672593612,1672597187,3575
11676,3515764058,3365519448,1672680598,1672683552,2954
11025,3929446196,3515974881,1672625133,1672626303,1170
10719,3491527603,3202787155,1672555675,1672557822,2147
11136,3287760230,3475033290,1672663406,1672664941,1535
11181,3701725839,3344478603,1672534264,1672534855,591
11088,3334381941,3319529422,1672584338,1672585497,1159
10156,3791289855,3533976217,1672627210,1672630716,3506
11724,3793497672,3491758029,1672669006,1672670084,1078
11760,3487622510,3783651407,1672539548,1672542155,2607
10333,3305657559,3287920864,1672670405,1672673675,3270
11105,3776710698,3516454693,1672700526,1672704115,3589
10314,3518408734,3714870496,1672610359,1672611775,1416
10056,3368079099,3330238204,1672596287,1672599525,3238
10406,3885545415,3393909269,1672582462,1672584230,1768
11118,3907225070,3602401154,1672536038,1672536671,633
11174,3287760230,3780500331,1672584987,1672586344,1357
10066,3793081195,3533225084,1672572714,1672576129,3415
11514,3666655293,3458753033,1672667908,1672669934,2026
11707,3440743218,3774221318,1672686168,1672689659,3491
11747,3701291994,3511003541,1672626946,1672628999,2053
10181,3907390925,3779255367,1672531579,1672534354,2775
11599,3773554767,3441737317,1672595662,1672598878,3216
11053,3511729562,3888642876,1672622893,1672625614,2721
11725,3352295704,3837885956,1672576339,1672577537,1198
9867,3805616707,3458271585,1672627818,1672631411,3593
10429,3430823498,3425260097,1672550471,1672552150,1679
11016,3905358065,3623067708,1672571260,1672574536,3276
11636,3603682643,3519513219,1672671253,1672673227,1974
9992,3887918622,3778909412,1672573646,1672574574,928
10716,3400112498,3500579482,1672662834,1672665349,2515
11621,3486824047,3513293711,1672662467,1672665581,3114
10513,3701725839,3452389513,1672583064,1672586600,3536
11110,3773394570,3405200303,1672579012,1672580587,1575
10643,3311739926,3711287751,1672627695,1672629355,1660
11087,3792930090,3306037126,1672545162,1672547695,2533
11747,3856975623,3500251781,1672545343,1672546483,1140
11642,3805926853,3513143959,1672665083,1672665641,558
10336,3516586325,3352044245,1672555596,1672558930,3334
10893,3298831109,3791108593,1672574831,1672577678,2847
10361,3447312353,3713471446,1672616101,1672618467,2366
9900,3856552205,3757407184,1672585818,1672588510,2692
11704,3514244308,3938398160,1672689215,1672692052,2837
11651,3469350379,3711770853,1672582436,1672585804,3368
10697,3515548696,3287753579,1672587029,1672587429,400
11260,3774782065,3518989186,1672552000,1672554035,2035
10245,3617771673,3360972732,1672639334,1672640354,1020
11729,3514341451,3513213122,1672639300,1672639744,444
11141,3629869834,3770480149,1672573075,1672576057,2982
10304,3394394262,3231859576,1672648363,1672649857,1494
10469,3837887478,3533077580,1672606820,1672607046,226
11351,3238310644,3510542303,1672612882,1672613934,1052
9850,3510869438,3318250647,1672562145,1672562764,619
10465,3500596577,3493598658,1672634117,1672634908,791
9861,3366566029,3834643026,1672618937,1672620942,2005
11617,3779454060,3783043770,1672677293,1672677444,151
10575,3501843187,3757872458,1672631678,1672634713,3035
10784,3907225070,3380357490,1672632738,1672634542,1804
10751,3730169449,3512750313,1672595093,1672597953,2860
11326,3501171785,3519465545,1672542205,1672543019,814
11508,3810949170,3342368576,1672598389,1672598507,118
10252,3756843139,3857389270,1672602944,1672606226,3282
10144,3319585148,3420664407,1672548536,1672552055,3519
10337,3756642173,3612841103,1672629639,1672631867,2228
11341,3505908965,3760997159,1672547627,1672547802,175
11295,3501205057,3919258737,1672701298,1672702832,1534
11539,3444168914,3500630465,1672541905,1672544257,2352
10213,3772425253,3533876927,1672638479,1672638785,306
10995,3475830203,3827889533,1672630363,1672630513,150
10568,3755238321,3713107380,1672538756,1672540478,1722
10061,3390444181,3313282478,1672576663,1672579437,2774
11753,3770018912,3623113240,1672662225,1672664546,2321
11115,3660496328,3229465607,1672634669,1672636600,1931
11583,3917467642,3701449715,1672559976,1672560147,171
11561,3509828883,3518947256,1672652279,1672655841,3562
9809,3621629499,3783594246,1672672789,1672674214,1425
10980,3278805844,3793926338,1672599838,1672601901,2063
11574,3780733404,3403218814,1672662364,1672663286,922
10410,3710119555,3902775449,1672558941,1672560543,1602
10229,3308481706,3820280594,1672647443,1672650725,3282
11510,3301332095,3299587876,1672606873,1672607519,646
10152,3757623259,3352057037,1672543195,1672545485,2290
9967,3392482187,3715101177,1672660672,1672662699,2027
10690,3703694139,3631444265,1672589077,1672591185,2108
10756,3835509670,3701685828,1672532903,1672534445,1542
11480,3756367938,3204473480,1672559365,1672562617,3252
10444,3229570647,3509677530,1672613072,1672615503,2431
9951,3756642173,3792719263,1672610587,1672614085,3498
11695,3772250554,3231227362,1672684322,1672685799,1477
11575,3974400577,3760074281,1672672422,1672672879,457
10776,3351856699,3776468503,1672578683,1672579713,1030
11432,3512417724,3500555856,1672661837,1672664161,2324
10219,3429315500,3514341451,1672564353,1672567270,2917
11661,3385006834,3777060250,1672633064,1672633138,74
10672,3825526565,3912862842,1672533414,1672534495,1081
11462,3515655024,3791332226,1672532961,1672534757,1796
11241,3398075553,3515558215,1672696585,1672697909,1324
10119,3311626308,3703588004,1672624935,1672625013,78
10256,3774946684,3516454693,1672656865,1672659080,2215
11012,3233965781,3809871495,1672604031,1672606299,2268
11360,3776841808,3511663572,1672563748,1672566109,2361
11590,3757773786,3534624672,1672629536,1672630728,1192
9878,3714264759,3760069457,1672564416,1672566667,2251
11744,3512546783,3428325402,1672623614,1672625295,1681
10708,3497904539,3614112171,1672599437,1672600753,1316
10037,3512744657,3925175853,1672653927,1672656351,2424
11379,3894328297,3738160394,1672629437,1672632698,3261
9921,3534206917,3701919083,1672633171,1672634358,1187
11530,3713416756,3911376818,1672655290,1672658062,2772
10644,3711945923,3772169046,1672611837,1672612616,779
10689,3887918622,3361952532,1672701539,1672702567,1028
10189,3229734741,3533340292,1672582008,1672585588,3580
11345,3511794841,3454343398,1672638862,1672639076,214
10280,3509317054,3701685828,1672702825,1672703732,907
9868,3244397548,3404375908,1672567464,1672568159,695
11369,3770019143,3301489209,1672686994,1672689628,2634
9844,3361711720,3664478769,1672683416,1672684471,1055
11269,3534506090,3975799349,1672586010,1672587920,1910
11423,3772980989,3665478011,1672693824,1672695421,1597
9907,3559754304,3776124041,1672606045,1672609082,3037
11219,3376487118,3294949958,1672600879,1672604061,3182
11104,3515984911,3510218188,1672689742,1672690135,393
11471,3474852115,3271282663,1672655530,1672657949,2419
11254,3513563152,3445558740,1672676089,1672676324,235
10683,3330238204,3703818358,1672652793,1672654708,1915
11099,3479910993,3756759239,1672678421,1672679341,920
10002,3512546783,3908464960,1672563478,1672565899,2421
10901,3806034626,3288346356,1672570888,1672571050,162
10073,3550405857,3907245259,1672605043,1672607756,2713
10589,3806034626,3312651192,1672557423,1672560023,2600
11456,3703351452,3519228207,1672545751,1672546294,543
11677,3907390925,3610723722,1672625150,1672627333,2183
11654,3792173463,3910020031,1672537014,1672538211,1197
10137,3739618347,3411355804,1672699413,1672701530,2117
10808,3791222330,3909399636,1672572535,1672574828,2293
11192,3438818153,3703443664,1672592061,1672592211,150
10236,3477248170,3783373085,1672595735,1672598800,3065
9961,3505936495,3245755569,1672560387,1672561023,636
10555,3533986052,3926724515,1672651512,1672653747,2235
10905,3381055770,3760069457,1672627856,1672629480,1624
10369,3770497768,3757201538,1672684891,1672688296,3405
10492,3201920708,3345954031,1672691556,1672691900,344
9956,3773024346,3279851026,1672650122,1672652852,2730
10192,3755361692,3772235668,1672586955,1672587155,200
10418,3513563152,3302348002,1672635188,1672636919,1731
10357,3774436159,3422205569,1672643167,1672645828,2661
11655,3474097405,3281970147,1672680701,1672682213,1512
10762,3509433155,3513140146,1672641190,1672641611,421
11609,3505438826,3791628195,1672636720,1672639413,2693
11027,3929355087,3205161801,1672550364,1672550432,68
10717,3468871103,3231227362,1672692737,1672693039,302
11177,3516034245,3904004824,1672551272,1672553522,2250
11285,3226172318,3445406685,1672664071,1672666041,1970
11211,3373135211,3517718901,1672663387,1672663798,411
10000,3510254698,3778706119,1672623395,1672624416,1021
10330,3501657158,3500209015,1672544735,1672547601,2866
10432,3772802020,3774673193,1672553947,1672555555,1608
10405,3812516461,3476144563,1672628659,1672629643,984
10260,3757501067,3509470194,1672634308,1672635309,1001
11702,3533440736,3436774112,1672625871,1672628045,2174
10213,3757869138,3304697982,1672545262,1672546564,1302
11324,3501963428,3715101177,1672543507,1672546022,2515
10657,3380357490,3774965463,1672577061,1672577752,691
10619,3776249160,3701865589,1672593134,1672596687,3553
10286,3615447269,3772867078,1672556396,1672559673,3277
9949,3610517436,3857344874,1672535157,1672535320,163
10849,3773376762,3711131262,1672564300,1672565204,904
10001,3730115019,3505331014,1672657675,1672660558,2883
11264,3602401154,3776407517,1672593637,1672596840,3203
10960,3792075871,3289771213,1672685781,1672686598,817
9990,3791581138,3660702754,1672688441,1672691833,3392
10232,3499142934,3906693728,1672675062,1672675961,899
11642,3770780655,3736621212,1672544406,1672545579,1173
11779,3514498259,3491948594,1672618288,1672620851,2563
11591,3899294071,3510836047,1672563566,1672564998,1432
10271,3518534560,3850005949,1672667647,1672670148,2501
10625,3777672363,3811354125,1672555608,1672556891,1283
10438,3202787155,3500595432,1672683563,1672685299,1736
11524,3850181934,3330799389,1672618514,1672621954,3440
11137,3371759126,3711852131,1672693055,1672693704,649
10971,3420881591,3472561941,1672545389,1672548396,3007
10026,3774326754,3852461753,1672676740,1672677914,1174
11199,3243651036,3770544738,1672682170,1672682785,615
10591,3517136772,3505825767,1672676903,1672678849,1946
11518,3979115924,3774682234,1672611016,1672612551,1535
11680,3477951091,3730169449,1672639221,1672642592,3371
11355,3979115924,3288920399,1672572531,1672574705,2174
10854,3710865678,3362706073,1672585402,1672586322,920
10139,3518157683,3450679913,1672570913,1672572453,1540
11153,3431317400,3776950532,1672620088,1672623344,3256
11149,3271780525,3513894659,1672685746,1672688069,2323
11374,3515726910,3468871103,1672603161,1672603554,393
10961,3520558137,3500442370,1672572973,1672575103,2130
10897,3760024021,3437703650,1672633446,1672635494,2048
10505,3906693728,3701028092,1672669851,1672672721,2870
9852,3738760498,3689386663,1672596316,1672597943,1627
10236,3333477908,3287968403,1672581684,1672582614,930
11095,3779413388,3715008501,1672571198,1672573037,1839
10655,3423147369,3505032773,1672599963,1672603442,3479
11542,3293579860,3557653200,1672535741,1672537884,2143
11412,3713224986,3916924978,1672682584,1672683489,905
11743,3499711458,3760679372,1672540590,1672541225,635
11672,3710783759,3373018943,1672663387,1672664238,851
10531,3757592622,3347172556,1672609795,1672609858,63
11510,3887382548,3500974385,1672616224,1672618182,1958
10809,3421040626,3818904268,1672682113,1672682599,486
10947,3850904092,3500011591,1672601815,1672602732,917
11048,3372079985,3710223875,1672570083,1672572337,2254
10372,3533974355,3293673220,1672672045,1672674058,2013
9821,3399173821,3519908593,1672599011,1672602328,3317
10288,3925792265,3701893620,1672693070,1672694937,1867
10403,3899970524,3807717766,1672540803,1672541727,924
10737,3792682835,3880030249,1672621025,1672623169,2144
10584,3827889533,3715590997,1672559256,1672561698,2442
11333,3885147558,3637566026,1672678192,1672680493,2301
11348,3778382224,3812261241,1672616167,1672618871,2704
10176,3435652260,3435159896,1672640531,1672642755,2224
9891,3687445224,3435801763,1672681155,1672681488,333
11154,3500591274,3757823215,1672544259,1672547130,2871
10827,3612841103,3514013999,1672697591,1672701077,3486
11790,3245245283,3493679801,1672564240,1672565551,1311
10693,3516026189,3774483862,1672588872,1672590648,1776
10329,3500011591,3311696372,1672578712,1672579120,408
10038,3777569538,3417431173,1672623675,1672626771,3096
11286,3430296808,3903088144,1672571647,1672574214,2567
10278,3887918622,3500974385,1672671582,1672673421,1839
10462,3792107875,3777304517,1672540156,1672541746,1590
11587,3482519872,3366801723,1672638069,1672638211,142
11704,3231859576,3465227623,1672606051,1672607559,1508
10773,3408111327,3713923960,1672599579,1672599709,130
10740,3509614126,3519059808,1672611182,1672611793,611
10966,3512965991,3203837944,1672648491,1672648822,331
9886,3756297396,3519965717,1672580499,1672582491,1992
10169,3519730914,3419648004,1672662562,1672663515,953
11650,3791994414,3774946684,1672642714,1672643311,597
11208,3773895671,3660702754,1672542312,1672544298,1986
10986,3488988274,3927675706,1672697102,1672698547,1445
11460,3780074082,3403218814,1672574654,1672577341,2687
10670,3406390503,3512753567,1672655750,1672657404,1654
11422,3505828210,3315432466,1672668502,1672669049,547
11196,3500444748,3624307518,1672599785,1672602232,2447
11093,3703938162,3556684272,1672650644,1672651685,1041
10910,3735152111,3701004302,1672664854,1672666852,1998
10624,3553229537,3500741534,1672539556,1672542644,3088
10425,3500931474,3774706478,1672640401,1672642365,1964
10502,3793407883,3791644831,1672689726,1672691260,1534
11287,3776583229,3914926436,1672632474,1672635620,3146
10464,3520832066,3505491969,1672675286,1672676923,1637
9978,3398075553,3403870769,1672581481,1672584209,2728
10530,3975799349,3513764665,1672613235,1672614280,1045
9814,3515378306,3516588277,1672571545,1672574440,2895
11225,3633860380,3512794667,1672652922,1672653106,184
10067,3515802579,3398489033,1672566058,1672567210,1152
9976,3770780655,3711187791,1672575767,1672578909,3142
11406,3760074281,3510439480,1672555433,1672556842,1409
9879,3400903513,3514508773,1672552058,1672554394,2336
11574,3435801763,3353194923,1672595076,1672598379,3303
10447,3313502623,3500234771,1672599017,1672600804,1787
11561,3559123082,3450164574,1672653611,1672653812,201
11613,3511218261,3412605548,1672653053,1672655944,2891
10442,3710807030,3619796619,1672574589,1672575482,893
11460,3774744663,3713471446,1672655466,1672655613,147
10238,3755767856,3534531061,1672621036,1672623225,2189
10219,3225554956,3516153301,1672682418,1672682789,371
10884,3453164933,3500968729,1672606554,1672608372,1818
10098,3482687604,3533419409,1672596192,1672596330,138
10493,3239279744,3812756400,1672574369,1672575489,1120
10083,3476308535,3793699467,1672557628,1672561050,3422
11221,3757501067,3358211034,1672691816,1672692535,719
11468,3713805968,3793081195,1672686739,1672687689,950
10096,3776581518,3373851012,1672624819,1672626029,1210
10118,3714435747,3534102440,1672698726,1672698954,228
11239,3778738044,3510368377,1672696797,1672697629,832
11735,3501557463,3505416534,1672633141,1672636230,3089
11777,3203837944,3520779124,1672595327,1672597243,1916
11557,3457249798,3681701931,1672623621,1672625473,1852
10895,3227339675,3306475287,1672647690,1672650205,2515
10606,3301369282,3701459978,1672556750,1672559831,3081
10261,3238310644,3920116284,1672540217,1672541511,1294
11732,3420664407,3776455762,1672621640,1672624343,2703
10914,3428788958,3414387263,1672609211,1672610504,1293
10593,3500693568,3686853863,1672635996,1672637921,1925
10573,3437286595,3307454562,1672614811,1672617928,3117
11039,3499142934,3924366353,1672571942,1672575318,3376
11064,3454151554,3465672238,1672537794,1672539806,2012
10231,3792475476,3422314045,1672639538,1672643063,3525
10425,3776440009,3755922811,1672644463,1672647353,2890
10385,3470135167,3520344592,1672699883,1672702763,2880
11612,3887069914,3390368796,1672575826,1672578768,2942
10458,3428878402,3512700007,1672597818,1672597940,122
10395,3714268380,3633622298,1672614269,1672615163,894
10779,3853783593,3606688595,1672648359,1672648711,352
9827,3533777032,3488988274,1672661626,1672664324,2698
10007,3917243005,3505119470,1672682437,1672683164,727
11149,3710147457,3558349840,1672616804,1672619973,3169
10810,3304028109,3701529552,1672550175,1672552278,2103
10218,3402105276,3755378125,1672693896,1672695090,1194
10488,3238997746,3515699732,1672540759,1672542611,1852
10960,3629869834,3776593726,1672551960,1672554522,2562
10524,3395615598,3713728777,1672615822,1672618177,2355
9861,3770018912,3511069449,1672622927,1672623685,758
10621,3486824047,3791351852,1672610670,1672611323,653
11767,3783172505,3774706478,1672646527,1672647752,1225
11757,3701493094,3664719070,1672647283,1672649202,1919
10698,3887382548,3772489471,1672567663,1672569094,1431
10048,3776841808,3703725221,1672567729,1672570848,3119
10001,3475560058,3776811587,1672656092,1672658845,2753
11623,3733411026,3512819376,1672580915,1672582179,1264
11048,3311529105,3714951681,1672627339,1672628399,1060
11456,3341129425,3403120725,1672537047,1672540239,3192
10805,3501557463,3780168985,1672597491,1672598167,676
11408,3472173212,3770408300,1672643507,1672644712,1205
11786,3920606331,3703742071,1672594337,1672596362,2025
11367,3445896667,3779975575,1672595865,1672598611,2746
10461,3512417724,3505164060,1672593294,1672594314,1020
11130,3534068874,3620836520,1672538905,1672541349,2444
9814,3825153408,3783043770,1672590374,1672593129,2755
10544,3519357822,3511663572,1672635335,1672637183,1848
10089,3935520819,3511199555,1672618012,1672621408,3396
11671,3710622746,3783443095,1672566431,1672566575,144
9995,3278430820,3716740576,1672681628,1672685205,3577
10600,3791863922,3513563152,1672602021,1672603742,1721
10878,3316406470,3813986705,1672639811,1672640141,330
10331,3429409539,3533830748,1672702674,1672703234,560
11564,3380281484,3501174621,1672701151,1672702344,1193
11210,3680075399,3472173212,1672662745,1672662832,87
11427,3230250213,3519724388,1672583468,1672583588,120
11571,3636857871,3971996397,1672604529,1672607452,2923
9974,3298831109,3336501403,1672634458,1672635563,1105
9857,3793949077,3446810761,1672534342,1672535120,778
11252,3856316719,3780964089,1672560302,1672563004,2702
9980,3780423516,3803382101,1672701647,1672705016,3369
11327,3468066881,3552922094,1672610091,1672612593,2502
11760,3245501577,3509912164,1672584103,1672586566,2463
10420,3369558911,3814289471,1672592159,1672592594,435
11423,3500455935,3937747312,1672672451,1672675021,2570
10160,3519015940,3735422623,1672700306,1672701793,1487
11396,3791072829,3517816581,1672589633,1672589745,112
10507,3511458926,3551972633,1672539708,1672541495,1787
11218,3400793223,3515259326,1672684773,1672685531,758
10660,3283295213,3496407500,1672571608,1672574570,2962
10594,3505908965,3774633364,1672606224,1672607811,1587
10399,3710316008,3912625932,1672652472,1672656019,3547
9925,3478937459,3682906048,1672667618,1672670963,3345
11382,3517151644,3510894809,1672685899,1672687924,2025
10722,3711404205,3755507566,1672578172,1672579253,1081
10949,3500889287,3780648744,1672679075,1672681302,2227
11484,3516167000,3414510793,1672533677,1672535105,1428
10277,3319061210,3777931341,1672583423,1672583786,363
11229,3636927297,3633294415,1672601810,1672603027,1217
10266,3518164450,3701540249,1672634118,1672636178,2060
11370,3780423516,3884191432,1672629189,1672630423,1234
10504,3662354016,3449672240,1672564424,1672564835,411
10554,3400560073,3904004824,1672658597,1672660725,2128
9796,3791825536,3371238318,1672541417,1672542533,1116
9948,3632720032,3783935976,1672568834,1672569166,332
9876,3511198566,3423217578,1672593688,1672597210,3522
9965,3791409441,3773876312,1672675827,1672678678,2851
11044,3294952405,3311626308,1672628167,1672631570,3403
10393,3756948477,3510178791,1672679538,1672680015,477
11324,3783060739,3513629502,1672553611,1672556017,2406
10034,3614112171,3520009158,1672543213,1672545201,1988
10165,3908878965,3917467642,1672606399,1672607556,1157
10533,3919211457,3778125688,1672560137,1672562371,2234
10403,3515577866,3791664049,1672694448,1672695194,746
11092,3513250976,3228465044,1672599307,1672600242,935
11786,3910020031,3514033319,1672596130,1672599160,3030
10908,3514033319,3515655024,1672688449,1672689396,947
11435,3831864108,3703336988,1672568169,1672568448,279
10208,3278443807,3512072679,1672594114,1672594569,455
10399,3468066881,3519322066,1672557027,1672559296,2269
11097,3776183353,3791584994,1672558857,1672561093,2236
11060,3757030923,3516867729,1672692735,1672696038,3303
10684,3533340292,3755175497,1672549283,1672552130,2847
10102,3520779124,3701284535,1672670592,1672672081,1489
10513,3505010941,3783201950,1672690168,1672693403,3235
10360,3301403047,3500120676,1672577411,1672578948,1537
10285,3899205452,3773161055,1672669174,1672671871,2697
11763,3770972037,3516454693,1672551527,1672552536,1009
10568,3774792696,3703438617,1672547820,1672549756,1936
11517,3701493094,3358530225,1672555236,1672556898,1662
11718,3756297396,3292663993,1672640216,1672642163,1947
9998,3515597467,3714287902,1672622675,1672625969,3294
10624,3512794667,3461741050,1672578568,1672578873,305
9817,3247075753,3685083275,1672552364,1672553877,1513
11153,3422959249,3373802545,1672621034,1672621914,880
11696,3313502623,3287094447,1672670596,1672672329,1733
11338,3823307824,3894495222,1672683736,1672687275,3539
9920,3685522474,3500785888,1672653189,1672655360,2171
11521,3821087562,3686211958,1672684386,1672684654,268
10368,3713969196,3973138649,1672556018,1672557948,1930
11555,3501835995,3779393140,1672556277,1672557945,1668
10958,3509274030,3505998260,1672693135,1672694058,923
11621,3773534165,3511004622,1672660663,1672663562,2899
9992,3429610195,3533867833,1672584897,1672585205,308
9862,3793222045,3714903253,1672622740,1672624493,1753
10073,3513586642,3351837521,1672598623,1672602171,3548
11698,3364683368,3356599815,1672588024,1672590677,2653
10673,3701453343,3776867553,1672551677,1672553044,1367
11673,3513486828,3400112498,1672630118,1672630863,745
10971,3311188620,3447938130,1672611049,1672612701,1652
10611,3505571800,3776950532,1672647059,1672647504,445
10860,3774652449,3701296091,1672680725,1672683958,3233
10153,3386323728,3779748270,1672558086,1672560081,1995
10672,3420854927,3377883705,1672623477,1672625464,1987
10923,3756998113,3710296607,1672630853,1672631213,360
11056,3517358336,3774035405,1672703081,1672704437,1356
10000,3908331271,3439045964,1672609313,1672611674,2361
11251,3319862687,3906693728,1672546127,1672546268,141
9985,3220660616,3736621212,1672677342,1672678267,925
11216,3515804844,3929446196,1672676472,1672679642,3170
11432,3711852131,3235470567,1672548368,1672549162,794
10403,3827981800,3713858538,1672662770,1672665965,3195
10712,3511198566,3519357822,1672574582,1672578154,3572
10253,3500018566,3519059808,1672681468,1672682305,837
10184,3534506090,3511095300,1672643560,1672645657,2097
10428,3701893620,3500444748,1672696777,1672697870,1093
11048,3756784813,3501619113,1672562067,1672563233,1166
10211,3770709417,3891272544,1672695134,1672696050,916
10200,3713636175,3517113478,1672646761,1672646986,225
10561,3516585063,3387971464,1672630306,1672630738,432
9880,3514571807,3347520239,1672580447,1672581080,633
10501,3515548696,3793029132,1672668225,1672668743,518
11445,3756759239,3757713457,1672543834,1672547332,3498
10313,3309528048,3814770073,1672531454,1672534711,3257
11789,3354405535,3516777819,1672540265,1672541634,1369
11132,3512288503,3411355804,1672563987,1672566462,2475
10637,3305093237,3772223331,1672641357,1672641586,229
11561,3899205452,3703438617,1672587250,1672588715,1465
10805,3287683210,3206926634,1672687925,1672690751,2826
10578,3791224239,3934980229,1672637489,1672639796,2307
10129,3301403047,3701655378,1672552423,1672553445,1022
9854,3416225867,3509912164,1672608191,1672610436,2245
10165,3493047640,3417431173,1672703009,1672705947,2938
10646,3500096103,3360309868,1672685931,1672687819,1888
11754,3514628916,3711613085,1672595243,1672595777,534
10869,3701448521,3514341451,1672702144,1672704852,2708
10529,3333355914,3311626308,1672620300,1672621895,1595
10967,3512769522,3399504157,1672574886,1672577203,2317
10618,3274341934,3792719263,1672695291,1672698879,3588
10778,3710223875,3330318282,1672575314,1672576791,1477
9925,3347520239,3773579644,1672617468,1672620347,2879
11531,3854957153,3894756677,1672684860,1672687073,2213
10585,3773636983,3496591885,1672583387,1672585064,1677
10009,3511382748,3600842635,1672643657,1672643854,197
10400,3520694387,3518205307,1672598448,1672598736,288
11104,3772131127,3450621820,1672591562,1672593199,1637
10449,3204821370,3505248368,1672595622,1672599022,3400
10197,3447312353,3760541837,1672643735,1672644945,1210
11711,3715106566,3776034313,1672658461,1672660883,2422
10348,3418367752,3715897627,1672607612,1672610346,2734
10045,3639465750,3513432588,1672601213,1672601603,390
11467,3519621901,3756297396,1672545865,1672546260,395
10425,3369108286,3804707712,1672616288,1672619460,3172
11104,3534278019,3793407883,1672701289,1672701358,69
11180,3403870769,3774744663,1672579635,1672581178,1543
10330,3382696725,3311739926,1672555739,1672557709,1970
11620,3683047199,3772291207,1672641039,1672641176,137
10729,3824259677,3468871103,1672679160,1672679915,755
10837,3501370430,3452090950,1672591310,1672594002,2692
11343,3513739060,3307535495,1672624714,1672625722,1008
10462,3621960662,3772188086,1672682512,1672684742,2230
10034,3516454693,3496591885,1672586389,1672588352,1963
11595,3338187803,3480560014,1672536852,1672537503,651
10160,3821103640,3613936929,1672551140,1672551824,684
9984,3429587594,3832002939,1672625168,1672626562,1394
11640,3500688476,3228997424,1672639366,1672640454,1088
10677,3666823095,3780626668,1672589893,1672590088,195
11013,3770671714,3711765138,1672586034,1672588334,2300
9996,3225554956,3533131937,1672622865,1672623775,910
9901,3890813040,3277634944,1672625272,1672627558,2286
10962,3513213122,3736941123,1672552696,1672555890,3194
9856,3909457959,3755107521,1672613357,1672615759,2402
9894,3627377299,3606688595,1672614109,1672616147,2038
10209,3509556649,3971280379,1672565387,1672566959,1572
11339,3772905073,3791435852,1672677081,1672679633,2552
10945,3376842515,3399943757,1672642822,1672644795,1973
11778,3783809405,3813986705,1672668972,1672671703,2731
11270,3779174993,3517991042,1672664867,1672667702,2835
11769,3313298164,3929446196,1672538036,1672539565,1529
10696,3929355087,3760687922,1672603453,1672605363,1910
10424,3616371564,3469778316,1672608191,1672610097,1906
10613,3519886257,3534812391,1672622993,1672623138,145
10060,3902300755,3627358016,1672629386,1672631730,2344
10797,3534531061,3732846295,1672655858,1672657664,1806
10959,3924366353,3500695402,1672599731,1672599797,66
11438,3716460706,3680278447,1672572191,1672572542,351
10065,3778741325,3916924978,1672555076,1672558407,3331
11184,3275171954,3703938162,1672660238,1672662925,2687
10932,3373135211,3633622298,1672628363,1672629976,1613
10404,3732440502,3463729805,1672619967,1672621962,1995
10694,3738734246,3366433035,1672608786,1672610875,2089
11305,3410602007,3226172318,1672679376,1672680695,1319
10846,3780213684,3228575883,1672700548,1672700818,270
10840,3449020351,3413799143,1672568922,1672569799,877
10549,3793934396,3517756624,1672684539,1672687117,2578
10303,3912915644,3514361485,1672658578,1672661409,2831
9892,3246381831,3884934977,1672658600,1672659792,1192
9998,3510022922,3519352855,1672664030,1672667254,3224
9857,3927675706,3510694464,1672561041,1672564617,3576
10964,3888409038,3516340010,1672572086,1672574443,2357
11497,3399943757,3685522474,1672539236,1672541566,2330
10748,3895839169,3711131262,1672570094,1672573110,3016
10431,3714951681,3357097510,1672609361,1672611370,2009
9812,3488333295,3714595459,1672696331,1672698550,2219
11457,3836090778,3352295704,1672567755,1672570970,3215
11447,3686211958,3778824229,1672611378,1672612445,1067
10604,3701448521,3791628263,1672680142,1672680464,322
10690,3277634944,3711287751,1672682101,1672684927,2826
10490,3714645218,3402105276,1672544261,1672544327,66
9970,3774090455,3358473096,1672694424,1672695497,1073
10064,3736036532,3511003541,1672695209,1672697909,2700
11652,3772882440,3311015817,1672561852,1672564672,2820
10066,3374552204,3354405535,1672553357,1672554508,1151
10404,3500456339,3550206045,1672630353,1672632983,2630
10512,3500927619,3791584994,1672672104,1672674352,2248
9802,3510819040,3894495222,1672642898,1672644558,1660
11747,3306491253,3516359146,1672662961,1672663394,433
10413,3757201138,3800434325,1672637089,1672639085,1996
10529,3393543588,3715261950,1672610378,1672613875,3497
10472,3774627091,3419378107,1672609119,1672612160,3041
10869,3715680249,3512490032,1672643921,1672646624,2703
10865,3714838100,3345896913,1672546422,1672547398,976
10956,3338115824,3915195160,1672695044,1672698269,3225
10792,3716733618,3409098014,1672553961,1672556587,2626
11460,3500922040,3305727497,1672651146,1672651615,469
11628,3463892928,3534604516,1672541770,1672543138,1368
10887,3292663993,3515974881,1672581807,1672582908,1101
10924,3501261089,3469370398,1672629074,1672631857,2783
11113,3453464785,3304661369,1672575952,1672578204,2252
11108,3487622510,3928421417,1672557609,1672559281,1672
11257,3807111856,3710819760,1672557550,1672557660,110
10050,3829698950,3886896755,1672647978,1672651477,3499
9815,3604569804,3713416106,1672576342,1672578644,2302
11444,3791716170,3757678397,1672651202,1672653512,2310
10681,3760096466,3703614781,1672682857,1672683552,695
10714,3332010532,3510919509,1672679519,1672680402,883
10012,3736056340,3520697518,1672610533,1672611518,985
11135,3703104365,3379400553,1672543383,1672543584,201
11456,3977157565,3703818358,1672537790,1672541116,3326
10701,3518088154,3701512498,1672600370,1672603252,2882
10746,3440582836,3335139032,1672698081,1672701494,3413
10903,3783238023,3478937459,1672541878,1672543892,2014
10256,3500833053,3895507040,1672679219,1672682533,3314
9960,3703725221,3802757611,1672653012,1672654468,1456
11405,3701655378,3298113026,1672683796,1672684854,1058
9806,3804840997,3626631210,1672686590,1672687439,849
11362,3465107990,3206926634,1672561220,1672561350,130
10326,3516815069,3511744756,1672584456,1672585057,601
11032,3305657559,3760525465,1672641967,1672642153,186
11621,3756890980,3756157377,1672603723,1672605804,2081
10011,3852014884,3430310785,1672651762,1672652738,976
10069,3517797610,3492728794,1672688173,1672688680,507
10665,3739297004,3434452046,1672538477,1672540309,1832
11007,3685877449,3811354125,1672651314,1672653741,2427
10709,3614944981,3533131937,1672661876,1672665288,3412
9865,3716389356,3501873139,1672600607,1672603923,3316
10314,3893932944,3238997746,1672631432,1672632760,1328
11439,3223144610,3603167427,1672542262,1672544203,1941
10647,3600842635,3791289855,1672672274,1672674828,2554
10907,3838119022,3783430498,1672655357,1672658784,3427
10990,3520697518,3226761201,1672631197,1672632667,1470
10726,3624872714,3514329209,1672658964,1672662325,3361
10211,3774325486,3701675183,1672601470,1672604886,3416
10089,3381254180,3755924094,1672600645,1672604027,3382
11388,3357026115,3510486220,1672669570,1672670876,1306
11063,3501992314,3973138649,1672658884,1672659359,475
10661,3760274119,3772943811,1672592041,1672594047,2006
10836,3774483862,3927202773,1672584017,1672586214,2197
11745,3519703964,3512495325,1672572801,1672575702,2901
11157,3534562354,3517530943,1672582791,1672585773,2982
10984,3778842400,3760024021,1672575507,1672575583,76
9822,3830291558,3776593726,1672618424,1672620259,1835
9998,3520012007,3713141087,1672624733,1672625795,1062
10968,3468871103,3440305508,1672626232,1672628429,2197
11622,3459694275,3898595916,1672557206,1672560803,3597
9925,3793003432,3229615214,1672665748,1672668490,2742
10990,3713416106,3445558740,1672556619,1672558047,1428
10680,3519065870,3660163550,1672645281,1672648542,3261
11231,3814672661,3519831322,1672548925,1672549152,227
10396,3780786276,3929002318,1672652845,1672655131,2286
9923,3715204544,3509167758,1672657241,1672658873,1632
9797,3533830748,3711854614,1672666882,1672668543,1661
10333,3403257752,3610723722,1672607481,1672609368,1887
10160,3510244209,3755075988,1672587256,1672588549,1293
9868,3793719515,3392010033,1672543430,1672544587,1157
11506,3236254381,3666367524,1672594698,1672597019,2321
10664,3500473064,3505887814,1672549016,1672551960,2944
10545,3516731917,3760382349,1672570437,1672571356,919
10280,3463729805,3793926338,1672599905,1672601800,1895
9944,3519730914,3714640103,1672555242,1672555549,307
10313,3509167758,3910020031,1672566890,1672570070,3180
11092,3551833298,3369810091,1672578893,1672579806,913
10978,3772966919,3774325486,1672666116,1672666831,715
11303,3713191326,3627431396,1672675141,1672678361,3220
11372,3463729805,3783176874,1672687830,1672690585,2755
10660,3703749690,3669475165,1672609741,1672611823,2082
9880,3306491253,3783313202,1672621377,1672623035,1658
10405,3827836825,3533960602,1672541646,1672544623,2977
10453,3713878219,3793689267,1672602193,1672605251,3058
10086,3245774173,3854957153,1672532091,1672533940,1849
10789,3481700413,3736987749,1672591866,1672593447,1581
9869,3511311554,3500234771,1672660253,1672663404,3151
10122,3500087325,3395565040,1672656772,1672658391,1619
11720,3713102459,3514564903,1672593846,1672595129,1283
11032,3387322545,3435715962,1672653882,1672654666,784
11425,3334824744,3780238637,1672655047,1672657201,2154
10263,3806471413,3500317923,1672582984,1672583303,319
10149,3513777705,3533841983,1672694746,1672697194,2448
9874,3510486220,3661856558,1672584606,1672586597,1991
11513,3774090455,3500799617,1672641311,1672642016,705
11585,3319585148,3715750580,1672564664,1672567368,2704
10925,3534459983,3711718368,1672558000,1672558983,983
10371,3808442442,3534204885,1672666070,1672667609,1539
10588,3387322545,3512871568,1672578957,1672581117,2160
9872,3519174861,3684651755,1672595102,1672598538,3436
11581,3666655293,3776407517,1672572765,1672574012,1247
10675,3533822490,3240622654,1672576480,1672579325,2845
10331,3773852157,3902357342,1672697910,1672699929,2019
10446,3713471446,3554437212,1672700079,1672700723,644
11168,3519465545,3680988889,1672608819,1672609401,582
10203,3288346356,3512784888,1672696263,1672699359,3096
11141,3773024346,3387413950,1672668361,1672669398,1037
9836,3688870751,3514941815,1672619259,1672620743,1484
11100,3760749218,3518368900,1672553680,1672554571,891
10798,3477951091,3777932225,1672665598,1672667891,2293
10196,3852014884,3434052463,1672599426,1672601376,1950
10177,3513293711,3311200541,1672557208,1672558324,1116
10390,3410602007,3515558215,1672681277,1672683306,2029
11182,3792824886,3480560014,1672690904,1672694078,3174
10602,3509828883,3886879696,1672676644,1672679227,2583
10984,3496352027,3500442370,1672575048,1672577195,2147
11407,3510694464,3534589501,1672674333,1672676793,2460
11463,3756897029,3245121919,1672658142,1672660083,1941
10607,3474074188,3516321993,1672686369,1672688543,2174
10766,3480259863,3855222429,1672666284,1672669631,3347
10075,3500726347,3552309108,1672549681,1672550815,1134
10039,3440770466,3510680251,1672556248,1672556996,748
10481,3514341451,3908331271,1672644959,1672646312,1353
11383,3756168814,3514107131,1672658798,1672659208,410
10272,3449233346,3703749690,1672533570,1672535545,1975
10106,3517426473,3780298499,1672607443,1672609197,1754
11182,3757549235,3501192566,1672676065,1672676249,184
11101,3372778334,3774326754,1672546877,1672548350,1473
10906,3413236071,3366433035,1672652570,1672654376,1806
10025,3316121649,3610806770,1672699622,1672702781,3159
11469,3385124073,3925208102,1672571793,1672572992,1199
11105,3783357035,3898595916,1672668893,1672671878,2985
11201,3660702754,3308744016,1672535854,1672538621,2767
9890,3711959141,3973582279,1672575059,1672577676,2617
10286,3500726347,3777932581,1672541778,1672544795,3017
10844,3513890046,3884180202,1672647823,1672649061,1238
10514,3291936679,3519102732,1672677371,1672679351,1980
11210,3500909455,3715111016,1672619712,1672622074,2362
10007,3714283424,3245245283,1672672084,1672672743,659
10268,3925098136,3793704155,1672617114,1672619739,2625
11015,3893629892,3533131937,1672532178,1672533045,867
11663,3518759318,3711171132,1672641553,1672643158,1605
10538,3793704155,3686853863,1672563735,1672564959,1224
10632,3732128078,3711836873,1672580898,1672582408,1510
10517,3824135033,3887382548,1672696263,1672697100,837
10485,3511245705,3221736756,1672585449,1672586351,902
9899,3665431349,3284829602,1672592497,1672592674,177
10524,3291936679,3330466913,1672611742,1672613700,1958
9912,3387388336,3902023467,1672695560,1672695640,80
11327,3311774510,3505010941,1672585789,1672588246,2457
11726,3902548260,3835599049,1672660556,1672664080,3524
10127,3517617472,3777498160,1672590265,1672592702,2437
10263,3669140241,3515803462,1672629230,1672632227,2997
10634,3755286041,3418791124,1672658879,1672660921,2042
10035,3432762943,3514673213,1672614830,1672616088,1258
9913,3803473387,3559754304,1672673291,1672673508,217
11569,3426207439,3272096922,1672692259,1672694374,2115
10309,3359012188,3318056480,1672645095,1672648289,3194
9892,3770530739,3291446384,1672537164,1672539410,2246
11336,3971447562,3505853594,1672577624,1672580778,3154
11367,3760776967,3382757142,1672560449,1672560945,496
10714,3760748418,3306491253,1672593414,1672595042,1628
9987,3516655509,3456795601,1672632986,1672635373,2387
10028,3881579907,3923133978,1672627257,1672630320,3063
10854,3915652382,3294821709,1672640952,1672642598,1646
11572,3791841318,3777112124,1672657953,1672658401,448
11524,3455430943,3716371766,1672572600,1672574220,1620
11273,3287689454,3510775046,1672667594,1672670071,2477
10438,3972847837,3519167605,1672555222,1672555533,311
10250,3939882169,3520553959,1672656259,1672657883,1624
10136,3201502111,3716669659,1672552079,1672553995,1916
10232,3715602742,3773636983,1672646648,1672646977,329
9980,3906874577,3311200541,1672573944,1672575447,1503
10375,3756168814,3353335252,1672585796,1672587767,1971
11078,3923524564,3316537706,1672668964,1672669390,426
10215,3924583142,3209075485,1672702981,1672704903,1922
10164,3534081527,3290097447,1672683829,1672684485,656
10550,3520860199,3454554552,1672643817,1672644459,642
10664,3227339675,3239990061,1672622044,1672623232,1188
10683,3755769254,3517045396,1672547374,1672548925,1551
11630,3517960157,3911821258,1672558183,1672559709,1526
10210,3515715968,3534589501,1672664076,1672665272,1196
10875,3772114731,3516904926,1672541178,1672542444,1266
10963,3779312237,3855077502,1672624176,1672626817,2641
10619,3306066522,3770671714,1672567544,1672569703,2159
11443,3915652382,3350966326,1672650182,1672651926,1744
11643,3473520701,3701725839,1672678876,1672682312,3436
10994,3534068874,3757607649,1672629294,1672631854,2560
11295,3201634072,3488988274,1672640399,1672643504,3105
10802,3350631472,3738760498,1672627551,1672629649,2098
9824,3757924067,3783942518,1672619287,1672619832,545
11187,3906693728,3289258397,1672678070,1672679598,1528
11008,3685083275,3774702364,1672537283,1672537477,194
11546,3515100211,3613703906,1672597810,1672600586,2776
11274,3977666815,3715419141,1672665658,1672668137,2479
10999,3337903727,3395615598,1672570764,1672573880,3116
11338,3436099135,3206262649,1672669140,1672669755,615
10269,3516429380,3713807753,1672680500,1672682688,2188
10732,3757513651,3534531061,1672582582,1672583455,873
9997,3430032005,3899756737,1672590673,1672592727,2054
11100,3760232135,3555763674,1672545066,1672547693,2627
10120,3668720465,3520395850,1672680082,1672682877,2795
10095,3783021859,3760420315,1672547365,1672548489,1124
11716,3756897029,3834311054,1672596460,1672596724,264
10307,3485151614,3513140146,1672694199,1672695513,1314
11139,3304028109,3510240661,1672612106,1672612917,811
11244,3715101177,3756493561,1672571688,1672573318,1630
10847,3500057674,3384001094,1672692239,1672693281,1042
10703,3780435349,3385124073,1672600185,1672602181,1996
9861,3445406685,3711755596,1672639142,1672639528,386
11578,3501115299,3972196462,1672667690,1672669744,2054
10239,3733836732,3300810210,1672593279,1672593503,224
10727,3850108828,3755286041,1672669439,1672671338,1899
11438,3715291931,3756717136,1672703677,1672706872,3195
11038,3244395841,3553229537,1672562644,1672566113,3469
11465,3757446082,3511078598,1672689811,1672693269,3458
10876,3715566511,3778561231,1672629896,1672631819,1923
11463,3371132167,3501657158,1672582851,1672583156,305
10206,3466492108,3772968080,1672582436,1672583434,998
10427,3710515351,3421956717,1672693137,1672695755,2618
11625,3416079461,3701350519,1672540277,1672543754,3477
10818,3446066492,3710082615,1672676656,1672676728,72
11402,3892177203,3483078667,1672613632,1672616699,3067
11581,3279731391,3387989658,1672678019,1672680306,2287
11386,3512857020,3430296808,1672628287,1672629614,1327
10668,3710783759,3853386575,1672612004,1672615491,3487
9887,3714897456,3756843139,1672631452,1672631550,98
11110,3783043346,3358675021,1672646348,1672649902,3554
11069,3714690161,3755849241,1672631673,1672632702,1029
9923,3715881104,3424997707,1672698066,1672700091,2025
10935,3792987243,3291153514,1672533367,1672536311,2944
11122,3401215739,3603740088,1672535936,1672537541,1605
11215,3715590997,3501759031,1672621014,1672622496,1482
9951,3220660616,3710147457,1672540930,1672541147,217
11300,3776122272,3772708314,1672655614,1672655769,155
11110,3491250381,3934991640,1672629114,1672630922,1808
10122,3808849597,3374147279,1672543996,1672547578,3582
11425,3341129425,3713514933,1672606204,1672608005,1801
11627,3434452046,3396472026,1672576729,1672577002,273
10381,3304672737,3808849597,1672688399,1672689667,1268
11100,3932491622,3519937708,1672597002,1672597215,213
11136,3714281795,3227647190,1672607930,1672609158,1228
9842,3366566029,3471507117,1672532706,1672533133,427
11573,3916673751,3385416697,1672557916,1672560003,2087
10958,3710783759,3505502819,1672610901,1672612939,2038
11514,3395069149,3534941710,1672548589,1672550157,1568
10394,3605591994,3501174621,1672544508,1672544642,134
11393,3713805968,3669140241,1672658581,1672658988,407
11297,3465227623,3662354016,1672698182,1672698774,592
10965,3835262447,3778986795,1672605150,1672606501,1351
10002,3516792348,3430399931,1672597068,1672598096,1028
11524,3514508773,3627358016,1672595802,1672598149,2347
9868,3713224986,3375324190,1672616423,1672617254,831
10164,3778819352,3609335008,1672630495,1672630897,402
11660,3716891903,3511364193,1672632663,1672634596,1933
10178,3922480066,3520016705,1672596037,1672596858,821
10141,3809207482,3774090455,1672623684,1672623892,208
10349,3203172170,3756991235,1672661325,1672664821,3496
10152,3208894215,3858330969,1672687132,1672688908,1776
11141,3713807459,3783095041,1672692202,1672695011,2809
10807,3500785888,3300238532,1672561476,1672564839,3363
10183,3514685272,3711119575,1672680763,1672684119,3356
10140,3285587972,3773770134,1672664461,1672665804,1343
11778,3510206323,3423353911,1672569385,1672570423,1038
11375,3971447562,3938059867,1672652020,1672654570,2550
9865,3514628916,3555378248,1672593720,1672595652,1932
11298,3713611960,3783373085,1672642002,1672644616,2614
10435,3793920312,3301369282,1672696084,1672697120,1036
10549,3513629502,3701865589,1672544496,1672545237,741
11478,3832312129,3971280379,1672635956,1672637184,1228
11179,3555378248,3770019143,1672661471,1672664115,2644
11121,3774506868,3517380144,1672594352,1672596134,1782
11132,3713373455,3203954795,1672576758,1672576826,68
10784,3629869834,3511476353,1672697636,1672700493,2857
10370,3776732532,3783826338,1672606543,1672608814,2271
10221,3455907179,3519947298,1672594217,1672596699,2482
10583,3370961012,3780238637,1672675784,1672679215,3431
11476,3714312797,3970775805,1672542070,1672545167,3097
10581,3760648750,3970775805,1672693520,1672694277,757
11110,3791351852,3468871103,1672598376,1672600517,2141
9935,3816184951,3760966645,1672642333,1672644230,1897
11764,3777149336,3756850160,1672569142,1672571745,2603
10220,3710891331,3809860102,1672590980,1672593111,2131
11020,3604569804,3311449914,1672562964,1672565506,2542
11068,3429315500,3488988274,1672597558,1672598124,566
11269,3757713457,3437934509,1672565319,1672566145,826
11162,3519322066,3760537855,1672657074,1672657965,891
11058,3792475476,3344710271,1672571332,1672572059,727
11334,3779706467,3778604070,1672642049,1672644738,2689
11789,3519351747,3511003541,1672662262,1672664730,2468
10011,3362368123,3517325365,1672671364,1672672476,1112
10967,3371759126,3520362238,1672655352,1672656517,1165
11102,3609335008,3475090917,1672533239,1672534971,1732
10503,3505331083,3791074200,1672636965,1672637519,554
10166,3701377471,3512417028,1672619854,1672620385,531
11148,3516444589,3669140241,1672681949,1672685351,3402
10480,3299587876,3909399636,1672622260,1672625480,3220
10341,3814378625,3681701931,1672606942,1672608292,1350
10115,3713694278,3516586325,1672571200,1672573516,2316
9951,3474074188,3774355339,1672654916,1672655488,572
11356,3825153408,3913847876,1672642440,1672644916,2476
11185,3555763674,3777405860,1672667364,1672670755,3391
10944,3511969443,3283847934,1672701186,1672703099,1913
10614,3811419378,3735838864,1672639744,1672640424,680
10693,3739395381,3512343029,1672652747,1672655008,2261
11398,3622654885,3977360666,1672590957,1672593892,2935
11089,3509274030,3422081502,1672647119,1672648140,1021
11348,3443041059,3715008501,1672679804,1672682808,3004
11536,3487622510,3277061226,1672578540,1672581063,2523
10546,3394364348,3533131937,1672692758,1672693676,918
10102,3777686966,3816184951,1672621209,1672621575,366
10194,3275171954,3627358016,1672692573,1672694471,1898
11135,3480418192,3500833053,1672687899,1672691345,3446
11645,3829358750,3387971464,1672695728,1672696798,1070
10289,3735152111,3852992961,1672587064,1672587896,832
11544,3713969196,3837887478,1672673541,1672674735,1194
10602,3520926977,3489340327,1672698230,1672698533,303
10434,3713471446,3713920790,1672681629,1672681698,69
10411,3307454562,3852992961,1672557872,1672561363,3491
9862,3755922811,3439045964,1672620734,1672624312,3578
11465,3664523809,3737685967,1672631202,1672633884,2682
10076,3511341866,3505901826,1672648019,1672651335,3316
11546,3970775805,3467232654,1672626404,1672629406,3002
10252,3517325365,3500630465,1672645769,1672646645,876
10057,3791905743,3896123242,1672558273,1672559232,959
11555,3755790149,3451757423,1672633058,1672636260,3202
10957,3500734346,3307521389,1672614020,1672614905,885
11065,3715101177,3812756400,1672673630,1672675995,2365
10141,3668681400,3885545415,1672575362,1672578299,2937
10610,3307521389,3830771832,1672698753,1672702133,3380
10002,3899756737,3400560073,1672568704,1672572056,3352
10410,3496407500,3533209168,1672549062,1672550295,1233
10938,3804095239,3716195780,1672607090,1672610582,3492
11324,3273674596,3402105276,1672627498,1672629533,2035
11120,3487395357,3514801709,1672574862,1672575961,1099
11391,3617771673,3701127475,1672577166,1672577987,821
10473,3791548838,3311409212,1672563898,1672567130,3232
9800,3505245692,3896200048,1672665180,1672665554,374
11365,3668681400,3858429342,1672568068,1672568152,84
10042,3805704844,3375324190,1672600579,1672601458,879
10672,3281148858,3711870537,1672588361,1672589572,1211
11290,3711287751,3890211161,1672571851,1672572565,714
10457,3359929534,3511466117,1672700600,1672703149,2549
9976,3421956717,3851877325,1672557963,1672561519,3556
11423,3760776967,3441840658,1672560834,1672560983,149
9942,3206241691,3855977674,1672595384,1672596639,1255
10513,3452982957,3510801769,1672666530,1672667884,1354
10571,3732846295,3500062408,1672651571,1672655071,3500
10029,3444453261,3533017131,1672538800,1672539624,824
10328,3517377614,3685083275,1672650639,1672652538,1899
11267,3520860199,3518947256,1672687637,1672691010,3373
11652,3906874577,3715196780,1672639278,1672642366,3088
10113,3390537737,3933872044,1672613889,1672614864,975
11274,3365839890,3334824744,1672634313,1672634672,359
11098,3791332061,3710680073,1672702557,1672703828,1271
11750,3357097510,3510291656,1672670854,1672673535,2681
11213,3295710494,3510819040,1672595548,1672597608,2060
11407,3703423962,3511296895,1672568594,1672569815,1221
11497,3776182849,3711518637,1672549000,1672550326,1326
9994,3500793739,3773853619,1672541547,1672543397,1850
9822,3239779992,3774627091,1672627879,1672631392,3513
11753,3335139032,3501171785,1672575850,1672578135,2285
10040,3500087325,3800434325,1672534272,1672536970,2698
10111,3837378340,3780482864,1672555809,1672556259,450
11403,3514747345,3701377471,1672691495,1672691736,241
11639,3857344874,3397783490,1672630749,1672631508,759
11531,3778695895,3616242727,1672670765,1672674153,3388
10019,3509297453,3902775449,1672593067,1672596509,3442
10893,3779340538,3517617472,1672665570,1672667496,1926
11078,3333505404,3757199889,1672542043,1672543577,1534
9985,3517325365,3517652011,1672667285,1672670771,3486
10719,3667072319,3884458862,1672540813,1672541824,1011
11138,3791205793,3500096103,1672625746,1672629067,3321
10475,3774539067,3387706541,1672656842,1672657747,905
10147,3779723939,3777909822,1672637847,1672639920,2073
10204,3203876438,3701493094,1672681596,1672685044,3448
11048,3686081254,3884394685,1672670083,1672670936,853
10336,3778706119,3511003541,1672627580,1672630906,3326
11518,3239401337,3520473111,1672594101,1672595367,1266
10578,3703722212,3519754667,1672533828,1672535776,1948
10693,3361711720,3735056027,1672596639,1672600223,3584
11335,3416105769,3445172440,1672575909,1672577092,1183
10513,3516706935,3509317776,1672536067,1672536239,172
9969,3886957097,3791542842,1672645946,1672647760,1814
11133,3715441786,3500909455,1672600553,1672601032,479
10824,3312800145,3780563627,1672689650,1672691076,1426
11330,3772648837,3511608609,1672608893,1672609934,1041
10135,3515607283,3447938130,1672593572,1672597144,3572
9949,3738429905,3733915784,1672596636,1672599780,3144
10004,3505709407,3430310785,1672569768,1672572153,2385
11762,3783430498,3307216611,1672597691,1672599226,1535
9830,3703462221,3201634072,1672700040,1672702647,2607
10182,3899756737,3393502004,1672620650,1672623223,2573
11736,3772019557,3369108286,1672630750,1672632019,1269
10342,3902357342,3715008501,1672698457,1672700733,2276
11544,3469350379,3550206045,1672615462,1672618154,2692
10132,3760322661,3432466467,1672658308,1672659431,1123
10707,3757607649,3228465044,1672558286,1672558777,491
9796,3387322545,3755736024,1672597287,1672597430,143
11163,3791072829,3777928067,1672607235,1672610626,3391
11091,3279731391,3916924978,1672549695,1672549901,206
10748,3619676231,3773714494,1672546928,1672550365,3437
9933,3519015940,3779561601,1672646199,1672648799,2600
11371,3380357490,3500994763,1672553240,1672553856,616
11190,3500073824,3711810752,1672680905,1672683820,2915
10120,3756363182,3620836520,1672635830,1672638334,2504
11062,3516454693,3774236212,1672655344,1672657065,1721
11191,3501244753,3516585063,1672559826,1672561881,2055
11505,3445355677,3235578121,1672676897,1672678612,1715
10100,3516535558,3791509334,1672554197,1672555861,1664
10601,3774652449,3512480125,1672684026,1672686047,2021
10960,3776583229,3373135211,1672612778,1672614083,1305
10387,3287760230,3780500764,1672675034,1672677405,2371
11213,3757549235,3616403486,1672610137,1672611708,1571
11281,3777931341,3776901443,1672662586,1672664102,1516
10066,3500994763,3533113740,1672568001,1672570716,2715
10908,3772877723,3500734346,1672531741,1672534500,2759
11507,3856147380,3776950532,1672565166,1672565697,531
11452,3348343425,3470962222,1672702608,1672704406,1798
10215,3791664049,3455955489,1672552641,1672553707,1066
10068,3534111498,3509274030,1672615737,1672618304,2567
9836,3371238318,3773411968,1672610742,1672613979,3237
9987,3757128722,3514853709,1672699314,1672700535,1221
10070,3519255644,3755769731,1672601160,1672602336,1176
9847,3311432176,3755630085,1672577925,1672578166,241
11090,3226913558,3779130507,1672702266,1672702559,293
11444,3513629502,3505825767,1672696908,1672699371,2463
10962,3780224882,3203876438,1672579655,1672582042,2387
10351,3500579482,3393502004,1672618924,1672619646,722
11402,3555763674,3780127017,1672552898,1672555141,2243
9802,3777498160,3710861700,1672621231,1672624631,3400
11768,3780142207,3770018912,1672695418,1672697009,1591
11517,3289771213,3839308659,1672700440,1672703301,2861
10831,3551833298,3757623259,1672537427,1672538538,1111
9950,3615447269,3516819320,1672648651,1672648959,308
9932,3347996015,3899294071,1672553029,1672554668,1639
11546,3922153821,3512681214,1672537112,1672538153,1041
10934,3756066702,3509912164,1672570301,1672572546,2245
10083,3713805968,3480270940,1672642967,1672644844,1877
10287,3714101349,3470962222,1672559128,1672559284,156
11053,3974400577,3559125467,1672543830,1672543974,144
11468,3756428507,3559123082,1672582063,1672584475,2412
11717,3780294116,3509614126,1672635730,1672635818,88
10979,3505416534,3520926977,1672584901,1672588083,3182
11185,3512504247,3519724388,1672582301,1672582497,196
10661,3514926921,3510750299,1672564935,1672566938,2003
10225,3473562779,3500456339,1672681850,1672684794,2944
11189,3505472087,3414510793,1672581305,1672581702,397
11079,3375906394,3444168914,1672556394,1672557759,1365
11412,3517325365,3793719515,1672596268,1672598320,2052
10486,3395610742,3755729826,1672579997,1672580072,75
10402,3403988682,3499142934,1672584436,1672586558,2122
11402,3499142934,3487779363,1672637338,1672640690,3352
10174,3757855416,3938398160,1672608335,1672609737,1402
11355,3755394177,3701779683,1672653449,1672656902,3453
10123,3756157377,3711836873,1672596384,1672598167,1783
11549,3883640904,3378172464,1672639006,1672640175,1169
10165,3501548163,3492728794,1672549992,1672550885,893
10520,3760080378,3857909328,1672638256,1672641553,3297
11585,3780129338,3488931357,1672680372,1672680663,291
9961,3534624672,3779503296,1672555760,1672557359,1599
10142,3703999217,3716463756,1672575544,1672577935,2391
11046,3908550561,3480405740,1672636161,1672637248,1087
11700,3304661369,3519055736,1672569894,1672572729,2835
10601,3285322570,3855629383,1672554433,1672556287,1854
9926,3406390503,3461137945,1672598420,1672601044,2624
10214,3773688906,3792824886,1672605630,1672608553,2923
11105,3235373942,3826068495,1672667912,1672668460,548
11203,3501174621,3779748270,1672591859,1672593064,1205
9946,3453464785,3505010941,1672636823,1672639058,2235
11246,3715724166,3397972945,1672552141,1672553683,1542
11706,3858429342,3755119166,1672698363,1672700319,1956
10822,3500234771,3618024815,1672586199,1672589030,2831
9809,3350966326,3770780655,1672669091,1672671012,1921
11230,3275661834,3509379617,1672608827,1672612128,3301
11786,3418382025,3534531039,1672589295,1672591511,2216
11387,3414387263,3519780867,1672610015,1672610393,378
11449,3393001196,3298831109,1672562335,1672565794,3459
11564,3379400553,3666561358,1672643905,1672645703,1798
10801,3511864772,3715101177,1672587492,1672589470,1978
10809,3512492332,3396453219,1672539579,1672541583,2004
9931,3783594729,3465107990,1672698419,1672699764,1345
9911,3713191326,3330466913,1672641047,1672644613,3566
10076,3517902505,3514761434,1672566985,1672569860,2875
10624,3313579674,3209075485,1672578955,1672580434,1479
10128,3447554599,3929923442,1672574369,1672574688,319
10920,3352374868,3756536476,1672558325,1672558670,345
11662,3519494023,3380418745,1672540433,1672541158,725
11217,3380167818,3774238066,1672648965,1672650655,1690
10920,3515838621,3902300755,1672602925,1672605311,2386
10253,3971051020,3534459983,1672688953,1672692002,3049
10573,3397972945,3857609616,1672556855,1672559112,2257
10379,3714065165,3779706467,1672537255,1672538760,1505
10372,3310961923,3773041843,1672615686,1672618484,2798
10500,3357074700,3509445318,1672654771,1672656836,2065
10813,3305656670,3710813103,1672626557,1672629175,2618
11640,3774238066,3303432071,1672593750,1672594235,485
11238,3774090455,3444680955,1672591678,1672593394,1716
10876,3500688476,3342545285,1672629999,1672631723,1724
11327,3515577866,3905889514,1672618642,1672621166,2524
11140,3205324639,3500889287,1672692169,1672693570,1401
11302,3485898181,3770764940,1672540629,1672541823,1194
10730,3438818153,3396453219,1672560155,1672562876,2721
10957,3703502114,3514341451,1672551543,1672552154,611
10956,3760776967,3880000841,1672593495,1672594659,1164
10371,3884934977,3317190427,1672590696,1672594152,3456
11696,3447948483,3331228758,1672678948,1672680400,1452
10480,3520049965,3313282478,1672703792,1672704786,994
11051,3201920708,3533225084,1672685178,1672687235,2057
10038,3333355914,3311045951,1672571002,1672571745,743
10094,3639465750,3390368796,1672540003,1672540104,101
10476,3520725149,3772966919,1672603356,1672603866,510
10972,3409514897,3755374000,1672639829,1672643023,3194
11506,3500968729,3520016705,1672593210,1672595731,2521
11097,3358211034,3439651226,1672605292,1672606809,1517
11443,3756363182,3713416106,1672599630,1672602958,3328
10567,3779930476,3519034304,1672640959,1672641787,828
10756,3715602742,3393502004,1672584985,1672586265,1280
11764,3402338011,3710865678,1672582372,1672583592,1220
10580,3713107380,3852161626,1672590746,1672593788,3042
10281,3500741005,3804707712,1672619154,1672619557,403
9931,3776968640,3609925909,1672541811,1672543320,1509
11662,3891586951,3517558635,1672618654,1672619729,1075
11153,3777767907,3778695017,1672636050,1672639299,3249
9823,3716233100,3631444265,1672617494,1672619032,1538
11169,3756759239,3282240901,1672635875,1672638447,2572
9985,3492728794,3311805161,1672648684,1672648885,201
11170,3500741534,3703481882,1672539904,1672541750,1846
10124,3715844082,3452175941,1672596892,1672598181,1289
10583,3711119575,3603452936,1672610462,1672610536,74
10164,3333355914,3756890980,1672619505,1672620468,963
10300,3364683368,3668154066,1672680985,1672681904,919
10955,3512555384,3341311972,1672578339,1672581181,2842
11570,3755175497,3500974385,1672625231,1672628581,3350
11148,3415840750,3501980730,1672689340,1672691933,2593
11435,3364067937,3772131127,1672588367,1672589905,1538
11324,3463883997,3233965781,1672612080,1672614753,2673
10139,3906693728,3664478769,1672567351,1672569091,1740
11312,3422460919,3760679372,1672618183,1672619231,1048
10939,3756437169,3733796228,1672579740,1672580126,386
11168,3519513219,3435342362,1672670036,1672672527,2491
11228,3813276198,3510206323,1672567363,1672568414,1051
11429,3772980989,3780467276,1672550260,1672551721,1461
9925,3454924050,3466620548,1672671086,1672674625,3539
9869,3897500723,3791758175,1672624984,1672627644,2660
10761,3776407517,3780050328,1672573892,1672576548,2656
10659,3520553959,3472774606,1672640793,1672642854,2061
11193,3278805844,3514737648,1672565765,1672568413,2648
11596,3518995270,3520832066,1672687703,1672690786,3083
10797,3336501403,3533929043,1672636869,1672640359,3490
10975,3360525513,3300810210,1672693907,1672695875,1968
10586,3311197635,3469350379,1672687583,1672690524,2941
11710,3512087090,3382696725,1672576508,1672577649,1141
10561,3481365330,3777569538,1672633058,1672636367,3309
9812,3227339675,3515405509,1672664434,1672664538,104
9844,3239779992,3834456158,1672682848,1672683949,1101
11442,3555764822,3520395850,1672617723,1672619784,2061
10817,3662354016,3792455305,1672652557,1672652977,420
11325,3206241691,3557528150,1672598648,1672600592,1944
11632,3894495222,3427049290,1672687289,1672690308,3019
11154,3977209952,3779561601,1672575049,1672577267,2218
11266,3894328297,3835262447,1672674361,1672676771,2410
11181,3701493094,3913746581,1672628592,1672629001,409
10239,3362706073,3756345026,1672588005,1672590671,2666
10659,3509252934,3365839890,1672578497,1672580570,2073
10829,3364286028,3701663839,1672567242,1672567767,525
10809,3505786561,3777751979,1672666102,1672668214,2112
11008,3710046567,3488988274,1672642161,1672644581,2420
10713,3505684690,3715261950,1672581556,1672582628,1072
11089,3519341916,3738734246,1672536876,1672537994,1118
9873,3936486724,3770631449,1672668749,1672669393,644
9917,3357496255,3511382748,1672617403,1672617803,400
9799,3311414429,3311409212,1672638873,1672639705,832
9936,3757311529,3714264759,1672610684,1672613062,2378
10421,3613781977,3491104534,1672605918,1672608395,2477
11760,3207497598,3500595432,1672692922,1672693866,944
11192,3883640454,3682906048,1672539820,1672540514,694
10775,3514564903,3534624672,1672650670,1672653716,3046
9858,3272096922,3333355914,1672577839,1672580357,2518
10197,3905358065,3914947393,1672695619,1672697066,1447
11134,3774195369,3512477276,1672621090,1672623391,2301
9829,3223177147,3205948776,1672648709,1672650425,1716
11754,3780563627,3660246433,1672643779,1672646178,2399
11630,3228465044,3614944981,1672675346,1672677657,2311
10609,3415803494,3500105301,1672635978,1672636533,555
11491,3834980281,3391854325,1672559212,1672562274,3062
10048,3893629892,3701978422,1672597900,1672598307,407
10348,3500863429,3792455305,1672692430,1672695019,2589
10091,3201634072,3439283360,1672660413,1672663516,3103
10611,3780563627,3893527651,1672571501,1672574727,3226
11210,3467415939,3713416106,1672574213,1672577408,3195
9838,3774450494,3228033254,1672695292,1672695418,126
11220,3791435852,3701978422,1672650208,1672652842,2634
9947,3273771395,3791332226,1672601001,1672601557,556
11781,3716160006,3500031401,1672567029,1672567501,472
9949,3772282008,3792578118,1672667556,1672668892,1336
9821,3200785194,3510882576,1672638447,1672641415,2968
10483,3703438617,3519494023,1672667846,1672668015,169
11569,3757732853,3317989975,1672575368,1672578900,3532
10141,3757924067,3509445318,1672673339,1672674035,696
11133,3756493561,3533009565,1672605924,1672608945,3021
10868,3360837082,3235470567,1672542879,1672544361,1482
10903,3452024572,3755688231,1672694727,1672697775,3048
10259,3738760498,3779160052,1672615447,1672616779,1332
11588,3817120976,3512490032,1672574852,1672575108,256
10262,3628423403,3500073824,1672607498,1672608308,810
11506,3894328297,3756525103,1672672540,1672675527,2987
11713,3970851830,3392573386,1672548192,1672549943,1751
11615,3478455812,3633860380,1672656130,1672658949,2819
11142,3825082811,3621591266,1672582059,1672583581,1522
10198,3783939161,3737745988,1672642776,1672644537,1761
10857,3274341934,3380444321,1672647165,1672647385,220
10165,3511908639,3772169046,1672580309,1672581347,1038
10441,3713878219,3621960662,1672600957,1672602041,1084
11240,3776249160,3501574882,1672602009,1672605470,3461
10343,3499622352,3776125503,1672572670,1672575342,2672
11280,3490953301,3509252934,1672650275,1672651055,780
10623,3510781595,3476144563,1672683379,1672686759,3380
11039,3380418745,3623512088,1672552436,1672555160,2724
10602,3923910914,3231271498,1672612298,1672614137,1839
10607,3363549860,3933731871,1672599434,1672600737,1303
11276,3715881104,3281935691,1672595925,1672597695,1770
11758,3780466967,3476308535,1672545369,1672545676,307
10792,3517718901,3792008302,1672615798,1672617119,1321
10750,3440671139,3685522474,1672700738,1672702713,1975
11232,3689420679,3509651954,1672678142,1672678388,246
10231,3273242177,3855077502,1672626809,1672628077,1268
10279,3898965585,3443004958,1672554165,1672554830,665
9812,3933562725,3307454562,1672534188,1672535372,1184
10468,3336501403,3301332095,1672598742,1672602232,3490
11782,3519015940,3207586072,1672659283,1672659966,683
10539,3450503086,3514560138,1672594621,1672595337,716
11196,3201502111,3897851509,1672626622,1672627930,1308
10513,3792497486,3440582836,1672675037,1672676934,1897
11112,3976225898,3970851830,1672637511,1672638393,882
11747,3519102732,3559619861,1672607405,1672607927,522
10300,3311924005,3343193067,1672598394,1672599739,1345
10460,3757823215,3509503263,1672593356,1672595370,2014
11704,3249771731,3714919471,1672651475,1672654170,2695
10368,3505531432,3302929858,1672559097,1672561175,2078
10554,3792972270,3505245692,1672683673,1672683910,237
10496,3772114731,3515047288,1672593001,1672593586,585
10088,3370961012,3387971464,1672593024,1672593588,564
10796,3512087090,3515470462,1672573683,1672574090,407
10052,3779160052,3778318250,1672575236,1672576971,1735
10726,3791224239,3413799143,1672562808,1672564181,1373
9845,3287734830,3227059650,1672559443,1672562212,2769
10896,3200320674,3352044245,1672644103,1672645726,1623
11491,3485151614,3225554956,1672695915,1672696035,120
11558,3441840658,3220660616,1672682476,1672682541,65
10777,3715291931,3927202773,1672703345,1672705931,2586
9889,3333355914,3778986795,1672541877,1672543003,1126
10943,3773603836,3351728355,1672540905,1672541546,641
9999,3813111107,3888903181,1672655492,1672656830,1338
10346,3756761603,3910354786,1672573330,1672576460,3130
11168,3615447269,3776732532,1672627373,1672628236,863
10223,3760776967,3826997668,1672633894,1672634976,1082
10658,3207497598,3856316719,1672695008,1672697367,2359
10336,3493047640,3938129916,1672595922,1672597357,1435
10458,3234445133,3839744168,1672607637,1672610084,2447
11015,3500031401,3330238204,1672557894,1672559645,1751
10175,3519435459,3933106901,1672540582,1672542887,2305
10680,3224040894,3304661369,1672699548,1672700915,1367
11671,3713740434,3514515499,1672554728,1672558150,3422
10136,3773848111,3312733562,1672702622,1672704714,2092
11611,3777729184,3516777819,1672695070,1672697665,2595
11038,3435037864,3774652449,1672703841,1672706756,2915
11775,3235313062,3226037966,1672583070,1672585039,1969
10233,3380357490,3971996397,1672587560,1672590963,3403
11314,3774109138,3780626668,1672638881,1672640245,1364
11699,3488333295,3559759778,1672672337,1672673378,1041
10735,3716669659,3513384042,1672642862,1672643999,1137
11081,3385481989,3514761434,1672621498,1672624947,3449
9890,3715419141,3516668203,1672544511,1672545990,1479
11688,3505183641,3914947393,1672680831,1672682094,1263
10934,3971447562,3519108639,1672660579,1672662951,2372
11276,3497904539,3500178849,1672676058,1672679445,3387
11685,3755767856,3516904926,1672703274,1672705391,2117
10780,3513111053,3978417055,1672598399,1672598651,252
11403,3773024346,3511286390,1672658268,1672660759,2491
10760,3533566754,3249614888,1672608969,1672609857,888
11631,3534812391,3774589551,1672688644,1672691455,2811
11272,3419648004,3684651755,1672635748,1672636132,384
9965,3703896751,3665431349,1672612289,1672614411,2122
11446,3777992576,3505980138,1672571461,1672574954,3493
10502,3772683155,3311515179,1672560288,1672563374,3086
10737,3827981800,3832333115,1672668947,1672671038,2091
10158,3609166109,3443004958,1672656056,1672659561,3505
10895,3311188620,3533816813,1672654220,1672656319,2099
10891,3895507040,3559112196,1672582537,1672583746,1209
11005,3927181190,3832333115,1672607563,1672610339,2776
11094,3793874490,3806720019,1672640188,1672640832,644
10142,3317190427,3517816581,1672679262,1672680571,1309
11755,3533009565,3770780655,1672584032,1672586191,2159
11697,3438470128,3777149336,1672538706,1672541492,2786
9975,3368176107,3304661369,1672568115,1672570113,1998
10320,3970265139,3920890008,1672575740,1672578781,3041
10339,3780423516,3856601074,1672606081,1672606411,330
9943,3666655293,3358434853,1672563940,1672566616,2676
11123,3309178914,3228218081,1672614367,1672617045,2678
10928,3223512565,3412605548,1672671338,1672673131,1793
9843,3240683148,3447554599,1672691853,1672692856,1003
10547,3240443426,3500785888,1672664049,1672664440,391
10822,3791825536,3884180202,1672702073,1672705034,2961
9847,3714179543,3358675021,1672608094,1672608574,480
11085,3517227599,3510484107,1672629437,1672630177,740
10448,3738734246,3851810349,1672542212,1672542313,101
11725,3770574826,3776001441,1672695733,1672696639,906
9944,3770276815,3733730342,1672630836,1672632683,1847
10555,3773736248,3557653200,1672695393,1672697386,1993
11270,3686860179,3505314920,1672625934,1672626807,873
10538,3830291558,3408408584,1672669490,1672671701,2211
11509,3311305760,3773523569,1672686376,1672689632,3256
11730,3342031426,3701127475,1672537133,1672538995,1862
11209,3776166086,3818532143,1672642859,1672644075,1216
11118,3515944817,3393955069,1672614588,1672615409,821
10579,3805704844,3505416534,1672555481,1672558375,2894
11416,3416105769,3791574640,1672561490,1672564156,2666
9956,3770780655,3305093237,1672606845,1672607135,290
11091,3311521176,3364302157,1672702693,1672703530,837
10666,3756363182,3936486724,1672668272,1672670232,1960
11031,3773523569,3293898029,1672653939,1672655677,1738
10977,3301431129,3792455305,1672649546,1672650734,1188
9805,3618895679,3973582279,1672658576,1672661135,2559
10554,3512492332,3467232654,1672672731,1672673985,1254
11757,3509073025,3773826624,1672594330,1672596515,2185
11276,3810584695,3713954144,1672680371,1672680574,203
10063,3801379377,3760529327,1672565471,1672568233,2762
10531,3473562779,3711862792,1672601024,1672604469,3445
10342,3510638085,3850904092,1672630695,1672634291,3596
11637,3514450836,3703624327,1672541887,1672543854,1967
11360,3512306195,3374195945,1672548529,1672550220,1691
9935,3505491969,3500591274,1672697813,1672701387,3574
10206,3730290851,3371759044,1672546283,1672547224,941
11764,3510694464,3414510793,1672606204,1672607044,840
10146,3517448452,3933562725,1672574133,1672576746,2613
10897,3713285095,3371238318,1672549940,1672552298,2358
11149,3304030474,3736941123,1672555401,1672556139,738
10076,3468066881,3465690527,1672627715,1672628919,1204
10091,3505190512,3880637958,1672552220,1672553809,1589
10578,3394959062,3350631472,1672657145,1672660109,2964
9812,3854390432,3927763819,1672636856,1672640363,3507
9966,3600441934,3299587876,1672667565,1672668375,810
10293,3716160006,3716740576,1672591609,1672592780,1171
9965,3668063289,3534372899,1672618988,1672621861,2873
10772,3976742903,3391093411,1672608061,1672610599,2538
11551,3516167000,3534174363,1672567380,1672568152,772
9896,3888642876,3270607273,1672615941,1672616250,309
10912,3534081527,3737467358,1672596467,1672597886,1419
10030,3755175497,3501853868,1672612518,1672612935,417
11191,3276393542,3510836047,1672579523,1672580003,480
10718,3311200541,3917905192,1672686288,1672687125,837
10125,3289771213,3892177203,1672697301,1672698634,1333
11681,3517558635,3778605154,1672555290,1672556281,991
10564,3772343750,3509701363,1672639709,1672642803,3094
10144,3353335252,3516429380,1672574597,1672576316,1719
10886,3774506868,3774195369,1672661701,1672662118,417
9955,3701475090,3345954031,1672694503,1672696526,2023
10029,3772282008,3505140123,1672652410,1672654637,2227
10696,3776841808,3783021859,1672665924,1672666496,572
11237,3909822999,3311331205,1672632300,1672632538,238
11695,3513739060,3396453219,1672683545,1672686474,2929
9821,3609335008,3716183063,1672535756,1672537926,2170
10087,3228575883,3710008760,1672678257,1672680998,2741
10767,3283106998,3883640454,1672697571,1672698215,644
10002,3716647407,3608214600,1672654681,1672657178,2497
10655,3534941710,3625400710,1672660570,1672662209,1639
10878,3501583486,3813111107,1672577966,1672578756,790
10676,3783506190,3407398464,1672592690,1672594921,2231
11423,3379400553,3818236682,1672629625,1672631289,1664
10398,3307236682,3701779683,1672584692,1672585720,1028
11713,3357026115,3713141087,1672577624,1672580904,3280
10369,3780482864,3275975921,1672557263,1672557751,488
11431,3716669659,3777672363,1672675957,1672677857,1900
10941,3488749569,3223177147,1672693434,1672696579,3145
10727,3791332061,3505266343,1672588897,1672589304,407
9800,3793375825,3756149282,1672554559,1672556739,2180
10173,3285322570,3783095041,1672650866,1672653380,2514
10449,3716891903,3378534521,1672680914,1672682922,2008
11671,3779835734,3730571757,1672536489,1672538785,2296
11368,3387870683,3894756677,1672667818,1672668810,992
10378,3624365837,3517652011,1672655868,1672658023,2155
11703,3622654885,3715737742,1672626579,1672628104,1525
9930,3778273230,3311583437,1672605730,1672606117,387
9922,3482172065,3225554956,1672563613,1672563964,351
9877,3486509752,3505278562,1672691007,1672692538,1531
10602,3449233346,3821087562,1672659292,1672660042,750
11052,3914740937,3500356342,1672589926,1672592672,2746
11300,3667814788,3378172464,1672680944,1672683300,2356
10063,3713969196,3714806574,1672687707,1672689934,2227
10945,3927675706,3716841469,1672635211,1672637853,2642
9962,3711430738,3903879740,1672592411,1672594905,2494
11266,3314965818,3519341916,1672665903,1672668975,3072
11263,3893527651,3760537855,1672614181,1672614834,653
11372,3716609198,3371759044,1672610986,1672614162,3176
11538,3931164237,3437108337,1672631489,1672634446,2957
9927,3803996569,3501828287,1672611193,1672613873,2680
10852,3203172170,3470135167,1672654377,1672656665,2288
11276,3713102459,3356599815,1672644456,1672645015,559
10675,3616403486,3444680955,1672546565,1672547759,1194
11319,3710051427,3711176990,1672629383,1672632898,3515
11145,3519937708,3518794921,1672694654,1672697265,2611
10314,3851810349,3714116241,1672589755,1672591944,2189
11002,3514007122,3335139032,1672678463,1672680279,1816
9922,3780956975,3225356349,1672656453,1672656957,504
11135,3636885498,3520515739,1672542359,1672545844,3485
10709,3477951091,3243056734,1672675990,1672676193,203
11709,3424476995,3228056289,1672702215,1672705286,3071
10628,3235313062,3667072319,1672599235,1672602765,3530
10895,3919349138,3682241594,1672664296,1672666141,1845
11094,3209417223,3716285196,1672562576,1672565163,2587
9897,3773032706,3760749218,1672654853,1672658120,3267
10683,3518572231,3534770827,1672622106,1672622496,390
11486,3516103646,3880788853,1672535991,1672539555,3564
10758,3857344874,3714806574,1672551991,1672554305,2314
11577,3516969689,3783067048,1672676955,1672680349,3394
11476,3713069234,3349319959,1672655884,1672658329,2445
10119,3475033290,3929355087,1672600698,1672601332,634
10548,3505331014,3780576351,1672651208,1672653645,2437
9844,3716233100,3817478012,1672629357,1672632896,3539
10819,3513186622,3857244486,1672626005,1672626938,933
11489,3792162098,3791628263,1672638245,1672639572,1327
11427,3714312797,3711190257,1672620148,1672623499,3351
10490,3278443807,3912811715,1672556159,1672559718,3559
10218,3710060386,3755273361,1672703799,1672705662,1863
11664,3710296607,3773202954,1672671655,1672671863,208
10346,3499711458,3780287649,1672681600,1672683110,1510
10353,3301369282,3911431642,1672602303,1672603691,1388
9880,3757030923,3683562111,1672548985,1672551946,2961
10389,3399943757,3668063289,1672558384,1672559282,898
11041,3505908965,3360309868,1672542474,1672545202,2728
11472,3431317400,3514980025,1672537146,1672539844,2698
10940,3519319233,3514576083,1672589500,1672591788,2288
10781,3716095450,3516706935,1672592487,1672595846,3359
11574,3362706073,3773083407,1672636551,1672639149,2598
11714,3389367628,3979115924,1672635308,1672636090,782
10790,3824135033,3554174421,1672610870,1672613238,2368
11417,3793029132,3710296607,1672644634,1672645305,671
11371,3783942518,3533976217,1672669274,1672672403,3129
10209,3776291254,3228218081,1672683108,1672685079,1971
11217,3221290808,3619796619,1672676657,1672679085,2428
9797,3687024828,3310021925,1672601379,1672603993,2614
10801,3716944983,3285322570,1672540856,1672543805,2949
11485,3756616853,3669475165,1672554385,1672555018,633
11111,3627431396,3923910914,1672584045,1672587171,3126
11456,3553694590,3711810752,1672691818,1672694842,3024
11350,3737050849,3802625412,1672658081,1672659705,1624
11335,3519886257,3520273299,1672674152,1672675690,1538
11103,3343511947,3519448648,1672614445,1672616837,2392
11063,3236360179,3701311947,1672591959,1672594851,2892
11378,3552309108,3513432588,1672582315,1672583225,910
10328,3430032005,3512726649,1672555037,1672555320,283
10548,3285587972,3710185376,1672690107,1672693093,2986
10772,3667814788,3779382417,1672597458,1672598429,971
10114,3406101720,3777932581,1672668718,1672669790,1072
10958,3514560138,3773899531,1672690888,1672694348,3460
10469,3770391782,3772609551,1672645873,1672647196,1323
11090,3760107540,3791644831,1672561470,1672564940,3470
10081,3469663062,3311414429,1672691890,1672692680,790
10499,3616242727,3757064623,1672677241,1672677776,535
11032,3684651755,3625779003,1672532794,1672535586,2792
10514,3832312129,3500433278,1672666028,1672669049,3021
9990,3776316903,3917811545,1672565280,1672566653,1373
10719,3519228207,3202740652,1672583736,1672586854,3118
10022,3480270940,3439532406,1672613456,1672615357,1901
10881,3756066702,3403218814,1672642337,1672642846,509
11194,3305612422,3284334297,1672696400,1672697940,1540
11345,3533566754,3512638952,1672656508,1672656996,488
10123,3618895679,3713726267,1672663738,1672665404,1666
11708,3755779925,3783443095,1672593996,1672594992,996
9821,3773770134,3501515425,1672548619,1672549843,1224
11582,3505593034,3500057674,1672563255,1672564998,1743
10649,3912625932,3811354125,1672687326,1672688013,687
10579,3533154906,3634766042,1672578838,1672581550,2712
10860,3516731917,3776581518,1672662115,1672663066,951
9809,3513802404,3778273230,1672637106,1672638475,1369
10154,3434452046,3286938590,1672576961,1672577914,953
10282,3443580855,3505175620,1672671716,1672672372,656
10175,3777715675,3755361692,1672608650,1672609660,1010
10498,3242149533,3509377714,1672620698,1672623689,2991
11051,3335974305,3505129296,1672702647,1672703663,1016
11394,3881579907,3760322661,1672682250,1672682533,283
10533,3627358016,3778819352,1672634288,1672635870,1582
11306,3500544306,3511198566,1672682807,1672684433,1626
10980,3760267158,3701865589,1672623125,1672625269,2144
10921,3513800589,3350631472,1672698553,1672698753,200
9801,3820280594,3714281210,1672621743,1672625002,3259
9856,3666561358,3716541851,1672631789,1672634637,2848
9856,3777932581,3770595035,1672620815,1672621067,252
10376,3520012007,3337675386,1672671966,1672672299,333
10548,3791245127,3533620069,1672600758,1672600938,180
9880,3554236075,3516815069,1672664135,1672664584,449
11534,3281970147,3273242177,1672678102,1672680935,2833
11339,3819400315,3429610195,1672583228,1672584058,830
10355,3783594729,3488887919,1672600301,1672602361,2060
11791,3311045951,3534426696,1672631813,1672635066,3253
9944,3234445133,3778605154,1672562724,1672564039,1315
10305,3791628263,3514541800,1672605610,1672606156,546
11078,3760737203,3509614126,1672634784,1672637748,2964
9974,3773378103,3438204844,1672562567,1672562705,138
10250,3501711464,3533642281,1672604836,1672607945,3109
11768,3403035480,3711862792,1672542443,1672546033,3590
11178,3756647451,3239279744,1672630160,1672630721,561
10200,3920606331,3478915403,1672633692,1672637160,3468
11681,3495482863,3701779683,1672682715,1672683132,417
11525,3792627762,3376842515,1672594145,1672595536,1391
10759,3378534521,3760525465,1672558803,1672561002,2199
11104,3273758330,3774304163,1672677339,1672679081,1742
10167,3756168814,3774145748,1672582962,1672583876,914
10502,3831864108,3778182724,1672616677,1672619734,3057
10887,3715852330,3772893815,1672675053,1672675648,595
11129,3812559393,3313101243,1672546368,1672548954,2586
11351,3609166109,3780129338,1672596919,1672597370,451
10698,3756367938,3510153173,1672615376,1672618837,3461
10857,3711810752,3239401337,1672531869,1672534748,2879
11616,3520926977,3519055736,1672657337,1672658273,936
10631,3437703650,3505560793,1672687737,1672689151,1414
10637,3884180202,3855440101,1672587726,1672587959,233
10573,3772708314,3602570831,1672606335,1672608033,1698
10240,3332840671,3511750850,1672697068,1672697543,475
11243,3505119470,3559754304,1672564534,1672566307,1773
9796,3485468650,3514673213,1672589812,1672591102,1290
11453,3402020492,3446764595,1672626802,1672629816,3014
10144,3272827860,3779706467,1672629354,1672630202,848
10555,3713767153,3380218091,1672606783,1672609959,3176
10848,3226172318,3733411026,1672689083,1672690662,1579
10825,3517810375,3511883778,1672702701,1672703890,1189
9918,3910049345,3304227085,1672617574,1672620755,3181
11577,3368951504,3408828584,1672665454,1672667803,2349
10064,3313579674,3355430975,1672607328,1672610873,3545
11145,3500630465,3777387533,1672680733,1672682216,1483
10162,3703722212,3703624327,1672615186,1672618499,3313
9839,3220660616,3851877325,1672574746,1672578196,3450
11686,3938129916,3898989233,1672581680,1672583395,1715
11738,3203954795,3203630241,1672606166,1672608037,1871
11259,3825795004,3783368855,1672694363,1672696153,1790
10783,3500909455,3400545490,1672564005,1672564324,319
10487,3977337501,3533976217,1672596954,1672597342,388
9921,3756680289,3620157388,1672670019,1672671905,1886
10867,3714424237,3703423962,1672598540,1672600721,2181
9857,3793704155,3477951091,1672631349,1672632880,1531
11781,3342235058,3224040894,1672534408,1672535632,1224
9812,3226913558,3276499910,1672626002,1672627661,1659
10077,3414841458,3241567995,1672597505,1672599850,2345
11132,3701385831,3977880564,1672649284,1672650195,911
10580,3275661834,3711770773,1672694808,1672697355,2547
10503,3701377471,3716633983,1672683866,1672686387,2521
10339,3828354855,3393543588,1672653913,1672655311,1398
10160,3442564712,3458271585,1672532985,1672535410,2425
11652,3445558740,3364067937,1672589246,1672591116,1870
10613,3774029494,3244495586,1672583136,1672585941,2805
10011,3516321993,3703818358,1672626490,1672628083,1593
10415,3402774497,3687445224,1672650298,1672652578,2280
10608,3485521840,3501574882,1672671145,1672673326,2181
11289,3835982340,3305612422,1672554864,1672557224,2360
10535,3711065081,3756876537,1672692197,1672692766,569
9882,3856147380,3760801237,1672588993,1672589336,343
9802,3227339675,3838423363,1672638104,1672639281,1177
10035,3927675706,3427049290,1672593727,1672596825,3098
10023,3311771689,3689223632,1672542697,1672544772,2075
10209,3368951504,3715700639,1672602765,1672605169,2404
10193,3777498160,3603452936,1672670183,1672671613,1430
10606,3332124606,3290097447,1672557257,1672557764,507
10095,3367202274,3297624618,1672570619,1672571858,1239
10278,3491335890,3774627091,1672662337,1672664808,2471
10426,3755238321,3633622298,1672545224,1672547608,2384
9832,3897500723,3772689657,1672557544,1672558705,1161
9842,3520049965,3825526565,1672560876,1672561387,511
10855,3316117186,3888057649,1672577797,1672579316,1519
10512,3896622009,3710223875,1672626939,1672627591,652
10421,3427741923,3715039960,1672653649,1672653813,164
10589,3774652449,3384151770,1672615353,1672617143,1790
11611,3710515351,3770480149,1672686465,1672688802,2337
11195,3512251592,3359012188,1672552134,1672555457,3323
11623,3777370992,3916924978,1672664435,1672664609,174
10703,3421956717,3553640169,1672676434,1672678750,2316
9857,3778479297,3446764595,1672598631,1672600434,1803
10436,3534937492,3701529552,1672592860,1672594031,1171
10868,3534578428,3629248353,1672667833,1672670813,2980
10898,3926724515,3780969898,1672662299,1672663874,1575
10222,3884862164,3477511446,1672648334,1672650285,1951
11017,3853182912,3902548260,1672677000,1672679686,2686
10914,3384001094,3418791124,1672611323,1672614187,2864
11209,3411626917,3366961580,1672660637,1672661822,1185
10651,3912862842,3340321384,1672574719,1672576343,1624
9968,3491948594,3791628263,1672690223,1672691939,1716
10801,3516586325,3777706200,1672689773,1672693048,3275
9908,3714787207,3919342147,1672560728,1672563695,2967
10820,3500444748,3465690527,1672648987,1672649088,101
11685,3777758203,3773736248,1672585058,1672587366,2308
11464,3510111365,3615447269,1672560345,1672561109,764
10294,3669427589,3534278019,1672580993,1672581926,933
10600,3345896913,3703732445,1672659108,1672659823,715
11454,3519997661,3911376818,1672550995,1672554283,3288
11479,3514776568,3396453219,1672655352,1672656760,1408
11385,3513800589,3716467469,1672588295,1672589235,940
11005,3429047448,3557653200,1672569617,1672571709,2092
11036,3473520701,3603682643,1672672397,1672675862,3465
10628,3440305508,3850108828,1672666317,1672668367,2050
11518,3909504515,3500104976,1672611780,1672613741,1961
10729,3807584987,3220123678,1672607625,1672607901,276
11754,3500927619,3272838634,1672665889,1672668511,2622
11546,3854229296,3500105301,1672619083,1672620433,1350
11048,3500974385,3403870769,1672680758,1672683175,2417
11764,3476431618,3271719569,1672623709,1672627181,3472
10835,3715923089,3316537706,1672634763,1672635327,564
9924,3739395381,3311771689,1672655423,1672656787,1364
11071,3515699732,3205113625,1672533022,1672533574,552
10972,3514776568,3757212744,1672665060,1672667021,1961
10217,3304227085,3760144712,1672583387,1672586967,3580
11525,3311410533,3515405509,1672556171,1672559117,2946
11307,3284483177,3779778679,1672584689,1672586484,1795
10512,3682266017,3509394912,1672621906,1672623615,1709
10749,3361635547,3335353798,1672594623,1672596730,2107
10018,3776122272,3737467358,1672605912,1672606237,325
11398,3511907179,3755767856,1672671098,1672671386,288
11332,3776534957,3311409212,1672679337,1672682149,2812
10197,3476308535,3774539067,1672581557,1672582845,1288
10855,3235578121,3533154906,1672548988,1672551942,2954
9946,3783238023,3500640854,1672564488,1672567158,2670
11170,3977337501,3703443664,1672589797,1672590400,603
10411,3773041843,3774506868,1672677940,1672678950,1010
10922,3382746533,3475090917,1672591102,1672593167,2065
10119,3793222045,3515681585,1672621521,1672622366,845
10394,3711765138,3246296769,1672669837,1672670955,1118
11022,3732090606,3271719569,1672671878,1672672649,771
10594,3757598610,3505825767,1672585923,1672586703,780
11533,3661856558,3773848111,1672564413,1672567884,3471
9912,3430296808,3355430975,1672664403,1672665294,891
10428,3792930090,3388915945,1672615672,1672617567,1895
11702,3931164237,3513186622,1672648090,1672649822,1732
11169,3828354855,3916673751,1672684398,1672684741,343
11053,3534102440,3514455363,1672557960,1672560462,2502
10204,3716801088,3791409441,1672554111,1672556361,2250
9878,3513092056,3832745283,1672676827,1672678888,2061
11655,3715602742,3612841103,1672658011,1672660406,2395
11571,3896211741,3760554453,1672644660,1672645487,827
11341,3517210356,3411626917,1672552112,1672554832,2720
11759,3512871568,3770476738,1672570964,1672573820,2856
10780,3515259326,3890638402,1672568602,1672571736,3134
10970,3500793739,3303552616,1672571691,1672574965,3274
11376,3516588277,3779255367,1672649503,1672650872,1369
10261,3915652382,3815700240,1672614896,1672615041,145
9944,3778731000,3903088144,1672596093,1672596586,493
11366,3461137945,3517797610,1672621660,1672622042,382
10170,3755989680,3274894848,1672692584,1672695061,2477
10027,3509996827,3716460706,1672548861,1672549090,229
10011,3271389160,3631444265,1672557062,1672558285,1223
11705,3515893948,3898592058,1672662463,1672665868,3405
10789,3835262447,3203876438,1672645674,1672645863,189
11622,3517380144,3979366845,1672676019,1672677476,1457
11474,3512750313,3509317776,1672606303,1672608869,2566
10197,3921736061,3755192104,1672615136,1672617437,2301
10935,3783826338,3505266343,1672568801,1672570174,1373
9810,3887030182,3792289287,1672699436,1672701164,1728
10455,3854957153,3518478484,1672554771,1672555716,945
9807,3395610742,3779778679,1672619223,1672622645,3422
11243,3433189219,3397527886,1672662141,1672665651,3510
9982,3518376262,3660176760,1672650733,1672654172,3439
11518,3533113740,3421674406,1672583772,1672586911,3139
11627,3516588277,3463892928,1672538137,1672538864,727
10856,3449672240,3913746581,1672663815,1672664892,1077
10213,3305727497,3520160414,1672599425,1672602048,2623
9820,3703419800,3777992576,1672570390,1672573086,2696
10625,3380167818,3703818358,1672539423,1672540104,681
10568,3681701931,3885645840,1672656374,1672658466,2092
11603,3783067048,3424988692,1672652078,1672655575,3497
10525,3760801237,3515100211,1672570321,1672570644,323
10258,3857389270,3716647407,1672532476,1672535053,2577
9995,3500104976,3713336088,1672566450,1672567366,916
10434,3833520635,3938398160,1672616382,1672617800,1418
11115,3490804766,3812756400,1672559255,1672561545,2290
9803,3387621912,3513859809,1672681974,1672683155,1181
11270,3509394912,3755286041,1672533805,1672536904,3099
11357,3515803462,3494560663,1672648593,1672650033,1440
9874,3353335252,3510801769,1672603076,1672606436,3360
11647,3429409539,3757994002,1672555917,1672556986,1069
9983,3776319560,3770273966,1672608265,1672609097,832
11175,3668855144,3511004622,1672614025,1672616076,2051
11679,3520694387,3512700007,1672582906,1672585766,2860
11542,3238997746,3927365255,1672556969,1672560438,3469
10539,3776950532,3855674398,1672610981,1672614354,3373
10056,3622654885,3780500764,1672571233,1672571436,203
11363,3514776568,3912862842,1672681136,1672683958,2822
11469,3413236071,3909220912,1672659061,1672659772,711
11195,3533009565,3777112124,1672641801,1672644734,2933
10154,3288920399,3273771395,1672648741,1672651166,2425
10898,3366501813,3624365837,1672580866,1672582240,1374
10008,3757607649,3755129708,1672667132,1672670692,3560
10283,3516167000,3519848902,1672592278,1672594381,2103
11355,3461630842,3774401596,1672579960,1672582961,3001
11292,3884862164,3307216611,1672642685,1672643276,591
11180,3792930090,3513739060,1672667360,1672668811,1451
10991,3703694139,3505392452,1672634103,1672635565,1462
11678,3509317776,3515607283,1672687327,1672689788,2461
10885,3778741325,3488988274,1672558962,1672559025,63
10349,3793719515,3883640904,1672696485,1672697996,1511
11676,3703336988,3429610195,1672703975,1672707405,3430
10765,3625779003,3505032644,1672652361,1672655182,2821
11091,3351153781,3500596577,1672533949,1672534580,631
10811,3791664049,3359351267,1672600033,1672602191,2158
11053,3792075871,3773636983,1672658342,1672660445,2103
10092,3634766042,3703779674,1672602136,1672604263,2127
11620,3392482187,3605078841,1672576431,1672578157,1726
11272,3792267993,3805616707,1672644190,1672646137,1947
11266,3382757142,3780511388,1672648288,1672648400,112
11766,3500591274,3613547091,1672667600,1672670350,2750
10093,3774035405,3713100169,1672656878,1672657596,718
10308,3238310644,3772509599,1672640264,1672642621,2357
11431,3533340292,3311626308,1672546268,1672548389,2121
10924,3313282478,3501628472,1672555906,1672557682,1776
11786,3555215568,3380418745,1672637507,1672638645,1138
9937,3736987749,3929446196,1672549717,1672551669,1952
11292,3806720019,3714101349,1672625197,1672626103,906
10586,3380167818,3732533330,1672687746,1672688921,1175
10768,3735152111,3517499844,1672586049,1672586766,717
11151,3519228207,3534941710,1672542406,1672545913,3507
11290,3433902955,3501271930,1672601096,1672601274,178
11738,3550405857,3313824913,1672627851,1672630633,2782
9797,3390444181,3350631472,1672549932,1672550437,505
10888,3519352855,3714595459,1672661891,1672664077,2186
10922,3772966919,3400560073,1672656194,1672657016,822
10619,3374195945,3773697080,1672691079,1672693964,2885
11761,3850904092,3802625412,1672629686,1672632958,3272
10083,3772169046,3430032005,1672641700,1672643972,2272
11273,3685645561,3533325993,1672574116,1672574616,500
10717,3774939922,3514926921,1672591824,1672592532,708
10654,3817315443,3229570647,1672640116,1672642918,2802
10761,3714250543,3465672238,1672694737,1672695560,823
10758,3515047288,3777932225,1672682967,1672684316,1349
11174,3420983899,3278779955,1672557805,1672559361,1556
11418,3374348845,3501711464,1672581714,1672582804,1090
10187,3780224882,3421040626,1672625687,1672628129,2442
11585,3231654754,3519937708,1672688426,1672688932,506
10641,3713566527,3301431129,1672669230,1672671319,2089
10092,3828568868,3446218191,1672605080,1672605320,240
10589,3779415433,3299587876,1672689617,1672690523,906
11645,3342495377,3311771689,1672591775,1672594254,2479
10222,3519463038,3885422379,1672612781,1672613038,257
11354,3534604516,3284334297,1672563996,1672564263,267
11247,3286938590,3837885956,1672621058,1672624324,3266
11425,3919814073,3884369346,1672581841,1672583260,1419
9801,3334381941,3534667712,1672586661,1672588761,2100
11689,3445355677,3815440588,1672555094,1672556936,1842
10509,3919984986,3776200012,1672668095,1672670419,2324
9945,3402580733,3511744756,1672592046,1672593633,1587
9905,3826418889,3783594246,1672554587,1672556444,1857
10729,3441737317,3776200012,1672584118,1672585564,1446
9947,3773344258,3668720465,1672574095,1672577302,3207
10672,3715111016,3711755596,1672595913,1672599093,3180
10655,3310737478,3902682060,1672685438,1672686807,1369
10945,3791574640,3337715675,1672598567,1672599170,603
9955,3312800145,3793003432,1672639618,1672642681,3063
9933,3783060739,3315094386,1672585949,1672589425,3476
10160,3352057037,3791906680,1672622471,1672622743,272
10202,3778124514,3512417724,1672635373,1672638570,3197
11428,3517151644,3896211741,1672556083,1672556855,772
10106,3793699467,3852014884,1672563855,1672567083,3228
11344,3276499910,3472561941,1672668840,1672670187,1347
11644,3454151554,3512133625,1672635916,1672637474,1558
11096,3272096922,3927805949,1672644218,1672645571,1353
10629,3936871734,3500596577,1672641283,1672644845,3562
10938,3757944870,3295530454,1672610958,1672611857,899
11071,3352493805,3792824886,1672642364,1672643743,1379
10695,3418683594,3402105276,1672550327,1672551676,1349
11054,3780074082,3757924067,1672579248,1672581935,2687
11506,3760069457,3711755596,1672551483,1672554113,2630
11086,3367526113,3517632796,1672614370,1672616203,1833
11427,3791332061,3703742071,1672593709,1672596031,2322
10924,3487278983,3713840946,1672589863,1672591538,1675
10208,3513203127,3505980138,1672691982,1672695253,3271
10724,3715106566,3534459983,1672531592,1672532602,1010
11771,3510864325,3425545115,1672647222,1672650606,3384
11148,3850735936,3505908965,1672623009,1672625414,2405
10299,3976742903,3703849264,1672576550,1672577755,1205
11695,3245501577,3440671139,1672629644,1672630655,1011
10823,3830254808,3514013999,1672629850,1672633330,3480
10029,3372617110,3393955069,1672597178,1672598051,873
10715,3884394685,3519521903,1672550624,1672550763,139
11057,3440991826,3505359060,1672665236,1672666883,1647
10113,3505331014,3711179193,1672625961,1672626284,323
11119,3511199555,3388915945,1672632390,1672633973,1583
9906,3732223664,3243056734,1672621711,1672622527,816
10645,3623894390,3701453343,1672676169,1672677910,1741
9979,3432762943,3275171954,1672693019,1672696401,3382
11023,3600871715,3979115924,1672636007,1672636689,682
11057,3737946004,3398489033,1672575484,1672576515,1031
10246,3505845400,3519997661,1672620874,1672623788,2914
10672,3703474558,3711287751,1672580191,1672582352,2161
10535,3386323728,3760801237,1672609270,1672612584,3314
11375,3710228292,3778695895,1672660371,1672662479,2108
10454,3533627473,3624872714,1672612235,1672612938,703
10707,3519357822,3757089924,1672657737,1672660555,2818
10238,3505291330,3778932673,1672543677,1672545107,1430
10320,3735679000,3500968729,1672584874,1672585022,148
11109,3380357490,3249614888,1672702695,1672705097,2402
11601,3480185839,3305612422,1672602604,1672605370,2766
11119,3609997804,3465107990,1672701241,1672704500,3259
11644,3415803494,3776561263,1672690065,1672692850,2785
9979,3306037126,3495152069,1672638969,1672642388,3419
9997,3733243990,3714264759,1672569940,1672572812,2872
11568,3533960602,3509431396,1672684126,1672685095,969
11521,3501583486,3804707712,1672650727,1672652637,1910
11321,3512555384,3278071998,1672643138,1672645776,2638
11705,3510864325,3348100657,1672667368,1672668443,1075
11448,3608214600,3271282663,1672656535,1672658296,1761
9979,3509317054,3803996569,1672691017,1672693987,2970
10575,3500415589,3227647190,1672690256,1672691055,799
10378,3509431396,3714902042,1672637429,1672639775,2346
11725,3510836047,3238056215,1672695220,1672695568,348
10641,3367262509,3520860199,1672635955,1672637026,1071
10004,3479402555,3511963020,1672554897,1672557746,2849
10295,3365519448,3416474842,1672661043,1672664117,3074
10891,3393955069,3515715968,1672621466,1672622038,572
10147,3600699873,3432466467,1672593859,1672597446,3587
10064,3354968884,3971280379,1672638116,1672639616,1500
11172,3487779363,3287968403,1672671998,1672675456,3458
11264,3409098014,3773440794,1672595873,1672599374,3501
10413,3513545735,3760731595,1672679608,1672679712,104
10604,3443521234,3517902505,1672558586,1672558707,121
11679,3492064037,3716633983,1672646825,1672648418,1593
10107,3911376818,3974264211,1672654614,1672656686,2072
11474,3770012744,3971051020,1672663477,1672665138,1661
10457,3818461836,3311331205,1672673476,1672673687,211
10682,3509677530,3331228758,1672561272,1672562315,1043
10676,3802374620,3778044082,1672698590,1672698952,362
11392,3931164237,3738760498,1672628052,1672629323,1271
10942,3533867833,3714838100,1672623698,1672626371,2673
11777,3278443807,3667814788,1672666714,1672667722,1008
11050,3770709417,3310021925,1672663922,1672664848,926
10799,3452982957,3793899166,1672683092,1672683935,843
10548,3701824335,3509274030,1672644625,1672646294,1669
11447,3914926436,3735838864,1672627848,1672628565,717
11457,3780287649,3638126174,1672697731,1672698622,891
11518,3417223898,3483347530,1672667933,1672668430,497
11496,3415032547,3667814788,1672571516,1672572814,1298
11552,3713858538,3550206045,1672694580,1672695676,1096
10709,3783122313,3533077580,1672550039,1672553017,2978
10746,3792512768,3755924094,1672596347,1672596843,496
10799,3443004958,3714065165,1672642546,1672643369,823
10444,3755238321,3793497672,1672604370,1672607063,2693
9854,3517253559,3711518637,1672637585,1672640762,3177
11427,3422205569,3483701493,1672686019,1672687172,1153
10569,3469350379,3405200303,1672567507,1672570539,3032
10021,3927202773,3308744016,1672546321,1672547148,827
10835,3500096103,3778605154,1672636309,1672637362,1053
10729,3393128259,3514685272,1672559390,1672560469,1079
11437,3770564547,3288920399,1672675027,1672677899,2872
10859,3710060386,3896123242,1672604185,1672606772,2587
11268,3509614126,3756297396,1672673167,1672673704,537
11389,3882851213,3305657559,1672668890,1672670132,1242
11029,3434581257,3520012007,1672699772,1672703148,3376
10541,3887030182,3760966645,1672641177,1672644092,2915
10964,3688768189,3703697059,1672666257,1672668800,2543
10342,3390368796,3476431618,1672572990,1672575109,2119
10844,3309415277,3287689454,1672598078,1672598372,294
11670,3533593766,3439283360,1672699598,1672702642,3044
10157,3514776568,3500693568,1672547865,1672550682,2817
11241,3730459093,3780238637,1672686673,1672687116,443
10324,3500922040,3770764940,1672593108,1672594684,1576
9995,3409514897,3398075553,1672612967,1672615166,2199
10622,3619676231,3557653200,1672592343,1672595644,3301
10517,3714250543,3774673193,1672644604,1672645877,1273
10271,3714919471,3422205569,1672666491,1672667867,1376
11431,3221736756,3391854325,1672612715,1672614918,2203
11246,3756119976,3757064623,1672598858,1672600507,1649
11695,3772962072,3500591274,1672601449,1672602646,1197
11123,3488399075,3732312480,1672553007,1672555355,2348
11763,3247193800,3513140146,1672678169,1672679427,1258
11175,3509018337,3919258737,1672621461,1672623075,1614
9889,3304592684,3778402454,1672624979,1672625724,745
11382,3834980281,3500442370,1672678827,1672679758,931
9962,3316406470,3345896913,1672544631,1672547150,2519
10940,3239990061,3779665641,1672645381,1672648499,3118
10823,3501988762,3517136772,1672680293,1672682318,2025
11754,3628423403,3511004622,1672589863,1672590304,441
10071,3484483775,3835262447,1672639472,1672642992,3520
10671,3715114417,3605101443,1672580840,1672581399,559
9982,3760687922,3887030182,1672690599,1672692114,1515
11259,3800434325,3514306458,1672703545,1672706628,3083
10371,3777112124,3884934977,1672552140,1672553267,1127
11690,3776407517,3511729562,1672570009,1672571907,1898
9883,3772489471,3621629499,1672677548,1672679909,2361
10027,3792455305,3230250213,1672535733,1672535924,191
11767,3904004824,3516792348,1672639912,1672642671,2759
10384,3352374868,3483347530,1672555370,1672556497,1127
9898,3801501384,3772169046,1672665507,1672668718,3211
10532,3809194824,3271719569,1672639969,1672640687,718
11536,3680939042,3917004141,1672635574,1672637149,1575
10361,3520832066,3519965717,1672640650,1672641929,1279
10615,3501977123,3505245692,1672550404,1672553762,3358
11500,3710680073,3406169279,1672603328,1672603421,93
10618,3513432588,3715101177,1672546932,1672549504,2572
11672,3396472026,3369482983,1672583530,1672583626,96
10099,3534531039,3756345026,1672685430,1672686585,1155
9853,3903065952,3206853747,1672641995,1672642447,452
11062,3476958001,3342426430,1672544567,1672544725,158
10341,3716468783,3851737350,1672556872,1672559104,2232
11070,3431317400,3511744756,1672611669,1672612297,628
11648,3613828705,3517949586,1672619605,1672621296,1691
11363,3757128722,3774035405,1672674493,1672677184,2691
10000,3513740840,3497732613,1672550364,1672551131,767
10272,3367121615,3804707712,1672633793,1672634700,907
10187,3903115138,3515715968,1672632997,1672635633,2636
10146,3343616490,3298113026,1672673352,1672673694,342
11059,3533030343,3482172065,1672609587,1672610240,653
9871,3476308535,3737571883,1672601126,1672602932,1806
10214,3713416106,3772882440,1672542711,1672546138,3427
10738,3432838598,3343511947,1672636725,1672638088,1363
11023,3710695372,3389069291,1672612578,1672613222,644
10785,3308481706,3711767051,1672656257,1672659217,2960
11484,3606688595,3825153408,1672671938,1672674333,2395
10674,3228465044,3783095041,1672563201,1672566308,3107
11518,3437286595,3932491622,1672555565,1672557888,2323
11642,3738429905,3294949958,1672584163,1672585894,1731
9906,3430399931,3344778261,1672535579,1672536805,1226
9866,3716676869,3909399636,1672661233,1672663380,2147
11289,3850005949,3924583142,1672611023,1672611838,815
11707,3452024572,3432762943,1672642871,1672643305,434
10480,3774448657,3757513651,1672690524,1672693541,3017
11419,3792107875,3534284132,1672666430,1672668554,2124
9817,3917467642,3402338011,1672604789,1672607852,3063
10743,3776068937,3660163550,1672612387,1672613043,656
11274,3519494023,3714435747,1672621251,1672623652,2401
10656,3774450494,3408111327,1672581372,1672582597,1225
11331,3512555384,3516586325,1672563932,1672566002,2070
10842,3757199889,3793996996,1672548742,1672550186,1444
10411,3711671702,3500019810,1672532367,1672532939,572
11080,3369108286,3899205452,1672618200,1672619084,884
11225,3703462221,3419829238,1672613930,1672616752,2822
11627,3711029952,3667814788,1672577216,1672580724,3508
9844,3935569749,3779778679,1672660463,1672662538,2075
10523,3505291330,3517617472,1672642258,1672642836,578
10046,3824259677,3703438617,1672607999,1672609786,1787
11561,3735152111,3514776568,1672645981,1672647071,1090
11257,3492728794,3516034245,1672534301,1672535289,988
9884,3780048608,3714892312,1672539232,1672540651,1419
9895,3637522163,3631444265,1672584884,1672586832,1948
9935,3817076003,3297100323,1672553698,1672556695,2997
11300,3617771673,3777672363,1672580692,1672582032,1340
11376,3473706746,3348343425,1672669397,1672672309,2912
11624,3470997293,3888903181,1672678843,1672680920,2077
10206,3514244308,3716526314,1672651376,1672653337,1961
10365,3666823095,3500624846,1672698072,1672698862,790
10244,3533473206,3482639402,1672562892,1672563959,1067
10145,3509470194,3711844574,1672593315,1672596426,3111
11275,3512395783,3714902042,1672593610,1672593808,198
11711,3900793652,3832745283,1672573624,1672576296,2672
10485,3278629965,3756149282,1672624633,1672626548,1915
11284,3500994763,3513250976,1672639787,1672642241,2454
11416,3511867383,3805704844,1672632503,1672636009,3506
10753,3367242388,3774506868,1672633273,1672634029,756
11408,3780482864,3466655775,1672582975,1672583357,382
10505,3936851114,3517195738,1672604200,1672604477,277
10018,3624365837,3515699732,1672556410,1672556847,437
11501,3436099135,3800434325,1672562048,1672565562,3514
10614,3715712376,3909632424,1672580117,1672581493,1376
10581,3501004005,3633622298,1672594317,1672596926,2609
11388,3394986304,3730935770,1672639933,1672640626,693
11620,3417969824,3793874490,1672626216,1672626868,652
11720,3669140241,3441944896,1672659987,1672662017,2030
11526,3204473480,3773891827,1672657189,1672658433,1244
11205,3513661302,3345896913,1672564940,1672566801,1861
9819,3701218904,3500317923,1672544361,1672544648,287
10767,3501253130,3556684272,1672557786,1672561244,3458
11772,3703481882,3311200541,1672545597,1672546778,1181
9873,3470962222,3553321027,1672643293,1672644235,942
11248,3206926634,3295530454,1672598290,1672599774,1484
9965,3228465044,3519754667,1672572630,1672573470,840
11283,3425646356,3713611960,1672601952,1672605383,3431
11453,3372778334,3711131262,1672621272,1672623537,2265
11121,3773554767,3757089924,1672694194,1672696621,2427
9996,3683047199,3356599815,1672697599,1672699332,1733
10288,3669427589,3856699097,1672591788,1672594373,2585
10164,3932491622,3713954144,1672694139,1672697563,3424
10229,3831864108,3738547113,1672550634,1672552149,1515
10076,3512154443,3616371564,1672687135,1672688790,1655
11659,3534812391,3839744168,1672537015,1672539262,2247
9843,3452677710,3972196462,1672586825,1672589074,2249
10210,3660176760,3757639274,1672547649,1672550236,2587
10805,3818570577,3772683155,1672602996,1672606288,3292
11209,3414387263,3716595760,1672684776,1672687092,2316
10626,3814672661,3247193800,1672581657,1672584649,2992
9917,3756413374,3389069291,1672680295,1672683845,3550
11755,3466149998,3403738461,1672575704,1672578509,2805
10744,3777263928,3465107990,1672703590,1672706267,2677
11683,3290060215,3515558215,1672700745,1672703775,3030
10567,3289017988,3223796145,1672595687,1672598324,2637
10295,3701668745,3505684690,1672615163,1672616982,1819
10708,3713805968,3534081527,1672664194,1672667125,2931
10546,3282240901,3534190196,1672633850,1672637133,3283
10672,3663353552,3515944817,1672594368,1672597563,3195
10774,3885422379,3884458862,1672551746,1672554279,2533
9878,3338016147,3778382224,1672578034,1672580634,2600
11008,3520049965,3776034313,1672563432,1672564837,1405
11460,3772556646,3500543341,1672632689,1672633003,314
11194,3853275529,3513996288,1672658367,1672660365,1998
10717,3444453261,3770497768,1672635326,1672638454,3128
10911,3916656185,3757584114,1672692500,1672692877,377
10855,3463729805,3516706121,1672607800,1672608283,483
10897,3442073613,3517253559,1672689630,1672690089,459
11382,3713927376,3520362238,1672546866,1672547266,400
9850,3402105276,3505845400,1672535003,1672537685,2682
11440,3907039612,3756998113,1672570023,1672571426,1403
11600,3773202954,3884369346,1672640580,1672641293,713
11124,3757501067,3774251051,1672599984,1672601663,1679
9870,3244397548,3905934770,1672699866,1672702494,2628
10586,3806034626,3439662051,1672631391,1672634001,2610
10256,3974264211,3924583142,1672566733,1672569296,2563
11677,3661856558,3341985886,1672569249,1672572227,2978
10757,3436018575,3885422379,1672679474,1672682703,3229
9983,3793569914,3559123082,1672590424,1672591462,1038
10582,3474097405,3710397477,1672647160,1672648453,1293
11283,3317887374,3434581257,1672677181,1672679283,2102
9860,3686885442,3772893815,1672664533,1672664843,310
10659,3512802259,3299052917,1672642095,1672642453,358
10277,3971289056,3407734098,1672579592,1672580939,1347
9852,3733411026,3519357822,1672655365,1672658824,3459
11140,3792900315,3307521389,1672608564,1672610093,1529
11378,3791758175,3419378107,1672651245,1672651340,95
10740,3779505358,3436774112,1672589146,1672591859,2713
11091,3515939841,3246395239,1672601940,1672603398,1458
9856,3823307824,3335353798,1672612461,1672614797,2336
10866,3461743188,3482519872,1672631539,1672633229,1690
10793,3316537706,3388937390,1672586858,1672588646,1788
10784,3923133978,3665478011,1672665881,1672666467,586
11358,3774035405,3714101349,1672549145,1672551546,2401
11082,3668764192,3517960157,1672542514,1672545753,3239
11308,3379666159,3703624327,1672556437,1672558735,2298
10041,3510254698,3534168768,1672563312,1672563596,284
10365,3776732532,3857344874,1672700284,1672703835,3551
9794,3886879696,3779255367,1672657698,1672657825,127
11065,3359351267,3334488428,1672613209,1672615530,2321
10326,3613936929,3515304526,1672545801,1672546972,1171
10876,3500821475,3713740434,1672636464,1672639861,3397
10048,3757128722,3818324410,1672578693,1672581101,2408
10536,3484483775,3357074700,1672629698,1672632191,2493
11063,3714883746,3791088014,1672659349,1672660330,981
9942,3904004824,3515939841,1672697056,1672699601,2545
10133,3760397450,3553229537,1672557151,1672560507,3356
9823,3505867821,3835599049,1672545777,1672546156,379
11674,3509073025,3309178914,1672536623,1672537216,593
10133,3703438617,3534696810,1672598549,1672600458,1909
10690,3783043770,3780173788,1672544220,1672545896,1676
10029,3341311972,3225356349,1672596864,1672598309,1445
11423,3490804766,3817120976,1672626112,1672627711,1599
11166,3738429905,3776166086,1672546215,1672548079,1864
10622,3716891903,3411213032,1672660812,1672662698,1886
10161,3360783381,3783408830,1672652650,1672655662,3012
10700,3517992521,3486509752,1672603865,1672604993,1128
10260,3310737478,3618024815,1672642775,1672644721,1946
10350,3309178914,3515507526,1672700778,1672702983,2205
9886,3755411110,3278251248,1672628536,1672632015,3479
10159,3500145103,3623067708,1672595755,1672599000,3245
10078,3778713526,3756784813,1672631759,1672634263,2504
10576,3792824886,3802374620,1672644039,1672647567,3528
10484,3791825536,3783157469,1672627815,1672630033,2218
10582,3713920790,3357496255,1672581623,1672584312,2689
9803,3739297004,3517902505,1672614869,1672616892,2023
10320,3501126057,3396656251,1672649441,1672650063,622
10149,3756897029,3519494023,1672569836,1672571139,1303
10704,3519055736,3358473096,1672594648,1672595293,645
10830,3396453219,3970265139,1672697099,1672700287,3188
11106,3519322066,3500473064,1672629166,1672630324,1158
11363,3701956841,3505234868,1672672204,1672675266,3062
11533,3792708936,3307454562,1672670217,1672672062,1845
10818,3350631472,3914353062,1672553682,1672555200,1518
10072,3906693728,3500145103,1672649997,1672652426,2429
10477,3307997700,3478206139,1672623222,1672625849,2627
10221,3896211741,3825932442,1672636346,1672636842,496
11017,3791825536,3770595035,1672577808,1672580113,2305
9837,3811503860,3516706935,1672659473,1672662291,2818
11104,3755769254,3533929043,1672640178,1672642946,2768
10946,3783879023,3755361692,1672625712,1672628190,2478
11689,3410788026,3778318250,1672584361,1672585592,1231
10575,3520189871,3774606418,1672635001,1672635650,649
11169,3760346746,3711854614,1672680144,1672682575,2431
10500,3755209597,3715700639,1672582808,1672584870,2062
11277,3907390925,3275751794,1672558806,1672559088,282
11712,3308149799,3514926921,1672562421,1672562842,421
10727,3780563627,3739297004,1672588850,1672589571,721
11281,3406132280,3519703964,1672640621,1672642617,1996
9806,3474074188,3772695548,1672534258,1672536361,2103
11507,3330188769,3909220912,1672646554,1672649385,2831
10152,3515637968,3398489033,1672624772,1672625443,671
10745,3716233100,3342545285,1672569797,1672570997,1200
11781,3509996827,3427527462,1672690347,1672692506,2159
11146,3904004824,3777200549,1672536594,1672537417,823
10064,3510439480,3390438262,1672593441,1672596513,3072
10114,3246381831,3780074082,1672607070,1672608840,1770
10155,3247545468,3660496328,1672703497,1672704738,1241
11563,3703104365,3774589551,1672551371,1672554378,3007
11057,3776125503,3515838621,1672554390,1672554998,608
10116,3462153833,3449020351,1672649494,1672650325,831
11144,3534499421,3810818108,1672629072,1672630722,1650
11783,3500741005,3925208102,1672630841,1672632312,1471
10599,3710223875,3515470462,1672622529,1672623463,934
9983,3505037247,3393909269,1672664341,1672666601,2260
9847,3715790104,3518794921,1672614885,1672615520,635
11019,3517617472,3311015817,1672607753,1672607882,129
10920,3534111498,3519165527,1672616579,1672618904,2325
11056,3441683673,3792475476,1672700703,1672702096,1393
10564,3880549316,3755238321,1672551470,1672551737,267
11751,3491758029,3779665641,1672656043,1672656269,226
10285,3513545735,3793689267,1672602270,1672604930,2660
10884,3382696725,3447267291,1672692712,1672694485,1773
10729,3515699732,3621812406,1672591208,1672592855,1647
10763,3711852131,3776710698,1672679509,1672680045,536
11162,3774304163,3923524564,1672539638,1672542597,2959
10878,3422460919,3452677710,1672645972,1672648027,2055
11081,3487395357,3233917789,1672557324,1672558453,1129
10627,3711243126,3896200048,1672594975,1672598204,3229
11458,3772708314,3687183789,1672616793,1672619112,2319
11643,3850993995,3390444181,1672626269,1672627093,824
11495,3485468650,3515939841,1672593580,1672593962,382
10174,3922153821,3778738044,1672547718,1672549464,1746
11437,3516572212,3756695502,1672653362,1672656784,3422
10646,3703168159,3517816581,1672612258,1672613177,919
10557,3462645981,3511078598,1672665060,1672667000,1940
11761,3509508477,3474879231,1672653704,1672654984,1280
10223,3773878451,3687183789,1672536678,1672539970,3292
9929,3409078869,3519924982,1672659919,1672661246,1327
11041,3513293711,3238796398,1672700549,1672702638,2089
10983,3925208102,3793987483,1672536548,1672537538,990
11060,3777387533,3505438826,1672564409,1672565359,950
9895,3358473096,3757393413,1672702365,1672702612,247
11411,3881579907,3688768189,1672595957,1672597797,1840
9837,3402338011,3298113026,1672664280,1672664659,379
11220,3486509752,3755736024,1672591753,1672592003,250
11389,3760481622,3972196462,1672689338,1672691827,2489
11168,3977880564,3392573386,1672535269,1672536238,969
11165,3803473387,3770941125,1672539070,1672541917,2847
11138,3505998260,3778382224,1672543535,1672545990,2455
10963,3732540636,3380218091,1672646518,1672648066,1548
10857,3512802259,3513203127,1672581660,1672583635,1975
11697,3519435459,3514498259,1672539925,1672541060,1135
9827,3713224038,3770486161,1672543536,1672546727,3191
10244,3505314920,3500928990,1672582901,1672585496,2595
10743,3825153408,3505183641,1672680033,1672682464,2431
11784,3400903513,3533440736,1672661405,1672662412,1007
11612,3683677062,3301332095,1672604151,1672605704,1553
10772,3516585063,3774652449,1672617949,1672620630,2681
11298,3710223875,3516444589,1672659263,1672661621,2358
10055,3783043770,3666022373,1672616904,1672620059,3155
9925,3509382404,3514498259,1672563337,1672564161,824
11502,3337673625,3338187803,1672641801,1672645059,3258
10029,3235198316,3710223875,1672639643,1672639986,343
10094,3932491622,3347520239,1672588503,1672591745,3242
10065,3685645561,3830771832,1672662418,1672665435,3017
11563,3495482863,3520471156,1672658386,1672660435,2049
11424,3930475498,3447078933,1672553094,1672555848,2754
11253,3405221863,3772461583,1672620534,1672622382,1848
10259,3924963918,3856975623,1672653164,1672655459,2295
10229,3905889514,3838748301,1672582043,1672585568,3525
10920,3505994703,3514306458,1672644554,1672647303,2749
10636,3430823498,3430032005,1672597869,1672600630,2761
10839,3362385373,3501356814,1672645115,1672645412,297
10127,3533225084,3897186782,1672692469,1672692679,210
11119,3510869438,3793987483,1672634539,1672637865,3326
10973,3468066881,3406492167,1672603832,1672605405,1573
10221,3371759044,3711804184,1672549426,1672549658,232
11170,3910190872,3756876537,1672700647,1672701282,635
10898,3438028077,3518947256,1672664510,1672666447,1937
10490,3772234939,3367526113,1672690016,1672691238,1222
10738,3229615214,3515379622,1672662221,1672665744,3523
9923,3971051020,3517144269,1672682061,1672682154,93
10544,3358262975,3776617627,1672598495,1672599066,571
10369,3824135033,3472774606,1672567541,1672569724,2183
11295,3220976338,3715622084,1672685815,1672687248,1433
10325,3755374000,3922430928,1672614929,1672615653,724
11398,3710622746,3438028077,1672591255,1672592563,1308
10766,3756784813,3779561601,1672564678,1672565630,952
11107,3516827471,3501557463,1672633245,1672634949,1704
10590,3514341451,3927763819,1672569006,1672571555,2549
11061,3453164933,3519357822,1672541308,1672541501,193
10741,3419378107,3558567160,1672570845,1672574257,3412
10085,3354405535,3756157377,1672694010,1672695238,1228
10978,3755192104,3623067708,1672588766,1672591599,2833
10764,3713416756,3613216900,1672671879,1672673036,1157
11030,3311197635,3209075485,1672645345,1672648042,2697
11556,3517551721,3780749789,1672558001,1672561174,3173
10561,3922786716,3827889533,1672580544,1672580861,317
11344,3245774173,3703443664,1672557481,1672560025,2544
11532,3511500932,3509186338,1672543231,1672543637,406
10643,3205687719,3505248368,1672533148,1672536036,2888
11365,3400903513,3366961580,1672533799,1672537398,3599
10411,3520824937,3777387533,1672567469,1672569558,2089
11702,3413511621,3854957153,1672671128,1672673757,2629
10529,3453464785,3662495290,1672595118,1672597717,2599
10061,3756157377,3473520701,1672634082,1672636885,2803
10489,3701453343,3278629965,1672562898,1672564877,1979
10477,3511615015,3774633364,1672534576,1672537016,2440
11355,3509503263,3909822999,1672586076,1672589355,3279
10920,3770941125,3776950532,1672650799,1672652276,1477
10221,3791905743,3505867821,1672641756,1672644486,2730
10597,3364660506,3755273361,1672650960,1672653273,2313
11221,3500178849,3792432763,1672624103,1672626963,2860
10382,3533974355,3624872714,1672687716,1672691240,3524
11121,3770424941,3517136772,1672562850,1672564288,1438
11280,3371759126,3519922921,1672660006,1672660429,423
10127,3701060732,3342495377,1672699824,1672699953,129
11202,3472173212,3777499535,1672584617,1672587675,3058
11515,3735197034,3778124514,1672654043,1672657165,3122
11101,3459694275,3778561231,1672562165,1672563191,1026
10234,3660176760,3500019810,1672700987,1672704149,3162
10362,3436401020,3517558635,1672660766,1672663167,2401
11577,3509208005,3311260898,1672597893,1672601275,3382
11188,3442403264,3807584987,1672561057,1672562315,1258
10819,3309651238,3757060033,1672634419,1672635210,791
11201,3391854325,3810949170,1672603232,1672605406,2174
11345,3387388336,3481365330,1672689571,1672691507,1936
10663,3413236071,3501963428,1672634137,1672636733,2596
10281,3517045396,3338115824,1672576713,1672579950,3237
9901,3880637958,3774673193,1672630762,1672633036,2274
10298,3394357241,3505521491,1672668905,1672672095,3190
10468,3778382224,3446233783,1672621944,1672622036,92
10985,3829358750,3515984911,1672628516,1672631280,2764
11049,3517943697,3511412229,1672619011,1672620773,1762
10637,3533419409,3608214600,1672692492,1672695630,3138
11321,3311260898,3293898029,1672685463,1672688180,2717
10312,3289017988,3976742903,1672623187,1672624319,1132
11692,3826542169,3661543201,1672606617,1672608429,1812
11204,3714283424,3779609338,1672538041,1672540209,2168
10389,3737622701,3419648004,1672586338,1672586658,320
11453,3520160414,3733423371,1672626614,1672629078,2464
10753,3467415939,3733870816,1672591437,1672594772,3335
11148,3701893620,3358675021,1672555016,1672555164,148
11119,3713621169,3756695502,1672548062,1672548342,280
11038,3812880543,3971051020,1672667091,1672669635,2544
11380,3680278447,3793934396,1672542872,1672544131,1259
10461,3777928067,3932566114,1672556380,1672559725,3345
10388,3316121649,3791584994,1672663504,1672666730,3226
10128,3501171785,3757796416,1672675197,1672675933,736
10020,3973582279,3777063455,1672612995,1672614726,1731
10906,3791863922,3229570647,1672593239,1672596797,3558
10862,3515715968,3760679372,1672690316,1672693263,2947
11124,3514450836,3511289729,1672635780,1672639080,3300
10923,3449020351,3209075485,1672648178,1672651062,2884
10032,3552444228,3505994703,1672558155,1672560797,2642
11734,3227956115,3793987483,1672603804,1672606832,3028
11491,3779818784,3501977123,1672663879,1672666480,2601
10153,3897107253,3925098136,1672552241,1672552826,585
11668,3636852764,3505998260,1672563665,1672564508,843
11238,3423940256,3208519320,1672574064,1672576398,2334
9868,3733796228,3555764822,1672661105,1672663029,1924
10408,3247845642,3512492332,1672652431,1672652829,398
11711,3515804844,3509167758,1672559824,1672562803,2979
11402,3714264759,3714116241,1672683819,1672687162,3343
10465,3887030182,3792785261,1672667894,1672670906,3012
10217,3245245283,3776053981,1672584093,1672587444,3351
11431,3500595432,3280208630,1672583489,1672585104,1615
11007,3313579674,3345902033,1672551308,1672553935,2627
10508,3311959533,3703849264,1672535900,1672537249,1349
10470,3757089924,3777932581,1672659978,1672662283,2305
11204,3770595035,3289258397,1672587810,1672588398,588
10470,3348343425,3715881104,1672637175,1672637436,261
10232,3661359073,3807717766,1672668594,1672670650,2056
10932,3714424237,3701359045,1672703148,1672705313,2165
10677,3512072679,3533620069,1672685871,1672687254,1383
10650,3770476738,3850993995,1672573659,1672575319,1660
9917,3514926921,3432762943,1672553590,1672555855,2265
10458,3780500331,3468066881,1672641493,1672644512,3019
10530,3916656185,3203876438,1672676630,1672678748,2118
10064,3857847527,3756297396,1672540675,1672543560,2885
11684,3887030182,3519351747,1672652602,1672654306,1704
11288,3776901443,3779340538,1672589936,1672592886,2950
10307,3934980229,3513203127,1672700141,1672700821,680
9980,3311159418,3201634072,1672567504,1672570991,3487
11747,3312800145,3620105539,1672649064,1672650512,1448
10744,3311771689,3923133978,1672568556,1672571182,2626
11552,3533440294,3937854073,1672555918,1672559171,3253
10219,3809194824,3505007498,1672561012,1672563658,2646
10846,3312959324,3516965624,1672663334,1672664301,967
11579,3629869834,3340897079,1672692536,1672693759,1223
10958,3391093411,3713224038,1672624616,1672626036,1420
10523,3384001094,3367299721,1672701336,1672702267,931
11133,3408111327,3732540636,1672670667,1672673526,2859
10433,3780074082,3773891827,1672670847,1672674356,3509
10421,3229615214,3441737317,1672656571,1672659631,3060
11023,3277634944,3938021614,1672693613,1672694441,828
10394,3439045964,3977360666,1672669956,1672671394,1438
11593,3501548163,3701925712,1672671573,1672672252,679
11789,3513092056,3514541800,1672549708,1672552070,2362
10799,3393909269,3236886943,1672604394,1672606042,1648
9952,3739217535,3478052226,1672586232,1672586998,766
11645,3926724515,3792008302,1672698544,1672700586,2042
9903,3483701493,3444397804,1672698391,1672698572,181
10699,3295748489,3519494023,1672537644,1672540030,2386
10270,3505804611,3977157565,1672685410,1672688342,2932
10787,3226037966,3534111498,1672534266,1672537539,3273
10839,3899294071,3349573092,1672617051,1672619448,2397
11175,3757501067,3512857020,1672698276,1672701038,2762
10200,3340321384,3734957248,1672537339,1672539919,2580
9813,3454151554,3446066492,1672688484,1672690626,2142
10029,3682673884,3287968403,1672560214,1672563325,3111
11709,3887502536,3902775449,1672594828,1672595972,1144
10633,3369270860,3600441934,1672608370,1672611890,3520
11559,3384001094,3494560663,1672583567,1672586818,3251
11262,3770275898,3703611876,1672624578,1672627163,2585
10660,3792851584,3458753033,1672556446,1672559238,2792
10511,3245501577,3685396470,1672551926,1672553851,1925
11081,3534506090,3770709417,1672676854,1672679239,2385
10163,3534206917,3713805968,1672533771,1672537161,3390
10051,3511640720,3511245705,1672543501,1672544387,886
10068,3381055770,3892487982,1672697855,1672700061,2206
10525,3736203662,3419648004,1672664793,1672668003,3210
10809,3518067857,3400186699,1672552448,1672554968,2520
10215,3514013999,3511206717,1672552203,1672552466,263
11457,3440671139,3638823001,1672619355,1672621420,2065
11412,3813085701,3432838598,1672580898,1672582419,1521
11481,3701971784,3432838598,1672612466,1672614089,1623
10910,3737738751,3311142523,1672661526,1672663171,1645
11707,3492350318,3757446082,1672694993,1672695474,481
11419,3492350318,3519162582,1672695358,1672698068,2710
10176,3500031401,3711856534,1672541829,1672543676,1847
11720,3441683673,3614112171,1672546265,1672548807,2542
10588,3406169279,3505500665,1672649023,1672651425,2402
10153,3206853747,3757311529,1672590101,1672592281,2180
11648,3791332061,3204149913,1672612167,1672614617,2450
10957,3393001196,3738547113,1672574018,1672576716,2698
11609,3510159441,3311583437,1672624768,1672628014,3246
11476,3858330969,3238310644,1672703830,1672706076,2246
9817,3839308659,3384151770,1672587271,1672588801,1530
10332,3938409715,3533620069,1672683283,1672683512,229
11584,3330466913,3534499421,1672698254,1672700597,2343
10280,3773475506,3444598583,1672581525,1672584945,3420
10383,3518425740,3278430820,1672599331,1672601285,1954
10667,3755357292,3791205793,1672644989,1672645053,64
10558,3552309108,3207307681,1672568390,1672568622,232
10079,3512681214,3629869834,1672659442,1672659690,248
11418,3772262649,3361789225,1672592130,1672593416,1286
10185,3361952532,3776001441,1672554408,1672554490,82
11709,3482687604,3791434207,1672679438,1672680386,948
10097,3368339963,3274894848,1672632489,1672634273,1784
10426,3622458047,3341311972,1672653339,1672654595,1256
9918,3513092056,3825082811,1672644690,1672647977,3287
10252,3464622743,3505175620,1672685211,1672688077,2866
9824,3669918958,3713969196,1672693772,1672694603,831
11092,3512072679,3313298164,1672671044,1672673749,2705
10157,3668955834,3534937492,1672658332,1672659596,1264
10196,3825082811,3462985379,1672669132,1672671197,2065
11252,3756536476,3417431173,1672668050,1672668664,614
11717,3778479297,3512490032,1672702763,1672705496,2733
10459,3711518637,3772114731,1672683983,1672685166,1183
9883,3388537708,3475830203,1672652263,1672654626,2363
10342,3300238532,3282240901,1672603001,1672606408,3407
9950,3776122272,3228477490,1672655271,1672657438,2167
9912,3233993993,3483078667,1672560567,1672560804,237
10253,3714902042,3359012188,1672563942,1672564914,972
11105,3505521491,3379076106,1672590038,1672593582,3544
10109,3311771689,3297624618,1672696522,1672699296,2774
10590,3772569860,3395069149,1672670633,1672673344,2711
10052,3733423371,3403120725,1672553701,1672556861,3160
11634,3681504869,3517551721,1672688300,1672690905,2605
10920,3248409083,3515548696,1672640548,1672641110,562
10603,3977157565,3773378103,1672671718,1672671937,219
10231,3701893620,3514515499,1672589544,1672591066,1522
10652,3770441717,3505331014,1672674386,1672676548,2162
11458,3512411326,3273242177,1672675566,1672678886,3320
11030,3776953418,3499998389,1672594702,1672597191,2489
10268,3505438826,3241593146,1672588981,1672591893,2912
11183,3446575109,3780563627,1672545177,1672545761,584
11158,3756297396,3733870816,1672593468,1672594450,982
9963,3730600658,3238779889,1672676789,1672679758,2969
11629,3603682643,3505183641,1672593421,1672597008,3587
11534,3338195686,3510368377,1672562470,1672565639,3169
11571,3791974273,3683562111,1672678026,1672680190,2164
11423,3807584987,3453464785,1672532899,1672535187,2288
11171,3779468781,3289017988,1672584314,1672586112,1798
10689,3716676869,3935569749,1672644510,1672644960,450
10127,3757604311,3512480125,1672663891,1672665134,1243
9837,3447078933,3471585513,1672534493,1672537545,3052
11788,3471177177,3281148858,1672696798,1672699115,2317
10637,3471177177,3351728355,1672605944,1672607913,1969
10494,3305727497,3517380144,1672595528,1672597790,2262
10435,3450735824,3755357292,1672654977,1672657087,2110
10134,3468343480,3339331632,1672571050,1672572078,1028
9939,3512744657,3622458047,1672623533,1672625361,1828
9849,3520165730,3613216900,1672675575,1672677658,2083
11230,3792008302,3505571800,1672588355,1672588930,575
10905,3513384042,3755584983,1672669852,1672671999,2147
10806,3423147369,3285201542,1672566680,1672567108,428
10072,3509360869,3279726491,1672537018,1672538628,1610
11655,3806720019,3880562532,1672695756,1672696509,753
11214,3513143959,3339478490,1672626221,1672629557,3336
10569,3815700240,3434452046,1672657127,1672658283,1156
11625,3205113625,3444453261,1672641676,1672644593,2917
10378,3533777032,3515802579,1672563344,1672563845,501
10715,3711223297,3903994989,1672640380,1672643918,3538
11095,3737467358,3450164574,1672646094,1672648947,2853
10773,3907088952,3792432763,1672687932,1672688502,570
10389,3295691964,3896840409,1672593269,1672595040,1771
11146,3342027511,3505491969,1672639108,1672640861,1753
11422,3271762055,3975799349,1672562355,1672562472,117
10694,3513996288,3918126468,1672635359,1672637201,1842
10737,3783651407,3822786416,1672626867,1672627982,1115
10012,3895422995,3229890340,1672656433,1672658085,1652
10293,3778273230,3500057674,1672675217,1672675361,144
11187,3710919244,3931495845,1672542495,1672543985,1490
9897,3636015050,3703502114,1672624082,1672625036,954
9828,3780352400,3711718368,1672640022,1672640955,933
10844,3277634944,3311410533,1672630769,1672631253,484
10765,3668855144,3613940925,1672700629,1672703978,3349
11098,3442181067,3514737648,1672597656,1672600295,2639
11191,3714065165,3330799389,1672534706,1672536752,2046
10936,3353194923,3701841013,1672622622,1672624755,2133
11649,3853386575,3423800775,1672625270,1672628198,2928
10947,3714525519,3682150740,1672542743,1672545890,3147
10697,3287734830,3776950532,1672698006,1672698458,452
10960,3772461583,3710223875,1672658456,1672660208,1752
10616,3501963428,3755779925,1672592381,1672595669,3288
10944,3820922991,3755342153,1672675440,1672676372,932
11596,3777932581,3760069457,1672637601,1672640682,3081
10756,3716541851,3472561941,1672604686,1672604842,156
11606,3534284132,3971289056,1672590899,1672592786,1887
11188,3880562532,3774221318,1672533374,1672533475,101
10911,3500864577,3791532324,1672654586,1672657310,2724
10687,3774652449,3373018943,1672571661,1672572048,387
10017,3500096103,3514244308,1672660392,1672661094,702
10544,3772882440,3818461836,1672659087,1672661582,2495
10652,3406132280,3772966919,1672534945,1672535461,516
11254,3459799131,3520832066,1672606544,1672609320,2776
11478,3770595035,3534374523,1672591916,1672592277,361
11558,3774921252,3519521903,1672603316,1672606844,3528
10805,3343616490,3930475498,1672622996,1672623635,639
10179,3228033254,3447938130,1672634768,1672637045,2277
11441,3793081195,3274239253,1672559426,1672560223,797
11201,3713875941,3682906048,1672662137,1672663976,1839
11542,3703624327,3710487368,1672616959,1672619886,2927
11081,3499998389,3711613085,1672589624,1672590833,1209
11552,3421956717,3274894848,1672656485,1672656999,514
10453,3636877469,3783277159,1672565123,1672567977,2854
11577,3223796145,3231654754,1672629074,1672629767,693
9878,3774744663,3312733562,1672633996,1672637315,3319
10634,3511526885,3554437212,1672696423,1672698361,1938
10162,3617771673,3630802959,1672686434,1672687914,1480
11606,3511608609,3533960602,1672569484,1672570967,1483
11780,3341129425,3417223898,1672602332,1672603788,1456
11137,3668369938,3852992961,1672566799,1672567911,1112
10432,3779609338,3450342110,1672569873,1672571104,1231
10584,3686211958,3776440009,1672665411,1672667958,2547
11299,3222357355,3299847117,1672660656,1672663860,3204
11660,3818461836,3287760230,1672606784,1672610241,3457
10449,3284334297,3703419800,1672645373,1672645451,78
10501,3934564437,3792012147,1672646291,1672649307,3016
11532,3801501384,3275975921,1672674603,1672677710,3107
9900,3685877449,3404375908,1672566165,1672568543,2378
10508,3971282455,3554317844,1672652932,1672655032,2100
10720,3755218683,3241855333,1672551831,1672552085,254
10385,3513215373,3851810349,1672552035,1672555435,3400
11556,3832745283,3919994216,1672544209,1672545322,1113
10729,3713611960,3511218261,1672654895,1672657925,3030
10237,3519356606,3757199889,1672582821,1672583713,892
10526,3716460706,3716733618,1672549122,1672551248,2126
11224,3310737478,3856552205,1672680023,1672680499,476
11341,3755507566,3500178849,1672574695,1672578165,3470
10888,3886837151,3710397477,1672649809,1672652523,2714
10330,3772234939,3515047288,1672541659,1672544173,2514
9975,3505811269,3881579907,1672660548,1672661150,602
11345,3970265139,3605760561,1672597868,1672599630,1762
10563,3505839395,3239279744,1672616629,1672618112,1483
10313,3850005949,3757598610,1672626784,1672628317,1533
10693,3509508477,3510795808,1672593509,1672594737,1228
10894,3791434207,3330238204,1672596969,1672600518,3549
10590,3928076270,3515803462,1672663512,1672664288,776
10217,3773041843,3533154906,1672552122,1672555673,3551
11030,3510775046,3520506192,1672560227,1672561947,1720
9821,3888057649,3624872714,1672645414,1672648866,3452
11445,3891586951,3791581138,1672658352,1672661755,3403
10200,3899205452,3793822639,1672565991,1672567172,1181
11405,3519055736,3791542842,1672690561,1672691518,957
9812,3303432071,3776407517,1672597591,1672601030,3439
11780,3714142299,3497562878,1672577536,1672581020,3484
10123,3338016147,3760679372,1672617555,1672619116,1561
11145,3341311972,3856897914,1672557130,1672557892,762
10320,3491758029,3516249472,1672675573,1672675769,196
10201,3636852764,3851515560,1672625930,1672626965,1035
10811,3284483177,3511004622,1672690397,1672693372,2975
11390,3710260848,3368441333,1672667517,1672670257,2740
11527,3376842515,3914740937,1672650733,1672653358,2625
10205,3517797610,3513384042,1672582077,1672584790,2713
11727,3711765138,3899903158,1672605090,1672608127,3037
10661,3304252969,3711076751,1672632516,1672634893,2377
10330,3755119166,3773554767,1672547120,1672548191,1071
9977,3236360179,3273674596,1672689053,1672689523,470
10047,3450735824,3773554767,1672573433,1672573751,318
10291,3713906305,3755769731,1672547320,1672549091,1771
9817,3509382404,3305657559,1672546303,1672548442,2139
10358,3770424941,3735197034,1672664882,1672666295,1413
11479,3513140146,3513203127,1672568546,1672568987,441
10268,3515259326,3780148144,1672622507,1672624267,1760
10661,3757869138,3792497486,1672541286,1672543148,1862
10323,3757407184,3371132167,1672641444,1672643246,1802
9866,3660257653,3854229296,1672619229,1672620760,1531
9821,3809207482,3370512945,1672654306,1672655890,1584
11248,3715196780,3711258452,1672701763,1672704540,2777
11221,3224053074,3372617110,1672681884,1672684060,2176
11016,3534624672,3772786559,1672559920,1672561778,1858
11636,3534122907,3500630465,1672655543,1672658727,3184
10652,3472561941,3776053084,1672554868,1672557586,2718
11201,3472173212,3710271021,1672647799,1672650429,2630
10013,3714250543,3289258397,1672677270,1672677871,601
11214,3359351267,3207586072,1672563408,1672565600,2192
11331,3500928990,3408982612,1672553423,1672555554,2131
10661,3500776597,3755670258,1672698685,1672702261,3576
10007,3241567995,3792682835,1672551189,1672553184,1995
10244,3779503296,3792455305,1672596052,1672598577,2525
11246,3772343750,3272328752,1672614332,1672615258,926
9843,3402338011,3837885956,1672564625,1672567936,3311
11451,3792785261,3635599307,1672547850,1672550527,2677
10269,3534758256,3500928990,1672696619,1672699072,2453
9971,3467415939,3774090455,1672638476,1672640287,1811
11791,3616371564,3710173412,1672601243,1672604215,2972
11536,3703697059,3517530943,1672686701,1672689056,2355
10306,3371564186,3491104534,1672676497,1672677121,624
10738,3515753241,3442403264,1672673352,1672673860,508
9801,3518408734,3714645218,1672671176,1672673281,2105
11561,3703722212,3812880543,1672703815,1672704285,470
11460,3688870751,3501550490,1672637997,1672640293,2296
10937,3354968884,3682150740,1672668792,1672671577,2785
11289,3519831322,3716526314,1672554257,1672555708,1451
10846,3360972732,3715680249,1672542504,1672545672,3168
10531,3774792696,3208894215,1672552714,1672554094,1380
11359,3559112196,3512133625,1672573997,1672575744,1747
11276,3793332600,3772844451,1672623325,1672624604,1279
11783,3533009565,3701596047,1672660611,1672663506,2895
11494,3400903513,3516706121,1672602114,1672605555,3441
11112,3518164450,3404187438,1672654151,1672656243,2092
11254,3381244346,3711770853,1672534938,1672537844,2906
10938,3437934509,3853386575,1672622825,1672623641,816
11696,3756157377,3855209450,1672561617,1672562894,1277
9872,3497138014,3820422111,1672539560,1672542609,3049
10350,3793949077,3442181067,1672672692,1672676061,3369
9882,3474350534,3666367524,1672699138,1672701336,2198
11616,3783651407,3774359137,1672592082,1672592400,318
10038,3711367577,3922409420,1672702842,1672705912,3070
10019,3701065296,3500741534,1672676987,1672679284,2297
11271,3205161801,3377250778,1672538490,1672542086,3596
10742,3433189219,3777405860,1672681043,1672681983,940
11013,3685396470,3818904268,1672610451,1672612674,2223
11229,3440582836,3701770921,1672613054,1672615768,2714
10924,3240443426,3444453261,1672546004,1672547893,1889
10519,3711804184,3201573194,1672551414,1672553132,1718
10008,3313824913,3500630465,1672541246,1672542237,991
11300,3500590302,3515304526,1672700690,1672701249,559
11481,3685083275,3510486220,1672586540,1672589419,2879
10283,3512492332,3520344592,1672576238,1672577507,1269
11106,3857590978,3893950585,1672690351,1672690596,245
11106,3513816744,3289017988,1672535820,1672536649,829
10390,3428788958,3452024572,1672593460,1672595584,2124
11032,3205687719,3792455305,1672554365,1672555600,1235
9976,3517113478,3619676231,1672548518,1672550838,2320
11686,3388463477,3509701363,1672629288,1672632884,3596
11574,3619796619,3886896755,1672619261,1672620822,1561
10457,3687024828,3372236721,1672541094,1672544244,3150
10356,3500630465,3472718723,1672541778,1672544248,2470
11613,3304227085,3834456158,1672650244,1672651734,1490
10343,3783408469,3793274846,1672647149,1672647252,103
11332,3461741050,3510758718,1672596497,1672596973,476
11014,3520022175,3272328752,1672540530,1672542607,2077
10619,3814672661,3500536897,1672659543,1672662986,3443
10565,3780298499,3500909455,1672682222,1672683069,847
11446,3285971415,3453164933,1672624584,1672624772,188
10192,3703277359,3480270940,1672696788,1672700085,3297
9882,3608214600,3601340045,1672692953,1672696540,3587
10266,3510758718,3713923960,1672540435,1672541548,1113
11439,3368441333,3500654356,1672654631,1672656485,1854
11156,3511794841,3519162582,1672537728,1672538534,806
10787,3852275715,3824259677,1672577615,1672579179,1564
10009,3831981073,3505117019,1672601281,1672603525,2244
9970,3272328752,3776193847,1672568834,1672571707,2873
11204,3511663572,3510836047,1672604435,1672605998,1563
11537,3511883778,3756717136,1672646632,1672649546,2914
10762,3510547682,3772751765,1672690652,1672692683,2031
10866,3757869138,3772250554,1672533722,1672535533,1811
10856,3245245283,3730935770,1672558756,1672559051,295
9824,3620836520,3779393140,1672672517,1672675383,2866
10588,3714067998,3853275529,1672558909,1672561862,2953
11566,3618895679,3483078667,1672555433,1672555806,373
10887,3533036499,3298113026,1672696265,1672697652,1387
10883,3518117078,3711190257,1672679777,1672682785,3008
11596,3516026189,3713416106,1672634895,1672636673,1778
11064,3519553933,3853182912,1672559525,1672561871,2346
10679,3228477490,3715602742,1672544868,1672548357,3489
11121,3487779363,3791359168,1672607340,1672608956,1616
11091,3220123678,3201419050,1672657592,1672658427,835
11628,3632303304,3288791629,1672610775,1672612831,2056
11107,3311449914,3249380931,1672581269,1672584553,3284
10440,3483347530,3792578118,1672610977,1672613866,2889
10363,3447312353,3880000841,1672594236,1672595163,927
10704,3299845453,3637105495,1672556691,1672560225,3534
11009,3791664049,3971422524,1672544554,1672547000,2446
10660,3364660506,3366501813,1672692577,1672694158,1581
11727,3774965463,3498803823,1672686363,1672688486,2123
11019,3315094386,3793814153,1672652112,1672653056,944
9874,3609925909,3738160394,1672667537,1672668398,861
11120,3737745988,3505097206,1672642424,1672643991,1567
9999,3479207976,3273242177,1672688640,1672690098,1458
10041,3757378286,3290097447,1672614274,1672615579,1305
9833,3500536897,3738760498,1672670689,1672673951,3262
11220,3402338011,3319660530,1672616186,1672619705,3519
10018,3346755179,3913847876,1672661731,1672664714,2983
11784,3772905073,3737571883,1672694763,1672694975,212
11643,3515726910,3466620548,1672623422,1672626053,2631
11545,3715712376,3533876927,1672675804,1672678372,2568
10404,3971422524,3501901313,1672686972,1672690331,3359
11242,3884369346,3517627003,1672587300,1672588776,1476
10250,3779102237,3711959141,1672679715,1672680241,526
10085,3512596743,3804075198,1672687367,1672688797,1430
11569,3791205793,3734957248,1672547029,1672548585,1556
11261,3760541837,3511095300,1672682342,1672685565,3223
10396,3505500665,3505490878,1672585335,1672586827,1492
11153,3500251781,3703104365,1672566069,1672568607,2538
10409,3287683210,3832289185,1672535018,1672537699,2681
11169,3755630085,3374348845,1672550101,1672552186,2085
10340,3519965717,3511412229,1672652154,1672653018,864
10931,3731644240,3492056330,1672579799,1672582735,2936
10707,3919494952,3663353552,1672572679,1672574745,2066
11049,3919984986,3514515499,1672697556,1672699298,1742
10596,3776122272,3715700639,1672661044,1672661205,161
11707,3534278019,3778741325,1672567268,1672570675,3407
11209,3755378125,3533929043,1672585359,1672587156,1797
11027,3773523569,3971996397,1672569251,1672570889,1638
10600,3898592058,3661856558,1672666769,1672669070,2301
10421,3793978936,3438204844,1672616347,1672617976,1629
10883,3510775046,3933872044,1672614172,1672616676,2504
10744,3774205060,3245755569,1672699952,1672701129,1177
10668,3681701931,3774706478,1672605892,1672607855,1963
10629,3609335008,3505173665,1672647767,1672650530,2763
10223,3715852330,3492350318,1672539406,1672540445,1039
10345,3711367577,3245642576,1672641606,1672644382,2776
10014,3783679478,3895839169,1672693111,1672694568,1457
9974,3933872044,3812277991,1672549796,1672551975,2179
11215,3773024346,3605591994,1672535107,1672537248,2141
10412,3458130310,3711219767,1672681909,1672684064,2155
10223,3510484107,3514033319,1672576403,1672577881,1478
11225,3236254381,3384001094,1672545513,1672546193,680
10586,3520725149,3737946004,1672582589,1672583081,492
11159,3736621212,3755411110,1672692741,1672696032,3291
11078,3932491622,3516167000,1672576107,1672577918,1811
11100,3336501403,3390537737,1672626753,1672629312,2559
10468,3500630465,3246296769,1672683163,1672683965,802
11551,3287094447,3711599043,1672591451,1672593116,1665
10313,3770924034,3514673213,1672582924,1672584482,1558
10822,3509677530,3730414796,1672623808,1672624064,256
11085,3777932225,3534278019,1672621224,1672623664,2440
10513,3493047640,3774326754,1672667781,1672669800,2019
10362,3660980656,3284829602,1672626974,1672627471,497
10915,3501843187,3516153301,1672613742,1672614055,313
10508,3477511446,3221126799,1672685227,1672686505,1278
11224,3805704844,3757732853,1672587496,1672590350,2854
10946,3393128259,3792289287,1672679075,1672680708,1633
10866,3385416697,3475845921,1672607737,1672610407,2670
11744,3493515706,3777135415,1672537028,1672537300,272
11364,3805718871,3500579482,1672601025,1672601134,109
11754,3552309108,3783679478,1672595370,1672596878,1508
9897,3342031426,3229465607,1672537794,1672538467,673
10641,3351837521,3518425740,1672560752,1672561073,321
10857,3791359168,3757924067,1672642707,1672646242,3535
10442,3518335611,3739297004,1672612039,1672613547,1508
11191,3511794841,3605905645,1672675136,1672677056,1920
11630,3352057037,3511095300,1672598590,1672600141,1551
10472,3772343750,3400793223,1672618068,1672618209,141
10910,3682086200,3515803462,1672702648,1672704573,1925
11739,3332124606,3501600785,1672603819,1672603997,178
10627,3792475476,3755075988,1672676447,1672677229,782
11303,3424425746,3615742989,1672700903,1672703805,2902
11771,3772234939,3388774559,1672558609,1672559163,554
10076,3792930090,3834949242,1672544133,1672547331,3198
10683,3780680252,3428878402,1672551552,1672554454,2902
10556,3465690527,3511199555,1672584413,1672587489,3076
10085,3488333295,3337673625,1672633158,1672633695,537
10699,3928421417,3755075988,1672680225,1672681396,1171
9968,3732596503,3715441786,1672652659,1672656122,3463
11520,3777204977,3274239253,1672552091,1672553648,1557
10394,3201920708,3490804766,1672668754,1672670826,2072
10148,3494748808,3505756991,1672562128,1672565386,3258
10330,3791409441,3452024572,1672622751,1672625583,2832
11593,3505266343,3880637958,1672701252,1672703158,1906
11192,3609103278,3516777819,1672666258,1672667735,1477
10552,3307997700,3514450836,1672665117,1672665970,853
11129,3732871856,3458753033,1672598042,1672599241,1199
10778,3774652449,3779340538,1672613150,1672614234,1084
10690,3716633983,3514698862,1672552729,1672554171,1442
10702,3271780525,3908550561,1672607157,1672608010,853
11397,3716423829,3778044082,1672697134,1672699239,2105
10859,3475090917,3628556590,1672546880,1672547503,623
11064,3791688526,3319061210,1672590495,1672592349,1854
11612,3791628195,3520160414,1672685482,1672688190,2708
11791,3826068495,3247845642,1672617321,1672618106,785
11057,3638050763,3338195686,1672537224,1672539065,1841
11280,3755342153,3367262509,1672664931,1672667758,2827
11377,3519228207,3711131262,1672597301,1672600625,3324
10099,3711947828,3925208102,1672552183,1672555213,3030
11706,3337673625,3850181934,1672632237,1672635089,2852
11298,3449672240,3632189887,1672598407,1672599918,1511
11427,3556684272,3247845642,1672702630,1672704976,2346
10415,3792455305,3612705426,1672547488,1672551033,3545
11001,3733836732,3293898029,1672544529,1672545864,1335
9902,3346755179,3757773786,1672601990,1672605392,3402
11063,3792627762,3226761201,1672684195,1672687675,3480
10917,3475033290,3337675386,1672688082,1672688293,211
10121,3478915403,3818236682,1672575045,1672577604,2559
10410,3668202976,3229570647,1672639267,1672640061,794
10463,3669418238,3441737317,1672562625,1672564292,1667
9995,3311264420,3477951091,1672638706,1672642187,3481
10872,3304227085,3313795594,1672586288,1672589292,3004
11639,3515304526,3207497598,1672655310,1672656776,1466
10446,3779413388,3303552616,1672573844,1672575834,1990
10471,3885147558,3416474842,1672608769,1672611586,2817
11666,3501901313,3425260097,1672662896,1672663769,873
9801,3382308738,3512337054,1672609748,1672610462,714
10020,3793948300,3509433155,1672532022,1672534804,2782
10798,3513624915,3514216460,1672613335,1672614746,1411
11093,3760396348,3738734246,1672574616,1672574692,76
10922,3510153173,3519319233,1672647705,1672648449,744
10096,3602570831,3500864577,1672696859,1672699067,2208
9980,3516792348,3500654356,1672561497,1672561882,385
11460,3689386663,3703476890,1672576199,1672576765,566
11584,3779102237,3772019557,1672697918,1672699670,1752
10407,3512492332,3711029952,1672695885,1672696612,727
10211,3311626308,3246567963,1672567277,1672569904,2627
9935,3370961012,3920606331,1672625466,1672626242,776
11384,3701377471,3356972733,1672645554,1672646469,915
11446,3491390365,3513432588,1672612951,1672615506,2555
11083,3778817220,3909067335,1672700463,1672703728,3265
10264,3358385652,3361635547,1672694548,1672696403,1855
10606,3347172556,3534604516,1672593168,1672595061,1893
11768,3500429731,3533209168,1672557003,1672558567,1564
11029,3375905193,3369482983,1672703998,1672706859,2861
10758,3371238318,3509556649,1672600784,1672603200,2416
10688,3703104365,3202787155,1672585845,1672587224,1379
11032,3733796228,3828354855,1672642260,1672642653,393
11280,3973134902,3509379617,1672677892,1672681066,3174
10410,3287403291,3779665641,1672699142,1672699314,172
10421,3515939841,3711243126,1672695137,1672697841,2704
10641,3227647190,3756695502,1672663410,1672665340,1930
10831,3972442654,3511969443,1672698920,1672700882,1962
10044,3274739459,3450621820,1672667626,1672668419,793
11256,3477248170,3774401596,1672616297,1672617200,903
9881,3284374600,3510547682,1672675174,1672677654,2480
11755,3393001196,3340321384,1672606022,1672607716,1694
9932,3462153833,3733836732,1672658102,1672659533,1431
11255,3518989186,3479207976,1672531354,1672534781,3427
10287,3510916875,3517991042,1672688642,1672691480,2838
9928,3512251592,3518058151,1672699876,1672700900,1024
10516,3779427180,3885422379,1672548167,1672551170,3003
10703,3534812391,3387621912,1672608820,1672611056,2236
11216,3501901313,3791584994,1672548332,1672549820,1488
11100,3289771213,3359929534,1672551577,1672551950,373
11087,3417223898,3922786716,1672595471,1672596866,1395
11087,3902023467,3621629499,1672584206,1672586121,1915
10416,3757446082,3757592622,1672659528,1672659756,228
11092,3806034626,3791698084,1672590749,1672593985,3236
10574,3220798451,3774627091,1672594721,1672595233,512
11760,3791509881,3387322545,1672578723,1672581193,2470
9896,3716733618,3680075399,1672589546,1672591793,2247
11530,3479207976,3513740840,1672661745,1672662903,1158
11298,3390537737,3701453343,1672613701,1672615518,1817
10078,3921736061,3883640454,1672647501,1672650839,3338
9908,3505901826,3499142934,1672534287,1672537003,2716
10457,3686644062,3701893620,1672542801,1672543784,983
10613,3509297453,3632094087,1672642249,1672644511,2262
10968,3500438542,3509274030,1672619856,1672621900,2044
11732,3424997707,3793783685,1672552310,1672554473,2163
10546,3492064037,3343698137,1672683397,1672684177,780
10185,3733411026,3606804618,1672629765,1672630022,257
11504,3432050858,3802374620,1672562734,1672566055,3321
10781,3880882684,3756066765,1672698753,1672700655,1902
10669,3519352855,3818461836,1672654566,1672656552,1986
10217,3511750695,3500994763,1672682892,1672686428,3536
10320,3247845642,3773848111,1672657314,1672658858,1544
11364,3240443426,3420854927,1672539583,1672540506,923
10516,3520824937,3224824355,1672582765,1672584441,1676
10087,3711844574,3773344258,1672558658,1672561121,2463
10530,3711430738,3492350318,1672587509,1672589286,1777
10128,3308744016,3375906394,1672621735,1672624760,3025
10926,3510795808,3343767438,1672676712,1672679761,3049
10497,3288346356,3380167818,1672561960,1672564901,2941
11276,3488399075,3600441934,1672668631,1672669769,1138
11712,3778741325,3342426430,1672547181,1672547672,491
11163,3554317844,3511412229,1672595721,1672599251,3530
11258,3514564903,3715039960,1672665040,1672665109,69
11411,3975796415,3288675710,1672593265,1672594422,1157
9865,3669918958,3733953055,1672572789,1672573744,955
11067,3302929858,3780941637,1672651578,1672652024,446
11028,3783043346,3774029494,1672587379,1672587577,198
11191,3512154443,3777928067,1672604540,1672606859,2319
10969,3372617110,3533728729,1672666606,1672670023,3417
10035,3520763492,3739820448,1672668800,1672671086,2286
11179,3520694387,3313824913,1672569510,1672571743,2233
10474,3773852157,3922301238,1672634980,1672637166,2186
11301,3806034626,3520344592,1672541167,1672542451,1284
9901,3915195160,3518478484,1672532811,1672535451,2640
10787,3779413388,3852992961,1672636411,1672638710,2299
10333,3517499844,3905889514,1672593117,1672594599,1482
11271,3780500331,3936851114,1672585906,1672586606,700
11012,3281970147,3520558137,1672679825,1672683260,3435
11159,3353194923,3713740434,1672665148,1672668082,2934
11156,3756119976,3711176990,1672574421,1672577242,2821
11630,3609997804,3930501172,1672539093,1672542082,2989
11083,3774450494,3914740937,1672650629,1672651844,1215
11395,3380357490,3437108337,1672577881,1672580385,2504
11280,3458130310,3513486828,1672560454,1672563679,3225
11669,3711131262,3756525103,1672689715,1672693206,3491
11331,3639081201,3811419378,1672632575,1672634733,2158
11614,3287968403,3773408491,1672656892,1672659586,2694
9840,3310961923,3808849597,1672563343,1672563774,431
10363,3922301238,3770285500,1672627320,1672628054,734
11103,3760687922,3442564712,1672595767,1672598433,2666
11565,3446764595,3241682278,1672698861,1672699956,1095
10555,3770480149,3607583720,1672574952,1672577512,2560
9839,3505414878,3385006834,1672664181,1672665076,895
11667,3783060739,3403988682,1672620074,1672621645,1571
11386,3430399931,3520925688,1672607223,1672609952,2729
10674,3202787155,3505500665,1672690993,1672694326,3333
10184,3807646028,3755507566,1672579516,1672580400,884
10205,3285587972,3515706117,1672698789,1672700218,1429
11036,3755342153,3774145748,1672627222,1672628128,906
11540,3770533675,3311771689,1672654991,1672656927,1936
10113,3512625661,3757060033,1672564279,1672566105,1826
11634,3773041843,3510486220,1672561902,1672562169,267
10769,3492350318,3773376762,1672590620,1672591772,1152
10965,3602570831,3715602742,1672554578,1672555474,896
10880,3817478012,3714658474,1672678387,1672681659,3272
10961,3776617627,3919719755,1672679128,1672680536,1408
10643,3613936929,3908331271,1672612893,1672614133,1240
10298,3887918622,3713923960,1672678610,1672681838,3228
11744,3757406215,3778370462,1672662581,1672665766,3185
11406,3713195480,3311432176,1672702386,1672703880,1494
11789,3730226545,3516904926,1672688706,1672690869,2163
10761,3701663839,3760854788,1672537860,1672538028,168
10456,3344778261,3348100657,1672662284,1672662427,143
10499,3736036532,3245245283,1672567625,1672567800,175
9950,3857847527,3334633634,1672587831,1672588946,1115
11514,3505032644,3317989975,1672619811,1672620544,733
10586,3500695402,3434452046,1672676109,1672676198,89
11413,3661359073,3533976217,1672559126,1672560465,1339
11416,3388463477,3856897914,1672642124,1672642783,659
9982,3489205994,3713990030,1672540235,1672543181,2946
10271,3461931154,3773394570,1672620087,1672623354,3267
11006,3972196462,3474074188,1672562687,1672565430,2743
11449,3500640854,3500209015,1672617041,1672620568,3527
10774,3701449715,3500793739,1672661995,1672663976,1981
11540,3500589560,3271719569,1672548687,1672550156,1469
11682,3619676231,3298831109,1672577428,1672578291,863
10278,3511867383,3773736248,1672660142,1672661214,1072
10682,3338195686,3316117186,1672659310,1672662652,3342
10070,3244098077,3501171785,1672586202,1672586706,504
11347,3711810268,3419829238,1672690917,1672692092,1175
10330,3510149298,3533859712,1672645910,1672649019,3109
10403,3505117019,3896200048,1672582677,1672584676,1999
10422,3500589560,3501901313,1672541507,1672544317,2810
10772,3304672737,3402105276,1672680912,1672682727,1815
10611,3715587520,3372236721,1672703286,1672706483,3197
11050,3512411326,3703168159,1672667952,1672670427,2475
11227,3774355339,3791269060,1672565613,1672568708,3095
10224,3450342110,3500018566,1672599047,1672600979,1932
10002,3398075553,3617135064,1672677673,1672679846,2173
10346,3452175941,3778706119,1672617598,1672618831,1233
11543,3458271585,3714883746,1672532543,1672535536,2993
10208,3513816744,3499820963,1672683708,1672686493,2785
10080,3710271021,3501427691,1672649858,1672650834,976
11026,3630462406,3756685732,1672614549,1672617479,2930
9953,3830291558,3734957248,1672680658,1672681344,686
10636,3501554468,3311449914,1672621339,1672622610,1271
11749,3716633983,3501619113,1672591360,1672594829,3469
11162,3662507634,3776561263,1672657628,1672659825,2197
9945,3626631210,3318590083,1672548638,1672548855,217
11693,3534111498,3773083407,1672639056,1672641706,2650
9927,3774450494,3603740088,1672594060,1672594886,826
11421,3701060732,3755170743,1672602270,1672604277,2007
11376,3638823001,3274341934,1672679024,1672681477,2453
10223,3461743188,3772751765,1672559699,1672562379,2680
10423,3501370430,3355880028,1672626452,1672629696,3244
9852,3282053097,3517558635,1672621506,1672622525,1019
10782,3730935770,3791906680,1672567047,1672568860,1813
11000,3428076194,3302416197,1672693191,1672695728,2537
10670,3285201542,3461137945,1672578165,1672581411,3246
10496,3603167427,3791644831,1672556098,1672559211,3113
10498,3518209090,3770925016,1672621636,1672623200,1564
11008,3774673193,3713139039,1672599811,1672602778,2967
10739,3438470128,3229890340,1672693675,1672693812,137
9845,3472774606,3779130507,1672655083,1672657239,2156
11197,3292936094,3972729768,1672638831,1672639243,412
11293,3239082508,3534102440,1672643153,1672646631,3478
11002,3391854325,3272328752,1672655605,1672657637,2032
10512,3243056734,3714787207,1672642320,1672643807,1487
10599,3311432176,3776200012,1672603079,1672606360,3281
10999,3285136057,3757823215,1672562406,1672562812,406
10777,3925792265,3622458047,1672554968,1672556420,1452
11792,3783651407,3685877449,1672661293,1672663452,2159
10719,3772296376,3247075753,1672685558,1672685977,419
11781,3779951373,3682673884,1672549359,1672551411,2052
11279,3793003432,3220987526,1672624899,1672626632,1733
10178,3501873139,3756736726,1672668706,1672669533,827
10124,3760854788,3783651407,1672696535,1672699860,3325
11631,3776617627,3318590083,1672692350,1672695389,3039
10375,3711404205,3472774606,1672587302,1672587795,493
10101,3312959324,3856975623,1672585764,1672587313,1549
9894,3355430975,3972442654,1672698206,1672699237,1031
10469,3925098136,3777063455,1672615858,1672616456,598
9998,3520832066,3895944547,1672539399,1672540185,786
10298,3777751979,3935569749,1672531634,1672534825,3191
10709,3534362749,3819315404,1672621006,1672623317,2311
10001,3774145748,3776581518,1672697552,1672698400,848
11652,3686885442,3915460293,1672669330,1672672153,2823
9840,3239401337,3501573548,1672564962,1672566554,1592
10711,3760529327,3925175853,1672656484,1672660048,3564
10328,3516257130,3793407883,1672699375,1672701790,2415
10498,3352044245,3919211457,1672551811,1672552114,303
11223,3756647451,3778479297,1672625623,1672627889,2266
11014,3770981604,3711889178,1672595854,1672596558,704
10283,3701291994,3755357292,1672560105,1672562544,2439
11774,3279726491,3701065296,1672660766,1672661775,1009
11311,3772216305,3516472352,1672536973,1672538955,1982
9944,3713726267,3511245705,1672612783,1672615274,2491
10716,3501550490,3551972633,1672540635,1672542826,2191
11233,3505839395,3315432466,1672654558,1672655522,964
11143,3501759031,3494680853,1672604619,1672607145,2526
11493,3923524564,3384170206,1672630365,1672630804,439
11196,3792719263,3713159131,1672599380,1672601559,2179
11591,3793949077,3756079870,1672666663,1672668950,2287
10034,3713694278,3780294116,1672655452,1672655672,220
11065,3429587594,3760901975,1672696466,1672699686,3220
10189,3756642173,3278251248,1672586569,1672586779,210
10914,3282240901,3408408584,1672545797,1672549034,3237
11163,3600699873,3402105276,1672602186,1672605432,3246
10203,3686644062,3716976932,1672542942,1672545550,2608
10034,3933106901,3207748225,1672698087,1672701536,3449
10780,3304697982,3311924005,1672564813,1672565522,709
10037,3518947256,3755922811,1672623443,1672623892,449
10667,3851451801,3515984911,1672539601,1672541389,1788
11071,3780435349,3440770466,1672690696,1672691220,524
10663,3519553933,3371132167,1672697708,1672699871,2163
10460,3417268745,3311602936,1672545987,1672546270,283
11323,3551972633,3505291330,1672581997,1672584904,2907
11766,3779478448,3292936094,1672657046,1672657499,453
10820,3340321384,3513213122,1672569594,1672572091,2497
11176,3513215373,3461877104,1672664131,1672665071,940
10832,3756437169,3773603836,1672702279,1672703319,1040
10458,3638071975,3713170867,1672567108,1672568151,1043
10194,3509626590,3756998113,1672577782,1672577889,107
10123,3778195766,3780563627,1672557733,1672559985,2252
10827,3823307824,3225554956,1672570452,1672572230,1778
10700,3284407073,3318220119,1672615395,1672617833,2438
11665,3971280379,3716160006,1672592136,1672594782,2646
10992,3615846003,3936486724,1672626895,1672628203,1308
11699,3880000841,3447078933,1672615282,1672617195,1913
10554,3203876438,3509828883,1672582943,1672584462,1519
10287,3516777819,3235198316,1672670402,1672671395,993
10733,3512700007,3511415786,1672701582,1672702675,1093
10050,3760416450,3227206772,1672539015,1672542344,3329
10834,3907245259,3500011591,1672693080,1672696208,3128
10560,3367202274,3436018575,1672643869,1672646280,2411
10564,3681737865,3400903513,1672553148,1672556135,2987
10671,3316821313,3520155898,1672696244,1672696566,322
11335,3938129916,3780680252,1672648965,1672651908,2943
9995,3373018943,3791368349,1672671055,1672672285,1230
10827,3500209015,3715680249,1672678391,1672679189,798
10761,3422205569,3777928067,1672618399,1672619429,1030
11337,3371759044,3716676869,1672572355,1672575736,3381
11454,3278779955,3778695895,1672623134,1672623999,865
10301,3756675909,3516965624,1672626305,1672626413,108
11255,3517645656,3818461836,1672680342,1672682345,2003
10622,3335353798,3776122272,1672546385,1672549376,2991
10537,3823600319,3500251781,1672593793,1672594365,572
9998,3772169046,3773636983,1672656540,1672659324,2784
11554,3512133625,3770533588,1672583638,1672587100,3462
11280,3276230295,3510694464,1672572989,1672575295,2306
11462,3343698137,3735679000,1672642802,1672646127,3325
10074,3240877710,3701171318,1672591359,1672592453,1094
9913,3710149975,3290060215,1672548843,1672550763,1920
10273,3757393413,3533628528,1672697799,1672699677,1878
10917,3351856699,3858497718,1672638651,1672641529,2878
10722,3685396470,3290797257,1672680849,1672684173,3324
10603,3664719070,3667950469,1672617011,1672619832,2821
10472,3976742903,3340723781,1672553488,1672554109,621
11404,3756363182,3711613085,1672616707,1672617265,558
10868,3772055279,3516668203,1672605780,1672607392,1612
11684,3772019557,3420983899,1672695517,1672698133,2616
11142,3338465050,3516034245,1672569199,1672569918,719
10665,3510939082,3801501384,1672573244,1672575175,1931
11228,3682086200,3283106998,1672601371,1672603916,2545
11692,3714067998,3812261241,1672590897,1672592176,1279
11048,3516335333,3606688595,1672537628,1672539554,1926
10944,3398489033,3684199077,1672659958,1672662212,2254
10443,3492350318,3930475498,1672607857,1672611065,3208
10135,3533841983,3776124041,1672585380,1672586201,821
11532,3238056215,3416079461,1672663620,1672664559,939
11288,3311231911,3501205057,1672598649,1672600822,2173
10277,3307236682,3915962248,1672677705,1672679541,1836
11327,3424425746,3783651407,1672652822,1672653165,343
9909,3304697982,3334482021,1672629379,1672630076,697
11038,3294952405,3792682835,1672690359,1672690691,332
10043,3783594246,3783122313,1672672335,1672673919,1584
11629,3514005973,3760346746,1672667500,1672667834,334
11501,3416225867,3310702648,1672670561,1672674114,3553
11411,3516019206,3500814753,1672694109,1672695571,1462
10749,3512546783,3772114731,1672697429,1672699449,2020
10089,3519951586,3757407184,1672616909,1672619192,2283
10525,3246971044,3445406685,1672552929,1672555488,2559
10622,3479910993,3533841983,1672557657,1672558349,692
11522,3884933821,3305657559,1672589621,1672590830,1209
9999,3304661369,3776447604,1672563548,1672565906,2358
10272,3791435852,3442073613,1672621016,1672622414,1398
10020,3534758256,3224040894,1672650022,1672652261,2239
11581,3686860179,3408982612,1672620569,1672622803,2234
10870,3791994414,3714264759,1672560741,1672562968,2227
10812,3813853446,3339649817,1672650397,1672651075,678
10459,3350966326,3757924067,1672602628,1672604492,1864
11041,3791289855,3338642026,1672554560,1672556543,1983
11073,3509208005,3405303958,1672651204,1672652362,1158
10484,3774702364,3516472352,1672656138,1672656894,756
10138,3770966950,3660163550,1672701379,1672702538,1159
11700,3514941815,3885147558,1672672413,1672675451,3038
10918,3772216305,3688410383,1672694592,1672696208,1616
11647,3776125503,3459799131,1672559039,1672561808,2769
11670,3770019143,3364683368,1672558322,1672558785,463
10071,3500654356,3683514731,1672674731,1672675658,927
10080,3686853863,3290797257,1672636565,1672638207,1642
10423,3534111498,3773024346,1672558326,1672559171,845
11004,3492064037,3285971415,1672637521,1672641061,3540
9990,3499343927,3620105539,1672535511,1672538000,2489
11420,3711599043,3500536897,1672561241,1672562461,1220
10313,3457249798,3805268739,1672544651,1672546331,1680
10031,3780435349,3625400710,1672622328,1672623163,835
11662,3500693568,3732128078,1672650191,1672651196,1005
10810,3511963020,3461931154,1672537088,1672539116,2028
11470,3714923092,3979115924,1672541716,1672544373,2657
11099,3791628263,3711131262,1672671824,1672672475,651
10195,3715897627,3836757034,1672542962,1672544515,1553
10696,3927675706,3714690161,1672665678,1672666637,959
10736,3777387533,3518794921,1672545327,1672546967,1640
10012,3512154443,3919349138,1672547958,1672550490,2532
10819,3511883778,3701725839,1672558170,1672560390,2220
11157,3207586072,3203457161,1672554588,1672557917,3329
10626,3452878062,3716740576,1672682040,1672685326,3286
10118,3510869438,3344778261,1672662191,1672665155,2964
11347,3505547832,3927675706,1672621879,1672623149,1270
11266,3774744663,3701519251,1672672935,1672675814,2879
11792,3447253775,3381055770,1672653862,1672657049,3187
9940,3473520701,3445558740,1672613657,1672614919,1262
11456,3777931341,3513215373,1672604486,1672605217,731
11079,3974668678,3500456339,1672680670,1672684206,3536
10293,3396440259,3937299996,1672618722,1672621790,3068
11130,3505416534,3629248353,1672595745,1672598434,2689
10166,3710813103,3777992576,1672696395,1672698335,1940
10696,3776791436,3514515499,1672626617,1672626851,234
10982,3755361692,3318224774,1672613843,1672614123,280
10031,3734957248,3519435459,1672678809,1672681703,2894
10565,3369482983,3484490325,1672674043,1672675296,1253
10847,3474852115,3783067048,1672565342,1672567502,2160
10440,3249614888,3334936138,1672587724,1672588142,418
10398,3837887478,3703572036,1672625136,1672626477,1341
11334,3792627762,3821103640,1672676256,1672677414,1158
11695,3883640454,3501004005,1672619072,1672622011,2939
9833,3931164237,3898592058,1672619562,1672620093,531
11461,3311200541,3837271330,1672563726,1672566168,2442
11221,3500640854,3714787207,1672694822,1672697738,2916
10277,3534491112,3793860209,1672628975,1672630796,1821
11337,3975799349,3855209450,1672540626,1672541247,621
11188,3772882440,3899205452,1672534154,1672536637,2483
10869,3929446196,3770105006,1672648788,1672651214,2426
11130,3511341866,3627377299,1672677450,1672677546,96
11020,3774921252,3458432407,1672580379,1672581064,685
11045,3896622009,3459694275,1672656310,1672658378,2068
10279,3600978954,3757796416,1672543322,1672544884,1562
10352,3715114417,3295710494,1672624901,1672626757,1856
10161,3553640169,3500019810,1672554350,1672556587,2237
9879,3897851509,3311045951,1672562358,1672563138,780
11041,3774483862,3971422524,1672587702,1672590854,3152
9908,3505245692,3858497718,1672649016,1672649809,793
11557,3711770853,3909822999,1672672054,1672673643,1589
11109,3454151554,3514585995,1672665304,1672667200,1896
10834,3417431173,3902292032,1672625062,1672627249,2187
9992,3410602007,3783176874,1672557542,1672560191,2649
10577,3777655401,3514853709,1672543800,1672546166,2366
10340,3772648837,3715590997,1672605506,1672609008,3502
10260,3238796398,3774450494,1672661283,1672664150,2867
10045,3512753567,3407734098,1672534440,1672534564,124
10305,3711959141,3711223297,1672618384,1672621526,3142
11342,3773840321,3731905251,1672581759,1672585268,3509
11368,3757623259,3903994989,1672553214,1672554168,954
10210,3505331014,3600441934,1672641436,1672644571,3135
10376,3533960602,3307997700,1672689135,1672692585,3450
11501,3468343480,3343859998,1672679262,1672681638,2376
11334,3559125467,3248061684,1672674428,1672675326,898
11155,3311696372,3715261950,1672696392,1672698182,1790
11736,3513740840,3365839890,1672601837,1672603198,1361
10100,3907088952,3703624327,1672558286,1672558579,293
10485,3778924002,3812677669,1672628851,1672630946,2095
11641,3516815069,3512492332,1672607040,1672609621,2581
10793,3272838634,3301449986,1672633009,1672634099,1090
10896,3755273361,3239401337,1672670207,1672673434,3227
10198,3757592622,3382746533,1672544873,1672546061,1188
11369,3466492108,3511969443,1672566366,1672569525,3159
11153,3444881567,3920606331,1672581829,1672584298,2469
11008,3780294116,3921138062,1672594743,1672596471,1728
11266,3756079870,3332010532,1672538935,1672540928,1993
10179,3424988692,3424476995,1672622623,1672623270,647
10451,3500087325,3304592684,1672670675,1672671550,875
10405,3435342362,3517358336,1672692644,1672694338,1694
10205,3662354016,3600699873,1672641375,1672641766,391
11202,3681701931,3520697518,1672674784,1672677821,3037
10980,3236360179,3482687604,1672691767,1672692776,1009
9908,3479402555,3917004141,1672573904,1672576467,2563
11715,3710919244,3509317054,1672566657,1672569789,3132
10428,3793987483,3228033254,1672582532,1672582981,449
9886,3733915784,3387322545,1672574981,1672577850,2869
10792,3485898181,3815700240,1672688236,1672691520,3284
11531,3520012007,3811629200,1672628412,1672629558,1146
10710,3815184540,3308744016,1672629805,1672631007,1202
10155,3804707712,3207497598,1672550295,1672552404,2109
10803,3534491112,3558567160,1672659980,1672662329,2349
11045,3703277359,3292663993,1672636734,1672640106,3372
10262,3500814753,3755170743,1672607732,1672607951,219
11599,3445406685,3714951681,1672564080,1672567182,3102
10609,3716285196,3245882008,1672593821,1672595111,1290
11138,3534068874,3773852157,1672666889,1672668786,1897
10769,3900540310,3777641081,1672602926,1672604889,1963
10791,3713374884,3738429905,1672628776,1672629517,741
10232,3387989658,3520925688,1672642103,1672642929,826
10798,3420881591,3793920312,1672571947,1672575213,3266
9949,3774436159,3778986795,1672660831,1672663253,2422
10777,3854957153,3379400553,1672560693,1672563224,2531
10533,3287403291,3714312797,1672666653,1672668865,2212
11402,3353194923,3459951739,1672701267,1672702046,779
11234,3909220912,3713621169,1672563983,1672565349,1366
10886,3517960740,3299845453,1672619054,1672620176,1122
10105,3209280342,3515100211,1672678501,1672681177,2676
11050,3777706200,3773895671,1672575415,1672576990,1575
10146,3624164232,3509701363,1672544219,1672547075,2856
11556,3500198430,3500994763,1672554511,1672556051,1540
11547,3516706935,3912625932,1672552193,1672552932,739
10946,3533037906,3311805161,1672572047,1672575635,3588
10061,3432466467,3501370430,1672656871,1672659993,3122
10744,3939422411,3479402555,1672581385,1672583767,2382
11121,3701655378,3338187803,1672690330,1672691428,1098
10574,3447591143,3857344874,1672572450,1672575663,3213
11755,3230612965,3312612693,1672665172,1672665987,815
10823,3288791629,3500833053,1672688372,1672689177,805
11564,3400186699,3880788853,1672539391,1672541905,2514
9986,3533976217,3418683594,1672601943,1672604056,2113
9840,3443004958,3780074082,1672655410,1672655837,427
10396,3307236682,3209417223,1672702846,1672705413,2567
10671,3931028233,3714870496,1672572538,1672575640,3102
11184,3783594246,3711854614,1672658872,1672661063,2191
10740,3467232654,3239990061,1672598180,1672601049,2869
10309,3905571273,3779312237,1672692129,1672692556,427
10051,3533440736,3776468503,1672686186,1672687363,1177
9861,3909504515,3553640169,1672551288,1672552251,963
10126,3307216611,3351728355,1672617507,1672620714,3207
9897,3711591464,3638823001,1672638051,1672639113,1062
11030,3510153173,3510291656,1672696326,1672698373,2047
10330,3459951739,3711722554,1672596906,1672598910,2004
10671,3516668203,3534937492,1672684243,1672687119,2876
11730,3932566114,3512495325,1672703885,1672704216,331
10089,3783879023,3755154460,1672594732,1672597838,3106
10259,3737571883,3757592622,1672581872,1672583120,1248
9877,3369810091,3780921044,1672578598,1672579453,855
10893,3791351852,3364718040,1672605528,1672608881,3353
11740,3783430498,3806034626,1672644989,1672645866,877
10518,3772296376,3427049290,1672582990,1672583969,979
10292,3514638555,3715622084,1672606261,1672606986,725
11761,3445406685,3776468503,1672671046,1672673771,2725
9870,3701374160,3501515425,1672584637,1672586881,2244
11030,3517113478,3281935691,1672618586,1672621791,3205
10363,3510882576,3518534560,1672649153,1672651735,2582
11509,3444646562,3814770073,1672598512,1672599851,1339
10295,3928508375,3394357241,1672653874,1672654451,577
10318,3665478011,3500440602,1672686727,1672687129,402
11003,3783021859,3475653510,1672622441,1672624991,2550
11223,3852014884,3486824047,1672655582,1672657094,1512
10391,3887382548,3830771832,1672688330,1672691875,3545
10772,3900793652,3703438617,1672633099,1672633455,356
11092,3811629200,3205687719,1672554004,1672557565,3561
10334,3772882440,3505804611,1672539334,1672540673,1339
10541,3310021925,3510240661,1672536281,1672536730,449
10876,3305656670,3783651407,1672618607,1672619416,809
11213,3773891827,3716371766,1672650171,1672650290,119
9899,3367242388,3851810349,1672655622,1672655856,234
11700,3855977674,3461743188,1672593317,1672596434,3117
10714,3519297683,3824135033,1672557546,1672560389,2843
10711,3297624618,3311188620,1672552659,1672554057,1398
11007,3711190257,3491250381,1672589637,1672592765,3128
11498,3443041059,3776053084,1672686090,1672688171,2081
11198,3404395454,3887030182,1672667364,1672667575,211
10599,3463892928,3500093945,1672608121,1672608991,870
10857,3205113625,3927181190,1672554224,1672557436,3212
11558,3534328311,3417360319,1672623200,1672625407,2207
11736,3387700451,3688410383,1672545635,1672548552,2917
11562,3776950532,3632189887,1672593417,1672595939,2522
10948,3806720019,3605591994,1672586528,1672587314,786
10413,3501004005,3682266017,1672680396,1672680934,538
10326,3910049345,3226913558,1672666168,1672667533,1365
10287,3491250381,3518164450,1672588581,1672589002,421
10823,3519841427,3505521491,1672611503,1672613420,1917
11531,3404461403,3290060215,1672545429,1672546923,1494
11010,3520925688,3500799617,1672653743,1672657225,3482
9975,3715114417,3309455369,1672683702,1672684335,633
11373,3516034245,3518376262,1672675813,1672679290,3477
10348,3936486724,3476958001,1672676134,1672679431,3297
10434,3398151217,3619676231,1672660635,1672663441,2806
10440,3533419409,3555763674,1672657641,1672658857,1216
10925,3779478448,3417360319,1672679324,1672681529,2205
9973,3512744657,3399726243,1672659373,1672661979,2606
11704,3413799143,3757064623,1672680002,1672682701,2699
10955,3501619113,3313795594,1672547758,1672548915,1157
11366,3778738044,3229570647,1672677644,1672680057,2413
11253,3534328311,3231963246,1672617861,1672618252,391
10647,3500442370,3714923092,1672607886,1672609841,1955
10485,3733730342,3307791650,1672613242,1672616650,3408
10016,3713875941,3780213684,1672532992,1672535393,2401
10164,3772234939,3229570647,1672638062,1672639854,1792
11722,3780563627,3512337054,1672552726,1672553501,775
10210,3890278838,3364683368,1672645635,1672647438,1803
11005,3737946004,3511069449,1672678816,1672681260,2444
11453,3343511947,3778273230,1672625661,1672626030,369
10684,3533566754,3793926338,1672701835,1672703495,1660
10212,3828354855,3715881104,1672629168,1672629901,733
11500,3442564712,3311264420,1672559184,1672561431,2247
10210,3516904926,3757501067,1672650501,1672651912,1411
11755,3287683210,3929002318,1672533336,1672536435,3099
9830,3714424237,3517325365,1672621464,1672623276,1812
11008,3776534957,3517021928,1672630633,1672632646,2013
10577,3792411831,3206241691,1672703238,1672705634,2396
10966,3902292032,3739217535,1672691672,1672693087,1415
9858,3480418192,3278443807,1672593353,1672596708,3355
11730,3534667712,3783730769,1672556672,1672558660,1988
11559,3792719263,3773408491,1672565978,1672566226,248
10305,3368441333,3836586875,1672700842,1672703237,2395
11634,3738760498,3345954031,1672692683,1672694159,1476
11616,3756740153,3306475287,1672688359,1672691592,3233
11421,3703896751,3414510793,1672635089,1672636251,1162
10471,3361952532,3903088144,1672570265,1672571967,1702
10869,3519357822,3888057649,1672646254,1672648003,1749
11132,3474879231,3520009158,1672586209,1672586413,204
11469,3711367577,3732871856,1672585998,1672587278,1280
11178,3777564559,3916924978,1672689499,1672691303,1804
10097,3418382025,3384001094,1672571614,1672573219,1605
11390,3224824355,3630802959,1672574844,1672578233,3389
9965,3509317054,3773432494,1672553530,1672554776,1246
9894,3925792265,3275975921,1672545416,1672547818,2402
11219,3202787155,3627358016,1672593795,1672594830,1035
10261,3894495222,3393502004,1672607093,1672607493,400
10552,3792972270,3311989687,1672645694,1672648904,3210
10453,3779778679,3512395783,1672649879,1672652179,2300
9912,3403988682,3513800589,1672661704,1672665082,3378
10237,3510278533,3501980730,1672564147,1672565781,1634
11008,3505994703,3467663782,1672684775,1672686161,1386
10351,3493515706,3783201950,1672632426,1672635449,3023
11613,3347520239,3512871568,1672694525,1672695309,784
10082,3520824937,3501137133,1672606962,1672608990,2028
10797,3509508477,3899205452,1672702145,1672703125,980
11573,3284483177,3915195160,1672692982,1672694534,1552
10478,3732871856,3505826673,1672601451,1672605022,3571
10737,3446764595,3922430928,1672678591,1672679498,907
11498,3385006834,3333505404,1672670642,1672672438,1796
11232,3438028077,3311515179,1672663311,1672664782,1471
9838,3733423371,3509828883,1672552747,1672553333,586
10251,3971422524,3770480149,1672566516,1672568407,1891
10920,3505248368,3510373076,1672666357,1672669530,3173
10104,3856897914,3518572231,1672602159,1672604978,2819
10368,3500931474,3491104534,1672684811,1672686633,1822
10379,3774325486,3773202954,1672688135,1672690743,2608
11401,3274239253,3380218091,1672648664,1672649347,683
11201,3772867078,3716371766,1672581527,1672582396,869
11536,3778838936,3517632796,1672677324,1672678250,926
10732,3533627473,3344710271,1672582755,1672584022,1267
9921,3505010941,3896840409,1672600242,1672600732,490
10798,3500814753,3368339963,1672583181,1672584632,1451
10032,3305657559,3501356814,1672612275,1672614853,2578
10860,3287683210,3703351452,1672531254,1672534544,3290
10102,3518376262,3791716170,1672584307,1672586472,2165
11669,3777304517,3400793223,1672602706,1672605964,3258
10193,3445406685,3756066702,1672594109,1672595228,1119
10187,3668855144,3884458862,1672593137,1672594383,1246
11242,3245121919,3738873928,1672552278,1672554904,2626
11685,3667654673,3318224774,1672651211,1672654793,3582
10454,3714690161,3773017746,1672555896,1672557236,1340
11679,3933872044,3915962248,1672675724,1672678192,2468
10315,3755129708,3713476192,1672534591,1672536341,1750
11475,3681504869,3305727497,1672637813,1672638654,841
11336,3780648744,3779174993,1672572077,1672573764,1687
10831,3509663119,3338195686,1672632888,1672633584,696
10954,3777405860,3476144563,1672533863,1672534558,695
10296,3732533330,3404461403,1672622564,1672625833,3269
10170,3791628263,3509355477,1672625026,1672627485,2459
11556,3349475873,3770180844,1672655428,1672658934,3506
10500,3519034304,3278629965,1672568112,1672568963,851
10616,3293553295,3512641538,1672543833,1672546216,2383
11103,3373018943,3446066492,1672668710,1672669551,841
10587,3435652260,3624365837,1672571389,1672573079,1690
9933,3605078841,3770273459,1672652161,1672652623,462
10788,3818904268,3319585148,1672622107,1672625519,3412
11568,3421956717,3377446376,1672670247,1672673679,3432
10916,3505685294,3461877104,1672582279,1672584401,2122
11263,3710861700,3231271498,1672636291,1672638980,2689
11288,3500455935,3342056927,1672676040,1672679059,3019
11722,3977337501,3792627762,1672566341,1672567403,1062
11051,3915460293,3972196462,1672699620,1672699845,225
11288,3756616853,3505416534,1672678307,1672680605,2298
10152,3634670780,3887502536,1672559824,1672562279,2455
10140,3755630085,3513215373,1672638581,1672640160,1579
10563,3772609551,3407403080,1672682143,1672684931,2788
10461,3459694275,3380185102,1672577542,1672580057,2515
11144,3716647407,3791532324,1672670108,1672671602,1494
11677,3825526565,3435801763,1672531234,1672534361,3127
10446,3935444008,3505155858,1672645734,1672649259,3525
11437,3289771213,3780013266,1672568399,1672569674,1275
11380,3510189563,3291446384,1672632734,1672636114,3380
10166,3714471069,3756717136,1672546788,1672547957,1169
11305,3817478012,3505121295,1672576790,1672578795,2005
11564,3406169279,3713102459,1672595344,1672598379,3035
10411,3716020849,3511078598,1672623055,1672624137,1082
11604,3791194984,3783176874,1672679774,1672682216,2442
11189,3777655401,3667814788,1672555330,1672557516,2186
10575,3447267291,3780298499,1672532881,1672535348,2467
10914,3533440736,3757872458,1672587153,1672590249,3096
10355,3513624915,3340897079,1672610551,1672611103,552
11481,3510262025,3452677710,1672562341,1672564732,2391
11383,3554437212,3510542303,1672538627,1672541287,2660
10691,3883640904,3772019557,1672651624,1672652521,897
10590,3716371766,3886837151,1672630346,1672633845,3499
10040,3505392452,3776953418,1672700331,1672701102,771
10840,3517617472,3369108286,1672605994,1672608387,2393
11172,3433902955,3408982612,1672694470,1672698019,3549
10064,3791435852,3510856388,1672662713,1672666200,3487
10924,3770715115,3302348002,1672640829,1672641956,1127
9965,3281970147,3880562532,1672673014,1672675655,2641
9864,3553640169,3551972633,1672571494,1672574175,2681
11206,3756761603,3533365834,1672690021,1672692618,2597
11480,3757855416,3701385831,1672703694,1672705454,1760
9856,3921736061,3793222045,1672572168,1672572787,619
10735,3714283424,3715750580,1672633012,1672636485,3473
11016,3459163055,3793222045,1672663063,1672666225,3162
11256,3422205569,3511218261,1672646923,1672647855,932
9825,3756685732,3513186578,1672689885,1672691170,1285
11117,3470997293,3972653129,1672692301,1672692440,139
10332,3711810752,3505685294,1672642108,1672645670,3562
11423,3915652382,3426207439,1672613116,1672613462,346
10966,3827836825,3715106566,1672541246,1672541834,588
9967,3821103640,3852310652,1672542690,1672543518,828
10331,3516792348,3534531061,1672533125,1672534243,1118
10567,3474350534,3735679000,1672659382,1672661736,2354
10438,3791409441,3774782065,1672582634,1672584071,1437
11751,3483701493,3662055682,1672693253,1672695170,1917
11671,3772169046,3899970524,1672695573,1672699068,3495
11704,3500596577,3513586642,1672606445,1672607100,655
11031,3505155858,3513563152,1672615889,1672617104,1215
9882,3774359137,3733836732,1672559568,1672562241,2673
11478,3914740937,3514638555,1672640500,1672642655,2155
9800,3501253130,3393376416,1672609461,1672612592,3131
9936,3501853868,3628556590,1672649396,1672649566,170
10230,3390438262,3783563043,1672608640,1672609651,1011
11184,3773878451,3616403486,1672590853,1672593739,2886
10904,3479585868,3238310644,1672638315,1672639895,1580
10156,3623113240,3667072319,1672657252,1672660726,3474
11072,3715284599,3732540636,1672594957,1672595627,670
11706,3377883705,3512784888,1672564950,1672565479,529
10336,3757446082,3774706478,1672651047,1672651977,930
11190,3513629502,3884934977,1672691849,1672693325,1476
10212,3367526113,3772343750,1672605735,1672608307,2572
9839,3919349138,3662354016,1672601578,1672602902,1324
9945,3703048107,3853386575,1672605914,1672607305,1391
10309,3517426473,3519780867,1672633471,1672634900,1429
9860,3520860199,3510159441,1672586796,1672587903,1107
10536,3802625412,3558349840,1672603038,1672605379,2341
11087,3710149975,3385006834,1672582261,1672583038,777
9998,3770991234,3779468781,1672579974,1672580998,1024
10046,3287403291,3454151554,1672686946,1672688249,1303
10902,3501711464,3293540333,1672647380,1672650357,2977
11739,3398489033,3517358336,1672630565,1672630879,314
10741,3971447562,3774238066,1672636623,1672638407,1784
9805,3791031227,3881579907,1672561025,1672564011,2986
11031,3241682278,3512625661,1672579934,1672581733,1799
9800,3273537848,3760107540,1672618371,1672621309,2938
11093,3925792265,3791587717,1672608110,1672610889,2779
10633,3512492332,3421956717,1672558983,1672559704,721
10798,3240683148,3633949990,1672547389,1672547475,86
10058,3516454693,3484739955,1672560446,1672563676,3230
11463,3779951373,3807486812,1672560036,1672560640,604
11307,3520057139,3510486220,1672674787,1672677935,3148
11005,3607583720,3777569538,1672548596,1672549956,1360
9989,3275975921,3836757034,1672623369,1672624577,1208
10060,3856699097,3514306458,1672562754,1672565720,2966
11431,3757032266,3512490032,1672683685,1672684295,610
11525,3884394685,3500624846,1672573410,1672574347,937
9892,3777041132,3639926564,1672606915,1672609814,2899
11096,3534624672,3463564410,1672541578,1672541889,311
10166,3509297453,3893527651,1672644378,1672644702,324
11289,3777041132,3772893815,1672537110,1672538828,1718
11049,3310702648,3830254808,1672545185,1672548042,2857
9843,3275171954,3446537819,1672665354,1672668485,3131
11371,3916656185,3388774559,1672643806,1672645015,1209
10933,3666022373,3614484939,1672659069,1672659483,414
10416,3510781595,3906693728,1672557662,1672558977,1315
11035,3301369282,3511003541,1672662778,1672665656,2878
9802,3314363575,3380167818,1672537215,1672540111,2896
9976,3509297453,3494560663,1672695275,1672696847,1572
10296,3755849241,3398862999,1672629305,1672632888,3583
9954,3311521176,3519712497,1672546383,1672548094,1711
11115,3703849264,3505119470,1672697968,1672700645,2677
9848,3906075386,3976225898,1672543883,1672545852,1969
10569,3757378286,3520189871,1672634195,1672635703,1508
10230,3419829238,3424997707,1672610789,1672614296,3507
11282,3441683673,3919984986,1672570341,1672571086,745
10747,3274739459,3515681585,1672534418,1672534603,185
11350,3462645981,3760322661,1672667287,1672669321,2034
10153,3400560073,3772343750,1672645175,1672645488,313
10106,3515753241,3772223331,1672698429,1672699077,648
10294,3832333115,3755465396,1672560613,1672561283,670
10368,3534122907,3534624672,1672677317,1672677598,281
10736,3344778261,3403257752,1672698248,1672698486,238
10325,3311410533,3510149298,1672602282,1672604372,2090
11686,3222364320,3292050211,1672602974,1672606228,3254
11695,3663505156,3505032773,1672606403,1672607808,1405
10900,3773736248,3462645981,1672654047,1672655415,1368
10617,3780148144,3288346356,1672602123,1672602338,215
11512,3518164450,3701385831,1672677452,1672677698,246
10202,3386323728,3458753033,1672546376,1672547825,1449
9985,3668202976,3883640904,1672616997,1672618296,1299
10567,3335139032,3774401596,1672658911,1672661205,2294
10982,3713858538,3513894659,1672621278,1672622901,1623
10393,3760481622,3757201138,1672690001,1672690795,794
10119,3480185839,3334633634,1672639181,1672639251,70
10312,3337903727,3520763492,1672555712,1672556714,1002
11066,3931028233,3732846295,1672670220,1672671765,1545
10059,3384713976,3909632424,1672665637,1672666178,541
11196,3471177177,3619705594,1672658358,1672659190,832
11526,3515803462,3735679000,1672602280,1672604001,1721
10468,3440671139,3776901443,1672693155,1672695208,2053
11521,3424425746,3427741923,1672658493,1672661638,3145
10231,3272827860,3404461403,1672672796,1672676017,3221
11555,3770595035,3505697295,1672634404,1672637458,3054
11441,3311409212,3239423794,1672558799,1672560359,1560
11617,3205908584,3929002318,1672698278,1672701365,3087
10942,3792440162,3396656251,1672663368,1672665362,1994
10547,3376487118,3387413950,1672618551,1672621450,2899
10167,3756413374,3756717136,1672609844,1672612921,3077
10023,3770630937,3774506868,1672569171,1672571808,2637
11231,3516969689,3711770853,1672672489,1672673212,723
11298,3783368855,3394394262,1672551061,1672551297,236
10482,3533340292,3856601074,1672592777,1672593862,1085
9847,3880030249,3421674406,1672586728,1672589241,2513
10573,3533440294,3393128259,1672632192,1672633930,1738
10832,3343616490,3533325993,1672678293,1672680832,2539
10837,3755767856,3491250381,1672599222,1672601079,1857
10744,3856601074,3516486526,1672684189,1672687203,3014
11391,3853783593,3935569749,1672656112,1672659430,3318
10095,3470135167,3390438262,1672615262,1672617519,2257
10519,3755075988,3520305100,1672657477,1672658773,1296
9920,3701521510,3534758256,1672537518,1672540438,2920
9867,3291446384,3416105769,1672653418,1672655822,2404
10830,3238310644,3930501172,1672619191,1672620070,879
9805,3553229537,3710585241,1672642097,1672643567,1470
10068,3361952532,3737685967,1672696581,1672697186,605
11118,3772282008,3301765144,1672632955,1672633986,1031
10489,3304697982,3783939161,1672561521,1672562706,1185
11109,3714902042,3311774510,1672542636,1672544715,2079
10036,3490008012,3906075386,1672590585,1672591953,1368
10242,3500433278,3912862842,1672632758,1672636022,3264
10976,3517652011,3558203963,1672654683,1672657810,3127
10993,3394986304,3604908372,1672574176,1672575527,1351
11505,3293553295,3715712376,1672688498,1672689243,745
11525,3418791124,3482639402,1672661488,1672663309,1821
10809,3279102372,3510547682,1672579011,1672582173,3162
10936,3772461583,3470135167,1672681916,1672682820,904
10142,3756536476,3776407517,1672702669,1672704986,2317
10548,3783594729,3778124514,1672561551,1672561772,221
10302,3922430928,3534537581,1672682120,1672682647,527
10243,3380418745,3852275715,1672600123,1672603435,3312
10578,3500536897,3518209090,1672601866,1672602906,1040
10860,3701387745,3772461583,1672636657,1672637379,722
11489,3291936679,3813085701,1672594377,1672597379,3002
10462,3662821438,3374348845,1672555080,1672557396,2316
10982,3827889533,3505490878,1672615909,1672618199,2290
11241,3703725221,3511963020,1672667245,1672668756,1511
10081,3307997700,3915679140,1672612271,1672615622,3351
10474,3514329209,3898965585,1672664665,1672665240,575
11279,3512784888,3338465050,1672614902,1672615912,1010
11692,3760776967,3391612879,1672582328,1672582721,393
9949,3509431396,3772569860,1672702986,1672705257,2271
11150,3773738817,3757201138,1672570587,1672571709,1122
10324,3780129338,3731644240,1672688502,1672690408,1906
10444,3293157673,3779415433,1672669203,1672670845,1642
10733,3204821370,3755584983,1672690551,1672693067,2516
10517,3605905645,3519297683,1672548766,1672551422,2656
10602,3756897029,3303772923,1672645828,1672648312,2484
10948,3438028077,3977157565,1672541353,1672542092,739
11216,3388915945,3302879906,1672576353,1672578595,2242
10390,3511744756,3711214982,1672665399,1672665892,493
10737,3897500723,3311188620,1672537594,1672538528,934
10211,3738873928,3236206821,1672641598,1672644682,3084
10991,3669140241,3511286390,1672674613,1672677431,2818
11024,3519055736,3776316903,1672688475,1672689188,713
11038,3810949170,3516463579,1672691618,1672691897,279
10593,3886879696,3384601925,1672598393,1672600794,2401
10049,3559619861,3336501403,1672675430,1672678334,2904
10739,3820280594,3914947393,1672619070,1672622013,2943
11331,3773408491,3518759318,1672570236,1672573654,3418
10108,3505816624,3204149913,1672572563,1672572628,65
11142,3810949170,3710680073,1672596671,1672597629,958
10757,3534984243,3417969824,1672574405,1672574922,517
10943,3505129296,3510218188,1672598101,1672598552,451
10777,3208519320,3713475356,1672681174,1672682573,1399
9852,3205948776,3886879696,1672687528,1672690417,2889
11506,3662821438,3517810375,1672539812,1672540730,918
10678,3898595916,3714250543,1672681834,1672684689,2855
10307,3791509881,3618895679,1672588158,1672589753,1595
10693,3929355087,3730571757,1672666763,1672666824,61
10438,3500019810,3779706467,1672616924,1672620136,3212
9944,3505560793,3772131127,1672575367,1672577373,2006
10523,3415562576,3420664407,1672560819,1672563961,3142
10484,3713740434,3517558635,1672605025,1672607849,2824
10375,3703624327,3229890340,1672575489,1672578536,3047
9888,3513186578,3428325402,1672615681,1672616419,738
11415,3915035136,3514244308,1672561408,1672564834,3426
11343,3500015630,3225554956,1672619754,1672623166,3412
10340,3455955489,3399726243,1672654819,1672656114,1295
10814,3703999217,3391093411,1672558638,1672559227,589
10562,3207497598,3299845453,1672568361,1672570209,1848
11638,3509433155,3209958726,1672555291,1672557247,1956
11782,3773953689,3757796416,1672684311,1672686534,2223
10248,3517149023,3229615214,1672702388,1672705501,3113
10264,3515047288,3534537581,1672551098,1672552093,995
10402,3756781024,3394394262,1672635904,1672636007,103
11622,3510209505,3817376705,1672690625,1672692519,1894
10634,3405303958,3519165527,1672601338,1672604539,3201
11190,3534190196,3836586875,1672628899,1672631973,3074
10117,3438470128,3533131937,1672611997,1672612444,447
10737,3395565040,3423346297,1672568264,1672571340,3076
10385,3416474842,3972847837,1672685528,1672685905,377
10680,3732128078,3760737203,1672674888,1672676668,1780
10988,3510882576,3760096466,1672700690,1672703729,3039
11421,3739844610,3505359060,1672628657,1672631636,2979
11402,3387706541,3783043346,1672607516,1672609729,2213
10070,3887069914,3897107253,1672543504,1672544008,504
11656,3716341323,3510233949,1672555026,1672555182,156
10340,3770780655,3714923092,1672645730,1672647293,1563
11606,3356599815,3802757611,1672676167,1672678181,2014
10881,3918126468,3627081426,1672613660,1672615309,1649
9858,3505472087,3668154066,1672546428,1672547479,1051
11129,3519465545,3444453261,1672603915,1672606155,2240
11149,3477248170,3462645981,1672536149,1672538695,2546
10157,3760776967,3375906394,1672648887,1672651005,2118
11346,3519228207,3817038422,1672624566,1672625822,1256
11549,3516586325,3470962222,1672546005,1672547620,1615
11554,3777992576,3922153821,1672645196,1672648382,3186
11642,3534537581,3505697295,1672698497,1672701363,2866
11675,3806471413,3773636983,1672550192,1672552766,2574
11722,3714951681,3783679478,1672654709,1672655683,974
11605,3735422623,3715106566,1672625085,1672627406,2321
10356,3447267291,3246971044,1672570560,1672572667,2107
11757,3299052917,3916924978,1672699102,1672702471,3369
10790,3533201269,3518335611,1672569152,1672570898,1746
11335,3514013999,3770631449,1672613824,1672615277,1453
10940,3519351747,3432838598,1672591315,1672594063,2748
10945,3510178791,3291446384,1672688263,1672690128,1865
11651,3520305100,3284334297,1672616194,1672619260,3066
9877,3715419141,3368951504,1672556175,1672558963,2788
10757,3779505358,3297684667,1672559671,1672560778,1107
11338,3201634072,3287403291,1672679477,1672679824,347
11694,3443102414,3625952981,1672602473,1672605689,3216
10383,3881785069,3716595760,1672603969,1672604155,186
10742,3914926436,3627431396,1672652077,1672655128,3051
11337,3773378103,3511199555,1672661766,1672663547,1781
11391,3636605690,3505720915,1672542338,1672543797,1459
11005,3387700451,3533960602,1672575935,1672579447,3512
11500,3609997804,3304235700,1672599089,1672599772,683
10372,3430296808,3301765144,1672533513,1672533576,63
10444,3447938130,3228477490,1672703078,1672704074,996
11636,3434052463,3736941123,1672608938,1672612372,3434
9882,3792972270,3898592058,1672675145,1672677382,2237
10891,3791581138,3815700240,1672636273,1672638733,2460
11506,3313502623,3500589560,1672658651,1672659255,604
11607,3792277399,3605591994,1672569781,1672572155,2374
10850,3353335252,3510291656,1672577440,1672579140,1700
11547,3772968080,3612841103,1672532006,1672533323,1317
10806,3274239253,3470135167,1672687184,1672689524,2340
11103,3778382224,3433196933,1672625754,1672628254,2500
10967,3393543588,3511199555,1672622188,1672622395,207
10441,3791547827,3241593146,1672700333,1672701425,1092
9882,3311696372,3519965717,1672553043,1672555289,2246
11181,3711029952,3929355087,1672661863,1672662225,362
9839,3853783593,3511969443,1672551760,1672554120,2360
11074,3602401154,3714471069,1672669596,1672671309,1713
11758,3703419800,3519712497,1672571701,1672574292,2591
9875,3294164983,3900766525,1672575225,1672577791,2566
11158,3664523809,3716891903,1672632510,1672634097,1587
10679,3776125503,3756948477,1672599691,1672601292,1601
11488,3802374620,3713566527,1672544138,1672546869,2731
9962,3807717766,3516103646,1672545104,1672545416,312
10663,3469350379,3303747093,1672672651,1672673667,1016
9823,3836136159,3201656220,1672595079,1672595722,643
11040,3682086200,3283847934,1672612142,1672612625,483
11483,3402774497,3512251592,1672688165,1672688683,518
10945,3516969689,3511650296,1672573280,1672574382,1102
9922,3407398464,3809216145,1672596117,1672596935,818
10029,3824135033,3378729459,1672698893,1672700147,1254
11022,3736203662,3710271021,1672601647,1672604235,2588
11594,3361789225,3311305760,1672699318,1672699805,487
11706,3308965136,3400903513,1672637873,1672640019,2146
10679,3381244346,3339331632,1672667553,1672667691,138
9907,3711349327,3520362238,1672672187,1672674985,2798
10863,3235578852,3377250778,1672579171,1672580982,1811
11123,3809207482,3513203127,1672590996,1672592800,1804
11344,3270502801,3406390503,1672536545,1672539213,2668
10220,3429587594,3772055279,1672678697,1672680438,1741
11420,3779604279,3333505404,1672670440,1672671066,626
11112,3738160394,3715790104,1672558430,1672560738,2308
10721,3904184638,3701529552,1672636770,1672640131,3361
10167,3835509670,3517810375,1672696418,1672698206,1788
10350,3272827860,3429587594,1672542891,1672544837,1946
11353,3809860102,3480418192,1672681225,1672684303,3078
10238,3398483531,3905571273,1672599532,1672600738,1206
10401,3311989687,3701004302,1672561391,1672564518,3127
11276,3310961923,3559759778,1672547074,1672547223,149
11681,3356599815,3780740477,1672673964,1672675880,1916
11106,3613703906,3932491622,1672585341,1672587549,2208
11032,3977337501,3499998389,1672633458,1672636707,3249
11176,3710046567,3628556590,1672616184,1672617401,1217
11213,3803473387,3804779247,1672667478,1672668524,1046
11560,3475033290,3850735936,1672648988,1672650035,1047
11592,3552261072,3615742989,1672562281,1672563720,1439
10207,3519965717,3773344258,1672587446,1672590422,2976
10198,3683514731,3774035405,1672699884,1672701691,1807
11080,3533365834,3777767907,1672617467,1672620902,3435
9798,3898595916,3435159896,1672619916,1672623182,3266
9957,3778605154,3512527440,1672599665,1672600965,1300
11466,3350966326,3916924978,1672666188,1672667712,1524
11515,3515984911,3446066492,1672578692,1672580460,1768
10390,3233993993,3776304080,1672536438,1672538114,1676
10318,3903994989,3515558215,1672580027,1672582056,2029
10767,3514638555,3533830748,1672679350,1672679596,246
11287,3470962222,3235074007,1672534314,1672537685,3371
10901,3909399636,3668063289,1672602680,1672604107,1427
10727,3520925688,3730935770,1672629343,1672631042,1699
10193,3495427619,3419762444,1672664794,1672666210,1416
11686,3354015456,3492056330,1672676948,1672679911,2963
10535,3780921044,3780942505,1672683080,1672686034,2954
10514,3305612422,3514145752,1672571414,1672572714,1300
10859,3770023722,3701978422,1672690328,1672692526,2198
11163,3757060033,3977360666,1672533915,1672536277,2362
11695,3350966326,3780074082,1672652873,1672656282,3409
11576,3755119166,3703481882,1672671107,1672671963,856
9872,3736941123,3772609551,1672541281,1672544378,3097
10249,3922480066,3509562377,1672674399,1672677545,3146
9946,3777932581,3662307789,1672680066,1672681139,1073
10138,3226172318,3534491112,1672553568,1672556320,2752
10039,3348343425,3613936929,1672668285,1672670153,1868
11424,3516731917,3851810349,1672535528,1672537011,1483
11219,3636857871,3778909412,1672682880,1672685337,2457
11582,3933731871,3343511947,1672664939,1672667265,2326
10283,3534278019,3273674596,1672606746,1672609512,2766
10520,3711367577,3773424266,1672540968,1672543781,2813
10393,3550887623,3501573548,1672686864,1672687363,499
9819,3447696555,3666958814,1672573131,1672574865,1734
11300,3760801237,3905934770,1672654519,1672657086,2567
10603,3783651407,3462153833,1672554327,1672556957,2630
10388,3756876537,3559619861,1672569976,1672572745,2769
10348,3617771673,3756695502,1672662616,1672663083,467
10845,3701284535,3534696810,1672673399,1672675055,1656
11161,3756525103,3517426473,1672597235,1672600001,2766
10753,3380281484,3501873139,1672627858,1672628997,1139
10594,3519046342,3939422411,1672551035,1672552378,1343
11496,3390438262,3534506090,1672617977,1672621484,3507
10518,3755119166,3289017988,1672696749,1672699840,3091
10413,3701887470,3738547113,1672609907,1672612444,2537
10586,3780294116,3920606331,1672633239,1672634669,1430
10354,3513171472,3461931154,1672604287,1672607780,3493
11619,3500624846,3514941815,1672693872,1672693951,79
11766,3425545115,3703206956,1672568010,1672568327,317
11535,3331228758,3773408491,1672681039,1672683901,2862
11720,3387388336,3505665788,1672562854,1672566092,3238
11218,3604908372,3829761380,1672563586,1672564563,977
10874,3517530943,3856975355,1672553657,1672554703,1046
10596,3880882684,3318056480,1672552498,1672555933,3435
10137,3710051427,3780982229,1672683049,1672683903,854
10571,3472018395,3778182724,1672615968,1672619159,3191
11713,3783368855,3714455496,1672631937,1672632377,440
11471,3396472026,3496352027,1672598778,1672600326,1548
11040,3774965463,3285136057,1672666005,1672668124,2119
11110,3283106998,3835262447,1672683943,1672686370,2427
10465,3311904032,3342495377,1672611021,1672613192,2171
10891,3397527886,3711959141,1672614076,1672617163,3087
9841,3667654673,3611570003,1672582861,1672584995,2134
11139,3432838598,3347520239,1672589715,1672592625,2910
10361,3299052917,3894495222,1672581255,1672584081,2826
10969,3703168159,3669140241,1672607055,1672609442,2387
11675,3935256825,3601340045,1672539629,1672541181,1552
10137,3235198316,3813853446,1672566969,1672570121,3152
10473,3500456339,3609997804,1672677296,1672680165,2869
10017,3361711720,3370512945,1672629642,1672630630,988
11694,3203876438,3439283360,1672675075,1672677442,2367
11721,3450621820,3714067998,1672591200,1672594040,2840
10028,3779930476,3783408469,1672638520,1672640613,2093
9914,3716475340,3853275529,1672697645,1672698455,810
11508,3710515351,3760144712,1672630775,1672633793,3018
10357,3755286041,3711844574,1672663268,1672663451,183
10302,3367262509,3487779363,1672634456,1672637659,3203
10408,3519831322,3515726910,1672681528,1672683123,1595
10258,3505119470,3472018395,1672682843,1672684861,2018
10962,3505449070,3513545735,1672600044,1672602505,2461
10185,3890194669,3703031637,1672616264,1672619590,3326
11736,3403150349,3773826624,1672607807,1672609468,1661
10283,3274239253,3778318250,1672649473,1672651515,2042
11391,3637522163,3494748808,1672654286,1672657621,3335
10858,3792824886,3209075485,1672638992,1672641295,2303
11441,3438470128,3514980025,1672673349,1672674074,725
10974,3635433296,3909632424,1672554669,1672556209,1540
10726,3770991234,3311583437,1672590883,1672592539,1656
10184,3555764822,3533265491,1672544521,1672546947,2426
11552,3920526713,3897186782,1672694169,1672696277,2108
10944,3701919083,3857244486,1672551876,1672553399,1523
10868,3306066522,3624307518,1672555439,1672556063,624
11263,3793232021,3885339157,1672578609,1672579684,1075
11152,3514007122,3776200012,1672689432,1672689680,248
10184,3374147279,3897003751,1672674735,1672676707,1972
11124,3882851213,3416105769,1672615510,1672618339,2829
10563,3239401337,3313101243,1672564359,1672565252,893
11591,3319585148,3505826673,1672605853,1672606148,295
10964,3915460293,3777063455,1672569293,1672572703,3410
10793,3908177413,3247545468,1672659012,1672662381,3369
10198,3971282455,3509544691,1672631975,1672634705,2730
9897,3834424604,3735197034,1672613319,1672614158,839
11359,3505994703,3555954355,1672676692,1672678977,2285
11128,3209075485,3468871103,1672660393,1672662615,2222
10524,3780308809,3919719755,1672596023,1672599553,3530
11277,3922409420,3885674996,1672598323,1672598510,187
9990,3970265139,3330318282,1672697785,1672698219,434
9879,3972442654,3711179193,1672546798,1672547487,689
10498,3515577866,3739075176,1672693175,1672695102,1927
9926,3713990030,3394357241,1672540495,1672542147,1652
11572,3446575109,3515803462,1672544845,1672545759,914
10719,3244098077,3778318250,1672657809,1672660109,2300
11607,3851451801,3394976623,1672690378,1672692244,1866
11594,3703938162,3851877325,1672608603,1672609729,1126
10377,3295691964,3820200446,1672701395,1672701633,238
11300,3917004141,3501583486,1672546628,1672546878,250
10732,3274739459,3510335069,1672646426,1672649421,2995
10883,3511608609,3912878303,1672666547,1672669711,3164
10632,3307521389,3311133296,1672661295,1672662507,1212
9908,3770441717,3924583142,1672598582,1672599049,467
10204,3835599049,3533113740,1672624582,1672626422,1840
10774,3295787354,3755790149,1672621693,1672624842,3149
10098,3825082811,3905571273,1672664875,1672665305,430
10670,3495482863,3922480066,1672682312,1672685047,2735
11651,3732540636,3688768189,1672642703,1672643673,970
10723,3791289855,3209417223,1672570613,1672572069,1456
10552,3381244346,3517499844,1672651843,1672654703,2860
10488,3701127475,3287403291,1672628619,1672631378,2759
10462,3500405175,3710680073,1672639971,1672640542,571
10545,3885545415,3393543588,1672695292,1672697379,2087
9798,3772845364,3364286028,1672661572,1672663456,1884
10101,3636852764,3821087562,1672670584,1672672207,1623
11639,3793689267,3938129916,1672575123,1672578431,3308
10589,3514352989,3777304517,1672588661,1672589323,662
10661,3932491622,3520860199,1672624795,1672627694,2899
11499,3710051427,3248409083,1672566584,1672567111,527
11492,3776249160,3533154906,1672533091,1672536205,3114
11225,3500640854,3611570003,1672562067,1672563633,1566
11579,3276393542,3783373085,1672533359,1672536352,2993
9900,3713416106,3533830748,1672600407,1672601427,1020
9962,3716195780,3533030343,1672642510,1672645985,3475
10312,3516472352,3422959249,1672598990,1672601407,2417
11679,3773714494,3278430820,1672636456,1672639535,3079
10285,3701769970,3509370016,1672627841,1672631180,3339
10513,3715587520,3505653701,1672658835,1672659776,941
9894,3462645981,3885545415,1672660114,1672660238,124
9798,3778695895,3501759031,1672609850,1672612445,2595
11280,3511867383,3612042508,1672647549,1672650262,2713
11577,3518164450,3279726491,1672594190,1672596004,1814
10747,3225356349,3485898181,1672655225,1672657094,1869
10261,3458432407,3756850160,1672575927,1672579256,3329
10099,3920606331,3534459983,1672534479,1672536528,2049
11508,3501657158,3480270940,1672695453,1672697058,1605
10360,3715419141,3701956841,1672654302,1672656546,2244
10648,3701919083,3912915644,1672579619,1672582725,3106
11310,3515507526,3732871856,1672540729,1672540936,207
10900,3703611876,3852310652,1672638469,1672640155,1686
10494,3932491622,3519165527,1672613935,1672614941,1006
11024,3304672737,3828354855,1672669854,1672672474,2620
11706,3304697982,3501963428,1672561894,1672563725,1831
11290,3274239253,3774236212,1672622516,1672622645,129
11246,3605905645,3660246433,1672585337,1672586481,1144
11649,3613781977,3510335069,1672541795,1672544506,2711
10675,3779340538,3226037966,1672682505,1672682685,180
11066,3780048608,3352493805,1672603527,1672604840,1313
10231,3437703650,3286938590,1672547578,1672548104,526
10459,3715590997,3516965624,1672597379,1672599096,1717
11167,3367121615,3850904092,1672588380,1672588491,111
10855,3916463490,3436099135,1672539435,1672541925,2490
11504,3553008208,3236948071,1672681010,1672684504,3494
10753,3518931700,3613703906,1672578342,1672579157,815
11388,3757855416,3711767051,1672595789,1672597281,1492
10222,3813111107,3975796415,1672591493,1672592272,779
11678,3512638952,3884388188,1672541424,1672544761,3337
10304,3552444228,3851877325,1672655374,1672658201,2827
10715,3273771395,3716676869,1672654215,1672655128,913
11027,3519922921,3385416697,1672553647,1672556414,2767
11701,3803382101,3792075871,1672613107,1672615526,2419
10079,3836090778,3402580733,1672581275,1672581579,304
11365,3932955949,3815700240,1672625658,1672626539,881
10115,3557653200,3511663572,1672657209,1672657920,711
11403,3428198021,3225554956,1672625585,1672627681,2096
11515,3777200549,3484739955,1672602493,1672604178,1685
11235,3929391979,3534459983,1672635338,1672638863,3525
11370,3200320674,3777569538,1672640741,1672643982,3241
11570,3779413388,3939882169,1672632056,1672633452,1396
10484,3515893948,3501171785,1672624921,1672628226,3305
10748,3602680347,3779505358,1672608775,1672609885,1110
11749,3701284535,3500928990,1672671447,1672672689,1242
10707,3395069149,3780074082,1672602952,1672603668,716
11495,3836586875,3559123082,1672652682,1672653332,650
10904,3559754304,3897186782,1672662725,1672664474,1749
10368,3231271498,3711852131,1672561569,1672563156,1587
10357,3977880564,3682150740,1672572951,1672575814,2863
10939,3613216900,3272581469,1672545702,1672549258,3556
10526,3665841655,3416079461,1672699512,1672702391,2879
11739,3912862842,3688410383,1672548368,1672550305,1937
11455,3514327931,3498803823,1672557951,1672559389,1438
10633,3519965717,3511311554,1672535409,1672538511,3102
9989,3783826338,3406238754,1672559364,1672561859,2495
11148,3511476353,3730571757,1672703732,1672706925,3193
10719,3609103278,3505685294,1672670427,1672671305,878
10156,3780500331,3283106998,1672597835,1672598755,920
11374,3880549316,3792455305,1672577941,1672580886,2945
11057,3802101760,3776034313,1672577653,1672581151,3498
10303,3519924982,3365519448,1672698725,1672700216,1491
10558,3681274982,3738734246,1672580506,1672583989,3483
11508,3374652108,3774029494,1672548428,1672551106,2678
10804,3500415589,3400112498,1672680394,1672680774,380
11535,3900540310,3518408734,1672558452,1672561514,3062
10838,3336225953,3424476995,1672647630,1672648464,834
11685,3271282663,3760322661,1672539806,1672541131,1325
11507,3512753567,3755203055,1672634663,1672636899,2236
11232,3711187791,3415032547,1672621105,1672621498,393
11227,3711219767,3514145752,1672574668,1672574843,175
11420,3284483177,3514498259,1672662192,1672663002,810
11466,3206926634,3757623259,1672692555,1672694044,1489
9930,3738103378,3701596047,1672558735,1672560942,2207
10166,3909067335,3792289287,1672597882,1672600450,2568
10269,3515597467,3913746581,1672642828,1672643410,582
11118,3343193067,3714516404,1672701567,1672705084,3517
10930,3739618347,3600978954,1672544111,1672546415,2304
11675,3422959249,3715724166,1672656397,1672657974,1577
10371,3469350379,3755411110,1672611898,1672614157,2259
10435,3453519360,3777937949,1672619384,1672621617,2233
10487,3791581138,3610517436,1672616383,1672619220,2837
10686,3356972733,3482639402,1672534491,1672536302,1811
9925,3393955069,3880882684,1672650963,1672652917,1954
10450,3311414429,3208594306,1672606828,1672607572,744
11744,3756695502,3491758029,1672615460,1672616769,1309
10189,3739297004,3500864577,1672555763,1672557427,1664
10027,3617771673,3600699873,1672683505,1672684630,1125
11156,3559112196,3811503860,1672532311,1672534639,2328
11726,3713224986,3445172440,1672571796,1672572462,666
11626,3248061684,3817376705,1672612430,1672615554,3124
10658,3520779124,3511867383,1672681450,1672681980,530
10344,3791509334,3713069234,1672569110,1672569531,421
9942,3516321814,3302988745,1672581970,1672583672,1702
11224,3927805949,3511907179,1672591546,1672594411,2865
9944,3852461753,3427049290,1672702206,1672704204,1998
11322,3714283424,3519065870,1672568557,1672570465,1908
10257,3783939161,3739297004,1672647349,1672649009,1660
10818,3850735936,3783594246,1672569138,1672572525,3387
10767,3364718040,3906874577,1672618884,1672619704,820
10681,3388946581,3220798451,1672575916,1672576330,414
10441,3776407517,3793497672,1672560302,1672561258,956
10628,3756328353,3351856699,1672582419,1672585319,2900
10178,3755357292,3370512945,1672658726,1672661613,2887
11379,3714516404,3600871715,1672599513,1672600035,522
10061,3334824744,3352493805,1672633530,1672635264,1734
10659,3553640169,3520273299,1672592723,1672595318,2595
10112,3736036532,3477248170,1672678356,1672679605,1249
11568,3315094386,3716841469,1672586750,1672589427,2677
10774,3713031958,3336225953,1672572490,1672574118,1628
11202,3512288503,3774195369,1672573174,1672575300,2126
11723,3713547793,3556684272,1672659112,1672661219,2107
9936,3513250976,3927805949,1672673438,1672676916,3478
11670,3397527886,3453464785,1672642533,1672645889,3356
11011,3517627003,3622654885,1672531957,1672532888,931
11516,3804707712,3714690161,1672611871,1672614695,2824
9956,3711852131,3915195160,1672682496,1672683124,628
10788,3701567668,3715737742,1672554555,1672556972,2417
11774,3935444008,3243305367,1672698660,1672700086,1426
9890,3501271930,3517151644,1672652732,1672655841,3109
10491,3462985379,3512857020,1672623815,1672627097,3282
11685,3701887470,3357026115,1672619296,1672619855,559
11174,3735679000,3423346297,1672569657,1672571852,2195
11448,3716733618,3384601925,1672621338,1672624388,3050
11777,3430032005,3730290851,1672688623,1672689383,760
10331,3520824937,3342426430,1672622721,1672624645,1924
9917,3518408734,3466620548,1672553195,1672554482,1287
10163,3774633364,3497904539,1672549496,1672549996,500
9964,3515548696,3513859809,1672689616,1672692690,3074
10919,3776953418,3756761603,1672601127,1672604319,3192
10461,3353335252,3893950585,1672618734,1672619851,1117
11284,3270502801,3491104534,1672617109,1672620016,2907
9840,3911431642,3393502004,1672684635,1672687272,2637
10564,3783060739,3770273459,1672544374,1672547700,3326
11577,3906260966,3774221318,1672655159,1672656856,1697
10309,3505816624,3896859936,1672623359,1672623638,279
10592,3510250740,3770533588,1672570726,1672572583,1857
11462,3809216145,3308149799,1672541735,1672542401,666
10944,3756428507,3500433278,1672550611,1672552474,1863
11080,3755865626,3893932944,1672570948,1672571356,408
11009,3311904032,3664719070,1672541391,1672542407,1016
10528,3231963246,3772489471,1672634994,1672635708,714
11049,3755154460,3285136057,1672594542,1672596508,1966
11242,3305656670,3488887919,1672536052,1672537328,1276
10059,3882851213,3509503263,1672672308,1672673057,749
11223,3514033319,3471555057,1672671631,1672673698,2067
10952,3662495290,3485151614,1672542911,1672544905,1994
11626,3701956841,3298113026,1672633331,1672635780,2449
10236,3514341451,3362368123,1672617990,1672620316,2326
9820,3409098014,3901169230,1672550010,1672552692,2682
11379,3287821258,3313579674,1672540413,1672543996,3583
11334,3660176760,3902548260,1672698803,1672700501,1698
11469,3465672238,3711804184,1672662438,1672664513,2075
11767,3900793652,3205687719,1672579105,1672580402,1297
10383,3308759754,3920890008,1672675217,1672677919,2702
10540,3512744657,3888057649,1672539371,1672540864,1493
10505,3510824484,3714718326,1672689536,1672692852,3316
11102,3534758256,3779748270,1672543051,1672544540,1489
9801,3737467358,3915035136,1672662066,1672665008,2942
10878,3774606418,3278443807,1672531231,1672532070,839
11602,3554317844,3301332095,1672572156,1672575458,3302
10276,3661359073,3236206821,1672657394,1672660275,2881
10709,3779212271,3923524564,1672654421,1672657422,3001
11676,3201957157,3835262447,1672563331,1672565165,1834
11463,3777200549,3357496255,1672548003,1672548769,766
10144,3279102372,3515802579,1672567844,1672569676,1832
10160,3755119166,3500994763,1672561177,1672562424,1247
11410,3485468650,3855977674,1672559626,1672559953,327
10425,3905358065,3511645260,1672665109,1672665931,822
10708,3300238532,3349319959,1672696379,1672698341,1962
9862,3933872044,3520016705,1672700323,1672702540,2217
10257,3510301454,3772882440,1672683573,1672686816,3243
10267,3478455812,3510301454,1672615125,1672616581,1456
11713,3309178914,3858497718,1672638899,1672641164,2265
10576,3780423516,3513171472,1672605817,1672606994,1177
10942,3500720752,3500442370,1672621000,1672624027,3027
10987,3533566754,3430823498,1672543933,1672546160,2227
11040,3886879696,3773161055,1672575668,1672579015,3347
11359,3311521176,3379076106,1672639768,1672641626,1858
11017,3778273230,3701925712,1672623441,1672626863,3422
11567,3303432071,3802625412,1672570447,1672573921,3474
10044,3772112976,3880000841,1672685600,1672687877,2277
10379,3443580855,3518572231,1672607425,1672608258,833
11267,3607583720,3757872458,1672668418,1672669661,1243
10068,3492056330,3716801088,1672650373,1672652833,2460
10049,3510240661,3501554468,1672702952,1672706399,3447
10308,3358982831,3302879906,1672629216,1672631009,1793
11777,3271389160,3534190196,1672534788,1672536450,1662
10527,3604569804,3703572036,1672659474,1672660703,1229
10478,3311569360,3773669001,1672655362,1672655911,549
11727,3311410533,3447312353,1672571058,1672573440,2382
11655,3375906394,3516321993,1672673952,1672675935,1983
11384,3512700007,3793364952,1672584408,1672585907,1499
11404,3612705426,3370448531,1672690180,1672693167,2987
10887,3813085701,3514297012,1672700300,1672703079,2779
10922,3284829602,3687445224,1672550551,1672551323,772
10525,3534278019,3387706541,1672618629,1672622061,3432
10689,3625952981,3512337054,1672629225,1672630432,1207
11216,3279102372,3633294415,1672612314,1672614327,2013
10299,3793732968,3505140123,1672582232,1672583845,1613
10428,3520824937,3500444748,1672585094,1672587811,2717
11366,3780050328,3716676869,1672654058,1672655903,1845
10496,3828354855,3776953418,1672640460,1672640944,484
10153,3835982340,3711671702,1672571503,1672575051,3548
9930,3319645922,3760271237,1672583749,1672585147,1398
11667,3793232021,3757378286,1672687975,1672690114,2139
11034,3342368576,3501873139,1672602938,1672605906,2968
10971,3910049345,3512087090,1672696686,1672697970,1284
11345,3311989687,3512546783,1672659412,1672661120,1708
9799,3779454060,3520160414,1672618155,1672618326,171
10813,3517756624,3783443095,1672546447,1672547724,1277
11232,3772216305,3791532324,1672674655,1672675853,1198
10155,3825234433,3908464960,1672702421,1672704830,2409
10663,3423147369,3899756737,1672589075,1672590215,1140
11348,3513203127,3780294116,1672639978,1672640832,854
10374,3487395357,3207586072,1672698978,1672702517,3539
10382,3356599815,3703443664,1672641361,1672643338,1977
9885,3791269060,3392482187,1672649326,1672652156,2830
10453,3307997700,3777932581,1672686192,1672687135,943
11166,3779818784,3757944870,1672590600,1672594056,3456
9819,3760274119,3689223632,1672550116,1672551605,1489
10650,3714688409,3418997135,1672546305,1672547760,1455
11693,3824259677,3613216900,1672581593,1672582869,1276
10624,3822786416,3854957153,1672597043,1672597886,843
10166,3760271237,3501927452,1672605788,1672605958,170
9866,3442564712,3517151644,1672693281,1672693498,217
11641,3907245259,3311805161,1672632392,1672634024,1632
9982,3779454060,3445172440,1672536227,1672537821,1594
11571,3520763492,3501992314,1672596290,1672599851,3561
9995,3477511446,3301449986,1672640375,1672643799,3424
11391,3498803823,3792900315,1672533764,1672534232,468
11745,3755630085,3403395712,1672627995,1672630959,2964
10378,3927675706,3755209597,1672669991,1672673441,3450
10009,3636885498,3334461288,1672635578,1672638159,2581
10285,3349475873,3807486812,1672652910,1672655457,2547
10256,3685083275,3517253559,1672587149,1672587313,164
11034,3299847117,3311410533,1672584751,1672585931,1180
10774,3287403291,3533265491,1672585036,1672587659,2623
10510,3240443426,3739387948,1672629307,1672631545,2238
10189,3518368900,3907039612,1672588976,1672590933,1957
10786,3516777819,3439283360,1672562565,1672566073,3508
11424,3428788958,3510218188,1672537660,1672538639,979
10560,3534168768,3239401337,1672626195,1672627276,1081
11680,3452024572,3619494735,1672613823,1672616888,3065
10887,3430310785,3520049965,1672667900,1672670049,2149
10882,3304661369,3420854927,1672660466,1672662933,2467
10282,3382757142,3515974881,1672544117,1672547457,3340
11605,3519908593,3313579674,1672703880,1672705282,1402
10983,3884369346,3806034626,1672647333,1672649937,2604
10555,3909504515,3453519360,1672537782,1672538456,674
10030,3241567995,3792972270,1672696979,1672697716,737
10796,3472173212,3817315443,1672640160,1672640363,203
9961,3711223297,3362385373,1672700861,1672704401,3540
10744,3470997293,3852461753,1672697323,1672700527,3204
11750,3931028233,3804095239,1672701230,1672701732,502
10680,3811503860,3347140733,1672701882,1672704315,2433
11106,3832745283,3501963428,1672686763,1672686932,169
11184,3736010012,3938059867,1672546857,1672550059,3202
11679,3858429342,3904485393,1672544017,1672545724,1707
10445,3778819352,3908550561,1672611864,1672612529,665
11532,3203630241,3701291994,1672590671,1672593746,3075
10785,3773738817,3710861700,1672693806,1672696213,2407
10239,3461137945,3757497708,1672560166,1672562129,1963
11745,3510882475,3603167427,1672623204,1672624038,834
11325,3493047640,3351728355,1672646989,1672648777,1788
11473,3519448648,3618024815,1672684808,1672687935,3127
11772,3601340045,3501027795,1672555519,1672555811,292
10677,3661359073,3778370462,1672616207,1672617529,1322
11197,3482172065,3714065165,1672679095,1672680466,1371
10099,3778838936,3755394177,1672556367,1672557399,1032
11367,3935256825,3511650296,1672580206,1672583122,2916
10982,3371184929,3302879906,1672532907,1672534649,1742
11787,3774035405,3505190512,1672667481,1672670643,3162
11723,3778927933,3439532406,1672564540,1672565525,985
9991,3713336088,3772461583,1672637956,1672640804,2848
11494,3505845400,3780129338,1672598843,1672601452,2609
11108,3510189563,3916673751,1672566902,1672566988,86
11436,3780238637,3713031958,1672685189,1672686858,1669
11188,3293553295,3715852330,1672618881,1672619409,528
10728,3776068937,3939851140,1672619040,1672622426,3386
9941,3662354016,3238796398,1672622669,1672623386,717
11560,3929446196,3380628097,1672661308,1672662597,1289
11057,3516321993,3701529552,1672536133,1672537575,1442
11675,3394394262,3517227599,1672601309,1672604267,2958
11305,3711938229,3241682278,1672645739,1672645977,238
10396,3226172318,3511078598,1672659487,1672662231,2744
10444,3515528947,3793442891,1672547670,1672550893,3223
10667,3510856388,3918981936,1672621522,1672622749,1227
11297,3481365330,3739217535,1672640353,1672643278,2925
10306,3732090606,3480185839,1672671133,1672671996,863
10802,3792455305,3371564186,1672666576,1672667565,989
10993,3632303304,3295787354,1672603889,1672607395,3506
10758,3773085258,3780680252,1672543988,1672546173,2185
10604,3500438542,3512645289,1672560686,1672562977,2291
10631,3779748270,3612841103,1672573418,1672575548,2130
10121,3553640169,3735197034,1672618075,1672621524,3449
10936,3737946004,3534937492,1672604029,1672606627,2598
10239,3774633364,3715441786,1672694966,1672695846,880
10480,3419378107,3463729805,1672610903,1672613416,2513
11716,3235578852,3516340010,1672574694,1672575443,749
11378,3896211741,3916463490,1672666259,1672668275,2016
11034,3971282455,3285587972,1672642322,1672645608,3286
10300,3513486828,3429315500,1672601843,1672603094,1251
11780,3476431618,3605905645,1672540890,1672542099,1209
11663,3713139039,3423147369,1672532358,1672535912,3554
10862,3534278019,3514611187,1672654712,1672657718,3006
10461,3297100323,3450234157,1672555851,1672559002,3151
10481,3774598935,3701374160,1672533250,1672534035,785
11178,3714903253,3896200048,1672588215,1672588703,488
10187,3513890046,3533726421,1672696471,1672698163,1692
11027,3780466967,3311015817,1672549288,1672550039,751
11640,3791072829,3462645981,1672671840,1672675241,3401
11597,3308965136,3505769529,1672694942,1672698307,3365
10440,3243763209,3881579907,1672607287,1672610468,3181
10972,3714919471,3500741005,1672688034,1672688461,427
10695,3342545285,3818236682,1672654206,1672656944,2738
10625,3793814153,3275274182,1672572419,1672572948,529
10486,3533976217,3516777819,1672664194,1672664639,445
11690,3715566511,3711889178,1672686010,1672688379,2369
11599,3770424941,3509379617,1672647851,1672648668,817
10350,3511095300,3394959062,1672570359,1672572687,2328
10236,3755230010,3517632796,1672673420,1672675797,2377
10804,3772980989,3200320674,1672596606,1672599007,2401
11240,3517325365,3479207976,1672545417,1672546736,1319
10950,3291936679,3514297012,1672551485,1672554923,3438
11000,3284407073,3480185839,1672562945,1672566351,3406
11645,3934564437,3714951681,1672562776,1672564343,1567
10683,3600302127,3856316719,1672621718,1672622332,614
10408,3776778306,3471996194,1672602755,1672605965,3210
11461,3411355804,3855209450,1672536794,1672539423,2629
11312,3714283424,3430032005,1672536723,1672539121,2398
11259,3714453773,3353326305,1672700716,1672703624,2908
11614,3533440294,3779975575,1672577035,1672579356,2321
11513,3557324887,3512697456,1672664072,1672666841,2769
10934,3501988762,3793934396,1672645227,1672646021,794
11218,3714281795,3814672661,1672595687,1672597528,1841
10718,3274239253,3449020351,1672574729,1672574908,179
10721,3716801088,3791994414,1672593997,1672596022,2025
10180,3777387533,3793719515,1672673718,1672674579,861
10255,3518534560,3350631472,1672675469,1672677796,2327
11245,3636877469,3739567072,1672566398,1672569907,3509
10715,3452175941,3512371853,1672583130,1672584702,1572
10869,3894495222,3510758718,1672550688,1672551779,1091
9804,3288675710,3245774173,1672588890,1672589166,276
10775,3714806574,3885674996,1672686063,1672687295,1232
9939,3773475506,3410788026,1672644696,1672647861,3165
9824,3500864577,3738160394,1672619637,1672619995,358
10949,3272581469,3730414796,1672667203,1672670415,3212
10880,3533365834,3703938162,1672545581,1672546046,465
11054,3511615015,3755924094,1672646177,1672648806,2629
10825,3772489471,3501554468,1672591045,1672592944,1899
10679,3505502819,3490953301,1672647853,1672648670,817
10935,3613936929,3893527651,1672604435,1672607988,3553
10225,3387700451,3299743638,1672693173,1672694195,1022
9965,3240683148,3774273260,1672568120,1672568503,383
9906,3242082716,3406132280,1672555143,1672555940,797
11397,3792475476,3472901378,1672582844,1672583340,496
11487,3500198430,3411355804,1672543322,1672546584,3262
9950,3436018575,3505011956,1672552489,1672553421,932
10918,3791072829,3621960662,1672543146,1672545054,1908
10037,3293540333,3791688526,1672680688,1672681484,796
10269,3501004005,3517617472,1672538784,1672541663,2879
11295,3935333166,3624164232,1672580563,1672581290,727
10230,3605905645,3851810349,1672625236,1672628511,3275
9877,3780921044,3701265238,1672697536,1672699708,2172
11543,3534506090,3780173788,1672641562,1672643795,2233
10023,3405435885,3202740652,1672588843,1672589392,549
11159,3505836431,3714951681,1672669399,1672671184,1785
10126,3452982957,3423346297,1672634894,1672636685,1791
10758,3533209168,3779382417,1672563176,1672565312,2136
11047,3760390822,3534372899,1672695923,1672698319,2396
10386,3500018566,3688410383,1672594577,1672596674,2097
9890,3732128078,3511028193,1672674658,1672675562,904
11236,3482687604,3470135167,1672579230,1672582171,2941
10687,3415803494,3911821258,1672547382,1672549635,2253
10038,3519260216,3792972270,1672535144,1672537534,2390
10798,3518209090,3779340538,1672667344,1672669867,2523
11200,3623953446,3370245766,1672571531,1672572865,1334
9906,3689386663,3435342362,1672547343,1672548960,1617
11569,3533876927,3917467642,1672592048,1672592180,132
10394,3339478490,3533009565,1672629291,1672630844,1553
10361,3760274119,3501977123,1672550101,1672553506,3405
10904,3510454018,3358959807,1672635784,1672639384,3600
10023,3505359060,3778986795,1672570073,1672570212,139
10045,3638018906,3376842515,1672649145,1672651798,2653
11735,3559123082,3304028109,1672698702,1672699456,754
11563,3824135033,3619705594,1672639479,1672639546,67
10216,3774782065,3834980281,1672597133,1672599584,2451
11499,3711836873,3662507634,1672541845,1672544793,2948
11131,3713728777,3773024346,1672644807,1672646868,2061
10482,3776841808,3516429380,1672673125,1672673255,130
10981,3362385373,3667654673,1672638290,1672640982,2692
10272,3395069149,3777641081,1672696113,1672696781,668
10331,3807486812,3807717766,1672658940,1672660629,1689
10115,3516454693,3711856534,1672554485,1672556717,2232
10283,3550887623,3394357241,1672662372,1672665298,2926
10861,3534372899,3311414429,1672594267,1672594912,645
11178,3716633983,3442564712,1672642769,1672643679,910
11173,3711613085,3461137945,1672591653,1672593532,1879
10443,3772131127,3828568868,1672691339,1672692291,952
10092,3774606418,3447948483,1672596673,1672597737,1064
9970,3801379377,3304672737,1672668751,1672670090,1339
11005,3465107990,3802757611,1672621714,1672622125,411
11563,3703896751,3500209015,1672688205,1672688631,426
10653,3433902955,3772425253,1672689813,1672691578,1765
11764,3418382025,3519951586,1672584053,1672586928,2875
9861,3298706213,3404461403,1672613439,1672615372,1933
11500,3500589560,3517045396,1672532867,1672533109,242
11118,3770630937,3444598583,1672667693,1672670985,3292
11422,3382670400,3773394570,1672567432,1672569419,1987
10347,3425260097,3370448531,1672642962,1672645439,2477
10710,3372778334,3311409212,1672619970,1672621208,1238
9973,3931028233,3335055096,1672680674,1672684010,3336
10086,3509445318,3833520635,1672592298,1672593988,1690
10644,3884388188,3469350379,1672663163,1672666548,3385
11383,3509317776,3446764595,1672563977,1672564569,592
10325,3398075553,3553321027,1672635810,1672639285,3475
9933,3519297683,3519703964,1672675281,1672676136,855
11591,3780352400,3512417724,1672614325,1672617706,3381
11728,3519513219,3496591885,1672689491,1672692169,2678
10127,3632303304,3505994703,1672665661,1672668702,3041
10096,3716982179,3920526713,1672545647,1672548112,2465
10801,3757604311,3715844082,1672587306,1672590781,3475
11540,3275661834,3605101443,1672594311,1672597550,3239
11006,3662055682,3681274982,1672662216,1672663203,987
10405,3791906680,3710051427,1672703307,1672705681,2374
11677,3380167818,3772188086,1672549420,1672552365,2945
11166,3479910993,3838423363,1672563776,1672565013,1237
10626,3360837082,3246395239,1672613601,1672616567,2966
10589,3435715962,3791796190,1672692528,1672693142,614
10432,3756685732,3932491622,1672637077,1672637923,846
10393,3358982831,3245882008,1672536578,1672539928,3350
11739,3614944981,3511526885,1672533607,1672535624,2017
11462,3774251051,3791542842,1672538830,1672538963,133
11267,3379076106,3917243005,1672684812,1672686443,1631
10138,3755378125,3715490209,1672568590,1672570143,1553
11196,3399943757,3600978954,1672691004,1672694212,3208
11579,3343767438,3760080378,1672664790,1672665212,422
9878,3703474558,3511608609,1672615671,1672617665,1994
10259,3500785888,3609166109,1672626644,1672627012,368
11124,3730052916,3515284733,1672624827,1672628036,3209
11056,3737946004,3226172318,1672578977,1672580734,1757
11340,3516257130,3835982340,1672552521,1672553979,1458
11428,3501427691,3977880564,1672633050,1672634127,1077
10048,3939882169,3292050211,1672673426,1672674853,1427
11547,3608973523,3780466967,1672597062,1672597318,256
10451,3770476738,3716467469,1672561502,1672563567,2065
10804,3201573194,3500178849,1672644815,1672646364,1549
11734,3510542303,3757773786,1672546997,1672548754,1757
11053,3505129296,3757660578,1672554043,1672555797,1754
9877,3730052916,3777564559,1672680405,1672682322,1917
10476,3458271585,3890211161,1672599868,1672602590,2722
10812,3518572231,3509252934,1672555659,1672557136,1477
11450,3837885956,3311696372,1672638812,1672639000,188
10807,3925823748,3777937949,1672699215,1672699411,196
10374,3301489209,3440401725,1672619606,1672621234,1628
10278,3774447975,3447696555,1672694210,1672697304,3094
11670,3500096103,3493047640,1672673075,1672674368,1293
10397,3515893948,3919994216,1672606169,1672606796,627
11704,3458753033,3422959249,1672675673,1672676761,1088
11251,3777118499,3516819320,1672615207,1672617739,2532
10168,3512417724,3510826414,1672548544,1672550632,2088
10115,3500251781,3439662051,1672637110,1672638883,1773
10509,3773344258,3428325402,1672681895,1672684495,2600
10289,3284334297,3203151036,1672615134,1672615280,146
10691,3701493094,3294326116,1672684957,1672686165,1208
11525,3887030182,3515681585,1672540801,1672543736,2935
10604,3714640103,3437108337,1672533196,1672535028,1832
10569,3716740576,3684199077,1672658218,1672659530,1312
9952,3519754667,3713954144,1672696262,1672698249,1987
11200,3897500723,3772893815,1672685217,1672686731,1514
11490,3511003541,3715566511,1672546295,1672548372,2077
10885,3500120676,3500799617,1672548702,1672551274,2572
10764,3511218261,3533777032,1672532480,1672533759,1279
10336,3791382196,3711404205,1672583172,1672585692,2520
10943,3358211034,3520558137,1672601710,1672602858,1148
10205,3778273230,3398862999,1672551871,1672554833,2962
10091,3604908372,3710891331,1672539999,1672542841,2842
10467,3514327931,3711671702,1672540196,1672541370,1174
10360,3713740434,3554437212,1672535933,1672537754,1821
10656,3825234433,3770275898,1672637116,1672638279,1163
10951,3791121243,3520473111,1672602692,1672603860,1168
10502,3474852115,3713805968,1672670299,1672672753,2454
10750,3463564410,3912625932,1672696886,1672700195,3309
10053,3701824335,3778253021,1672640221,1672642090,1869
9985,3319061210,3778604070,1672702705,1672703884,1179
10260,3791688526,3361789225,1672668088,1672671639,3551
10029,3505173665,3612042508,1672549406,1672549545,139
11170,3934070285,3514508773,1672670854,1672673155,2301
10783,3779174993,3424988692,1672540183,1672541424,1241
9887,3756685732,3899756737,1672541377,1672542557,1180
9807,3776034313,3505828210,1672595190,1672596730,1540
11433,3668720465,3510189563,1672694411,1672695730,1319
11193,3618024815,3756876537,1672582149,1672582800,651
10861,3792021895,3896859936,1672682481,1672685189,2708
10168,3303552616,3389367628,1672598261,1672601556,3295
10364,3319585148,3245642576,1672700095,1672700590,495
11056,3400112498,3714283424,1672695162,1672695254,92
11748,3909504515,3760390822,1672674703,1672677306,2603
9925,3920155862,3779835734,1672575306,1672578873,3567
10424,3514306458,3687024828,1672636731,1672639733,3002
9923,3510864325,3500640854,1672633656,1672634983,1327
11243,3456795601,3515939841,1672668583,1672669726,1143
10643,3487779363,3479585868,1672655612,1672656578,966
10758,3756647451,3201419050,1672655709,1672658859,3150
11147,3289017988,3287760230,1672531604,1672534085,2481
10322,3369108286,3557129226,1672606513,1672607928,1415
11128,3447267291,3469780362,1672600679,1672603609,2930
10707,3680939042,3713219299,1672562158,1672562314,156
11648,3302348002,3783176874,1672555772,1672556371,599
11001,3711870537,3534506090,1672634744,1672637686,2942
10084,3510335069,3710316008,1672556465,1672557630,1165
11050,3711938229,3515379622,1672633615,1672634430,815
10152,3687183789,3783443095,1672537638,1672540573,2935
10797,3792633495,3711844574,1672551406,1672553639,2233
10857,3519754667,3284865931,1672607631,1672608207,576
11230,3780435349,3343859998,1672633032,1672636370,3338
10692,3703168159,3688870751,1672548446,1672551081,2635
10580,3357026115,3713611960,1672630667,1672632042,1375
10631,3710271021,3475560058,1672633257,1672633650,393
11678,3778100960,3393128259,1672638163,1672640175,2012
10581,3711349327,3760801237,1672615822,1672619295,3473
10319,3342545285,3505853594,1672645874,1672647391,1517
11635,3227498870,3459694275,1672594042,1672597611,3569
10201,3602401154,3364302157,1672596992,1672597623,631
11591,3773475506,3399734748,1672650545,1672653376,2831
11731,3703277359,3910190872,1672562666,1672564079,1413
10800,3757407184,3516668203,1672686504,1672688653,2149
11683,3756525103,3773475506,1672591414,1672593160,1746
11779,3713219299,3807800457,1672639392,1672642076,2684
11663,3519319233,3804075198,1672539479,1672542957,3478
11785,3975799349,3611533094,1672534999,1672537728,2729
10245,3446810761,3303772923,1672575815,1672577067,1252
11192,3533225084,3284865931,1672638414,1672639041,627
11561,3897003751,3757944870,1672571504,1672572195,691
11518,3472718723,3293579860,1672685341,1672687357,2016
11524,3224824355,3513800589,1672594293,1672594744,451
10286,3773161055,3716475340,1672603767,1672604471,704
11317,3713416106,3792797648,1672570042,1672571567,1525
11765,3701519251,3349319959,1672699588,1672701691,2103
11364,3519174861,3777909822,1672673984,1672675926,1942
11317,3478455812,3777564559,1672569377,1672571582,2205
10464,3511864772,3206217657,1672664619,1672666745,2126
11299,3774706478,3783043770,1672688049,1672688246,197
11515,3276209319,3514685272,1672552014,1672555524,3510
11441,3512417028,3757924067,1672536347,1672539238,2891
10025,3285515107,3710271021,1672542543,1672545407,2864
10846,3513586642,3885645840,1672624874,1672625878,1004
11475,3897851509,3774965463,1672674284,1672676301,2017
9995,3779427180,3703659324,1672693610,1672694238,628
10373,3517021928,3891272544,1672624377,1672627432,3055
10164,3970265139,3783430498,1672545159,1672547560,2401
10411,3311142523,3555764822,1672591754,1672593422,1668
10133,3500726347,3205324639,1672568830,1672569098,268
10980,3505416534,3405435885,1672556893,1672559978,3085
11387,3513739060,3509382404,1672682826,1672683614,788
10930,3807717766,3533703578,1672543756,1672545981,2225
9907,3520506192,3341311972,1672631473,1672634049,2576
11118,3483347530,3757201138,1672594329,1672594789,460
10500,3295530454,3533841983,1672544486,1672547744,3258
10715,3602054754,3370751461,1672698408,1672700339,1931
11267,3514941815,3755378125,1672566398,1672567878,1480
10676,3903994989,3776125503,1672541950,1672543965,2015
10938,3419648004,3304227085,1672672502,1672674548,2046
10252,3832333115,3345954031,1672657520,1672660632,3112
9854,3774436159,3736621212,1672635660,1672639093,3433
11290,3505175620,3505011956,1672585052,1672586180,1128
9876,3201634072,3515944817,1672557942,1672559740,1798
10968,3319529422,3298113026,1672658497,1672661953,3456
10419,3510153173,3664719070,1672539125,1672541810,2685
10239,3757446082,3519621901,1672602623,1672604474,1851
11307,3510206323,3666655293,1672659359,1672659767,408
10720,3852014884,3620836520,1672552006,1672553268,1262
10336,3714806574,3459163055,1672636358,1672638594,2236
11346,3520155898,3239990061,1672600062,1672600146,84
10988,3505811269,3311569360,1672614094,1672614573,479
10608,3668154066,3663505156,1672573722,1672576643,2921
10530,3514353133,3233965781,1672646434,1672647258,824
11523,3738734246,3505173665,1672588874,1672588953,79
10262,3939882169,3813276198,1672686262,1672687621,1359
10051,3338195686,3880030249,1672577813,1672578849,1036
11239,3553229537,3856897914,1672556301,1672558316,2015
10846,3519319233,3346755179,1672636234,1672638615,2381
10846,3505278562,3716179251,1672570982,1672572033,1051
11003,3851515560,3881012415,1672635525,1672638193,2668
9803,3777074709,3505709407,1672637912,1672640076,2164
10884,3390444181,3755209597,1672618249,1672619526,1277
11659,3716160006,3934564437,1672642785,1672644390,1605
11589,3519319233,3927805949,1672685184,1672688078,2894
11237,3492350318,3900766525,1672682786,1672685275,2489
11091,3340321384,3517469005,1672621600,1672622150,550
10881,3919258737,3701567668,1672589778,1672590488,710
11230,3858330969,3309455369,1672652869,1672654968,2099
10501,3716160006,3776122272,1672631022,1672633093,2071
10740,3915962248,3307454562,1672608357,1672610374,2017
11206,3783730769,3783238023,1672578046,1672578366,320
9803,3623113240,3510919509,1672639593,1672641278,1685
10119,3468343480,3468343480,1672673577,1672677071,3494
10556,3273758330,3601063076,1672631333,1672633421,2088
9896,3519228207,3500429731,1672683433,1672686750,3317
10284,3400560073,3792289287,1672696167,1672696882,715
11218,3773738817,3703999217,1672662520,1672663933,1413
10884,3513894659,3313298164,1672535832,1672536330,498
11085,3505720915,3511750850,1672618118,1672618529,411
10736,3701291994,3509508477,1672595663,1672598544,2881
11506,3510781595,3516969689,1672548336,1672550017,1681
10284,3473520701,3714883746,1672562223,1672565243,3020
10285,3393376416,3477582923,1672543857,1672546561,2704
9963,3519724388,3279731391,1672539055,1672540623,1568
10393,3780142207,3370512945,1672680461,1672683165,2704
10939,3519165527,3734957248,1672623635,1672625083,1448
9898,3408982612,3428076194,1672540340,1672543492,3152
10504,3512857020,3783651407,1672662337,1672664083,1746
11079,3681274982,3343193067,1672635652,1672638459,2807
10150,3701171318,3380185102,1672642322,1672645864,3542
10396,3791664049,3285587972,1672661217,1672661503,286
10707,3489212992,3703611876,1672656213,1672658129,1916
11749,3688845298,3436099135,1672658726,1672660226,1500
11599,3778842400,3921138062,1672666929,1672667790,861
10239,3517530943,3793949077,1672667095,1672667264,169
9943,3778695895,3772869013,1672617501,1672618805,1304
10892,3238997746,3663505156,1672685306,1672688866,3560
11622,3509274030,3772250554,1672623578,1672626520,2942
9939,3517645656,3518572231,1672690198,1672690283,85
11485,3513563152,3773378103,1672534589,1672535298,709
11278,3534578428,3776710698,1672671218,1672674565,3347
10813,3772114731,3222364320,1672589077,1672590415,1338
11683,3469780362,3817038422,1672648477,1672651723,3246
10146,3236886943,3926065090,1672607614,1672608544,930
10853,3222357355,3276209319,1672593339,1672596449,3110
11433,3776468503,3780048608,1672589599,1672592758,3159
11221,3445733121,3519351747,1672607139,1672609434,2295
9905,3403870769,3500974385,1672570182,1672570567,385
11550,3235470567,3516319492,1672677268,1672680544,3276
10518,3472272792,3305727497,1672665486,1672666347,861
9978,3398075553,3755465396,1672603363,1672605719,2356
11048,3278805844,3231271498,1672657399,1672659769,2370
10940,3513486828,3495427619,1672696667,1672697091,424
11086,3804095239,3733870816,1672535803,1672539383,3580
11761,3463892928,3438818153,1672685589,1672687784,2195
10167,3422915648,3924205112,1672595031,1672596047,1016
10177,3515100211,3534984243,1672566730,1672569929,3199
11578,3517992521,3513629502,1672625172,1672625446,274
10624,3600699873,3367299721,1672663298,1672666050,2752
10815,3703725221,3476416072,1672562692,1672564237,1545
11103,3246062632,3814672661,1672533751,1672537215,3464
10142,3331228758,3514013999,1672579492,1672582683,3191
9955,3370448531,3468201976,1672592901,1672594752,1851
10013,3755790149,3776867553,1672593508,1672594473,965
11588,3931164237,3555215568,1672675204,1672676065,861
10420,3632094087,3516429380,1672649797,1672653122,3325
10285,3888409038,3309178914,1672635527,1672638992,3465
10909,3776309810,3319660530,1672654996,1672658039,3043
11145,3479402555,3469780362,1672620942,1672624243,3301
11097,3615742989,3367109648,1672636183,1672639444,3261
10725,3773853619,3777552831,1672682807,1672683267,460
11344,3716733618,3533419409,1672557507,1672560000,2493
10144,3638126174,3820922991,1672602429,1672604769,2340
10704,3825932442,3711767051,1672572028,1672572341,313
11378,3437703650,3553008208,1672681900,1672684736,2836
10531,3701459978,3806720019,1672651825,1672653770,1945
11460,3500120676,3632094087,1672665481,1672667601,2120
9965,3270607273,3976400190,1672567562,1672567657,95
11231,3716526314,3510824484,1672644859,1672646170,1311
10382,3406390503,3500994763,1672674643,1672677717,3074
10923,3203630241,3919494952,1672644821,1672647613,2792
9853,3312733562,3272328752,1672628535,1672629254,719
10337,3774401596,3519059808,1672567959,1672571260,3301
10032,3403988682,3500579482,1672631052,1672632911,1859
10366,3500104976,3633294415,1672590762,1672593423,2661
10948,3711854614,3732467455,1672543452,1672543630,178
9949,3907225070,3505720915,1672658859,1672661662,2803
10159,3783238023,3774965463,1672613090,1672613795,705
10224,3513890046,3711959141,1672649387,1672650711,1324
11202,3534206917,3393543588,1672560732,1672561458,726
10831,3501271930,3468281011,1672553687,1672554378,691
11328,3931319307,3207307681,1672600733,1672602851,2118
10559,3513764665,3376842515,1672582787,1672584363,1576
9914,3792578118,3289771213,1672699480,1672699642,162
11605,3331228758,3330318282,1672654383,1672657096,2713
11246,3505936495,3770595035,1672535054,1672535155,101
11649,3342368576,3711591464,1672576142,1672577128,986
11247,3512337054,3638050763,1672626936,1672630249,3313
11133,3909067335,3505011956,1672691098,1672691770,672
9917,3931164237,3779282072,1672611162,1672614119,2957
11242,3774589551,3203172170,1672647028,1672647981,953
10370,3733915784,3517132086,1672552301,1672554382,2081
10130,3807486812,3920526713,1672623897,1672626079,2182
11287,3477248170,3903879740,1672664580,1672667568,2988
11376,3510542303,3776968640,1672622145,1672625238,3093
10483,3857609616,3772877723,1672660937,1672663769,2832
10567,3683047199,3792578118,1672561731,1672562443,712
10374,3228033254,3482519872,1672559979,1672560774,795
10372,3505502819,3773024346,1672613287,1672614247,960
10548,3715858201,3662495290,1672548572,1672548831,259
9904,3715106566,3777041132,1672643224,1672645084,1860
11651,3515405509,3236948071,1672660248,1672661909,1661
10520,3494748808,3500105301,1672618514,1672619000,486
11295,3533822490,3516340010,1672584558,1672588084,3526
10821,3519435459,3367202274,1672601019,1672602847,1828
10236,3613940925,3834643026,1672553467,1672556962,3495
11050,3509445318,3382670400,1672683065,1672685384,2319
10959,3917905192,3774506868,1672584240,1672586697,2457
11263,3220798451,3372079985,1672547395,1672550255,2860
11084,3512769522,3533620069,1672620536,1672621613,1077
10283,3224053840,3713920790,1672625830,1672628971,3141
9838,3505438826,3515528947,1672545646,1672546408,762
10354,3290097447,3736010012,1672682633,1672682742,109
10895,3450511428,3500211484,1672535904,1672538811,2907
11462,3517377614,3805704844,1672682824,1672685286,2462
11113,3977615973,3778713526,1672543387,1672544273,886
10406,3425260097,3314363575,1672588116,1672590291,2175
10445,3635433296,3884934977,1672543422,1672544301,879
9891,3534362749,3500433278,1672652260,1672655380,3120
9916,3501557463,3511286390,1672687044,1672687536,492
11574,3779255367,3703779674,1672605476,1672606225,749
10757,3500429731,3777706200,1672660604,1672662596,1992
10588,3307791650,3713100169,1672590872,1672591197,325
9794,3760648750,3713805968,1672615759,1672617657,1898
9796,3770424941,3517195738,1672602000,1672604637,2637
10203,3209925780,3245121919,1672544728,1672544857,129
11144,3371238318,3665841655,1672574392,1672577839,3447
11245,3760080378,3520470646,1672535688,1672537758,2070
10941,3517021928,3312800145,1672671019,1672671543,524
10302,3711187791,3515577866,1672569836,1672571670,1834
9802,3360949039,3904184638,1672612214,1672613563,1349
10944,3760656396,3856699097,1672622732,1672625441,2709
10007,3680939042,3517627003,1672664184,1672665368,1184
10676,3684108920,3304592684,1672588176,1672589904,1728
11428,3534562354,3245245283,1672644553,1672647007,2454
10981,3501370430,3374147279,1672536765,1672538294,1529
11401,3619796619,3776001441,1672562074,1672563089,1015
10697,3513563152,3287094447,1672575423,1672576807,1384
10797,3512826895,3793860209,1672641987,1672644649,2662
11453,3686081254,3510262025,1672651487,1672654692,3205
9813,3623512088,3755175497,1672555039,1672556410,1371
9901,3514980025,3755107521,1672618372,1672619611,1239
10682,3783043770,3780740477,1672533559,1672536071,2512
10947,3275735969,3817029483,1672696301,1672697243,942
11718,3342056927,3429409539,1672630108,1672630860,752
11655,3515726910,3489212992,1672636503,1672637345,842
10443,3429047448,3818324410,1672607723,1672607913,190
11266,3441336851,3511095300,1672681897,1672684377,2480
11583,3886957097,3661543201,1672670096,1672671850,1754
11637,3791664049,3713969196,1672676151,1672676834,683
11461,3776249160,3916955566,1672621426,1672622505,1079
10301,3773017746,3276231633,1672696474,1672698288,1814
10061,3288346356,3424988692,1672568037,1672570960,2923
10190,3783408469,3978643889,1672613139,1672614105,966
10847,3278251248,3793783685,1672633231,1672634951,1720
10147,3491250381,3515893948,1672600069,1672602014,1945
11719,3500429731,3511199555,1672659370,1672660702,1332
11599,3512802259,3422314045,1672622247,1672625812,3565
10203,3715724166,3895507040,1672683826,1672685557,1731
11430,3509828883,3904184638,1672667552,1672671045,3493
11438,3509503263,3419829238,1672682150,1672685295,3145
10705,3284865931,3774035405,1672637341,1672640909,3568
10819,3332124606,3757728121,1672677619,1672680127,2508
9865,3666022373,3826542169,1672585270,1672588796,3526
9949,3684651755,3777370992,1672587853,1672591234,3381
10932,3505496725,3970851830,1672596934,1672599989,3055
11073,3916463490,3791974273,1672641361,1672643527,2166
11749,3513432588,3444453261,1672686040,1672686414,374
11410,3289258397,3856699097,1672580227,1672580610,383
11127,3509382404,3780352400,1672672861,1672675458,2597
10076,3206241691,3773554767,1672660850,1672661732,882
10391,3807717766,3710149975,1672627311,1672628610,1299
11187,3200785194,3630802959,1672553267,1672554573,1306
10671,3375906394,3713434898,1672603970,1672604240,270
11483,3300810210,3817038422,1672572633,1672573791,1158
11443,3666823095,3393543588,1672665782,1672667880,2098
10285,3372079985,3780308809,1672572920,1672574384,1464
11663,3793899166,3710397477,1672683953,1672685751,1798
11479,3453464785,3516153301,1672600803,1672603010,2207
11149,3711810752,3900793652,1672642517,1672644076,1559
10713,3512495325,3755273361,1672569662,1672572789,3127
11168,3513739060,3915035136,1672638499,1672639680,1181
11278,3366501813,3465672238,1672613087,1672615435,2348
10594,3770276815,3756685732,1672688534,1672689818,1284
11305,3710119555,3622458047,1672678353,1672679791,1438
11458,3682241594,3856897914,1672569532,1672569971,439
11191,3514033319,3469350379,1672620389,1672621280,891
11758,3732128078,3777706200,1672660259,1672661988,1729
10543,3662522808,3520473111,1672605328,1672606613,1285
11691,3500079479,3501628472,1672628705,1672630734,2029
10540,3756157377,3534589501,1672639566,1672642651,3085
11413,3715923089,3711755596,1672641940,1672644641,2701
11456,3935444008,3475560058,1672629281,1672632050,2769
9885,3397330170,3295748489,1672583910,1672584366,456
11775,3509996827,3520189871,1672600204,1672603633,3429
10551,3772216305,3500019810,1672544659,1672545217,558
9944,3760397450,3516588277,1672594308,1672597676,3368
10876,3275661834,3288791629,1672585140,1672588418,3278
10117,3505278562,3710861700,1672625103,1672625616,513
10546,3342368576,3756850160,1672567128,1672569470,2342
11417,3836136159,3730169449,1672634383,1672636843,2460
11122,3701521510,3420854927,1672700169,1672701058,889
9902,3711430738,3755218683,1672620473,1672621434,961
11094,3713224038,3429333292,1672585142,1672585241,99
10659,3917243005,3714281210,1672640594,1672642083,1489
10335,3510189563,3826315540,1672695198,1672698470,3272
9912,3311200541,3509431396,1672556716,1672558177,1461
10756,3760737203,3881785069,1672699022,1672700969,1947
10258,3361789225,3500211484,1672597272,1672599651,2379
11065,3375906394,3501612813,1672548613,1672549248,635
10863,3493515706,3220987526,1672649833,1672652683,2850
11771,3793364952,3307454562,1672570586,1672572068,1482
11198,3405221863,3435652260,1672565583,1672566487,904
10731,3385006834,3294164983,1672629978,1672631007,1029
10153,3779609338,3464622743,1672607146,1672610374,3228
11410,3516572212,3760144712,1672636444,1672639534,3090
10984,3909632424,3772962072,1672633028,1672634620,1592
11408,3514353133,3772291207,1672590511,1672593820,3309
11593,3278805844,3420664407,1672683464,1672685892,2428
11628,3501370430,3773024346,1672684069,1672685527,1458
11008,3227647190,3713219299,1672559766,1672562491,2725
10262,3616242727,3701675183,1672664048,1672666462,2414
10210,3626631210,3669427589,1672551315,1672551872,557
11607,3378430760,3424988692,1672653999,1672655519,1520
11241,3516200419,3517227599,1672540453,1672543533,3080
10337,3972856326,3461931154,1672675389,1672678770,3381
11117,3505491969,3381244346,1672553438,1672556736,3298
10692,3445558740,3311197635,1672651580,1672651806,226
10871,3520553959,3461137945,1672596836,1672598594,1758
11342,3776778306,3366566029,1672552918,1672553066,148
10956,3471585513,3519015940,1672689694,1672690562,868
11676,3855674398,3919984986,1672541464,1672544114,2650
10176,3803473387,3821087562,1672675248,1672678847,3599
9974,3445406685,3834456158,1672686694,1672688899,2205
9902,3450735824,3206544535,1672624434,1672627877,3443
11463,3756680289,3711844574,1672627133,1672628311,1178
10866,3923133978,3515577866,1672580193,1672582852,2659
9905,3362368123,3714287902,1672553736,1672555472,1736
10077,3776124041,3783939161,1672544241,1672546173,1932
10927,3284374600,3515470462,1672537406,1672540143,2737
11607,3757851680,3715114417,1672588803,1672589342,539
10822,3534362749,3756759239,1672546150,1672547619,1469
11548,3511095300,3615742989,1672584124,1672587534,3410
10060,3463729805,3835982340,1672625333,1672627429,2096
10932,3234445133,3776001441,1672620590,1672623956,3366
11488,3780482864,3772234939,1672655707,1672657516,1809
10943,3505032644,3398075553,1672584809,1672586893,2084
10685,3791070926,3505155858,1672547646,1672547893,247
10187,3511650296,3513850048,1672605508,1672608257,2749
11223,3316406470,3855077502,1672616142,1672618244,2102
11247,3446810761,3770924034,1672531538,1672533109,1571
10977,3714268380,3398483531,1672579788,1672580771,983
10954,3390438262,3756525103,1672585859,1672588697,2838
11326,3756761603,3444397804,1672548128,1672551217,3089
10263,3777729184,3341311972,1672650182,1672650963,781
10625,3351153781,3417268745,1672691727,1672692392,665
10554,3378172464,3509274030,1672674128,1672676937,2809
10771,3505936495,3505173665,1672537158,1672540558,3400
11142,3755729826,3302416197,1672633242,1672635893,2651
11063,3773579644,3512768285,1672538094,1672539407,1313
11285,3778706119,3791587717,1672600786,1672603676,2890
10800,3294326116,3809207482,1672648717,1672651377,2660
11085,3519948471,3402338011,1672562774,1672563567,793
10361,3229465607,3756149282,1672685449,1672686357,908
10062,3793814153,3933106901,1672616495,1672618723,2228
10320,3514941815,3510454018,1672677153,1672679343,2190
10099,3516486526,3703415246,1672532851,1672534080,1229
11178,3824135033,3309415277,1672654851,1672657639,2788
9986,3501657158,3207497598,1672545037,1672547839,2802
11081,3783594246,3553694590,1672669628,1672670431,803
10297,3312733562,3822315407,1672693352,1672695397,2045
11066,3533974355,3512681214,1672681619,1672682056,437
11036,3534206917,3463729805,1672698272,1672699329,1057
10281,3505032773,3515284733,1672561877,1672565180,3303
11505,3732128078,3208594306,1672611405,1672612257,852
10012,3397330170,3519000878,1672675820,1672676209,389
10775,3713547793,3772689657,1672537327,1672539232,1905
10175,3614944981,3516517348,1672618071,1672620109,2038
10732,3440671139,3500421940,1672664196,1672667139,2943
10300,3284483177,3703697059,1672610029,1672610745,716
9816,3517358336,3557528150,1672693365,1672694615,1250
10818,3770924034,3632720032,1672671094,1672673738,2644
10737,3817478012,3701841013,1672660630,1672661607,977
9925,3779282072,3516103646,1672672141,1672673218,1077
10946,3773891827,3755203055,1672620719,1672621686,967
10088,3311463998,3772114731,1672573787,1672576619,2832
11440,3513186578,3500674240,1672700782,1672701019,237
11185,3829698950,3776732532,1672606920,1672610257,3337
10470,3516867729,3774401596,1672556269,1672558765,2496
11082,3552444228,3518408734,1672661210,1672661378,168
9985,3427741923,3904004824,1672574255,1672576563,2308
10020,3774702364,3906075386,1672650134,1672652836,2702
11415,3362127525,3805831563,1672595109,1672597887,2778
9999,3292663993,3756781024,1672618682,1672620232,1550
9941,3822786416,3514698862,1672540690,1672541876,1186
11606,3400793223,3511907179,1672646552,1672646962,410
11443,3857590978,3776193847,1672534369,1672536226,1857
10952,3791716170,3831981073,1672636378,1672639176,2798
11108,3820922991,3294164983,1672675671,1672676822,1151
11517,3783043770,3791905743,1672592878,1672595647,2769
11268,3441737317,3356599815,1672547860,1672550005,2145
10346,3519948471,3514560138,1672570900,1672574040,3140
10012,3820200446,3760749218,1672593808,1672594947,1139
9816,3773534165,3505066871,1672684447,1672685823,1376
10249,3792021895,3711404205,1672684511,1672686442,1931
10164,3856316719,3685083275,1672699333,1672701201,1868
10087,3793926338,3233993993,1672694478,1672695424,946
11087,3505117019,3519165527,1672586427,1672586950,523
10584,3437023385,3774606418,1672636833,1672637535,702
10455,3715441786,3495637721,1672544810,1672546404,1594
11064,3311739926,3239082508,1672626675,1672629894,3219
10213,3534506090,3895944547,1672579034,1672582508,3474
10064,3783730769,3238796398,1672676107,1672677639,1532
10724,3500421940,3206262649,1672549614,1672552635,3021
11609,3311529105,3400112498,1672601510,1672603139,1629
11459,3533816813,3351837521,1672558229,1672560391,2162
11095,3238310644,3501600785,1672693699,1672694085,386
10452,3516904926,3792012147,1672558787,1672560539,1752
11241,3896615831,3757064623,1672625169,1672627685,2516
11772,3793902476,3311583437,1672575529,1672576922,1393
10902,3760346746,3534758256,1672620345,1672622787,2442
11446,3857590978,3713514933,1672563196,1672566135,2939
10643,3791617239,3711870537,1672620577,1672623719,3142
9938,3837888196,3517331746,1672600141,1672602574,2433
11470,3716445184,3485521840,1672562026,1672563840,1814
11746,3812677669,3792627762,1672683930,1672687269,3339
10116,3908177413,3420854927,1672696918,1672699653,2735
10169,3519780867,3500209015,1672628536,1672631597,3061
9973,3609166109,3505173665,1672555385,1672557103,1718
11764,3818570577,3444646562,1672565912,1672566830,918
10234,3791332061,3756493561,1672538395,1672540334,1939
11251,3683677062,3760679372,1672699458,1672702566,3108
10384,3755570137,3517499844,1672567198,1672568558,1360
11121,3247075753,3713611960,1672541727,1672541794,67
10866,3685396470,3342837214,1672626891,1672628238,1347
11331,3492728794,3783939161,1672630176,1672633529,3353
10658,3778318250,3888523259,1672643714,1672645487,1773
11647,3792012147,3381055770,1672656271,1672658143,1872
11676,3519754667,3613216900,1672657126,1672660401,3275
11343,3927763819,3419648004,1672702338,1672703895,1557
10404,3509208005,3395615598,1672563199,1672563419,220
10756,3926065090,3558567160,1672670633,1672672362,1729
11509,3667814788,3514005973,1672674931,1672676509,1578
10173,3713996094,3791031227,1672701774,1672704206,2432
9848,3516340010,3495482863,1672652638,1672655881,3243
10688,3501574882,3330188769,1672703627,1672705832,2205
11636,3715291931,3783122313,1672666554,1672670023,3469
11017,3757060033,3777263928,1672654876,1672655125,249
11396,3926065090,3302988745,1672679223,1672680251,1028
10930,3770441717,3505331083,1672666323,1672667187,864
10425,3792627762,3409098014,1672574100,1672575167,1067
10330,3551833298,3517991042,1672630756,1672633085,2329
11334,3792824886,3836757034,1672588185,1672591139,2954
11528,3333477908,3778817220,1672604700,1672607389,2689
11442,3714516404,3466620548,1672579065,1672579169,104
9918,3793274957,3777672363,1672626294,1672627309,1015
10342,3801379377,3891586951,1672602023,1672604329,2306
9939,3662821438,3517144269,1672607213,1672608392,1179
11037,3484739955,3534499421,1672620600,1672621978,1378
10069,3500178849,3715750580,1672636094,1672637200,1106
10181,3605078841,3777564559,1672534347,1672534841,494
11396,3225371682,3505908965,1672609788,1672613374,3586
11137,3779340538,3558349840,1672652069,1672653742,1673
11522,3452024572,3639926564,1672534905,1672535068,163
10385,3466492108,3517627003,1672659332,1672661474,2142
10794,3209925780,3711430738,1672579993,1672580908,915
11219,3500198430,3500178849,1672643120,1672645656,2536
10178,3519435459,3312800145,1672531633,1672534583,2950
11302,3273771395,3452090950,1672659720,1672661155,1435
10839,3680939042,3518335611,1672635465,1672637111,1646
11562,3737622701,3380444321,1672650081,1672651708,1627
10381,3737467358,3611298237,1672594508,1672596376,1868
10648,3367262509,3284374600,1672622495,1672625030,2535
10738,3711171132,3311264420,1672607698,1672609205,1507
11760,3202740652,3760271237,1672663590,1672664892,1302
11751,3429610195,3835509670,1672679417,1672681466,2049
11196,3730571757,3424476995,1672655921,1672659206,3285
9973,3241593146,3275171954,1672681760,1672682579,819
11384,3713840946,3770981604,1672553930,1672556784,2854
10129,3516827471,3703818358,1672667843,1672671425,3582
11081,3716389356,3519712497,1672669113,1672672458,3345
11465,3730290851,3512645289,1672699584,1672702573,2989
10974,3783935976,3342027511,1672626949,1672627054,105
10860,3481365330,3772893815,1672537033,1672540288,3255
11186,3380418745,3403120725,1672682650,1672683424,774
10500,3447554599,3463892928,1672692977,1672696058,3081
10405,3893629892,3809871495,1672671592,1672671694,102
11596,3739395381,3226037966,1672592251,1672593046,795
10512,3929002318,3511476353,1672626691,1672629303,2612
10621,3828906027,3500062408,1672602721,1672603806,1085
10372,3756685732,3373802545,1672568981,1672570700,1719
10915,3660702754,3783021859,1672579023,1672579566,543
11144,3780466967,3774195369,1672582994,1672585671,2677
11313,3716475340,3711938229,1672585035,1672586310,1275
11042,3518947256,3209417223,1672541861,1672542605,744
10593,3345028045,3409098014,1672617835,1672620673,2838
9917,3636015050,3393543588,1672681976,1672682929,953
10884,3772296376,3880000841,1672585125,1672586837,1712
10913,3811419378,3533201269,1672672471,1672675606,3135
11616,3639503148,3915035136,1672587470,1672589666,2196
10545,3774682234,3919342147,1672652807,1672653994,1187
10796,3319436533,3701887470,1672545330,1672547925,2595
11717,3783201950,3777909822,1672673257,1672676609,3352
10417,3972653129,3517551721,1672601109,1672601564,455
10112,3512371853,3777641081,1672590592,1672591772,1180
11384,3510680251,3783679478,1672665881,1672668991,3110
11665,3505853594,3472173212,1672544310,1672546199,1889
10285,3793987483,3715622084,1672700567,1672703620,3053
11039,3770715115,3932919664,1672549964,1672552500,2536
11370,3446218191,3910020031,1672565958,1672569365,3407
11681,3479402555,3811351746,1672602759,1672606303,3544
10801,3714101349,3662354016,1672535021,1672536119,1098
10106,3533365834,3500863429,1672561835,1672562099,264
10012,3773411968,3304030474,1672682980,1672685905,2925
11276,3904485393,3365839890,1672547377,1672549589,2212
10045,3306066522,3505331083,1672612128,1672612264,136
10005,3710585241,3892487982,1672698659,1672701638,2979
9795,3365839890,3701265238,1672623708,1672626711,3003
10688,3632720032,3777672363,1672551036,1672553224,2188
10921,3756685732,3817029483,1672596365,1672597473,1108
10190,3374147279,3369810091,1672538535,1672541057,2522
11310,3836757034,3817076003,1672661976,1672662235,259
10230,3774316305,3335353798,1672631648,1672633422,1774
10139,3491239350,3778382224,1672676053,1672676755,702
10725,3711040761,3447267291,1672629480,1672629997,517
11739,3711430738,3491250381,1672690894,1672692483,1589
11274,3777706200,3888409038,1672627450,1672629450,2000
11789,3739618347,3774090455,1672583733,1672586510,2777
11466,3203630241,3710813103,1672540946,1672543444,2498
10549,3243305367,3732090606,1672534632,1672537237,2605
11516,3403988682,3517021928,1672538483,1672540401,1918
11454,3779212271,3792627762,1672663185,1672664203,1018
11170,3558349840,3494748808,1672685339,1672687277,1938
10002,3605591994,3703031637,1672651780,1672654394,2614
10845,3776187150,3738734246,1672628254,1672628408,154
11686,3227498870,3516319492,1672571964,1672575089,3125
10581,3534578428,3512965991,1672660612,1672664028,3416
10192,3776950532,3479452888,1672555310,1672557098,1788
10439,3514776568,3780941637,1672703774,1672706906,3132
10957,3776732532,3756493561,1672661617,1672664397,2780
10019,3701171318,3513890046,1672618281,1672621289,3008
10065,3393001196,3388937390,1672594912,1672595367,455
11139,3779413388,3810949170,1672549110,1672552332,3222
9988,3665841655,3971447562,1672539181,1672541024,1843
11322,3517113478,3756413374,1672538463,1672540732,2269
10675,3617771673,3938129916,1672579318,1672579746,428
10675,3638050763,3439651226,1672625483,1672627548,2065
9953,3430399931,3340321384,1672606828,1672609059,2231
10641,3515803462,3757639274,1672634225,1672634354,129
10320,3783935976,3500536897,1672691793,1672693446,1653
10263,3511286390,3514033319,1672540824,1672541843,1019
11405,3713031958,3888409038,1672567935,1672568969,1034
11514,3715712376,3851737350,1672597988,1672599309,1321
11177,3511750695,3534543864,1672542534,1672545241,2707
11563,3505684690,3755630085,1672546550,1672549954,3404
10977,3500057674,3429587594,1672592993,1672594524,1531
10117,3779503296,3287683210,1672700836,1672703262,2426
11681,3780050146,3491104534,1672678096,1672680356,2260
11275,3517380144,3373135211,1672652210,1672655118,2908
10840,3711938229,3926724515,1672686141,1672689468,3327
9966,3510189563,3515984911,1672582875,1672584854,1979
11377,3292936094,3511615015,1672650083,1672650884,801
9938,3461137945,3476144563,1672688385,1672689162,777
9864,3780171640,3839308659,1672645220,1672646652,1432
10700,3240622654,3396440259,1672689128,1672692151,3023
11736,3791269060,3783809405,1672584844,1672588377,3533
11499,3339331632,3354405535,1672653157,1672656296,3139
10191,3444646562,3760107540,1672570607,1672573744,3137
9875,3509370016,3757851680,1672666047,1672668538,2491
10886,3505811269,3534491112,1672623667,1672626961,3294
10331,3447312353,3713416756,1672696291,1672697126,835
11349,3554236075,3416225867,1672650289,1672651190,901
11075,3361926328,3817376705,1672639050,1672641224,2174
10980,3308149799,3291936679,1672640971,1672643754,2783
10350,3774325486,3505502819,1672535108,1672538323,3215
11622,3287968403,3776304080,1672585281,1672587677,2396
11168,3519780867,3773408491,1672597036,1672598072,1036
11493,3391093411,3511415786,1672669918,1672670660,742
10252,3307997700,3220123678,1672581053,1672582807,1754
10813,3774035405,3389069291,1672541466,1672543192,1726
11577,3772966919,3701359045,1672643366,1672645951,2585
11081,3515259326,3919994216,1672573829,1672575301,1472
11187,3427049290,3428076194,1672545569,1672547020,1451
10086,3711179193,3441683673,1672650990,1672652268,1278
11788,3367262509,3281148858,1672655173,1672658334,3161
11478,3774598935,3443004958,1672543772,1672544734,962
11782,3777074709,3555215568,1672576775,1672579748,2973
10752,3415032547,3422548081,1672621150,1672622916,1766
10576,3354968884,3791206902,1672650928,1672652876,1948
11221,3501657158,3514498259,1672597332,1672597407,75
9897,3919342147,3223512565,1672646755,1672647458,703
9897,3772689657,3756695502,1672614836,1672617066,2230
11688,3518067857,3701769970,1672629537,1672632212,2675
11740,3377446376,3732312480,1672664167,1672664240,73
10676,3518058151,3739075176,1672587284,1672589887,2603
9913,3780013266,3772845364,1672599124,1672600161,1037
10054,3757607649,3471996194,1672551683,1672554871,3188
10978,3668720465,3511003541,1672613761,1672614420,659
11477,3711179193,3515577866,1672609699,1672610931,1232
11495,3711938229,3778125688,1672615214,1672615848,634
10200,3245774173,3737738751,1672657538,1672659332,1794
11077,3663902064,3516319492,1672547635,1672547883,248
10600,3415803494,3340321384,1672695531,1672698200,2669
10394,3434452046,3311414429,1672610726,1672612327,1601
11682,3711367577,3500863429,1672701560,1672702435,875
11362,3636605690,3374348845,1672565282,1672568098,2816
10733,3441944896,3760024021,1672596007,1672597494,1487
10988,3793987483,3756297396,1672677382,1672679920,2538
11636,3510547682,3858429342,1672607422,1672609246,1824
11362,3446233783,3423346297,1672546713,1672550163,3450
10258,3856897914,3514021667,1672641053,1672642119,1066
10386,3778695017,3511382748,1672557963,1672558531,568
10108,3715284599,3288791629,1672562467,1672563758,1291
11079,3511095300,3919345990,1672584050,1672584493,443
10791,3518376262,3779282072,1672634476,1672636239,1763
10262,3501027795,3518478484,1672657667,1672659149,1482
11265,3209280342,3853275529,1672621266,1672621531,265
10767,3500087325,3739297004,1672668734,1672669443,709
11207,3912878303,3314965818,1672640189,1672641270,1081
11239,3295710494,3337675386,1672694683,1672695198,515
11351,3311529105,3899294071,1672628947,1672632290,3343
10901,3510680251,3890638402,1672552484,1672553017,533
10933,3505500665,3520779124,1672650239,1672652201,1962
10207,3357496255,3899903158,1672617556,1672619474,1918
11285,3368339963,3716095450,1672576029,1672579532,3503
11545,3756367938,3895944547,1672612302,1672612655,353
11124,3510535683,3240683148,1672535004,1672535753,749
11748,3730115019,3319585148,1672604347,1672605549,1202
10854,3515939841,3513764665,1672612163,1672613813,1650
11448,3915962248,3227647190,1672656577,1672658722,2145
9803,3245755569,3319585148,1672582472,1672585006,2534
11029,3792440162,3773899531,1672665994,1672667759,1765
10152,3307521389,3473706746,1672532080,1672533220,1140
9851,3511311554,3713878219,1672700582,1672703811,3229
10315,3471131277,3711219767,1672575794,1672578709,2915
11675,3703474558,3466149998,1672577173,1672577465,292
11053,3777112124,3342031426,1672671860,1672673744,1884
10089,3405221863,3513563152,1672617878,1672620221,2343
10774,3209075485,3856316719,1672697270,1672698012,742
11103,3501828287,3757855416,1672626468,1672626961,493
11684,3487278983,3359351267,1672638141,1672641093,2952
11420,3510836047,3468066881,1672546195,1672546890,695
10160,3235470567,3716423829,1672604106,1672604244,138
10600,3773376762,3500429731,1672601278,1672601705,427
10347,3931767736,3370961012,1672668140,1672670905,2765
11659,3307236682,3739820448,1672601703,1672604700,2997
11118,3314965818,3770018912,1672672479,1672674696,2217
10439,3604569804,3791121243,1672630551,1672633220,2669
10007,3471177177,3272827860,1672568629,1672569098,469
10675,3773736248,3893932944,1672620973,1672623192,2219
10720,3316406470,3298831109,1672629452,1672632924,3472
11206,3500595432,3242149533,1672679885,1672681868,1983
10456,3447312353,3501901313,1672667594,1672668013,419
10770,3772968080,3757513651,1672576067,1672578951,2884
11624,3468343480,3619494735,1672618904,1672620397,1493
10784,3774304163,3422548081,1672679872,1672682546,2674
11719,3714312797,3922301238,1672534423,1672535100,677
11656,3390438262,3856552205,1672689329,1672689955,626
10111,3223144610,3780238637,1672584709,1672586921,2212
11699,3505173665,3505936495,1672612827,1672613808,981
10742,3480560014,3779723939,1672552017,1672552858,841
10524,3774822697,3714731729,1672635862,1672636273,411
10574,3505066871,3450503086,1672610352,1672611263,911
9907,3716020849,3884001167,1672552917,1672554215,1298
10401,3833993674,3637566026,1672613153,1672615159,2006
11554,3792021895,3440401725,1672532612,1672533731,1119
11213,3783695231,3710228292,1672691730,1672693999,2269
11095,3711870537,3703779674,1672599048,1672600482,1434
11670,3466492108,3358530225,1672603354,1672606749,3395
10914,3517440258,3428878402,1672575047,1672576475,1428
10164,3893527651,3387971464,1672678607,1672681333,2726
10507,3773024346,3514698862,1672610802,1672612477,1675
11010,3500342408,3209925780,1672643160,1672645852,2692
9807,3233712975,3660702754,1672612944,1672615361,2417
11486,3341985886,3711367577,1672654319,1672657006,2687
10034,3520155898,3687445224,1672690292,1672692572,2280
11059,3605591994,3312946269,1672684831,1672686598,1767
10684,3810949170,3757994002,1672695440,1672696292,852
10358,3513111053,3389069291,1672577904,1672580862,2958
10017,3489205994,3518058151,1672670809,1672674398,3589
10463,3927181190,3716197140,1672577231,1672579529,2298
11553,3701493094,3778731000,1672561267,1672563971,2704
10441,3632094087,3826542169,1672588730,1672590964,2234
11243,3482687604,3423940256,1672586649,1672590021,3372
11129,3510801769,3310021925,1672621027,1672622371,1344
9871,3515230715,3773424266,1672678141,1672680568,2427
10518,3855977674,3774238066,1672645047,1672645694,647
11534,3935569749,3497562878,1672534493,1672535400,907
11471,3701350519,3710487368,1672695586,1672698940,3354
11175,3534278019,3415228763,1672684799,1672687298,2499
11536,3374552204,3514455363,1672564988,1672567568,2580
10266,3438028077,3474074188,1672590244,1672590790,546
10349,3732533330,3776727271,1672551875,1672552796,921
10818,3436401020,3667072319,1672559996,1672562004,2008
9905,3501548163,3451757423,1672624112,1672627032,2920
10045,3732596503,3898595916,1672577260,1672578192,932
10608,3903994989,3772877723,1672696035,1672696934,899
10951,3509431396,3419648004,1672644441,1672646667,2226
10721,3884369346,3713906305,1672624407,1672624470,63
10465,3534491112,3515726910,1672566439,1672569015,2576
10679,3500444748,3505491969,1672543350,1672543930,580
11541,3516965624,3772708314,1672643527,1672644460,933
11482,3791382196,3429610195,1672604994,1672605861,867
10291,3511969443,3465107990,1672693022,1672695690,2668
10582,3501628472,3243651036,1672676127,1672679102,2975
10030,3605078841,3714883746,1672533691,1672534304,613
11699,3358211034,3466492108,1672659396,1672660243,847
11644,3636015050,3472561941,1672612793,1672613002,209
10537,3714806574,3445733121,1672567930,1672570065,2135
10062,3938398160,3770631449,1672545110,1672545389,279
10206,3776581518,3518995270,1672646441,1672647903,1462
11668,3244098077,3713102459,1672639766,1672641366,1600
10079,3497732613,3851737350,1672532094,1672534851,2757
10226,3792497486,3714688409,1672653927,1672656995,3068
11421,3714897456,3243056734,1672698076,1672698515,439
10787,3817376705,3440770466,1672570090,1672570464,374
10250,3534604516,3756991235,1672575382,1672577361,1979
11322,3713285095,3209958726,1672644347,1672646256,1909
10487,3510373076,3500356342,1672620945,1672622513,1568
11696,3792824886,3779454060,1672556070,1672556904,834
10191,3500456339,3516731917,1672608858,1672610829,1971
10226,3385124073,3760997159,1672593844,1672596647,2803
11763,3495427619,3206377955,1672603153,1672606659,3506
10644,3247545468,3890638402,1672606313,1672606926,613
10037,3310961923,3664478769,1672678080,1672680338,2258
10862,3238310644,3714870496,1672702130,1672702430,300
11318,3774195369,3501573548,1672600054,1672600735,681
10138,3736010012,3514327931,1672620603,1672622292,1689
10962,3438028077,3776455762,1672698109,1672701523,3414
10853,3701387745,3505709407,1672702144,1672702340,196
11717,3923524564,3429587594,1672696378,1672699390,3012
9906,3235198316,3904846341,1672692872,1672693205,333
10019,3971051020,3500720752,1672536789,1672539192,2403
11224,3500922040,3703659324,1672629651,1672633025,3374
11731,3882851213,3505291330,1672565923,1672565987,64
10742,3662495290,3359351267,1672677560,1672678469,909
10032,3701296091,3900793652,1672616481,1672618914,2433
10121,3534459983,3342837214,1672644080,1672646163,2083
11512,3500221079,3979366845,1672585880,1672586653,773
10927,3358434853,3772320856,1672687702,1672688235,533
11293,3615742989,3776953418,1672591245,1672592857,1612
10024,3884180202,3732104286,1672542245,1672543891,1646
10762,3501976169,3713191326,1672671056,1672671167,111
11423,3301449986,3638823001,1672622924,1672624121,1197
10038,3305612422,3760679372,1672671197,1672671657,460
10474,3516588277,3680278447,1672573002,1672575451,2449
10307,3398021818,3551972633,1672657699,1672657998,299
10968,3770972037,3760397450,1672693910,1672695452,1542
11260,3518478484,3248409083,1672628263,1672629996,1733
11634,3972729768,3312612693,1672568120,1672568696,576
11234,3430399931,3376842515,1672552911,1672554709,1798
10669,3714688409,3492064037,1672546023,1672547438,1415
11672,3793442891,3615245840,1672589181,1672589588,407
10200,3756781024,3280208630,1672564182,1672566175,1993
11726,3857909328,3493047640,1672546242,1672546941,699
11147,3812516461,3505901826,1672634957,1672635685,728
10787,3245774173,3511663572,1672685977,1672687015,1038
10195,3505502819,3638050763,1672552210,1672554993,2783
11170,3714377201,3500927619,1672611656,1672614010,2354
9799,3755922811,3730414796,1672648106,1672648620,514
9930,3509663119,3533986052,1672616165,1672616278,113
10253,3731644240,3500536897,1672590776,1672593823,3047
10043,3240443426,3505684690,1672599113,1672602655,3542
10841,3516819320,3783172505,1672625683,1672626741,1058
10412,3510968599,3295710494,1672566081,1672568119,2038
11258,3880637958,3226913558,1672691765,1672694248,2483
11591,3686860179,3461877104,1672596221,1672599755,3534
11195,3714074120,3780511388,1672624716,1672624967,251
10697,3918981936,3500455935,1672558002,1672558523,521
11625,3463892928,3519435459,1672605044,1672607679,2635
9795,3501253130,3885545415,1672559018,1672561693,2675
10257,3450503086,3514455363,1672604376,1672606568,2192
11418,3487278983,3501253130,1672545718,1672549283,3565
11208,3423800775,3275751794,1672610783,1672613900,3117
10150,3298706213,3229734741,1672570400,1672570551,151
11004,3791206902,3517440258,1672602118,1672605583,3465
11575,3922480066,3780287649,1672557614,1672558763,1149
11054,3714903456,3779930476,1672675616,1672677197,1581
11059,3283847934,3715441786,1672703623,1672704725,1102
10683,3780298499,3360949039,1672560194,1672562615,2421
10453,3756784813,3334381941,1672533513,1672536579,3066
9825,3398075553,3680832669,1672665358,1672668634,3276
11783,3888903181,3517083465,1672629693,1672632724,3031
10701,3617771673,3509208005,1672541220,1672542175,955
11068,3757728121,3510189563,1672598293,1672599374,1081
10791,3371564186,3812677669,1672620384,1672622125,1741
11008,3711722554,3822634862,1672616455,1672617651,1196
11495,3512101369,3332010532,1672540622,1672541371,749
11736,3394364348,3922480066,1672539690,1672543141,3451
10370,3429610195,3505994703,1672536216,1672536779,563
10718,3245245283,3602401154,1672651343,1672653901,2558
9965,3278629965,3770846374,1672687882,1672688781,899
10925,3511199555,3972196462,1672561995,1672564924,2929
10415,3931164237,3427049290,1672662636,1672665469,2833
11170,3710585241,3977209952,1672618170,1672621198,3028
10795,3474097405,3776122272,1672662793,1672663518,725
11175,3311159418,3713954144,1672662833,1672666032,3199
10888,3341311972,3772966919,1672598906,1672602301,3395
10031,3779478448,3830291558,1672533589,1672535237,1648
10488,3229734741,3922786716,1672681946,1672684654,2708
11491,3246804115,3400903513,1672679788,1672680646,858
11652,3880788853,3916673751,1672605084,1672605539,455
10904,3357097510,3516904926,1672661506,1672664587,3081
11035,3228575883,3773770134,1672557068,1672560205,3137
10468,3976742903,3779930476,1672620592,1672621011,419
10551,3511412229,3390368796,1672698882,1672700846,1964
10431,3469350379,3440770466,1672560457,1672561005,548
11161,3501548163,3776901443,1672699488,1672703009,3521
10414,3519356606,3510801769,1672677947,1672680996,3049
10496,3517151644,3384151770,1672627729,1672628329,600
10157,3287734830,3201957157,1672603197,1672605017,1820
11091,3517499844,3395082458,1672531884,1672535259,3375
11310,3500854711,3533009565,1672638895,1672641976,3081
10428,3880882684,3377250778,1672676184,1672676579,395
11167,3686211958,3971280379,1672659417,1672661116,1699
10276,3757869138,3559123082,1672685460,1672687190,1730
10580,3494560663,3514297012,1672571849,1672571936,87
11649,3791587717,3713102459,1672610187,1672613117,2930
10071,3791289855,3756066765,1672656980,1672657635,655
11432,3602570831,3633622298,1672590677,1672591285,608
11371,3715712376,3517499844,1672617704,1672618367,663
10320,3368441333,3897186782,1672601627,1672604653,3026
10629,3512638952,3478052226,1672671135,1672673313,2178
10747,3737050849,3347996015,1672604203,1672605184,981
10455,3711945923,3791351852,1672608413,1672609645,1232
10163,3466655775,3510373076,1672697855,1672698366,511
11663,3517331746,3760481622,1672633450,1672633528,78
11071,3514005973,3505121295,1672648815,1672649251,436
9960,3533876927,3450164574,1672640063,1672641022,959
11629,3499998389,3756272704,1672661491,1672663651,2160
11510,3686885442,3406492167,1672681394,1672683899,2505
10634,3931495845,3713996094,1672568627,1672570401,1774
11710,3711844574,3510022922,1672697260,1672699731,2471
10289,3600699873,3936851114,1672621902,1672622586,684
10112,3550206045,3858330969,1672703581,1672704137,556
10277,3907245259,3774109138,1672657467,1672657843,376
10848,3639081201,3662821438,1672637065,1672638491,1426
10866,3793874490,3276230295,1672583382,1672585875,2493
11083,3663902064,3273242177,1672575062,1672575878,816
11344,3639926564,3501271930,1672645451,1672645767,316
10571,3512819376,3783879023,1672597147,1672599346,2199
11438,3518376262,3824657614,1672594496,1672596394,1898
10756,3660176760,3304252969,1672545765,1672548049,2284
10042,3301369282,3710852576,1672652365,1672655012,2647
11449,3283295213,3884862164,1672573643,1672576477,2834
10107,3831981073,3513850048,1672557485,1672558354,869
11062,3715490209,3773636983,1672691177,1672693268,2091
10095,3667950469,3886837151,1672554938,1672557254,2316
10726,3403120725,3533225084,1672566013,1672568059,2046
11792,3513894659,3791194984,1672673134,1672674837,1703
10683,3520515739,3701448521,1672587242,1672589297,2055
9956,3783172505,3715897627,1672697661,1672698278,617
10336,3928508375,3773202954,1672580697,1672580806,109
11682,3398862999,3509186338,1672702879,1672705143,2264
10672,3381244346,3533201269,1672581173,1672583337,2164
10808,3461743188,3779930476,1672663397,1672663842,445
10965,3716669659,3733423371,1672583559,1672586873,3314
10719,3465227623,3330318282,1672668049,1672671282,3233
10208,3225554956,3929446196,1672701884,1672703222,1338
10830,3435037864,3228465044,1672571812,1672572293,481
11784,3917467642,3509556649,1672552042,1672553361,1319
11743,3222364320,3779130507,1672615354,1672615495,141
11643,3812559393,3341985886,1672554079,1672555161,1082
10447,3714658474,3809216145,1672691377,1672694713,3336
11382,3731905251,3509677530,1672659886,1672662175,2289
9945,3500440602,3770972037,1672609564,1672611416,1852
11428,3533419409,3226172318,1672556727,1672557161,434
10956,3606804618,3490008012,1672602994,1672606120,3126
11286,3520725149,3505129296,1672642450,1672645620,3170
9831,3884458862,3757199889,1672625759,1672627944,2185
10707,3516731917,3838423363,1672637795,1672638361,566
9941,3534174363,3804707712,1672548487,1672548642,155
10975,3482786946,3603452936,1672654686,1672655164,478
9918,3701387745,3305093237,1672571568,1672571883,315
11206,3510795808,3770631449,1672638408,1672640126,1718
11314,3384001094,3732846295,1672531895,1672533398,1503
10999,3711770853,3301431129,1672692840,1672692923,83
11369,3806034626,3780048608,1672660699,1672660837,138
9876,3369810091,3602570831,1672672327,1672675753,3426
9896,3364660506,3500011591,1672670237,1672673550,3313
11254,3361635547,3338115824,1672648939,1672652225,3286
10641,3311529105,3896211741,1672590584,1672593307,2723
11208,3760382349,3737050849,1672660991,1672661429,438
9899,3418791124,3517949586,1672571837,1672572225,388
9865,3450511428,3557528150,1672611319,1672613471,2152
10939,3303552616,3557653200,1672623356,1672624575,1219
10121,3885645840,3332840671,1672613433,1672614685,1252
11791,3487278983,3755175497,1672561928,1672564154,2226
10316,3357097510,3500854711,1672675983,1672677370,1387
11586,3499142934,3404187438,1672565606,1672569078,3472
11770,3513143959,3770966950,1672547492,1672548033,541
11320,3534426696,3534531061,1672556630,1672558616,1986
11540,3611298237,3534812391,1672640421,1672641986,1565
10741,3513140146,3880882684,1672586364,1672588947,2583
10484,3971422524,3534604516,1672593958,1672597385,3427
9800,3276393542,3938398160,1672694373,1672697647,3274
11358,3467756698,3311305760,1672577476,1672580875,3399
11142,3714281210,3909220912,1672567228,1672568342,1114
11369,3903879740,3551972633,1672533338,1672534193,855
10166,3835982340,3774663639,1672553150,1672556383,3233
11392,3714116241,3515405509,1672684605,1672687461,2856
11052,3505291330,3927699036,1672577850,1672580031,2181
11524,3474852115,3515974881,1672545416,1672546220,804
10131,3755670258,3500221079,1672682446,1672683950,1504
9976,3510484107,3830771832,1672562138,1672563555,1417
10133,3909822999,3854229296,1672641862,1672642950,1088
10994,3934564437,3912878303,1672534250,1672537382,3132
11473,3283106998,3713621169,1672606510,1672608234,1724
10870,3534284132,3711131262,1672534889,1672536926,2037
9871,3516517348,3711223297,1672609313,1672609517,204
10243,3398489033,3703624327,1672546629,1672548749,2120
11742,3755374000,3519521903,1672567066,1672568295,1229
10354,3344778261,3713875941,1672645383,1672648025,2642
11421,3249614888,3534068874,1672644154,1672646735,2581
9908,3713906305,3817120976,1672653316,1672655336,2020
10453,3703779674,3380185102,1672653338,1672654026,688
10110,3512555384,3311463998,1672668743,1672668885,142
10745,3756647451,3533642281,1672652158,1672652256,98
10295,3505097206,3711287751,1672546257,1672548823,2566
11478,3855440101,3618024815,1672667319,1672670716,3397
11565,3433189219,3516444589,1672560806,1672563004,2198
11449,3919719755,3714142299,1672653246,1672655427,2181
11346,3620836520,3505173665,1672554000,1672555770,1770
10315,3510486220,3793920312,1672700941,1672704091,3150
10780,3713636175,3372079985,1672629572,1672630426,854
10059,3680075399,3246296769,1672593523,1672594800,1277
11201,3505032773,3664719070,1672642409,1672643623,1214
10964,3302879906,3735197034,1672607233,1672607940,707
9969,3716740576,3510824484,1672656918,1672658171,1253
11179,3516792348,3971051020,1672622871,1672624545,1674
9936,3364286028,3447591143,1672577427,1672580237,2810
10369,3783368855,3755203055,1672698594,1672700851,2257
10859,3909220912,3287094447,1672562225,1672565600,3375
10360,3501554468,3777751979,1672627295,1672628224,929
11221,3715249954,3533703578,1672563504,1672565554,2050
11671,3770391782,3716982179,1672538382,1672540168,1786
10954,3420983899,3480418192,1672583243,1672585210,1967
9912,3345028045,3236512807,1672573301,1672574781,1480
10985,3774090455,3701668745,1672597052,1672600485,3433
10537,3275661834,3242082716,1672701323,1672703131,1808
11520,3247545468,3662055682,1672546878,1672547920,1042
11005,3392482187,3710051427,1672578546,1672581181,2635
9805,3500405175,3755229631,1672631212,1672631455,243
10244,3977880564,3791435852,1672569683,1672570394,711
10561,3701311947,3772569860,1672652268,1672653117,849
10494,3398021818,3519965717,1672571180,1672574002,2822
11539,3452677710,3778561231,1672551435,1672553167,1732
11572,3311463998,3496579251,1672632587,1672635283,2696
10567,3770408300,3817029483,1672551766,1672554779,3013
10428,3738873928,3350169064,1672635414,1672638273,2859
11368,3760346746,3311626308,1672532182,1672535453,3271
11240,3777729184,3818236682,1672670057,1672671421,1364
10259,3403120725,3776440009,1672676778,1672679824,3046
11590,3472561941,3660980656,1672558381,1672558626,245
10476,3774706478,3757501067,1672652860,1672653126,266
10021,3471996194,3241593146,1672633481,1672636952,3471
10437,3731905251,3662055682,1672532507,1672532756,249
10244,3776125503,3715282492,1672634527,1672636696,2169
11768,3403150349,3813986705,1672555959,1672557305,1346
10729,3316551382,3513486828,1672601879,1672602235,356
10822,3500438542,3446764595,1672623502,1672624405,903
11370,3777290300,3408982612,1672536472,1672537053,581
11450,3245501577,3512072679,1672561796,1672562544,748
11458,3439662051,3519322066,1672561907,1672562385,478
10600,3780423516,3479910993,1672593852,1672595244,1392
9811,3513186578,3478937459,1672663287,1672664012,725
10545,3900540310,3514361485,1672631635,1672632123,488
9992,3710223875,3837378340,1672686148,1672687157,1009
10113,3241593146,3778182724,1672700977,1672702753,1776
9799,3713336088,3230250213,1672615692,1672617806,2114
10923,3333477908,3669140241,1672602651,1672603292,641
10469,3851515560,3373135211,1672701164,1672701837,673
10856,3513890046,3510758718,1672702342,1672704054,1712
11454,3902300755,3773408491,1672703003,1672703994,991
11003,3500429731,3934280144,1672610840,1672612661,1821
11405,3713996094,3715897627,1672581999,1672582178,179
11041,3378747834,3485151614,1672703987,1672705420,1433
10511,3516167000,3511289729,1672695636,1672696512,876
10630,3932919664,3517991042,1672575201,1672575353,152
11296,3353326305,3337675386,1672661663,1672665246,3583
11379,3511908639,3605101443,1672553325,1672554660,1335
11114,3510262025,3554437212,1672557145,1672558560,1415
10410,3770846374,3408982612,1672570141,1672570652,511
10168,3669918958,3519908593,1672610512,1672611249,737
11038,3830962592,3701956841,1672675451,1672675822,371
10858,3284483177,3730414796,1672693023,1672695853,2830
10742,3358959807,3436774112,1672576242,1672578157,1915
11633,3711430738,3514926921,1672551427,1672552573,1146
11163,3555763674,3931767736,1672597226,1672598231,1005
10573,3905358065,3933106901,1672603668,1672605689,2021
11773,3792597493,3421524698,1672558102,1672559833,1731
10458,3357496255,3701065296,1672564374,1672567135,2761
10582,3360525513,3517810375,1672624092,1672626165,2073
9965,3475845921,3904184638,1672654808,1672657905,3097
10869,3361865467,3619538249,1672537955,1672540126,2171
10084,3335055096,3505500523,1672673732,1672675737,2005
11356,3710807030,3610517436,1672650383,1672651135,752
10621,3937636109,3710622746,1672562421,1672563791,1370
11253,3779160052,3519947298,1672644263,1672647219,2956
9950,3613936929,3857609616,1672683352,1672684782,1430
10229,3519352855,3466149998,1672567789,1672567997,208
10179,3737946004,3662055682,1672675027,1672676018,991
10197,3770595035,3293673220,1672590063,1672592025,1962
10078,3932566114,3335353798,1672667337,1672667406,69
10387,3355880028,3716445184,1672702640,1672703295,655
11185,3516535558,3311479294,1672569652,1672572512,2860
10306,3482639402,3243305367,1672572100,1672573099,999
11211,3403395712,3714179543,1672685018,1672688180,3162
11518,3405435885,3774822697,1672610470,1672610894,424
11019,3500595432,3812756400,1672686041,1672689580,3539
11398,3970775805,3428325402,1672572307,1672573379,1072
10955,3534362749,3600699873,1672595486,1672596777,1291
11660,3783651407,3534278019,1672576267,1672578503,2236
11784,3505816624,3404187438,1672651485,1672651800,315
11634,3777370601,3519841427,1672685485,1672687199,1714
10808,3711591464,3711718368,1672686592,1672687398,806
11780,3432050858,3273771395,1672640448,1672640763,315
11341,3772869013,3770530739,1672622757,1672623179,422
11255,3770715115,3445558740,1672546956,1672547324,368
10429,3342837214,3710296607,1672661342,1672664028,2686
10817,3370401047,3772556646,1672660409,1672661048,639
11409,3517253559,3394976623,1672531505,1672533557,2052
10094,3714283424,3514005973,1672612205,1672613883,1678
11449,3730348493,3783942518,1672649897,1672652555,2658
10658,3757064623,3495637721,1672553916,1672555879,1963
10145,3793948300,3886957097,1672612033,1672614742,2709
9838,3668720465,3701675183,1672616181,1672619678,3497
10486,3488333295,3517551721,1672563020,1672564260,1240
10654,3755129708,3373135211,1672592933,1672594043,1110
11065,3783879023,3755357292,1672621346,1672624236,2890
11063,3776187150,3446233783,1672680552,1672682644,2092
11633,3206377955,3716541851,1672678507,1672680839,2332
10385,3285136057,3858330969,1672573826,1672576701,2875
11334,3703476890,3716209499,1672685526,1672688450,2924
10462,3240443426,3701284535,1672620663,1672620959,296
11057,3505482210,3330318282,1672607723,1672610552,2829
11141,3510189563,3772962072,1672681348,1672683214,1866
10683,3791072829,3792708936,1672541521,1672543160,1639
11570,3714870496,3773736248,1672556696,1672559828,3132
10827,3516167000,3330318282,1672577130,1672577440,310
11244,3389367628,3519951586,1672626172,1672627170,998
10499,3610517436,3301449986,1672595615,1672597234,1619
10855,3500536897,3893629892,1672614480,1672614729,249
10996,3245755569,3680075399,1672610718,1672612862,2144
10688,3923524564,3760966645,1672701482,1672703763,2281
10136,3206217657,3770023722,1672598915,1672600270,1355
11704,3510143850,3760107540,1672596599,1672598631,2032
9842,3780500331,3239279744,1672649203,1672652015,2812
9878,3714897456,3520763492,1672637102,1672639038,1936
11345,3774939922,3297624618,1672618471,1672620962,2491
10362,3772556646,3792597493,1672695089,1672697360,2271
10980,3514560138,3513563152,1672686949,1672688843,1894
10381,3280208630,3208594306,1672687185,1672688786,1601
11582,3894495222,3512251592,1672669670,1672670486,816
11324,3836586875,3556684272,1672637441,1672638175,734
11382,3793934396,3850005949,1672698680,1672700499,1819
11070,3332840671,3519730914,1672651286,1672651487,201
10551,3516429380,3202787155,1672643978,1672647461,3483
10772,3713031958,3501988762,1672665616,1672667319,1703
10558,3311463998,3701041860,1672627158,1672627569,411
11555,3932566114,3836586875,1672557169,1672557356,187
11618,3372596013,3235470567,1672613666,1672614513,847
9897,3517943697,3711591464,1672646171,1672648001,1830
11042,3513739060,3514107131,1672676554,1672677946,1392
11478,3423353911,3351153781,1672621744,1672625165,3421
11020,3662307789,3778544203,1672542331,1672543315,984
10015,3928508375,3773688906,1672701929,1672704106,2177
10898,3475090917,3774483862,1672542669,1672544797,2128
10394,3778819352,3385416697,1672542110,1672543844,1734
11149,3732871856,3885339157,1672550163,1672550739,576
10068,3440582836,3500019810,1672628531,1672629921,1390
11355,3514801709,3514329209,1672655760,1672657591,1831
11707,3755924094,3852310652,1672695698,1672697959,2261
10805,3517949586,3513203127,1672627227,1672628240,1013
10834,3714424237,3533841983,1672661116,1672664392,3276
10001,3783947742,3505867821,1672564681,1672566488,1807
11555,3808849597,3533628528,1672663652,1672666877,3225
10697,3370751461,3346755179,1672637603,1672638908,1305
10247,3710819760,3513890046,1672536227,1672537118,891
10966,3904045870,3375257546,1672536819,1672538218,1399
9866,3203457161,3701449715,1672622343,1672624301,1958
10254,3246062632,3760267158,1672541144,1672544111,2967
10728,3685877449,3711770773,1672634416,1672636016,1600
10571,3303747093,3783408469,1672673861,1672674006,145
10020,3533620069,3710865678,1672642083,1672643943,1860
9964,3501407804,3774792696,1672684678,1672685760,1082
10863,3500922040,3779169946,1672626137,1672628408,2271
11180,3938059867,3292050211,1672568218,1672571136,2918
10968,3809871495,3533265491,1672543267,1672546411,3144
11418,3716733618,3779561601,1672703973,1672705862,1889
10985,3703351452,3271719569,1672575306,1672577878,2572
11404,3714595459,3667814788,1672597497,1672597960,463
10860,3513800589,3625779003,1672698433,1672700499,2066
9817,3836136159,3703818358,1672582978,1672584847,1869
10504,3885645840,3471177177,1672555778,1672556680,902
10162,3520625600,3793814153,1672608820,1672611161,2341
11704,3511867383,3342368576,1672656429,1672657557,1128
11266,3487395357,3291936679,1672603372,1672605424,2052
11637,3444295435,3519341916,1672577582,1672578220,638
9847,3330318282,3406238754,1672672891,1672675413,2522
10893,3780511388,3701493094,1672571627,1672571951,324
11318,3281935691,3713969196,1672592239,1672593453,1214
9986,3824135033,3783594729,1672593162,1672593501,339
11101,3732128078,3513213122,1672685220,1672688232,3012
11158,3515378306,3390537737,1672668084,1672668836,752
10473,3205687719,3711187791,1672674290,1672677267,2977
10774,3275057862,3665478011,1672680762,1672682260,1498
11464,3770544738,3905889514,1672625050,1672627943,2893
11760,3246567963,3516815069,1672694165,1672695434,1269
11500,3520763492,3469370398,1672603314,1672605187,1873
9884,3312733562,3915679140,1672659860,1672661196,1336
10366,3732846295,3519841427,1672535353,1672537222,1869
11366,3715419141,3776291254,1672559584,1672561898,2314
11672,3500062408,3293157673,1672640635,1672643300,2665
10316,3500889287,3481700413,1672684978,1672688506,3528
10778,3755203055,3520362238,1672604031,1672607150,3119
11061,3345028045,3292663993,1672604026,1672605632,1606
9905,3510159441,3500741005,1672533539,1672533952,413
11257,3780942505,3735056027,1672546804,1672549877,3073
10425,3908177413,3365839890,1672627241,1672628515,1274
11432,3209417223,3514455363,1672583956,1672584792,836
9982,3365519448,3514628916,1672593214,1672594572,1358
11624,3514021667,3239279744,1672620293,1672620844,551
11510,3516585063,3505234868,1672640334,1672642026,1692
10110,3925208102,3500741534,1672625227,1672625622,395
11030,3516444589,3519351747,1672544148,1672546173,2025
9956,3791584994,3505331083,1672622345,1672624824,2479
9823,3739844610,3514145752,1672666646,1672669960,3314
10234,3512087090,3441683673,1672532717,1672535190,2473
10411,3246381831,3802101760,1672595448,1672598122,2674
11644,3310702648,3519521903,1672595432,1672596836,1404
11451,3703277359,3916673751,1672656102,1672657382,1280
10651,3421956717,3362706073,1672655001,1672657381,2380
11176,3777641081,3929446196,1672616151,1672617406,1255
11066,3534562354,3395615598,1672608847,1672609000,153
10879,3770574826,3475033290,1672552646,1672554759,2113
10002,3501628472,3701374160,1672582409,1672584649,2240
9845,3376842515,3713336088,1672648285,1672649520,1235
11333,3246062632,3703588004,1672547819,1672550024,2205
10254,3792063616,3732440502,1672639877,1672642555,2678
11432,3491104534,3714806574,1672669970,1672670548,578
11529,3305657559,3511729562,1672538092,1672538724,632
10875,3509370633,3713434898,1672662521,1672662698,177
10318,3393376416,3485151614,1672571623,1672572764,1141
10231,3820280594,3669475165,1672588673,1672590334,1661
10414,3520344592,3228218081,1672683807,1672685283,1476
11450,3362127525,3779835734,1672700073,1672703408,3335
10278,3500741005,3515096959,1672701902,1672704623,2721
11252,3832002939,3500814753,1672576109,1672576410,301
11719,3770273459,3618895679,1672570758,1672572835,2077
11604,3701655378,3714101349,1672645733,1672648345,2612
10415,3772802020,3716841469,1672675402,1672676068,666
11429,3777135415,3839417558,1672584270,1672585144,874
10714,3514980025,3716994924,1672591707,1672593455,1748
10289,3283847934,3812261241,1672608255,1672611033,2778
10885,3302416197,3661543201,1672546765,1672548354,1589
11103,3772751765,3893629892,1672614223,1672614906,683
11321,3533009565,3509626590,1672588534,1672589534,1000
11436,3505521491,3533593766,1672634886,1672638208,3322
10630,3921138062,3533365834,1672575815,1672576034,219
11672,3519951586,3777200549,1672689983,1672690757,774
11531,3231654754,3778382224,1672603189,1672604352,1163
10226,3416225867,3273771395,1672578265,1672580454,2189
9907,3777135415,3791547827,1672600203,1672602420,2217
10282,3467663782,3701265238,1672554719,1672556145,1426
11310,3716178116,3730600658,1672544794,1672544956,162
11225,3206217657,3919345990,1672689138,1672690794,1656
10574,3333355914,3474350534,1672641790,1672643779,1989
11501,3370448531,3933106901,1672658310,1672661380,3070
11160,3509297453,3733953055,1672681904,1672685449,3545
10571,3467944159,3311515179,1672596568,1672598267,1699
10395,3372778334,3533473206,1672605650,1672607467,1817
9812,3774238066,3379400553,1672603285,1672603892,607
11626,3773432494,3777200549,1672554684,1672557031,2347
10244,3246381831,3364718040,1672641948,1672643643,1695
11602,3407403080,3208519320,1672543912,1672545309,1397
10112,3351837521,3479585868,1672578405,1672578473,68
11096,3905955166,3886896755,1672608366,1672609960,1594
11415,3780173788,3377311502,1672670549,1672671075,526
11717,3519356606,3688410383,1672656004,1672658698,2694
11374,3307997700,3406101720,1672609863,1672612569,2706
10716,3408982612,3805704844,1672645636,1672647118,1482
10814,3511341866,3299847117,1672619634,1672622220,2586
10112,3511003541,3776593726,1672665467,1672668004,2537
11490,3733870816,3534174363,1672573205,1672575254,2049
10144,3533642281,3793497672,1672545665,1672546869,1204
10152,3246971044,3730290851,1672688463,1672688984,521
11002,3715566511,3473520701,1672546984,1672550434,3450
10638,3445355677,3820922991,1672611860,1672612914,1054
11650,3602054754,3337673625,1672689119,1672691868,2749
10599,3457249798,3813986705,1672677734,1672678228,494
10460,3602570831,3245774173,1672677500,1672679030,1530
10915,3773534165,3501992314,1672549475,1672550331,856
11614,3505867821,3391854325,1672673515,1672673802,287
10073,3513293711,3519059808,1672570694,1672572288,1594
10133,3760390822,3713927376,1672575258,1672576908,1650
10303,3277061226,3305656670,1672609224,1672612340,3116
10958,3714424237,3713434898,1672647703,1672650423,2720
10071,3701540249,3437703650,1672666420,1672667054,634
9860,3832902787,3519055736,1672554944,1672557949,3005
10565,3373018943,3500734346,1672664966,1672665076,110
10965,3683514731,3737467358,1672576141,1672576255,114
10830,3520339198,3359012188,1672542829,1672546087,3258
9911,3501550490,3465227623,1672534147,1672536958,2811
10851,3515939841,3371497614,1672562697,1672563147,450
11399,3637522163,3884388188,1672565185,1672566720,1535
9917,3551972633,3793719515,1672554441,1672556348,1907
10909,3701311947,3662522808,1672567530,1672568692,1162
11346,3511028193,3480560014,1672659920,1672661165,1245
9835,3394976623,3467756698,1672543498,1672544432,934
10768,3519908593,3534491112,1672545358,1672546700,1342
11426,3638126174,3826315540,1672580172,1672580640,468
9941,3511500932,3480405740,1672631648,1672633279,1631
11243,3208894215,3500693568,1672703959,1672706623,2664
10265,3701004302,3777405860,1672600584,1672602370,1786
11094,3461877104,3818236682,1672572188,1672575588,3400
11187,3756850160,3361952532,1672535161,1672535769,608
10570,3613547091,3387388336,1672567568,1672568059,491
11705,3533030343,3534758256,1672538177,1672540044,1867
11672,3220976338,3487231844,1672606946,1672610136,3190
11283,3774598935,3515304526,1672614356,1672616735,2379
11177,3533209168,3516706121,1672590008,1672593389,3381
10693,3757713457,3713100169,1672655235,1672656451,1216
11618,3778100960,3228477490,1672535513,1672536075,562
10012,3903115138,3424997707,1672545745,1672548431,2686
9894,3703818358,3890278838,1672654905,1672657309,2404
10423,3353811455,3774090455,1672701955,1672704625,2670
11422,3358675021,3783594246,1672616493,1672617325,832
11368,3819024145,3399173821,1672559338,1672561438,2100
10388,3760385591,3517949586,1672580163,1672580703,540
10209,3279102372,3827889533,1672697669,1672701164,3495
11521,3515230715,3361711720,1672678922,1672680373,1451
11071,3510819040,3364067937,1672557386,1672560159,2773
10137,3334461288,3513186578,1672695858,1672698660,2802
10083,3791222330,3495637721,1672613248,1672616357,3109
11525,3855209450,3449020351,1672690186,1672692841,2655
11538,3505066871,3454151554,1672639905,1672641493,1588
11097,3353194923,3776901443,1672572623,1672574917,2294
11605,3839417558,3376487118,1672574655,1672575393,738
11437,3514352989,3533728729,1672691787,1672693709,1922
11027,3756168814,3633294415,1672700367,1672703064,2697
10290,3487278983,3851810349,1672642939,1672645535,2596
10268,3228477490,3517358336,1672578323,1672580040,1717
10886,3663902064,3501126057,1672615029,1672617946,2917
9899,3920116284,3554236075,1672573976,1672576927,2951
9799,3624164232,3916656185,1672696232,1672699784,3552
11770,3792475476,3510484107,1672616668,1672619887,3219
9968,3452677710,3283847934,1672663079,1672665111,2032
11039,3488931357,3804779247,1672614277,1672615008,731
10152,3602680347,3739844610,1672701848,1672705134,3286
10740,3278629965,3774598935,1672551771,1672552962,1191
9888,3510454018,3682150740,1672699739,1672700524,785
11483,3228033254,3340723781,1672623973,1672627334,3361
10082,3471585513,3703443664,1672602612,1672605510,2898
10085,3533440736,3382757142,1672632894,1672636143,3249
11005,3701770921,3482786946,1672666835,1672669272,2437
10404,3760390822,3313824913,1672629302,1672629661,359
10446,3467944159,3609644043,1672693655,1672693739,84
11591,3446575109,3516359146,1672618637,1672620321,1684
11576,3756890980,3756736726,1672583812,1672584748,936
11748,3885422379,3772683155,1672551986,1672555456,3470
11350,3358262975,3515893948,1672614793,1672618177,3384
10214,3276231633,3896123242,1672616286,1672616487,201
11494,3907039612,3517426473,1672702916,1672703645,729
11528,3359418136,3231859576,1672550631,1672552895,2264
10976,3777715675,3687183789,1672626852,1672629814,2962
11778,3319436533,3434052463,1672648310,1672648912,602
9919,3755922811,3500640854,1672550268,1672552635,2367
10485,3505066871,3427527462,1672605514,1672607609,2095
11273,3716669659,3308481706,1672551545,1672554651,3106
10981,3284374600,3711810752,1672599425,1672601867,2442
11790,3624307518,3701887470,1672648931,1672651997,3066
11360,3827889533,3519297683,1672610698,1672612777,2079
10907,3311989687,3793783685,1672635477,1672638039,2562
11742,3516517348,3343698137,1672572805,1672573869,1064
10774,3471996194,3335974305,1672640662,1672642461,1799
11253,3755790149,3477248170,1672614696,1672616220,1524
10923,3500833053,3715282492,1672616602,1672619119,2517
10638,3435159896,3512101369,1672543596,1672546326,2730
10663,3757732853,3715441777,1672545468,1672546788,1320
10692,3710316008,3776034313,1672583512,1672586766,3254
11388,3780964089,3472018395,1672582312,1672583681,1369
11263,3500720752,3711938229,1672629582,1672630747,1165
11264,3515939841,3505998260,1672603212,1672604298,1086
11755,3332124606,3713694278,1672573913,1672576379,2466
11423,3514611187,3854229296,1672700098,1672702327,2229
10110,3418382025,3559123082,1672533183,1672534358,1175
11658,3512857020,3533627473,1672575642,1672578359,2717
11613,3281935691,3755209597,1672553846,1672555937,2091
11463,3418367752,3516378356,1672671408,1672673258,1850
10551,3500596577,3509355477,1672624995,1672627090,2095
11239,3976400190,3773770134,1672580726,1672581393,667
10048,3715106566,3534111498,1672599071,1672602390,3319
9949,3778182724,3349475873,1672560393,1672563747,3354
11633,3453164933,3511289729,1672610306,1672612730,2424
9901,3777564559,3817376705,1672635295,1672638056,2761
10961,3884180202,3715566511,1672649341,1672651327,1986
11265,3755630085,3925208102,1672614348,1672617570,3222
10971,3904846341,3639465750,1672599421,1672600746,1325
10300,3815440588,3496579251,1672700705,1672703688,2983
9932,3668955834,3419762444,1672608607,1672609840,1233
10846,3505709407,3895944547,1672544917,1672546546,1629
11141,3420664407,3355430975,1672639355,1672639773,418
11474,3773024346,3479207976,1672576519,1672578561,2042
11383,3703476890,3817029483,1672535819,1672538598,2779
10073,3897500723,3770715115,1672695691,1672697480,1789
11693,3701893620,3316117186,1672614280,1672615424,1144
10738,3514761434,3387700451,1672555320,1672555912,592
11042,3512154443,3791617239,1672676462,1672677443,981
10855,3209958726,3756948477,1672654854,1672655707,853
11236,3778713526,3205161801,1672619380,1672621747,2367
11410,3791121243,3458271585,1672628991,1672629647,656
10742,3776811587,3311989687,1672543199,1672544514,1315
11254,3486824047,3519947298,1672661647,1672663911,2264
10535,3713107380,3343698137,1672561096,1672563860,2764
10604,3701448521,3773376762,1672631015,1672631680,665
9926,3516167000,3509379617,1672607905,1672611028,3123
9870,3620157388,3757623259,1672568331,1672571566,3235
10173,3509360869,3791382196,1672632172,1672633674,1502
10975,3505828210,3533703578,1672568809,1672570000,1191
11465,3623953446,3664478769,1672580422,1672583184,2762
11097,3533777032,3773434690,1672691107,1672691490,383
11138,3774296721,3627081426,1672569345,1672569611,266
11149,3224053074,3513545735,1672691693,1672693522,1829
10089,3792682835,3500927619,1672640472,1672643687,3215
11018,3533777032,3755865626,1672558547,1672561983,3436
10019,3512697456,3209958726,1672668140,1672669532,1392
10769,3711862792,3776407517,1672635964,1672637665,1701
10975,3229615214,3510291656,1672599512,1672599688,176
10249,3515637968,3853188285,1672539228,1672542018,2790
10452,3456795601,3311331205,1672703493,1672705510,2017
10980,3428198021,3619494735,1672621549,1672623248,1699
10140,3520155898,3493047640,1672637187,1672640198,3011
11121,3441336851,3352374868,1672688986,1672690622,1636
10638,3703481882,3432466467,1672689844,1672693226,3382
11527,3491335890,3922786716,1672682796,1672685949,3153
11562,3760074281,3310702648,1672631781,1672635239,3458
9831,3821103640,3505804611,1672610266,1672610661,395
11709,3755922811,3618672178,1672683846,1672684224,378
10482,3783157469,3777729184,1672690734,1672693686,2952
9870,3776841808,3611298237,1672629047,1672629243,196
10463,3356599815,3403738461,1672662284,1672664228,1944
10880,3278430820,3552309108,1672578472,1672581567,3095
11374,3617135064,3760382349,1672584569,1672587971,3402
9812,3681737865,3308481706,1672665738,1672667531,1793
10229,3613940925,3772943811,1672630517,1672631183,666
11537,3505547832,3316121649,1672614585,1672615915,1330
11287,3514216460,3805718871,1672574820,1672576981,2161
9795,3363549860,3770764940,1672703938,1672706858,2920
10268,3711804184,3682150740,1672588986,1672589360,374
10225,3500329674,3534988162,1672537519,1672540338,2819
11704,3361952532,3737622701,1672650443,1672652407,1964
11631,3516497645,3716179251,1672656086,1672658740,2654
10453,3858497718,3778932673,1672608372,1672609336,964
10075,3757660578,3362706073,1672575511,1672576130,619
11412,3317190427,3780127017,1672578995,1672579156,161
10470,3387322545,3899205452,1672596881,1672596991,110
10549,3392482187,3227874229,1672646928,1672647907,979
10653,3500854711,3783947742,1672609726,1672610699,973
11019,3505359060,3513563152,1672533157,1672534228,1071
9886,3817120976,3770941125,1672578302,1672580820,2518
10218,3926065090,3348343425,1672651504,1672654114,2610
9956,3783021859,3500456339,1672694214,1672695562,1348
10657,3227498870,3512819376,1672608362,1672609402,1040
10246,3313502623,3516249472,1672657366,1672659511,2145
10658,3533209168,3273674596,1672649911,1672652155,2244
9824,3777063455,3715282492,1672602411,1672605884,3473
11675,3534111498,3501271930,1672669317,1672669898,581
11522,3936851114,3366164642,1672657958,1672659788,1830
10651,3793822639,3733915784,1672604971,1672605632,661
10089,3619676231,3829761380,1672546423,1672546961,538
10594,3519260216,3791088014,1672533501,1672535868,2367
10215,3534696810,3240443426,1672603270,1672605949,2679
10442,3445406685,3510254698,1672686246,1672686736,490
10853,3515893948,3778842400,1672664104,1672666175,2071
11569,3711287751,3519059808,1672595490,1672598792,3302
9998,3730115019,3711945923,1672642341,1672644409,2068
11716,3384151770,3462153833,1672653427,1672654943,1516
10374,3777149336,3511004622,1672670640,1672671469,829
9842,3244395841,3493679801,1672620711,1672622996,2285
11539,3481365330,3452024572,1672649920,1672652587,2667
10246,3500734346,3533876927,1672628461,1672629687,1226
11257,3406132280,3456795601,1672581589,1672585127,3538
11706,3780648744,3516965624,1672638586,1672641321,2735
10225,3342837214,3793814153,1672696803,1672696962,159
11218,3666561358,3437108337,1672695527,1672697891,2364
11007,3273242177,3380418745,1672621501,1672624307,2806
10070,3783368855,3711862792,1672622703,1672625242,2539
11381,3510209505,3803996569,1672675013,1672675366,353
11048,3774090455,3511794841,1672600781,1672602715,1934
11707,3809207482,3793732968,1672580557,1672582431,1874
11298,3928508375,3903065952,1672641827,1672642350,523
10414,3484490325,3732596503,1672556740,1672558130,1390
9833,3668764192,3857389270,1672544202,1672545292,1090
11290,3505148522,3778544203,1672615840,1672617149,1309
10298,3903088144,3516706935,1672680298,1672682868,2570
10306,3233917789,3512072679,1672680708,1672681999,1291
10169,3341432459,3760274119,1672546711,1672549083,2372
11420,3246804115,3384001094,1672627754,1672628786,1032
10386,3853182912,3517210356,1672585923,1672586095,172
9854,3239401337,3685083275,1672541873,1672544763,2890
10099,3421524698,3757851680,1672703929,1672705956,2027
11778,3228477490,3505826673,1672638037,1672638658,621
11473,3354405535,3716492409,1672670154,1672670398,244
10090,3779454060,3501137133,1672676346,1672677031,685
9893,3757198930,3757773786,1672605467,1672606214,747
9895,3319862687,3452024572,1672614766,1672615445,679
10372,3736621212,3715441786,1672692503,1672694779,2276
10049,3359880163,3783201950,1672612491,1672613213,722
11583,3353811455,3398151217,1672542036,1672543391,1355
10151,3834980281,3756367938,1672695057,1672697881,2824
10607,3519015940,3933562725,1672601499,1672604851,3352
11495,3511500932,3890638402,1672535043,1672536355,1312
10318,3445077330,3703462221,1672616093,1672616971,878
11246,3221736756,3313392810,1672594716,1672597256,2540
10072,3480270940,3358211034,1672629248,1672630043,795
10534,3774195369,3773083407,1672604502,1672605925,1423
11232,3403257752,3501843187,1672590545,1672591506,961
11730,3368339963,3783879023,1672617589,1672619596,2007
9856,3636927297,3716195780,1672670133,1672672303,2170
10319,3806471413,3733123020,1672686156,1672687174,1018
11431,3374652108,3914947393,1672589123,1672590577,1454
11087,3520016705,3713840946,1672692436,1672692939,503
11482,3334482021,3791617239,1672652507,1672653935,1428
10793,3716609198,3778479297,1672572392,1672575880,3488
10918,3716801088,3684651755,1672652132,1672652699,567
10001,3515528947,3513586642,1672633882,1672635425,1543
10466,3360309868,3512154443,1672635298,1672636880,1582
9819,3333505404,3474350534,1672562656,1672564988,2332
10094,3283295213,3774702364,1672558225,1672559284,1059
10926,3811354125,3791332061,1672569482,1672572690,3208
10748,3770630937,3520553959,1672580573,1672581737,1164
10179,3850735936,3760144712,1672652527,1672653398,871
9905,3514498259,3624872714,1672651583,1672653606,2023
10924,3792432094,3233712975,1672534914,1672536695,1781
10733,3770285500,3533976217,1672577630,1672579988,2358
9879,3281970147,3395082458,1672544969,1672545875,906
11115,3492064037,3774939922,1672675187,1672675431,244
10880,3972653129,3248061684,1672605076,1672607896,2820
11385,3517227599,3757598610,1672549101,1672550136,1035
10901,3760481622,3500145103,1672700101,1672702377,2276
11467,3222357355,3207307681,1672678232,1672678460,228
11048,3793569914,3713285095,1672658771,1672660593,1822
10411,3822634862,3433189219,1672636590,1672639165,2575
11061,3355899481,3511969443,1672604335,1672605663,1328
10850,3979366845,3307454562,1672559737,1672560692,955
11076,3293673220,3495446254,1672661534,1672662650,1116
11192,3500994763,3233965781,1672549413,1672552805,3392
11234,3703481882,3334482021,1672599691,1672602053,2362
10927,3913746581,3792267993,1672669077,1672670256,1179
10670,3500814753,3501261089,1672532740,1672536089,3349
10321,3660163550,3501843187,1672669858,1672672519,2661
11359,3812277991,3632720032,1672536320,1672538335,2015
11298,3897186782,3318056480,1672687460,1672688743,1283
10530,3293673220,3626631210,1672696086,1672697582,1496
10234,3760274119,3757501067,1672558872,1672559654,782
11409,3632720032,3801379377,1672538227,1672539459,1232
10267,3778932673,3378172464,1672557596,1672560907,3311
10404,3609335008,3927181190,1672651830,1672652510,680
11039,3514033319,3511382748,1672571177,1672574573,3396
11192,3517151644,3517377614,1672609193,1672612487,3294
11537,3773603836,3777686966,1672552778,1672555065,2287
11005,3757311529,3814770073,1672567929,1672569731,1802
11040,3501612813,3393502004,1672600247,1672603420,3173
11437,3792512768,3533728729,1672687001,1672689305,2304
11659,3440401725,3411355804,1672618900,1672620823,1923
11223,3360949039,3773579644,1672636438,1672638667,2229
10308,3500356342,3349475873,1672650876,1672652410,1534
11592,3229621693,3897003751,1672575444,1672575754,310
9908,3511750695,3760481622,1672696099,1672696611,512
10072,3510882475,3783651407,1672620377,1672623109,2732
10311,3518425740,3484483775,1672688245,1672689324,1079
10444,3482786946,3813986705,1672550255,1672551038,783
10460,3906260966,3374195945,1672567699,1672568802,1103
10029,3979366845,3711862792,1672578143,1672580845,2702
10797,3534499421,3515893948,1672658581,1672662156,3575
11030,3791368349,3463729805,1672549845,1672553105,3260
11407,3419829238,3304661369,1672553677,1672555268,1591
10242,3464622743,3482687604,1672663816,1672663992,176
10828,3440770466,3733123020,1672603166,1672603486,320
11226,3701971784,3439662051,1672631107,1672631934,827
10277,3236563828,3902023467,1672567272,1672568316,1044
10913,3287753579,3756168814,1672583536,1672586843,3307
10032,3850181934,3238796398,1672549361,1672551854,2493
11569,3370751461,3628423403,1672640547,1672642475,1928
9833,3791074200,3393001196,1672701851,1672703510,1659
10165,3361635547,3923133978,1672637141,1672638514,1373
11752,3791245127,3776183353,1672689787,1672692402,2615
11615,3534941710,3922301238,1672677964,1672681544,3580
11009,3509677530,3534589501,1672537975,1672540594,2619
10162,3505472087,3475653510,1672703848,1672706056,2208
10998,3487395357,3556684272,1672682669,1672682955,286
10008,3703849264,3770424941,1672590863,1672593592,2729
9946,3309178914,3455907179,1672617262,1672618599,1337
10052,3370512945,3774682234,1672593800,1672595563,1763
10486,3403738461,3312800145,1672556412,1672559797,3385
10740,3776841808,3755779925,1672635483,1672636215,732
9976,3336501403,3825932442,1672696612,1672700086,3474
10950,3235373942,3406132280,1672554850,1672555324,474
10837,3822634862,3510916875,1672556978,1672559695,2717
11180,3822368676,3793222045,1672560380,1672563020,2640
10134,3756525103,3287821258,1672631759,1672633804,2045
10062,3826418889,3792440162,1672573734,1672573838,104
11661,3776732532,3714690161,1672594746,1672598184,3438
10973,3479910993,3774782065,1672601154,1672602450,1296
10214,3895839169,3887069914,1672681962,1672684715,2753
10973,3791205793,3519621901,1672683959,1672684035,76
10606,3440743218,3520057139,1672641582,1672643286,1704
11670,3857244486,3283847934,1672620241,1672620370,129
10560,3772980989,3510233949,1672662301,1672664524,2223
10817,3880788853,3812756400,1672679105,1672682348,3243
11435,3505496725,3701668745,1672576834,1672580053,3219
11186,3884394685,3413799143,1672684751,1672686111,1360
10119,3515706117,3716341323,1672542865,1672545509,2644
11283,3774448657,3902775449,1672677487,1672679961,2474
11187,3467415939,3201573194,1672661836,1672663150,1314
10659,3343511947,3489340327,1672665481,1672666634,1153
10040,3778706119,3559123082,1672556433,1672556908,475
10633,3514737648,3276499910,1672588326,1672590217,1891
10110,3551972633,3732440502,1672612923,1672615808,2885
11358,3715852330,3375906394,1672569873,1672570905,1032
10870,3636857871,3380285779,1672540305,1672541244,939
10478,3711076751,3971422524,1672582624,1672584188,1564
11457,3774702364,3384601925,1672694747,1672697813,3066
10087,3481365330,3713170867,1672644278,1672647490,3212
11365,3834456158,3483078667,1672679134,1672681340,2206
10870,3511908639,3520182275,1672610958,1672612462,1504
9966,3667950469,3612841103,1672682608,1672684757,2149
11585,3715261950,3227206772,1672669879,1672671690,1811
11500,3454924050,3228997424,1672611652,1672615160,3508
10186,3832902787,3736010012,1672646733,1672647032,299
11179,3770018912,3374147279,1672607177,1672607849,672
11060,3605101443,3715881104,1672629892,1672630549,657
11070,3335055096,3855977674,1672540068,1672541119,1051
11345,3773878451,3505502819,1672568094,1672568783,689
10327,3776348451,3301332095,1672595643,1672597190,1547
11521,3738103378,3241682278,1672602520,1672605078,2558
9848,3630802959,3513203127,1672597192,1672597923,731
9810,3736941123,3688130094,1672597589,1672600799,3210
10387,3731644240,3505416534,1672619350,1672619651,301
9876,3774652449,3452389513,1672612804,1672614972,2168
10101,3533113740,3488931357,1672541979,1672545149,3170
10690,3777641081,3367109648,1672538559,1672539660,1101
11432,3464622743,3773899531,1672531674,1672533118,1444
10892,3623894390,3777932581,1672571176,1672571877,701
9880,3443191792,3688870751,1672574845,1672576081,1236
9856,3299845453,3600171014,1672638337,1672640573,2236
10083,3739820448,3783935976,1672589599,1672589697,98
11720,3208894215,3281970147,1672676848,1672677140,292
9840,3511671476,3397783490,1672533915,1672535427,1512
10267,3937299996,3757944870,1672537631,1672539922,2291
10547,3778479297,3384151770,1672662005,1672663441,1436
11179,3334461288,3713920790,1672683296,1672684362,1066
9869,3550206045,3483701493,1672686215,1672688674,2459
10039,3902775449,3636015050,1672682557,1672683559,1002
9856,3668063289,3389367628,1672570631,1672574098,3467
10415,3492728794,3793783685,1672694841,1672698425,3584
10083,3423782420,3711959141,1672575717,1672579123,3406
9843,3855977674,3309651238,1672559317,1672560942,1625
9826,3513384042,3301403047,1672547197,1672549240,2043
11437,3406132280,3341985886,1672674813,1672677198,2385
10824,3778824229,3515470462,1672703453,1672704436,983
10364,3774627091,3612841103,1672579381,1672582605,3224
11319,3520832066,3756616853,1672654842,1672656576,1734
10411,3851515560,3884388188,1672578986,1672580184,1198
10041,3710008760,3815440588,1672646008,1672646492,484
10473,3333477908,3319645922,1672557455,1672560620,3165
10615,3971280379,3623067708,1672638881,1672638996,115
9923,3711029952,3710487368,1672688339,1672688882,543
10518,3711671702,3777498160,1672615441,1672617330,1889
11311,3757030923,3685522474,1672561367,1672564793,3426
9977,3478937459,3301403047,1672572794,1672576080,3286
10833,3413799143,3711938229,1672669309,1672671160,1851
11177,3710119555,3854390432,1672660788,1672662528,1740
11413,3777758203,3757924067,1672640108,1672640328,220
11625,3311410533,3552309108,1672631165,1672634699,3534
11085,3783879023,3533036499,1672555772,1672556021,249
9803,3432838598,3382746533,1672687818,1672689615,1797
10572,3888642876,3500198430,1672679137,1672682277,3140
10373,3226037966,3310021925,1672601525,1672603671,2146
11420,3512203553,3612841103,1672572941,1672575236,2295
11133,3783095041,3287920864,1672575194,1672577495,2301
10890,3534374523,3510373076,1672636283,1672636922,639
10794,3519886257,3609103278,1672604196,1672604765,569
9829,3289017988,3979115924,1672550135,1672553433,3298
11281,3639503148,3613828705,1672532225,1672533448,1223
11473,3519924982,3713219299,1672561338,1672562316,978
11451,3512625661,3355430975,1672585765,1672585882,117
10373,3888903181,3714640103,1672691715,1672693781,2066
10272,3514926921,3307997700,1672550578,1672553538,2960
11485,3756759239,3662507634,1672640670,1672642476,1806
9959,3209958726,3711518637,1672599947,1672600961,1014
11394,3778924002,3934980229,1672697527,1672698784,1257
10098,3236360179,3883640904,1672631349,1672632286,937
10628,3628423403,3924366353,1672571926,1672572357,431
11203,3464622743,3777060250,1672572361,1672574092,1731
9831,3760648750,3757728121,1672623137,1672626454,3317
10439,3899294071,3711770773,1672640887,1672644285,3398
10796,3884394685,3622152515,1672687566,1672687632,66
10997,3400025324,3387388336,1672558198,1672559610,1412
11300,3491335890,3505037247,1672682300,1672685367,3067
10340,3777041132,3924366353,1672636425,1672637086,661
11278,3890638402,3791435852,1672533792,1672536448,2656
11376,3471555057,3392573386,1672640356,1672640759,403
11625,3516034245,3714688409,1672576217,1672577646,1429
11572,3501901313,3393128259,1672617827,1672618368,541
11148,3519886257,3793814153,1672664648,1672665252,604
11682,3375906394,3770764940,1672572314,1672575355,3041
11542,3505521491,3249771731,1672589708,1672591191,1483
11401,3703779674,3439283360,1672606668,1672608824,2156
11664,3246971044,3312946269,1672602718,1672604780,2062
11460,3701377471,3420983899,1672559428,1672562970,3542
10528,3413236071,3791224239,1672537893,1672539073,1180
10693,3701041860,3377250778,1672580930,1672582686,1756
11215,3703818358,3239401337,1672621273,1672624719,3446
11594,3534937492,3783176874,1672567688,1672570688,3000
10030,3774782065,3244395841,1672577702,1672579527,1825
10705,3500415589,3476416072,1672589596,1672589662,66
11348,3534937492,3773878451,1672637758,1672639404,1646
10166,3773891827,3284334297,1672622128,1672625544,3416
10682,3509208005,3500455935,1672587167,1672588301,1134
11089,3509677530,3931917809,1672694223,1672695658,1435
11427,3755203055,3510680251,1672674330,1672676566,2236
9886,3818324410,3855440101,1672670432,1672673443,3011
10209,3500741005,3715590997,1672540481,1672543919,3438
10074,3773891827,3925098136,1672653389,1672655733,2344
10450,3520160414,3701359045,1672570956,1672571263,307
11765,3318220119,3755394177,1672666658,1672669524,2866
11758,3513894659,3452090950,1672638402,1672638564,162
11707,3450735824,3773534165,1672611393,1672614033,2640
10192,3520012007,3339649817,1672561799,1672562825,1026
11728,3631444265,3600302127,1672593580,1672594183,603
11762,3301765144,3772296376,1672694923,1672696613,1690
11750,3552261072,3607288879,1672697729,1672700059,2330
10039,3711214982,3895507040,1672658022,1672658321,299
10903,3777074709,3820280594,1672682555,1672684793,2238
11055,3454924050,3703031637,1672561411,1672563817,2406
11739,3517045396,3396472026,1672596191,1672596445,254
10716,3316551382,3440582836,1672680344,1672683698,3354
10006,3711171132,3231227362,1672673320,1672676139,2819
10444,3468281011,3510218188,1672553052,1672553755,703
11073,3207748225,3347520239,1672649288,1672649816,528
10065,3341432459,3311015817,1672582244,1672583792,1548
10123,3515096959,3206853747,1672610039,1672610976,937
10549,3519162582,3897500723,1672626442,1672626648,206
10090,3514941815,3839417558,1672606796,1672608298,1502
10880,3770480149,3820922991,1672669631,1672671214,1583
11202,3833993674,3445406685,1672631294,1672631863,569
10885,3623067708,3297684667,1672589437,1672591051,1614
11559,3338465050,3930475498,1672586950,1672589965,3015
11166,3710919244,3927202773,1672600530,1672603058,2528
9838,3479910993,3907923381,1672663910,1672665625,1715
11119,3938409715,3428198021,1672625693,1672626603,910
10955,3236206821,3738760498,1672574606,1672576822,2216
11527,3713141087,3379076106,1672542724,1672543067,343
9979,3227339675,3534589501,1672633558,1672634957,1399
11038,3505665788,3680988889,1672607645,1672610329,2684
9941,3710487368,3201634072,1672584684,1672588053,3369
11248,3500096103,3441840658,1672666194,1672666726,532
10445,3445896667,3519841427,1672699823,1672702389,2566
10208,3836586875,3888642876,1672668025,1672668744,719
11034,3304697982,3895839169,1672533860,1672536348,2488
11405,3634766042,3916463490,1672642838,1672643114,276
10264,3834980281,3390537737,1672532052,1672532145,93
10933,3852992961,3389367628,1672676878,1672679998,3120
10326,3505097206,3515304526,1672613666,1672615252,1586
10652,3511645260,3774539067,1672668585,1672670141,1556
10268,3701675183,3311260898,1672649990,1672653188,3198
10333,3373018943,3479207976,1672620485,1672623080,2595
9921,3703104365,3500785888,1672652738,1672655393,2655
11430,3466149998,3505756991,1672633447,1672636124,2677
11719,3713434898,3780500764,1672694299,1672696410,2111
11450,3755378125,3777937949,1672555818,1672556986,1168
9896,3516444589,3928076270,1672561918,1672564817,2899
10466,3757050615,3358262975,1672606356,1672608160,1804
11527,3246804115,3452802329,1672609701,1672613242,3541
11671,3500329674,3906693728,1672639512,1672640157,645
11394,3939882169,3738132114,1672560196,1672561393,1197
9964,3971447562,3703277359,1672547393,1672549874,2481
11584,3511794841,3457249798,1672565233,1672567793,2560
11149,3311602936,3792337863,1672654136,1672654932,796
10381,3793899166,3732440502,1672534907,1672535075,168
11478,3510968599,3534589501,1672659140,1672662675,3535
10765,3554317844,3778479297,1672579173,1672581037,1864
10418,3403120725,3779609338,1672657396,1672659220,1824
10963,3295530454,3299587876,1672674926,1672677345,2419
11010,3520824937,3442073613,1672672995,1672674191,1196
10139,3715039960,3515304526,1672578356,1672580605,2249
11727,3777758203,3500776597,1672574288,1672577613,3325
10004,3716740576,3852275715,1672650239,1672652673,2434
10526,3760096466,3774236212,1672663040,1672665311,2271
10683,3818324410,3662307789,1672549346,1672552526,3180
11418,3533841983,3778695017,1672701952,1672705309,3357
10802,3773556853,3793332600,1672615899,1672616232,333
11060,3822368676,3533365834,1672573513,1672574816,1303
11032,3371759044,3776968640,1672694075,1672697519,3444
11266,3770595035,3518164450,1672663771,1672664610,839
11602,3779212271,3343193067,1672569950,1672571698,1748
10360,3501980730,3342252701,1672686204,1672687459,1255
10453,3500776597,3783122313,1672701135,1672703963,2828
10869,3777706200,3459163055,1672664853,1672666621,1768
11616,3783408830,3779160052,1672561525,1672562941,1416
11377,3517149023,3553694590,1672658611,1672659228,617
11188,3426468199,3825877848,1672683030,1672684795,1765
10992,3714903456,3783727937,1672556663,1672557113,450
11295,3609997804,3774401596,1672534373,1672537145,2772
10163,3354015456,3352493805,1672630362,1672630567,205
10744,3505500523,3500018566,1672703755,1672705809,2054
10448,3519465545,3806720019,1672563418,1672565903,2485
10117,3772869013,3615447269,1672696517,1672697931,1414
10315,3278779955,3505531432,1672581622,1672582885,1263
10923,3880549316,3363549860,1672621136,1672621233,97
11499,3715126587,3778479297,1672616364,1672619374,3010
11153,3919258737,3510218188,1672642986,1672644892,1906
10549,3494748808,3715284599,1672625550,1672626983,1433
11456,3465690527,3550405857,1672693937,1672695233,1296
10397,3703896751,3510758718,1672693472,1672696133,2661
11399,3780171640,3292936094,1672573137,1672573299,162
10953,3311805161,3792824886,1672598000,1672600279,2279
11475,3703168159,3663505156,1672674644,1672675148,504
9826,3400186699,3422205569,1672574036,1672577421,3385
11031,3533628528,3756717136,1672545096,1672546060,964
9941,3715852330,3939882169,1672643919,1672646311,2392
10028,3776791436,3778124514,1672574203,1672574263,60
10034,3927365255,3533131937,1672653491,1672654048,557
10152,3369482983,3533473206,1672600683,1672602872,2189
10636,3715724166,3436099135,1672613942,1672616097,2155
10232,3447312353,3510209505,1672612472,1672616003,3531
11200,3274223335,3605591994,1672681703,1672685029,3326
11669,3829358750,3938398160,1672642298,1672644165,1867
10350,3294821709,3505836431,1672700540,1672703323,2783
11754,3925098136,3462645981,1672625462,1672625564,102
10223,3713969196,3357496255,1672570686,1672573433,2747
11520,3364302157,3319660530,1672622876,1672624286,1410
10770,3978254945,3395610742,1672604559,1672605365,806
11292,3406937294,3756149282,1672661774,1672664422,2648
10361,3773768643,3516497645,1672558992,1672559536,544
10315,3555215568,3461931154,1672682447,1672683503,1056
10711,3772683155,3511671476,1672571878,1672574647,2769
11710,3515597467,3520471156,1672613751,1672616162,2411
10389,3514013999,3510278533,1672649284,1672649909,625
11360,3406169279,3808849597,1672570969,1672573998,3029
10947,3520925688,3600171014,1672629988,1672633311,3323
11785,3351949206,3347140733,1672658958,1672662157,3199
10182,3912181197,3311805161,1672593576,1672596987,3411
11109,3757501067,3509370016,1672660249,1672662309,2060
10721,3500329674,3415803494,1672535647,1672537825,2178
10146,3312800145,3505804611,1672655226,1672657124,1898
9832,3534984243,3755670258,1672559953,1672563330,3377
10636,3487278983,3244098077,1672544874,1672547955,3081
11404,3513850048,3828568868,1672614242,1672614342,100
10631,3832289185,3793926338,1672578456,1672579115,659
11539,3619494735,3713224986,1672660153,1672660775,622
11696,3272827860,3774251051,1672698632,1672700672,2040
11029,3896622009,3772683155,1672652891,1672653025,134
11428,3803473387,3757201138,1672666932,1672668058,1126
10166,3792708936,3774682234,1672599011,1672601726,2715
11041,3207748225,3793081195,1672681560,1672684103,2543
10162,3385006834,3201634072,1672588827,1672589961,1134
10460,3291936679,3714883746,1672591469,1672593453,1984
10530,3774359137,3929923442,1672631300,1672634558,3258
10507,3711947828,3636605690,1672672288,1672674109,1821
10139,3446810761,3513140146,1672560517,1672560826,309
11232,3505032773,3367262509,1672547419,1672550647,3228
10893,3353194923,3279731391,1672598499,1672599776,1277
10915,3662354016,3621439107,1672609051,1672609162,111
10044,3970265139,3517756624,1672569245,1672569840,595
10487,3305612422,3603452936,1672614604,1672616801,2197
11431,3415228763,3703462221,1672616719,1672617805,1086
10377,3792578118,3498857406,1672585810,1672586439,629
9879,3600842635,3391612879,1672606234,1672607352,1118
11209,3276393542,3513111053,1672543437,1672543603,166
11316,3515726910,3636605690,1672558695,1672560105,1410
11767,3200320674,3501612813,1672539574,1672543132,3558
10430,3716801088,3271389160,1672532837,1672536300,3463
9913,3778838936,3505234868,1672575599,1672576004,405
9905,3972196462,3338115824,1672597808,1672598799,991
10833,3505234868,3500579482,1672656528,1672659987,3459
11370,3714718326,3915035136,1672659057,1672661424,2367
10937,3463892928,3901217668,1672539549,1672541375,1826
11159,3715852330,3713283029,1672663991,1672666712,2721
11357,3778706119,3792851584,1672592795,1672592919,124
11775,3701374160,3713416756,1672682084,1672682385,301
11760,3451757423,3534284132,1672563908,1672565321,1413
10435,3716976932,3554236075,1672599661,1672600103,442
10665,3713740434,3511003541,1672654633,1672655118,485
11743,3607583720,3447554599,1672643293,1672646264,2971
11391,3308744016,3928508375,1672667004,1672668561,1557
11764,3406492167,3387971464,1672581611,1672583542,1931
11115,3935520819,3777686966,1672651164,1672652280,1116
11663,3247193800,3342056927,1672533347,1672535489,2142
10686,3209280342,3779255367,1672667639,1672668030,391
10300,3812880543,3510758718,1672629139,1672629493,354
10779,3367526113,3838039092,1672691604,1672695005,3401
10065,3514352989,3248409083,1672593840,1672594715,875
9913,3406937294,3225554956,1672585078,1672586496,1418
11412,3359418136,3715106566,1672685518,1672688930,3412
9824,3772689657,3361865467,1672649235,1672650529,1294
10412,3534696810,3711770853,1672630278,1672633612,3334
10993,3500922040,3404395454,1672596244,1672597225,981
11662,3755411110,3501573548,1672620036,1672623539,3503
10044,3244395841,3613936929,1672649476,1672650789,1313
10121,3711722554,3826542169,1672558552,1672561463,2911
9822,3440401725,3302348002,1672682967,1672686186,3219
10911,3755154460,3701385831,1672611665,1672614233,2568
10361,3772943811,3505665788,1672549389,1672550682,1293
10270,3500049870,3710296607,1672567468,1672569205,1737
11434,3520022175,3779778679,1672667119,1672667680,561
10537,3807111856,3713107380,1672667470,1672667759,289
10251,3710060386,3501174621,1672570931,1672571524,593
11158,3299845453,3793987483,1672688646,1672691323,2677
11109,3756113624,3520273299,1672577381,1672579724,2343
10334,3660702754,3313502623,1672581095,1672582712,1617
10453,3735197034,3880637958,1672681092,1672683733,2641
10903,3513186622,3755175497,1672561967,1672562732,765
11198,3509370633,3513661302,1672561797,1672565051,3254
11238,3505887814,3310021925,1672639546,1672641523,1977
11316,3351728355,3309651238,1672632485,1672634974,2489
10909,3716118473,3510750299,1672558796,1672561966,3170
10357,3380185102,3471585513,1672675365,1672677491,2126
11723,3714142299,3534984243,1672646408,1672648001,1593
11114,3553640169,3479207976,1672639576,1672640554,978
10870,3639926564,3710107905,1672637171,1672638923,1752
10785,3780435349,3496591885,1672545386,1672547082,1696
9954,3976742903,3512477276,1672555983,1672559255,3272
11431,3220660616,3776200012,1672574787,1672576212,1425
10458,3919345990,3884458862,1672636003,1672638948,2945
11277,3916656185,3340723781,1672671450,1672673380,1930
11743,3774483862,3289017988,1672546211,1672548100,1889
11328,3714294005,3701385831,1672688598,1672690177,1579
11637,3274894848,3780626668,1672695400,1672697489,2089
10388,3275751794,3634670780,1672586249,1672588213,1964
11539,3890211161,3308744016,1672628110,1672631156,3046
10581,3510547682,3811629200,1672635843,1672637067,1224
10178,3630462406,3514007122,1672603986,1672607425,3439
10495,3467944159,3334936138,1672618547,1672619677,1130
11155,3510486220,3391612879,1672652046,1672654925,2879
10457,3515379622,3711076751,1672642862,1672644480,1618
11538,3511311554,3819400315,1672562353,1672563681,1328
9990,3626631210,3884001167,1672636921,1672638925,2004
9953,3515944817,3407734098,1672578476,1672582034,3558
11165,3903065952,3462985379,1672581192,1672581885,693
10767,3713767153,3221126799,1672567883,1672568803,920
10870,3770391782,3513740840,1672551521,1672551845,324
11057,3821103640,3793814153,1672583193,1672586604,3411
10713,3513171472,3342545285,1672534614,1672536482,1868
10244,3303772923,3486509752,1672597140,1672598764,1624
10584,3278251248,3770424892,1672592126,1672593968,1842
11362,3730226545,3534374523,1672568861,1672569689,828
10579,3447948483,3200785194,1672642808,1672643234,426
9810,3686885442,3836586875,1672700262,1672702102,1840
10088,3416225867,3684199077,1672596571,1672597198,627
10499,3515470462,3602054754,1672612787,1672615901,3114
10015,3776447604,3880562532,1672575171,1672577330,2159
9885,3928508375,3226913558,1672685237,1672687751,2514
10471,3738160394,3515715968,1672585337,1672588234,2897
11484,3442096275,3713139039,1672562269,1672565337,3068
10043,3791332226,3519034304,1672663517,1672667051,3534
10383,3243056734,3361952532,1672540036,1672542968,2932
10086,3774673193,3245642576,1672607737,1672610316,2579
11399,3283847934,3353811455,1672624645,1672625495,850
11205,3773411968,3773579644,1672571107,1672573819,2712
11346,3777909822,3793029132,1672542674,1672546258,3584
10569,3454924050,3513171472,1672693952,1672695976,2024
11724,3501115299,3510262025,1672533826,1672535264,1438
10184,3377311502,3511750850,1672634860,1672638397,3537
10485,3479452888,3500209015,1672584102,1672585022,920
11485,3469370398,3710296607,1672604959,1672607547,2588
10699,3665603628,3716541851,1672557795,1672559681,1886
10723,3791716170,3454924050,1672629224,1672629345,121
10690,3905571273,3776440009,1672674613,1672676689,2076
11565,3227647190,3424476995,1672648528,1672649158,630
11689,3293540333,3272581469,1672587481,1672588136,655
10029,3920606331,3757623259,1672613190,1672616271,3081
10650,3240877710,3774394000,1672537711,1672541060,3349
11441,3368441333,3534204885,1672657306,1672657711,405
10991,3793704155,3309651238,1672678543,1672679418,875
10779,3272581469,3370401047,1672600281,1672600464,183
10829,3624872714,3902548260,1672598400,1672598512,112
11352,3407398464,3512504247,1672643189,1672646130,2941
11205,3235578121,3510250740,1672660212,1672661330,1118
10979,3388463477,3710060386,1672607353,1672609176,1823
11177,3711844574,3512871568,1672637010,1672637367,357
10114,3774744663,3715114417,1672549151,1672549295,144
11738,3603740088,3710865678,1672538729,1672540414,1685
11371,3603167427,3509274030,1672665903,1672665982,79
10095,3714902042,3554174421,1672537635,1672540033,2398
11179,3930727474,3362706073,1672551006,1672551701,695
10023,3364067937,3774633364,1672627427,1672629574,2147
11461,3441336851,3207748225,1672567392,1672570694,3302
10692,3935520819,3369810091,1672638738,1672641096,2358
11250,3477248170,3477951091,1672643505,1672646466,2961
11364,3275057862,3422314045,1672593742,1672597221,3479
11709,3512826895,3515681585,1672654992,1672657068,2076
10996,3422314045,3308965136,1672685530,1672687947,2417
10116,3274239253,3903879740,1672596004,1672596081,77
11141,3922786716,3505887814,1672697247,1672698197,950
11074,3500178849,3306066522,1672574508,1672575589,1081
9939,3757639274,3465227623,1672563017,1672565488,2471
10158,3405303958,3893527651,1672552339,1672552764,425
11095,3773736248,3312612693,1672652044,1672654709,2665
10004,3342545285,3833993674,1672698241,1672700282,2041
10156,3505816624,3853386575,1672595469,1672596332,863
10663,3711176990,3480108752,1672539567,1672542983,3416
10314,3358434853,3783594729,1672675690,1672677698,2008
10080,3406169279,3298113026,1672635694,1672638803,3109
10159,3534531039,3514450836,1672636033,1672637710,1677
9861,3760420315,3517645656,1672551918,1672555102,3184
10207,3770544738,3757064623,1672579352,1672582012,2660
10718,3924366353,3625779003,1672659296,1672661759,2463
9836,3284334297,3885674996,1672675766,1672677409,1643
11585,3441944896,3500209015,1672624387,1672624757,370
11492,3235313062,3227498870,1672607241,1672610304,3063
10954,3773895671,3812261241,1672608217,1672611417,3200
11136,3837435907,3519055736,1672650285,1672651620,1335
11638,3776953418,3229615214,1672546724,1672550148,3424
10815,3469663062,3836757034,1672544830,1672548108,3278
11422,3511364193,3772569860,1672647391,1672650784,3393
10448,3899156705,3238779889,1672690101,1672691358,1257
11415,3516034245,3286862903,1672686076,1672688743,2667
11167,3908464960,3517331746,1672702970,1672705965,2995
10561,3806471413,3756066765,1672606190,1672609646,3456
11185,3501873139,3791509881,1672631615,1672632409,794
10776,3330188769,3491948594,1672620987,1672623078,2091
10623,3510486220,3975799349,1672604333,1672604714,381
11515,3773768643,3311410533,1672662053,1672663699,1646
10403,3282053097,3518088154,1672617148,1672619506,2358
11512,3792255406,3805268739,1672603176,1672604088,912
10025,3605101443,3701041860,1672605718,1672606346,628
10233,3779282072,3453519360,1672574135,1672574677,542
10254,3354968884,3668720465,1672582491,1672585668,3177
10446,3736941123,3888523259,1672682412,1672683182,770
11623,3711187791,3778741325,1672680277,1672683320,3043
11491,3501977123,3516321993,1672537601,1672538805,1204
10405,3854202447,3475830203,1672683973,1672687174,3201
11683,3638071975,3777715675,1672669531,1672672295,2764
10421,3621812406,3279726491,1672669230,1672672650,3420
11270,3513859809,3516655509,1672620398,1672620867,469
11474,3334936138,3512638952,1672697788,1672698796,1008
10566,3791994414,3882905311,1672533855,1672534069,214
10561,3714595459,3922430928,1672695941,1672697113,1172
11255,3732846295,3295530454,1672546605,1672550014,3409
10951,3828906027,3311521176,1672555258,1672558190,2932
11646,3337675386,3514145752,1672630274,1672632512,2238
9927,3977209952,3716423829,1672597075,1672599849,2774
10375,3716095450,3509457543,1672574311,1672576569,2258
11450,3735197034,3396656251,1672563886,1672566481,2595
10240,3792972270,3777118499,1672653998,1672654208,210
11140,3293540333,3368951504,1672584555,1672587118,2563
10070,3400112498,3938398160,1672667589,1672669423,1834
10838,3517253559,3713031958,1672532038,1672533877,1839
10556,3386323728,3757212744,1672566284,1672568043,1759
11101,3899156705,3461743188,1672690425,1672693172,2747
10142,3511078598,3822368676,1672544224,1672545553,1329
11780,3417268745,3273758330,1672641500,1672641960,460
10770,3976400190,3223796145,1672675011,1672676952,1941
9981,3919814073,3772869013,1672564114,1672567065,2951
10154,3275735969,3701448521,1672634391,1672635439,1048
10573,3622729771,3362706073,1672568513,1672570383,1870
10028,3371238318,3304661369,1672546478,1672548639,2161
11635,3311696372,3904846341,1672694089,1672694411,322
11511,3730414796,3533340292,1672571291,1672572815,1524
10635,3439662051,3713224986,1672652292,1672654216,1924
10402,3509317054,3660496328,1672636319,1672638507,2188
11331,3440743218,3778909412,1672593165,1672593625,460
10789,3235074007,3714250543,1672558386,1672559597,1211
10689,3475653510,3516731917,1672621935,1672624743,2808
10929,3756998113,3627081426,1672560862,1672564169,3307
10351,3509370016,3501963428,1672587837,1672588459,622
11573,3517021928,3615245840,1672577820,1672578510,690
9831,3756536476,3511883778,1672621199,1672622567,1368
10981,3363549860,3285322570,1672691750,1672692890,1140
11439,3760748418,3512504247,1672649142,1672652528,3386
10999,3687183789,3811351746,1672543629,1672544153,524
10442,3516792348,3703849264,1672531542,1672533682,2140
10771,3422205569,3339649817,1672587815,1672589594,1779
10272,3662495290,3634670780,1672574454,1672575960,1506
11696,3499711458,3519831322,1672672224,1672674429,2205
9922,3772019557,3357074700,1672554765,1672556165,1400
10755,3710046567,3668855144,1672586578,1672589727,3149
10541,3239779992,3534984243,1672570923,1672571203,280
10157,3559754304,3475033290,1672636347,1672637340,993
10712,3772291207,3444168914,1672633798,1672635808,2010
10063,3519162582,3817029483,1672537593,1672539794,2201
10013,3778382224,3371564186,1672614446,1672616929,2483
10014,3557324887,3533030343,1672661837,1672662629,792
11594,3714471069,3919342147,1672694874,1672695479,605
9808,3207497598,3555378248,1672545095,1672548376,3281
11009,3400545490,3737745988,1672682860,1672684203,1343
10568,3774195369,3370751461,1672619638,1672620884,1246
10579,3533037906,3815184540,1672652196,1672654359,2163
11082,3534168768,3776583229,1672695663,1672696161,498
10557,3533976217,3938409715,1672640808,1672641509,701
10338,3500415589,3439045964,1672701596,1672704770,3174
11527,3342027511,3488333295,1672571670,1672575000,3330
10052,3780982229,3359929534,1672548175,1672550236,2061
11615,3244397548,3716801088,1672575199,1672578147,2948
10727,3818324410,3473706746,1672639329,1672641850,2521
11021,3760396348,3505502819,1672575255,1672578625,3370
10094,3601340045,3505998260,1672694638,1672695052,414
10807,3932955949,3481700413,1672532768,1672533183,415
10209,3281970147,3447267291,1672540444,1672541008,564
10980,3368848936,3511963020,1672674707,1672676581,1874
10193,3600978954,3513661302,1672616540,1672618424,1884
10012,3240877710,3601340045,1672626998,1672627973,975
10868,3756363182,3770424941,1672614457,1672616025,1568
10555,3511476353,3756675909,1672697141,1672698542,1401
11362,3533325993,3223512565,1672690181,1672690689,508
11493,3271719569,3809860102,1672656156,1672657983,1827
10652,3516867729,3904846341,1672585953,1672586551,598
9992,3792075871,3360949039,1672573893,1672576519,2626
11395,3514508773,3533777032,1672615234,1672615405,171
9965,3244397548,3339649817,1672679001,1672680600,1599
11301,3222364320,3499142934,1672562204,1672564701,2497
10043,3669418238,3235373942,1672572843,1672573366,523
10206,3756695502,3534168768,1672701632,1672703676,2044
11566,3772980989,3316406470,1672601926,1672605093,3167
9841,3517227599,3533037906,1672575312,1672576500,1188
11344,3893043842,3915460293,1672622330,1672625511,3181
9813,3520049965,3511671476,1672632150,1672633148,998
11749,3822315407,3500688476,1672611113,1672614119,3006
11188,3381254180,3236254381,1672585837,1672588874,3037
11322,3534531061,3770966950,1672645436,1672648475,3039
11388,3445733121,3398489033,1672532720,1672533402,682
10280,3345902033,3505816624,1672604229,1672607326,3097
10809,3452090950,3447591143,1672686050,1672688593,2543
10588,3406492167,3806471413,1672541623,1672543764,2141
11717,3756736726,3924205112,1672566745,1672567090,345
10112,3482786946,3778838936,1672531285,1672533625,2340
11788,3516588277,3977337501,1672693645,1672695571,1926
9884,3422081502,3772683155,1672684681,1672686367,1686
9917,3292936094,3552444228,1672591921,1672594105,2184
10142,3609644043,3475845921,1672617547,1672620205,2658
10841,3623113240,3711258452,1672543195,1672543373,178
11785,3916924978,3825526565,1672623945,1672625832,1887
10912,3772425253,3780786276,1672559917,1672561857,1940
10109,3206241691,3495152069,1672597233,1672599925,2692
11107,3379666159,3505155858,1672651474,1672652750,1276
10764,3518408734,3450511428,1672610434,1672613315,2881
10044,3500833053,3757773786,1672652371,1672655192,2821
10109,3885339157,3287920864,1672535737,1672537912,2175
11418,3974264211,3779609338,1672632548,1672634615,2067
10271,3701291994,3793899166,1672558022,1672558311,289
11105,3617771673,3927202773,1672638784,1672641260,2476
11068,3486509752,3501126057,1672641867,1672644494,2627
10614,3516444589,3304030474,1672563379,1672566942,3563
9963,3682802569,3906075386,1672601463,1672602234,771
10853,3773579644,3791351852,1672539391,1672540873,1482
10451,3915460293,3778738044,1672575704,1672576409,705
10474,3735422623,3683514731,1672540772,1672543298,2526
9870,3390444181,3399734748,1672598058,1672601061,3003
10948,3239082508,3311260898,1672690036,1672692721,2685
11370,3823600319,3634766042,1672571594,1672574111,2517
11469,3713139039,3505786561,1672588106,1672591240,3134
11191,3858429342,3557324887,1672660779,1672664373,3594
10747,3514685272,3757660578,1672620446,1672623920,3474
10213,3608973523,3513508737,1672626260,1672626349,89
10434,3342495377,3710680073,1672553567,1672555589,2022
11474,3783935976,3220987526,1672699338,1672699746,408
11760,3533593766,3777439655,1672564806,1672566211,1405
11106,3338465050,3834456158,1672586300,1672589870,3570
11048,3716976932,3447948483,1672553965,1672557456,3491
10437,3774273260,3402774497,1672632972,1672634480,1508
10110,3701887470,3893950585,1672671632,1672671759,127
10349,3733423371,3516257130,1672614964,1672617707,2743
11595,3711243126,3397330170,1672536521,1672540065,3544
9861,3423353911,3776468503,1672575417,1672575599,182
10319,3828354855,3779454060,1672616748,1672616927,179
11552,3505887814,3519167605,1672696576,1672698921,2345
10206,3505853594,3893950585,1672582353,1672583910,1557
11070,3777112124,3480418192,1672572262,1672572496,234
11598,3342545285,3756079870,1672597963,1672600646,2683
11111,3811354125,3500591274,1672588808,1672590083,1275
11378,3701675183,3780563627,1672622257,1672625185,2928
9928,3971422524,3428325402,1672681240,1672682670,1430
11170,3515838621,3510694464,1672616285,1672617406,1121
11717,3778932673,3925835590,1672600911,1672601829,918
10555,3231859576,3378172464,1672658148,1672660189,2041
11670,3234445133,3602401154,1672682725,1672684975,2250
10539,3533077580,3500799617,1672655716,1672657582,1866
10414,3772877723,3756675909,1672552184,1672552946,762
10589,3711171132,3271719569,1672589605,1672589867,262
10470,3855222429,3832902787,1672584225,1672587227,3002
10105,3203630241,3791581138,1672652164,1672653090,926
11505,3278443807,3927763819,1672557651,1672559306,1655
11582,3500674240,3792797648,1672675977,1672678282,2305
11363,3778713526,3356972733,1672661117,1672663139,2022
10293,3701374160,3888642876,1672636974,1672640053,3079
10130,3738547113,3477511446,1672586251,1672587395,1144
10822,3931495845,3770180844,1672580480,1672580734,254
10507,3514353133,3783594729,1672593108,1672596601,3493
10808,3225554956,3732533330,1672533294,1672533983,689
10530,3533593766,3913847876,1672604958,1672607419,2461
10575,3777909822,3711349327,1672609404,1672612563,3159
11753,3496407500,3382746533,1672612847,1672615801,2954
10083,3770941125,3619494735,1672613426,1672615530,2104
11135,3510856388,3778382224,1672658113,1672659338,1225
10473,3793926338,3519351747,1672538601,1672540183,1582
9871,3477511446,3304661369,1672596920,1672600516,3596
10539,3711591464,3755129708,1672612338,1672612454,116
10799,3715008501,3773840321,1672686049,1672687064,1015
11070,3755342153,3774029494,1672629460,1672632016,2556
10810,3978254945,3500544306,1672642099,1672643292,1193
11017,3755630085,3818570577,1672552645,1672555445,2800
10224,3926724515,3776304080,1672547942,1672549795,1853
10260,3975796415,3831981073,1672638784,1672641428,2644
10115,3778370462,3856699097,1672685463,1672688086,2623
11643,3776001441,3820280594,1672667498,1672667931,433
9852,3534168768,3780298499,1672539225,1672539521,296
10715,3462153833,3500209015,1672583932,1672585743,1811
11014,3716178116,3713107380,1672569417,1672572571,3154
10185,3510373076,3550206045,1672663551,1672666345,2794
10372,3772893815,3600171014,1672566447,1672569457,3010
10164,3783430498,3516588277,1672650552,1672650856,304
10119,3773579644,3667950469,1672643038,1672646329,3291
10953,3515558215,3666958814,1672690501,1672692669,2168
9846,3472272792,3422915648,1672546122,1672547470,1348
10574,3311177439,3511311554,1672583458,1672584970,1512
10520,3519848902,3518478484,1672572744,1672574178,1434
11292,3357496255,3304235700,1672703426,1672706067,2641
10043,3343767438,3519297683,1672641784,1672643821,2037
9949,3897003751,3514007122,1672645488,1672646405,917
10079,3287689454,3225554956,1672654418,1672656397,1979
10233,3293540333,3342235058,1672674106,1672674880,774
10256,3500589560,3703351452,1672636022,1672636748,726
11402,3337903727,3411626917,1672584808,1672585026,218
10423,3939882169,3500814753,1672558231,1672561418,3187
10335,3514628916,3228575883,1672666953,1672669725,2772
10095,3773848111,3832312129,1672659843,1672660247,404
10502,3505839395,3777552831,1672653440,1672656049,2609
11220,3818324410,3476144563,1672552665,1672553505,840
10940,3511198566,3776583229,1672550254,1672550466,212
10140,3907923381,3924205112,1672634716,1672635513,797
10692,3513384042,3774506868,1672625155,1672628650,3495
10216,3854390432,3624164232,1672666018,1672666291,273
10942,3755378125,3773394570,1672632492,1672635631,3139
9859,3898965585,3352044245,1672555512,1672558415,2903
11342,3471131277,3780956975,1672571683,1672573406,1723
10909,3512726649,3500317923,1672638047,1672639359,1312
10709,3446066492,3714142299,1672583163,1672583383,220
10008,3716460706,3399943757,1672699945,1672700010,65
10441,3380418745,3499820963,1672683094,1672685822,2728
10225,3357074700,3482519872,1672640156,1672642826,2670
10397,3977880564,3453464785,1672634376,1672635321,945
10862,3500591274,3509208005,1672579029,1672581348,2319
10461,3755369666,3487622510,1672641280,1672644066,2786
10893,3977360666,3793364952,1672570107,1672570205,98
10398,3511286390,3519108639,1672674687,1672677073,2386
10498,3236360179,3710622746,1672615121,1672617423,2302
11432,3312651192,3411626917,1672594363,1672594930,567
11453,3792440162,3491104534,1672701419,1672704816,3397
10519,3773848111,3513508737,1672638410,1672639497,1087
10895,3890813040,3533009565,1672585229,1672586035,806
10006,3778824229,3517960157,1672589779,1672590535,756
9804,3602570831,3513250976,1672677427,1672679483,2056
10026,3621591266,3343616490,1672605137,1672606588,1451
10310,3501253130,3453464785,1672610971,1672611172,201
10050,3739297004,3509651954,1672597532,1672601041,3509
9857,3714595459,3519341916,1672673410,1672675987,2577
11401,3272827860,3551972633,1672681763,1672684364,2601
10146,3450621820,3512641538,1672661233,1672663430,2197
9795,3757584114,3760679372,1672648784,1672648917,133
10753,3621439107,3624164232,1672551256,1672552509,1253
10679,3701925712,3492056330,1672562895,1672564120,1225
11194,3519356606,3520160414,1672542341,1672543789,1448
11127,3517380144,3440305508,1672677136,1672677398,262
11223,3812677669,3755154460,1672538726,1672541968,3242
10797,3639503148,3922153821,1672633357,1672636512,3155
9835,3760232135,3534624672,1672697096,1672699694,2598
10085,3429409539,3736036532,1672640276,1672641324,1048
11017,3731905251,3936486724,1672556713,1672559694,2981
10110,3735152111,3711854614,1672569236,1672569508,272
10426,3793783685,3815184540,1672611789,1672614968,3179
10877,3783313202,3791644831,1672554268,1672555546,1278
11491,3450342110,3778695017,1672655268,1672655638,370
9856,3509167758,3713805968,1672629454,1672629840,386
11004,3774606418,3779503296,1672575544,1672577949,2405
11325,3511286390,3516777819,1672580960,1672582196,1236
11136,3716733618,3713224986,1672629053,1672631758,2705
10648,3773411968,3713547793,1672679726,1672681791,2065
10497,3533822490,3617771673,1672570509,1672573413,2904
10125,3791206902,3272328752,1672676403,1672677306,903
10991,3311133296,3713767153,1672619315,1672621112,1797
11776,3505129296,3755218683,1672549448,1672550630,1182
11589,3923524564,3625400710,1672581940,1672584160,2220
11710,3636877469,3822634862,1672597243,1672598663,1420
10327,3914926436,3505190512,1672661793,1672663516,1723
10452,3770273966,3825082811,1672641329,1672642471,1142
10565,3354015456,3334824744,1672565518,1672569004,3486
10571,3500442370,3505266343,1672643465,1672646773,3308
11186,3611570003,3500018566,1672610847,1672613503,2656
10397,3511382748,3249614888,1672654994,1672658459,3465
9985,3773899531,3609997804,1672624927,1672627202,2275
10694,3776534957,3468343480,1672693333,1672696546,3213
10621,3701291994,3730935770,1672681874,1672682274,400
10149,3231963246,3312800145,1672684033,1672686953,2920
11109,3683514731,3505709407,1672536719,1672538589,1870
11447,3498803823,3828354855,1672582785,1672584220,1435
10016,3505155858,3817120976,1672532536,1672534491,1955
10905,3773770134,3347520239,1672606260,1672609193,2933
11393,3514576083,3885674996,1672656717,1672659740,3023
9859,3910020031,3919349138,1672586961,1672587032,71
10811,3440743218,3510894809,1672676476,1672677197,721
10221,3515378306,3513171472,1672601767,1672603376,1609
10309,3780423516,3773770134,1672694732,1672697078,2346
10957,3201656220,3380444321,1672675589,1672676456,867
10825,3300238532,3459163055,1672588811,1672591997,3186
11653,3760748418,3516815069,1672534277,1672534706,429
11322,3510919509,3500654356,1672550979,1672554316,3337
10315,3534081527,3922153821,1672618578,1672619629,1051
10760,3757623259,3791382196,1672590829,1672594408,3579
11080,3520860199,3716976932,1672668357,1672670112,1755
9853,3834311054,3557528150,1672608562,1672609106,544
10830,3633294415,3857389270,1672673674,1672675015,1341
10245,3278251248,3710585241,1672573286,1672576102,2816
11134,3511907179,3897500723,1672701909,1672704902,2993
10645,3520273299,3792824886,1672692092,1672695048,2956
11374,3757501067,3482786946,1672550679,1672551979,1300
11084,3634766042,3495482863,1672588215,1672589396,1181
11305,3622458047,3513545735,1672629294,1672631527,2233
10709,3661543201,3624307518,1672550898,1672552467,1569
11316,3519951586,3902300755,1672546492,1672548097,1605
10214,3510486220,3362127525,1672698316,1672700217,1901
10401,3666367524,3859191694,1672610478,1672613112,2634
11584,3835262447,3905358065,1672608459,1672611025,2566
11247,3773083407,3937854073,1672553221,1672556336,3115
10223,3633860380,3756157377,1672690771,1672690927,156
10691,3461931154,3241567995,1672693556,1672695222,1666
10535,3453164933,3319660530,1672570319,1672570831,512
11729,3978254945,3894328297,1672609139,1672611719,2580
11597,3534362749,3760420315,1672664923,1672667676,2753
9966,3405221863,3777909822,1672554961,1672555208,247
11310,3778819352,3311810583,1672687896,1672689925,2029
11232,3501980730,3450735824,1672654330,1672656502,2172
10559,3301449986,3428878402,1672659873,1672663139,3266
10296,3501873139,3703476890,1672695364,1672695569,205
11151,3477248170,3611832288,1672700319,1672703203,2884
10487,3620836520,3793934396,1672565781,1672567586,1805
10836,3505097206,3760776967,1672605616,1672606535,919
10481,3772845364,3515974881,1672618080,1672618842,762
11411,3924366353,3772844451,1672703973,1672704037,64
10013,3440770466,3732467455,1672623595,1672626862,3267
11185,3819315404,3478206139,1672650072,1672653480,3408
10133,3440743218,3776732532,1672553820,1672555913,2093
10574,3533017131,3294949958,1672667882,1672670169,2287
10759,3909220912,3235074007,1672537653,1672541167,3514
10821,3826315540,3909632424,1672592657,1672595650,2993
11149,3802101760,3341738186,1672655126,1672658601,3475
9858,3476144563,3389069291,1672567095,1672568075,980
11618,3335974305,3756761603,1672640688,1672643428,2740
9963,3415840750,3778273230,1672679358,1672680681,1323
11212,3474074188,3453519360,1672585522,1672588048,2526
9837,3854229296,3630802959,1672599323,1672601110,1787
10400,3756066765,3939422411,1672616187,1672618859,2672
11007,3395082458,3229621693,1672698787,1672701436,2649
11521,3397330170,3500096103,1672694815,1672695131,316
10622,3421674406,3417268745,1672585331,1672587965,2634
9988,3474852115,3472561941,1672620336,1672622763,2427
11311,3331471764,3439662051,1672540687,1672542265,1578
10179,3730169449,3757050615,1672610550,1672614124,3574
11164,3900540310,3422314045,1672625573,1672626894,1321
11590,3394357241,3278071998,1672628605,1672631242,2637
11652,3757311529,3454924050,1672703882,1672704364,482
10274,3499998389,3533830748,1672541091,1672544192,3101
10670,3505496725,3971289056,1672699310,1672700920,1610
10407,3756168814,3452175941,1672576153,1672577370,1217
9976,3480270940,3307454562,1672649830,1672649941,111
11694,3208894215,3445355677,1672567575,1672570523,2948
10022,3228218081,3512337054,1672636282,1672639284,3002
11287,3892487982,3730935770,1672633664,1672635411,1747
11331,3900793652,3374147279,1672552883,1672553532,649
10236,3302988745,3791206902,1672701605,1672703398,1793
11245,3445733121,3442462115,1672601031,1672601967,936
9871,3479910993,3533201269,1672558458,1672559544,1086
9938,3832745283,3398489033,1672648942,1672650319,1377
11432,3885545415,3309415277,1672634725,1672635180,455
11567,3826542169,3347520239,1672623365,1672626961,3596
11247,3249771731,3715858201,1672532972,1672533535,563
10657,3500062408,3793442891,1672668174,1672668483,309
11451,3432466467,3450164574,1672594904,1672597460,2556
11600,3429333292,3340897079,1672699447,1672702876,3429
11085,3738132114,3715750580,1672541062,1672543225,2163
11636,3780982229,3511245705,1672579335,1672580750,1415
11597,3755361692,3476144563,1672675797,1672677014,1217
9866,3343511947,3341985886,1672651863,1672652782,919
11459,3811351746,3379400553,1672689858,1672690926,1068
10894,3979115924,3713514933,1672674862,1672676204,1342
10738,3290060215,3520506192,1672609949,1672612393,2444
10989,3243763209,3293673220,1672542650,1672543479,829
10676,3233993993,3735422623,1672613456,1672616819,3363
11013,3735679000,3416079461,1672637938,1672639909,1971
10439,3311739926,3345028045,1672544042,1672544761,719
10562,3403177609,3755342153,1672660647,1672662337,1690
10062,3772966919,3757823215,1672615512,1672617612,2100
11175,3772227820,3501261089,1672577245,1672577484,239
10973,3515706117,3519046342,1672702304,1672705028,2724
9928,3779609338,3514541800,1672643479,1672646437,2958
11415,3349319959,3714101349,1672590808,1672591925,1117
11149,3772216305,3793081195,1672690190,1672691098,908
10436,3627377299,3755584983,1672662338,1672662839,501
11606,3491390365,3852310652,1672617334,1672617519,185
10133,3511963020,3519319233,1672554593,1672554732,139
11128,3977615973,3229890340,1672664926,1672665184,258
10184,3772282008,3519937708,1672550233,1672553088,2855
10746,3932566114,3500630465,1672678243,1672679238,995
11328,3294164983,3224824355,1672552107,1672553142,1035
10194,3836586875,3505248368,1672667543,1672669656,2113
10671,3510262025,3773878451,1672562681,1672566006,3325
10992,3832289185,3371759044,1672580033,1672583300,3267
10976,3615846003,3533859712,1672550701,1672551730,1029
10637,3500674240,3716922925,1672627882,1672629076,1194
11215,3773899531,3780224882,1672547237,1672549414,2177
10369,3500444748,3459951739,1672634334,1672635852,1518
9801,3370448531,3913746581,1672645822,1672648643,2821
11285,3716676869,3755942724,1672679797,1672680970,1173
10572,3519228207,3344710271,1672645802,1672647037,1235
11514,3206241691,3938021614,1672553971,1672555191,1220
10748,3893629892,3780786276,1672635903,1672638469,2566
11032,3418683594,3369482983,1672677253,1672677538,285
11212,3716423829,3512343029,1672566068,1672569239,3171
11034,3714281795,3756328353,1672605519,1672608765,3246
10044,3408408584,3713416106,1672664516,1672666965,2449
10022,3912625932,3713100169,1672560247,1672561292,1045
10344,3716976932,3228575883,1672625213,1672627845,2632
10897,3487395357,3476958001,1672549350,1672552088,2738
10938,3510159441,3311197635,1672565506,1672567728,2222
10158,3711938229,3772291207,1672540836,1672543249,2413
10399,3858429342,3928508375,1672644261,1672646805,2544
10395,3701004302,3520725149,1672697834,1672701308,3474
10401,3887382548,3938129916,1672629056,1672630671,1615
11784,3774706478,3509360869,1672663616,1672664849,1233
10301,3343193067,3454343398,1672646795,1672647224,429
10993,3514033319,3367299721,1672550440,1672553641,3201
10088,3710271021,3783826338,1672563851,1672565791,1940
10724,3513171472,3363549860,1672545284,1672547588,2304
11422,3621960662,3777655401,1672690929,1672691623,694
11118,3713373455,3893629892,1672668395,1672669813,1418
10579,3804075198,3703896751,1672581244,1672581972,728
9903,3407403080,3442181067,1672686130,1672687590,1460
10910,3609644043,3468201976,1672620080,1672622228,2148
11360,3516827471,3452878062,1672668127,1672670961,2834
9959,3408982612,3373135211,1672654617,1672655540,923
10058,3757128722,3703474558,1672666328,1672667598,1270
10411,3534459983,3517718901,1672644997,1672648560,3563
10855,3403988682,3713476192,1672611660,1672614657,2997
11327,3780900318,3348100657,1672673110,1672676015,2905
9883,3519341916,3770480149,1672674396,1672675177,781
10057,3600441934,3757678397,1672683393,1672685035,1642
10756,3516497645,3662495290,1672571131,1672571977,846
11554,3515984911,3972847837,1672651112,1672653250,2138
10220,3511198566,3447253775,1672701579,1672702877,1298
11759,3309651238,3516651799,1672540050,1672540327,277
11355,3809207482,3713767153,1672580389,1672582126,1737
9877,3469370398,3437934509,1672651368,1672653149,1781
10028,3343193067,3760382349,1672660959,1672661669,710
10521,3445355677,3760854788,1672554731,1672558329,3598
11526,3311449914,3738429905,1672681984,1672684088,2104
9816,3282053097,3510209505,1672669303,1672672268,2965
11487,3286938590,3757199889,1672593647,1672595339,1692
9969,3533225084,3390444181,1672700570,1672704156,3586
10884,3710296607,3623894390,1672581103,1672582851,1748
11645,3477248170,3429409539,1672546336,1672548568,2232
10528,3913746581,3711171132,1672621319,1672623991,2672
11744,3977209952,3713444403,1672650380,1672651567,1187
10751,3519448648,3730115019,1672666141,1672666238,97
11440,3415803494,3519059808,1672605202,1672607141,1939
10540,3501356814,3271762055,1672621945,1672622884,939
11055,3662522808,3600871715,1672601392,1672603278,1886
11621,3669140241,3730348493,1672627658,1672629602,1944
10186,3559759778,3637566026,1672602505,1672602607,102
11124,3505097206,3273674596,1672585983,1672587208,1225
11505,3434581257,3685877449,1672666056,1672667833,1777
11651,3625779003,3515706117,1672655547,1672658215,2668
10237,3710622746,3446537819,1672535907,1672538785,2878
11241,3703031637,3779382417,1672655187,1672656088,901
10086,3711945923,3509996827,1672609882,1672612305,2423
10983,3792682835,3247075753,1672610246,1672612141,1895
10317,3701519251,3451757423,1672587379,1672589289,1910
11052,3716195780,3360837082,1672611181,1672612494,1313
11037,3625952981,3714951681,1672620845,1672622191,1346
10152,3793822639,3364302157,1672645745,1672646588,843
11210,3713740434,3437023385,1672639195,1672640405,1210
10262,3899205452,3446810761,1672642661,1672645119,2458
10852,3776407517,3772569860,1672536639,1672539183,2544
10820,3510373076,3207586072,1672671040,1672673270,2230
10950,3682086200,3505037247,1672696228,1672699093,2865
10907,3518376262,3501583486,1672612207,1672612897,690
10216,3711959141,3826542169,1672688135,1672689429,1294
10138,3755670258,3505709407,1672559026,1672561101,2075
10752,3512101369,3820200446,1672619874,1672622527,2653
10957,3804075198,3518058151,1672633395,1672636941,3546
10122,3756413374,3403218814,1672538372,1672541154,2782
10563,3714903456,3273674596,1672600692,1672601952,1260
11768,3408111327,3287734830,1672611194,1672612366,1172
11313,3920526713,3755507566,1672543680,1672546504,2824
11309,3780941637,3274739459,1672678452,1672681893,3441
10815,3517558635,3342368576,1672681085,1672683861,2776
11002,3780612543,3509274030,1672628134,1672630676,2542
11648,3791409441,3364948616,1672568382,1672571710,3328
9914,3710271021,3856897914,1672662658,1672663034,376
11204,3715724166,3780171640,1672679782,1672682135,2353
11577,3893043842,3517426473,1672571133,1672572791,1658
10664,3517136772,3619538249,1672603465,1672604205,740
11099,3511645260,3292936094,1672636550,1672638615,2065
11355,3778986795,3810949170,1672548076,1672550227,2151
11162,3458432407,3318590083,1672575599,1672579149,3550
9909,3938129916,3515974881,1672671043,1672673734,2691
10092,3370512945,3500640854,1672557333,1672560304,2971
11676,3778605154,3935444008,1672689449,1672691757,2308
11102,3440305508,3490008012,1672696341,1672699026,2685
11698,3780050146,3519724388,1672548423,1672551155,2732
11183,3915962248,3667814788,1672535008,1672535462,454
11575,3730414796,3603740088,1672539976,1672542120,2144
10770,3534988162,3930501172,1672617992,1672619284,1292
10212,3793874490,3780287649,1672685051,1672688282,3231
11651,3517992521,3492350318,1672661826,1672664197,2371
10444,3221126799,3613781977,1672605589,1672608126,2537
10178,3756890980,3519951586,1672631426,1672632205,779
11693,3313101243,3760854788,1672659158,1672659433,275
10686,3519167605,3931767736,1672645945,1672647265,1320
10251,3533777032,3732223664,1672566632,1672567654,1022
10129,3404395454,3757198930,1672685227,1672688184,2957
11145,3625931630,3777118499,1672598807,1672601388,2581
11161,3821103640,3660163550,1672677027,1672677284,257
9918,3710680073,3516651799,1672665588,1672666122,534
10023,3780142207,3733953055,1672580015,1672582000,1985
10708,3851877325,3885147558,1672665166,1672666670,1504
11512,3756948477,3444646562,1672694028,1672694945,917
10550,3554236075,3668855144,1672582842,1672585620,2778
10516,3514685272,3510373076,1672676915,1672677724,809
11702,3665478011,3777751979,1672658145,1672659724,1579
10174,3518205307,3436018575,1672589429,1672589797,368
10431,3516359146,3350966326,1672638681,1672640397,1716
11393,3639465750,3358262975,1672561801,1672563204,1403
11050,3880549316,3780956975,1672612629,1672616028,3399
10217,3773848111,3275171954,1672695407,1672696663,1256
10664,3779340538,3778731000,1672685745,1672689205,3460
10846,3382670400,3311959533,1672599701,1672602245,2544
11015,3385124073,3714281795,1672563897,1672563967,70
11180,3825082811,3519947298,1672579331,1672580037,706
11385,3280208630,3501574882,1672655284,1672658331,3047
11030,3335139032,3805926853,1672560518,1672563997,3479
10165,3509701363,3772425253,1672557036,1672560236,3200
10185,3773434690,3730414796,1672680909,1672681591,682
11318,3511744756,3804707712,1672673369,1672675026,1657
11151,3384170206,3317989975,1672639363,1672640077,714
11684,3904045870,3774304163,1672691115,1672693878,2763
10742,3354015456,3367242388,1672687680,1672689915,2235
11733,3755823805,3501550490,1672647508,1672647996,488
10416,3452677710,3294949958,1672656622,1672657275,653
10202,3304447950,3499622352,1672596731,1672597569,838
10342,3757198930,3776291254,1672655384,1672656913,1529
11350,3909822999,3359351267,1672571566,1672572563,997
11108,3312800145,3520155898,1672612835,1672616003,3168
10057,3396453219,3340321384,1672596383,1672597230,847
11085,3512495325,3893043842,1672675004,1672675261,257
9887,3772250554,3533628528,1672610028,1672612501,2473
9941,3505887814,3852461753,1672657409,1672659728,2319
11511,3500927619,3394364348,1672586449,1672588617,2168
10396,3399504157,3832902787,1672556908,1672559064,2156
11700,3307791650,3853783593,1672681832,1672683538,1706
10470,3413799143,3500720752,1672697370,1672697911,541
11100,3505490878,3666561358,1672676695,1672678419,1724
9880,3515681585,3360783381,1672537454,1672539592,2138
10975,3639081201,3907088952,1672585406,1672588340,2934
10280,3780786276,3713219299,1672608987,1672610617,1630
9830,3533427742,3500863429,1672542306,1672545079,2773
10444,3520925688,3757592622,1672536249,1672537510,1261
11335,3245501577,3772291207,1672600604,1672603546,2942
10315,3533642281,3389367628,1672539509,1672542552,3043
10853,3362368123,3793987483,1672668684,1672671518,2834
10327,3778986795,3730935770,1672562045,1672565093,3048
10242,3500051606,3398075553,1672616889,1672617293,404
11374,3772343750,3701284535,1672673980,1672675814,1834
11185,3716160006,3757050615,1672693361,1672696651,3290
10576,3407734098,3882905311,1672702732,1672705671,2939
11544,3630462406,3493515706,1672670635,1672670724,89
11783,3888642876,3348100657,1672649967,1672652227,2260
11254,3805616707,3519341916,1672620235,1672620348,113
10034,3500776597,3832902787,1672592029,1672594325,2296
10838,3857389270,3445896667,1672579519,1672580615,1096
10937,3971422524,3703462221,1672538916,1672539426,510
10651,3515715968,3791269060,1672543090,1672546162,3072
10380,3341311972,3415032547,1672552574,1672555127,2553
10836,3755075988,3510206323,1672549760,1672549891,131
10883,3490008012,3779212271,1672682166,1672685676,3510
10834,3613216900,3791194984,1672631611,1672633917,2306
9832,3934991640,3487779363,1672687789,1672688042,253
10863,3519351747,3516706935,1672605302,1672607944,2642
11259,3438470128,3909822999,1672555504,1672559096,3592
10904,3637566026,3791205793,1672538816,1672542253,3437
11082,3638035545,3755369666,1672557358,1672557542,184
9833,3511095300,3363549860,1672563865,1672567261,3396
9995,3933106901,3773738817,1672586666,1672589223,2557
10957,3402774497,3773603836,1672559958,1672562685,2727
11553,3520763492,3604908372,1672663676,1672663896,220
10510,3428788958,3239990061,1672633454,1672636721,3267
10984,3236254381,3229465607,1672573210,1672574404,1194
9893,3613216900,3488749569,1672642425,1672642905,480
11765,3716371766,3834980281,1672570934,1672572194,1260
11576,3534068874,3513802404,1672697331,1672698042,711
11238,3351837521,3518478484,1672601929,1672604593,2664
11448,3271780525,3615846003,1672665993,1672668121,2128
11122,3515838621,3685877449,1672618036,1672619464,1428
9964,3633622298,3933469838,1672614625,1672616180,1555
11426,3837435907,3429409539,1672703453,1672707003,3550
11625,3817038422,3519108639,1672671281,1672672125,844
10964,3828568868,3979366845,1672612267,1672615253,2986
9821,3621812406,3516019206,1672596177,1672598067,1890
10174,3662794240,3440743218,1672584330,1672586522,2192
10709,3713547793,3517144269,1672536790,1672538096,1306
10630,3203909360,3770457058,1672651021,1672653717,2696
10474,3921736061,3505148522,1672658652,1672659166,514
10546,3622458047,3205324639,1672652272,1672654683,2411
10276,3713805968,3229890340,1672657110,1672660563,3453
11703,3397972945,3755394177,1672640572,1672643371,2799
11128,3520553959,3738103378,1672645669,1672646778,1109
11006,3757089924,3346755179,1672683637,1672684956,1319
11518,3780213684,3436018575,1672625817,1672627758,1941
11178,3315432466,3514980025,1672663366,1672664182,816
10001,3298831109,3514761434,1672661433,1672664123,2690
10000,3770180844,3513816744,1672646979,1672648459,1480
10384,3246971044,3461877104,1672581099,1672582375,1276
11329,3439532406,3335139032,1672703792,1672706080,2288
10301,3614944981,3783408469,1672664047,1672665828,1781
11518,3880030249,3468066881,1672631461,1672632419,958
10940,3501550490,3501574882,1672609910,1672612797,2887
9859,3898592058,3811351746,1672686185,1672687142,957
10354,3511466117,3520057139,1672567248,1672570392,3144
11155,3512819376,3933872044,1672675718,1672678523,2805
10567,3833993674,3780206849,1672679009,1672681357,2348
11273,3516321993,3396440259,1672583190,1672586475,3285
10753,3713611960,3355430975,1672674749,1672675143,394
10198,3711591464,3755502373,1672616616,1672618689,2073
10306,3922430928,3341432459,1672549514,1672550564,1050
11014,3896200048,3509370016,1672619516,1672621879,2363
10421,3284334297,3770595035,1672665233,1672665417,184
11658,3428198021,3500329674,1672663472,1672666686,3214
10037,3755229631,3934980229,1672628738,1672631618,2880
10253,3206853747,3534988162,1672577315,1672577819,504
11339,3793274957,3358434853,1672690266,1672692536,2270
10765,3669475165,3461877104,1672620013,1672621862,1849
11064,3732467455,3496352027,1672703169,1672705049,1880
10608,3233993993,3533265491,1672695901,1672698256,2355
11637,3423782420,3515655024,1672701462,1672701741,279
10966,3716541851,3613547091,1672602882,1672604008,1126
10987,3459951739,3703749690,1672663636,1672666761,3125
11725,3907390925,3756157377,1672620898,1672622490,1592
9837,3235313062,3500591274,1672692946,1672695746,2800
9957,3703614781,3518408734,1672545712,1672546450,738
11093,3513384042,3701512498,1672588318,1672589766,1448
10810,3499343927,3832333115,1672539985,1672542906,2921
11428,3703048107,3500329674,1672598662,1672601325,2663
11489,3688410383,3783563043,1672555959,1672556518,559
9802,3422314045,3756328353,1672555433,1672558927,3494
9970,3509562377,3806720019,1672695650,1672696982,1332
11666,3713283029,3487278983,1672643621,1672646944,3323
11496,3510869438,3516378356,1672651346,1672653243,1897
11492,3408828584,3735197034,1672629680,1672631468,1788
10852,3516932899,3393543588,1672616745,1672617368,623
11632,3510189563,3472018395,1672670673,1672671927,1254
10035,3533830748,3716197140,1672657602,1672659125,1523
10922,3379076106,3514673213,1672658105,1672658553,448
10836,3416225867,3701359045,1672652194,1672653873,1679
10478,3438818153,3852992961,1672536660,1672537204,544
11418,3437023385,3608214600,1672638829,1672638977,148
11511,3493598658,3209417223,1672622612,1672624687,2075
9822,3291153514,3714287902,1672595539,1672598272,2733
11535,3760997159,3462985379,1672692595,1672695456,2861
9988,3779468781,3340321384,1672596455,1672597582,1127
9975,3501628472,3770476738,1672533750,1672535268,1518
10901,3395069149,3855977674,1672689322,1672690832,1510
11199,3738160394,3902548260,1672691765,1672692027,262
9817,3665478011,3533642281,1672638853,1672641504,2651
10575,3779415433,3665841655,1672540849,1672543747,2898
11325,3394364348,3519712497,1672661489,1672663383,1894
11647,3701448521,3710149975,1672608724,1672611618,2894
11310,3505234868,3756536476,1672645225,1672647306,2081
10032,3482519872,3513996288,1672631066,1672631870,804
10813,3971422524,3500057674,1672661462,1672664778,3316
10125,3513486828,3379517265,1672696416,1672696757,341
11085,3710107905,3760710525,1672658272,1672659126,854
11739,3701685828,3514801709,1672688895,1672691783,2888
9824,3703611876,3393909269,1672614857,1672614958,101
11043,3602054754,3319660530,1672560020,1672562924,2904
11504,3703351452,3773475506,1672575474,1672576508,1034
11562,3501004005,3485898181,1672633480,1672634143,663
11182,3335055096,3512726649,1672672044,1672672874,830
9917,3774145748,3757050615,1672683359,1672684019,660
11036,3511640720,3241855333,1672580089,1672581235,1146
11618,3791532324,3494680853,1672687706,1672689688,1982
10609,3760554453,3310702648,1672556198,1672557320,1122
10366,3500821475,3311409212,1672538212,1672541505,3293
11057,3510486220,3391612879,1672592086,1672593890,1804
10966,3730935770,3351728355,1672543492,1672543565,73
10042,3287753579,3779415433,1672631438,1672632084,646
11461,3310961923,3519322066,1672625706,1672627293,1587
10575,3625931630,3285515107,1672674074,1672676427,2353
11004,3778817220,3688410383,1672640683,1672642646,1963
11039,3469350379,3313824913,1672664744,1672665494,750
10116,3913847876,3856316719,1672641318,1672644439,3121
11186,3701971784,3307236682,1672541116,1672542961,1845
10245,3616242727,3756328353,1672618543,1672622124,3581
10424,3281148858,3716423829,1672581466,1672582620,1154
10213,3314965818,3387621912,1672661644,1672662250,606
10623,3912811715,3770457058,1672682272,1672682899,627
9908,3231153513,3517766135,1672571689,1672574496,2807
10115,3520273299,3888642876,1672668017,1672670518,2501
10203,3714101349,3224040894,1672560080,1672560196,116
11598,3710529628,3853182912,1672638896,1672639276,380
10362,3510262025,3287734830,1672601199,1672604081,2882
9843,3778125688,3776187150,1672663800,1672664742,942
10376,3932566114,3220660616,1672684682,1672686785,2103
10018,3703659324,3660257653,1672669555,1672672486,2931
10481,3451757423,3716944983,1672617541,1672619931,2390
10189,3437108337,3240443426,1672621420,1672624110,2690
10498,3293553295,3351856699,1672669517,1672672087,2570
10891,3516167000,3701449715,1672546205,1672549210,3005
11061,3505291330,3318590083,1672594808,1672595754,946
10944,3509167758,3974400577,1672664070,1672664557,487
10252,3516249472,3361926328,1672656853,1672657195,342
11707,3399943757,3619538249,1672603471,1672606141,2670
10880,3713621169,3453164933,1672610874,1672613356,2482
10600,3514216460,3281970147,1672550447,1672551045,598
11744,3472561941,3783368855,1672628899,1672630124,1225
10367,3714902042,3452878062,1672666114,1672668311,2197
10050,3777405860,3703206956,1672561340,1672564405,3065
10245,3236512807,3515548696,1672547705,1672549777,2072
10922,3936486724,3534758256,1672533271,1672536075,2804
11386,3520779124,3711765138,1672702618,1672703278,660
11404,3515507526,3316551382,1672612855,1672615916,3061
10353,3514145752,3500234771,1672537039,1672538342,1303
11215,3817038422,3501853868,1672608392,1672611927,3535
10077,3533036499,3447938130,1672550676,1672551810,1134
10338,3793407883,3920155862,1672589846,1672592602,2756
11223,3887918622,3701065296,1672628978,1672629197,219
11774,3513143959,3714902042,1672697105,1672699982,2877
11198,3884394685,3514776568,1672625409,1672628042,2633
11421,3511864772,3783373085,1672564915,1672565868,953
11693,3779174993,3509457543,1672645622,1672647604,1982
10346,3780466967,3203954795,1672553863,1672556173,2310
11440,3221290808,3937747312,1672539020,1672541736,2716
11716,3756850160,3308744016,1672611304,1672613404,2100
9915,3780423516,3500931474,1672679882,1672683381,3499
10907,3447253775,3882851213,1672532170,1672533440,1270
9999,3284374600,3552444228,1672672428,1672675469,3041
10795,3505278562,3238056215,1672696811,1672698557,1746
11517,3500018566,3934280144,1672604128,1672604762,634
10031,3517530943,3774326754,1672663626,1672666422,2796
11267,3440671139,3776183353,1672611592,1672613141,1549
11377,3500473064,3534102440,1672570574,1672573453,2879
10168,3773738817,3935256825,1672549600,1672550169,569
10114,3479585868,3450164574,1672548899,1672551151,2252
11657,3514941815,3853783593,1672536624,1672539763,3139
10603,3783313202,3777135415,1672618300,1672620318,2018
10370,3777060250,3514761434,1672591084,1672591782,698
11605,3520553959,3501843187,1672583063,1672585824,2761
10345,3911376818,3772227820,1672622741,1672626233,3492
10898,3377446376,3302988745,1672663023,1672664779,1756
10140,3885339157,3715126587,1672554605,1672554847,242
10185,3519848902,3716633983,1672615375,1672618174,2799
10437,3493515706,3885645840,1672611017,1672613883,2866
11000,3437023385,3229890340,1672534201,1672534344,143
10019,3666958814,3612705426,1672550949,1672554473,3524
9802,3415228763,3450679913,1672651814,1672652532,718
10023,3911376818,3231271498,1672689020,1672692459,3439
9913,3755411110,3793899166,1672547681,1672549718,2037
11636,3792627762,3534937492,1672597911,1672601387,3476
10241,3311626308,3227919286,1672628192,1672630588,2396
11698,3337715675,3514455363,1672552784,1672554696,1912
11285,3438028077,3515507526,1672645902,1672648906,3004
11286,3770991234,3509379617,1672537406,1672540008,2602
11148,3774682234,3505709407,1672591760,1672593782,2022
11217,3776447604,3929923442,1672624494,1672627627,3133
11072,3774090455,3438818153,1672662263,1672663310,1047
10479,3613703906,3777686966,1672697749,1672698322,573
11544,3317887374,3779815753,1672673435,1672674536,1101
9950,3407403080,3772055279,1672697960,1672701498,3538
11442,3665431349,3505121295,1672543705,1672545528,1823
10137,3287683210,3311805161,1672644274,1672645945,1671
10596,3772909073,3776407517,1672655542,1672656179,637
11221,3516359146,3228465044,1672693423,1672694084,661
10902,3519059808,3228477490,1672553769,1672555986,2217
10024,3760382349,3501988762,1672678046,1672679319,1273
10774,3780171640,3227874229,1672654333,1672656882,2549
10467,3333355914,3908177413,1672625554,1672625743,189
10242,3689420679,3716891903,1672604091,1672605081,990
10245,3500079479,3912862842,1672690474,1672694071,3597
9943,3375324190,3668764192,1672546243,1672546745,502
11654,3834424604,3714268380,1672568421,1672571809,3388
10375,3284483177,3776125503,1672567857,1672570582,2725
10154,3505853594,3716740576,1672563316,1672565811,2495
10494,3776778306,3435652260,1672664984,1672666698,1714
11558,3938129916,3716609198,1672637968,1672639951,1983
11678,3505449070,3397527886,1672602250,1672603565,1315
10645,3792063616,3783095041,1672659862,1672660493,631
11214,3369558911,3284483177,1672562628,1672563109,481
11725,3399734748,3501927452,1672574620,1672577074,2454
11221,3714688409,3515548696,1672628067,1672631012,2945
11470,3515804844,3308965136,1672589237,1672589887,650
10672,3513215373,3517210356,1672646801,1672649040,2239
11032,3701529552,3520553959,1672607179,1672608592,1413
10031,3362385373,3666367524,1672565907,1672569281,3374
11534,3397330170,3505828210,1672597160,1672598502,1342
11247,3716118473,3716841469,1672654642,1672656871,2229
11594,3512343029,3774236212,1672548413,1672551184,2771
9955,3517149023,3501171785,1672701763,1672704333,2570
9794,3916656185,3711065081,1672663573,1672666510,2937
10785,3235074007,3756876537,1672653153,1672656631,3478
11523,3335353798,3783373085,1672673860,1672674908,1048
10041,3423940256,3511078598,1672555597,1672557336,1739
10400,3422081502,3469350379,1672550503,1672551889,1386
10213,3774195369,3239990061,1672677979,1672679430,1451
10926,3500674240,3760267158,1672620227,1672621788,1561
11464,3500093945,3518368900,1672617384,1672617476,92
10184,3756680289,3939422411,1672647070,1672648270,1200
11326,3293553295,3510153173,1672585543,1672589049,3506
10564,3783043770,3455907179,1672635162,1672636278,1116
10700,3387413950,3895839169,1672552998,1672554838,1840
10468,3318056480,3783043770,1672643919,1672646261,2342
11434,3509828883,3920116284,1672630042,1672630894,852
10710,3921736061,3441737317,1672684740,1672688127,3387
11271,3247193800,3780308809,1672685539,1672685731,192
11698,3517448452,3534589501,1672654223,1672656217,1994
10783,3274239253,3755192104,1672538152,1672540657,2505
11212,3512555384,3310737478,1672627284,1672629726,2442
11106,3285515107,3278779955,1672595511,1672597943,2432
10452,3520473111,3770564547,1672547442,1672550010,2568
11704,3783611957,3770630937,1672576100,1672576569,469
10933,3780612543,3778370462,1672540114,1672541851,1737
10888,3311739926,3447554599,1672606626,1672606836,210
10068,3534284132,3505359060,1672660784,1672662684,1900
11249,3299052917,3510291656,1672675145,1672678199,3054
11207,3710680073,3344778261,1672683785,1672685833,2048
9972,3772909073,3609644043,1672556464,1672559077,2613
10024,3294821709,3773738817,1672681758,1672683225,1467
10858,3773768643,3501980730,1672686968,1672688482,1514
10940,3711804184,3500799617,1672675705,1672678620,2915
11792,3829698950,3924366353,1672644321,1672646775,2454
10518,3355903597,3885545415,1672532605,1672535697,3092
10998,3358473096,3453164933,1672694793,1672697368,2575
10182,3780466967,3774221318,1672683146,1672684381,1235
11035,3476144563,3398151217,1672702724,1672706259,3535
11611,3776841808,3534426696,1672686275,1672689267,2992
10798,3429610195,3772708314,1672700017,1672702050,2033
10106,3235470567,3777932581,1672674286,1672676569,2283
11629,3776183353,3517797610,1672688193,1672688979,786
11550,3486824047,3399504157,1672581506,1672584937,3431
10549,3396472026,3972856326,1672549224,1672552787,3563
10456,3760901975,3461743188,1672591530,1672591895,365
11035,3689386663,3772112976,1672584576,1672585167,591
11335,3701028092,3443191792,1672535989,1672539431,3442
10085,3229890340,3505359060,1672582685,1672585628,2943
9887,3666958814,3333505404,1672698238,1672699267,1029
10023,3755922811,3978643889,1672656036,1672657616,1580
10862,3858330969,3208560443,1672603394,1672604108,714
10056,3905889514,3513850048,1672620503,1672621727,1224
10855,3773714494,3850904092,1672677592,1672680480,2888
11054,3890194669,3342031426,1672682954,1672683840,886
11744,3627431396,3482639402,1672570726,1672571872,1146
11040,3827889533,3425260097,1672608178,1672610562,2384
10061,3377883705,3774663639,1672657917,1672659695,1778
11274,3663353552,3403218814,1672701205,1672703392,2187
11639,3501171785,3858429342,1672665495,1672668461,2966
11459,3454151554,3511182297,1672680363,1672680813,450
11613,3777751979,3511750850,1672645272,1672646631,1359
10012,3513486828,3394394262,1672554988,1672558473,3485
10185,3927202773,3832002939,1672654468,1672657946,3478
11749,3316537706,3472173212,1672674086,1672676558,2472
10352,3826542169,3500120676,1672665025,1672668538,3513
10324,3783060739,3713283029,1672690421,1672691098,677
10163,3905358065,3615245840,1672560298,1672563296,2998
11575,3534174363,3773714494,1672563028,1672564778,1750
9980,3714065165,3701668745,1672539367,1672541324,1957
10615,3225554956,3318250647,1672656901,1672657011,110
10374,3519712497,3776968640,1672651022,1672653981,2959
11391,3364948616,3405303958,1672690508,1672692834,2326
10354,3337675386,3380444321,1672536427,1672539141,2714
10640,3533340292,3770780655,1672598655,1672602191,3536
10674,3313795594,3511671476,1672678047,1672679118,1071
10837,3509370016,3388537708,1672666803,1672669583,2780
10912,3710125627,3776455762,1672669686,1672671397,1711
10135,3398075553,3755107521,1672615075,1672617405,2330
11148,3396656251,3533037906,1672635478,1672637666,2188
11249,3662794240,3311414429,1672560189,1672562609,2420
11033,3515803462,3512480125,1672684949,1672686107,1158
11358,3372596013,3811503860,1672541217,1672544812,3595
10525,3732440502,3510680251,1672544138,1672545537,1399
11242,3515100211,3760648750,1672634726,1672636272,1546
11091,3229621693,3774326754,1672697996,1672699996,2000
9927,3738103378,3713840946,1672554531,1672558062,3531
10364,3715282492,3287920864,1672565876,1672566006,130
10669,3757869138,3201502111,1672559408,1672560865,1457
10618,3853783593,3600871715,1672573192,1672576322,3130
11130,3533642281,3481700413,1672580452,1672581445,993
9853,3716468783,3757713457,1672689258,1672689642,384
10853,3496352027,3519553933,1672607796,1672608257,461
10598,3500928990,3224053840,1672622245,1672624923,2678
11083,3703419800,3917905192,1672679555,1672680748,1193
11744,3733953055,3395610742,1672674468,1672677740,3272
11417,3533440736,3783679478,1672639507,1672640404,897
11455,3534102440,3931028233,1672570557,1672571137,580
11496,3893527651,3777932581,1672545079,1672546536,1457
10349,3927675706,3666958814,1672650745,1672652537,1792
11312,3777290300,3533154906,1672628747,1672629513,766
10582,3780563627,3711856534,1672689462,1672689883,421
11457,3632303304,3391612879,1672544145,1672544908,763
10176,3757150421,3434452046,1672604625,1672607431,2806
10206,3554437212,3689223632,1672691050,1672691197,147
10599,3482786946,3510750299,1672620258,1672623456,3198
10209,3777290300,3714424237,1672632964,1672634080,1116
11256,3703474558,3891586951,1672625414,1672627686,2272
11626,3396440259,3311432176,1672609783,1672611797,2014
10677,3512101369,3385481989,1672656148,1672659394,3246
10887,3304672737,3517469005,1672667372,1672670971,3599
10733,3311133296,3311305760,1672695163,1672696855,1692
11044,3755570137,3517358336,1672595233,1672596894,1661
10220,3533627473,3366164642,1672698678,1672699683,1005
9960,3714281210,3247193800,1672610034,1672611711,1677
10399,3624365837,3500793739,1672702190,1672703886,1696
10266,3772867078,3701893620,1672636708,1672637155,447
11698,3229615214,3239082508,1672648893,1672651927,3034
9839,3205687719,3423782420,1672617032,1672618626,1594
11020,3316537706,3733915784,1672624281,1672626932,2651
11079,3811629200,3309415277,1672636894,1672637446,552
11146,3510149298,3919984986,1672691744,1672694241,2497
10854,3417223898,3711770773,1672633088,1672633795,707
11140,3716994924,3716197140,1672615744,1672616315,571
11792,3437703650,3731644240,1672560198,1672562859,2661
11667,3514853709,3701887470,1672532528,1672535781,3253
10848,3229621693,3519255644,1672672889,1672674520,1631
11040,3519435459,3780423516,1672576218,1672579163,2945
11676,3603167427,3414841458,1672564522,1672566519,1997
10652,3517253559,3475033290,1672701774,1672704049,2275
10884,3429315500,3710852576,1672590975,1672591996,1021
10749,3733796228,3791332226,1672536691,1672537219,528
11549,3501126057,3773032706,1672570325,1672571011,686
10093,3516932899,3778382224,1672642559,1672645959,3400
11182,3774506868,3714951681,1672591707,1672594246,2539
10808,3435159896,3279102372,1672687724,1672689842,2118
11490,3476416072,3514508773,1672571402,1672572251,849
11039,3683047199,3856129522,1672685539,1672686218,679
9894,3778824229,3479910993,1672644134,1672645245,1111
10253,3517718901,3388774559,1672625084,1672626019,935
10226,3703206956,3622152515,1672688678,1672689205,527
10080,3902023467,3733796228,1672697068,1672700099,3031
11489,3500974385,3461630842,1672631542,1672634008,2466
9798,3801501384,3773895671,1672542628,1672544038,1410
9882,3805268739,3378534521,1672679713,1672680246,533
10252,3773424266,3777641081,1672613015,1672615831,2816
10365,3318250647,3760554453,1672560818,1672561288,470
11591,3780680252,3772164469,1672689124,1672689770,646
10339,3501992314,3892177203,1672639963,1672642480,2517
10696,3701004302,3824657614,1672637469,1672640262,2793
11544,3783277159,3714179543,1672645883,1672646854,971
10583,3513203127,3501988762,1672655121,1672657267,2146
10015,3519352855,3437108337,1672633382,1672635123,1741
10201,3791088014,3314965818,1672647903,1672651243,3340
11016,3688768189,3716233100,1672607688,1672607857,169
11168,3515304526,3774450494,1672569181,1672570271,1090
10226,3854390432,3462645981,1672673042,1672675123,2081
10349,3514926921,3838039092,1672701728,1672704657,2929
9806,3515706117,3512546783,1672558959,1672561120,2161
10419,3613940925,3918981936,1672539754,1672539951,197
11545,3664478769,3206377955,1672584954,1672585087,133
10542,3342027511,3935256825,1672561542,1672561929,387
11199,3757030923,3803473387,1672662354,1672662617,263
9933,3224053074,3736010012,1672696990,1672697195,205
10594,3713475356,3311521176,1672550752,1672552268,1516
10204,3505032773,3515304526,1672628361,1672630621,2260
10306,3770574826,3245501577,1672607215,1672610003,2788
10545,3368441333,3779665641,1672553314,1672553520,206
10323,3623113240,3447591143,1672695345,1672695906,561
10607,3500994763,3288346356,1672610827,1672614332,3505
10077,3370512945,3811419378,1672626881,1672629581,2700
10308,3387706541,3362385373,1672619391,1672621860,2469
11512,3311409212,3429315500,1672593800,1672596142,2342
11786,3235074007,3472272792,1672642979,1672645252,2273
10088,3778402454,3779169946,1672665592,1672668409,2817
11211,3755394177,3422915648,1672689490,1672692863,3373
9804,3449672240,3533976217,1672572983,1672576439,3456
10646,3303772923,3209417223,1672669495,1672669589,94
10806,3519357822,3774939922,1672644425,1672646384,1959
9994,3512087090,3299587876,1672650913,1672653220,2307
10055,3533841983,3505496725,1672538883,1672540840,1957
11190,3714116241,3770630937,1672609914,1672613080,3166
10345,3452389513,3774316305,1672567859,1672569955,2096
11258,3513624915,3311739926,1672537676,1672540487,2811
10776,3500922040,3520694387,1672544256,1672545322,1066
10176,3275735969,3520189871,1672627719,1672629222,1503
10896,3415032547,3714806574,1672534605,1672538083,3478
10152,3516472352,3478206139,1672690347,1672691157,810
10814,3792012147,3829358750,1672532298,1672533118,820
11579,3666561358,3398483531,1672641546,1672644741,3195
11597,3757796416,3475033290,1672696264,1672697701,1437
10502,3776166086,3780942505,1672567961,1672568146,185
10287,3436099135,3715750580,1672629813,1672632236,2423
10743,3505593034,3404461403,1672678272,1672679517,1245
10341,3756328353,3622654885,1672559422,1672562588,3166
10217,3509912164,3627377299,1672660931,1672661784,853
11377,3512871568,3773202954,1672609607,1672611945,2338
10632,3534168768,3500049870,1672659837,1672661577,1740
11062,3493515706,3519000878,1672628850,1672629567,717
9974,3773899531,3716841469,1672579936,1672581000,1064
11756,3756493561,3689223632,1672605345,1672606571,1226
10059,3770018912,3517136772,1672640610,1672642115,1505
11301,3667814788,3510680251,1672676425,1672677583,1158
11088,3756717136,3501515425,1672603752,1672604732,980
11103,3550405857,3710008760,1672644466,1672647130,2664
11093,3478915403,3465690527,1672650598,1672651274,676
11513,3716994924,3776407517,1672604883,1672606132,1249
11510,3777672363,3550206045,1672657397,1672658488,1091
10151,3773017746,3807800457,1672692869,1672695712,2843
11446,3776901443,3501980730,1672592843,1672594868,2025
11213,3500671218,3777932581,1672680891,1672680951,60
10235,3713102459,3501628472,1672648746,1672650229,1483
11211,3791072829,3392573386,1672633850,1672635708,1858
9832,3405221863,3760529327,1672702700,1672704940,2240
10769,3409514897,3485151614,1672585622,1672588677,3055
10057,3422915648,3779951373,1672595526,1672595812,286
11317,3615742989,3710271021,1672636392,1672638933,2541
10726,3511615015,3379076106,1672563814,1672565875,2061
11456,3513545735,3756761603,1672547224,1672548995,1771
11244,3505248368,3760096466,1672592335,1672595898,3563
9998,3311409212,3793274846,1672672351,1672673492,1141
11114,3925823748,3926724515,1672659358,1672660782,1424
11759,3713726267,3342056927,1672553385,1672555798,2413
10310,3505121295,3465690527,1672651203,1672653838,2635
10208,3470962222,3450679913,1672701236,1672701344,108
11203,3835262447,3919211457,1672693795,1672696622,2827
9981,3701265238,3715126587,1672541403,1672544224,2821
11450,3605078841,3514244308,1672565776,1672568788,3012
10528,3612042508,3313298164,1672541242,1672544094,2852
10764,3500927619,3972196462,1672615353,1672617617,2264
10093,3916656185,3501126057,1672701384,1672703332,1948
11039,3600699873,3812261241,1672574791,1672576936,2145
10540,3633860380,3701060732,1672665779,1672666120,341
11545,3936871734,3732467455,1672703397,1672705438,2041
11474,3634670780,3611939581,1672552410,1672553083,673
11742,3347205332,3505119470,1672543847,1672544839,992
10825,3714065165,3517469005,1672616358,1672618522,2164
10187,3304252969,3285322570,1672695340,1672697888,2548
10598,3513586642,3433196933,1672575279,1672575411,132
9901,3391612879,3442096275,1672549107,1672551349,2242
9922,3780298499,3317887374,1672570997,1672571477,480
11696,3227956115,3778402454,1672634510,1672634855,345
11350,3839417558,3501835995,1672540689,1672542452,1763
11735,3461630842,3479402555,1672610860,1672613509,2649
9864,3403988682,3899903158,1672639107,1672640635,1528
10945,3513894659,3378729459,1672532512,1672534431,1919
10716,3421524698,3783942518,1672596710,1672597721,1011
9929,3505155858,3206544535,1672584590,1672587625,3035
11661,3791574640,3500799617,1672660223,1672663441,3218
10336,3364948616,3687445224,1672690056,1672692223,2167
10395,3491104534,3776316903,1672681668,1672682834,1166
9797,3422460919,3701453343,1672688063,1672690150,2087
10972,3736885568,3682266017,1672652810,1672654777,1967
10342,3513213122,3493047640,1672668970,1672671232,2262
9805,3303432071,3793987483,1672610593,1672611861,1268
10976,3716179251,3898965585,1672561697,1672561810,113
9894,3755630085,3365519448,1672543353,1672545638,2285
10545,3853188285,3683562111,1672607363,1672609902,2539
9995,3773878451,3509274030,1672680931,1672684280,3349
11750,3925098136,3701978422,1672687196,1672688906,1710
10695,3500018566,3621591266,1672654405,1672655060,655
10574,3500630465,3382308738,1672665858,1672665949,91
11205,3517227599,3476431618,1672664558,1672666169,1611
10347,3777751979,3628556590,1672545889,1672548719,2830
10242,3772320856,3293157673,1672695867,1672698802,2935
11375,3780287649,3534328311,1672650041,1672650903,862
10460,3510826414,3500889287,1672642931,1672646391,3460
10969,3772882440,3380418745,1672616241,1672618348,2107
11451,3770476738,3368848936,1672615716,1672617683,1967
11162,3274341934,3620105539,1672614144,1672614893,749
10684,3814289471,3520824937,1672549951,1672551521,1570
11360,3773697080,3756897029,1672682794,1672684540,1746
10716,3311414429,3293553295,1672688063,1672688625,562
11209,3463729805,3756642173,1672578559,1672579610,1051
11325,3778838936,3475830203,1672541467,1672544476,3009
10524,3533037906,3908464960,1672640976,1672644033,3057
9920,3780482864,3882851213,1672608926,1672609403,477
9985,3934611532,3776319560,1672638431,1672640969,2538
10284,3716891903,3307535495,1672645500,1672646631,1131
11587,3756876537,3827981800,1672565131,1672566935,1804
10810,3755823805,3305093237,1672576489,1672576866,377
11398,3614944981,3246395239,1672635903,1672636000,97
11250,3499711458,3793920312,1672664527,1672665909,1382
11448,3288791629,3517195738,1672679760,1672680216,456
11299,3225371682,3534531039,1672646453,1672649089,2636
10181,3478052226,3711430738,1672661871,1672661966,95
11677,3515715968,3243763209,1672538175,1672540743,2568
11566,3505853594,3715284599,1672659754,1672660932,1178
11730,3500049870,3773475506,1672694684,1672695122,438
10158,3713927376,3444881567,1672585936,1672588319,2383
10941,3715291931,3480259863,1672571625,1672574749,3124
10807,3616242727,3515507526,1672656792,1672659596,2804
10792,3366433035,3417223898,1672608002,1672609044,1042
11575,3398483531,3427527462,1672560435,1672561436,1001
11234,3774359137,3505936495,1672572257,1672574962,2705
11288,3450679913,3330188769,1672552654,1672554064,1410
11518,3309528048,3505007498,1672540748,1672543241,2493
11494,3734233216,3732846295,1672619720,1672622045,2325
10585,3357026115,3817029483,1672613495,1672615489,1994
11699,3454554552,3440305508,1672575084,1672576743,1659
10846,3756328353,3885422379,1672584678,1672585198,520
11729,3432762943,3755209597,1672616035,1672618608,2573
10206,3490804766,3514297012,1672544955,1672547732,2777
10955,3776778306,3756876537,1672622017,1672625062,3045
11756,3669283586,3516429380,1672549433,1672551368,1935
11380,3500329674,3739075176,1672573878,1672576603,2725
10082,3757678397,3682266017,1672559519,1672559713,194
10921,3418382025,3975799349,1672560045,1672563387,3342
10229,3783430498,3885339157,1672556557,1672558598,2041
11336,3760346746,3428788958,1672651504,1672652450,946
9960,3366566029,3733870816,1672558653,1672558733,80
11567,3512101369,3791547827,1672538581,1672539361,780
11025,3715587520,3404375908,1672587740,1672591054,3314
10599,3716179251,3452677710,1672656540,1672659332,2792
11495,3739297004,3443041059,1672602644,1672604911,2267
11183,3776455762,3293898029,1672569338,1672569609,271
11055,3513764665,3500927619,1672697638,1672698591,953
10980,3510758718,3714718326,1672551357,1672554702,3345
11722,3400793223,3701540249,1672616117,1672618109,1992
10690,3774145748,3792785261,1672600940,1672602132,1192
9957,3514611187,3552261072,1672667852,1672668191,339
11439,3853783593,3243651036,1672533722,1672536111,2389
11445,3757584114,3791688526,1672604433,1672605594,1161
10091,3701725839,3907390925,1672596045,1672599266,3221
11128,3710695372,3517991042,1672536820,1672539136,2316
10748,3613828705,3312800145,1672626048,1672629045,2997
10000,3925208102,3770476738,1672694700,1672696608,1908
11171,3791121243,3711190257,1672674679,1672678049,3370
11689,3511458926,3512101369,1672700357,1672703674,3317
9895,3776187150,3313392810,1672584716,1672586499,1783
10481,3482786946,3290097447,1672567846,1672571227,3381
9976,3923910914,3780048608,1672665291,1672666787,1496
10677,3825234433,3358473096,1672642680,1672644462,1782
11788,3206217657,3886837151,1672594464,1672597708,3244
10800,3505531432,3342545285,1672581681,1672585002,3321
11215,3399943757,3426207439,1672541397,1672542005,608
11412,3350966326,3978254945,1672672011,1672674118,2107
10222,3534604516,3976225898,1672645655,1672647778,2123
11657,3895422995,3661856558,1672589435,1672590659,1224
10618,3779415433,3445406685,1672601264,1672601566,302
10216,3305656670,3880030249,1672659514,1672659574,60
11247,3518882056,3533974355,1672603597,1672604948,1351
11377,3429333292,3533325993,1672588800,1672589859,1059
10635,3516706121,3342426430,1672662357,1672662418,61
11058,3209925780,3347996015,1672627279,1672630741,3462
11093,3897851509,3885147558,1672607360,1672608001,641
11201,3516706121,3776447604,1672582868,1672583013,145
10352,3756668747,3203630241,1672666121,1672667595,1474
10782,3793274846,3403257752,1672596746,1672600130,3384
10316,3533009565,3757032266,1672670608,1672672524,1916
10138,3780941637,3511415786,1672597281,1672599887,2606
10727,3779454060,3510244209,1672573186,1672576703,3517
9999,3517380144,3711214982,1672601225,1672604584,3359
10762,3510240661,3760382349,1672585318,1672586695,1377
11580,3534491112,3353194923,1672560454,1672562302,1848
10476,3619676231,3639081201,1672703759,1672705018,1259
9802,3372596013,3482639402,1672684438,1672684714,276
10363,3701865589,3233712975,1672559040,1672562380,3340
10101,3231654754,3512133625,1672535658,1672537510,1852
10384,3231963246,3780733404,1672694706,1672696345,1639
9933,3710173412,3505684690,1672665478,1672666728,1250
11055,3500854711,3511311554,1672646354,1672648570,2216
10041,3478915403,3513777705,1672653202,1672656233,3031
11790,3938021614,3484490325,1672658219,1672660971,2752
11666,3716801088,3512802259,1672564415,1672566917,2502
11306,3638035545,3834424604,1672610312,1672613372,3060
9951,3783043346,3228477490,1672572832,1672575933,3101
11147,3601214648,3777439655,1672532460,1672532849,389
11791,3713606829,3779130507,1672540839,1672541324,485
11087,3420881591,3510826414,1672623641,1672625015,1374
10883,3230250213,3772262649,1672678505,1672678585,80
10597,3755378125,3486824047,1672563354,1672563450,96
10211,3791617239,3275751794,1672570080,1672572225,2145
10845,3710173412,3303747093,1672583571,1672586755,3184
11679,3519000878,3772867078,1672625171,1672625577,406
11011,3780576351,3558264627,1672545796,1672548247,2451
10989,3468201976,3779665641,1672534552,1672536800,2248
10531,3501554468,3791072829,1672598730,1672601769,3039
10592,3311472321,3793274957,1672593656,1672595152,1496
10802,3461931154,3559112196,1672653664,1672654205,541
11211,3660496328,3512288503,1672598247,1672600670,2423
10292,3513111053,3500591274,1672565566,1672565626,60
11456,3668202976,3976400190,1672701010,1672701741,731
10129,3505245692,3908550561,1672550027,1672551998,1971
10777,3516340010,3834643026,1672599520,1672602870,3350
11430,3221126799,3514508773,1672567092,1672569750,2658
10901,3714595459,3418791124,1672630344,1672633083,2739
10717,3774663639,3423353911,1672638018,1672640405,2387
10851,3519831322,3777063455,1672692285,1672692804,519
10500,3372079985,3792432763,1672588183,1672591278,3095
10517,3851877325,3223177147,1672661859,1672665232,3373
10654,3701540249,3456795601,1672564268,1672565723,1455
10521,3500442370,3716891903,1672560019,1672560249,230
11185,3513800589,3857909328,1672673012,1672673155,143
10404,3711947828,3285136057,1672644714,1672646454,1740
9796,3792597493,3791121243,1672578004,1672580799,2795
10608,3501734800,3770925016,1672556709,1672558820,2111
11334,3826418889,3777370992,1672655041,1672655164,123
10319,3711671702,3632094087,1672564657,1672566865,2208
11574,3236512807,3459951739,1672639546,1672641296,1750
10980,3477248170,3819024145,1672654069,1672657175,3106
10103,3857389270,3778124514,1672653178,1672654550,1372
11091,3624365837,3713858538,1672565929,1672566864,935
10633,3511003541,3834980281,1672569480,1672572174,2694
10251,3819315404,3387621912,1672658966,1672661802,2836
11574,3309178914,3937636109,1672652424,1672654387,1963
11537,3510638085,3514389188,1672579599,1672582018,2419
10657,3510240661,3511078598,1672630055,1672632822,2767
10384,3517797610,3715737742,1672608047,1672609297,1250
11564,3778695017,3244495586,1672597152,1672600319,3167
10278,3770941125,3342031426,1672567270,1672568040,770
11424,3778924002,3500221079,1672606951,1672609210,2259
9918,3780482864,3231227362,1672680120,1672682439,2319
10303,3332124606,3713920790,1672668405,1672671329,2924
11176,3367121615,3509663119,1672615560,1672618254,2694
11634,3515726910,3285971415,1672535440,1672538936,3496
11105,3922301238,3403218814,1672551040,1672553780,2740
10908,3912878303,3976225898,1672539773,1672541684,1911
10409,3514352989,3972847837,1672675562,1672678568,3006
10789,3902548260,3777751979,1672663012,1672664877,1865
10064,3760420315,3450511428,1672612635,1672613301,666
11675,3913847876,3791532324,1672635436,1672635865,429
11469,3711367577,3703481882,1672640374,1672640802,428
11768,3884934977,3384151770,1672674129,1672676376,2247
9928,3714065165,3500093945,1672548218,1672550784,2566
10084,3793222045,3378729459,1672543857,1672546227,2370
10923,3514585995,3520473111,1672558412,1672561896,3484
11361,3608214600,3510750299,1672643438,1672644640,1202
11064,3311197635,3443004958,1672569761,1672571704,1943
10528,3290097447,3509544691,1672642705,1672644035,1330
10174,3444295435,3902357342,1672703060,1672706218,3158
11076,3433189219,3422548081,1672607997,1672611344,3347
11343,3716526314,3330466913,1672591170,1672594522,3352
9913,3773579644,3498803823,1672645003,1672645345,342
11013,3244395841,3304028109,1672623622,1672624762,1140
10105,3779561601,3838119022,1672676317,1672679764,3447
11135,3513545735,3481019442,1672642740,1672645937,3197
11697,3756675909,3428325402,1672595053,1672598514,3461
9882,3533340292,3791121243,1672639979,1672642959,2980
10844,3534068874,3770424892,1672587555,1672589712,2157
10366,3519046342,3394394262,1672641504,1672642202,698
10205,3500776597,3472718723,1672551043,1672552534,1491
10685,3896615831,3388537708,1672679903,1672681461,1558
11142,3442181067,3519108639,1672655030,1672656729,1699
10240,3809207482,3772966919,1672682011,1672684975,2964
10507,3686644062,3501244753,1672629978,1672630558,580
9919,3299845453,3622218289,1672696388,1672699055,2667
11647,3472018395,3792627762,1672656704,1672658625,1921
10076,3900195680,3407734098,1672599892,1672603206,3314
10802,3716976932,3757713457,1672629801,1672632281,2480
10848,3442403264,3737571883,1672644034,1672644315,281
10989,3910354786,3793783685,1672591401,1672594918,3517
10375,3733915784,3373135211,1672575932,1672579260,3328
10326,3856316719,3396440259,1672619648,1672622988,3340
10794,3377883705,3517149023,1672674499,1672677780,3281
11350,3732846295,3300810210,1672691026,1672693738,2712
10593,3519319233,3778927933,1672637636,1672641027,3391
10232,3780050328,3792597493,1672655277,1672656762,1485
9798,3426207439,3777499535,1672543796,1672544302,506
10653,3330238204,3791628195,1672692903,1672695370,2467
10783,3623512088,3512133625,1672614317,1672616600,2283
10635,3710228292,3486509752,1672703438,1672705831,2393
11466,3238779889,3277634944,1672645849,1672648730,2881
11514,3307997700,3773697080,1672612135,1672612805,670
10998,3608973523,3421956717,1672600203,1672603688,3485
11537,3783021859,3408828584,1672638961,1672639880,919
11414,3449233346,3887030182,1672604745,1672606853,2108
10698,3915460293,3201573194,1672680148,1672682966,2818
9842,3601063076,3406029706,1672568784,1672569195,411
10480,3822315407,3714892312,1672613143,1672615057,1914
10293,3715490209,3298831109,1672689913,1672692038,2125
11709,3512395783,3684108920,1672541433,1672542497,1064
11180,3636885498,3306491253,1672612105,1672612921,816
9919,3469663062,3510250740,1672674600,1672676825,2225
10690,3851515560,3770630937,1672670084,1672673594,3510
9804,3713807753,3792075871,1672642171,1672642496,325
11036,3388915945,3683047199,1672640394,1672642085,1691
10575,3416225867,3514560138,1672591372,1672591865,493
10759,3271719569,3206853747,1672582305,1672584950,2645
11152,3681504869,3907245259,1672624124,1672626959,2835
10011,3290797257,3687445224,1672567466,1672569174,1708
10258,3778382224,3505998260,1672632859,1672635019,2160
10814,3501137133,3713840946,1672641657,1672645068,3411
10009,3518425740,3425260097,1672554629,1672557793,3164
11721,3442096275,3760529327,1672690778,1672693286,2508
11519,3395069149,3462985379,1672617058,1672620068,3010
11395,3520395850,3499711458,1672605923,1672608430,2507
10311,3807486812,3902548260,1672565426,1672566237,811
11513,3780956975,3515984911,1672563161,1672565193,2032
11752,3369810091,3839417558,1672586925,1672590099,3174
9986,3770019143,3356972733,1672620451,1672623230,2779
10755,3235578121,3495482863,1672613068,1672613763,695
10744,3716197140,3505164060,1672695240,1672698588,3348
9888,3501550490,3387322545,1672681454,1672681775,321
10690,3736621212,3783651407,1672580990,1672584402,3412
11183,3821087562,3791581138,1672567353,1672567601,248
10715,3236886943,3338465050,1672683412,1672686437,3025
11529,3856699097,3518759318,1672586082,1672588178,2096
11546,3509912164,3281970147,1672654032,1672654120,88
11133,3466620548,3773475506,1672545874,1672547758,1884
9944,3760481622,3791688526,1672648981,1672650366,1385
9815,3558349840,3884394685,1672581617,1672583706,2089
10416,3757823215,3776125503,1672594247,1672597813,3566
10121,3890638402,3517797610,1672679783,1672682448,2665
11758,3917811545,3891272544,1672623855,1672627319,3464
10131,3307535495,3513432588,1672617429,1672619920,2491
10152,3509167758,3510826414,1672626264,1672628439,2175
9942,3372617110,3770709417,1672574506,1672575263,757
11765,3334482021,3516932899,1672533868,1672535242,1374
11098,3665478011,3358434853,1672632423,1672633319,896
10165,3519513219,3755175497,1672632933,1672634831,1898
11547,3716801088,3533365834,1672686570,1672688325,1755
11730,3516965624,3399734748,1672616414,1672618473,2059
11085,3417969824,3517756624,1672556309,1672558566,2257
11209,3825153408,3777498160,1672572219,1672575151,2932
11770,3902682060,3518534560,1672683404,1672684822,1418
10480,3513171472,3638823001,1672666478,1672668416,1938
10062,3662354016,3710919244,1672683059,1672684987,1928
11443,3757924067,3393128259,1672632544,1672634562,2018
10522,3779930476,3399943757,1672631636,1672634628,2992
11348,3510301454,3394364348,1672646692,1672650040,3348
11571,3600699873,3290097447,1672667956,1672669543,1587
10572,3271282663,3379076106,1672662511,1672665586,3075
10766,3294952405,3756890980,1672688139,1672690304,2165
10371,3890638402,3756272704,1672546660,1672548967,2307
9897,3301765144,3287920864,1672643620,1672646683,3063
11771,3341738186,3976400190,1672533126,1672534611,1485
9929,3716609198,3925792265,1672703689,1672706385,2696
10085,3409078869,3622152515,1672640506,1672642152,1646
11295,3739387948,3520165730,1672692668,1672693089,421
10574,3223796145,3512871568,1672656595,1672657942,1347
10444,3933872044,3449233346,1672558408,1672561780,3372
11202,3518882056,3760481622,1672687514,1672689843,2329
11216,3711767051,3919211457,1672626760,1672629908,3148
11350,3447312353,3509186338,1672658724,1672661593,2869
10381,3558349840,3908464960,1672618741,1672622219,3478
11716,3756740153,3505491969,1672649684,1672650706,1022
10414,3351153781,3793899166,1672558766,1672562265,3499
10169,3223144610,3500543341,1672668806,1672672140,3334
10883,3773798215,3757201138,1672608000,1672610858,2858
10615,3736036532,3770273966,1672572186,1672574708,2522
11302,3772882440,3293540333,1672638549,1672639409,860
9968,3308744016,3713373455,1672609089,1672611072,1983
10241,3311331205,3703048107,1672542536,1672544304,1768
10256,3500145103,3776304080,1672678440,1672680568,2128
10178,3422314045,3284829602,1672608598,1672610582,1984
9878,3812559393,3793934396,1672657198,1672659873,2675
11523,3505825767,3533867833,1672634930,1672636697,1767
9895,3500688476,3922786716,1672615087,1672616330,1243
10567,3247075753,3499622352,1672591025,1672591893,868
10082,3512395783,3348343425,1672543969,1672544283,314
10046,3890211161,3505697295,1672665797,1672666271,474
11075,3440991826,3934991640,1672649575,1672652675,3100
11308,3516463579,3807646028,1672672527,1672674646,2119
10296,3514297012,3776953418,1672539678,1672542327,2649
11076,3783176874,3408828584,1672660998,1672661661,663
10766,3557129226,3735422623,1672632359,1672634393,2034
11244,3922301238,3909220912,1672639155,1672640053,898
10343,3713840946,3899903158,1672646515,1672646647,132
11112,3513764665,3793232021,1672598398,1672599051,653
11504,3839308659,3515548696,1672548891,1672551624,2733
10910,3510335069,3517551721,1672672092,1672672691,599
10914,3777135415,3933106901,1672693754,1672696896,3142
11123,3514541800,3378430760,1672561657,1672563909,2252
11600,3756149282,3803382101,1672572213,1672575155,2942
10602,3715441777,3430399931,1672568089,1672570719,2630
11693,3770715115,3760748418,1672551929,1672552533,604
11234,3311774510,3809194824,1672636296,1672637020,724
11693,3400025324,3701265238,1672651769,1672652761,992
11183,3824135033,3914740937,1672557737,1672559208,1471
10929,3730169449,3837888196,1672599446,1672600623,1177
11494,3780148144,3510882576,1672648267,1672650351,2084
11757,3519165527,3386323728,1672537884,1672541355,3471
10098,3714065165,3510244209,1672648977,1672649538,561
10230,3638050763,3689223632,1672689852,1672692291,2439
11732,3779415433,3711765138,1672663882,1672664479,597
11461,3378747834,3817038422,1672622441,1672625015,2574
9959,3792267993,3774702364,1672608626,1672611556,2930
11582,3777937949,3977157565,1672560605,1672561086,481
10672,3239279744,3415803494,1672648614,1672650832,2218
10614,3515259326,3880562532,1672547821,1672548786,965
9824,3755670258,3757639274,1672664211,1672667527,3316
10059,3313795594,3605591994,1672684524,1672684601,77
10989,3703896751,3710529628,1672626199,1672627579,1380
10092,3713374884,3312733562,1672657187,1672660336,3149
11060,3202787155,3534775239,1672542239,1672544232,1993
10254,3701459978,3517499844,1672631757,1672633277,1520
11240,3777290300,3240622654,1672637241,1672638460,1219
10816,3660980656,3388463477,1672682746,1672685424,2678
11717,3928421417,3793860209,1672626273,1672626898,625
10315,3887382548,3394357241,1672624119,1672627424,3305
9820,3203457161,3281970147,1672621576,1672624418,2842
10836,3274341934,3335353798,1672689524,1672689801,277
10878,3854957153,3755688231,1672683857,1672686118,2261
11217,3518759318,3361711720,1672663309,1672666459,3150
11561,3501927452,3512744657,1672583110,1672584246,1136
10456,3444598583,3792432094,1672607448,1672608639,1191
10279,3756680289,3367299721,1672671387,1672672977,1590
10279,3825932442,3701770921,1672633007,1672633759,752
11494,3387700451,3514033319,1672606490,1672607219,729
10375,3773534165,3898989233,1672643724,1672647230,3506
10233,3703423962,3774221318,1672692267,1672693015,748
10273,3519357822,3603452936,1672534802,1672538041,3239
11353,3380444321,3760854788,1672619110,1672621079,1969
10689,3882905311,3205687719,1672619919,1672623060,3141
11378,3311414429,3517558635,1672552633,1672555551,2918
10676,3500342408,3534624672,1672650361,1672653827,3466
10954,3857590978,3510022922,1672556269,1672559650,3381
10970,3534775239,3430823498,1672578774,1672580101,1327
10938,3388915945,3500854711,1672604117,1672604841,724
10178,3732846295,3783695231,1672617455,1672617786,331
11220,3394986304,3382757142,1672701930,1672702705,775
9803,3425646356,3711065081,1672687378,1672687989,611
11737,3832333115,3780956975,1672627527,1672628790,1263
11643,3443191792,3703443664,1672599555,1672602979,3424
10602,3714065165,3776440009,1672560044,1672560867,823
10274,3238997746,3382757142,1672689929,1672691454,1525
11204,3273242177,3465227623,1672531770,1672532488,718
11316,3668764192,3826068495,1672577303,1672580560,3257
9910,3774673193,3632189887,1672656819,1672659511,2692
11217,3919345990,3245882008,1672555803,1672556740,937
10293,3793926338,3757030923,1672627036,1672629652,2616
10273,3470962222,3780352400,1672532973,1672535918,2945
10616,3773895671,3517325365,1672684869,1672687133,2264
10138,3444397804,3284374600,1672537267,1672538858,1591
10961,3512495325,3880000841,1672580025,1672581205,1180
11482,3930727474,3500356342,1672621407,1672621683,276
10083,3760274119,3777655401,1672603182,1672604826,1644
11511,3971422524,3856975623,1672621024,1672624178,3154
11483,3343511947,3433196933,1672656695,1672657286,591
10162,3316537706,3830962592,1672593207,1672594540,1333
11621,3817029483,3603452936,1672615601,1672615837,236
10333,3817120976,3349319959,1672695660,1672697699,2039
10039,3243651036,3831981073,1672621702,1672625277,3575
10989,3757796416,3772070986,1672644735,1672646382,1647
10283,3514341451,3441737317,1672537336,1672537800,464
10679,3611533094,3713471446,1672576456,1672578146,1690
10857,3733796228,3683562111,1672656452,1672658417,1965
10629,3513508737,3278779955,1672701479,1672704952,3473
10796,3701841013,3715587520,1672611105,1672613688,2583
10660,3713740434,3703206956,1672542605,1672545584,2979
10893,3227956115,3380285779,1672609680,1672613162,3482
10829,3511003541,3358982831,1672549000,1672551554,2554
11595,3631444265,3710919244,1672585925,1672588491,2566
10174,3780423516,3534988162,1672554323,1672557515,3192
9827,3971051020,3421674406,1672593016,1672594956,1940
10275,3533440294,3662354016,1672605969,1672607453,1484
10255,3902292032,3505117019,1672561188,1672562652,1464
9831,3273537848,3760748418,1672601886,1672604663,2777
11100,3520471156,3713906305,1672555640,1672557423,1783
10602,3793902476,3776001441,1672532299,1672534409,2110
10369,3501192566,3793814153,1672611797,1672614687,2890
10234,3773603836,3912181197,1672602885,1672603270,385
11748,3395505794,3624872714,1672667959,1672670582,2623
10856,3416079461,3914353062,1672534781,1672537098,2317
10185,3517440258,3505351253,1672532519,1672533404,885
10937,3311924005,3603167427,1672604965,1672608116,3151
10968,3375324190,3500442370,1672659981,1672662122,2141
10623,3779748270,3737571883,1672600790,1672601654,864
9988,3791351852,3629869834,1672701905,1672703157,1252
10568,3701171318,3938129916,1672632009,1672632850,841
11292,3355903597,3780511388,1672532928,1672535772,2844
10513,3791716170,3898965585,1672561874,1672563145,1271
10284,3403120725,3363549860,1672630099,1672632835,2736
10571,3811503860,3803996569,1672548827,1672552388,3561
10370,3511206717,3518376262,1672681710,1672683957,2247
11536,3774598935,3397330170,1672560998,1672561318,320
10821,3618895679,3810584695,1672641276,1672642383,1107
10217,3770273459,3500726347,1672607088,1672607983,895
9920,3622654885,3512203553,1672640278,1672643447,3169
11647,3316537706,3791205793,1672642945,1672643865,920
10755,3515726910,3505032773,1672621901,1672625254,3353
11345,3302879906,3308744016,1672538838,1672541463,2625
11613,3513661302,3773636983,1672572741,1672574182,1441
11687,3885645840,3713285095,1672648996,1672649153,157
10501,3757030923,3791072829,1672666079,1672669364,3285
10402,3905934770,3409078869,1672599295,1672600536,1241
11243,3496407500,3714525519,1672613607,1672615060,1453
10258,3444295435,3493598658,1672663096,1672663853,757
11361,3294821709,3823600319,1672595446,1672597638,2192
10400,3365839890,3975796415,1672630784,1672632439,1655
10099,3906075386,3233917789,1672652000,1672654869,2869
10099,3458753033,3397783490,1672553022,1672554036,1014
9846,3469780362,3933106901,1672647759,1672650170,2411
10973,3510680251,3701865589,1672572541,1672575683,3142
10848,3779478448,3638071975,1672610386,1672611697,1311
11602,3361952532,3807646028,1672592088,1672594710,2622
11175,3274341934,3760901975,1672550767,1672552107,1340
10769,3369938668,3357026115,1672614273,1672614835,562
10257,3711767051,3305656670,1672656962,1672657554,592
10971,3514638555,3388830370,1672532518,1672534271,1753
11662,3816184951,3284829602,1672551006,1672551111,105
11424,3492056330,3971280379,1672585314,1672586806,1492
11089,3511867383,3392482187,1672663335,1672664643,1308
11200,3792797648,3227498870,1672532909,1672534455,1546
11732,3295710494,3715724166,1672538560,1672539024,464
9811,3311805161,3356972733,1672566979,1672568695,1716
10603,3500011591,3715106566,1672570258,1672572102,1844
11668,3633294415,3499998389,1672594774,1672595896,1122
11728,3513111053,3509433155,1672686049,1672687714,1665
9853,3514329209,3505500665,1672551364,1672552427,1063
11425,3500405175,3703742071,1672611025,1672613765,2740
10306,3938398160,3756850160,1672586648,1672589900,3252
10215,3780308809,3793407883,1672582046,1672582985,939
10567,3856147380,3501407804,1672577881,1672578773,892
10496,3510542303,3739217535,1672544155,1672547539,3384
11364,3783357035,3228218081,1672549516,1672550188,672
10235,3517149023,3776193847,1672663688,1672666082,2394
10417,3757713457,3818324410,1672611845,1672614872,3027
11055,3475090917,3519886257,1672672562,1672673617,1055
11298,3777932581,3783157469,1672584280,1672584656,376
11095,3283295213,3711430738,1672560973,1672561757,784
10691,3370512945,3834456158,1672666892,1672668645,1753
11006,3501427691,3792578118,1672553878,1672555109,1231
11361,3933872044,3500909455,1672671271,1672673944,2673
9942,3347205332,3519046342,1672590902,1672593866,2964
11498,3770285500,3429409539,1672551239,1672551696,457
9887,3772962072,3337675386,1672551752,1672552028,276
10349,3793783685,3850181934,1672543791,1672544167,376
11486,3972442654,3515838621,1672596333,1672599729,3396
9941,3487988841,3756843139,1672581950,1672582546,596
9907,3275274182,3688130094,1672680196,1672681546,1350
9910,3939851140,3402338011,1672535731,1672538870,3139
10799,3777932225,3917004141,1672556131,1672558943,2812
10339,3778713526,3776583229,1672599166,1672600767,1601
10920,3770486161,3393001196,1672660722,1672663959,3237
10772,3773697080,3602401154,1672560371,1672561768,1397
11556,3533986052,3777992576,1672577640,1672579909,2269
11740,3774205060,3925792265,1672615738,1672616631,893
10507,3496352027,3227956115,1672627090,1672628053,963
9961,3701004302,3512645289,1672584543,1672585307,764
10525,3896123242,3468871103,1672572819,1672574958,2139
11107,3472718723,3710125627,1672540318,1672541974,1656
10740,3298706213,3710119555,1672641981,1672645111,3130
10849,3710919244,3510758718,1672677617,1672679518,1901
11568,3755378125,3519886257,1672654281,1672654956,675
10392,3733243990,3852275715,1672676273,1672679095,2822
11559,3734957248,3774401596,1672665893,1672668062,2169
11023,3501711464,3310021925,1672641658,1672643825,2167
11703,3511198566,3614112171,1672700504,1672701450,946
9906,3209075485,3404461403,1672647742,1672651267,3525
10598,3822634862,3511466117,1672650944,1672652081,1137
10136,3755502373,3500342408,1672682706,1672685009,2303
11005,3340897079,3356599815,1672683748,1672684479,731
11442,3884180202,3778713526,1672546104,1672546847,743
11121,3378430760,3494157939,1672596076,1672598374,2298
10269,3613781977,3515230715,1672690344,1672690824,480
10550,3505097206,3710891331,1672538341,1672541464,3123
10225,3422081502,3909457959,1672602775,1672604360,1585
10821,3637566026,3793442891,1672701705,1672704802,3097
9820,3510484107,3429333292,1672701889,1672702088,199
9880,3513213122,3701824335,1672536704,1672540148,3444
10924,3755779925,3479207976,1672685071,1672686851,1780
9872,3793899166,3897107253,1672599188,1672601939,2751
10857,3714268380,3367526113,1672703282,1672705919,2637
11569,3316821313,3505472087,1672699871,1672701345,1474
11674,3470997293,3685083275,1672536360,1672537810,1450
10411,3757513651,3755865626,1672567946,1672568069,123
11475,3380281484,3971422524,1672557858,1672561109,3251
9972,3517617472,3755942724,1672628376,1672631390,3014
11045,3500591274,3207586072,1672602318,1672604777,2459
10478,3409514897,3971447562,1672541290,1672543977,2687
10834,3777439655,3714455496,1672590117,1672591443,1326
10272,3241682278,3792337863,1672604728,1672604831,103
11059,3783313202,3716841469,1672544482,1672546243,1761
10914,3510178791,3440305508,1672549562,1672550193,631
10671,3469370398,3351949206,1672644277,1672646662,2385
10098,3662495290,3301449986,1672589636,1672592556,2920
11560,3395565040,3505994703,1672630461,1672633760,3299
10737,3534278019,3601214648,1672677172,1672677307,135
10845,3452090950,3780921044,1672636437,1672639836,3399
10310,3484739955,3911821258,1672551069,1672551622,553
10315,3793375825,3777992576,1672644115,1672645498,1383
11539,3311197635,3716423829,1672698901,1672699979,1078
11085,3388923880,3500654356,1672668519,1672671642,3123
10642,3770544738,3780511388,1672677096,1672678351,1255
10935,3904184638,3777569538,1672557346,1672559423,2077
10461,3688870751,3388830370,1672661916,1672665454,3538
11494,3277061226,3760346746,1672554796,1672557773,2977
11572,3837435907,3923524564,1672565765,1672568198,2433
10629,3686081254,3518794921,1672651925,1672653223,1298
10074,3911821258,3372596013,1672699454,1672700393,939
10912,3776348472,3756157377,1672609836,1672610086,250
10956,3757050615,3778182724,1672658812,1672660366,1554
11413,3933731871,3793375825,1672586400,1672588044,1644
10761,3512480125,3777290300,1672579340,1672580983,1643
11790,3223796145,3455955489,1672635295,1672635957,662
10598,3500595432,3517331746,1672693574,1672695403,1829
11261,3896123242,3713927376,1672666034,1672667309,1275
11721,3272838634,3520697518,1672627902,1672630420,2518
11237,3813276198,3914740937,1672649594,1672650184,590
11521,3444397804,3370401047,1672676072,1672676233,161
11243,3629248353,3520049965,1672544211,1672544315,104
10070,3730169449,3809207482,1672592760,1672593513,753
10805,3513816744,3711770853,1672563792,1672567091,3299
10148,3501370430,3513384042,1672646917,1672647529,612
10739,3479585868,3713606829,1672568040,1672570377,2337
10139,3818236682,3435715962,1672684668,1672685502,834
11707,3701377471,3234445133,1672596098,1672596512,414
10973,3603740088,3756428507,1672617648,1672620899,3251
11683,3757001552,3425260097,1672694736,1672695204,468
10678,3829698950,3711190257,1672595940,1672596901,961
11239,3773475506,3896840409,1672575547,1672576079,532
11236,3760749218,3461877104,1672588820,1672590232,1412
11161,3662495290,3234445133,1672631261,1672634310,3049
9897,3501963428,3357097510,1672554249,1672557601,3352
10014,3380281484,3837887478,1672686252,1672688463,2211
11792,3900195680,3463729805,1672664469,1672664706,237
11637,3511671476,3289258397,1672660480,1672663067,2587
11296,3332010532,3783172505,1672647128,1672650347,3219
11182,3777706200,3630462406,1672687932,1672688666,734
10521,3222357355,3509317054,1672642426,1672644143,1717
10369,3713373455,3890638402,1672639439,1672641622,2183
11783,3773878451,3304672737,1672631359,1672634734,3375
10058,3389069291,3428878402,1672698332,1672701550,3218
10466,3493598658,3500579482,1672581090,1672582391,1301
10007,3886879696,3433902955,1672537574,1672538671,1097
10469,3305656670,3710119555,1672567103,1672569385,2282
11748,3435652260,3558567160,1672641651,1672644739,3088
11784,3513802404,3418791124,1672563589,1672565123,1534
11306,3333477908,3491527603,1672625888,1672628913,3025
10041,3710008760,3755729826,1672662213,1672662518,305
9818,3437934509,3899205452,1672702116,1672704048,1932
11680,3774325486,3500776597,1672666485,1672667136,651
10152,3714902042,3272827860,1672536526,1672537864,1338
10690,3756437169,3701350519,1672674566,1672676880,2314
11056,3553008208,3514638555,1672696674,1672698859,2185
11403,3716801088,3755374000,1672648470,1672650846,2376
10579,3936851114,3245882008,1672666569,1672669774,3205
10243,3297100323,3772869013,1672562003,1672564008,2005
11457,3703694139,3760966645,1672621400,1672624892,3492
10605,3519908593,3519352855,1672665900,1672667760,1860
11714,3204473480,3711015176,1672689187,1672689899,712
11112,3760232135,3447938130,1672560116,1672560697,581
11703,3701385831,3760322661,1672680706,1672682943,2237
10231,3774682234,3403150349,1672583022,1672584982,1960
11704,3735497729,3489340327,1672663563,1672666073,2510
11595,3500019810,3716994924,1672678138,1672681346,3208
10584,3757639274,3756119976,1672559748,1672561874,2126
11372,3517617472,3469778316,1672633080,1672634979,1899
11587,3776600696,3711959141,1672675009,1672676622,1613
10947,3513171472,3924366353,1672698125,1672698824,699
10061,3511182297,3779427180,1672564046,1672564828,782
9837,3514776568,3410602007,1672632881,1672634796,1915
10206,3774304163,3803382101,1672692401,1672693885,1484
10283,3516321993,3770424892,1672560202,1672561087,885
11403,3778741325,3511867383,1672666533,1672669027,2494
10491,3517645656,3770480149,1672671853,1672675048,3195
11701,3853386575,3932955949,1672567040,1672567364,324
11464,3703502114,3757607649,1672600656,1672601857,1201
11408,3701521510,3858497718,1672687488,1672691015,3527
11313,3776279305,3791368349,1672679824,1672682669,2845
10941,3825877848,3783043346,1672656409,1672659023,2614
10196,3710271021,3897500723,1672684868,1672688213,3345
11581,3472718723,3496352027,1672568522,1672571444,2922
10007,3500994763,3469350379,1672532873,1672533553,680
11739,3510836047,3505266343,1672633852,1672637040,3188
10393,3756680289,3626631210,1672619803,1672620162,359
11202,3912811715,3311142523,1672567413,1672569898,2485
11493,3533427742,3333355914,1672630738,1672631591,853
10545,3715700639,3778817220,1672688938,1672690886,1948
9877,3773475506,3312612693,1672549158,1672551719,2561
10020,3317989975,3859191694,1672579038,1672579766,728
10604,3516969689,3382746533,1672567402,1672569397,1995
11725,3500105301,3474852115,1672608488,1672609843,1355
10361,3436401020,3685396470,1672599567,1672599760,193
9956,3773432494,3755175497,1672635789,1672637879,2090
11132,3715590997,3240443426,1672667700,1672668139,439
11346,3770671714,3534206917,1672640637,1672642343,1706
10685,3836586875,3515304526,1672587497,1672590847,3350
10444,3716178116,3228477490,1672565149,1672566838,1689
10166,3202740652,3777937949,1672703596,1672706677,3081
10185,3780576351,3440671139,1672638922,1672642340,3418
11678,3780435349,3501515425,1672599452,1672601975,2523
10514,3710695372,3783408469,1672685500,1672688613,3113
10146,3611533094,3770023722,1672686957,1672687141,184
11328,3919345990,3773378103,1672590949,1672591665,716
11451,3452802329,3625400710,1672674943,1672677292,2349
10993,3520515739,3936871734,1672572710,1672575240,2530
10489,3221736756,3366501813,1672572364,1672573521,1157
11053,3777387533,3519108639,1672576555,1672576623,68
11599,3500440602,3305612422,1672657460,1672659963,2503
11680,3716676869,3908331271,1672685975,1672687205,1230
10452,3783095041,3309415277,1672693416,1672696175,2759
11726,3772461583,3710487368,1672647782,1672648715,933
11345,3935520819,3283295213,1672644814,1672645576,762
11787,3701567668,3472774606,1672557935,1672558901,966
11466,3289258397,3603682643,1672675421,1672676779,1358
10096,3817478012,3405303958,1672598693,1672599404,711
10981,3353335252,3923910914,1672554725,1672556171,1446
10654,3393909269,3810584695,1672619966,1672622365,2399
11089,3711889178,3476431618,1672656022,1672658766,2744
10976,3418791124,3304235700,1672668555,1672671762,3207
10489,3513777705,3826068495,1672695800,1672699062,3262
10084,3837885956,3791106473,1672610461,1672612634,2173
11500,3240443426,3760537855,1672563482,1672564382,900
10489,3851737350,3850181934,1672545374,1672547772,2398
10287,3701377471,3518335611,1672557055,1672559385,2330
10086,3703502114,3236886943,1672565813,1672568008,2195
11490,3500654356,3711836873,1672656841,1672660157,3316
10031,3487231844,3559125467,1672615592,1672619025,3433
10465,3534775239,3402774497,1672569227,1672571384,2157
9800,3344478603,3760710525,1672545632,1672547771,2139
11179,3246296769,3711214982,1672545093,1672547114,2021
11154,3517991042,3510373076,1672608208,1672608679,471
10655,3393001196,3516463579,1672663794,1672664331,537
11400,3776447604,3228033254,1672703229,1672706378,3149
10670,3703659324,3520344592,1672683931,1672685838,1907
11482,3414510793,3311521176,1672549232,1672552540,3308
10443,3478052226,3387388336,1672675025,1672676278,1253
10661,3205113625,3500251781,1672575232,1672578592,3360
11613,3500079479,3367109648,1672631384,1672632505,1121
11131,3291153514,3371759126,1672595658,1672598769,3111
11325,3519108639,3774483862,1672535955,1672538465,2510
11482,3793874490,3611533094,1672597741,1672599349,1608
10471,3930766276,3713416106,1672543641,1672545518,1877
11208,3917467642,3505521491,1672692099,1672694041,1942
9970,3791547827,3306037126,1672571930,1672572344,414
10211,3441944896,3334461288,1672543927,1672546252,2325
10408,3713373455,3422548081,1672543893,1672545759,1866
10760,3313298164,3519341916,1672634668,1672634786,118
10953,3971282455,3780467276,1672601094,1672603875,2781
11301,3772320856,3514685272,1672649579,1672651927,2348
11591,3487622510,3783408469,1672546803,1672549267,2464
11136,3716285196,3703849264,1672627283,1672629743,2460
9995,3760080378,3703438617,1672700169,1672703251,3082
10072,3441683673,3492064037,1672692852,1672694260,1408
11190,3509433155,3500057674,1672658067,1672661602,3535
11062,3714870496,3505438826,1672665208,1672667883,2675
10285,3505980138,3500015630,1672616469,1672617059,590
11557,3623894390,3519034304,1672592003,1672594552,2549
11270,3510694464,3660163550,1672541196,1672544109,2913
10783,3609644043,3236948071,1672546296,1672549538,3242
11073,3937636109,3701311947,1672666296,1672669324,3028
11192,3430310785,3399726243,1672634871,1672636033,1162
10116,3703896751,3472272792,1672551452,1672551745,293
11112,3770631449,3505887814,1672684287,1672687079,2792
10867,3716647407,3808442442,1672673054,1672675160,2106
10535,3516792348,3514007122,1672538184,1672541765,3581
10838,3776468503,3925208102,1672656070,1672659332,3262
10743,3514005973,3534190196,1672696338,1672697825,1487
10238,3934564437,3501244753,1672537436,1672537683,247
10777,3770991234,3615447269,1672703924,1672704289,365
10645,3839744168,3792255406,1672692370,1672693668,1298
10778,3510244209,3611832288,1672614957,1672616679,1722
9845,3513800589,3908464960,1672701739,1672704987,3248
10355,3757001552,3791532324,1672567800,1672570943,3143
9832,3812677669,3520339198,1672624212,1672624903,691
9860,3730571757,3289017988,1672601160,1672601393,233
11526,3520506192,3912811715,1672538696,1672540134,1438
11132,3519937708,3851877325,1672553013,1672553372,359
10009,3514776568,3756948477,1672597876,1672598841,965
10918,3441336851,3510638085,1672587767,1672591237,3470
11420,3701004302,3715852330,1672702475,1672705555,3080
11791,3770715115,3318250647,1672641883,1672643360,1477
11318,3513092056,3662507634,1672622291,1672622631,340
10965,3703438617,3519351747,1672684147,1672686464,2317
11531,3241855333,3517797610,1672646056,1672646450,394
10472,3757549235,3290797257,1672673625,1672676433,2808
11150,3533017131,3905571273,1672606558,1672608163,1605
9940,3716676869,3512203553,1672587054,1672587611,557
11088,3489205994,3491390365,1672668028,1672669645,1617
11316,3890211161,3660980656,1672593830,1672595466,1636
10030,3455907179,3272581469,1672616284,1672618817,2533
10702,3505414878,3500438542,1672650915,1672653973,3058
10067,3735838864,3334824744,1672687080,1672688736,1656
11295,3711591464,3556684272,1672637444,1672637632,188
11336,3884388188,3514761434,1672667378,1672667768,390
11210,3476416072,3519965717,1672612186,1672614550,2364
10235,3500591274,3513996288,1672531724,1672533791,2067
10446,3402580733,3770533675,1672698413,1672698960,547
11427,3736036532,3629248353,1672657938,1672661492,3554
10425,3459694275,3509912164,1672653209,1672654378,1169
11339,3505720915,3972653129,1672544395,1672547694,3299
10971,3757869138,3516819320,1672546169,1672549113,2944
11093,3791368349,3380281484,1672679258,1672681733,2475
11767,3923133978,3512697456,1672631054,1672632879,1825
11611,3554437212,3416474842,1672660395,1672663958,3563
10566,3855222429,3711518637,1672687577,1672689714,2137
11597,3776867553,3293673220,1672620792,1672624241,3449
11655,3929923442,3388537708,1672588903,1672589672,769
11339,3977209952,3715566511,1672545277,1672545703,426
10643,3449672240,3316551382,1672547706,1672550598,2892
11605,3512681214,3737050849,1672674296,1672676961,2665
10782,3505011956,3533876927,1672660846,1672663766,2920
9836,3362385373,3371238318,1672566558,1672569765,3207
10105,3304672737,3519553933,1672688217,1672689760,1543
10711,3773408491,3791031227,1672584564,1672585863,1299
11662,3516517348,3760554453,1672563176,1672565110,1934
11325,3756675909,3757869138,1672667032,1672668626,1594
11659,3517499844,3513661302,1672666553,1672667675,1122
10064,3465690527,3421524698,1672673224,1672675918,2694
11656,3513563152,3756536512,1672618215,1672619051,836
11073,3779174993,3313579674,1672652682,1672655455,2773
11366,3791716170,3304447950,1672615889,1672617495,1606
11743,3906075386,3519319233,1672553188,1672555505,2317
10527,3420854927,3778479297,1672594306,1672595627,1321
11364,3918126468,3470997293,1672638053,1672639024,971
10763,3756493561,3401215739,1672637347,1672639040,1693
11234,3319436533,3934564437,1672654924,1672657866,2942
11605,3714870496,3715566511,1672583000,1672584924,1924
10424,3780308809,3760322661,1672697365,1672698504,1139
10356,3818461836,3772114731,1672613247,1672615799,2552
10880,3511466117,3203630241,1672686605,1672689857,3252
9903,3241855333,3444881567,1672627261,1672630186,2925
10377,3881785069,3428076194,1672641414,1672644493,3079
10390,3770486161,3430032005,1672648801,1672649141,340
11516,3500049870,3500968729,1672676598,1672676962,364
10649,3791435852,3557528150,1672578901,1672581460,2559
10991,3915195160,3791716170,1672674047,1672674967,920
10498,3772905073,3479910993,1672686021,1672689342,3321
11461,3446537819,3411355804,1672698986,1672699689,703
11689,3505164060,3819400315,1672696886,1672699071,2185
11432,3639465750,3505129296,1672641596,1672644699,3103
10351,3829358750,3793332600,1672637696,1672638208,512
11406,3362127525,3774483862,1672697225,1672700523,3298
11175,3480185839,3850904092,1672703214,1672706785,3571
10712,3777758203,3636927297,1672627650,1672630275,2625
9874,3688130094,3614484939,1672654884,1672656297,1413
11511,3316821313,3311515179,1672600027,1672602785,2758
11582,3406492167,3735497729,1672649704,1672650332,628
10466,3304447950,3612705426,1672628148,1672629787,1639
11104,3713283029,3972847837,1672579982,1672580828,846
11367,3977209952,3703048107,1672684142,1672684720,578
10200,3512477276,3338642026,1672602796,1672604354,1558
11270,3366433035,3770172119,1672663496,1672665960,2464
10743,3910190872,3505825767,1672575914,1672576873,959
10483,3510278533,3286938590,1672695911,1672698044,2133
9995,3418791124,3511245705,1672667941,1672669033,1092
11216,3632303304,3713878219,1672654545,1672655642,1097
11542,3551833298,3733243990,1672617186,1672618481,1295
10974,3415032547,3220798451,1672649521,1672649789,268
10486,3606688595,3891272544,1672566798,1672569904,3106
11275,3289771213,3613216900,1672591216,1672594742,3526
10938,3430310785,3518794921,1672677505,1672680131,2626
10412,3760443176,3451757423,1672644116,1672645902,1786
9973,3517440258,3342368576,1672612427,1672613615,1188
10855,3512371853,3512794667,1672625366,1672625580,214
9889,3714377201,3778382224,1672662679,1672665936,3257
11596,3510869438,3368848936,1672580702,1672583344,2642
11474,3513140146,3971280379,1672560028,1672562329,2301
11443,3370961012,3316406470,1672575820,1672577242,1422
11341,3662794240,3500211484,1672649740,1672650179,439
10766,3500011591,3895422995,1672559958,1672561158,1200
11663,3774251051,3459951739,1672605850,1672608075,2225
11587,3733870816,3757732853,1672635376,1672638800,3424
11512,3450503086,3437286595,1672593286,1672594457,1171
11202,3773895671,3925823748,1672671112,1672671881,769
9811,3715923089,3783238023,1672617600,1672620491,2891
10654,3509663119,3488887919,1672571651,1672573614,1963
10938,3714787207,3441944896,1672592950,1672593836,886
10920,3779609338,3976225898,1672583357,1672586904,3547
10298,3505359060,3716492409,1672674477,1672677038,2561
11358,3756761603,3623113240,1672587326,1672588468,1142
10770,3934611532,3533009565,1672575001,1672575609,608
11165,3505066871,3711836873,1672640862,1672643676,2814
11307,3770276815,3514638555,1672566042,1672568989,2947
10850,3609997804,3319862687,1672591983,1672592305,322
10796,3814770073,3350169064,1672558366,1672559308,942
10618,3500057674,3515764058,1672563789,1672565973,2184
10239,3934564437,3833520635,1672572673,1672574664,1991
10287,3533703578,3385416697,1672642193,1672642588,395
11781,3429610195,3772968080,1672616186,1672617450,1264
11479,3311514075,3429315500,1672541665,1672544594,2929
9821,3682241594,3755924094,1672649925,1672650465,540
10950,3500104976,3440401725,1672559773,1672561505,1732
11691,3516463579,3908464960,1672544631,1672547630,2999
10459,3822496670,3703697059,1672535324,1672536510,1186
9948,3937747312,3505490878,1672582699,1672583749,1050
11206,3760554453,3880000841,1672576718,1672577682,964
11055,3209075485,3734233216,1672647108,1672648492,1384
10839,3479585868,3703206956,1672600954,1672603958,3004
10602,3205113625,3512371853,1672667485,1672669823,2338
9840,3533620069,3715602742,1672628629,1672631279,2650
9956,3770564547,3711947828,1672563475,1672564067,592
10207,3776534957,3713170867,1672579450,1672581911,2461
10320,3238796398,3520832066,1672546958,1672549403,2445
9918,3703031637,3514508773,1672629202,1672630306,1104
10869,3465227623,3773826624,1672635548,1672637133,1585
10942,3500863429,3760443176,1672639010,1672640325,1315
10728,3772509599,3792432763,1672624399,1672627380,2981
11510,3710060386,3298113026,1672700480,1672701720,1240
9842,3286938590,3732090606,1672689925,1672690106,181
10319,3791409441,3399726243,1672579666,1672582223,2557
10690,3773852157,3533201269,1672532986,1672534487,1501
11191,3891272544,3773891827,1672632213,1672634097,1884
10850,3778819352,3510882576,1672569746,1672571762,2016
11470,3501171785,3627081426,1672657610,1672657754,144
10351,3533642281,3512343029,1672536195,1672537529,1334
10185,3935333166,3398862999,1672542045,1672545483,3438
11030,3513740840,3453164933,1672544790,1672545162,372
10662,3270607273,3447267291,1672670139,1672670463,324
11069,3837888196,3512477276,1672638331,1672638600,269
10742,3907039612,3664719070,1672653653,1672656522,2869
10391,3710819760,3837887478,1672661488,1672664664,3176
10332,3408408584,3760731595,1672586651,1672589187,2536
11116,3552261072,3773408491,1672545775,1672547575,1800
11374,3309415277,3533841983,1672652253,1672653048,795
10732,3780173788,3396472026,1672639128,1672641793,2665
10763,3270502801,3501988762,1672700757,1672700900,143
11709,3732223664,3760390822,1672634116,1672635420,1304
9831,3358959807,3272581469,1672545014,1672547536,2522
11112,3533867833,3500438542,1672673817,1672674952,1135
10880,3203630241,3406169279,1672545860,1672547636,1776
11647,3607583720,3501976169,1672588108,1672591093,2985
9982,3515944817,3513629502,1672581265,1672581406,141
11418,3500234771,3493679801,1672655354,1672657328,1974
11096,3418997135,3453519360,1672638077,1672640114,2037
10847,3399173821,3711945923,1672661629,1672663415,1786
9803,3755394177,3779174993,1672662870,1672665580,2710
10915,3777060250,3663353552,1672665856,1672668060,2204
11392,3730348493,3302929858,1672586876,1672589284,2408
11212,3907923381,3342252701,1672606357,1672608671,2314
11115,3971289056,3512343029,1672643033,1672643260,227
10188,3739297004,3772962072,1672687006,1672689783,2777
11493,3638126174,3908862092,1672696184,1672697442,1258
10779,3880000841,3780964089,1672696296,1672698592,2296
11400,3387971464,3201656220,1672685376,1672686029,653
10042,3500693568,3905934770,1672584592,1672584842,250
10252,3203837944,3476958001,1672574914,1672576289,1375
11729,3715897627,3756536476,1672644245,1672647271,3026
11004,3791664049,3830291558,1672627954,1672629204,1250
9869,3701596047,3713069234,1672564652,1672565133,481
10970,3418997135,3738429905,1672572022,1672574137,2115
10020,3703742071,3851810349,1672688438,1672689222,784
10915,3772609551,3517021928,1672538610,1672539336,726
11058,3760024021,3892177203,1672656548,1672658622,2074
10718,3755209597,3377311502,1672612431,1672613445,1014
11194,3713416106,3783373085,1672646492,1672648519,2027
11139,3311479294,3293553295,1672583731,1672584438,707
10591,3714690161,3701284535,1672648239,1672651559,3320
11520,3773344258,3978417055,1672660138,1672661407,1269
11633,3716179251,3902023467,1672598257,1672598701,444
9871,3856975623,3517499844,1672546756,1672547836,1080
10363,3760390822,3227956115,1672677277,1672680128,2851
10056,3703572036,3760322661,1672678447,1672678559,112
11275,3857590978,3773876312,1672683963,1672684233,270
11560,3275975921,3296970170,1672700991,1672702863,1872
11610,3375257546,3810818108,1672693959,1672696516,2557
10993,3505097206,3447202943,1672680344,1672681656,1312
10155,3358675021,3665603628,1672559794,1672561541,1747
11204,3240683148,3715881104,1672632660,1672634405,1745
9829,3783176874,3755107521,1672626980,1672629347,2367
10180,3518989186,3779102237,1672661910,1672665277,3367
10255,3815184540,3778924002,1672589440,1672591846,2406
11158,3716209499,3500455935,1672580867,1672581218,351
11296,3505936495,3246062632,1672635076,1672636911,1835
9984,3271389160,3533728729,1672688771,1672692267,3496
11246,3510159441,3366961580,1672671227,1672672876,1649
11499,3377311502,3430399931,1672577596,1672578880,1284
11441,3203172170,3281935691,1672632300,1672635452,3152
10462,3939422411,3319645922,1672557382,1672560148,2766
11295,3662821438,3777060250,1672609424,1672612920,3496
10691,3368339963,3783730769,1672638454,1672638780,326
10873,3500654356,3711367577,1672638047,1672641069,3022
10772,3627081426,3714645218,1672686869,1672690015,3146
11018,3703725221,3686853863,1672620967,1672623465,2498
10632,3975796415,3534068874,1672560825,1672560963,138
11714,3518995270,3793874490,1672546086,1672546982,896
10576,3229890340,3822315407,1672624696,1672626599,1903
10324,3241682278,3352295704,1672550840,1672554211,3371
10954,3886837151,3701971784,1672604529,1672607593,3064
11503,3534372899,3791628195,1672587408,1672590099,2691
9833,3510244209,3662307789,1672544852,1672545833,981
11039,3306491253,3370751461,1672645591,1672646904,1313
10558,3501205057,3760080378,1672573158,1672574622,1464
11318,3368079099,3515507526,1672542663,1672544851,2188
10141,3352057037,3511526885,1672578871,1672579189,318
11432,3773770134,3501711464,1672531209,1672533079,1870
9798,3783506190,3510218188,1672686037,1672688178,2141
9828,3467944159,3714951681,1672655857,1672657704,1847
10995,3884180202,3777387533,1672599663,1672600987,1324
10613,3360783381,3351856699,1672658540,1672660285,1745
10353,3710819760,3514455363,1672644910,1672647234,2324
10721,3516335333,3776319560,1672644689,1672647306,2617
11271,3505148522,3835599049,1672536297,1672537265,968
11677,3791382196,3436401020,1672695273,1672696124,851
11472,3390438262,3514508773,1672539318,1672541816,2498
10576,3500793739,3351949206,1672585325,1672586985,1660
10703,3714731729,3512504247,1672670379,1672672189,1810
10295,3773408491,3824135033,1672566282,1672566463,181
11169,3711065081,3774448657,1672656361,1672657388,1027
10871,3519886257,3828906027,1672619767,1672621923,2156
10637,3505291330,3927202773,1672659328,1672660589,1261
11635,3403150349,3457249798,1672649907,1672650080,173
10003,3713805968,3362127525,1672687975,1672690176,2201
10866,3452104161,3895944547,1672634947,1672636862,1915
10126,3714897456,3272328752,1672608253,1672609183,930
10954,3559112196,3443102414,1672648772,1672649653,881
10813,3494560663,3311583437,1672626052,1672629444,3392
10420,3710149975,3278071998,1672544586,1672545721,1135
11195,3500674240,3780733404,1672678272,1672679240,968
10263,3935569749,3780352400,1672695886,1672698160,2274
11386,3467756698,3937636109,1672653427,1672653678,251
10394,3311133296,3910049345,1672624923,1672627891,2968
10300,3500018566,3519703964,1672662543,1672663615,1072
9880,3501004005,3378430760,1672587091,1672589166,2075
10439,3534206917,3755411110,1672591802,1672594786,2984
9907,3200785194,3287403291,1672646500,1672647776,1276
10006,3713878219,3817478012,1672559975,1672561156,1181
11065,3517083465,3514327931,1672701109,1672704677,3568
9988,3520471156,3922430928,1672671100,1672674407,3307
10904,3714870496,3515378306,1672618378,1672618570,192
11555,3372236721,3774506868,1672616240,1672618110,1870
10459,3505291330,3791716170,1672620499,1672621511,1012
11060,3518511124,3662507634,1672580975,1672581537,562
11673,3500079479,3930727474,1672539663,1672541834,2171
11355,3302929858,3345896913,1672563300,1672565054,1754
11133,3613703906,3366961580,1672642850,1672643031,181
11302,3534578428,3387621912,1672668326,1672670349,2023
10705,3714116241,3231153513,1672691186,1672694631,3445
10125,3389367628,3500093945,1672594440,1672597492,3052
10329,3776968640,3924963918,1672565699,1672569291,3592
10436,3309415277,3757855416,1672636769,1672638972,2203
10866,3783942518,3830962592,1672685161,1672688295,3134
10832,3701841013,3245755569,1672658300,1672659833,1533
10939,3770630937,3557129226,1672557230,1672557804,574
10698,3387388336,3915962248,1672558059,1672560334,2275
10411,3935333166,3516867729,1672627390,1672627693,303
10829,3500595432,3837435907,1672641923,1672644308,2385
10762,3912915644,3380418745,1672573440,1672575802,2362
10412,3770023722,3836757034,1672675804,1672677497,1693
11006,3888903181,3701028092,1672703539,1672703715,176
11306,3737946004,3336225953,1672614245,1672615564,1319
10746,3703419800,3513186622,1672633859,1672635300,1441
10695,3515699732,3511608609,1672666802,1672668923,2121
11254,3777499535,3711722554,1672591307,1672592743,1436
10987,3501927452,3510882475,1672592062,1672594337,2275
11397,3395069149,3912862842,1672673855,1672675698,1843
11108,3275661834,3501548163,1672546472,1672548423,1951
10368,3510250740,3285587972,1672687068,1672689930,2862
9969,3388774559,3715790104,1672688586,1672689534,948
11238,3516497645,3458753033,1672655882,1672659233,3351
11744,3780466967,3835262447,1672565413,1672567863,2450
9909,3736885568,3714806574,1672621961,1672624543,2582
11367,3776950532,3294326116,1672534725,1672537322,2597
10299,3772689657,3855209450,1672542229,1672543637,1408
9875,3500209015,3974668678,1672674751,1672675546,795
9998,3509626590,3316121649,1672690318,1672693709,3391
9921,3685645561,3505502819,1672641069,1672642823,1754
10194,3423782420,3223512565,1672611088,1672612838,1750
11756,3520057139,3637566026,1672628576,1672631802,3226
10630,3710852576,3505825767,1672645269,1672646989,1720
11520,3244397548,3500671218,1672636162,1672637298,1136
10182,3701218904,3776440009,1672563154,1672566635,3481
11273,3792008302,3756680289,1672582753,1672585517,2764
10976,3711854614,3399173821,1672556541,1672559475,2934
10287,3710107905,3777074709,1672583425,1672584002,577
10405,3517144269,3713416106,1672618112,1672621370,3258
11621,3755942724,3929002318,1672703486,1672705966,2480
10494,3663505156,3240683148,1672690213,1672693608,3395
10602,3364660506,3774606418,1672617669,1672619992,2323
11679,3533365834,3473562779,1672604401,1672607249,2848
9817,3776200012,3500096103,1672696060,1672699537,3477
11695,3736056340,3637522163,1672579136,1672581662,2526
10626,3756647451,3783611957,1672631392,1672634973,3581
11381,3793274957,3930727474,1672566895,1672569214,2319
10474,3663902064,3483701493,1672628837,1672632137,3300
10190,3899903158,3200320674,1672636030,1672638936,2906
11392,3793822639,3310702648,1672679490,1672681963,2473
11121,3772943811,3770391782,1672664980,1672667919,2939
11533,3514776568,3275171954,1672682540,1672682778,238
11562,3681274982,3281148858,1672633257,1672636316,3059
10145,3680075399,3977615973,1672684531,1672687575,3044
10429,3377250778,3756781024,1672692924,1672695880,2956
10182,3916955566,3500015630,1672615609,1672618204,2595
10449,3850904092,3738873928,1672638659,1672640333,1674
11749,3792972270,3375906394,1672585723,1672589218,3495
9998,3224053840,3774965463,1672604092,1672607196,3104
11402,3779604279,3714294005,1672652270,1672654422,2152
10646,3776407517,3757592622,1672567522,1672570045,2523
11005,3770424892,3368848936,1672537900,1672538678,778
10618,3701925712,3516588277,1672543043,1672545849,2806
10837,3773848111,3409514897,1672574878,1672575495,617
10143,3908862092,3517960740,1672691511,1672693393,1882
11644,3301489209,3378430760,1672554179,1672555660,1481
10369,3736010012,3711430738,1672682166,1672685246,3080
11705,3685396470,3906260966,1672543458,1672544554,1096
9951,3512697456,3313579674,1672698511,1672699179,668
11780,3478455812,3422548081,1672648209,1672651635,3426
9977,3468871103,3493679801,1672615138,1672617273,2135
9892,3511199555,3894328297,1672698125,1672701323,3198
10192,3635433296,3355430975,1672544438,1672547314,2876
10662,3500688476,3888409038,1672575608,1672577453,1845
10974,3820922991,3551972633,1672694747,1672697881,3134
10337,3512527440,3713195480,1672598551,1672601866,3315
10634,3898965585,3701359045,1672592677,1672594771,2094
11778,3465672238,3512154443,1672560159,1672562848,2689
9974,3793948300,3509701363,1672677196,1672679862,2666
11051,3793783685,3248409083,1672668407,1672670626,2219
10197,3438818153,3713805968,1672668961,1672669148,187
10351,3770275898,3512490032,1672556361,1672558800,2439
10528,3701291994,3774506868,1672673141,1672673741,600
11061,3450342110,3812277991,1672577679,1672579591,1912
10034,3793987483,3520022175,1672587328,1672590468,3140
10675,3927805949,3519108639,1672571707,1672572543,836
10237,3713219299,3514564903,1672642786,1672644889,2103
10892,3338115824,3557528150,1672698970,1672701289,2319
10033,3510244209,3517113478,1672574656,1672575930,1274
11644,3301332095,3791368349,1672592703,1672595235,2532
10766,3492064037,3512645289,1672633096,1672634092,996
10092,3732533330,3772659062,1672567593,1672570625,3032
11241,3801379377,3600302127,1672564508,1672567592,3084
10154,3715490209,3282053097,1672668161,1672668272,111
10672,3505183641,3710316008,1672693559,1672693856,297
10506,3409514897,3778927933,1672565024,1672566192,1168
10911,3713728777,3933106901,1672602062,1672604172,2110
10792,3557129226,3900195680,1672576815,1672579890,3075
10024,3418683594,3450164574,1672669680,1672670307,627
11295,3513586642,3390438262,1672565838,1672567383,1545
11788,3715700639,3515893948,1672573660,1672576765,3105
10373,3440401725,3895422995,1672598225,1672601810,3585
9994,3452677710,3505836431,1672672041,1672674109,2068
10047,3772556646,3902682060,1672625668,1672628932,3264
10535,3533929043,3517632796,1672606518,1672607610,1092
10535,3505490878,3904846341,1672638240,1672640213,1973
11060,3371759044,3770275898,1672682846,1672684969,2123
11228,3974264211,3407398464,1672610037,1672611334,1297
11504,3380185102,3511028193,1672683111,1672685845,2734
10833,3472718723,3937299996,1672573084,1672576510,3426
10789,3979366845,3823307824,1672575127,1672578182,3055
11322,3285322570,3505037247,1672640238,1672643554,3316
11336,3903115138,3488931357,1672629446,1672630313,867
11628,3760687922,3770764940,1672651567,1672653208,1641
11547,3636927297,3452982957,1672539169,1672542355,3186
11095,3772844451,3793902476,1672536385,1672537251,866
11511,3835262447,3791974273,1672609049,1672611928,2879
10434,3910049345,3770544738,1672638914,1672640622,1708
10947,3778738044,3514980025,1672685794,1672689357,3563
11694,3204821370,3510758718,1672586309,1672589327,3018
10604,3354968884,3791072829,1672659554,1672661438,1884
10394,3757089924,3555954355,1672549256,1672550227,971
11439,3510240661,3669418238,1672638526,1672638794,268
10500,3452878062,3299052917,1672568025,1672569837,1812
11495,3637105495,3512546783,1672604842,1672608417,3575
11716,3442403264,3550206045,1672613428,1672614463,1035
10330,3496579251,3714287902,1672678713,1672681755,3042
10254,3480560014,3509508477,1672676954,1672678460,1506
10259,3612705426,3755203055,1672650948,1672652100,1152
10886,3248061684,3600302127,1672607823,1672608574,751
11064,3512504247,3316821313,1672548585,1672551723,3138
10956,3907039612,3512638952,1672538104,1672540062,1958
11525,3513213122,3783939161,1672570124,1672570621,497
10600,3909220912,3890638402,1672573270,1672573449,179
10583,3770709417,3559112196,1672601421,1672604273,2852
11539,3270607273,3902023467,1672539421,1672541056,1635
11224,3770976984,3776710698,1672683438,1672684785,1347
11130,3715246385,3711671702,1672569121,1672570083,962
10552,3204821370,3770709417,1672703159,1672706246,3087
11174,3452104161,3618024815,1672559840,1672562046,2206
10179,3853182912,3403177609,1672638011,1672638480,469
10326,3778838936,3317989975,1672566268,1672566927,659
9906,3205948776,3888057649,1672591529,1672592008,479
9849,3756948477,3558264627,1672600543,1672603201,2658
10104,3757407184,3839308659,1672685881,1672687529,1648
10379,3713195480,3450234157,1672693802,1672694484,682
10740,3791825536,3919994216,1672603926,1672604182,256
10788,3201634072,3904184638,1672699282,1672701020,1738
10355,3380285779,3636605690,1672623555,1672625955,2400
10516,3512154443,3330466913,1672640690,1672644187,3497
10647,3880000841,3202740652,1672588163,1672588284,121
11169,3818570577,3777149336,1672560257,1672561855,1598
9920,3310021925,3829698950,1672677356,1672677811,455
10816,3287689454,3970851830,1672627925,1672631424,3499
11359,3515304526,3516731917,1672566336,1672568802,2466
10592,3518995270,3732533330,1672544610,1672547248,2638
10461,3713373455,3423940256,1672656457,1672656896,439
11309,3513850048,3380285779,1672642692,1672645087,2395
10642,3350169064,3509677530,1672568438,1672570941,2503
10204,3514329209,3347205332,1672555097,1672558422,3325
10732,3295748489,3509651954,1672547168,1672548659,1491
10898,3756367938,3912915644,1672649767,1672652388,2621
10965,3311514075,3711518637,1672672247,1672673307,1060
10155,3756850160,3505314920,1672701736,1672705295,3559
10716,3777909822,3303772923,1672560252,1672561847,1595
10344,3306475287,3773376762,1672586169,1672586728,559
11336,3512555384,3514013999,1672698020,1672701320,3300
11037,3514776568,3714903253,1672626785,1672627405,620
10994,3760024021,3475845921,1672642590,1672645069,2479
9862,3342027511,3287689454,1672623982,1672627146,3164
11736,3772869013,3600842635,1672605968,1672609539,3571
11753,3735152111,3500909455,1672629318,1672631924,2606
10246,3304697982,3512857020,1672702893,1672704898,2005
10040,3715881104,3500864577,1672624812,1672625566,754
10512,3376487118,3484490325,1672581024,1672582949,1925
11250,3388923880,3783172505,1672649211,1672650004,793
10146,3245642576,3714377201,1672637134,1672638884,1750
11512,3519046342,3757728121,1672661392,1672663227,1835
10421,3973134902,3227956115,1672596515,1672597573,1058
10331,3481365330,3780148144,1672531683,1672531751,68
10634,3515378306,3500776597,1672537245,1672538602,1357
11619,3534284132,3774145748,1672544740,1672547231,2491
9995,3776791436,3713875941,1672643406,1672645469,2063
11263,3370245766,3936486724,1672669737,1672670047,310
10784,3510111365,3360309868,1672601425,1672604861,3436
11053,3509377714,3777729184,1672546811,1672547706,895
11026,3701655378,3760656396,1672644361,1672647896,3535
10382,3315094386,3480259863,1672645273,1672648829,3556
11117,3513140146,3307521389,1672629644,1672632878,3234
10943,3519848902,3773770134,1672638640,1672639073,433
11072,3501711464,3458130310,1672584977,1672586892,1915
10632,3343193067,3516932899,1672590594,1672591938,1344
10294,3756876537,3500734346,1672690007,1672693312,3305
9813,3716733618,3681737865,1672572358,1672575007,2649
10946,3350169064,3513384042,1672609353,1672612871,3518
9877,3381244346,3760396348,1672532674,1672534793,2119
10002,3345954031,3510454018,1672596505,1672596751,246
11437,3904004824,3937636109,1672586666,1672587021,355
11082,3519848902,3850735936,1672573282,1672574936,1654
10281,3475033290,3778909412,1672592749,1672596219,3470
11687,3510278533,3898965585,1672617483,1672619774,2291
11576,3520155898,3710783759,1672565048,1672565756,708
9806,3853386575,3287753579,1672662239,1672663510,1271
10953,3512337054,3777370601,1672543380,1672546034,2654
10418,3372079985,3514005973,1672632264,1672634583,2319
9913,3776593726,3450342110,1672589172,1672590285,1113
10519,3793274957,3425646356,1672676358,1672679628,3270
11555,3513486828,3835982340,1672532073,1672534000,1927
10364,3855674398,3713636175,1672544526,1672546085,1559
10242,3493679801,3778824229,1672626426,1672627743,1317
10747,3425646356,3401215739,1672557458,1672559558,2100
11553,3429333292,3732540636,1672560565,1672562327,1762
10960,3971289056,3510819040,1672544498,1672547824,3326
11622,3887030182,3792432763,1672575400,1672578235,2835
10471,3388481990,3299845453,1672689766,1672691734,1968
11349,3895944547,3350966326,1672549345,1672550588,1243
10371,3792267993,3518209090,1672595631,1672596126,495
9900,3299845453,3273758330,1672628527,1672629412,885
10477,3811503860,3703938162,1672612736,1672612804,68
11692,3858330969,3413799143,1672613930,1672617122,3192
10903,3760679372,3370448531,1672652333,1672654374,2041
10606,3376842515,3778125688,1672535685,1672537002,1317
10960,3416225867,3500544306,1672640311,1672643755,3444
10301,3716976932,3399430522,1672674193,1672677531,3338
11551,3520725149,3607583720,1672599100,1672602413,3313
11139,3772609551,3247075753,1672649879,1672651499,1620
10062,3757064623,3714923092,1672568867,1672572027,3160
10943,3510836047,3465672238,1672618680,1672620401,1721
11121,3468871103,3791074200,1672616431,1672616751,320
10153,3791382196,3668154066,1672533569,1672537029,3460
10496,3701887470,3343859998,1672536291,1672539370,3079
10848,3511028193,3914926436,1672598912,1672599639,727
11600,3713767153,3558203963,1672639739,1672639906,167
11128,3909220912,3612042508,1672612457,1672615681,3224
10684,3440401725,3468343480,1672663501,1672665420,1919
10855,3512826895,3501977123,1672553366,1672554664,1298
11275,3755823805,3776166086,1672618132,1672621033,2901
11501,3776901443,3890211161,1672536061,1672536426,365
10194,3773556853,3511729562,1672612685,1672613053,368
10300,3500198430,3308744016,1672661199,1672664524,3325
11540,3805831563,3757872458,1672689520,1672691023,1503
10238,3366164642,3733423371,1672577076,1672579691,2615
9898,3837271330,3520506192,1672651072,1672653428,2356
11359,3918126468,3403150349,1672566655,1672569700,3045
11773,3822786416,3510795808,1672577742,1672578967,1225
11433,3515655024,3235578852,1672588263,1672589018,755
10849,3908464960,3481019442,1672650446,1672651038,592
10446,3510022922,3776600696,1672594467,1672595292,825
11377,3757728121,3499343927,1672595607,1672596099,492
10042,3520165730,3347520239,1672599516,1672601246,1730
10301,3780173788,3340897079,1672602192,1672604092,1900
11011,3783201950,3505011956,1672596478,1672599577,3099
11766,3311159418,3474852115,1672588056,1672588670,614
9853,3290097447,3398021818,1672547979,1672551493,3514
10051,3436018575,3501261089,1672532707,1672534490,1783
10962,3465227623,3510278533,1672669412,1672671077,1665
10716,3519357822,3311188620,1672640779,1672641610,831
10166,3930475498,3505173665,1672551928,1672554084,2156
11678,3501192566,3427049290,1672662800,1672664391,1591
10498,3444295435,3552309108,1672696716,1672697449,733
11294,3715590997,3791548838,1672531990,1672535106,3116
10933,3856975623,3500596577,1672537785,1672539306,1521
10987,3934611532,3613936929,1672689533,1672689857,324
10472,3304447950,3246062632,1672571676,1672572457,781
11514,3472272792,3207748225,1672604252,1672607426,3174
11243,3461741050,3701028092,1672667501,1672669019,1518
10987,3783563043,3511028193,1672644882,1672645744,862
11340,3519689906,3714116241,1672664204,1672666558,2354
10756,3355430975,3716891903,1672624613,1672627374,2761
11357,3515548696,3622654885,1672610439,1672612025,1586
10767,3974264211,3852310652,1672685406,1672688917,3511
11030,3776166086,3624365837,1672564899,1672568273,3374
11618,3494157939,3682266017,1672624247,1672625323,1076
9809,3285322570,3314965818,1672656133,1672659577,3444
11540,3511645260,3514033319,1672551817,1672552256,439
11450,3792597493,3757378286,1672666118,1672667768,1650
9893,3803996569,3500654356,1672556806,1672556907,101
11259,3513203127,3512802259,1672576420,1672577160,740
10344,3974264211,3520273299,1672632685,1672635471,2786
11190,3777041132,3517426473,1672654942,1672656160,1218
11662,3358211034,3732440502,1672539457,1672541366,1909
11366,3445558740,3919719755,1672648260,1672648821,561
10525,3471131277,3600699873,1672635727,1672636672,945
11029,3716233100,3505037247,1672646983,1672650544,3561
10823,3777729184,3395610742,1672653570,1672653749,179
11067,3812559393,3714312797,1672688527,1672690781,2254
10256,3714516404,3776187150,1672644573,1672647148,2575
10166,3511245705,3737050849,1672556160,1672556321,161
11174,3757198930,3683047199,1672702313,1672702777,464
11466,3770424892,3716676869,1672620987,1672621967,980
9853,3669497617,3773636983,1672692158,1672694981,2823
10303,3772844451,3622654885,1672605507,1672607843,2336
9917,3624164232,3511750850,1672670779,1672672383,1604
11569,3922480066,3288791629,1672565539,1672568926,3387
10471,3623512088,3774682234,1672611086,1672612045,959
11643,3856552205,3428076194,1672690462,1672691116,654
11788,3291446384,3898592058,1672696433,1672697951,1518
10249,3792162098,3533009565,1672621532,1672621646,114
9847,3663353552,3220976338,1672680138,1672681507,1369
10036,3399734748,3757311529,1672550972,1672552874,1902
10711,3509677530,3792972270,1672641068,1672642390,1322
10937,3358385652,3385006834,1672605335,1672607400,2065
11773,3511671476,3484739955,1672663491,1672667002,3511
10464,3817038422,3505314920,1672640546,1672642574,2028
11266,3783967375,3304592684,1672567924,1672568758,834
10732,3303747093,3512306195,1672682308,1672684417,2109
10638,3284334297,3683047199,1672610169,1672610894,725
11594,3918981936,3338016147,1672642950,1672645332,2382
10441,3760232135,3500741534,1672566447,1672567903,1456
9993,3471996194,3511867383,1672680989,1672683771,2782
11731,3757855416,3533726421,1672653874,1672656785,2911
10780,3909067335,3896859936,1672595382,1672596418,1036
11225,3496591885,3623894390,1672696898,1672697831,933
11045,3515655024,3246381831,1672624193,1672624693,500
10911,3834311054,3533365834,1672600273,1672600570,297
11784,3534190196,3776304080,1672590583,1672592860,2277
10933,3311264420,3511794841,1672688186,1672688271,85
11551,3496352027,3365839890,1672671220,1672673709,2489
10368,3884388188,3449233346,1672584495,1672585472,977
10948,3779689733,3701919083,1672634291,1672637302,3011
10038,3500793739,3439283360,1672578999,1672582015,3016
9894,3773083407,3418997135,1672576523,1672576877,354
11747,3500421940,3517021928,1672539499,1672542048,2549
11095,3910049345,3385006834,1672658956,1672661458,2502
10329,3505828210,3711214982,1672541836,1672545130,3294
10464,3442564712,3783043346,1672622194,1672624738,2544
10704,3783408469,3793978936,1672534694,1672537072,2378
10949,3384001094,3756695502,1672589067,1672591055,1988
11240,3778318250,3275057862,1672572166,1672572439,273
10759,3533703578,3355899481,1672668255,1672671432,3177
10513,3292050211,3303772923,1672650052,1672652284,2232
10564,3471131277,3236360179,1672573446,1672575016,1570
11116,3829358750,3515699732,1672655329,1672656932,1603
10153,3505826673,3857344874,1672584988,1672588331,3343
10155,3480259863,3834643026,1672551372,1672554494,3122
11698,3825526565,3501980730,1672685120,1672688068,2948
10022,3287403291,3512411326,1672581727,1672582350,623
10119,3756525103,3446066492,1672692737,1672694307,1570
11275,3505936495,3336501403,1672629051,1672630252,1201
11628,3358982831,3409514897,1672682779,1672686094,3315
10547,3555954355,3427741923,1672581547,1672582799,1252
11188,3358473096,3773394570,1672657791,1672660550,2759
11435,3903088144,3312733562,1672549145,1672549954,809
10053,3922409420,3824657614,1672575192,1672577872,2680
9996,3818461836,3713285095,1672561973,1672563573,1600
10613,3701519251,3793860209,1672538584,1672540770,2186
11565,3739075176,3774401596,1672665338,1672667330,1992
10374,3773826624,3910049345,1672688059,1672689560,1501
9955,3491250381,3518209090,1672563633,1672564040,407
11671,3430399931,3447253775,1672597831,1672597947,116
9824,3500073824,3520824937,1672575442,1672576889,1447
10438,3499820963,3902682060,1672701909,1672703306,1397
11753,3760854788,3774539067,1672688020,1672688605,585
11197,3834424604,3716994924,1672680780,1672682102,1322
11723,3491335890,3714312797,1672671387,1672672744,1357
10395,3793274846,3533225084,1672592028,1672595375,3347
10439,3294952405,3783172505,1672558255,1672558810,555
11776,3780206849,3908331271,1672586759,1672588998,2239
10864,3295748489,3919994216,1672658229,1672659491,1262
10807,3601214648,3669427589,1672682589,1672683580,991
11087,3897107253,3509370633,1672610398,1672613330,2932
10812,3479910993,3635599307,1672553946,1672556315,2369
11770,3905889514,3812677669,1672613693,1672614939,1246
10825,3792972270,3756168814,1672592112,1672593896,1784
11265,3623512088,3755849241,1672563457,1672564906,1449
11204,3362127525,3773394570,1672641281,1672643576,2295
10257,3934991640,3554174421,1672568869,1672570443,1574
10471,3791509334,3731644240,1672619230,1672619759,529
11403,3739297004,3500776597,1672693166,1672695368,2202
11141,3312959324,3518931700,1672665274,1672666236,962
11526,3606688595,3881012415,1672638796,1672640310,1514
10047,3850005949,3491335890,1672539042,1672540033,991
10424,3510291656,3757523596,1672664843,1672666196,1353
9918,3435715962,3904846341,1672591186,1672591660,474
9812,3478915403,3710125627,1672547357,1672548256,899
10699,3472561941,3512288503,1672697121,1672700625,3504
11224,3500654356,3791205793,1672670041,1672671582,1541
10276,3534284132,3902023467,1672686531,1672686655,124
11350,3665478011,3933106901,1672603500,1672604998,1498
10661,3555764822,3240622654,1672646026,1672647368,1342
11573,3227498870,3290797257,1672638604,1672641603,2999
10316,3422314045,3813111107,1672651911,1672652810,899
10674,3358211034,3793442891,1672541355,1672543489,2134
11453,3735422623,3304447950,1672637372,1672640765,3393
10301,3334633634,3533473206,1672665372,1672667767,2395
10739,3716541851,3311924005,1672632611,1672633281,670
11338,3686644062,3511095300,1672632267,1672634192,1925
11672,3428325402,3501619113,1672586501,1672589419,2918
10259,3334936138,3437286595,1672534279,1672534412,133
10226,3760554453,3850904092,1672643219,1672643566,347
11306,3738526914,3937747312,1672600277,1672603429,3152
11328,3776867553,3512477276,1672634925,1672635652,727
10798,3898989233,3777932581,1672666237,1672669368,3131
11610,3534604516,3772019557,1672628525,1672630613,2088
10101,3393909269,3756168814,1672547371,1672548432,1061
10428,3822315407,3856129522,1672651363,1672651996,633
11166,3374147279,3792851584,1672682252,1672685557,3305
11388,3275975921,3930766276,1672659127,1672662480,3353
10683,3500688476,3703443664,1672651215,1672653142,1927
11732,3517132086,3813853446,1672637014,1672639186,2172
10349,3243763209,3755767856,1672699196,1672700299,1103
11579,3444646562,3791532324,1672562042,1672564457,2415
10509,3778932673,3770023722,1672603732,1672606100,2368
10119,3716944983,3770764940,1672684229,1672685023,794
11620,3757406215,3485151614,1672589687,1672591614,1927
10951,3204473480,3711765138,1672654802,1672656409,1607
10967,3919719755,3935333166,1672549376,1672552806,3430
10344,3838119022,3793442891,1672536874,1672539511,2637
11401,3340723781,3715790104,1672638981,1672640369,1388
11645,3302988745,3805926853,1672686164,1672688867,2703
11005,3880788853,3552261072,1672701559,1672703376,1817
10698,3445733121,3239779992,1672621722,1672624591,2869
11177,3780500331,3512857020,1672671014,1672672953,1939
10254,3914947393,3818904268,1672692251,1672694182,1931
11651,3319862687,3738734246,1672653209,1672656239,3030
11630,3514776568,3468201976,1672554590,1672556108,1518
9898,3534081527,3711862792,1672635389,1672638607,3218
10999,3499998389,3404395454,1672533401,1672534661,1260
9960,3667072319,3733953055,1672636738,1672638040,1302
10455,3512965991,3519167605,1672676397,1672679307,2910
10535,3501208658,3611533094,1672640344,1672642676,2332
10971,3928508375,3715204544,1672617512,1672619368,1856
11479,3558567160,3534696810,1672548594,1672548978,384
11756,3760979523,3774939922,1672555393,1672556030,637
10619,3882905311,3898965585,1672648324,1672649477,1153
10375,3225371682,3792851584,1672533619,1672534486,867
10154,3774401596,3774822697,1672593163,1672596737,3574
10557,3380167818,3735152111,1672613136,1672614915,1779
10708,3716475340,3516020922,1672675174,1672677826,2652
10180,3519448648,3509186338,1672620891,1672623599,2708
11545,3501835995,3739217535,1672687614,1672690918,3304
11133,3936871734,3923133978,1672573000,1672573077,77
10793,3713728777,3461741050,1672664441,1672666351,1910
10224,3285515107,3791522832,1672689561,1672690228,667
11221,3914947393,3619796619,1672676716,1672677613,897
10892,3777118499,3559619861,1672556027,1672558143,2116
10156,3783727937,3271762055,1672531287,1672531977,690
11569,3711889178,3780733404,1672537302,1672539238,1936
9994,3494560663,3756066702,1672626076,1672628731,2655
10586,3711722554,3534770827,1672612698,1672614592,1894
11178,3511364193,3805268739,1672692775,1672694985,2210
11547,3514801709,3373135211,1672557108,1672557173,65
10299,3760396348,3776279305,1672566884,1672570201,3317
9843,3885545415,3402580733,1672628806,1672631913,3107
10062,3711671702,3779951373,1672588178,1672591324,3146
11309,3519435459,3306037126,1672626964,1672627945,981
10063,3793274846,3478455812,1672582923,1672584809,1886
10637,3514005973,3779503296,1672581624,1672584297,2673
10707,3760274119,3311409212,1672695279,1672698525,3246
10481,3517136772,3516429380,1672698850,1672702033,3183
11717,3713434898,3445172440,1672689942,1672693401,3459
11305,3850993995,3430310785,1672632591,1672634460,1869
10950,3710147457,3703048107,1672585314,1672586507,1193
11076,3711755596,3856601074,1672575532,1672576741,1209
10748,3423940256,3375257546,1672620603,1672621773,1170
10863,3888523259,3228465044,1672583084,1672583685,601
11479,3429610195,3241855333,1672657580,1672660220,2640
10434,3533593766,3711076751,1672659675,1672660455,780
11540,3773714494,3505908965,1672605316,1672607782,2466
11605,3811503860,3475830203,1672590717,1672593437,2720
11574,3701596047,3428878402,1672555013,1672556733,1720
9919,3485521840,3716492409,1672558890,1672562158,3268
11130,3392482187,3619676231,1672549571,1672550825,1254
10834,3316537706,3903879740,1672583517,1672586750,3233
10151,3778986795,3431317400,1672567156,1672568495,1339
9863,3776534957,3791628195,1672671238,1672673046,1808
9976,3914947393,3792432763,1672658469,1672658949,480
10345,3440743218,3311515179,1672567330,1672567442,112
11017,3822786416,3780352400,1672686796,1672688061,1265
10381,3605905645,3554317844,1672620018,1672620869,851
10472,3515974881,3500415589,1672618390,1672620844,2454
10949,3822786416,3278629965,1672644213,1672647732,3519
11683,3711243126,3756740153,1672612503,1672614546,2043
10550,3780074082,3830771832,1672551788,1672554262,2474
11661,3534278019,3802374620,1672600367,1672603373,3006
10839,3342837214,3605905645,1672601221,1672604508,3287
11772,3355903597,3626631210,1672676595,1672677118,523
11400,3505359060,3756428507,1672534110,1672537385,3275
10909,3512477276,3902292032,1672663737,1672665005,1268
11449,3713224038,3823307824,1672628089,1672630652,2563
11531,3701655378,3533726421,1672699860,1672703404,3544
11421,3899294071,3885147558,1672626511,1672627898,1387
11516,3715852330,3513816744,1672557192,1672560610,3418
11418,3274894848,3714923092,1672680042,1672680107,65
10093,3970265139,3516867729,1672593359,1672593683,324
11009,3891272544,3520515739,1672627981,1672630282,2301
9981,3515715968,3833520635,1672694557,1672695295,738
10029,3243305367,3770941125,1672647206,1672647624,418
10554,3357097510,3367202274,1672599762,1672601217,1455
10025,3359472956,3441336851,1672635864,1672636681,817
11535,3701065296,3760024021,1672581881,1672581954,73
9833,3716595760,3829358750,1672674584,1672675170,586
10707,3289771213,3514673213,1672689188,1672690133,945
10062,3716982179,3519351747,1672604193,1672604750,557
10662,3505032773,3772909073,1672623271,1672624069,798
10648,3791698084,3311529105,1672561329,1672564017,2688
10506,3773840321,3501253130,1672621785,1672622965,1180
10744,3505786561,3625952981,1672599367,1672602196,2829
10558,3238796398,3888642876,1672661828,1672664168,2340
11618,3534372899,3311774510,1672597717,1672600002,2285
11381,3302416197,3500579482,1672688374,1672689143,769
9876,3228997424,3452677710,1672653736,1672656202,2466
9849,3407734098,3205161801,1672633413,1672634423,1010
11486,3772131127,3517151644,1672650799,1672653958,3159
10746,3334824744,3668764192,1672608513,1672609083,570
10464,3500062408,3515944817,1672565303,1672568576,3273
10328,3514926921,3811629200,1672597878,1672598310,432
10736,3928076270,3773161055,1672591126,1672591564,438
11189,3838119022,3225554956,1672611792,1672612256,464
10046,3736941123,3760385591,1672627996,1672628883,887
10140,3512596743,3825932442,1672555192,1672558273,3081
11312,3738760498,3517797610,1672666311,1672669858,3547
10290,3515405509,3626631210,1672637279,1672639205,1926
10485,3715441786,3909504515,1672624191,1672627314,3123
11207,3557129226,3777569538,1672680784,1672683067,2283
11295,3713954144,3450679913,1672535813,1672537998,2185
10349,3934980229,3918126468,1672545779,1672548680,2901
10951,3514673213,3757713457,1672551528,1672553770,2242
10976,3447554599,3714806574,1672534898,1672537905,3007
10322,3703849264,3908862092,1672550755,1672552959,2204
10242,3757198930,3306066522,1672596634,1672598162,1528
11000,3241567995,3411213032,1672649562,1672651659,2097
10841,3773891827,3792162098,1672549447,1672551538,2091
11695,3500555856,3302416197,1672606395,1672607401,1006
11625,3614484939,3417969824,1672646173,1672649259,3086
11412,3881785069,3791542842,1672631965,1672634561,2596
10379,3713954144,3517144269,1672550151,1672553254,3103
11301,3829761380,3371238318,1672627198,1672628186,988
11286,3513629502,3604569804,1672586776,1672587135,359
10449,3756850160,3513143959,1672580550,1672581555,1005
9819,3711765138,3278805844,1672566029,1672567299,1270
9827,3770285500,3896211741,1672657454,1672660967,3513
10009,3979115924,3378430760,1672596924,1672599391,2467
10778,3444397804,3925208102,1672668213,1672671143,2930
11379,3411355804,3510022922,1672637448,1672638373,925
10253,3756736726,3273537848,1672654377,1672655025,648
11761,3511245705,3294164983,1672558339,1672559440,1101
9857,3774598935,3370751461,1672589694,1672592272,2578
10940,3511750695,3511864772,1672615400,1672615496,96
10949,3880549316,3791587717,1672611439,1672612728,1289
10199,3778838936,3638018906,1672568101,1672569031,930
10370,3774447975,3510535683,1672596798,1672597430,632
11535,3240622654,3831864108,1672668274,1672670817,2543
11243,3341985886,3776187150,1672650065,1672650391,326
11376,3776583229,3760144712,1672646287,1672646726,439
10028,3780074082,3221126799,1672638637,1672641594,2957
10990,3774236212,3703419800,1672588765,1672591695,2930
11132,3408982612,3423217578,1672541457,1672544143,2686
11686,3885339157,3516444589,1672620472,1672621293,821
10052,3925098136,3368079099,1672673481,1672674186,705
10738,3488749569,3509073025,1672534693,1672538049,3356
10146,3755286041,3701529552,1672535790,1672537596,1806
11581,3895944547,3501583486,1672686596,1672687497,901
11218,3772291207,3776841808,1672633569,1672634597,1028
10964,3713611960,3755729826,1672566921,1672568644,1723
10961,3209417223,3432466467,1672602908,1672603951,1043
10043,3512337054,3881579907,1672539293,1672540547,1254
9875,3773161055,3713728777,1672669851,1672671971,2120
10921,3791108593,3512251592,1672628570,1672630345,1775
9996,3929355087,3773768643,1672631128,1672634052,2924
11034,3517380144,3421040626,1672613458,1672614440,982
11492,3738734246,3636015050,1672628361,1672630615,2254
11288,3915679140,3732223664,1672537836,1672538481,645
11198,3772882440,3493515706,1672688993,1672690458,1465
10136,3623894390,3714892312,1672605942,1672607074,1132
9794,3482172065,3410602007,1672564212,1672565386,1174
10968,3600871715,3517718901,1672588756,1672590427,1671
10120,3850005949,3831981073,1672614561,1672617998,3437
10050,3780467276,3836136159,1672592904,1672595259,2355
10878,3770544738,3793978936,1672659713,1672662981,3268
10251,3416225867,3922409420,1672629447,1672630533,1086
11692,3909399636,3534758256,1672700309,1672700417,108
11004,3731905251,3622152515,1672539992,1672543350,3358
11589,3446537819,3511003541,1672682423,1672682629,206
10210,3513661302,3391612879,1672535795,1672535903,108
11078,3236512807,3701453343,1672672075,1672672826,751
11172,3400793223,3703896751,1672639380,1672642864,3484
10962,3971422524,3510919509,1672590660,1672590799,139
10605,3783238023,3908862092,1672548858,1672549003,145
11643,3736203662,3444453261,1672570081,1672570285,204
11658,3614112171,3226913558,1672673779,1672676869,3090
11274,3373851012,3509355477,1672602196,1672604644,2448
11375,3445355677,3627377299,1672635437,1672636152,715
9987,3240622654,3668855144,1672593267,1672593913,646
10446,3713728777,3519831322,1672531299,1672532918,1619
11320,3501612813,3367526113,1672583137,1672585256,2119
10654,3680075399,3203151036,1672567324,1672568686,1362
10818,3914353062,3776953418,1672638085,1672638801,716
10552,3472173212,3318220119,1672659370,1672659598,228
10330,3509355477,3779604279,1672682359,1672682830,471
11769,3711404205,3715490209,1672562121,1672562514,393
10560,3914740937,3716669659,1672576368,1672578645,2277
11312,3638071975,3319061210,1672626269,1672628191,1922
9900,3509317054,3440582836,1672548829,1672549648,819
10101,3774598935,3887918622,1672663852,1672665843,1991
11589,3287920864,3511526885,1672612042,1672614596,2554
10042,3735197034,3511580693,1672588344,1672591331,2987
10382,3780435349,3817376705,1672592608,1672594382,1774
9929,3361635547,3760648750,1672674587,1672676352,1765
11342,3711219767,3511580693,1672571349,1672573447,2098
11236,3770924034,3371238318,1672625272,1672626848,1576
11538,3832902787,3837888196,1672646837,1672650105,3268
11674,3715419141,3434052463,1672606406,1672606953,547
10564,3776187150,3509996827,1672623279,1672626226,2947
10301,3932491622,3681274982,1672563441,1672566116,2675
10837,3755154460,3834311054,1672609503,1672610239,736
10356,3608973523,3854957153,1672666605,1672668454,1849
11662,3343616490,3519621901,1672544293,1672547778,3485
11517,3776166086,3513384042,1672682354,1672682800,446
9820,3505697295,3294952405,1672674871,1672676417,1546
10733,3500624846,3446066492,1672573467,1672574596,1129
10599,3757944870,3756890980,1672637020,1672637604,584
10655,3757584114,3773768643,1672582179,1672584408,2229
11185,3516655509,3623894390,1672592753,1672593592,839
10048,3770285500,3711945923,1672533156,1672534332,1176
10029,3438818153,3347996015,1672631301,1672633146,1845
11013,3715111016,3713416756,1672539143,1672539611,468
10578,3714065165,3613781977,1672663130,1672665003,1873
11017,3353326305,3661359073,1672587864,1672590272,2408
10978,3613781977,3387413950,1672636815,1672639143,2328
10787,3756536512,3515577866,1672642256,1672642576,320
11675,3512480125,3739567072,1672608017,1672608699,682
10666,3714923092,3509508477,1672568190,1672571381,3191
11502,3601340045,3500927619,1672655543,1672657221,1678
10398,3436774112,3245501577,1672684008,1672684682,674
11455,3222364320,3514361485,1672636310,1672639737,3427
10158,3209075485,3933872044,1672686295,1672688542,2247
11112,3515047288,3760271237,1672686349,1672687327,978
11629,3617771673,3297684667,1672664156,1672667656,3500
10682,3888409038,3416105769,1672675495,1672677318,1823
10866,3336225953,3358530225,1672664218,1672665015,797
10510,3490008012,3730600658,1672590136,1672592835,2699
10762,3312651192,3471507117,1672655084,1672655440,356
10698,3353194923,3304252969,1672637653,1672639597,1944
10478,3934611532,3770846374,1672700176,1672701014,838
11298,3404395454,3553640169,1672539384,1672539812,428
10060,3517380144,3533728729,1672648460,1672650636,2176
11215,3287821258,3783563043,1672643403,1672645530,2127
11758,3515970536,3519162582,1672682815,1672684723,1908
10855,3896622009,3714595459,1672624430,1672626951,2521
11052,3416105769,3827889533,1672587389,1672588764,1375
10891,3497562878,3904184638,1672558773,1672561401,2628
10803,3352295704,3433196933,1672540461,1672541480,1019
11748,3513203127,3806034626,1672550924,1672553640,2716
11043,3500741534,3701519251,1672532139,1672535361,3222
10043,3400560073,3609103278,1672702123,1672704236,2113
10842,3710223875,3710695372,1672540927,1672541003,76
10925,3777204977,3715587520,1672647858,1672650402,2544
11470,3505190512,3780982229,1672588838,1672592305,3467
10714,3851451801,3511069449,1672635354,1672638743,3389
10538,3516517348,3756784813,1672541144,1672541240,96
11151,3739217535,3513545735,1672696328,1672698804,2476
11066,3793874490,3330238204,1672640009,1672640706,697
10002,3880562532,3293540333,1672692477,1672692702,225
10852,3499998389,3755924094,1672699157,1672700478,1321
10686,3304672737,3882905311,1672565471,1672565802,331
10598,3511289729,3340897079,1672687473,1672687551,78
10862,3772556646,3534667712,1672574562,1672574959,397
9900,3481700413,3779478448,1672658812,1672661244,2432
10336,3714179543,3776304080,1672613553,1672614855,1302
11483,3613940925,3512411326,1672579673,1672581496,1823
10216,3714471069,3209958726,1672550203,1672550705,502
11647,3468066881,3757406215,1672580266,1672580763,497
11151,3773736248,3667950469,1672642272,1672643188,916
10999,3914947393,3973582279,1672591697,1672593191,1494
10132,3501873139,3857590978,1672555412,1672558164,2752
10601,3756736726,3534506090,1672662368,1672665488,3120
11291,3505291330,3372236721,1672651123,1672651542,419
11093,3509394912,3776534957,1672566118,1672566813,695
11696,3687445224,3783201950,1672700911,1672701377,466
10813,3514628916,3501759031,1672661213,1672664313,3100
11410,3304235700,3773714494,1672567148,1672568702,1554
10237,3510439480,3783043770,1672684631,1672686602,1971
10351,3510535683,3505482210,1672672062,1672673640,1578
9990,3710260848,3887918622,1672666735,1672669853,3118
9891,3369810091,3373851012,1672563566,1672565724,2158
11252,3485521840,3533703578,1672694936,1672697513,2577
10254,3682266017,3777655401,1672557555,1672559059,1504
9836,3711076751,3830254808,1672620311,1672621924,1613
10208,3936871734,3447253775,1672570001,1672573002,3001
9986,3627081426,3701493094,1672608919,1672610502,1583
10856,3927805949,3776183353,1672628038,1672628678,640
9801,3500062408,3534506090,1672640446,1672642752,2306
10490,3711755596,3773579644,1672622012,1672625336,3324
10180,3783809405,3757773786,1672573041,1672575121,2080
10819,3932955949,3474074188,1672610846,1672612051,1205
10850,3505331014,3776319560,1672687887,1672688734,847
10547,3886879696,3380285779,1672676861,1672680349,3488
11004,3770780655,3559221089,1672555145,1672556532,1387
11141,3711258452,3703779674,1672676545,1672677902,1357
10558,3703474558,3351728355,1672680855,1672684288,3433
10702,3519055736,3318056480,1672672158,1672673736,1578
10045,3714471069,3825932442,1672701715,1672704019,2304
10334,3334381941,3770981604,1672655679,1672657451,1772
11343,3857847527,3501927452,1672698566,1672701434,2868
11594,3852461753,3779282072,1672582388,1672582695,307
10314,3501253130,3399734748,1672676918,1672678790,1872
9859,3716801088,3534204885,1672634215,1672637584,3369
9953,3703462221,3500889287,1672575607,1672579097,3490
9887,3632720032,3209280342,1672617598,1672620248,2650
11227,3884180202,3509370016,1672674235,1672675030,795
11339,3905955166,3773848111,1672531272,1672532004,732
11377,3436401020,3666958814,1672642083,1672644257,2174
11099,3420664407,3517426473,1672637870,1672639370,1500
10103,3716209499,3511382748,1672667662,1672668991,1329
10483,3463883997,3394986304,1672634896,1672636491,1595
11736,3710680073,3772893815,1672691229,1672693625,2396
9834,3229621693,3837378340,1672622937,1672625445,2508
9805,3500421940,3519255644,1672585020,1672588604,3584
10486,3757446082,3837887478,1672539342,1672542588,3246
11722,3893950585,3394364348,1672554313,1672555764,1451
10723,3894328297,3443521234,1672615216,1672615534,318
11324,3510373076,3367526113,1672639995,1672643342,3347
11167,3633949990,3701887470,1672538112,1672541543,3431
11589,3714065165,3501427691,1672656254,1672656471,217
11196,3411626917,3501174621,1672697901,1672699923,2022
11597,3519034304,3505066871,1672690295,1672693345,3050
10002,3297624618,3430399931,1672569280,1672570543,1263
9888,3703419800,3297684667,1672699420,1672703000,3580
11212,3301403047,3208560443,1672565699,1672568810,3111
11687,3632720032,3334936138,1672636113,1672637478,1365
10401,3778544203,3939422411,1672591480,1672593292,1812
11403,3499142934,3716341323,1672540144,1672540439,295
11327,3836586875,3905571273,1672543840,1672544223,383
10701,3776811587,3511296895,1672632324,1672632798,474
11606,3903879740,3282053097,1672583830,1672586679,2849
10336,3519165527,3305656670,1672641045,1672641878,833
10079,3756367938,3616242727,1672638710,1672640345,1635
10722,3428198021,3897500723,1672640997,1672641234,237
10892,3295748489,3380167818,1672583083,1672585302,2219
11608,3780013266,3227647190,1672532700,1672535298,2598
9917,3832002939,3713100169,1672577043,1672578682,1639
11682,3777909822,3362706073,1672693717,1672695973,2256
11064,3512480125,3774035405,1672645074,1672648362,3288
11546,3512638952,3305612422,1672532343,1672535560,3217
10205,3354877289,3520344592,1672567170,1672570746,3576
11344,3627081426,3396453219,1672591060,1672593443,2383
10981,3411355804,3715590997,1672532201,1672532808,607
9989,3533627473,3418791124,1672577788,1672580708,2920
11336,3791628263,3817120976,1672593159,1672595931,2772
9877,3834424604,3607288879,1672565657,1672569189,3532
10277,3701779683,3355903597,1672587920,1672591090,3170
10387,3760801237,3488887919,1672698932,1672700819,1887
10585,3501600785,3713566527,1672663098,1672665767,2669
10470,3760749218,3733953055,1672645858,1672647084,1226
10151,3477951091,3772489471,1672652521,1672655521,3000
10259,3371497614,3505190512,1672675760,1672676202,442
11629,3458130310,3466149998,1672601694,1672603655,1961
9835,3893950585,3606688595,1672680808,1672683423,2615
10086,3791905743,3760481622,1672620908,1672622270,1362
11399,3316537706,3491948594,1672569972,1672572081,2109
10456,3780173788,3902300755,1672624699,1672627579,2880
11159,3343767438,3821082558,1672593981,1672595976,1995
9857,3852310652,3287683210,1672548129,1672550204,2075
10420,3826068495,3402774497,1672559296,1672559925,629
10773,3352374868,3512641538,1672534163,1672534899,736
10358,3755502373,3780648744,1672638466,1672639183,717
11065,3466655775,3336225953,1672628782,1672629839,1057
11740,3518209090,3457249798,1672568997,1672570969,1972
9840,3857590978,3501759031,1672665045,1672666425,1380
10591,3517149023,3495427619,1672603167,1672606571,3404
10461,3927675706,3505010941,1672551677,1672553085,1408
11375,3886879696,3471585513,1672647961,1672648625,664
11369,3897107253,3511364193,1672610182,1672611602,1420
10541,3899205452,3627358016,1672574262,1672575590,1328
10643,3520471156,3458271585,1672662518,1672664007,1489
11110,3512251592,3501976169,1672665924,1672668756,2832
10371,3514244308,3774483862,1672628913,1672629359,446
11408,3513186622,3403870769,1672653744,1672655992,2248
11451,3776348472,3305657559,1672647894,1672650470,2576
11526,3713875941,3510819040,1672696181,1672696688,507
10447,3779975575,3979366845,1672640077,1672642088,2011
9903,3783826338,3488399075,1672582331,1672582481,150
10664,3487278983,3304028109,1672682282,1672682465,183
10149,3420854927,3636015050,1672645775,1672647439,1664
11320,3510638085,3713954144,1672674483,1672677977,3494
10511,3355899481,3418997135,1672678431,1672681234,2803
11351,3917905192,3624872714,1672686338,1672687560,1222
11524,3516463579,3772648837,1672598622,1672602055,3433
11351,3510836047,3233993993,1672583942,1672586092,2150
11082,3783594246,3517992521,1672653032,1672653268,236
11305,3311904032,3452677710,1672689984,1672693114,3130
11293,3473562779,3818461836,1672682517,1672685402,2885
11012,3927805949,3730600658,1672631364,1672632161,797
11565,3516867729,3407403080,1672558074,1672558342,268
9907,3660163550,3345896913,1672698058,1672700544,2486
9809,3501126057,3511615015,1672622552,1672625050,2498
10647,3710680073,3347172556,1672533413,1672535213,1800
9994,3607583720,3510542303,1672608875,1672611764,2889
10015,3783594729,3793719515,1672664109,1672666154,2045
10240,3812261241,3680988889,1672621022,1672623213,2191
10064,3512371853,3287920864,1672581888,1672582786,898
11422,3776455762,3682673884,1672678662,1672681487,2825
11237,3447591143,3780626668,1672568003,1672570644,2641
11310,3666367524,3519724388,1672573050,1672574468,1418
11112,3361789225,3730414796,1672644218,1672646815,2597
10661,3501873139,3757523596,1672657104,1672657214,110
11694,3629869834,3792785261,1672558507,1672560693,2186
10561,3534578428,3224053074,1672539147,1672542208,3061
10222,3802101760,3735152111,1672663593,1672663896,303
11379,3559759778,3435801763,1672546395,1672547683,1288
10232,3774633364,3732871856,1672636160,1672637137,977
11121,3715246385,3731905251,1672600425,1672602883,2458
10154,3774744663,3732540636,1672533116,1672534995,1879
9966,3713336088,3312946269,1672700346,1672700791,445
10943,3485521840,3294949958,1672672040,1672672355,315
10157,3457249798,3907245259,1672576357,1672579914,3557
11343,3520182275,3681274982,1672608645,1672610451,1806
10010,3289258397,3772019557,1672675233,1672677680,2447
10243,3534758256,3338115824,1672580847,1672581809,962
11030,3343616490,3501271930,1672640240,1672641284,1044
10014,3382746533,3757549235,1672541213,1672543677,2464
9847,3777204977,3240443426,1672586282,1672586908,626
10325,3318224774,3489340327,1672634675,1672635434,759
11280,3884369346,3505496725,1672580931,1672582529,1598
9821,3555763674,3791758175,1672646767,1672650170,3403
10489,3772786559,3351728355,1672609450,1672610196,746
9928,3440401725,3686860179,1672551288,1672553130,1842
10310,3660702754,3783368855,1672682579,1672684820,2241
11632,3894328297,3613781977,1672653310,1672656162,2852
10205,3932566114,3714142299,1672542438,1672544126,1688
10357,3618672178,3818461836,1672691812,1672694848,3036
10076,3688768189,3689386663,1672590853,1672592738,1885
10163,3688870751,3245882008,1672683154,1672685446,2292
11029,3554174421,3471131277,1672691107,1672694389,3282
9850,3520165730,3774539067,1672630846,1672632708,1862
11589,3760396348,3716492409,1672671844,1672673287,1443
9820,3435342362,3487622510,1672624990,1672626515,1525
11021,3791031227,3929355087,1672688595,1672690071,1476
10525,3425646356,3710819760,1672591299,1672593548,2249
11118,3894328297,3208519320,1672694488,1672696586,2098
10488,3447554599,3311305760,1672655479,1672655938,459
11184,3881579907,3347996015,1672618298,1672619041,743
11746,3272827860,3449233346,1672702022,1672703206,1184
11544,3713878219,3854229296,1672610484,1672612470,1986
11360,3884458862,3805831563,1672690648,1672690911,263
10630,3239401337,3518067857,1672597452,1672597843,391
10112,3837888196,3780352400,1672601468,1672602734,1266
10346,3638035545,3713374884,1672535573,1672536891,1318
11599,3417223898,3808442442,1672648861,1672651115,2254
10723,3501205057,3201502111,1672563662,1672565242,1580
10003,3345028045,3505500665,1672541876,1672544024,2148
11776,3974400577,3283295213,1672589227,1672589900,673
10176,3205113625,3755361692,1672580589,1672583502,2913
10366,3756168814,3450234157,1672581807,1672584774,2967
10597,3711196962,3791863922,1672640297,1672641478,1181
10684,3501980730,3924366353,1672682510,1672685858,3348
10253,3774606418,3938021614,1672578430,1672581910,3480
11341,3512480125,3516019206,1672579442,1672581641,2199
11210,3319660530,3772659062,1672624759,1672625271,512
10212,3239279744,3713107380,1672560827,1672563883,3056
10037,3755502373,3415840750,1672666917,1672669497,2580
11602,3778382224,3533593766,1672608169,1672611435,3266
11299,3927202773,3405200303,1672648958,1672650195,1237
9847,3511218261,3505416534,1672542439,1672543850,1411
9956,3509556649,3318250647,1672560492,1672562279,1787
9934,3533113740,3518335611,1672602935,1672604577,1642
9833,3201656220,3509562377,1672696016,1672697379,1363
11131,3486824047,3284829602,1672628147,1672630258,2111
11058,3620157388,3819400315,1672681555,1672684279,2724
11425,3911431642,3733953055,1672643686,1672644225,539
10291,3404461403,3832002939,1672658664,1672661198,2534
10747,3826315540,3755729826,1672539574,1672542790,3216
10469,3511750695,3515974881,1672645693,1672647912,2219
10815,3757639274,3468871103,1672601353,1672602454,1101
10949,3755465396,3711599043,1672555527,1672556559,1032
11708,3401215739,3976225898,1672561610,1672564702,3092
11165,3311959533,3738429905,1672632871,1672633426,555
11342,3701529552,3338465050,1672634439,1672637265,2826
10991,3476308535,3601340045,1672566743,1672568974,2231
11125,3494680853,3512641538,1672628930,1672632304,3374
10077,3247075753,3791351852,1672687691,1672691282,3591
11171,3500211484,3635599307,1672550590,1672553357,2767
11249,3900793652,3519841427,1672608387,1672608736,349
9924,3793699467,3792012147,1672671354,1672674588,3234
9964,3505521491,3477951091,1672662685,1672663676,991
9994,3353335252,3776593726,1672692743,1672693237,494
11275,3374552204,3440671139,1672646007,1672648202,2195
11250,3500049870,3773017746,1672658672,1672659944,1272
10137,3500595432,3483701493,1672677649,1672678703,1054
11108,3509186338,3505032644,1672691085,1672691461,376
10751,3207748225,3928508375,1672580445,1672582585,2140
10108,3517469005,3859191694,1672604100,1672605731,1631
9925,3393376416,3281148858,1672682376,1672684002,1626
11715,3518572231,3517718901,1672537368,1672537626,258
11242,3514776568,3510149298,1672579175,1672579794,619
9961,3514638555,3777655401,1672538033,1672540730,2697
9843,3478052226,3477248170,1672702353,1672705546,3193
10768,3821087562,3511341866,1672628723,1672629386,663
11758,3393001196,3311142523,1672585670,1672586385,715
10249,3461931154,3509457543,1672574119,1672575234,1115
11526,3385416697,3285971415,1672538763,1672538940,177
9833,3501853868,3714645218,1672604121,1672607327,3206
11586,3779609338,3807646028,1672555413,1672557527,2114
9923,3301765144,3621812406,1672551716,1672551812,96
10348,3772609551,3407734098,1672699146,1672700703,1557
10502,3711671702,3409078869,1672609425,1672611510,2085
10830,3713224986,3780482864,1672618537,1672621888,3351
10906,3701284535,3516651799,1672628410,1672628743,333
11179,3783172505,3881785069,1672624670,1672625624,954
10369,3776447604,3680988889,1672684425,1672686304,1879
11091,3509370016,3757060033,1672625381,1672627562,2181
11408,3533440736,3852992961,1672554396,1672555882,1486
11021,3814672661,3367242388,1672532508,1672533089,581
11274,3519908593,3519908593,1672607675,1672609917,2242
11152,3399430522,3454924050,1672547870,1672551362,3492
10223,3517469005,3514352989,1672557968,1672560252,2284
10355,3703722212,3855440101,1672582477,1672586010,3533
11496,3222364320,3910190872,1672535503,1672538669,3166
10070,3737571883,3760274119,1672694110,1672696655,2545
9868,3500209015,3510916875,1672669834,1672672680,2846
10973,3332124606,3510486220,1672547240,1672547315,75
10818,3505500665,3783651407,1672674199,1672677741,3542
10005,3773697080,3905571273,1672606977,1672609847,2870
11551,3518511124,3501115299,1672616786,1672617295,509
10449,3715419141,3974400577,1672549558,1672552746,3188
11510,3925823748,3756642173,1672538573,1672541844,3271
11774,3515804844,3311414429,1672535645,1672536349,704
11233,3760416450,3241855333,1672565137,1672565840,703
10565,3515378306,3300810210,1672561292,1672563539,2247
10516,3711029952,3609103278,1672577134,1672578753,1619
11774,3230612965,3277634944,1672656828,1672658388,1560
10051,3635599307,3278779955,1672531227,1672531817,590
10656,3891586951,3221290808,1672583341,1672584381,1040
11757,3406169279,3603682643,1672675019,1672675407,388
11126,3520182275,3977615973,1672639765,1672641503,1738
10448,3201656220,3513186622,1672661364,1672662943,1579
9954,3666022373,3783357035,1672556265,1672557862,1597
11719,3519356606,3304447950,1672620161,1672621097,936
11484,3636885498,3462645981,1672623904,1672625916,2012
10668,3665603628,3299845453,1672577855,1672579460,1605
11549,3550405857,3714718326,1672597602,1672600913,3311
10705,3516067011,3710125627,1672593382,1672596460,3078
11355,3760979523,3710060386,1672539877,1672541026,1149
11572,3630462406,3439532406,1672570497,1672572573,2076
10997,3374652108,3520189871,1672579494,1672582746,3252
10148,3277061226,3238310644,1672605477,1672606319,842
10493,3201920708,3792008302,1672677608,1672680448,2840
10215,3777767907,3934070285,1672633365,1672634851,1486
10416,3714658474,3235074007,1672603784,1672605961,2177
10231,3318250647,3902682060,1672588336,1672590921,2585
9949,3501574882,3760679372,1672588303,1672590883,2580
10272,3274239253,3835599049,1672605211,1672606916,1705
10362,3520344592,3352374868,1672539209,1672542206,2997
11490,3509828883,3817076003,1672632774,1672635199,2425
10372,3780749789,3378172464,1672575847,1672577008,1161
10813,3716341323,3755779925,1672649594,1672651887,2293
9872,3918126468,3779930476,1672541393,1672544341,2948
11786,3770476738,3505816624,1672549150,1672551422,2272
10579,3302348002,3388463477,1672574712,1672574823,111
10106,3501515425,3793948300,1672563706,1672566165,2459
10177,3662522808,3891586951,1672537186,1672540651,3465
11495,3684108920,3710819760,1672626797,1672627892,1095
11602,3756784813,3713767153,1672627148,1672629165,2017
9958,3756066702,3509208005,1672691045,1672691762,717
10179,3411213032,3756525103,1672557200,1672557425,225
11304,3533209168,3773083407,1672688786,1672691882,3096
10816,3487988841,3739567072,1672613782,1672614365,583
11735,3665841655,3501988762,1672550269,1672552245,1976
10626,3791031227,3223144610,1672660550,1672662832,2282
10029,3791368349,3637522163,1672701343,1672704418,3075
11068,3778182724,3511650296,1672681939,1672684743,2804
10793,3369558911,3433902955,1672595212,1672595944,732
10829,3319529422,3777751979,1672556707,1672558400,1693
10127,3519352855,3777932581,1672555363,1672556790,1427
9877,3776053084,3630802959,1672569883,1672572045,2162
10477,3756998113,3776187150,1672654833,1672657169,2336
11665,3778195766,3399504157,1672663199,1672665142,1943
11032,3533113740,3500624846,1672548401,1672550514,2113
9836,3516792348,3817120976,1672589626,1672592853,3227
10814,3837888196,3739395381,1672552971,1672556427,3456
11575,3919349138,3778479297,1672609323,1672609599,276
10904,3625931630,3516103646,1672580398,1672580571,173
11203,3792337863,3518408734,1672673831,1672674586,755
10237,3791509881,3912181197,1672601355,1672602269,914
11614,3836586875,3511095300,1672650584,1672654070,3486
11528,3513563152,3793949077,1672585112,1672587087,1975
11031,3774145748,3713224986,1672598994,1672599940,946
11259,3515230715,3319645922,1672584619,1672585972,1353
10038,3516378356,3509382404,1672564287,1672566352,2065
11583,3512871568,3668681400,1672566972,1672568684,1712
11578,3385481989,3201957157,1672542255,1672544202,1947
9907,3361789225,3533427742,1672651348,1672652940,1592
10588,3855077502,3482786946,1672554638,1672557144,2506
9892,3358982831,3711856534,1672622658,1672623110,452
11641,3355430975,3501557463,1672671479,1672674054,2575
10361,3773134128,3518408734,1672676276,1672676925,649
10318,3772223331,3739567072,1672620197,1672620891,694
10127,3629869834,3510801769,1672568672,1672570160,1488
11442,3780500764,3834311054,1672551966,1672555525,3559
10097,3412605548,3519937708,1672698144,1672698388,244
10606,3288791629,3770972037,1672581788,1672582385,597
11085,3316117186,3915679140,1672691794,1672695093,3299
11613,3792107875,3715737742,1672667021,1672668847,1826
10028,3701925712,3783313202,1672587362,1672587927,565
11306,3338195686,3450164574,1672649524,1672650707,1183
9923,3783947742,3520926977,1672598734,1672602065,3331
11128,3347140733,3394986304,1672536901,1672540314,3413
11028,3509297453,3774706478,1672547592,1672549404,1812
11689,3770846374,3342252701,1672626673,1672628996,2323
11140,3511969443,3904045870,1672567422,1672567510,88
9944,3920116284,3910190872,1672552657,1672554889,2232
10120,3515764058,3358211034,1672542797,1672543423,626
10231,3611298237,3355430975,1672537608,1672539528,1920
9797,3519754667,3715291931,1672620618,1672622944,2326
11476,3488887919,3500720752,1672610115,1672611335,1220
10626,3776440009,3703572036,1672697283,1672699112,1829
11556,3710296607,3770925016,1672609225,1672610683,1458
11639,3826418889,3516517348,1672683089,1672684743,1654
10089,3306491253,3474074188,1672691983,1672693997,2014
11688,3513293711,3512726649,1672559363,1672562036,2673
10036,3732540636,3776122272,1672649903,1672653426,3523
10949,3774539067,3350169064,1672658144,1672659420,1276
11189,3480259863,3733243990,1672593777,1672594011,234
11205,3828906027,3493047640,1672577876,1672578995,1119
10146,3514698862,3533427742,1672663573,1672665474,1901
11709,3780563627,3505502819,1672643295,1672646239,2944
10656,3703659324,3780563627,1672636504,1672639965,3461
9975,3459951739,3755154460,1672647769,1672650396,2627
11722,3515726910,3519754667,1672670623,1672673349,2726
11115,3519102732,3973134902,1672658994,1672659610,616
11623,3500433278,3770018912,1672623849,1672626258,2409
11234,3520155898,3716209499,1672700224,1672701578,1354
11654,3271780525,3332840671,1672566741,1672568366,1625
11588,3517499844,3851737350,1672672570,1672673007,437
10661,3500591274,3710051427,1672691799,1672693421,1622
9866,3899970524,3776617627,1672695369,1672696105,736
11186,3711287751,3248061684,1672654218,1672655492,1274
10784,3777200549,3510894809,1672645836,1672647371,1535
10696,3793822639,3510864325,1672687597,1672690594,2997
11785,3373018943,3501225887,1672616683,1672617037,354
11516,3200320674,3628556590,1672684155,1672686860,2705
10619,3287683210,3442403264,1672679454,1672679984,530
11035,3778738044,3776901443,1672585126,1672585831,705
10491,3205113625,3511466117,1672681427,1672684880,3453
10477,3347520239,3774822697,1672649291,1672652813,3522
10902,3516651799,3554236075,1672532190,1672535395,3205
10552,3793081195,3295530454,1672577529,1672579400,1871
10287,3737738751,3378430760,1672652756,1672653296,540
10349,3533265491,3333505404,1672676743,1672679207,2464
10981,3510801769,3298831109,1672581415,1672584200,2785
9941,3516792348,3505901826,1672571122,1672572677,1555
10810,3249380931,3756890980,1672564121,1672564936,815
11726,3625952981,3239779992,1672655451,1672657275,1824
10459,3487988841,3447948483,1672575219,1672577324,2105
11163,3511078598,3791031227,1672540550,1672544110,3560
11153,3939422411,3511963020,1672539583,1672541978,2395
10747,3931164237,3710296607,1672615958,1672616028,70
10984,3501225887,3510250740,1672547752,1672549877,2125
11398,3418367752,3735679000,1672605402,1672608695,3293
11213,3776778306,3392573386,1672684610,1672686028,1418
11704,3517627003,3500720752,1672629322,1672631449,2127
10172,3701956841,3812677669,1672693569,1672694280,711
10892,3384713976,3772461583,1672692883,1672695471,2588
10584,3757064623,3519297683,1672627840,1672630745,2905
10138,3347140733,3778817220,1672688649,1672691663,3014
11063,3443004958,3513186622,1672569287,1672571076,1789
11317,3388830370,3534667712,1672550022,1672552794,2772
10126,3755170743,3515470462,1672555316,1672555530,214
10012,3239279744,3792682835,1672683970,1672685593,1623
11060,3441683673,3778544203,1672542342,1672544862,2520
11469,3306475287,3279102372,1672619289,1672619787,498
10415,3300810210,3703438617,1672692326,1672692550,224
10905,3778741325,3398151217,1672592078,1672592625,547
10881,3711947828,3686644062,1672561147,1672561645,498
11296,3977880564,3482172065,1672614798,1672615152,354
10785,3388463477,3510864325,1672577575,1672579861,2286
10409,3224053074,3716341323,1672658403,1672660705,2302
10854,3882905311,3317190427,1672614632,1672617043,2411
11425,3891272544,3220123678,1672622089,1672622243,154
11478,3533642281,3236206821,1672691655,1672694416,2761
10683,3919984986,3774145748,1672679524,1672679832,308
11547,3713471446,3793364952,1672547467,1672548510,1043
10615,3792597493,3639926564,1672659044,1672660546,1502
11425,3772968080,3701453343,1672661897,1672664737,2840
10806,3311810583,3776953418,1672618147,1672620295,2148
11705,3335139032,3439651226,1672649089,1672651185,2096
11281,3755849241,3792012147,1672656344,1672659550,3206
10112,3615245840,3512417724,1672700644,1672701892,1248
11042,3791205793,3439651226,1672547973,1672550283,2310
10904,3615846003,3931767736,1672649910,1672651477,1567
10044,3779815753,3710260848,1672702424,1672704923,2499
9806,3425545115,3701770921,1672633229,1672633977,748
10325,3366501813,3714902042,1672625571,1672627199,1628
9845,3683514731,3418791124,1672536580,1672538399,1819
10772,3777263928,3452389513,1672615264,1672615962,698
10726,3496407500,3450503086,1672598546,1672600755,2209
10425,3337673625,3287968403,1672658038,1672658197,159
10030,3461743188,3972856326,1672601051,1672604285,3234
10571,3458753033,3978643889,1672538301,1672539489,1188
11287,3916955566,3715622084,1672700749,1672702600,1851
11251,3440743218,3827889533,1672556034,1672557638,1604
9839,3909822999,3639926564,1672676943,1672679344,2401
11752,3423353911,3313282478,1672652209,1672652882,673
10866,3459799131,3772877723,1672638130,1672640727,2597
10996,3359012188,3755361692,1672679651,1672682401,2750
11688,3378430760,3342252701,1672626259,1672629512,3253
11663,3245642576,3774029494,1672703309,1672703865,556
10342,3313502623,3703999217,1672698814,1672701902,3088
9917,3509252934,3514389188,1672664138,1672667248,3110
11673,3344478603,3792851584,1672639459,1672641777,2318
11347,3711810268,3511182297,1672613278,1672615014,1736
10715,3382757142,3851515560,1672633649,1672634962,1313
10673,3714923092,3311200541,1672668053,1672669546,1493
10993,3517645656,3511382748,1672597192,1672600078,2886
10819,3464622743,3713373455,1672609854,1672612380,2526
11098,3289258397,3511969443,1672685647,1672685899,252
10077,3516777819,3247193800,1672691217,1672694699,3482
9882,3783060739,3793222045,1672553712,1672557016,3304
11243,3533225084,3776710698,1672608591,1672610575,1984
9859,3512417028,3509379617,1672681685,1672682277,592
10561,3701769970,3710008760,1672667340,1672670132,2792
11070,3680278447,3553229537,1672655610,1672658343,2733
11610,3501835995,3852461753,1672664741,1672666530,1789
11205,3514361485,3660176760,1672646311,1672648115,1804
10255,3779505358,3774792696,1672602241,1672605160,2919
10906,3760854788,3438028077,1672680640,1672682705,2065
11410,3515699732,3732467455,1672680728,1672682036,1308
10507,3791074200,3444881567,1672539937,1672541595,1658
10019,3623953446,3791542842,1672546515,1672549206,2691
10174,3780680252,3757678397,1672573304,1672574015,711
9819,3511078598,3316406470,1672669137,1672670454,1317
11730,3757851680,3442403264,1672631637,1672631873,236
10759,3903065952,3760232135,1672579694,1672580615,921
10567,3500931474,3791863922,1672669648,1672670362,714
10043,3607288879,3773798215,1672559063,1672561415,2352
11000,3970775805,3701350519,1672675280,1672675898,618
10111,3975799349,3443102414,1672584851,1672585246,395
10121,3311142523,3755630085,1672561779,1672562247,468
9936,3755229631,3334824744,1672630553,1672633534,2981
10251,3443580855,3494560663,1672650560,1672653774,3214
10601,3517991042,3929355087,1672556670,1672558147,1477
11179,3495482863,3770709417,1672539960,1672540840,880
11605,3783939161,3701004302,1672690944,1672691731,787
10005,3738547113,3364302157,1672556242,1672558686,2444
10295,3471996194,3534589501,1672684019,1672685075,1056
10086,3390438262,3710861700,1672622500,1672624987,2487
11130,3515715968,3713374884,1672602361,1672603503,1142
10401,3482639402,3600978954,1672558611,1672561886,3275
10426,3839744168,3358211034,1672578323,1672580368,2045
11726,3701448521,3534667712,1672569317,1672570743,1426
11590,3776053084,3478915403,1672660525,1672662671,2146
10316,3714264759,3228575883,1672534775,1672535616,841
11548,3362368123,3683047199,1672575293,1672576694,1401
11601,3756763585,3516378356,1672645455,1672646814,1359
10419,3441840658,3517253559,1672531918,1672535240,3322
10503,3838423363,3274894848,1672649232,1672651482,2250
10329,3510233949,3480270940,1672703368,1672706353,2985
10255,3369270860,3337675386,1672690283,1672691506,1223
11632,3711870537,3686644062,1672537567,1672537743,176
10111,3925098136,3776125503,1672532732,1672533509,777
10565,3293157673,3601063076,1672692068,1672694111,2043
11775,3779468781,3620105539,1672580737,1672582686,1949
9904,3334381941,3773523569,1672652375,1672654809,2434
11249,3399504157,3505665788,1672698854,1672700681,1827
10421,3514244308,3793689267,1672644872,1672648060,3188
10852,3810584695,3661543201,1672679862,1672681010,1148
11561,3374147279,3685877449,1672593862,1672596751,2889
11534,3309455369,3505908965,1672612456,1672613761,1305
10613,3882580580,3203172170,1672570695,1672573150,2455
11560,3713875941,3779102237,1672635121,1672638494,3373
10061,3533822490,3922153821,1672625355,1672626165,810
10344,3465227623,3291936679,1672663692,1672664657,965
11261,3533876927,3616242727,1672601094,1672603633,2539
10469,3375324190,3279851026,1672550831,1672552912,2081
9957,3783506190,3397527886,1672614414,1672616225,1811
11358,3905571273,3663505156,1672657451,1672658268,817
9931,3376487118,3711076751,1672536480,1672539634,3154
10450,3791863922,3289017988,1672662263,1672664116,1853
10092,3309178914,3715724166,1672642275,1672642662,387
11649,3792851584,3896615831,1672701638,1672703579,1941
10916,3552261072,3436774112,1672601951,1672603384,1433
10488,3890638402,3811419378,1672645428,1672646653,1225
11287,3534937492,3733123020,1672646748,1672646921,173
11422,3398021818,3418997135,1672585083,1672587529,2446
10793,3701893620,3338187803,1672674490,1672675709,1219
10793,3550206045,3774822697,1672581194,1672582048,854
10605,3757924067,3520725149,1672663225,1672665601,2376
10735,3489212992,3274223335,1672696550,1672698765,2215
10614,3792432763,3557528150,1672646451,1672650037,3586
10084,3334461288,3311159418,1672538567,1672541716,3149
10062,3244495586,3893629892,1672559923,1672563399,3476
9865,3755502373,3972196462,1672570307,1672573312,3005
9913,3793822639,3883640904,1672600354,1672601955,1601
10756,3447554599,3315432466,1672699368,1672701281,1913
11385,3925823748,3755394177,1672646730,1672648681,1951
10304,3972653129,3681701931,1672654297,1672657579,3282
11188,3501171785,3505032644,1672585400,1672586638,1238
10893,3534206917,3278779955,1672608836,1672611917,3081
10820,3914740937,3398483531,1672594344,1672596825,2481
11319,3682906048,3733953055,1672577177,1672579843,2666
10505,3830771832,3437023385,1672620993,1672623389,2396
11587,3382308738,3400545490,1672623400,1672624395,995
10364,3520339198,3777767907,1672580389,1672582351,1962
11070,3837885956,3480405740,1672630767,1672631044,277
10378,3511963020,3302929858,1672591959,1672594253,2294
11307,3793996996,3209280342,1672590353,1672593756,3403
10385,3716841469,3825795004,1672655895,1672658396,2501
11496,3703336988,3406492167,1672700728,1672703601,2873
10628,3520145112,3791547827,1672599024,1672601216,2192
11237,3791434207,3772695548,1672611933,1672613545,1612
9940,3973582279,3711187791,1672587009,1672588567,1558
10101,3806720019,3358982831,1672579642,1672581685,2043
11123,3757604311,3857609616,1672600790,1672601898,1108
10401,3315432466,3770780655,1672574655,1672576120,1465
11428,3273242177,3335139032,1672638174,1672640996,2822
10414,3777706200,3793783685,1672623362,1672626478,3116
10863,3516335333,3374652108,1672597930,1672600484,2554
9797,3285587972,3350631472,1672703495,1672705924,2429
10726,3780129338,3772966919,1672544094,1672546275,2181
11659,3500317923,3896123242,1672646571,1672647197,626
11238,3435159896,3436401020,1672545924,1672549259,3335
10386,3512417028,3773434690,1672687050,1672689891,2841
10264,3730290851,3518759318,1672616297,1672618728,2431
10885,3908550561,3607288879,1672618603,1672620072,1469
11428,3792708936,3683677062,1672626732,1672628891,2159
9950,3756876537,3732846295,1672646707,1672649938,3231
10333,3621812406,3756763585,1672612700,1672614529,1829
11346,3730414796,3519065870,1672570111,1672570305,194
10046,3938409715,3461630842,1672698469,1672700533,2064
9973,3910049345,3394976623,1672611221,1672612011,790
10134,3514980025,3701387745,1672673943,1672677128,3185
10895,3203876438,3436401020,1672631323,1672633456,2133
10743,3519924982,3516019206,1672658286,1672659153,867
11712,3444295435,3515974881,1672679582,1672683129,3547
10311,3897003751,3283106998,1672649227,1672651845,2618
10553,3369108286,3780224882,1672686146,1672689225,3079
10212,3341432459,3517144269,1672554593,1672556575,1982
10254,3311521176,3220976338,1672565319,1672566957,1638
11062,3756066765,3711613085,1672566559,1672568299,1740
10008,3933106901,3713373455,1672555400,1672556411,1011
9970,3467663782,3703031637,1672568243,1672570516,2273
10395,3770709417,3519689906,1672589113,1672591573,2460
10996,3436018575,3779835734,1672696651,1672698652,2001
11774,3287753579,3512826895,1672670406,1672672345,1939
10637,3505653701,3474097405,1672647300,1672650234,2934
10576,3477951091,3505502819,1672671744,1672673961,2217
10431,3402020492,3446066492,1672542768,1672544496,1728
11269,3273537848,3757523596,1672537426,1672539414,1988
9828,3820200446,3894328297,1672562323,1672564278,1955
10088,3461630842,3884180202,1672607707,1672607906,199
9992,3505756991,3793407883,1672667325,1672670907,3582
10889,3518478484,3520189871,1672562095,1672562653,558
10432,3715852330,3682906048,1672574655,1672577644,2989
11783,3770180844,3330238204,1672550584,1672550711,127
11062,3776348472,3501548163,1672591596,1672594097,2501
10724,3394986304,3757089924,1672553030,1672553305,275
11350,3356972733,3284407073,1672551490,1672552590,1100
11582,3774706478,3920116284,1672692891,1672695911,3020
11017,3511500932,3488333295,1672672422,1672674868,2446
10798,3755154460,3701127475,1672624291,1672627597,3306
11340,3515970536,3380167818,1672689897,1672693457,3560
10520,3773041843,3778402454,1672645776,1672646101,325
11715,3391612879,3779413388,1672559061,1672559947,886
9832,3534499421,3500455935,1672607851,1672608765,914
10856,3822786416,3428303756,1672537509,1672539522,2013
10022,3333477908,3517960157,1672642438,1672643123,685
11022,3391093411,3826542169,1672582425,1672585088,2663
10255,3776125503,3505538902,1672572841,1672574993,2152
11458,3510694464,3388946581,1672623234,1672626331,3097
9890,3780921044,3513777705,1672696754,1672699190,2436
11152,3774921252,3774145748,1672535290,1672536599,1309
10200,3915035136,3919342147,1672681849,1672683703,1854
10390,3439283360,3513111053,1672700343,1672703348,3005
10213,3880882684,3713740434,1672647341,1672650372,3031
10199,3534328311,3701385831,1672635141,1672637489,2348
11430,3398483531,3760443176,1672617118,1672618086,968
11545,3776348472,3505836431,1672691850,1672692700,850
11002,3352044245,3501027795,1672633191,1672633508,317
10786,3341311972,3711671702,1672596992,1672600590,3598
11363,3756991235,3755729826,1672653610,1672654106,496
11014,3900195680,3783506190,1672532323,1672535744,3421
10951,3301765144,3915460293,1672599354,1672600688,1334
9995,3739387948,3899205452,1672698910,1672700118,1208
10250,3501828287,3500062408,1672547061,1672550454,3393
10752,3836090778,3301449986,1672570802,1672571683,881
10118,3520016705,3814289471,1672662580,1672664061,1481
11259,3447591143,3555378248,1672554437,1672556757,2320
10576,3516497645,3517136772,1672654394,1672656462,2068
10683,3246062632,3513624915,1672643047,1672645538,2491
10542,3894328297,3710185376,1672603899,1672604178,279
10981,3338642026,3497904539,1672680876,1672683135,2259
10357,3783122313,3534284132,1672545042,1672548470,3428
11071,3378430760,3352295704,1672698978,1672699373,395
10596,3533974355,3301369282,1672594301,1672595272,971
10877,3637522163,3780740477,1672575011,1672578376,3365
11520,3881785069,3397972945,1672682359,1672683753,1394
11735,3351856699,3921736061,1672543375,1672543840,465
10662,3515706117,3917905192,1672592222,1672592496,274
9819,3777767907,3424425746,1672669563,1672671662,2099
10618,3772282008,3417969824,1672634966,1672638255,3289
10695,3602570831,3517151644,1672629679,1672633213,3534
11544,3633622298,3380628097,1672575408,1672578371,2963
11088,3667814788,3686211958,1672553364,1672553943,579
10402,3559619861,3757598610,1672574457,1672574833,376
9910,3792432094,3359012188,1672576795,1672580025,3230
10925,3778605154,3896840409,1672624809,1672627390,2581
11288,3505853594,3510218188,1672540854,1672541030,176
11589,3302929858,3713740434,1672613338,1672614803,1465
10986,3770273966,3714892312,1672690681,1672693510,2829
11007,3447696555,3660496328,1672588831,1672592378,3547
9830,3935256825,3756761603,1672618992,1672620812,1820
11035,3519046342,3516572212,1672703584,1672705626,2042
11108,3443004958,3792987243,1672601233,1672604212,2979
11273,3713416756,3710515351,1672608673,1672609975,1302
11356,3450234157,3774296721,1672644186,1672645938,1752
10809,3514698862,3701459978,1672539464,1672542972,3508
9824,3711179193,3779413388,1672565199,1672567712,2513
10281,3635433296,3774090455,1672615641,1672617827,2186
9823,3793783685,3347996015,1672586797,1672589797,3000
10068,3970851830,3512087090,1672622929,1672624587,1658
10772,3830771832,3713471446,1672549159,1672550356,1197
10812,3519102732,3518067857,1672561851,1672562371,520
10613,3403257752,3360525513,1672629573,1672632403,2830
11041,3780921044,3779102237,1672619716,1672621644,1928
10782,3779255367,3776187150,1672615589,1672616763,1174
10967,3802374620,3292663993,1672579113,1672580154,1041
10573,3701521510,3887502536,1672689857,1672690521,664
9820,3774029494,3776053981,1672698527,1672700470,1943
9858,3760710525,3512477276,1672644141,1672646893,2752
11748,3312612693,3885422379,1672620328,1672620461,133
10588,3500695402,3206377955,1672628760,1672629045,285
10433,3776193847,3489205994,1672590155,1672590553,398
9868,3756740153,3738547113,1672674746,1672676085,1339
11468,3779561601,3793822639,1672626106,1672627795,1689
9905,3375906394,3426207439,1672608725,1672611969,3244
11667,3774633364,3756647451,1672580206,1672581261,1055
10711,3620836520,3555378248,1672546210,1672546727,517
11134,3757001552,3711015176,1672635112,1672637531,2419
10907,3976742903,3890278838,1672585892,1672588739,2847
9796,3472018395,3514628916,1672540622,1672540905,283
10134,3760710525,3755075988,1672646975,1672647346,371
10627,3470997293,3534426696,1672567180,1672570161,2981
10571,3716492409,3481365330,1672538832,1672542030,3198
10182,3472901378,3773669001,1672672900,1672672981,81
11352,3710316008,3345896913,1672588314,1672590385,2071
11386,3884191432,3311410533,1672677622,1672679584,1962
10630,3636605690,3755374000,1672657005,1672659726,2721
11307,3732596503,3301369282,1672680839,1672683096,2257
10857,3714883746,3687183789,1672533141,1672536441,3300
10892,3403870769,3513111053,1672676423,1672677097,674
10319,3772509599,3779413388,1672687632,1672687995,363
11288,3756345026,3777112124,1672531899,1672535460,3561
10467,3888409038,3756876537,1672583348,1672583479,131
11319,3274341934,3550405857,1672690263,1672692721,2458
10884,3272838634,3245755569,1672598851,1672601614,2763
11240,3819024145,3791825536,1672579588,1672580652,1064
10000,3774195369,3713195480,1672688214,1672690559,2345
11169,3513586642,3398075553,1672541291,1672544340,3049
11484,3510301454,3379517265,1672638437,1672640129,1692
10607,3779835734,3703749690,1672702811,1672705021,2210
10250,3777439655,3783879023,1672540491,1672543002,2511
11750,3930727474,3534589501,1672654656,1672655257,601
11651,3534102440,3534543864,1672659280,1672661967,2687
10263,3339478490,3716994924,1672688648,1672692061,3413
10842,3479585868,3281935691,1672689164,1672692681,3517
11482,3701512498,3714074120,1672701720,1672704977,3257
10677,3517151644,3827981800,1672588973,1672589529,556
11318,3714264759,3435652260,1672544755,1672545920,1165
11545,3500049870,3977666815,1672615100,1672615375,275
11296,3755502373,3975796415,1672648073,1672649068,995
11560,3500211484,3774221318,1672562083,1672564144,2061
10367,3517797610,3310702648,1672682984,1672685165,2181
11083,3368951504,3245501577,1672643155,1672645178,2023
11630,3519712497,3275171954,1672686861,1672687697,836
10841,3888057649,3830599959,1672695438,1672698969,3531
11321,3772882440,3776124041,1672674322,1672676950,2628
11014,3513777705,3755192104,1672677752,1672679521,1769
11539,3808442442,3356599815,1672533064,1672534882,1818
11172,3392573386,3519689906,1672614880,1672615254,374
11057,3399430522,3515100211,1672619293,1672621047,1754
11498,3444598583,3342252701,1672598036,1672598908,872
10548,3512154443,3713767153,1672583510,1672585289,1779
10893,3934991640,3624164232,1672653508,1672655745,2237
11413,3792283334,3490804766,1672673229,1672674254,1025
10280,3669497617,3824135033,1672555490,1672558556,3066
11344,3614944981,3392482187,1672701432,1672704551,3119
10392,3286862903,3780680252,1672699364,1672700955,1591
11730,3711176990,3772425253,1672575738,1672577405,1667
11024,3610517436,3620157388,1672690770,1672693911,3141
10841,3505291330,3619676231,1672675602,1672677710,2108
10229,3756695502,3755154460,1672665397,1672665748,351
10571,3513800589,3773394570,1672681721,1672685174,3453
10115,3511969443,3500120676,1672575032,1672575361,329
11374,3715790104,3517800171,1672687376,1672690522,3146
11200,3770991234,3770276815,1672601413,1672601786,373
10874,3200320674,3227059650,1672553896,1672556903,3007
11297,3852461753,3772893815,1672661873,1672663282,1409
10546,3971996397,3713611960,1672619909,1672621252,1343
10207,3780500764,3301489209,1672699948,1672702492,2544
9934,3509297453,3933106901,1672655273,1672655429,156
11463,3391612879,3814672661,1672549067,1672550247,1180
10349,3344478603,3880788853,1672569800,1672571069,1269
10585,3792972270,3701770921,1672592344,1672594367,2023
10914,3684651755,3318056480,1672564756,1672564996,240
10248,3555764822,3779778679,1672560926,1672563601,2675
11193,3510864325,3817076003,1672620878,1672621648,770
10951,3716994924,3294326116,1672588614,1672591815,3201
11353,3776316903,3509626590,1672595122,1672595216,94
10057,3760776967,3370961012,1672634033,1672636958,2925
10075,3302879906,3514455363,1672617502,1672618431,929
10444,3780013266,3341985886,1672687504,1672690299,2795
9877,3519703964,3760416450,1672599229,1672601565,2336
11311,3370961012,3685396470,1672535971,1672537029,1058
10428,3755209597,3500889287,1672674723,1672675903,1180
10721,3359472956,3517902505,1672618356,1672621426,3070
9794,3314363575,3500051606,1672584600,1672586599,1999
11046,3349319959,3500105301,1672585870,1672588282,2412
9822,3826418889,3509503263,1672686950,1672688703,1753
10241,3774251051,3703737650,1672685120,1672686917,1797
10815,3281970147,3510750299,1672646825,1672646930,105
11356,3275661834,3514005973,1672547233,1672549464,2231
10937,3791522832,3903115138,1672623525,1672625228,1703
11219,3793920312,3519162582,1672687250,1672689494,2244
11087,3515284733,3738160394,1672553585,1672556593,3008
10171,3406101720,3834424604,1672657264,1672659983,2719
10406,3505500665,3714897456,1672544825,1672545739,914
10672,3467232654,3367109648,1672658635,1672659960,1325
11064,3914947393,3907039612,1672552952,1672554444,1492
10975,3316406470,3701887470,1672557923,1672558109,186
11300,3772882440,3757872458,1672655845,1672658512,2667
11380,3897186782,3716492409,1672622031,1672623033,1002
11737,3519465545,3807111856,1672547535,1672550159,2624
11732,3202787155,3495637721,1672622644,1672624674,2030
9947,3513545735,3683562111,1672609833,1672610132,299
10829,3519922921,3443521234,1672575871,1672578800,2929
11200,3772609551,3779340538,1672695402,1672696021,619
9835,3772291207,3977666815,1672659323,1672659511,188
10080,3600302127,3429315500,1672573701,1672574501,800
11448,3715602742,3778695895,1672669462,1672672987,3525
10444,3479207976,3755175497,1672655994,1672656900,906
9854,3388481990,3770275898,1672654837,1672655142,305
11652,3703502114,3301403047,1672698132,1672698596,464
10724,3792627762,3780168985,1672606409,1672606586,177
10607,3779778679,3534869444,1672567741,1672570161,2420
10799,3835262447,3505359060,1672605771,1672606045,274
11092,3777715675,3773554767,1672595150,1672595611,461
11027,3780626668,3505155858,1672641884,1672642233,349
11550,3939422411,3364067937,1672671777,1672675048,3271
10689,3510454018,3773523569,1672568901,1672569230,329
11094,3470997293,3520182275,1672697859,1672701172,3313
10010,3418683594,3711852131,1672536148,1672538505,2357
10493,3555215568,3783060739,1672570101,1672573528,3427
10963,3209958726,3246567963,1672612459,1672613447,988
10499,3791509334,3512417724,1672543499,1672544364,865
9987,3701127475,3345954031,1672634395,1672634626,231
9861,3520165730,3242149533,1672696347,1672696693,346
9841,3310961923,3627081426,1672608774,1672611336,2562
11682,3501004005,3660163550,1672595611,1672598133,2522
11307,3776841808,3413511621,1672676703,1672677575,872
10191,3755075988,3333505404,1672661521,1672662721,1200
10907,3923910914,3757393413,1672556956,1672559821,2865
10424,3500720752,3435342362,1672596858,1672597499,641
9814,3739395381,3773202954,1672624948,1672626108,1160
11173,3757393413,3478915403,1672686799,1672690053,3254
10594,3421956717,3710515351,1672636791,1672639484,2693
10856,3468066881,3358262975,1672603035,1672603243,208
10825,3929923442,3636015050,1672620188,1672621702,1514
9800,3772223331,3352493805,1672639857,1672641215,1358
10785,3294164983,3469780362,1672606326,1672609384,3058
10574,3516965624,3306066522,1672604870,1672605666,796
10395,3456795601,3760397450,1672661383,1672663699,2316
10319,3770530739,3730348493,1672702248,1672705487,3239
10763,3805704844,3756616853,1672571135,1672572437,1302
10807,3231227362,3450511428,1672565231,1672566266,1035
9829,3370401047,3711810268,1672577057,1672579378,2321
10017,3778924002,3760232135,1672626096,1672628918,2822
11211,3513740840,3803382101,1672577140,1672578603,1463
9944,3812880543,3899756737,1672642448,1672644438,1990
11278,3510856388,3632094087,1672554658,1672556102,1444
10382,3434052463,3791409441,1672615119,1672616532,1413
10946,3500889287,3443102414,1672611974,1672614916,2942
10429,3347172556,3318590083,1672578425,1672581161,2736
10070,3715246385,3462153833,1672600234,1672600540,306
11715,3778125688,3716183063,1672550664,1672551449,785
11037,3773523569,3450164574,1672667285,1672668074,789
11372,3703351452,3916673751,1672546478,1672547935,1457
10737,3272827860,3638071975,1672585293,1672587145,1852
10766,3710852576,3510254698,1672566928,1672568766,1838
10388,3777060250,3282053097,1672544768,1672544864,96
10186,3609997804,3449020351,1672535232,1672536151,919
10339,3716976932,3851515560,1672626989,1672627122,133
11534,3411213032,3510143850,1672534542,1672534896,354
9932,3517551721,3392482187,1672700600,1672700959,359
10114,3711040761,3929923442,1672606109,1672607495,1386
10152,3779160052,3400560073,1672671850,1672672801,951
11184,3773475506,3236948071,1672590649,1672591772,1123
11502,3713875941,3491104534,1672664119,1672666942,2823
11309,3307454562,3683514731,1672594095,1672596858,2763
11139,3520049965,3513486828,1672605947,1672608376,2429
11171,3886957097,3534206917,1672614804,1672615843,1039
10029,3244397548,3639503148,1672550652,1672552576,1924
10425,3313824913,3701218904,1672702966,1672705233,2267
11230,3914947393,3773688906,1672664836,1672667367,2531
11095,3776811587,3420664407,1672604471,1672606522,2051
11740,3347172556,3375257546,1672685422,1672688037,2615
10990,3972653129,3510439480,1672535205,1672536531,1326
10147,3780956975,3776319560,1672535605,1672537029,1424
10197,3689420679,3733423371,1672603227,1672604922,1695
9819,3469778316,3378747834,1672615197,1672617134,1937
9908,3714377201,3837888196,1672684044,1672686009,1965
11792,3615846003,3369270860,1672698089,1672698428,339
10955,3500579482,3534491112,1672688284,1672688805,521
11001,3479910993,3710173412,1672613231,1672614284,1053
10026,3780964089,3685396470,1672604000,1672606676,2676
10126,3852161626,3760656396,1672542257,1672543774,1517
10619,3505314920,3780294116,1672569344,1672569733,389
10854,3292050211,3779212271,1672674795,1672675013,218
11608,3668720465,3515405509,1672599804,1672602695,2891
11717,3935256825,3519162582,1672660708,1672662051,1343
10072,3437703650,3284407073,1672597308,1672598241,933
9997,3319061210,3714525519,1672586402,1672587500,1098
10126,3792475476,3395505794,1672542076,1672544204,2128
10627,3510111365,3710119555,1672624440,1672625386,946
11000,3510968599,3715114417,1672608959,1672610349,1390
10444,3555764822,3779665641,1672606800,1672609756,2956
10061,3290797257,3491758029,1672609382,1672612146,2764
11472,3713444403,3349319959,1672613768,1672615694,1926
10286,3701919083,3774238066,1672560598,1672561322,724
11034,3703624327,3519521903,1672574009,1672575939,1930
10106,3501573548,3406029706,1672579465,1672580072,607
10147,3311410533,3937854073,1672594975,1672597983,3008
11418,3885645840,3510795808,1672685714,1672685887,173
10127,3396440259,3711770773,1672654133,1672656348,2215
10677,3511744756,3880030249,1672666608,1672668169,1561
11733,3710125627,3791841318,1672638272,1672640675,2403
10399,3793874490,3533830748,1672623184,1672625372,2188
10884,3715700639,3933872044,1672538339,1672538526,187
11493,3505414878,3780680252,1672560277,1672561159,882
10635,3382746533,3713285095,1672600844,1672602874,2030
11244,3517816581,3516815069,1672639591,1672640241,650
11566,3701377471,3715419141,1672607360,1672608768,1408
9883,3882851213,3627431396,1672688986,1672692138,3152
11240,3778986795,3444295435,1672663301,1672666118,2817
10520,3770019143,3272581469,1672697441,1672700302,2861
10270,3711131262,3512596743,1672638633,1672638985,352
11617,3791108593,3558264627,1672659033,1672660696,1663
10294,3715204544,3513384042,1672631891,1672635336,3445
11201,3246971044,3494157939,1672659076,1672661264,2188
11179,3897500723,3205324639,1672579397,1672579991,594
10315,3888057649,3896615831,1672592254,1672594087,1833
10336,3913746581,3715126587,1672625012,1672627384,2372
10642,3358434853,3505853594,1672691023,1672693345,2322
11228,3755218683,3517448452,1672636818,1672637867,1049
11304,3756890980,3463892928,1672583598,1672583855,257
10090,3971447562,3791368349,1672669860,1672670571,711
10768,3974668678,3639503148,1672549483,1672551552,2069
10752,3776053981,3483078667,1672636013,1672638445,2432
9841,3490953301,3274223335,1672554164,1672555323,1159
10677,3827889533,3505248368,1672639875,1672640816,941
10283,3509828883,3515706117,1672589537,1672590662,1125
10420,3516497645,3774448657,1672559078,1672559253,175
11516,3897186782,3380285779,1672683438,1672684038,600
10955,3244495586,3501843187,1672591971,1672592150,179
10743,3791108593,3756437169,1672567414,1672569775,2361
10362,3394976623,3938129916,1672696497,1672698968,2471
11611,3714074120,3519108639,1672538399,1672541911,3512
10847,3297624618,3312651192,1672534800,1672537656,2856
10234,3441683673,3667654673,1672602752,1672606171,3419
11743,3780050146,3517816581,1672555199,1672558555,3356
11389,3716285196,3534174363,1672610467,1672613399,2932
11398,3804840997,3756680289,1672579855,1672582165,2310
10942,3669497617,3715246385,1672698391,1672700756,2365
11749,3853386575,3716633983,1672643530,1672644326,796
10247,3770533588,3388481990,1672535913,1672536603,690
10870,3791905743,3760144712,1672643805,1672646548,2743
11673,3773738817,3714283424,1672682869,1672683550,681
10073,3793902476,3515405509,1672592411,1672593498,1087
11705,3780648744,3533974355,1672691396,1672693171,1775
10761,3510486220,3512625661,1672662756,1672666267,3511
9905,3716994924,3505248368,1672533157,1672535642,2485
11688,3619494735,3739217535,1672565002,1672567813,2811
10414,3220976338,3601340045,1672581073,1672584469,3396
10098,3619705594,3780648744,1672685021,1672687640,2619
10299,3896859936,3832289185,1672686697,1672689615,2918
11303,3406492167,3511476353,1672634512,1672635531,1019
11724,3285971415,3423217578,1672600082,1672602398,2316
10227,3509297453,3319862687,1672569920,1672571193,1273
11731,3360525513,3533642281,1672544965,1672546240,1275
11755,3713636175,3882851213,1672597125,1672600274,3149
10146,3501600785,3500145103,1672680798,1672681157,359
10434,3377883705,3518157683,1672687374,1672689005,1631
11353,3512769522,3485521840,1672637136,1672639471,2335
9842,3774539067,3223177147,1672567947,1672570073,2126
10790,3772262649,3835599049,1672592338,1672595102,2764
9964,3701284535,3855629383,1672567574,1672570977,3403
11437,3516472352,3736056340,1672631370,1672633710,2340
11774,3783947742,3311569360,1672569652,1672572490,2838
11317,3299052917,3391093411,1672594471,1672597661,3190
9942,3716841469,3505500523,1672549492,1672549668,176
11250,3414510793,3310961923,1672591031,1672592957,1926
9980,3511198566,3421956717,1672588187,1672591763,3576
11649,3776200012,3735679000,1672624866,1672626485,1619
10970,3813853446,3906075386,1672662031,1672662140,109
10490,3619494735,3931028233,1672582858,1672583432,574
10790,3459163055,3792063616,1672681643,1672683520,1877
11238,3375324190,3379400553,1672569148,1672570283,1135
11506,3513629502,3303772923,1672657422,1672657837,415
10772,3505032644,3445172440,1672661768,1672662447,679
10073,3505684690,3602054754,1672566878,1672570129,3251
11436,3925098136,3838119022,1672626294,1672626885,591
11481,3393376416,3701387745,1672587463,1672588149,686
11422,3778370462,3606804618,1672595048,1672598137,3089
11191,3683047199,3756647451,1672666833,1672670181,3348
11699,3519228207,3779665641,1672540268,1672540850,582
10802,3899970524,3773826624,1672631493,1672634935,3442
10704,3773953689,3778695017,1672651869,1672653052,1183
10965,3512871568,3490804766,1672548188,1672551380,3192
11058,3515405509,3422460919,1672585074,1672587293,2219
10372,3534362749,3495152069,1672700802,1672704319,3517
10135,3533030343,3512395783,1672548013,1672548248,235
10337,3760854788,3778819352,1672625062,1672628127,3065
10251,3401215739,3514801709,1672585106,1672585880,774
10384,3398021818,3778706119,1672651921,1672654706,2785
10641,3791245127,3770924034,1672634782,1672637759,2977
9826,3392573386,3443191792,1672675537,1672675635,98
11132,3668855144,3515379622,1672694833,1672695335,502
11013,3933106901,3808849597,1672534995,1672535454,459
11605,3755361692,3313579674,1672638344,1672640440,2096
11696,3822496670,3688845298,1672684559,1672687778,3219
10558,3334708091,3278443807,1672616201,1672616502,301
10964,3533830748,3713878219,1672699440,1672701240,1800
10607,3972653129,3315432466,1672594862,1672595058,196
10848,3513508737,3773424266,1672569027,1672570743,1716
10685,3501574882,3361865467,1672664962,1672666030,1068
9811,3396440259,3922480066,1672682964,1672683469,505
10824,3387413950,3473706746,1672589442,1672590827,1385
10553,3783879023,3978417055,1672606639,1672608661,2022
11591,3559759778,3855674398,1672618571,1672620961,2390
10521,3533593766,3713374884,1672551622,1672553131,1509
11476,3239779992,3285322570,1672636993,1672639129,2136
10540,3505148522,3778924002,1672533115,1672533734,619
11677,3534531039,3716669659,1672561304,1672563465,2161
11421,3501205057,3417431173,1672655447,1672656426,979
10296,3450342110,3510454018,1672581423,1672583263,1840
11747,3812677669,3397527886,1672647764,1672649075,1311
10196,3713840946,3774035405,1672602850,1672603596,746
10903,3791841318,3517552930,1672694310,1672694796,486
10983,3701385831,3688845298,1672657623,1672659470,1847
10050,3701769970,3491390365,1672564264,1672565807,1543
11542,3773714494,3281970147,1672569585,1672570155,570
10319,3500671218,3445896667,1672611201,1672614095,2894
11515,3337903727,3533017131,1672678201,1672681645,3444
10171,3235198316,3915679140,1672531363,1672534749,3386
10572,3776447604,3308759754,1672695145,1672697912,2767
11305,3884862164,3374348845,1672660301,1672660697,396
10521,3519997661,3780308809,1672581728,1672582486,758
11042,3433189219,3886957097,1672585387,1672586376,989
11637,3511744756,3925835590,1672577599,1672579983,2384
11413,3430296808,3783939161,1672656966,1672657690,724
10974,3515284733,3715249954,1672674326,1672674489,163
11349,3757713457,3836757034,1672663971,1672664232,261
10966,3685083275,3925835590,1672667797,1672671314,3517
10705,3533009565,3756149282,1672560552,1672561435,883
11653,3533816813,3334381941,1672571383,1672571988,605
11388,3713107380,3505994703,1672640655,1672642096,1441
9839,3236886943,3773024346,1672619283,1672621094,1811
9947,3510801769,3355903597,1672639950,1672640558,608
11147,3505994703,3342837214,1672699387,1672701382,1995
10346,3454343398,3895507040,1672680093,1672680388,295
11581,3665603628,3701519251,1672554257,1672556250,1993
10350,3634670780,3520016705,1672599609,1672601063,1454
11753,3825234433,3423782420,1672587196,1672590228,3032
10994,3730115019,3922153821,1672622326,1672622451,125
10925,3635599307,3703277359,1672593787,1672595983,2196
10551,3519046342,3505155858,1672692429,1672694110,1681
11443,3311463998,3519754667,1672568943,1672571738,2795
10426,3619796619,3732223664,1672643551,1672644137,586
10411,3500734346,3772234939,1672560202,1672563302,3100
11480,3801501384,3334633634,1672617202,1672619903,2701
11644,3776034313,3392573386,1672603707,1672604797,1090
10778,3364683368,3703938162,1672541696,1672543688,1992
11525,3501115299,3732312480,1672675084,1672677195,2111
11161,3519937708,3715680249,1672640348,1672642489,2141
10818,3818236682,3203151036,1672679432,1672682829,3397
10992,3713969196,3777878462,1672583411,1672584339,928
10202,3445172440,3780127017,1672687764,1672688929,1165
10674,3713170867,3714903253,1672692528,1672693391,863
10055,3452982957,3209280342,1672637000,1672638334,1334
11218,3395082458,3792008302,1672614555,1672617957,3402
9993,3757050615,3311904032,1672636578,1672638181,1603
10979,3519015940,3509626590,1672696500,1672698932,2432
10237,3793899166,3755989680,1672639310,1672642072,2762
10026,3776534957,3533037906,1672668108,1672668649,541
11621,3385416697,3428076194,1672671138,1672673205,2067
11467,3387706541,3342252701,1672616295,1672619259,2964
9958,3429333292,3404375908,1672648159,1672651184,3025
11192,3425646356,3519922921,1672560499,1672563142,2643
10359,3772869013,3501828287,1672532102,1672534611,2509
11298,3316537706,3737622701,1672554409,1672556775,2366
10596,3713954144,3735422623,1672556602,1672556807,205
10681,3414387263,3334461288,1672649228,1672650346,1118
11765,3888523259,3516586325,1672599497,1672601051,1554
9987,3415840750,3714838100,1672600175,1672602750,2575
10021,3780224882,3714731729,1672691279,1672694611,3332
10524,3500015630,3639081201,1672548134,1672550844,2710
10384,3904184638,3682150740,1672579176,1672582522,3346
10686,3618672178,3505490878,1672566075,1672567915,1840
10738,3770105006,3520515739,1672546681,1672549816,3135
11553,3793920312,3858497718,1672650686,1672650885,199
10981,3505438826,3776791436,1672677409,1672679757,2348
10496,3505291330,3680988889,1672659407,1672661138,1731
11151,3450234157,3511364193,1672600170,1672602672,2502
10277,3819024145,3774663639,1672649042,1672649574,532
11377,3493598658,3777499535,1672569856,1672572717,2861
10290,3701919083,3398489033,1672622438,1672622527,89
10520,3912915644,3885147558,1672571677,1672572448,771
11701,3304697982,3533037906,1672636628,1672638265,1637
10202,3505155858,3834980281,1672613371,1672616369,2998
10461,3713219299,3429333292,1672608949,1672609659,710
10772,3462645981,3701919083,1672681883,1672684984,3101
11098,3224053074,3494157939,1672634899,1672637617,2718
10445,3793987483,3377311502,1672564210,1672566126,1916
10418,3701475090,3793375825,1672620293,1672620937,644
10133,3501873139,3669427589,1672691574,1672693802,2228
10773,3451757423,3931028233,1672558419,1672561142,2723
10109,3370751461,3485521840,1672615515,1672616822,1307
11411,3445172440,3485468650,1672553163,1672553853,690
11507,3774921252,3509701363,1672587632,1672589434,1802
10246,3627081426,3512768285,1672569726,1672571571,1845
11760,3514498259,3979115924,1672678844,1672680086,1242
11682,3929923442,3911376818,1672641271,1672643959,2688
10084,3791974273,3513545735,1672700103,1672701938,1835
10218,3755394177,3428303756,1672550119,1672550930,811
11133,3791825536,3474097405,1672646081,1672648540,2459
10501,3776304080,3716891903,1672650383,1672653306,2923
10845,3832002939,3470962222,1672601209,1672603267,2058
10121,3757150421,3203457161,1672554220,1672557392,3172
10707,3241593146,3311015817,1672658557,1672661300,2743
9872,3780576351,3770012744,1672584998,1672587589,2591
10463,3772569860,3711404205,1672621274,1672624218,2944
10014,3882905311,3755849241,1672702012,1672702494,482
10039,3288346356,3911431642,1672571057,1672573736,2679
10869,3715700639,3609925909,1672531720,1672535140,3420
11424,3773738817,3978643889,1672636187,1672638486,2299
10775,3227339675,3515100211,1672600192,1672601082,890
10043,3854957153,3313101243,1672558287,1672560094,1807
11265,3778253021,3780435349,1672546616,1672547592,976
9818,3703779674,3319061210,1672648964,1672649743,779
11451,3514776568,3505936495,1672662171,1672662805,634
11368,3311264420,3783373085,1672536190,1672539546,3356
11301,3557653200,3836757034,1672650328,1672651407,1079
10518,3229615214,3669918958,1672552938,1672553254,316
9838,3783967375,3308744016,1672590256,1672592350,2094
10886,3899756737,3505665788,1672630830,1672634351,3521
10804,3534604516,3857389270,1672628102,1672629117,1015
11072,3510758718,3757823215,1672535009,1672536475,1466
9901,3915035136,3929002318,1672570971,1672571542,571
11239,3399943757,3639926564,1672627717,1672630951,3234
10173,3904846341,3779665641,1672657908,1672659406,1498
11331,3783594246,3505278562,1672603165,1672605979,2814
10918,3305656670,3505148522,1672630503,1672633893,3390
11554,3516572212,3444168914,1672660612,1672663907,3295
10699,3400025324,3703722212,1672693913,1672697338,3425
10238,3716647407,3772250554,1672635091,1672637596,2505
9908,3361952532,3837435907,1672647792,1672648397,605
10276,3760267158,3475033290,1672607277,1672608890,1613
10467,3245245283,3714806574,1672621508,1672623419,1911
10540,3534081527,3774326754,1672697431,1672701020,3589
10587,3467756698,3452878062,1672659278,1672662479,3201
10861,3627081426,3630462406,1672577600,1672579936,2336
11146,3715724166,3472718723,1672539983,1672541571,1588
9881,3500833053,3792075871,1672655835,1672658751,2916
11157,3387706541,3684199077,1672685267,1672688032,2765
10551,3489340327,3780626668,1672615055,1672616938,1883
10741,3511864772,3733730342,1672581694,1672582685,991
11410,3299587876,3770533675,1672561301,1672562316,1015
9939,3773394570,3882580580,1672693400,1672696533,3133
10804,3505472087,3515802579,1672594851,1672595905,1054
11567,3500864577,3203630241,1672555343,1672557987,2644
11103,3467944159,3625931630,1672684987,1672686580,1593
11740,3291617477,3780982229,1672634773,1672637444,2671
11337,3301489209,3519167605,1672594641,1672596711,2070
11369,3755175497,3783313202,1672651986,1672654259,2273
10033,3904004824,3500968729,1672547137,1672549837,2700
9956,3970851830,3837888196,1672638234,1672638363,129
10693,3505769529,3534102440,1672611985,1672613443,1458
11436,3381244346,3500821475,1672612810,1672614144,1334
10807,3793987483,3500251781,1672549246,1672551092,1846
11488,3734233216,3778924002,1672582280,1672585192,2912
11292,3733423371,3783594246,1672702827,1672703363,536
10103,3461743188,3387621912,1672695276,1672696885,1609
11569,3972856326,3551833298,1672578728,1672580493,1765
11766,3757212744,3311463998,1672655270,1672656224,954
9925,3312733562,3510775046,1672694907,1672695853,946
11144,3831981073,3776291254,1672689787,1672692230,2443
10242,3911821258,3927365255,1672590623,1672591732,1109
11708,3686885442,3811503860,1672572487,1672574303,1816
11630,3347140733,3457249798,1672557852,1672559984,2132
11087,3711767051,3395565040,1672652287,1672655755,3468
11070,3686860179,3311260898,1672622084,1672623304,1220
11478,3501583486,3687445224,1672700852,1672702158,1306
10012,3772786559,3855629383,1672697923,1672699349,1426
10789,3711767051,3817029483,1672566473,1672567756,1283
11403,3403035480,3835509670,1672533022,1672535622,2600
10681,3911431642,3344710271,1672661042,1672663575,2533
10848,3780511388,3922480066,1672537071,1672539474,2403
10624,3505032644,3931319307,1672701624,1672704732,3108
11276,3516731917,3509379617,1672669518,1672672703,3185
10020,3387706541,3716209499,1672636509,1672638576,2067
11558,3890278838,3615447269,1672567846,1672569873,2027
11639,3450621820,3372596013,1672604546,1672607918,3372
11501,3780148144,3711870537,1672567218,1672569562,2344
10647,3791031227,3668202976,1672646210,1672646886,676
10654,3924963918,3701449715,1672536405,1672539262,2857
10371,3882580580,3773738817,1672534802,1672536331,1529
11768,3756781024,3273758330,1672698014,1672700220,2206
10281,3471131277,3208962614,1672605439,1672607299,1860
11018,3756897029,3791509881,1672683813,1672684495,682
10405,3714074120,3242149533,1672678995,1672679102,107
10833,3489212992,3793926338,1672609920,1672612016,2096
10524,3714287902,3776727271,1672597333,1672600745,3412
11162,3444646562,3410788026,1672626727,1672627175,448
11601,3203151036,3779413388,1672647353,1672648350,997
11142,3837888196,3837885956,1672628461,1672629839,1378
10048,3512343029,3668154066,1672600767,1672604165,3398
11379,3834643026,3622729771,1672665916,1672666503,587
10914,3519922921,3783679478,1672702791,1672703976,1185
11143,3358982831,3330318282,1672663025,1672663886,861
11791,3776001441,3416079461,1672558342,1672559656,1314
10030,3423353911,3334488428,1672634394,1672636138,1744
10364,3519730914,3756272704,1672603812,1672606597,2785
11060,3899903158,3791587717,1672597353,1672599641,2288
10224,3505936495,3513777705,1672605741,1672606394,653
11603,3500221079,3201920708,1672660744,1672660871,127
10393,3408408584,3511608609,1672579589,1672580201,612
11785,3905358065,3774483862,1672627722,1672630101,2379
10391,3701529552,3450234157,1672677421,1672677960,539
10003,3483701493,3505720915,1672628189,1672630038,1849
11513,3710046567,3519357822,1672683609,1672684652,1043
11168,3732596503,3402774497,1672594808,1672597661,2853
9864,3774251051,3533225084,1672697049,1672697707,658
11256,3271719569,3791617239,1672679619,1672680326,707
10567,3370961012,3624365837,1672572292,1672572807,515
10678,3513143959,3367242388,1672567447,1672570817,3370
10493,3509614126,3415032547,1672682324,1672683678,1354
11422,3476308535,3285587972,1672688535,1672689808,1273
10922,3510968599,3276393542,1672621318,1672624525,3207
10839,3832002939,3900766525,1672573615,1672575992,2377
11443,3514564903,3206377955,1672636046,1672638900,2854
9992,3902682060,3461630842,1672614470,1672615286,816
11068,3716445184,3277634944,1672685840,1672688781,2941
11600,3757150421,3925175853,1672549670,1672552616,2946
11540,3777060250,3667950469,1672653263,1672655701,2438
10212,3715590997,3500031401,1672538484,1672539996,1512
11791,3434052463,3636852764,1672610752,1672612899,2147
11596,3805704844,3533593766,1672601605,1672603467,1862
10679,3418997135,3516019206,1672668150,1672670095,1945
11273,3713514933,3246395239,1672623655,1672624968,1313
10304,3302416197,3710296607,1672695206,1672697045,1839
11588,3505278562,3512337054,1672651579,1672653402,1823
10228,3514341451,3735838864,1672679423,1672681824,2401
11402,3519463038,3627431396,1672596827,1672598778,1951
11593,3552309108,3825877848,1672685182,1672685561,379
10679,3791796190,3783043346,1672547371,1672548476,1105
11096,3792497486,3901169230,1672562088,1672563737,1649
10034,3533473206,3711947828,1672598568,1672598869,301
10765,3517448452,3517902505,1672688944,1672692502,3558
10170,3439651226,3512371853,1672675644,1672677010,1366
10880,3936851114,3714142299,1672582740,1672585811,3071
11704,3715246385,3476308535,1672556869,1672560165,3296
10484,3399734748,3890813040,1672641736,1672641901,165
11610,3515259326,3505449070,1672609502,1672611256,1754
10538,3505245692,3513486828,1672606166,1672608840,2674
9871,3209925780,3520470646,1672588622,1672591061,2439
11413,3534190196,3770457058,1672702567,1672704719,2152
10768,3365519448,3760420315,1672680417,1672683657,3240
11322,3519102732,3377250778,1672621750,1672623676,1926
9978,3475830203,3227498870,1672671252,1672673986,2734
11028,3313392810,3443191792,1672612086,1672615101,3015
10966,3683047199,3501407804,1672655492,1672658849,3357
11732,3505571800,3499622352,1672639715,1672641302,1587
10309,3533726421,3629248353,1672655404,1672658335,2931
10482,3703749690,3335139032,1672569931,1672573357,3426
10484,3884180202,3837435907,1672614330,1672614485,155
11462,3512697456,3455430943,1672571117,1672572974,1857
10819,3776841808,3792627762,1672597779,1672600452,2673
10488,3738429905,3701521510,1672678039,1672681035,2996
11203,3533473206,3440401725,1672670339,1672672299,1960
10304,3756647451,3391854325,1672551894,1672555465,3571
10971,3780298499,3689420679,1672567520,1672567754,234
10580,3880030249,3772114731,1672597083,1672598513,1430
10514,3908878965,3500591274,1672686364,1672686767,403
10050,3505697295,3384001094,1672597390,1672597702,312
10276,3515607283,3310712221,1672591151,1672592930,1779
10863,3505234868,3779282072,1672703044,1672706009,2965
10757,3888642876,3774682234,1672677030,1672680171,3141
10048,3533929043,3732104286,1672611846,1672613831,1985
10174,3613216900,3922480066,1672693119,1672695187,2068
11354,3305093237,3490953301,1672651736,1672654012,2276
10072,3756763585,3387706541,1672664498,1672665584,1086
10600,3553321027,3793822639,1672676668,1672679400,2732
10131,3355899481,3403218814,1672661200,1672662836,1636
11390,3423346297,3534068874,1672689701,1672690746,1045
10216,3501192566,3713476192,1672611581,1672613426,1845
11226,3710296607,3422548081,1672644711,1672647333,2622
11349,3776166086,3829412384,1672568978,1672569050,72
10845,3880030249,3806034626,1672588654,1672591352,2698
9870,3432762943,3780921044,1672631369,1672631790,421
11235,3439036305,3209925780,1672582884,1672582958,74
10703,3273758330,3516668203,1672637940,1672640917,2977
11407,3701448521,3418791124,1672701230,1672703327,2097
11742,3301431129,3518794921,1672623980,1672624400,420
10746,3500595432,3510882475,1672698527,1672701080,2553
10445,3554174421,3461877104,1672641653,1672644705,3052
9858,3838423363,3714264759,1672630770,1672633889,3119
10531,3637566026,3243763209,1672559557,1672561971,2414
11298,3829698950,3482639402,1672636042,1672636929,887
10531,3512965991,3772216305,1672568576,1672569172,596
11153,3683677062,3791351852,1672651074,1672651540,466
11402,3773953689,3311810583,1672567466,1672567880,414
10295,3711862792,3701769970,1672644163,1672646892,2729
9879,3824657614,3760554453,1672632078,1672634807,2729
10394,3931495845,3711938229,1672655007,1672655281,274
10865,3808849597,3437108337,1672644145,1672646015,1870
11265,3335055096,3373802545,1672585062,1672587184,2122
9859,3902682060,3444646562,1672609030,1672612120,3090
10080,3510209505,3338115824,1672558284,1672560199,1915
10692,3369810091,3772235668,1672661507,1672663657,2150
10015,3701779683,3472774606,1672681344,1672681809,465
11127,3810584695,3275171954,1672702015,1672705505,3490
10002,3440305508,3519965717,1672602777,1672602978,201
10113,3837888196,3533627473,1672657495,1672659580,2085
11701,3514013999,3715881104,1672585612,1672589062,3450
11650,3931495845,3813853446,1672623088,1672624823,1735
11773,3472173212,3613216900,1672697154,1672698974,1820
10902,3224040894,3375324190,1672607719,1672608501,782
10612,3315432466,3505490878,1672590991,1672592007,1016
10714,3688845298,3509470194,1672555622,1672556760,1138
11032,3713547793,3510638085,1672638360,1672639201,841
10567,3276230295,3235373942,1672675281,1672676971,1690
11070,3534578428,3510894809,1672680890,1672683687,2797
10603,3779393140,3760346746,1672584782,1672587653,2871
11583,3730169449,3710397477,1672653341,1672656002,2661
10727,3514980025,3716209499,1672574678,1672575429,751
10228,3737745988,3350631472,1672585538,1672587805,2267
11045,3533777032,3534328311,1672549002,1672552203,3201
11129,3369270860,3512288503,1672536123,1672538003,1880
9947,3701291994,3738160394,1672615882,1672618677,2795
10491,3716195780,3713611960,1672671769,1672672134,365
10653,3919494952,3396440259,1672610312,1672611638,1326
10406,3713219299,3757198930,1672630270,1672631624,1354
10739,3791758175,3977880564,1672639278,1672641195,1917
10216,3499820963,3357074700,1672650642,1672651978,1336
10546,3638050763,3496591885,1672646261,1672646420,159
11458,3533620069,3382696725,1672576340,1672579576,3236
11538,3319862687,3793497672,1672537100,1672539449,2349
10433,3976742903,3311188620,1672599109,1672600549,1440
11121,3791698084,3906075386,1672558722,1672561437,2715
10234,3792719263,3534204885,1672603264,1672604382,1118
10153,3453519360,3510882475,1672678420,1672680786,2366
11046,3200372897,3417268745,1672625671,1672626769,1098
10759,3411213032,3703415246,1672560433,1672561918,1485
11329,3513508737,3515379622,1672553710,1672553893,183
11179,3610723722,3414387263,1672604610,1672606579,1969
10909,3519730914,3398151217,1672566925,1672570452,3527
11546,3757212744,3914947393,1672694302,1672696384,2082
10661,3318224774,3935256825,1672637689,1672640804,3115
11387,3732104286,3791509334,1672668229,1672670216,1987
10554,3773579644,3342027511,1672587425,1672587675,250
11347,3714688409,3896622009,1672535041,1672537839,2798
10110,3612705426,3513859809,1672586978,1672588613,1635
10678,3715419141,3935569749,1672690396,1672690533,137
11583,3518376262,3359351267,1672653349,1672654937,1588
11395,3397783490,3802374620,1672633516,1672633766,250
10578,3770671714,3519494023,1672584687,1672586364,1677
10450,3701004302,3701374160,1672684117,1672687061,2944
10821,3685877449,3312651192,1672648130,1672648853,723
10465,3380281484,3773376762,1672604018,1672604778,760
11404,3755570137,3233712975,1672559130,1672560345,1215
10065,3509470194,3511466117,1672587801,1672588077,276
10138,3735838864,3388915945,1672680651,1672680894,243
10996,3755361692,3780500331,1672654844,1672657015,2171
10141,3501115299,3404187438,1672676392,1672678502,2110
11596,3755670258,3638071975,1672600949,1672601186,237
10371,3756119976,3902357342,1672618160,1672619027,867
10447,3519754667,3887918622,1672671296,1672673738,2442
10748,3620836520,3779689733,1672677253,1672680122,2869
11218,3276231633,3501370430,1672702439,1672703375,936
10348,3316406470,3682802569,1672675823,1672679221,3398
10478,3501843187,3353335252,1672676258,1672677362,1104
11524,3466620548,3534372899,1672634604,1672636123,1519
10464,3908331271,3715282492,1672638611,1672639282,671
10689,3858330969,3770925016,1672630410,1672632889,2479
11487,3311771689,3716891903,1672540579,1672540863,284
11783,3783443095,3773636983,1672549696,1672549974,278
10621,3482687604,3756616853,1672558325,1672561081,2756
10514,3500198430,3520057139,1672587175,1672587942,767
11141,3513215373,3380285779,1672604307,1672607521,3214
10203,3701028092,3885674996,1672690719,1672690939,220
11400,3556684272,3286862903,1672609025,1672610211,1186
10357,3442073613,3512625661,1672686961,1672688848,1887
11012,3772909073,3330466913,1672616730,1672617107,377
11435,3770780655,3511883778,1672628527,1672630586,2059
10475,3493679801,3778125688,1672614145,1672615966,1821
10657,3515802579,3715622084,1672645074,1672646827,1753
11505,3714281795,3703462221,1672610126,1672612826,2700
9882,3500455935,3393001196,1672671281,1672673396,2115
11586,3505119470,3701449715,1672581839,1672582499,660
11713,3409514897,3716633983,1672581799,1672583232,1433
10819,3703104365,3760346746,1672533944,1672534842,898
9808,3373851012,3783238023,1672701491,1672702334,843
9847,3773697080,3424425746,1672667586,1672669687,2101
10297,3376842515,3792075871,1672625525,1672628812,3287
11437,3715284599,3757089924,1672612384,1672614521,2137
10751,3619494735,3713636175,1672591585,1672593395,1810
10411,3313502623,3780982229,1672698809,1672702011,3202
9798,3243305367,3733423371,1672538400,1672541643,3243
11141,3505291330,3612705426,1672674706,1672677003,2297
11670,3515304526,3783368855,1672584099,1672587219,3120
10547,3533777032,3204821370,1672701652,1672702603,951
10200,3776455762,3827981800,1672659307,1672661544,2237
10789,3501407804,3832902787,1672586258,1672586692,434
10071,3703481882,3623894390,1672669333,1672671780,2447
10581,3520165730,3301403047,1672667456,1672669240,1784
10507,3780148144,3713285095,1672535517,1672537329,1812
11271,3505828210,3772802020,1672580172,1672581551,1379
10396,3368441333,3299845453,1672648266,1672650774,2508
11482,3760537855,3419762444,1672651464,1672653992,2528
9906,3500591274,3824657614,1672620835,1672622612,1777
10372,3714903253,3774706478,1672687726,1672689485,1759
10473,3533703578,3921736061,1672680946,1672682582,1636
9972,3779778679,3783594246,1672645766,1672646788,1022
10654,3505449070,3624164232,1672560874,1672563302,2428
9863,3773017746,3756784813,1672665245,1672666991,1746
10074,3350169064,3270607273,1672680807,1672681747,940
10074,3611939581,3396453219,1672669707,1672672307,2600
9841,3206241691,3225356349,1672595399,1672597179,1780
9849,3505278562,3236360179,1672605222,1672608450,3228
11542,3937854073,3520470646,1672532739,1672534804,2065
11266,3419762444,3774792696,1672673688,1672674047,359
9938,3301489209,3206217657,1672686441,1672688133,1692
10606,3516034245,3475653510,1672545428,1672547828,2400
11726,3516463579,3304227085,1672665004,1672665220,216
10615,3245245283,3500438542,1672682303,1672683118,815
10159,3440671139,3511003541,1672538410,1672541909,3499
11730,3516472352,3517949586,1672648324,1672649819,1495
10522,3938129916,3711196962,1672624457,1672627033,2576
11547,3760346746,3206926634,1672579225,1672580284,1059
11411,3287821258,3398075553,1672627055,1672628160,1105
11683,3755230010,3516815069,1672584784,1672587153,2369
11742,3208594306,3773736248,1672583898,1672584070,172
9927,3441683673,3779130507,1672591070,1672592857,1787
11401,3836757034,3384170206,1672585631,1672587738,2107
10872,3288791629,3500073824,1672558674,1672560043,1369
11115,3924963918,3713728777,1672555125,1672555594,469
11735,3224040894,3520471156,1672673349,1672673460,111
11575,3776348472,3520016705,1672647455,1672647930,475
10548,3533777032,3422959249,1672545046,1672548196,3150
11584,3510262025,3500671218,1672623229,1672624897,1668
11306,3501253130,3284483177,1672589799,1672590616,817
11564,3206853747,3731905251,1672625352,1672628280,2928
11703,3770480149,3509317776,1672563863,1672566513,2650
10868,3205324639,3755630085,1672603970,1672606765,2795
9954,3347996015,3760346746,1672673651,1672674713,1062
11100,3632094087,3433902955,1672544922,1672546566,1644
11146,3375324190,3778819352,1672567248,1672570429,3181
11615,3304672737,3500854711,1672681574,1672682872,1298
11453,3667950469,3510819040,1672563479,1672563555,76
10058,3519322066,3403395712,1672661415,1672662109,694
10185,3760966645,3886896755,1672592988,1672593917,929
11260,3517810375,3662522808,1672696429,1672699740,3311
9989,3338187803,3520009158,1672701049,1672704411,3362
10070,3800434325,3338465050,1672540125,1672541744,1619
11775,3776953418,3501835995,1672657668,1672659598,1930
10367,3914947393,3811354125,1672579100,1672582497,3397
10385,3505331083,3715291931,1672564788,1672566795,2007
11780,3701675183,3701978422,1672589801,1672590961,1160
11362,3791269060,3629248353,1672629687,1672630151,464
11638,3312651192,3238310644,1672678573,1672681419,2846
11576,3756413374,3757089924,1672680581,1672682614,2033
10464,3288791629,3505491969,1672570583,1672571982,1399
9872,3710585241,3735497729,1672624690,1672625528,838
11347,3977360666,3774195369,1672585498,1672588786,3288
10951,3736987749,3311177439,1672601053,1672601298,245
11480,3520182275,3757851680,1672538637,1672541890,3253
10136,3811354125,3714250543,1672561904,1672564394,2490
10146,3534372899,3910354786,1672540931,1672542888,1957
10524,3892177203,3815700240,1672669460,1672671669,2209
10992,3200785194,3511750850,1672675416,1672675848,432
11355,3924963918,3231654754,1672651033,1672653067,2034
10555,3919342147,3760979523,1672682441,1672684726,2285
11499,3304661369,3505245692,1672657212,1672660480,3268
9922,3907225070,3714718326,1672674017,1672675904,1887
11685,3241567995,3770564547,1672695936,1672697572,1636
10542,3711214982,3888409038,1672536694,1672536865,171
10394,3505908965,3923133978,1672678726,1672680487,1761
10421,3773899531,3354877289,1672671703,1672671901,198
11724,3458130310,3792277399,1672534573,1672537066,2493
10802,3857244486,3301449986,1672609068,1672611461,2393
10239,3510919509,3807111856,1672579342,1672580322,980
9918,3900793652,3833520635,1672577957,1672580953,2996
10878,3511412229,3516572212,1672679614,1672681307,1693
10229,3207497598,3896615831,1672595270,1672595693,423
11753,3777290300,3716183063,1672617032,1672617540,508
11717,3395069149,3514628916,1672684322,1672686645,2323
11373,3422915648,3713740434,1672559312,1672559865,553
11285,3491335890,3793902476,1672689301,1672692778,3477
10263,3923524564,3906693728,1672563812,1672564111,299
10213,3509508477,3688870751,1672571262,1672572196,934
10600,3510987684,3353326305,1672572534,1672573056,522
11172,3512411326,3299847117,1672582367,1672585647,3280
10893,3519435459,3203909360,1672594695,1672596119,1424
10916,3755465396,3510882475,1672579554,1672580072,518
11366,3516815069,3773378103,1672650480,1672651244,764
10913,3447591143,3513996288,1672662736,1672663079,343
10277,3600978954,3505245692,1672555513,1672556021,508
9865,3606804618,3441336851,1672641188,1672644525,3337
10183,3777751979,3770941125,1672698706,1672700116,1410
9898,3509382404,3713475356,1672608004,1672609227,1223
10700,3517021928,3622654885,1672604478,1672605686,1208
10291,3927504954,3773378103,1672648808,1672652162,3354
10646,3773434690,3517227599,1672678501,1672681017,2516
10379,3792411831,3220987526,1672663293,1672663588,295
10249,3231271498,3459163055,1672699786,1672699866,80
10308,3515726910,3780050146,1672601407,1672601883,476
11247,3369270860,3701925712,1672536601,1672538191,1590
11601,3271719569,3711854614,1672702952,1672705901,2949
11261,3611832288,3517943697,1672688059,1672691127,3068
10961,3756695502,3776200012,1672622298,1672624216,1918
9955,3888523259,3418382025,1672613839,1672616492,2653
10957,3792107875,3517195738,1672557833,1672559911,2078
11394,3602401154,3851451801,1672652045,1672652172,127
10067,3384001094,3776200012,1672620022,1672620790,768
10208,3919494952,3937854073,1672630275,1672632780,2505
10223,3520763492,3975799349,1672635695,1672638636,2941
10046,3241593146,3511004622,1672646388,1672649000,2612
11235,3500688476,3777439655,1672553839,1672554607,768
10878,3777290300,3513764665,1672602668,1672605773,3105
11350,3297684667,3638126174,1672604981,1672606022,1041
11627,3461743188,3519997661,1672541618,1672542999,1381
11403,3732223664,3774663639,1672636227,1672636909,682
10732,3756297396,3780982229,1672538649,1672538759,110
11318,3422959249,3519494023,1672619484,1672620846,1362
10974,3371759126,3880788853,1672698412,1672699150,738
10804,3239082508,3774682234,1672621478,1672624695,3217
10520,3505531432,3338187803,1672592317,1672594141,1824
11073,3772169046,3511382748,1672632182,1672632821,639
10718,3352374868,3512681214,1672610142,1672613188,3046
10862,3500145103,3898592058,1672659511,1672659895,384
11028,3668063289,3882580580,1672581643,1672582439,796
10195,3791994414,3770925016,1672615432,1672616245,813
10376,3234445133,3760801237,1672675920,1672677341,1421
11085,3418791124,3511500932,1672622258,1672622784,526
11557,3624164232,3534988162,1672580019,1672582740,2721
11285,3510638085,3509470194,1672573256,1672576780,3524
11618,3611533094,3911376818,1672642124,1672643288,1164
10771,3935333166,3230612965,1672620059,1672620824,765
10329,3484739955,3515259326,1672701562,1672704930,3368
10097,3711196962,3792021895,1672656254,1672658758,2504
11538,3204821370,3238310644,1672534924,1672537424,2500
11042,3272096922,3505685294,1672661242,1672663260,2018
10747,3338187803,3358211034,1672585147,1672586570,1423
9820,3737738751,3490953301,1672635457,1672637524,2067
11693,3904045870,3500589560,1672625463,1672627963,2500
10527,3494157939,3516429380,1672570951,1672572987,2036
10962,3925823748,3344478603,1672664730,1672665047,317
9838,3505836431,3854957153,1672634658,1672635442,784
11457,3757592622,3713694278,1672635832,1672637228,1396
10129,3534372899,3760854788,1672549714,1672551329,1615
11427,3778318250,3515726910,1672578469,1672579483,1014
11406,3552444228,3389069291,1672551546,1672553491,1945
10628,3757869138,3783238023,1672636741,1672639767,3026
10209,3778713526,3669418238,1672625938,1672626092,154
9882,3714897456,3774706478,1672664988,1672667663,2675
11037,3711243126,3701685828,1672636702,1672639911,3209
9857,3292663993,3934280144,1672701488,1672703446,1958
10965,3757598610,3505266343,1672644709,1672647737,3028
11202,3423346297,3818324410,1672689933,1672692233,2300
10798,3916924978,3510826414,1672666766,1672668327,1561
11149,3776447604,3773523569,1672594285,1672595990,1705
10190,3779505358,3711804184,1672578505,1672581672,3167
11152,3776187150,3662354016,1672680182,1672682869,2687
10875,3737745988,3374195945,1672684416,1672685781,1365
10677,3421674406,3776841808,1672652295,1672654266,1971
10774,3778605154,3477511446,1672689498,1672692820,3322
11003,3336501403,3374652108,1672627744,1672629523,1779
11427,3209925780,3514776568,1672660898,1672661543,645
11755,3783201950,3311810583,1672582012,1672584355,2343
9929,3755865626,3684651755,1672690205,1672691048,843
10328,3404187438,3636885498,1672656791,1672660129,3338
11261,3755630085,3406029706,1672693711,1672693993,282
11068,3517810375,3409514897,1672651679,1672654194,2515
11130,3739297004,3516585063,1672668550,1672669034,484
9844,3307236682,3500456339,1672658014,1672658451,437
9914,3368848936,3471555057,1672595763,1672595916,153
9801,3776001441,3739297004,1672665171,1672668407,3236
9951,3711404205,3716209499,1672682786,1672682953,167
9961,3511867383,3773024346,1672623710,1672625615,1905
10774,3703443664,3518117078,1672560223,1672561482,1259
11550,3711854614,3774965463,1672558578,1672558852,274
9999,3756119976,3805718871,1672538916,1672541457,2541
10630,3281970147,3408828584,1672620007,1672621158,1151
10582,3511864772,3515726910,1672679593,1672681230,1637
9794,3780224882,3710813103,1672591218,1672592776,1558
10993,3716468783,3710149975,1672678905,1672679206,301
11065,3701359045,3711040761,1672682405,1672683716,1311
9843,3512395783,3716179251,1672591018,1672591360,342
10048,3776053981,3302929858,1672639668,1672641018,1350
10347,3779561601,3512726649,1672641356,1672642805,1449
9907,3663505156,3233917789,1672534980,1672535834,854
10383,3499820963,3235313062,1672587678,1672591253,3575
10237,3459694275,3501977123,1672545241,1672545919,678
11587,3938059867,3387971464,1672687819,1672690675,2856
11415,3792021895,3680939042,1672689938,1672692374,2436
10965,3715249954,3779748270,1672667581,1672670800,3219
10860,3511671476,3715291931,1672614191,1672617395,3204
10489,3791581138,3519260216,1672626115,1672627200,1085
9939,3405435885,3827981800,1672624410,1672625928,1518
11673,3713224038,3499998389,1672559237,1672562819,3582
9947,3451757423,3892177203,1672589006,1672589248,242
10881,3701385831,3897186782,1672576906,1672578267,1361
10660,3377311502,3500922040,1672661844,1672662317,473
11127,3337715675,3757639274,1672598552,1672602029,3477
10450,3519356606,3299847117,1672692765,1672695416,2651
11203,3716492409,3821087562,1672574221,1672576261,2040
10383,3774436159,3802625412,1672551351,1672552263,912
11294,3780500331,3777751979,1672680202,1672682948,2746
9888,3499622352,3236360179,1672564347,1672566951,2604
10713,3513800589,3553229537,1672534235,1672537435,3200
10388,3773876312,3534506090,1672587993,1672589420,1427
11688,3278430820,3533209168,1672567810,1672570842,3032
10621,3770972037,3760397450,1672578506,1672580608,2102
9825,3858429342,3519108639,1672552845,1672554153,1308
10367,3416474842,3411626917,1672680326,1672681565,1239
11440,3271780525,3419378107,1672630112,1672633681,3569
11341,3287753579,3510864325,1672594880,1672595766,886
11338,3825153408,3509503263,1672646156,1672649697,3541
11453,3902682060,3514747345,1672532885,1672535800,2915
11193,3274894848,3513213122,1672563251,1672566078,2827
10342,3778838936,3909632424,1672663421,1672665217,1796
9960,3711767051,3714287902,1672590790,1672592624,1834
11361,3899970524,3807111856,1672579212,1672580464,1252
10830,3808849597,3558203963,1672573681,1672574914,1233
9944,3236886943,3977157565,1672670328,1672672967,2639
10648,3756536512,3770105006,1672679807,1672681546,1739
10687,3304592684,3293898029,1672662499,1672662706,207
10781,3236948071,3227498870,1672581401,1672582262,861
11691,3473706746,3501427691,1672684099,1672685578,1479
10905,3684108920,3423217578,1672700269,1672703843,3574
10866,3780168985,3399173821,1672534060,1672537524,3464
11634,3605760561,3830254808,1672598934,1672600966,2032
11110,3517960740,3435159896,1672556262,1672559727,3465
11005,3611533094,3509562377,1672615882,1672616859,977
10443,3778927933,3791522832,1672590382,1672592860,2478
10841,3887030182,3716389356,1672555160,1672555856,696
9955,3231963246,3791409441,1672700262,1672703310,3048
10048,3510882475,3510869438,1672608429,1672611772,3343
10757,3916656185,3616242727,1672599973,1672600254,281
10894,3703849264,3509382404,1672644158,1672644363,205
11155,3478206139,3909457959,1672641714,1672642446,732
10896,3519947298,3701887470,1672576547,1672578423,1876
11090,3421956717,3446810761,1672632322,1672632891,569
10318,3500595432,3519435459,1672582593,1672583983,1390
11723,3517943697,3534204885,1672553537,1672554362,825
10029,3514013999,3773953689,1672553251,1672553551,300
11231,3515047288,3773848111,1672653390,1672654054,664
9884,3308759754,3405435885,1672591424,1672593576,2152
11032,3202740652,3208962614,1672693073,1672695451,2378
10417,3352493805,3366801723,1672556052,1672557694,1642
11505,3406492167,3716467469,1672681791,1672684078,2287
11713,3534543864,3278779955,1672544431,1672545738,1307
10317,3371184929,3778838936,1672576875,1672579587,2712
10746,3533009565,3713807753,1672646533,1672649833,3300
11621,3390444181,3636015050,1672547112,1672549647,2535
9991,3806720019,3666367524,1672664708,1672665749,1041
10686,3505066871,3710147457,1672616650,1672616878,228
11453,3757128722,3246381831,1672592871,1672595854,2983
10094,3516535558,3852161626,1672671237,1672674654,3417
10180,3756345026,3511218261,1672662474,1672665709,3235
9831,3512371853,3319436533,1672649063,1672649594,531
10460,3235074007,3413236071,1672626506,1672627417,911
10743,3757872458,3510022922,1672670067,1672672944,2877
10910,3703849264,3416474842,1672632542,1672633428,886
10099,3888642876,3974264211,1672570943,1672572079,1136
10899,3515096959,3770991234,1672652132,1672653846,1714
9837,3710680073,3358385652,1672636601,1672637412,811
10361,3293673220,3738760498,1672594931,1672594994,63
9993,3240877710,3760080378,1672615142,1672618048,2906
10428,3445077330,3933469838,1672623201,1672623678,477
11363,3505472087,3397330170,1672650548,1672651733,1185
9874,3662495290,3813276198,1672555269,1672557681,2412
10792,3341432459,3669497617,1672591335,1672591685,350
10164,3854390432,3777686966,1672544890,1672548334,3444
9974,3233712975,3715790104,1672690891,1672691635,744
10383,3442073613,3710919244,1672623888,1672625356,1468
10833,3776867553,3791581138,1672653937,1672654452,515
11559,3293898029,3912915644,1672602815,1672605944,3129
11680,3509317776,3380418745,1672679231,1672679732,501
10492,3519015940,3476958001,1672566856,1672566991,135
10889,3711196962,3602570831,1672616044,1672619257,3213
11169,3777370992,3513215373,1672627358,1672628473,1115
11692,3245121919,3780563627,1672649681,1672650003,322
11398,3905955166,3807646028,1672689524,1672693033,3509
10170,3711190257,3371564186,1672677707,1672679863,2156
11278,3278071998,3779723939,1672635640,1672636982,1342
11242,3773017746,3440305508,1672649967,1672650125,158
9813,3533628528,3791194984,1672659810,1672662295,2485
11348,3410602007,3853783593,1672568502,1672571524,3022
11280,3929923442,3792851584,1672687970,1672688483,513
10115,3208894215,3778561231,1672542821,1672543160,339
11398,3773085258,3511650296,1672618774,1672618840,66
10097,3343698137,3235470567,1672618040,1672618848,808
11205,3246804115,3773554767,1672568864,1672570365,1501
9955,3711945923,3514980025,1672590107,1672592741,2634
11664,3294326116,3925208102,1672669307,1672670840,1533
10225,3757773786,3510189563,1672685235,1672686594,1359
10041,3801379377,3533822490,1672629464,1672630213,749
10445,3780982229,3514352989,1672536637,1672539472,2835
11232,3514564903,3514329209,1672581169,1672581855,686
11556,3509360869,3935444008,1672676283,1672676352,69
9894,3770991234,3516815069,1672604518,1672605369,851
10780,3638035545,3487231844,1672698728,1672701481,2753
11782,3830962592,3304672737,1672661064,1672664645,3581
10030,3933469838,3773714494,1672640771,1672641932,1161
10030,3770408300,3701779683,1672652030,1672655155,3125
10649,3500433278,3500814753,1672696325,1672698230,1905
10296,3779478448,3499998389,1672571217,1672574615,3398
10843,3477248170,3714287902,1672577462,1672579608,2146
9951,3633294415,3793003432,1672622555,1672625873,3318
10864,3774965463,3783067048,1672610705,1672612712,2007
10099,3422915648,3703476890,1672667666,1672669596,1930
10751,3779415433,3465672238,1672676913,1672680002,3089
10404,3807717766,3375324190,1672583672,1672584238,566
11281,3347520239,3205161801,1672677273,1672677801,528
10570,3519841427,3440743218,1672666339,1672667705,1366
11271,3703481882,3773826624,1672601515,1672601796,281
9974,3682673884,3890278838,1672576231,1672578757,2526
10601,3509360869,3884458862,1672646875,1672647493,618
10257,3533340292,3777686966,1672539309,1672542588,3279
11528,3777569538,3487622510,1672650473,1672653421,2948
10515,3470997293,3736036532,1672552878,1672553720,842
10321,3975799349,3899294071,1672532473,1672535891,3418
10854,3668369938,3515284733,1672665882,1672667863,1981
10052,3509186338,3971422524,1672603674,1672606704,3030
11221,3509457543,3378172464,1672629998,1672630808,810
11708,3471555057,3500104976,1672685210,1672686915,1705
10779,3730052916,3757584114,1672598475,1672599912,1437
11535,3757199889,3703462221,1672572301,1672572407,106
11631,3488399075,3666561358,1672680802,1672683821,3019
9804,3505331083,3373135211,1672643890,1672647299,3409
10174,3515096959,3402020492,1672612047,1672614939,2892
11511,3629248353,3420983899,1672656534,1672657845,1311
11042,3773017746,3916924978,1672583114,1672583848,734
11755,3776407517,3791409441,1672608151,1672608473,322
10045,3792173463,3440671139,1672700314,1672703547,3233
10457,3854229296,3971289056,1672649373,1672651920,2547
11149,3511415786,3513777705,1672682700,1672683250,550
10169,3605760561,3500234771,1672698401,1672699116,715
9916,3783095041,3514564903,1672603718,1672606380,2662
10737,3510758718,3245501577,1672598915,1672601247,2332
10303,3231963246,3757378286,1672676272,1672678347,2075
10221,3276209319,3447202943,1672536877,1672537167,290
9935,3838119022,3496352027,1672538936,1672541160,2224
11138,3441944896,3313795594,1672559142,1672560603,1461
11248,3559112196,3384001094,1672536256,1672537972,1716
10274,3246971044,3932919664,1672663734,1672665099,1365
9806,3714453773,3898989233,1672554128,1672556099,1971
10524,3247845642,3500799617,1672635531,1672637027,1496
11249,3854202447,3713031958,1672594251,1672596006,1755
9956,3710185376,3293673220,1672689228,1672691583,2355
10526,3688845298,3533830748,1672615954,1672617044,1090
11667,3364286028,3519521903,1672564855,1672564933,78
10846,3366961580,3778909412,1672634420,1672636460,2040
9915,3207748225,3900540310,1672687379,1672689344,1965
10284,3825795004,3738526914,1672640391,1672642834,2443
9927,3772882440,3514576083,1672629198,1672629373,175
11001,3783067048,3774359137,1672557479,1672558682,1203
10680,3791359168,3512750313,1672610890,1672611197,307
11038,3491239350,3701668745,1672617264,1672620110,2846
10322,3820922991,3817376705,1672628582,1672629366,784
10562,3793949077,3305093237,1672606072,1672606512,440
10815,3272581469,3515726910,1672537295,1672540523,3228
10319,3443004958,3221736756,1672591891,1672592133,242
11730,3377446376,3713611960,1672657376,1672660692,3316
11468,3792627762,3342252701,1672602903,1672604864,1961
10912,3927699036,3430823498,1672700012,1672702200,2188
9945,3393001196,3977360666,1672636154,1672637743,1589
10231,3777041132,3755849241,1672669356,1672670446,1090
10614,3480259863,3553229537,1672660684,1672662949,2265
11008,3887382548,3514216460,1672594278,1672596654,2376
10947,3385006834,3605905645,1672631014,1672634602,3588
10082,3777060250,3622218289,1672663884,1672665971,2087
10937,3358434853,3613828705,1672690145,1672690211,66
11013,3760554453,3852014884,1672567892,1672570777,2885
11373,3517195738,3426207439,1672618408,1672620718,2310
10915,3334633634,3519724388,1672550399,1672550604,205
10809,3305612422,3776534957,1672669915,1672671095,1180
9794,3305727497,3774145748,1672670894,1672671597,703
11103,3500994763,3625779003,1672677061,1672679566,2505
10866,3663505156,3393543588,1672684284,1672685659,1375
9802,3801379377,3777715675,1672691599,1672694177,2578
10024,3514216460,3500671218,1672585734,1672589051,3317
9936,3474852115,3792411831,1672545741,1672547211,1470
11257,3682673884,3505414878,1672703288,1672705950,2662
11280,3534491112,3714903253,1672643343,1672643812,469
11678,3772968080,3510939082,1672674747,1672678131,3384
10459,3757513651,3389367628,1672655878,1672657454,1576
9796,3373851012,3516429380,1672531575,1672532922,1347
11528,3774744663,3773738817,1672703964,1672705661,1697
11732,3520697518,3424476995,1672689348,1672690622,1274
9835,3360972732,3755192104,1672628454,1672631198,2744
10598,3505472087,3791587717,1672672678,1672675350,2672
11461,3834980281,3518205307,1672599707,1672600961,1254
11170,3772070986,3827981800,1672679702,1672681357,1655
11247,3518995270,3773876312,1672703395,1672705747,2352
11227,3438204844,3688410383,1672655977,1672657642,1665
10549,3413799143,3299845453,1672651787,1672653483,1696
10167,3792012147,3714065165,1672633715,1672635748,2033
10976,3899970524,3558567160,1672700281,1672700580,299
10017,3403738461,3519724388,1672580529,1672582515,1986
10106,3772489471,3922430928,1672629615,1672632431,2816
10284,3394959062,3783067048,1672645146,1672645977,831
11000,3633949990,3463564410,1672543289,1672544475,1186
10208,3352374868,3703749690,1672702617,1672703552,935
11325,3298113026,3976742903,1672587814,1672590015,2201
10389,3757201538,3386323728,1672581753,1672581884,131
9818,3231859576,3366164642,1672638914,1672641653,2739
9891,3505816624,3760554453,1672684470,1672687705,3235
9971,3226913558,3783651407,1672697232,1672699017,1785
10294,3603740088,3370751461,1672568470,1672570484,2014
11743,3357496255,3757604311,1672670991,1672673186,2195
11247,3518425740,3703438617,1672581750,1672584298,2548
9823,3278779955,3839308659,1672575480,1672577527,2047
11164,3509018337,3558203963,1672682575,1672684208,1633
10352,3520016705,3613940925,1672678121,1672680242,2121
11379,3921736061,3880562532,1672684204,1672685318,1114
10987,3356972733,3703614781,1672564660,1672567711,3051
11565,3668154066,3206217657,1672538878,1672539927,1049
11550,3501980730,3710316008,1672668191,1672670290,2099
10068,3710260848,3812277991,1672618590,1672619078,488
10171,3510143850,3496591885,1672609227,1672610141,914
10019,3912625932,3518209090,1672595116,1672597429,2313
10660,3374552204,3812677669,1672604925,1672605338,413
10234,3511289729,3500688476,1672557275,1672560083,2808
10698,3701412729,3772648837,1672591409,1672594492,3083
10737,3919349138,3555764822,1672683670,1672686622,2952
11402,3735838864,3311521176,1672593320,1672593655,335
10222,3682802569,3412605548,1672574011,1672576191,2180
9899,3710185376,3343616490,1672682878,1672685974,3096
10851,3714067998,3711430738,1672577171,1672579357,2186
10989,3733423371,3636857871,1672559365,1672561331,1966
11744,3515753241,3605760561,1672639454,1672640391,937
11050,3437286595,3509252934,1672583015,1672586129,3114
10016,3491948594,3664523809,1672642584,1672645150,2566
10272,3792075871,3851810349,1672613511,1672615761,2250
10187,3513143959,3468871103,1672576202,1672579354,3152
10489,3490953301,3856129522,1672602489,1672603707,1218
11239,3456795601,3534206917,1672550098,1672552938,2840
11128,3716541851,3512645289,1672701078,1672704023,2945
11721,3249771731,3516019206,1672690290,1672692033,1743
10238,3684199077,3515548696,1672629343,1672629843,500
10459,3735152111,3361789225,1672575076,1672578299,3223
11014,3852275715,3773024346,1672585515,1672588269,2754
11205,3345028045,3772609551,1672678114,1672679833,1719
9857,3734957248,3533209168,1672553353,1672553862,509
10575,3818570577,3703423962,1672545215,1672545997,782
9797,3912181197,3411213032,1672654506,1672656986,2480
11019,3374195945,3703896751,1672582439,1672583696,1257
11163,3512700007,3899205452,1672624280,1672625495,1215
10801,3756363182,3755218683,1672604275,1672607702,3427
10178,3715249954,3501027795,1672569828,1672571932,2104
11784,3713726267,3404187438,1672689496,1672692428,2932
11481,3881579907,3713728777,1672695387,1672698160,2773
10231,3701004302,3829761380,1672679625,1672681705,2080
11588,3701218904,3776279305,1672553865,1672556933,3068
10786,3823307824,3517377614,1672638870,1672641292,2422
11337,3907225070,3633622298,1672644319,1672646578,2259
10070,3406390503,3295787354,1672679533,1672680234,701
10769,3422548081,3772251279,1672645951,1672648811,2860
11393,3304252969,3512638952,1672594142,1672595190,1048
10881,3510968599,3852014884,1672570896,1672573028,2132
11469,3313824913,3295748489,1672699952,1672701095,1143
11291,3783368855,3376842515,1672658262,1672659846,1584
11069,3703588004,3713728777,1672679861,1672680649,788
10853,3739844610,3500595432,1672617607,1672619227,1620
10696,3714283424,3292936094,1672571765,1672574256,2491
10616,3711131262,3773603836,1672565982,1672566955,973
11660,3239279744,3311771689,1672557214,1672558008,794
10266,3714595459,3619494735,1672570856,1672573131,2275
10622,3902023467,3772296376,1672612011,1672612130,119
11478,3757514745,3716647407,1672632610,1672634517,1907
10170,3443004958,3533976217,1672700824,1672701434,610
9814,3380218091,3509996827,1672532186,1672535442,3256
10293,3855674398,3908878965,1672690767,1672691855,1088
11145,3342426430,3907225070,1672639080,1672640579,1499
10152,3755922811,3514005973,1672639415,1672641068,1653
11063,3432762943,3755670258,1672686970,1672689921,2951
11626,3716341323,3772966919,1672664166,1672666108,1942
10305,3777686966,3853188285,1672701107,1672704426,3319
10861,3505331014,3978254945,1672685154,1672687528,2374
11357,3510022922,3438204844,1672617356,1672618364,1008
11433,3209280342,3616242727,1672603305,1672605120,1815
9808,3922301238,3825526565,1672686390,1672687344,954
11674,3375905193,3515096959,1672580595,1672581971,1376
10276,3662055682,3402020492,1672640530,1672641397,867
11493,3520926977,3512555384,1672699963,1672700402,439
10015,3770595035,3972856326,1672699522,1672700810,1288
11127,3516572212,3513859809,1672612111,1672615301,3190
11401,3715844082,3515893948,1672622514,1672625090,2576
10508,3772659062,3447253775,1672669943,1672673515,3572
10220,3285515107,3924963918,1672618482,1672619427,945
10816,3776166086,3711349327,1672533215,1672536192,2977
9891,3474074188,3402338011,1672543795,1672546585,2790
10056,3970851830,3713069234,1672701108,1672703616,2508
10278,3373018943,3393502004,1672655917,1672658151,2234
10160,3390444181,3773394570,1672613267,1672616410,3143
10838,3444680955,3360949039,1672673910,1672676763,2853
10002,3238056215,3603167427,1672601720,1672604233,2513
11427,3500994763,3779255367,1672673501,1672673861,360
11689,3512638952,3716460706,1672674245,1672675046,801
11385,3777499535,3711765138,1672662273,1672663621,1348
10503,3885674996,3711187791,1672669579,1672669887,308
11154,3299845453,3713471446,1672607837,1672608688,851
11452,3770846374,3444168914,1672698834,1672699605,771
11481,3374552204,3319585148,1672555796,1672558828,3032
10180,3533929043,3368848936,1672676777,1672680093,3316
11705,3636015050,3400793223,1672701931,1672705206,3275
10388,3371564186,3276209319,1672610203,1672613662,3459
10580,3362385373,3760554453,1672678242,1672681098,2856
11252,3375905193,3238779889,1672690472,1672691090,618
10277,3715737742,3311583437,1672621539,1672623014,1475
11462,3351856699,3413236071,1672631476,1672634153,2677
11292,3770275898,3714377201,1672566860,1672569237,2377
10747,3711076751,3512596743,1672540066,1672543175,3109
11342,3505011956,3757584114,1672660891,1672663980,3089
10139,3852992961,3272096922,1672546001,1672549015,3014
11577,3904004824,3550405857,1672552124,1672552748,624
11128,3505531432,3443041059,1672700919,1672702435,1516
11132,3488887919,3511078598,1672696391,1672696847,456
10325,3200372897,3915460293,1672539081,1672542000,2919
11289,3715750580,3792682835,1672540605,1672542809,2204
11624,3701459978,3512154443,1672568175,1672569163,988
11470,3667072319,3777290300,1672633330,1672634923,1593
9818,3495482863,3974264211,1672645556,1672649136,3580
10978,3505502819,3850904092,1672593093,1672593516,423
11786,3779561601,3778561231,1672568212,1672571562,3350
10968,3512203553,3289017988,1672703154,1672704034,880
10557,3783563043,3514244308,1672551449,1672551765,316
11710,3414387263,3783594246,1672691220,1672693824,2604
10473,3505571800,3760396348,1672542517,1672543416,899
10169,3609103278,3351856699,1672577105,1672577971,866
10919,3512251592,3755769731,1672540158,1672543504,3346
11650,3400025324,3446537819,1672682342,1672682992,650
10220,3814289471,3818324410,1672565457,1672567445,1988
11473,3520515739,3780142207,1672603781,1672606109,2328
11241,3773848111,3772751765,1672536235,1672537184,949
11524,3415840750,3897003751,1672644562,1672644975,413
10452,3733796228,3380357490,1672574063,1672576480,2417
10380,3757607649,3486509752,1672587357,1672588243,886
11069,3206262649,3235470567,1672578597,1672579584,987
10034,3438028077,3756525103,1672538239,1672540067,1828
11433,3925823748,3479402555,1672565223,1672567318,2095
10165,3688410383,3429315500,1672598605,1672599230,625
11109,3826315540,3293898029,1672661643,1672663940,2297
11021,3442403264,3826068495,1672679539,1672681260,1721
10514,3730935770,3499343927,1672666644,1672667211,567
9890,3776407517,3519341916,1672615828,1672616368,540
10091,3517627003,3774355339,1672621810,1672624125,2315
10000,3399430522,3908331271,1672571701,1672572318,617
10052,3517797610,3715284599,1672563679,1672565407,1728
11592,3552922094,3221736756,1672668015,1672669338,1323
11018,3760737203,3791581138,1672612163,1672615516,3353
11071,3783408830,3487395357,1672587775,1672589866,2091
10594,3519494023,3909504515,1672586128,1672588864,2736
10234,3793274846,3760656396,1672566390,1672569020,2630
9816,3534667712,3836090778,1672641618,1672644780,3162
10147,3491239350,3780308809,1672668539,1672669512,973
10521,3920155862,3509317054,1672645063,1672647144,2081
10975,3479402555,3534775239,1672606287,1672606434,147
11695,3662507634,3668855144,1672535828,1672538911,3083
10409,3491250381,3394364348,1672641772,1672642975,1203
11762,3404461403,3229570647,1672658080,1672659392,1312
9917,3513894659,3491250381,1672668270,1672671321,3051
11481,3392573386,3778838936,1672589828,1672592807,2979
11060,3500799617,3703614781,1672635932,1672638635,2703
11763,3756736726,3476308535,1672560038,1672562166,2128
10108,3914947393,3792283334,1672536699,1672537865,1166
11741,3977157565,3501734800,1672533108,1672534340,1232
9930,3439036305,3792578118,1672683074,1672684092,1018
10386,3783554600,3730600658,1672546217,1672548323,2106
10015,3730169449,3279731391,1672567182,1672570003,2821
10637,3274341934,3500889287,1672648414,1672650691,2277
11134,3275975921,3500178849,1672688836,1672690722,1886
11577,3687183789,3668764192,1672555180,1672558613,3433
9966,3667950469,3225554956,1672652043,1672653681,1638
10061,3617771673,3512337054,1672624833,1672625681,848
10157,3382746533,3511095300,1672618528,1672619836,1308
10594,3772216305,3832002939,1672601840,1672602288,448
10577,3515558215,3388537708,1672595707,1672598560,2853
9959,3227059650,3203172170,1672686704,1672687500,796
11243,3755154460,3778924002,1672703016,1672705305,2289
11004,3791070926,3615846003,1672660059,1672660757,698
10137,3205161801,3792475476,1672622116,1672624283,2167
10522,3886957097,3713728777,1672610077,1672611680,1603
11688,3793232021,3730226545,1672634989,1672635515,526
11009,3971996397,3604908372,1672568619,1672568845,226
10010,3887069914,3757607649,1672572663,1672574964,2301
10434,3778738044,3226761201,1672556599,1672558439,1840
11566,3884933821,3221126799,1672638556,1672638715,159
10757,3977666815,3510291656,1672651630,1672653030,1400
10396,3734233216,3682266017,1672645179,1672648318,3139
10201,3832002939,3883640904,1672608078,1672610384,2306
10150,3512504247,3497562878,1672533350,1672536741,3391
9874,3387700451,3517358336,1672641911,1672644395,2484
11095,3248409083,3338465050,1672566274,1672568664,2390
11420,3501557463,3500473064,1672610740,1672613003,2263
10549,3757128722,3711214982,1672542939,1672546054,3115
11721,3515047288,3514761434,1672555173,1672557016,1843
10881,3534531039,3447267291,1672599222,1672599501,279
11373,3519521903,3685645561,1672623648,1672626649,3001
11739,3245882008,3710865678,1672538479,1672540969,2490
10002,3929446196,3778124514,1672569375,1672569721,346
11741,3517797610,3534174363,1672646491,1672647278,787
10680,3837271330,3446764595,1672696185,1672697515,1330
10128,3711065081,3500120676,1672644943,1672647466,2523
11340,3239082508,3780298499,1672692271,1672694477,2206
11404,3515893948,3225371682,1672668958,1672669676,718
9913,3246804115,3375905193,1672657044,1672660595,3551
11474,3931028233,3772114731,1672568013,1672569174,1161
10547,3364067937,3474879231,1672634986,1672636962,1976
9876,3514673213,3710046567,1672608258,1672609460,1202
10266,3713906305,3911821258,1672591427,1672594969,3542
10857,3737571883,3505756991,1672546584,1672549285,2701
11774,3703502114,3791222330,1672648537,1672649269,732
11442,3520305100,3417223898,1672658605,1672659014,409
11313,3815440588,3701725839,1672543718,1672544040,322
11498,3711810268,3286862903,1672571495,1672572090,595
11167,3513213122,3780749789,1672640508,1672642183,1675
10395,3351728355,3311200541,1672640161,1672643546,3385
10162,3688870751,3791581138,1672589225,1672590808,1583
10121,3773826624,3713373455,1672677519,1672677744,225
10411,3756759239,3710271021,1672560712,1672563079,2367
10795,3501976169,3311177439,1672566772,1672570076,3304
9866,3776053084,3513384042,1672575980,1672578530,2550
11121,3919984986,3415562576,1672689310,1672689538,228
10523,3925792265,3509252934,1672615362,1672615903,541
11410,3772070986,3910190872,1672695447,1672696564,1117
10398,3856129522,3776279305,1672669488,1672672009,2521
11373,3337903727,3436099135,1672679302,1672681543,2241
10516,3359880163,3686211958,1672634361,1672636943,2582
11580,3755209597,3778713526,1672695859,1672698863,3004
10631,3453464785,3896840409,1672561263,1672564636,3373
10308,3311409212,3880030249,1672591237,1672593964,2727
9909,3780435349,3511907179,1672554979,1672558578,3599
11271,3760346746,3358982831,1672598394,1672599942,1548
11059,3730414796,3780173788,1672617445,1672618785,1340
10467,3505685294,3935444008,1672682396,1672683170,774
11552,3911821258,3517469005,1672665499,1672667971,2472
10007,3476308535,3402580733,1672539918,1672540717,799
9872,3909067335,3884388188,1672534469,1672537574,3105
11635,3772708314,3368079099,1672680406,1672683592,3186
11254,3517380144,3403257752,1672631986,1672634646,2660
11736,3294949958,3755849241,1672594940,1672597601,2661
9911,3495637721,3755670258,1672540348,1672542976,2628
9820,3716740576,3856147380,1672575641,1672578091,2450
11400,3288346356,3347140733,1672632027,1672633738,1711
11127,3772968080,3714838100,1672546764,1672547429,665
11526,3715249954,3823307824,1672698706,1672699756,1050
11365,3713102459,3703722212,1672663163,1672666665,3502
11242,3777552831,3777992576,1672577141,1672580216,3075
11134,3500671218,3835262447,1672617364,1672618233,869
10668,3471555057,3446764595,1672688717,1672691458,2741
11768,3436099135,3772648837,1672696485,1672697485,1000
11310,3605905645,3881785069,1672637876,1672638481,605
11746,3512343029,3626631210,1672628279,1672629231,952
10241,3501977123,3519948471,1672656843,1672660196,3353
10867,3391093411,3634766042,1672564786,1672565480,694
10278,3511199555,3773669001,1672555921,1672559456,3535
10479,3851451801,3920526713,1672662304,1672662817,513
10333,3716389356,3716467469,1672596842,1672599862,3020
9989,3755790149,3559123082,1672622555,1672624467,1912
11621,3512697456,3904184638,1672677531,1672679886,2355
10066,3501657158,3890638402,1672579335,1672582680,3345
11400,3347172556,3235198316,1672640026,1672642837,2811
11520,3292663993,3714718326,1672588126,1672589900,1774
11070,3342056927,3770172119,1672573462,1672574850,1388
9821,3285515107,3770530739,1672561326,1672564557,3231
11226,3374348845,3471585513,1672694112,1672696036,1924
11074,3713606829,3500079479,1672687948,1672691169,3221
11297,3937299996,3813276198,1672572715,1672576128,3413
11772,3830254808,3730290851,1672683867,1672683968,101
10074,3684199077,3228033254,1672682503,1672684790,2287
10774,3756437169,3927763819,1672534437,1672536681,2244
9922,3345896913,3271389160,1672656618,1672659142,2524
11276,3284483177,3298113026,1672669736,1672672834,3098
11652,3226761201,3757311529,1672606083,1672608187,2104
10865,3701925712,3663902064,1672540609,1672542025,1416
10275,3473706746,3778695895,1672658225,1672660127,1902
11578,3772962072,3757201138,1672545105,1672546557,1452
10672,3665478011,3736056340,1672672162,1672674044,1882
11606,3513545735,3884191432,1672696044,1672699465,3421
11228,3757514745,3513186578,1672687893,1672689899,2006
11190,3832745283,3732223664,1672633717,1672636811,3094
11557,3791542842,3715419141,1672602155,1672603837,1682
10249,3356972733,3731905251,1672699756,1672701749,1993
10356,3312800145,3923524564,1672680656,1672682565,1909
10286,3630802959,3533876927,1672639061,1672640319,1258
10425,3509370633,3735197034,1672599388,1672600812,1424
11564,3714870496,3772343750,1672564721,1672568228,3507
9904,3518478484,3239423794,1672557962,1672559297,1335
10636,3482786946,3450679913,1672663009,1672666508,3499
9916,3447253775,3520832066,1672642173,1672645491,3318
10495,3683677062,3518067857,1672698158,1672700304,2146
10940,3305093237,3813853446,1672642660,1672645675,3015
11092,3342252701,3517358336,1672590112,1672591466,1354
11210,3516019206,3430296808,1672667310,1672668505,1195
9863,3400186699,3486509752,1672599475,1672600341,866
10524,3512527440,3500234771,1672583125,1672583797,672
10683,3774663639,3514145752,1672533286,1672534956,1670
10709,3246062632,3510149298,1672623911,1672625629,1718
10974,3925208102,3505769529,1672557671,1672561148,3477
10113,3292936094,3505173665,1672703748,1672706210,2462
11584,3512826895,3757406215,1672617234,1672617650,416
11100,3505351253,3757855416,1672634184,1672637234,3050
10702,3778838936,3756647451,1672571642,1672572521,879
9964,3519724388,3931917809,1672602343,1672605270,2927
10894,3516359146,3270607273,1672651865,1672653381,1516
11229,3430032005,3304227085,1672584514,1672587671,3157
10379,3783879023,3899970524,1672676676,1672677356,680
10623,3660702754,3711223297,1672651902,1672652539,637
9934,3893043842,3711349327,1672663653,1672663921,268
10707,3458432407,3973582279,1672572148,1672573376,1228
10928,3755378125,3306491253,1672638307,1672639887,1580
10331,3814672661,3777569538,1672563880,1672564074,194
10542,3903994989,3739217535,1672697251,1672697921,670
9795,3519059808,3533974355,1672600542,1672603685,3143
10575,3972196462,3227206772,1672668133,1672669236,1103
11090,3880882684,3774673193,1672663068,1672663912,844
9996,3275751794,3621960662,1672689869,1672691960,2091
11548,3701493094,3496579251,1672577337,1672579679,2342
11308,3520165730,3520779124,1672691885,1672694589,2704
9992,3793920312,3638018906,1672653941,1672655393,1452
10290,3294164983,3934980229,1672610689,1672612828,2139
11032,3520016705,3372079985,1672598616,1672601255,2639
11094,3245882008,3711076751,1672658483,1672660965,2482
10306,3500928990,3519260216,1672668122,1672669520,1398
9912,3469780362,3791269060,1672656679,1672657890,1211
10534,3432838598,3791106473,1672548136,1672549014,878
11555,3770671714,3505697295,1672686229,1672689272,3043
11625,3603452936,3203876438,1672680223,1672683094,2871
10367,3791382196,3772909073,1672606843,1672608197,1354
9855,3899756737,3713100169,1672623235,1672626157,2922
11323,3757501067,3914926436,1672666862,1672667485,623
11725,3711430738,3776732532,1672621923,1672624043,2120
10870,3662307789,3793899166,1672582032,1672583698,1666
11404,3202787155,3830291558,1672542424,1672543577,1153
9948,3505491969,3517132086,1672669359,1672670470,1111
11254,3755357292,3409098014,1672701473,1672703669,2196
11068,3429333292,3735056027,1672601435,1672603528,2093
11702,3417431173,3511003541,1672532419,1672534548,2129
10359,3411213032,3517151644,1672545696,1672547569,1873
10925,3934280144,3931917809,1672562883,1672565607,2724
11103,3711287751,3880030249,1672572227,1672574867,2640
10971,3434581257,3291153514,1672638318,1672640781,2463
11487,3511466117,3483701493,1672566231,1672569542,3311
10981,3780500764,3306475287,1672643259,1672643423,164
11568,3703476890,3517949586,1672614197,1672614601,404
10031,3715008501,3274341934,1672542116,1672542251,135
11205,3791994414,3233917789,1672636146,1672639214,3068
10420,3273242177,3416474842,1672681588,1672682459,871
11154,3774195369,3514776568,1672592648,1672594623,1975
11188,3307216611,3558349840,1672641867,1672645302,3435
10341,3713726267,3208894215,1672686629,1672688889,2260
10444,3513624915,3423782420,1672579219,1672582315,3096
11287,3736203662,3533265491,1672691630,1672695128,3498
10948,3336501403,3809194824,1672649057,1672650626,1569
9907,3621812406,3534626053,1672549260,1672549914,654
11097,3793029132,3435715962,1672596935,1672597646,711
10207,3420881591,3777928067,1672655317,1672656167,850
11670,3311569360,3880637958,1672670133,1672672156,2023
10576,3310021925,3714453773,1672553810,1672555178,1368
11608,3737571883,3403177609,1672556853,1672557028,175
10358,3533627473,3760069457,1672643087,1672645125,2038
10345,3514352989,3449672240,1672619504,1672620936,1432
11323,3500234771,3482786946,1672584754,1672585411,657
11712,3344710271,3701291994,1672552529,1672554839,2310
10022,3636605690,3420881591,1672634247,1672634824,577
10747,3354015456,3384170206,1672566161,1672566903,742
10215,3770533588,3908878965,1672540374,1672543946,3572
9975,3855077502,3773024346,1672621435,1672623000,1565
11019,3927805949,3347172556,1672596394,1672599175,2781
11656,3519255644,3368951504,1672680258,1672683625,3367
10146,3295710494,3304030474,1672685135,1672686935,1800
11561,3505490878,3793497672,1672584009,1672586090,2081
11527,3681737865,3518408734,1672589025,1672589975,950
11690,3624164232,3779778679,1672535712,1672537599,1887
10778,3791070926,3395082458,1672554893,1672555390,497
11226,3703277359,3851877325,1672534619,1672536436,1817
11171,3773534165,3891272544,1672576936,1672579543,2607
10015,3713767153,3732312480,1672695854,1672697244,1390
11397,3778253021,3505175620,1672606388,1672608687,2299
11182,3512697456,3512794667,1672694850,1672698147,3297
10833,3813986705,3669427589,1672665300,1672667337,2037
11539,3510894809,3557324887,1672665002,1672668564,3562
10965,3429587594,3633622298,1672625871,1672628132,2261
11625,3500596577,3792021895,1672553990,1672555283,1293
10654,3348343425,3711810268,1672547675,1672549455,1780
10673,3494157939,3703443664,1672544496,1672546469,1973
9911,3701529552,3472774606,1672617902,1672619338,1436
9971,3272328752,3611570003,1672653450,1672655407,1957
10444,3519162582,3713728777,1672559544,1672559838,294
10059,3453464785,3938129916,1672543019,1672544437,1418
11383,3505351253,3505173665,1672640686,1672643583,2897
10400,3225356349,3510795808,1672674870,1672677055,2185
9795,3905934770,3390537737,1672557088,1672557447,359
10549,3682906048,3533419409,1672600177,1672601394,1217
11710,3343859998,3517021928,1672651759,1672654560,2801
9927,3319436533,3701655378,1672698999,1672701275,2276
11517,3517530943,3515715968,1672621405,1672621889,484
9802,3703104365,3224053840,1672670433,1672670627,194
9949,3406101720,3890638402,1672568501,1672570743,2242
9941,3711131262,3421674406,1672574505,1672576604,2099
9813,3979366845,3509167758,1672685934,1672688612,2678
11264,3733423371,3880637958,1672622104,1672622701,597
11331,3780142207,3757198930,1672611975,1672612560,585
11221,3474097405,3520305100,1672545563,1672548174,2611
10736,3500342408,3307535495,1672583318,1672583683,365
11155,3779160052,3509701363,1672677924,1672678505,581
10240,3793081195,3247845642,1672630267,1672633737,3470
10049,3302988745,3711518637,1672653289,1672654695,1406
10368,3505183641,3513140146,1672535717,1672537149,1432
10997,3340897079,3305093237,1672625352,1672625594,242
9940,3792277399,3516572212,1672648833,1672649991,1158
10211,3520506192,3392010033,1672632196,1672634541,2345
11653,3929355087,3245121919,1672571170,1672574739,3569
10075,3932919664,3756367938,1672581137,1672583951,2814
11130,3736941123,3882905311,1672672411,1672675186,2775
11327,3209280342,3776193847,1672671467,1672675028,3561
11267,3714923092,3791587717,1672535587,1672535747,160
10456,3600302127,3920606331,1672674792,1672676259,1467
10981,3307997700,3499998389,1672603480,1672604038,558
10626,3287968403,3477511446,1672600677,1672602928,2251
10572,3501192566,3515803462,1672676156,1672678904,2748
11088,3310702648,3773852157,1672665582,1672667145,1563
10787,3920526713,3304252969,1672628002,1672631136,3134
10866,3853275529,3667654673,1672619276,1672621055,1779
10209,3776034313,3666367524,1672617367,1672619113,1746
10237,3970775805,3513563152,1672600991,1672604195,3204
11764,3534174363,3917905192,1672689363,1672689633,270
10040,3511750695,3505816624,1672675081,1672675340,259
11418,3438818153,3469778316,1672556394,1672558687,2293
11472,3804095239,3239401337,1672544215,1672546508,2293
10074,3760966645,3516588277,1672652187,1672652396,209
11154,3312612693,3393502004,1672605332,1672606999,1667
11223,3373018943,3373851012,1672645827,1672647809,1982
11034,3776968640,3284483177,1672691017,1672692313,1296
11470,3505816624,3778253021,1672619779,1672622281,2502
11194,3971280379,3629869834,1672633500,1672634952,1452
9883,3496407500,3513816744,1672678626,1672678972,346
11272,3716944983,3600699873,1672564384,1672564620,236
10480,3311774510,3505653701,1672597290,1672598787,1497
10616,3716371766,3774359137,1672662607,1672664833,2226
10891,3893629892,3519553933,1672571875,1672573589,1714
11760,3710852576,3757773786,1672585467,1672587511,2044
10923,3770544738,3735497729,1672630124,1672633431,3307
11685,3711040761,3971289056,1672698240,1672699883,1643
11613,3600171014,3791205793,1672659644,1672661490,1846
9876,3682802569,3779505358,1672628783,1672629619,836
11113,3625400710,3517227599,1672691364,1672694151,2787
11578,3511526885,3793874490,1672660360,1672661247,887
11619,3301403047,3501115299,1672582717,1672583577,860
10354,3738103378,3246062632,1672575059,1672575877,818
9910,3884458862,3378747834,1672699854,1672703073,3219
9944,3440770466,3662507634,1672617521,1672617582,61
10403,3245755569,3311771689,1672632614,1672634944,2330
10668,3902023467,3431317400,1672546671,1672548123,1452
11652,3930475498,3533209168,1672665041,1672667401,2360
10789,3924205112,3533976217,1672620683,1672622202,1519
11634,3519322066,3222364320,1672654426,1672656742,2316
11383,3516486526,3293673220,1672559913,1672562074,2161
11439,3505839395,3713069234,1672635016,1672637927,2911
11456,3299847117,3739844610,1672640444,1672643180,2736
10817,3353326305,3906260966,1672667962,1672670739,2777
11136,3733243990,3229621693,1672683063,1672686363,3300
10935,3858497718,3302929858,1672542194,1672542876,682
11191,3770457058,3923524564,1672650105,1672650469,364
10926,3836586875,3603740088,1672597078,1672598320,1242
11341,3809207482,3888903181,1672641174,1672642222,1048
11347,3459694275,3276393542,1672658286,1672659563,1277
10953,3485468650,3462985379,1672615911,1672619243,3332
10654,3716341323,3404461403,1672594935,1672598367,3432
10750,3428878402,3559112196,1672593452,1672596394,2942
10613,3475090917,3760346746,1672603127,1672604702,1575
9857,3713475356,3710119555,1672604659,1672606488,1829
10719,3278779955,3347520239,1672617287,1672619296,2009
9956,3429333292,3829761380,1672637731,1672638695,964
10747,3505164060,3900793652,1672572411,1672574707,2296
10853,3393376416,3773895671,1672531288,1672531832,544
10145,3533131937,3423217578,1672667073,1672667715,642
11790,3666561358,3520189871,1672607802,1672609109,1307
11206,3480405740,3505032644,1672671376,1672672220,844
10853,3776304080,3497732613,1672531566,1672532269,703
11623,3611832288,3519908593,1672674358,1672674679,321
11760,3512768285,3837888196,1672594218,1672596645,2427
10189,3389069291,3206262649,1672590647,1672591497,850
10770,3500693568,3430310785,1672669327,1672671979,2652
11659,3511883778,3230612965,1672554122,1672555846,1724
11289,3792162098,3519448648,1672554777,1672558156,3379
11124,3710223875,3229621693,1672678921,1672680862,1941
10596,3779255367,3519922921,1672557605,1672560443,2838
10287,3715111016,3278779955,1672553479,1672555064,1585
11325,3311305760,3278629965,1672557863,1672560384,2521
10072,3780168985,3825082811,1672601758,1672603068,1310
10649,3779102237,3757598610,1672589503,1672591611,2108
10377,3270607273,3409098014,1672552155,1672553041,886
10679,3714377201,3485151614,1672532628,1672533952,1324
9795,3793874490,3923133978,1672669399,1672672455,3056
10808,3515507526,3774744663,1672683220,1672686021,2801
9933,3680832669,3774195369,1672622008,1672623609,1601
9965,3773853619,3387700451,1672630841,1672632722,1881
10413,3715441777,3279726491,1672576560,1672577021,461
11759,3341738186,3714142299,1672589588,1672590780,1192
10943,3711810752,3713927376,1672532288,1672533793,1505
11706,3515699732,3387388336,1672595958,1672597335,1377
9963,3793407883,3288346356,1672603617,1672604354,737
10788,3811503860,3829761380,1672613515,1672613828,313
10100,3452090950,3500018566,1672566500,1672570011,3511
10565,3513545735,3497138014,1672545677,1672547217,1540
11120,3600978954,3826418889,1672585525,1672587337,1812
10132,3388463477,3701374160,1672538553,1672540987,2434
9998,3398862999,3513384042,1672645064,1672648362,3298
10188,3783157469,3701311947,1672666983,1672669355,2372
11030,3510486220,3477951091,1672588658,1672588723,65
11353,3512072679,3240683148,1672636378,1672636605,227
9916,3517949586,3909632424,1672655020,1672658456,3436
10794,3311177439,3511003541,1672674506,1672674758,252
9941,3711852131,3452389513,1672674050,1672676964,2914
11765,3783043770,3755849241,1672680430,1672682928,2498
10769,3308149799,3805831563,1672551597,1672555020,3423
10221,3774450494,3510143850,1672686343,1672689082,2739
10568,3509317054,3820280594,1672627310,1672628422,1112
10478,3534770827,3714903253,1672596055,1672598309,2254
11108,3783408830,3298113026,1672643100,1672645002,1902
10638,3339331632,3779393140,1672604570,1672605223,653
10240,3773554767,3628423403,1672698203,1672698276,73
11554,3805704844,3442462115,1672659323,1672660263,940
11073,3209925780,3239990061,1672625132,1672627793,2661
10527,3241682278,3517469005,1672682202,1672683420,1218
11356,3800434325,3774394000,1672592475,1672593282,807
10953,3713416756,3772262649,1672633731,1672635928,2197
10182,3505314920,3510758718,1672572862,1672574558,1696
11751,3730052916,3505825767,1672667194,1672667833,639
10818,3514853709,3851451801,1672659983,1672662421,2438
10753,3206241691,3376487118,1672663166,1672664027,861
10578,3760554453,3318220119,1672675892,1672676986,1094
11310,3793874490,3713224986,1672662312,1672664206,1894
10103,3755411110,3512343029,1672602954,1672604497,1543
9893,3778125688,3738526914,1672613933,1672615859,1926
11425,3418382025,3906075386,1672560508,1672562101,1593
10325,3534770827,3343511947,1672602579,1672602922,343
11265,3792708936,3701004302,1672582178,1672584298,2120
10272,3291446384,3660980656,1672670734,1672671215,481
11313,3517149023,3667072319,1672687118,1672690255,3137
11481,3513293711,3273771395,1672626172,1672629089,2917
11046,3663505156,3510486220,1672667497,1672670939,3442
10450,3714903456,3738547113,1672665948,1672668536,2588
10796,3976742903,3714690161,1672545602,1672548045,2443
10725,3351856699,3491390365,1672686610,1672689985,3375
10906,3516249472,3774448657,1672614625,1672615468,843
10125,3773878451,3403395712,1672642833,1672644251,1418
10314,3519922921,3772943811,1672612472,1672615644,3172
10356,3553008208,3417268745,1672561188,1672562766,1578
10547,3931319307,3450511428,1672582757,1672584163,1406
11532,3793874490,3407398464,1672561448,1672564259,2811
11638,3927202773,3512965991,1672613261,1672614218,957
10396,3516200419,3513545735,1672577372,1672579428,2056
10894,3816184951,3534426696,1672696702,1672697088,386
10756,3452104161,3739075176,1672626678,1672628832,2154
11158,3347205332,3973134902,1672562174,1672564312,2138
10603,3683047199,3770981604,1672553362,1672556582,3220
10543,3517991042,3360783381,1672692673,1672695160,2487
11225,3805268739,3792708936,1672609446,1672610606,1160
10462,3703277359,3757030923,1672655516,1672656436,920
11426,3533017131,3632189887,1672596531,1672599796,3265
10830,3773440794,3519924982,1672614393,1672615183,790
10126,3714287902,3813986705,1672678747,1672680877,2130
10861,3344778261,3711029952,1672573382,1672576871,3489
10247,3715249954,3792972270,1672693501,1672696256,2755
9866,3231153513,3512857020,1672677608,1672679165,1557
10883,3505908965,3791206902,1672547422,1672550247,2825
10720,3308744016,3935520819,1672702748,1672703068,320
10038,3509433155,3276209319,1672536987,1672539033,2046
11616,3423800775,3791664049,1672636569,1672638030,1461
10160,3779169946,3760271237,1672662895,1672666378,3483
9823,3825795004,3770846374,1672605307,1672608591,3284
10643,3773344258,3471131277,1672537398,1672540092,2694
9811,3514361485,3904184638,1672624385,1672627388,3003
10988,3387971464,3715602742,1672559249,1672560424,1175
10768,3760107540,3776034313,1672640932,1672642819,1887
11366,3703048107,3757032266,1672590401,1672593390,2989
11039,3888409038,3513859809,1672643222,1672644433,1211
10859,3780048608,3391854325,1672604199,1672607248,3049
9971,3241593146,3273771395,1672608057,1672608649,592
11414,3440743218,3553640169,1672702078,1672702705,627
10922,3235198316,3517902505,1672625497,1672625733,236
9833,3819315404,3715712376,1672673555,1672674671,1116
10176,3368176107,3777928067,1672589432,1672590310,878
10264,3922409420,3289258397,1672652871,1672655654,2783
10363,3519947298,3897003751,1672619041,1672621524,2483
11266,3239779992,3703277359,1672660406,1672662667,2261
11542,3517816581,3422460919,1672580063,1672582914,2851
10679,3311521176,3245642576,1672558731,1672560529,1798
10394,3500909455,3780423516,1672569799,1672573016,3217
11232,3510206323,3336225953,1672572103,1672572999,896
10323,3779689733,3701663839,1672574569,1672575857,1288
10901,3903088144,3773798215,1672637802,1672639537,1735
10676,3713191326,3514389188,1672684175,1672685037,862
10169,3602680347,3703697059,1672555846,1672556111,265
11343,3710223875,3892177203,1672623871,1672625579,1708
10059,3755769254,3509470194,1672577063,1672577501,438
10820,3807486812,3884458862,1672623907,1672626107,2200
11294,3783611957,3714268380,1672544961,1672547163,2202
10033,3755238321,3893527651,1672531291,1672532655,1364
10868,3716595760,3404187438,1672693257,1672693900,643
10276,3823307824,3711367577,1672584521,1672584695,174
11223,3836757034,3505314920,1672540904,1672543456,2552
10196,3516706121,3272328752,1672692317,1672695512,3195
10260,3534562354,3791224239,1672629893,1672630543,650
11065,3825234433,3773202954,1672682292,1672683868,1576
11019,3931319307,3359929534,1672563938,1672564765,827
10703,3760966645,3793719515,1672682908,1672683181,273
11115,3827981800,3755107521,1672634950,1672635922,972
11655,3395610742,3783373085,1672668747,1672668810,63
11182,3443521234,3311924005,1672559228,1672560117,889
10057,3760385591,3711854614,1672540993,1672541714,721
10230,3852310652,3533726421,1672644055,1672645913,1858
10176,3772683155,3437108337,1672591140,1672591520,380
10520,3425545115,3491104534,1672545443,1672548474,3031
11571,3500015630,3738734246,1672649360,1672652814,3454
10799,3713906305,3898965585,1672624343,1672626405,2062
9956,3284407073,3777729184,1672666466,1672669246,2780
10560,3714923092,3514013999,1672537088,1672538382,1294
11363,3807111856,3446810761,1672589793,1672591326,1533
9941,3481700413,3533340292,1672588810,1672590486,1676
11259,3922480066,3607583720,1672668815,1672669397,582
10216,3516444589,3735152111,1672589335,1672590325,990
9993,3476958001,3756525103,1672671247,1672673700,2453
11697,3929002318,3422460919,1672587929,1672589891,1962
11674,3711804184,3203172170,1672541318,1672543036,1718
11741,3711591464,3399943757,1672688173,1672690704,2531
10799,3275171954,3978254945,1672698851,1672700331,1480
10010,3534589501,3333505404,1672583403,1672585153,1750
10134,3514327931,3780969898,1672576437,1672577383,946
10971,3487988841,3316121649,1672639069,1672642346,3277
11764,3513384042,3756367938,1672688043,1672691321,3278
10546,3518209090,3827836825,1672598166,1672598853,687
11000,3685522474,3514013999,1672572685,1672575448,2763
9978,3776124041,3714101349,1672538863,1672542154,3291
11057,3802625412,3411355804,1672630326,1672633851,3525
11375,3511311554,3313298164,1672596288,1672599096,2808
10444,3738873928,3515230715,1672673780,1672676121,2341
11722,3667814788,3473706746,1672620338,1672620579,241
11544,3227874229,3226761201,1672663481,1672665968,2487
9977,3473520701,3791434207,1672585188,1672587595,2407
11197,3755779925,3701841013,1672554456,1672557520,3064
10788,3774627091,3853182912,1672594174,1672596771,2597
11049,3388481990,3533841983,1672648116,1672650752,2636
10096,3791194984,3715490209,1672635147,1672635631,484
11389,3505472087,3715261950,1672695985,1672698762,2777
11485,3515706117,3509433155,1672645728,1672647175,1447
11437,3931164237,3533642281,1672541844,1672543882,2038
11086,3756843139,3409514897,1672583866,1672585853,1987
10282,3302348002,3511364193,1672580250,1672581689,1439
10903,3366961580,3500198430,1672631591,1672632629,1038
10001,3894495222,3287689454,1672577700,1672578170,470
9884,3517632796,3703415246,1672651636,1672652971,1335
11304,3501977123,3770530739,1672677870,1672679592,1722
10078,3638050763,3898592058,1672665102,1672665899,797
10668,3770497768,3311305760,1672663933,1672666352,2419
10300,3515597467,3756536512,1672555773,1672557802,2029
11711,3319862687,3344710271,1672637434,1672640661,3227
11715,3803996569,3760737203,1672647019,1672648468,1449
10343,3332124606,3773475506,1672609972,1672612659,2687
10261,3519780867,3519356606,1672622247,1672625386,3139
11313,3826997668,3357074700,1672622117,1672625282,3165
11485,3711349327,3772343750,1672663349,1672665588,2239
10510,3756763585,3500734346,1672627192,1672630550,3358
10353,3553321027,3336225953,1672636079,1672636326,247
9836,3821082558,3977666815,1672560466,1672562144,1678
9894,3713373455,3792633495,1672630924,1672632528,1604
11267,3461743188,3555378248,1672670291,1672673381,3090
10713,3509626590,3388537708,1672628298,1672630651,2353
10981,3739217535,3501554468,1672612838,1672613430,592
11217,3505867821,3811503860,1672638650,1672641777,3127
10956,3890638402,3881012415,1672614060,1672615470,1410
11627,3514761434,3501137133,1672640035,1672642406,2371
10693,3760731595,3492350318,1672644955,1672647398,2443
11341,3533628528,3714892312,1672668651,1672670250,1599
11742,3556684272,3374552204,1672591891,1672593511,1620
11581,3737745988,3509556649,1672615684,1672617183,1499
11567,3500688476,3518931700,1672655793,1672656097,304
10304,3298831109,3772708314,1672643529,1672646524,2995
11160,3714645218,3514341451,1672665377,1672666292,915
11594,3516706121,3772164469,1672570404,1672572579,2175
10443,3301403047,3685083275,1672564136,1672566642,2506
11352,3409078869,3730169449,1672617034,1672620187,3153
11776,3617771673,3770273459,1672583914,1672587345,3431
11204,3732104286,3884394685,1672532350,1672534563,2213
11106,3511286390,3780171640,1672674045,1672674557,512
10767,3910049345,3516588277,1672681302,1672684121,2819
10644,3911431642,3349573092,1672648176,1672651661,3485
10902,3912811715,3636877469,1672607982,1672610313,2331
11469,3611298237,3738734246,1672601888,1672604641,2753
10927,3505685294,3382308738,1672618375,1672619140,765
10712,3519689906,3710919244,1672688431,1672691709,3278
11248,3505032644,3774792696,1672587482,1672590952,3470
10576,3792107875,3783443095,1672562691,1672565262,2571
11555,3703443664,3924583142,1672668555,1672671109,2554
11168,3714283424,3776001441,1672693434,1672696702,3268
11282,3666367524,3342545285,1672613534,1672615393,1859
10789,3510775046,3500433278,1672698668,1672700170,1502
11271,3832902787,3274239253,1672564990,1672567981,2991
10574,3302416197,3907923381,1672531380,1672531863,483
11327,3898989233,3516819320,1672663928,1672664272,344
11019,3919994216,3501612813,1672664708,1672665174,466
10705,3856897914,3609335008,1672560429,1672562286,1857
9804,3920116284,3701521510,1672638220,1672639038,818
10554,3235470567,3701284535,1672576033,1672578793,2760
11177,3516777819,3358959807,1672600120,1672603429,3309
11470,3783730769,3855222429,1672614979,1672615574,595
10739,3701770921,3776447604,1672663110,1672665434,2324
11173,3534589501,3246381831,1672569577,1672573034,3457
10733,3615245840,3510801769,1672588784,1672592272,3488
11792,3516969689,3515597467,1672660232,1672660475,243
11256,3236886943,3733915784,1672556283,1672558202,1919
10172,3780048608,3511004622,1672626984,1672627856,872
11466,3519513219,3770764940,1672594045,1672594185,140
10428,3792987243,3517151644,1672682168,1672683282,1114
11439,3778819352,3470962222,1672619469,1672621538,2069
10655,3483078667,3837271330,1672609756,1672611081,1325
11442,3770273459,3518157683,1672643818,1672647340,3522
10304,3517136772,3783594246,1672583714,1672586003,2289
10122,3914947393,3814378625,1672537577,1672540028,2451
10129,3555954355,3500590302,1672547248,1672548207,959
11287,3791905743,3668369938,1672650926,1672652810,1884
10082,3737467358,3516932899,1672604715,1672607972,3257
11434,3520473111,3621960662,1672674028,1672675465,1437
10224,3716647407,3791841318,1672647929,1672649039,1110
10599,3299845453,3379400553,1672698550,1672698793,243
10401,3818532143,3512802259,1672571451,1672572025,574
11182,3223796145,3517499844,1672687340,1672689625,2285
11023,3405435885,3461137945,1672642705,1672644537,1832
11064,3271719569,3393001196,1672588346,1672589531,1185
11140,3715204544,3505155858,1672675237,1672678287,3050
11053,3287920864,3313392810,1672601565,1672604653,3088
11673,3851877325,3311771689,1672681272,1672682491,1219
11673,3368951504,3913847876,1672697668,1672699699,2031
11590,3792475476,3398483531,1672603850,1672605538,1688
10708,3757446082,3379400553,1672661509,1672664036,2527
11523,3513508737,3533703578,1672582136,1672583438,1302
10327,3783086267,3715320359,1672596730,1672599284,2554
10489,3852461753,3711765138,1672654496,1672656165,1669
11171,3505007498,3369938668,1672624318,1672627530,3212
11577,3825877848,3434452046,1672692173,1672694043,1870
9853,3520779124,3812880543,1672645707,1672647626,1919
11511,3929002318,3834456158,1672575469,1672576868,1399
11318,3438470128,3463892928,1672557365,1672560479,3114
9958,3669918958,3462153833,1672700276,1672702711,2435
9933,3245642576,3905358065,1672692943,1672693955,1012
10046,3779706467,3783730769,1672673916,1672677121,3205
11123,3351153781,3755688231,1672540713,1672543778,3065
11684,3917004141,3783060739,1672564132,1672566036,1904
10077,3701824335,3703031637,1672535570,1672536904,1334
10073,3472018395,3509544691,1672539751,1672540162,411
10697,3713990030,3495446254,1672659368,1672661734,2366
11404,3519553933,3469780362,1672674484,1672676447,1963
10207,3760710525,3520362238,1672644800,1672645526,726
10645,3222364320,3621439107,1672699920,1672703037,3117
11346,3227874229,3779723939,1672612756,1672614006,1250
9879,3613781977,3899205452,1672626546,1672626853,307
10265,3500799617,3205687719,1672553135,1672555907,2772
11003,3447253775,3917811545,1672566294,1672566928,634
9909,3236360179,3632189887,1672552657,1672553278,621
11605,3919345990,3703048107,1672650177,1672651214,1037
10303,3776901443,3514005973,1672691445,1672693469,2024
9899,3778544203,3931767736,1672536346,1672536824,478
9982,3331471764,3837885956,1672667779,1672668229,450
9923,3669427589,3513508737,1672534195,1672536827,2632
10310,3388537708,3857344874,1672636565,1672638499,1934
9998,3276393542,3494157939,1672582817,1672585344,2527
10242,3886957097,3279851026,1672662965,1672663864,899
10942,3714435747,3714892312,1672650304,1672651915,1611
10405,3935333166,3313824913,1672539659,1672541639,1980
11274,3772227820,3660980656,1672572389,1672573142,753
9844,3422959249,3359929534,1672646046,1672646984,938
10817,3341129425,3555378248,1672615944,1672617109,1165
11052,3888057649,3757944870,1672644241,1672644682,441
10238,3311260898,3342031426,1672635245,1672638760,3515
11619,3899903158,3756536476,1672613523,1672614745,1222
10620,3900793652,3519102732,1672605509,1672606460,951
11602,3776901443,3311569360,1672677679,1672679487,1808
10903,3345954031,3760801237,1672667198,1672668632,1434
10852,3381055770,3243763209,1672553627,1672553696,69
10765,3703624327,3927805949,1672667675,1672670298,2623
10431,3229734741,3363549860,1672660922,1672661961,1039
10290,3229570647,3311177439,1672608107,1672609570,1463
10077,3809207482,3297624618,1672678401,1672678921,520
10297,3711613085,3791269060,1672608625,1672609777,1152
10120,3638018906,3228997424,1672619714,1672622252,2538
10675,3534372899,3241567995,1672638880,1672640965,2085
11640,3837887478,3852461753,1672600360,1672603508,3148
11590,3334633634,3517426473,1672565346,1672566470,1124
10182,3534122907,3770273459,1672537464,1672539976,2512
11665,3773041843,3514638555,1672557799,1672557953,154
9857,3377446376,3417431173,1672659348,1672661979,2631
11306,3927504954,3881579907,1672691849,1672694491,2642
11301,3390368796,3278251248,1672593889,1672597322,3433
11221,3501711464,3613940925,1672689022,1672690631,1609
11015,3714892312,3711430738,1672693962,1672695028,1066
11428,3276209319,3637105495,1672647906,1672649450,1544
10820,3978643889,3713726267,1672576645,1672579756,3111
10057,3757050615,3783967375,1672590607,1672594048,3441
10280,3513203127,3783408830,1672591903,1672594263,2360
11164,3318250647,3711945923,1672632532,1672633412,880
10495,3559759778,3884001167,1672564964,1672568193,3229
11094,3774652449,3713100169,1672639843,1672641553,1710
9838,3793926338,3828354855,1672698657,1672701726,3069
11604,3757407184,3611533094,1672598659,1672598997,338
10098,3474074188,3313392810,1672656986,1672658168,1182
11004,3627377299,3354877289,1672616597,1672618746,2149
10065,3428325402,3271719569,1672604097,1672605888,1791
9950,3416079461,3519255644,1672532356,1672533418,1062
10451,3347172556,3422314045,1672667963,1672669407,1444
10420,3898595916,3918981936,1672661342,1672663342,2000
9929,3778695895,3713373455,1672680829,1672682851,2022
10770,3513545735,3311904032,1672557175,1672558131,956
10168,3715282492,3274223335,1672659465,1672662108,2643
11667,3533726421,3512641538,1672569480,1672571497,2017
9871,3514007122,3777909822,1672647191,1672650440,3249
11011,3358530225,3760776967,1672556651,1672558462,1811
11575,3447253775,3716891903,1672703797,1672703996,199
11431,3914353062,3778695017,1672613307,1672613976,669
10511,3435715962,3778838936,1672592201,1672595650,3449
10231,3310961923,3606688595,1672605674,1672607906,2232
10809,3778479297,3279102372,1672542705,1672543275,570
10701,3209925780,3478052226,1672652767,1672653973,1206
11388,3881579907,3517632796,1672556527,1672559156,2629
10061,3519703964,3279851026,1672551915,1672555053,3138
10138,3714645218,3450679913,1672582132,1672585404,3272
10537,3792578118,3778695895,1672553958,1672557276,3318
10716,3239082508,3620836520,1672573724,1672574208,484
11636,3407734098,3783176874,1672681852,1672682042,190
10681,3669418238,3346755179,1672636594,1672636675,81
11661,3292936094,3791581138,1672670608,1672673512,2904
10205,3229621693,3514685272,1672613680,1672615336,1656
10137,3282053097,3703031637,1672683395,1672685568,2173
11451,3933731871,3226761201,1672552428,1672552801,373
10692,3512802259,3858497718,1672564771,1672567053,2282
11191,3510209505,3515378306,1672651903,1672653618,1715
9884,3505248368,3716475340,1672595956,1672598135,2179
11481,3666655293,3757150421,1672567477,1672567783,306
10350,3361952532,3516454693,1672548346,1672549512,1166
11326,3733836732,3791368349,1672603435,1672604476,1041
9921,3900195680,3533419409,1672634215,1672636881,2666
10485,3235313062,3791532324,1672538483,1672538883,400
9997,3793407883,3349475873,1672686495,1672687544,1049
10647,3610723722,3925835590,1672665360,1672666828,1468
10679,3517380144,3757064623,1672553541,1672554026,485
10397,3805616707,3906874577,1672670103,1672672101,1998
11008,3510244209,3302348002,1672534939,1672535526,587
10279,3772867078,3520763492,1672648263,1672651217,2954
10161,3838423363,3467756698,1672560825,1672562127,1302
11477,3220798451,3513563152,1672602630,1672603342,712
11050,3773523569,3826542169,1672615860,1672618162,2302
9812,3772291207,3421956717,1672569041,1672572074,3033
11336,3500726347,3516257130,1672668475,1672671179,2704
10747,3228477490,3824657614,1672651177,1672653229,2052
10375,3714312797,3200320674,1672650432,1672652152,1720
10029,3520049965,3703732445,1672649211,1672651384,2173
9981,3756763585,3512504247,1672616261,1672618771,2510
11100,3516588277,3514611187,1672532274,1672535081,2807
10373,3517902505,3224040894,1672618168,1672620844,2676
10529,3519908593,3760069457,1672679786,1672681918,2132
11633,3555378248,3291936679,1672560819,1672561695,876
10509,3855077502,3805718871,1672689778,1672693012,3234
10855,3275274182,3500120676,1672539702,1672541275,1573
10117,3519162582,3908878965,1672586192,1672588612,2420
10974,3668955834,3770972037,1672620815,1672623547,2732
11643,3311432176,3602401154,1672574953,1672576058,1105
10165,3703722212,3517440258,1672693718,1672695043,1325
10328,3851810349,3510750299,1672618907,1672621802,2895
10865,3770486161,3370512945,1672599805,1672601609,1804
10944,3710919244,3491104534,1672695331,1672695775,444
10767,3227059650,3936871734,1672633752,1672634567,815
10288,3515558215,3805704844,1672629723,1672631391,1668
11108,3812277991,3245121919,1672644371,1672647116,2745
10303,3312612693,3898989233,1672682896,1672683401,505
11274,3387322545,3637522163,1672658118,1672661700,3582
10196,3778695895,3363549860,1672546184,1672548729,2545
11717,3917905192,3488399075,1672590823,1672593655,2832
10650,3297100323,3510373076,1672580773,1672581458,685
9811,3534812391,3509626590,1672577899,1672578321,422
10527,3919719755,3772683155,1672635892,1672638568,2676
11478,3510836047,3491390365,1672680088,1672683069,2981
10037,3774448657,3424425746,1672545405,1672546240,835
10178,3305727497,3638823001,1672607102,1672609599,2497
11033,3433189219,3923524564,1672684836,1672688078,3242
10470,3902300755,3923910914,1672599822,1672601785,1963
11509,3380418745,3791368349,1672599371,1672602431,3060
10327,3275274182,3514353133,1672621671,1672623625,1954
10520,3519465545,3442096275,1672601588,1672603260,1672
9976,3309651238,3772262649,1672532307,1672535382,3075
11785,3510291656,3512871568,1672587670,1672589353,1683
9917,3509677530,3520926977,1672663852,1672664927,1075
11719,3772683155,3520145112,1672548310,1672550318,2008
11116,3514776568,3701041860,1672609668,1672612215,2547
11424,3505571800,3930475498,1672557304,1672559991,2687
11593,3826418889,3851515560,1672562622,1672563994,1372
10887,3756428507,3429610195,1672622535,1672623503,968
11038,3919994216,3773394570,1672545238,1672547647,2409
10935,3243763209,3779561601,1672561080,1672563515,2435
9938,3711223297,3517530943,1672612349,1672613517,1168
10599,3295748489,3774946684,1672703056,1672704627,1571
10269,3773424266,3233993993,1672642437,1672645556,3119
9867,3756740153,3288920399,1672697547,1672699632,2085
10011,3793232021,3311197635,1672650415,1672653448,3033
10348,3500211484,3454343398,1672610037,1672610565,528
11258,3393001196,3716197140,1672700139,1672701140,1001
11551,3501004005,3905889514,1672672713,1672675477,2764
10532,3511245705,3896123242,1672534903,1672537561,2658
10629,3305612422,3509370016,1672689777,1672690194,417
10408,3519341916,3492728794,1672632924,1672635161,2237
10559,3248061684,3756079870,1672555835,1672556946,1111
10207,3772070986,3408111327,1672557735,1672559768,2033
10925,3903879740,3554174421,1672588190,1672589093,903
10013,3884388188,3238997746,1672601682,1672603565,1883
9867,3445172440,3623894390,1672635308,1672638811,3503
11271,3703572036,3757212744,1672686276,1672687699,1423
11272,3347996015,3311521176,1672621191,1672623471,2280
10288,3772648837,3519689906,1672677699,1672679151,1452
9829,3517440258,3519937708,1672677915,1672678278,363
10439,3474879231,3468871103,1672574943,1672575631,688
11261,3780013266,3359418136,1672644072,1672644380,308
11694,3830771832,3890211161,1672586329,1672589444,3115
11445,3773202954,3824657614,1672553219,1672553931,712
11691,3505684690,3757001552,1672618854,1672621998,3144
11183,3343767438,3359880163,1672639375,1672642200,2825
9872,3912811715,3342031426,1672643931,1672645500,1569
11784,3291936679,3311739926,1672649323,1672651260,1937
10785,3420881591,3500927619,1672641625,1672642110,485
10281,3343193067,3510454018,1672637322,1672639644,2322
11484,3406029706,3513486828,1672657928,1672660381,2453
11659,3711258452,3857389270,1672604967,1672607679,2712
10407,3303432071,3510111365,1672568873,1672571608,2735
10190,3920155862,3487231844,1672620624,1672622184,1560
9911,3501988762,3791548838,1672550699,1672551431,732
9937,3345902033,3472718723,1672685204,1672687973,2769
10863,3299587876,3814378625,1672681168,1672682251,1083
10166,3774447975,3517144269,1672571761,1672574329,2568
10124,3777672363,3294821709,1672599905,1672601337,1432
10203,3505697295,3311626308,1672593348,1672593712,364
11753,3770715115,3667814788,1672665057,1672667619,2562
11329,3373851012,3884369346,1672644306,1672645300,994
10920,3857609616,3520160414,1672642577,1672644054,1477
11673,3396440259,3307454562,1672629947,1672633376,3429
10877,3680832669,3714264759,1672640030,1672641849,1819
10351,3500329674,3780352400,1672584619,1672587583,2964
11183,3500015630,3713996094,1672619221,1672621528,2307
11771,3772291207,3303552616,1672697770,1672699998,2228
11090,3814672661,3880882684,1672564828,1672567130,2302
10289,3773895671,3381244346,1672573485,1672575054,1569
10399,3343193067,3293898029,1672603406,1672605019,1613
11514,3249771731,3600171014,1672576981,1672580365,3384
10302,3534775239,3311959533,1672551638,1672551921,283
11219,3284374600,3294164983,1672601156,1672603630,2474
9934,3516359146,3516444589,1672537003,1672538011,1008
9973,3369270860,3714067998,1672575867,1672578210,2343
11418,3772609551,3533037906,1672608775,1672612216,3441
11248,3776710698,3510882576,1672534688,1672537680,2992
10334,3834311054,3231963246,1672600378,1672603158,2780
10214,3756066765,3783357035,1672630912,1672631591,679
10649,3437934509,3791974273,1672582676,1672585733,3057
11062,3832333115,3716944983,1672676624,1672677402,778
11337,3703351452,3344478603,1672539090,1672540013,923
10388,3447078933,3500931474,1672662190,1672665116,2926
11094,3899156705,3757584114,1672542743,1672543778,1035
11727,3779561601,3287734830,1672673943,1672676326,2383
10829,3778702093,3821103640,1672675618,1672679098,3480
11654,3773636983,3924583142,1672634278,1672635601,1323
11385,3368176107,3783408830,1672580350,1672583539,3189
11296,3770846374,3513486828,1672565136,1672565919,783
10385,3442096275,3756890980,1672602445,1672604048,1603
10830,3772844451,3772968080,1672606119,1672608919,2800
11275,3778253021,3701865589,1672539275,1672540908,1633
10832,3974668678,3622218289,1672672824,1672674971,2147
9963,3362706073,3715111016,1672667873,1672669770,1897
10828,3756668747,3534459983,1672666649,1672668112,1463
10357,3774598935,3510159441,1672638639,1672640657,2018
11095,3791509334,3811354125,1672650027,1672652039,2012
11686,3378172464,3756149282,1672628663,1672629402,739
10783,3470962222,3384170206,1672533198,1672535474,2276
10450,3505756991,3805718871,1672652996,1672653198,202
11419,3338187803,3231859576,1672542296,1672543065,769
10511,3298706213,3711131262,1672580816,1672583175,2359
10174,3500928990,3805926853,1672578020,1672580808,2788
10122,3682086200,3792107875,1672649293,1672651611,2318
11230,3553229537,3375257546,1672579119,1672580506,1387
9826,3500793739,3755129708,1672563968,1672565369,1401
10126,3774946684,3792708936,1672647957,1672649125,1168
10978,3510454018,3409098014,1672657592,1672659067,1475
10138,3357074700,3701725839,1672603469,1672606528,3059
10076,3770544738,3512203553,1672667696,1672669762,2066
11654,3710296607,3611533094,1672683763,1672686774,3011
9942,3517149023,3514761434,1672689869,1672690809,940
10739,3668955834,3319660530,1672557336,1672559633,2297
10485,3373018943,3756525103,1672544766,1672547879,3113
10323,3520145112,3511466117,1672591974,1672592293,319
11378,3500251781,3850108828,1672532676,1672533394,718
10835,3791108593,3511095300,1672595600,1672598534,2934
9995,3604908372,3664478769,1672683165,1672684618,1453
9824,3495446254,3509370016,1672651175,1672653496,2321
10081,3437286595,3505121295,1672556967,1672559810,2843
9998,3355430975,3839417558,1672641719,1672644550,2831
11685,3703462221,3509317054,1672585567,1672588534,2967
9858,3500019810,3755107521,1672678177,1672680454,2277
11380,3756843139,3778273230,1672674896,1672675890,994
11383,3513143959,3971289056,1672549998,1672552740,2742
11663,3780213684,3738429905,1672546850,1672550448,3598
11254,3820922991,3908464960,1672537249,1672538288,1039
10516,3466620548,3755849241,1672659176,1672660414,1238
10193,3792173463,3882580580,1672539278,1672541073,1795
11164,3534589501,3397972945,1672576854,1672578097,1243
11721,3434052463,3715320359,1672536605,1672538666,2061
9980,3447696555,3201920708,1672683746,1672685928,2182
11716,3533017131,3783122313,1672532735,1672534866,2131
10666,3714870496,3516932899,1672662045,1672662920,875
9923,3978417055,3713514933,1672601570,1672602268,698
9890,3520049965,3685396470,1672657014,1672659992,2978
11183,3310961923,3757198930,1672544393,1672547974,3581
11668,3783935976,3516827471,1672582187,1672585002,2815
10822,3773534165,3919211457,1672688762,1672690618,1856
11289,3773895671,3713805968,1672601942,1672602025,83
10623,3825526565,3519055736,1672536191,1672537444,1253
10460,3235578852,3393376416,1672557918,1672560013,2095
10292,3312946269,3636885498,1672650302,1672652945,2643
11565,3501137133,3833993674,1672666300,1672667876,1576
10686,3701567668,3510278533,1672602135,1672603675,1540
10294,3231859576,3471585513,1672609936,1672613333,3397
9999,3713740434,3500015630,1672667010,1672668657,1647
11482,3513777705,3711613085,1672586858,1672589417,2559
9922,3534122907,3517949586,1672635889,1672639051,3162
10661,3916673751,3884394685,1672620677,1672623337,2660
11145,3515470462,3511645260,1672577159,1672578598,1439
10841,3396440259,3282240901,1672615441,1672615901,460
10088,3231654754,3703572036,1672653831,1672656529,2698
10125,3780048608,3519174861,1672670679,1672671614,935
10493,3200785194,3760710525,1672699897,1672701616,1719
10097,3773085258,3358675021,1672534089,1672535805,1716
10569,3819315404,3903115138,1672574827,1672575170,343
9841,3492728794,3395615598,1672617026,1672620476,3450
10583,3505472087,3485898181,1672584548,1672588019,3471
11539,3343767438,3439036305,1672631700,1672634095,2395
10121,3449020351,3792785261,1672621607,1672623446,1839
10523,3791863922,3806034626,1672647255,1672649748,2493
10891,3501027795,3513092056,1672579031,1672581027,1996
11105,3793407883,3520155898,1672700199,1672702861,2662
11270,3713996094,3773697080,1672591432,1672594707,3275
11356,3509828883,3473520701,1672641537,1672644536,2999
10710,3226172318,3805831563,1672627077,1672627729,652
11667,3850181934,3505769529,1672582854,1672583858,1004
10821,3912811715,3779609338,1672613980,1672614611,631
11453,3387870683,3918126468,1672615932,1672617674,1742
10343,3490804766,3369270860,1672625640,1672628477,2837
11222,3684199077,3802625412,1672601827,1672604085,2258
11193,3235198316,3533037906,1672531847,1672533480,1633
11230,3465107990,3756680289,1672695261,1672695943,682
11368,3557324887,3501115299,1672644083,1672645133,1050
10804,3756157377,3505804611,1672580322,1672581642,1320
11339,3713141087,3516444589,1672554101,1672556236,2135
11435,3505709407,3534770827,1672606924,1672607705,781
11596,3298706213,3800434325,1672554087,1672554280,193
10974,3905571273,3661543201,1672653459,1672656490,3031
10829,3791224239,3760074281,1672606772,1672607477,705
9975,3780435349,3713107380,1672634425,1672636843,2418
10779,3774090455,3510244209,1672581130,1672584571,3441
10403,3510262025,3818461836,1672657137,1672660454,3317
10823,3480560014,3311514075,1672664739,1672668031,3292
10985,3710119555,3773411968,1672619439,1672619740,301
9896,3308965136,3664719070,1672647536,1672650769,3233
10612,3422205569,3772751765,1672637476,1672638758,1282
10531,3852992961,3221126799,1672666447,1672666855,408
10318,3756759239,3389069291,1672591700,1672593194,1494
10614,3928508375,3716371766,1672627592,1672629736,2144
9947,3818532143,3494560663,1672646648,1672650084,3436
11080,3512546783,3850108828,1672602596,1672603158,562
9993,3783157469,3285322570,1672641987,1672644944,2957
11682,3774483862,3714281210,1672615090,1672616404,1314
11460,3519513219,3772683155,1672545403,1672548868,3465
11236,3772877723,3884191432,1672596204,1672598927,2723
10592,3512251592,3776001441,1672618605,1672619222,617
11363,3397783490,3290797257,1672538895,1672540511,1616
10785,3386323728,3342426430,1672613843,1672616907,3064
11325,3760080378,3836757034,1672613851,1672616197,2346
11576,3514747345,3701919083,1672590522,1672593356,2834
10150,3403395712,3755107521,1672679289,1672681952,2663
10938,3783809405,3500421940,1672560483,1672563707,3224
10251,3757407184,3418683594,1672627794,1672630746,2952
10389,3510758718,3239082508,1672664832,1672668204,3372
10400,3311805161,3380285779,1672560334,1672561214,880
10896,3513816744,3382746533,1672647858,1672648870,1012
10589,3760687922,3791222330,1672672841,1672675465,2624
11504,3682086200,3825082811,1672674343,1672674474,131
11364,3293157673,3303552616,1672703322,1672706480,3158
11688,3501407804,3713927376,1672687159,1672688646,1487
10067,3510254698,3977337501,1672681464,1672682339,875
10954,3228465044,3500674240,1672623441,1672623886,445
11253,3793497672,3516257130,1672597587,1672601113,3526
10122,3715490209,3927181190,1672703549,1672705064,1515
11629,3899970524,3238056215,1672556970,1672559193,2223
11205,3633622298,3760979523,1672654294,1672654388,94
10822,3915460293,3791351852,1672651584,1672651784,200
10184,3239401337,3703443664,1672674090,1672675897,1807
10498,3519108639,3832902787,1672602247,1672604095,1848
11751,3665841655,3513740840,1672650963,1672652741,1778
10719,3409514897,3710919244,1672601944,1672603568,1624
10903,3777878462,3281970147,1672603785,1672604872,1087
10845,3637522163,3403395712,1672619239,1672621989,2750
10126,3520155898,3344778261,1672539868,1672540149,281
10523,3515715968,3809207482,1672590507,1672593140,2633
11715,3501253130,3517113478,1672697143,1672699917,2774
10435,3509252934,3774273260,1672688460,1672691852,3392
9838,3756272704,3897851509,1672546262,1672547476,1214
10295,3925792265,3896211741,1672656537,1672659218,2681
9948,3716371766,3903879740,1672595542,1672598100,2558
9920,3511364193,3274341934,1672599136,1672602690,3554
11302,3513215373,3919342147,1672598546,1672600288,1742
10981,3404395454,3915652382,1672571250,1672572578,1328
11512,3776200012,3639465750,1672539571,1672541940,2369
9853,3777909822,3512490032,1672659068,1672661711,2643
10582,3517797610,3710046567,1672592043,1672592577,534
11233,3639465750,3516904926,1672549996,1672553458,3462
10540,3444295435,3715790104,1672666045,1672668801,2756
11286,3773024346,3816184951,1672564857,1672568369,3512
11454,3772227820,3822786416,1672666347,1672669554,3207
11720,3716160006,3778402454,1672538943,1672541657,2714
11365,3911821258,3714883746,1672678192,1672678522,330
10018,3518408734,3424997707,1672586671,1672590161,3490
10127,3774946684,3488333295,1672601428,1672602377,949
11733,3774296721,3289258397,1672616286,1672618162,1876
10743,3774029494,3760966645,1672587657,1672588506,849
10586,3716195780,3332840671,1672606610,1672607986,1376
11197,3393502004,3776950532,1672548753,1672548922,169
10514,3493598658,3487622510,1672632427,1672634110,1683
11226,3756493561,3713031958,1672595793,1672599273,3480
11752,3404395454,3902023467,1672689421,1672690502,1081
10776,3779340538,3858330969,1672646160,1672648506,2346
11271,3417431173,3774195369,1672544032,1672546712,2680
11723,3813986705,3233993993,1672679534,1672679870,336
10426,3408111327,3439532406,1672651552,1672654537,2985
10980,3736941123,3371564186,1672552677,1672554904,2227
9986,3756890980,3516026189,1672665016,1672665573,557
10236,3224053074,3778318250,1672658812,1672661302,2490
10321,3511364193,3636857871,1672680157,1672680729,572
10419,3505140123,3779778679,1672646125,1672647946,1821
10424,3777686966,3624365837,1672560025,1672562517,2492
9986,3886837151,3773378103,1672694802,1672695604,802
10985,3780733404,3403988682,1672546522,1672547982,1460
11038,3703336988,3770441717,1672542759,1672543071,312
10757,3206853747,3440582836,1672600435,1672601761,1326
10832,3344778261,3668063289,1672610027,1672612256,2229
10995,3776600696,3830599959,1672575680,1672576104,424
10712,3896622009,3416225867,1672533080,1672535516,2436
11454,3513802404,3245755569,1672540894,1672541435,541
11715,3417223898,3319660530,1672701878,1672703758,1880
9964,3414510793,3732128078,1672597904,1672600516,2612
9860,3513171472,3311449914,1672600058,1672600199,141
10054,3603682643,3357097510,1672632493,1672635535,3042
10413,3772296376,3756876537,1672636194,1672638438,2244
10384,3234445133,3208519320,1672553877,1672555575,1698
10515,3637522163,3397972945,1672696355,1672696997,642
10138,3500421940,3793699467,1672636819,1672637413,594
11531,3511526885,3505449070,1672593819,1672593916,97
10116,3534499421,3395082458,1672579868,1672583028,3160
10212,3488988274,3780206849,1672683029,1672686083,3054
11038,3778195766,3516153301,1672701449,1672704147,2698
10572,3485468650,3856975623,1672592466,1672594741,2275
11665,3511364193,3414387263,1672675027,1672676069,1042
9996,3533473206,3303772923,1672680938,1672681011,73
10957,3732871856,3834456158,1672694811,1672697979,3168
9806,3772216305,3364948616,1672697987,1672698383,396
11040,3533642281,3244397548,1672564020,1672566875,2855
10876,3777304517,3500688476,1672656857,1672659678,2821
9942,3272581469,3553640169,1672642235,1672645799,3564
10061,3510882576,3770275898,1672563697,1672564609,912
11684,3471507117,3701971784,1672689582,1672690307,725
10970,3880030249,3288346356,1672617061,1672620012,2951
10881,3430296808,3971422524,1672550483,1672552236,1753
11408,3756761603,3512492332,1672600872,1672603501,2629
10472,3792708936,3830771832,1672574921,1672577549,2628
11531,3307454562,3512480125,1672662804,1672664836,2032
10134,3710119555,3313392810,1672579148,1672581056,1908
10492,3757128722,3716982179,1672654381,1672656413,2032
10802,3319645922,3339331632,1672534224,1672535340,1116
9805,3772070986,3630802959,1672591323,1672594904,3581
10317,3490953301,3773798215,1672653916,1672654121,205
10249,3838423363,3793902476,1672670006,1672673568,3562
11045,3388481990,3555764822,1672536636,1672538247,1611
10760,3368848936,3501873139,1672617365,1672618030,665
11344,3666561358,3926065090,1672569968,1672571584,1616
10894,3430032005,3319862687,1672682789,1672683139,350
11078,3469780362,3293540333,1672624090,1672626105,2015
10322,3465107990,3516340010,1672566010,1672569566,3556
10155,3501174621,3901169230,1672680865,1672683573,2708
10116,3278629965,3284829602,1672550354,1672551883,1529
11497,3920116284,3791106473,1672536489,1672539259,2770
11540,3490008012,3713100169,1672538063,1672539846,1783
9965,3500889287,3479402555,1672606216,1672607296,1080
11302,3805926853,3304235700,1672639847,1672641909,2062
10506,3733243990,3711945923,1672684795,1672688028,3233
11721,3713107380,3792930090,1672580536,1672581001,465
11578,3510919509,3710861700,1672536110,1672539525,3415
10223,3311410533,3791863922,1672623324,1672623690,366
11544,3466620548,3792633495,1672602718,1672605714,2996
11569,3475033290,3511608609,1672687795,1672688212,417
11687,3716118473,3461743188,1672603783,1672607098,3315
11600,3517652011,3793497672,1672701438,1672701936,498
10171,3396472026,3778731000,1672577542,1672580689,3147
11683,3310021925,3220660616,1672558454,1672559736,1282
10687,3625400710,3773876312,1672589281,1672590620,1339
11422,3777498160,3778842400,1672562919,1672564674,1755
9809,3353335252,3930475498,1672565297,1672566522,1225
10571,3757598610,3935520819,1672675176,1672677271,2095
11187,3976225898,3774744663,1672702547,1672703320,773
10903,3295710494,3912878303,1672615785,1672616186,401
10129,3533593766,3271780525,1672598795,1672598877,82
11375,3206544535,3770533588,1672549348,1672551675,2327
10838,3732223664,3534499421,1672611999,1672614138,2139
9845,3856316719,3832312129,1672622508,1672625541,3033
11214,3632189887,3479585868,1672694276,1672697124,2848
11095,3791289855,3367262509,1672692429,1672695163,2734
10375,3342056927,3713141087,1672660029,1672663273,3244
10855,3714919471,3755273361,1672649877,1672651225,1348
10751,3770533588,3930727474,1672632897,1672635313,2416
11557,3817029483,3369482983,1672700306,1672702330,2024
11451,3501992314,3520016705,1672558375,1672558492,117
9905,3272096922,3638035545,1672604084,1672604348,264
9888,3519965717,3773736248,1672599471,1672602469,2998
11550,3505500665,3501734800,1672589806,1672592847,3041
11579,3445406685,3434581257,1672550669,1672554199,3530
10524,3380218091,3638018906,1672556183,1672556389,206
11578,3500591274,3355880028,1672689860,1672691248,1388
9932,3622729771,3792900315,1672676294,1672679509,3215
10511,3714281795,3715196780,1672652966,1672656052,3086
11227,3473520701,3514007122,1672575812,1672576195,383
11719,3404375908,3520926977,1672598289,1672601391,3102
10032,3857847527,3855629383,1672555826,1672558904,3078
11704,3304661369,3472901378,1672645025,1672648011,2986
11193,3817376705,3510484107,1672590090,1672590682,592
11425,3513800589,3912915644,1672541771,1672544589,2818
11594,3683047199,3500057674,1672576043,1672577408,1365
11373,3713920790,3773579644,1672658580,1672660140,1560
11610,3311514075,3533131937,1672588038,1672590759,2721
10965,3515047288,3791542842,1672564431,1672567856,3425
11027,3770530739,3738734246,1672534841,1672536188,1347
11740,3757150421,3756850160,1672560335,1672562461,2126
10323,3920116284,3381055770,1672687599,1672689240,1641
10056,3701387745,3516827471,1672561497,1672563602,2105
11246,3885645840,3505720915,1672592086,1672593016,930
10974,3510178791,3917243005,1672643948,1672644409,461
11401,3555378248,3792432094,1672620926,1672621592,666
11095,3500695402,3455955489,1672659597,1672663016,3419
11683,3334381941,3433189219,1672662906,1672664540,1634
11126,3713031958,3711755596,1672590405,1672593758,3353
10152,3406132280,3553008208,1672586659,1672587764,1105
10588,3822368676,3515681585,1672620718,1672622029,1311
11219,3701284535,3201502111,1672597799,1672598469,670
10272,3298831109,3509508477,1672669697,1672672643,2946
10201,3774436159,3780941637,1672597703,1672598011,308
11195,3388463477,3780352400,1672531665,1672532208,543
11217,3533036499,3552444228,1672654151,1672655429,1278
10957,3895507040,3517227599,1672654490,1672656819,2329
11383,3505653701,3487231844,1672652624,1672654254,1630
10876,3313824913,3512826895,1672635260,1672635866,606
11025,3318590083,3515259326,1672605968,1672606932,964
11729,3971051020,3900793652,1672543920,1672546785,2865
10867,3419789418,3309178914,1672637383,1672639699,2316
10774,3285136057,3247845642,1672632623,1672635622,2999
10770,3516815069,3772223331,1672662099,1672662625,526
11554,3780213684,3342426430,1672611181,1672611997,816
11590,3811419378,3777498160,1672599107,1672601753,2646
11065,3739395381,3245501577,1672617214,1672618537,1323
9943,3736941123,3711404205,1672597348,1672597678,330
10339,3501004005,3534578428,1672559171,1672561104,1933
10980,3514033319,3510869438,1672643802,1672647102,3300
9873,3816184951,3228575883,1672629287,1672632571,3284
10828,3441336851,3388481990,1672652560,1672653268,708
10773,3711040761,3776727271,1672541362,1672544499,3137
10341,3559759778,3516026189,1672614277,1672615105,828
10368,3904184638,3687183789,1672555652,1672556406,754
11435,3938129916,3519730914,1672630778,1672631578,800
9796,3342031426,3533154906,1672684094,1672687260,3166
11307,3667654673,3201419050,1672662460,1672663686,1226
10031,3701004302,3783313202,1672575069,1672577633,2564
10615,3701956841,3505769529,1672598068,1672601382,3314
11361,3442462115,3780500331,1672648878,1672652196,3318
10589,3421956717,3311479294,1672579692,1672583047,3355
11000,3452389513,3885147558,1672661013,1672664491,3478
10164,3509317054,3703443664,1672560306,1672562659,2353
11307,3793949077,3446810761,1672626574,1672629710,3136
10141,3714688409,3378430760,1672698848,1672702004,3156
11364,3711889178,3711029952,1672548922,1672549046,124
10586,3900766525,3424425746,1672659799,1672659876,77
9856,3505117019,3515379622,1672563353,1672566553,3200
10894,3777878462,3520012007,1672599840,1672601501,1661
10587,3311479294,3757201138,1672657314,1672660795,3481
11367,3793987483,3688410383,1672696229,1672696352,123
11383,3735497729,3512492332,1672679241,1672680832,1591
10658,3774673193,3509370633,1672532994,1672535535,2541
10007,3825932442,3631444265,1672548798,1672551652,2854
10810,3703474558,3358530225,1672585457,1672585658,201
11076,3343859998,3299847117,1672558546,1672559035,489
11611,3350631472,3934070285,1672649851,1672652640,2789
11182,3371184929,3777672363,1672642439,1672643120,681
10063,3201573194,3505547832,1672543176,1672544967,1791
10243,3773434690,3500695402,1672596281,1672598775,2494
10701,3505936495,3366164642,1672580538,1672580847,309
11048,3910190872,3777937949,1672562670,1672565112,2442
10964,3519174861,3534984243,1672543967,1672547462,3495
10659,3756668747,3887030182,1672533264,1672534284,1020
11042,3484490325,3891586951,1672667730,1672668726,996
10058,3854390432,3352374868,1672620650,1672624087,3437
10025,3516257130,3884388188,1672556857,1672557727,870
11431,3509317054,3342252701,1672592446,1672592855,409
10692,3777992576,3534775239,1672677873,1672680248,2375
11687,3380444321,3615742989,1672536476,1672537515,1039
10817,3857244486,3716526314,1672547247,1672547331,84
9883,3510291656,3201920708,1672690392,1672690953,561
10263,3783176874,3403988682,1672674119,1672675557,1438
10745,3932566114,3275661834,1672610251,1672613020,2769
11747,3703722212,3227339675,1672639289,1672642434,3145
11311,3516257130,3509370016,1672609314,1672610646,1332
10896,3510968599,3505845400,1672649994,1672650746,752
11493,3701824335,3300238532,1672590669,1672591626,957
10809,3385416697,3778253021,1672605078,1672608306,3228
10428,3612705426,3208894215,1672597726,1672598895,1169
11724,3501992314,3368951504,1672652943,1672655625,2682
10653,3778695017,3713969196,1672631192,1672631980,788
11258,3304252969,3380218091,1672563117,1672564818,1701
10450,3500671218,3406492167,1672639912,1672643419,3507
10255,3342235058,3777655401,1672574699,1672575352,653
11220,3231271498,3915035136,1672588597,1672591953,3356
9821,3454343398,3463564410,1672589457,1672589561,104
10650,3501873139,3227919286,1672633985,1672634275,290
10682,3366501813,3783373085,1672688955,1672690292,1337
10976,3791194984,3287094447,1672644863,1672645196,333
9926,3515378306,3519448648,1672627156,1672628093,937
11495,3701218904,3391093411,1672678149,1672678260,111
10818,3510819040,3612042508,1672579374,1672581200,1826
11113,3807646028,3400186699,1672563930,1672567147,3217
10125,3519319233,3716095450,1672680282,1672681796,1514
10309,3780964089,3491250381,1672615547,1672616093,546
11089,3899294071,3774706478,1672585817,1672589115,3298
10086,3774965463,3501205057,1672622070,1672625271,3201
10749,3517426473,3505836431,1672547715,1672548605,890
11774,3896622009,3519922921,1672565157,1672565974,817
11050,3755924094,3494748808,1672600523,1672603052,2529
10324,3778741325,3533830748,1672595599,1672597190,1591
11344,3498857406,3778702093,1672659617,1672662007,2390
10983,3621439107,3701770921,1672551009,1672551562,553
11335,3715008501,3512504247,1672575120,1672576322,1202
11151,3770764940,3757728121,1672672113,1672674636,2523
11689,3755769254,3357026115,1672625168,1672625859,691
10110,3791825536,3793822639,1672641149,1672644172,3023
10776,3494157939,3970775805,1672698060,1672701410,3350
10761,3500928990,3511458926,1672609801,1672612613,2812
11255,3774316305,3779413388,1672544610,1672546732,2122
11755,3429315500,3519102732,1672557922,1672559555,1633
11184,3505502819,3397330170,1672682176,1672684336,2160
10915,3380167818,3710529628,1672577073,1672579846,2773
10754,3930766276,3716595760,1672612485,1672612828,343
9822,3783594246,3701171318,1672627475,1672628395,920
10804,3344478603,3505839395,1672563745,1672564577,832
9966,3415803494,3500234771,1672684498,1672686543,2045
10369,3415840750,3482687604,1672585565,1672586504,939
11137,3246062632,3822786416,1672686827,1672690258,3431
9962,3515838621,3330466913,1672567065,1672568837,1772
10992,3902300755,3375906394,1672656882,1672657280,398
10127,3510547682,3716095450,1672606499,1672608225,1726
10962,3778044082,3776122272,1672533105,1672536514,3409
10285,3716526314,3477582923,1672532946,1672535879,2933
9915,3716801088,3776778306,1672641129,1672643158,2029
10346,3703462221,3201419050,1672623431,1672626396,2965
10588,3519730914,3285587972,1672690571,1672693655,3084
10486,3711947828,3976742903,1672594891,1672595040,149
11231,3736056340,3793874490,1672616954,1672618499,1545
9966,3520506192,3896622009,1672577164,1672579000,1836
10988,3713219299,3227874229,1672644878,1672646327,1449
10119,3469370398,3716389356,1672684449,1672686605,2156
10843,3899756737,3890194669,1672534196,1672536829,2633
11497,3533976217,3783408469,1672574944,1672575659,715
10946,3939422411,3511415786,1672695404,1672696177,773
10709,3716669659,3770941125,1672591535,1672593783,2248
10670,3666958814,3274239253,1672580102,1672581942,1840
10316,3716541851,3716982179,1672603385,1672605727,2342
11072,3509996827,3756493561,1672593583,1672596819,3236
10553,3773688906,3829698950,1672583254,1672586757,3503
11462,3311449914,3661543201,1672582559,1672584117,1558
11496,3738429905,3774706478,1672651583,1672653635,2052
10321,3534278019,3246395239,1672557780,1672558656,876
11066,3358959807,3715724166,1672632188,1672633144,956
10206,3304672737,3793029132,1672607972,1672608778,806
10543,3681504869,3559759778,1672691625,1672693849,2224
11316,3770671714,3533816813,1672652311,1672655154,2843
10154,3757598610,3710622746,1672625123,1672628047,2924
10971,3772169046,3396440259,1672659675,1672661499,1824
9894,3331471764,3517210356,1672624598,1672626985,2387
11603,3701663839,3831981073,1672628984,1672631595,2611
11217,3621591266,3333477908,1672697893,1672699848,1955
10200,3292936094,3701512498,1672671891,1672674004,2113
10023,3774965463,3713990030,1672579292,1672579681,389
10125,3289258397,3514564903,1672600565,1672600697,132
10201,3447554599,3607288879,1672637837,1672640800,2963
10048,3627358016,3716841469,1672602929,1672606101,3172
10624,3770019143,3806034626,1672585797,1672587826,2029
10092,3435652260,3772980989,1672626267,1672626818,551
10889,3633949990,3500688476,1672549743,1672552834,3091
10797,3780964089,3416474842,1672592579,1672592810,231
11611,3359418136,3407403080,1672555992,1672557585,1593
11566,3760854788,3828906027,1672579890,1672583371,3481
11236,3511206717,3928508375,1672701171,1672701299,128
11027,3938021614,3499711458,1672566500,1672567786,1286
10819,3301369282,3806720019,1672554663,1672555266,603
11666,3716467469,3791108593,1672699274,1672702256,2982
11163,3516904926,3441840658,1672597021,1672598349,1328
11083,3760346746,3517325365,1672543682,1672546856,3174
10475,3509912164,3773768643,1672678152,1672680089,1937
11731,3857609616,3369810091,1672534074,1672534532,458
11405,3405221863,3756363182,1672577267,1672577846,579
11143,3520160414,3471585513,1672626653,1672629887,3234
9954,3235578121,3774539067,1672664064,1672665302,1238
11153,3783067048,3756763585,1672680139,1672682507,2368
11191,3227919286,3883640454,1672680891,1672682894,2003
11789,3936871734,3780294116,1672631758,1672633738,1980
10628,3701540249,3779604279,1672623762,1672626813,3051
10368,3533703578,3387971464,1672556382,1672557357,975
11515,3710397477,3510882576,1672615377,1672618967,3590
11570,3334381941,3505836431,1672684434,1672685277,843
10812,3239279744,3637105495,1672678933,1672682322,3389
10612,3715566511,3779930476,1672680377,1672683854,3477
11449,3773556853,3223796145,1672545253,1672545726,473
10071,3351728355,3852014884,1672653308,1672654358,1050
10469,3206241691,3791522832,1672606726,1672607100,374
10802,3772569860,3478455812,1672560092,1672562282,2190
11597,3829761380,3505314920,1672628427,1672630281,1854
10758,3224824355,3734233216,1672621545,1672622609,1064
9853,3294164983,3441336851,1672670740,1672673812,3072
10798,3710861700,3349475873,1672539874,1672542323,2449
11190,3450503086,3774355339,1672631156,1672633532,2376
10706,3501515425,3517227599,1672599794,1672602704,2910
11164,3343511947,3351728355,1672608540,1672611632,3092
9881,3973134902,3703749690,1672697341,1672700255,2914
11103,3716994924,3513661302,1672642096,1672645532,3436
9872,3884369346,3406101720,1672700081,1672702168,2087
10192,3519046342,3387971464,1672633323,1672636593,3270
9811,3792682835,3607583720,1672618284,1672620839,2555
11672,3838039092,3603740088,1672574232,1672575423,1191
10617,3714883746,3636015050,1672670162,1672671030,868
10913,3971282455,3714919471,1672658680,1672661070,2390
11566,3476144563,3972729768,1672625597,1672625905,308
11126,3239279744,3756437169,1672667305,1672670515,3210
10331,3318590083,3414387263,1672666965,1672668749,1784
10437,3377883705,3423147369,1672639088,1672640012,924
11500,3398151217,3439283360,1672549187,1672550077,890
9971,3856129522,3905571273,1672691012,1672691573,561
10744,3613547091,3421956717,1672543200,1672546065,2865
11687,3783594729,3376487118,1672612967,1672615908,2941
11726,3783443095,3755175497,1672537461,1672538892,1431
11143,3301765144,3203909360,1672681221,1672684298,3077
10596,3814770073,3419789418,1672563154,1672564448,1294
10679,3513624915,3519102732,1672560624,1672561571,947
11194,3613781977,3603452936,1672561884,1672562305,421
10514,3909067335,3780500331,1672618300,1672621619,3319
11186,3224053840,3510368377,1672551294,1672552725,1431
9907,3505438826,3481019442,1672676511,1672677649,1138
11765,3703938162,3501027795,1672689836,1672690888,1052
10294,3903115138,3791716170,1672547994,1672551132,3138
10732,3778838936,3760656396,1672565589,1672566046,457
10528,3423940256,3519521903,1672560599,1672563691,3092
11473,3716633983,3206217657,1672581388,1672584827,3439
10717,3275751794,3519162582,1672639193,1672641936,2743
11413,3713636175,3902292032,1672684700,1672685805,1105
9904,3793274957,3514941815,1672639545,1672641242,1697
10365,3436774112,3900793652,1672701868,1672702184,316
11631,3294164983,3333505404,1672567455,1672567614,159
10968,3501225887,3405303958,1672696220,1672698822,2602
10193,3972442654,3514216460,1672544653,1672546028,1375
10734,3500473064,3770180844,1672561741,1672564283,2542
11195,3791587717,3350169064,1672607562,1672607859,297
10051,3757514745,3730935770,1672613789,1672614381,592
11122,3774221318,3376842515,1672630822,1672631522,700
10460,3511004622,3534204885,1672550703,1672551480,777
11111,3497562878,3621812406,1672574708,1672577031,2323
10634,3505007498,3829412384,1672541615,1672543145,1530
9893,3783727937,3825526565,1672632176,1672634892,2716
10102,3925175853,3812516461,1672603933,1672607384,3451
10440,3792283334,3512784888,1672603186,1672603982,796
11589,3778402454,3471507117,1672628821,1672629569,748
10145,3360837082,3517083465,1672562850,1672563369,519
9850,3372778334,3773523569,1672686641,1672689967,3326
11143,3605101443,3393909269,1672679572,1672681538,1966
9994,3419829238,3514776568,1672540066,1672541225,1159
11189,3668681400,3731644240,1672614447,1672615403,956
11509,3780964089,3516867729,1672669122,1672672345,3223
11429,3685877449,3636857871,1672623055,1672624575,1520
10851,3307997700,3884934977,1672661496,1672661743,247
10553,3731905251,3491390365,1672634494,1672637402,2908
10643,3756680289,3715490209,1672543698,1672546924,3226
10302,3510819040,3222357355,1672640380,1672641745,1365
11445,3711518637,3517227599,1672560533,1672563158,2625
11618,3283785820,3811351746,1672687608,1672689023,1415
9990,3896211741,3821082558,1672536132,1672539692,3560
10244,3703502114,3714281795,1672700805,1672703283,2478
10323,3500087325,3494157939,1672607044,1672607580,536
10008,3513777705,3791206902,1672578618,1672581486,2868
11285,3760648750,3497732613,1672685425,1672686165,740
9808,3770275898,3850005949,1672679513,1672682892,3379
10588,3394959062,3364683368,1672603109,1672604409,1300
10066,3714645218,3513840186,1672693001,1672693656,655
11157,3505826673,3614112171,1672662032,1672663241,1209
11089,3208594306,3716609198,1672547591,1672547816,225
11136,3501271930,3501992314,1672623867,1672627055,3188
10400,3755342153,3345896913,1672670695,1672673503,2808
11458,3291446384,3710919244,1672591207,1672592137,930
10569,3453519360,3773852157,1672552339,1672555485,3146
10961,3858497718,3978643889,1672565409,1672568452,3043
10760,3384601925,3235373942,1672532539,1672533238,699
10191,3839744168,3505175620,1672557061,1672560088,3027
10445,3778838936,3421674406,1672665280,1672668288,3008
11458,3410788026,3533976217,1672653441,1672655370,1929
10269,3446764595,3681274982,1672585321,1672586257,936
10494,3899156705,3336501403,1672623665,1672624338,673
10905,3310021925,3779340538,1672603624,1672605120,1496
11573,3305657559,3772751765,1672573075,1672575905,2830
11602,3515378306,3735152111,1672673901,1672675468,1567
11062,3445558740,3791841318,1672657058,1672659105,2047
10294,3512697456,3312946269,1672683403,1672686033,2630
10280,3779312237,3780576351,1672652151,1672654795,2644
9962,3625779003,3313282478,1672687387,1672688037,650
10714,3770595035,3514244308,1672617989,1672621104,3115
10733,3711015176,3439662051,1672548157,1672551254,3097
10943,3627081426,3688768189,1672608866,1672609259,393
10152,3779815753,3613940925,1672664458,1672666036,1578
10817,3662522808,3939882169,1672666357,1672669621,3264
11000,3517800171,3517992521,1672615483,1672616074,591
10095,3343859998,3306491253,1672699513,1672702389,2876
11323,3366961580,3439532406,1672617300,1672620415,3115
10565,3406390503,3352493805,1672595291,1672597028,1737
9825,3893043842,3384601925,1672558671,1672561362,2691
11646,3756149282,3236360179,1672674948,1672676101,1153
10741,3395615598,3633949990,1672608988,1672611872,2884
9881,3510159441,3419829238,1672660025,1672662883,2858
9901,3716922925,3925208102,1672602373,1672603858,1485
10793,3925823748,3714065165,1672664864,1672668049,3185
10319,3517949586,3407398464,1672543925,1672547156,3231
11017,3760687922,3467756698,1672671706,1672672298,592
10674,3501271930,3473706746,1672543073,1672544840,1767
10193,3773424266,3850181934,1672582122,1672585076,2954
10235,3533960602,3388774559,1672693740,1672694804,1064
11228,3825234433,3791796190,1672682045,1672684846,2801
10080,3661856558,3512251592,1672637966,1672640866,2900
10894,3903065952,3688768189,1672543668,1672546578,2910
10564,3283847934,3283847934,1672670625,1672673683,3058
10766,3614112171,3776778306,1672624538,1672625596,1058
9903,3772227820,3913746581,1672577034,1672577693,659
10148,3780050146,3783730769,1672551961,1672555320,3359
11628,3500019810,3902682060,1672679658,1672682052,2394
10169,3755361692,3515655024,1672700371,1672702168,1797
10428,3887069914,3512072679,1672623050,1672624101,1051
11004,3311924005,3534491112,1672670592,1672673649,3057
10813,3973134902,3360837082,1672609886,1672610832,946
11459,3512417028,3606688595,1672611929,1672613547,1618
9795,3378172464,3427741923,1672684540,1672685066,526
11014,3666367524,3233965781,1672538332,1672539050,718
10396,3714595459,3715566511,1672534941,1672535354,413
11499,3511526885,3777715675,1672691188,1672691634,446
11328,3927675706,3515507526,1672545291,1672548679,3388
10931,3618024815,3368079099,1672661878,1672665360,3482
10849,3513092056,3627081426,1672629693,1672631472,1779
11583,3610806770,3804075198,1672531700,1672534626,2926
11444,3348100657,3710515351,1672666174,1672668853,2679
11455,3511028193,3600871715,1672611606,1672614058,2452
10646,3776053084,3890813040,1672600982,1672603019,2037
10068,3776304080,3279851026,1672693785,1672695304,1519
10230,3505491969,3559754304,1672576957,1672577587,630
10756,3823600319,3500093945,1672589751,1672591906,2155
11414,3510244209,3488399075,1672695281,1672696674,1393
10271,3711367577,3513890046,1672672540,1672672914,374
10437,3783368855,3509445318,1672561978,1672563485,1507
11123,3519260216,3300238532,1672585947,1672589035,3088
10964,3836757034,3278443807,1672687345,1672688684,1339
10682,3605760561,3519965717,1672599179,1672600098,919
11318,3668955834,3778273230,1672536051,1672537765,1714
10965,3703438617,3434052463,1672610715,1672612308,1593
10019,3738103378,3500741005,1672590197,1672592365,2168
10606,3620157388,3351856699,1672553104,1672553631,527
11612,3627431396,3452090950,1672531239,1672531895,656
11039,3779340538,3776968640,1672676652,1672680110,3458
11386,3773432494,3500438542,1672567789,1672569479,1690
10317,3715737742,3302348002,1672674128,1672676474,2346
10199,3602570831,3273758330,1672622203,1672625767,3564
9976,3714806574,3890638402,1672590790,1672593449,2659
10225,3701519251,3274341934,1672548121,1672549817,1696
10122,3509651954,3511069449,1672553334,1672553956,622
11137,3454554552,3817029483,1672562545,1672564588,2043
10701,3519689906,3500654356,1672642814,1672645396,2582
11220,3287760230,3534604516,1672592916,1672595060,2144
9840,3510262025,3533627473,1672561154,1672562581,1427
10244,3701663839,3552309108,1672566313,1672567401,1088
11681,3307521389,3387700451,1672682172,1672685624,3452
10384,3716233100,3757773786,1672691992,1672695110,3118
10921,3414841458,3893629892,1672577246,1672578735,1489
10755,3711187791,3770391782,1672570481,1672570796,315
11527,3636015050,3886896755,1672590924,1672591586,662
11656,3505684690,3204149913,1672575398,1672576959,1561
11090,3778824229,3500019810,1672649770,1672650507,737
10022,3241567995,3500596577,1672635012,1672638591,3579
10379,3505175620,3774205060,1672568604,1672571680,3076
10678,3334482021,3711243126,1672533622,1672535699,2077
10237,3757406215,3779382417,1672696991,1672699938,2947
9993,3330466913,3553640169,1672688139,1672690519,2380
11342,3909399636,3791522832,1672589168,1672591570,2402
10079,3777758203,3835982340,1672535059,1672536492,1433
10170,3713807459,3792411831,1672633911,1672635646,1735
10642,3919345990,3519689906,1672599341,1672599921,580
10256,3415228763,3442181067,1672664114,1672664404,290
11440,3501853868,3555764822,1672645366,1672648805,3439
10398,3933562725,3201573194,1672567108,1672570150,3042
10116,3492350318,3283106998,1672606961,1672609064,2103
11443,3971282455,3791581138,1672638191,1672640608,2417
10122,3551833298,3505331014,1672583016,1672586203,3187
10249,3839417558,3919984986,1672616566,1672616888,322
11470,3732871856,3701956841,1672578305,1672581157,2852
10384,3755342153,3711223297,1672605174,1672607961,2787
10335,3600302127,3791031227,1672557590,1672558086,496
11227,3602054754,3713139039,1672531875,1672532526,651
11442,3715852330,3500057674,1672670981,1672674127,3146
9971,3491104534,3636877469,1672532995,1672535033,2038
10402,3714640103,3303772923,1672586257,1672586559,302
10418,3505121295,3512826895,1672687776,1672689235,1459
11563,3713767153,3730600658,1672584863,1672586913,2050
10898,3791542842,3713374884,1672548902,1672552190,3288
10013,3760232135,3428878402,1672691615,1672692410,795
10099,3511069449,3780942505,1672638818,1672642091,3273
10779,3311177439,3278629965,1672580026,1672580591,565
10005,3471507117,3812677669,1672607337,1672608172,835
11573,3404375908,3501554468,1672645780,1672646360,580
10378,3519553933,3231153513,1672688383,1672689431,1048
10868,3783430498,3500251781,1672662487,1672663302,815
11708,3856975623,3314363575,1672661781,1672662325,544
10440,3924583142,3757851680,1672605834,1672608522,2688
10426,3556684272,3772291207,1672595916,1672598011,2095
10432,3403988682,3461743188,1672679844,1672682221,2377
10193,3915195160,3500591274,1672574485,1672577981,3496
9881,3514941815,3369270860,1672609989,1672611292,1303
11131,3517380144,3514297012,1672582945,1672584855,1910
9922,3443521234,3316117186,1672677058,1672679901,2843
11195,3780287649,3442403264,1672588215,1672590012,1797
11730,3791581138,3462153833,1672596099,1672596880,781
10935,3445733121,3447267291,1672699624,1672700441,817
10991,3416474842,3498857406,1672641979,1672644830,2851
11505,3636857871,3638126174,1672597006,1672597205,199
10687,3756345026,3755286041,1672688120,1672691608,3488
10475,3516019206,3514628916,1672551388,1672551623,235
10143,3428076194,3519521903,1672660696,1672663947,3251
11251,3457249798,3505438826,1672693761,1672693854,93
10291,3511608609,3783554600,1672616492,1672618513,2021
11004,3377446376,3440743218,1672563647,1672564143,496
10849,3509186338,3338115824,1672640848,1672641150,302
10453,3509470194,3403257752,1672637461,1672640011,2550
10496,3517210356,3857609616,1672693685,1672694357,672
11004,3888409038,3663353552,1672619336,1672620932,1596
11298,3534562354,3238310644,1672559088,1672559774,686
9972,3908464960,3475830203,1672690238,1672693507,3269
11297,3500057674,3201634072,1672628443,1672630128,1685
11780,3735679000,3510856388,1672676089,1672676165,76
11624,3312800145,3424425746,1672587369,1672590092,2723
10208,3517551721,3461137945,1672606561,1672606768,207
11535,3518067857,3406937294,1672666290,1672668351,2061
10223,3500440602,3514685272,1672614946,1672617127,2181
10889,3791409441,3976742903,1672624471,1672625727,1256
11107,3711959141,3929446196,1672576903,1672577934,1031
11339,3345954031,3938021614,1672563616,1672566172,2556
10837,3774029494,3777204977,1672543114,1672545757,2643
10418,3920116284,3474350534,1672685451,1672686476,1025
11626,3774706478,3802374620,1672562660,1672563764,1104
10225,3349475873,3900793652,1672671239,1672673266,2027
11420,3755378125,3774029494,1672681285,1672683768,2483
10648,3661359073,3909632424,1672564901,1672564981,80
9808,3716994924,3919345990,1672635260,1672636502,1242
10906,3315094386,3818570577,1672689677,1672692427,2750
11671,3773032706,3511028193,1672662559,1672665642,3083
10751,3362127525,3419829238,1672556961,1672560088,3127
11751,3730169449,3361789225,1672579973,1672582572,2599
10939,3919984986,3977337501,1672545509,1672546542,1033
11087,3516034245,3434452046,1672575664,1672577829,2165
10693,3559123082,3518425740,1672603694,1672605940,2246
10581,3435715962,3777135415,1672582688,1672583918,1230
10874,3478052226,3510542303,1672680243,1672682611,2368
10331,3613828705,3418367752,1672600183,1672602736,2553
10410,3480418192,3777204977,1672634703,1672638237,3534
9881,3510968599,3275661834,1672572224,1672573903,1679
11500,3791031227,3440305508,1672541504,1672544492,2988
10446,3419829238,3600978954,1672629035,1672629205,170
10732,3439662051,3780612543,1672614133,1672614352,219
10743,3791716170,3777290300,1672548097,1672548506,409
11385,3887502536,3452677710,1672539178,1672542240,3062
9867,3908464960,3760107540,1672692474,1672693386,912
10755,3701865589,3756761603,1672678336,1672681631,3295
10662,3770275898,3512826895,1672595411,1672595629,218
10613,3334824744,3884394685,1672547481,1672548643,1162
11579,3793926338,3716118473,1672606069,1672606778,709
10948,3360525513,3533593766,1672555881,1672557039,1158
10360,3711862792,3494680853,1672585943,1672586131,188
11402,3345902033,3632303304,1672561473,1672564429,2956
11037,3517151644,3435342362,1672681429,1672683219,1790
11030,3533440294,3755286041,1672694541,1672694905,364
11021,3776710698,3511907179,1672641946,1672645235,3289
10569,3899294071,3296970170,1672537299,1672539784,2485
10238,3398862999,3929355087,1672610161,1672612112,1951
11577,3772867078,3820280594,1672654503,1672655292,789
10543,3703611876,3680278447,1672579137,1672579395,258
10559,3290097447,3915679140,1672550351,1672552672,2321
10890,3534372899,3505351253,1672686221,1672688042,1821
10888,3760748418,3435801763,1672653587,1672655026,1439
11487,3366501813,3714690161,1672634881,1672638445,3564
11404,3500317923,3730459093,1672666158,1672667137,979
9795,3755570137,3409098014,1672679695,1672680453,758
10595,3792432763,3756272704,1672685042,1672686294,1252
11490,3660980656,3612042508,1672667644,1672667895,251
11263,3555763674,3279731391,1672689374,1672691245,1871
10035,3834456158,3925208102,1672541523,1672541761,238
9843,3534102440,3516827471,1672654295,1672657872,3577
11181,3517253559,3240622654,1672610170,1672612446,2276
10684,3501828287,3533822490,1672599267,1672600853,1586
10024,3685396470,3703588004,1672612148,1672612853,705
10477,3533340292,3918126468,1672674990,1672677210,2220
9849,3309528048,3777932581,1672617839,1672620106,2267
10903,3317989975,3701387745,1672698142,1672699863,1721
11529,3511311554,3352493805,1672586888,1672588284,1396
11032,3505032644,3770631449,1672568774,1672568936,162
10777,3896123242,3904846341,1672627237,1672629490,2253
9804,3510301454,3478206139,1672607030,1672609280,2250
11214,3665603628,3778273230,1672691266,1672693160,1894
10417,3533726421,3485468650,1672548789,1672548911,122
11534,3505500523,3772112976,1672674876,1672675739,863
10709,3434452046,3380628097,1672628798,1672631199,2401
10720,3516819320,3807584987,1672649489,1672651213,1724
10962,3511864772,3463892928,1672677143,1672680699,3556
10634,3772882440,3711755596,1672592801,1672593360,559
11546,3458271585,3664719070,1672552862,1672554734,1872
9829,3447591143,3701519251,1672668623,1672672041,3418
11186,3710813103,3519922921,1672532318,1672532770,452
11571,3238796398,3857909328,1672564162,1672565111,949
9814,3938129916,3439036305,1672604551,1672604785,234
9972,3755107521,3351856699,1672595180,1672598166,2986
11447,3850904092,3505836431,1672695767,1672696334,567
11555,3701893620,3520155898,1672629995,1672633350,3355
10997,3890813040,3518425740,1672656793,1672659037,2244
10096,3501619113,3710529628,1672585715,1672586080,365
10046,3756066702,3440991826,1672596035,1672596275,240
11241,3924205112,3779282072,1672609954,1672612086,2132
10098,3515230715,3513840186,1672668647,1672671977,3330
9902,3710223875,3519521903,1672639587,1672640235,648
10801,3755203055,3792021895,1672695148,1672697248,2100
10342,3779706467,3976742903,1672594758,1672596290,1532
11550,3625952981,3455955489,1672629379,1672631723,2344
10645,3884862164,3973138649,1672675731,1672678269,2538
10049,3509394912,3783879023,1672616015,1672616786,771
11691,3315094386,3714264759,1672584099,1672584388,289
10407,3666958814,3534812391,1672610343,1672611974,1631
11456,3711889178,3778713526,1672604003,1672604663,660
11401,3627081426,3311529105,1672572875,1672575640,2765
10220,3319862687,3483347530,1672553772,1672556895,3123
10224,3756759239,3929923442,1672560239,1672561449,1210
10968,3310702648,3517530943,1672546537,1672546956,419
10445,3780982229,3514033319,1672608766,1672610559,1793
11094,3623894390,3500695402,1672630352,1672632408,2056
11089,3886879696,3466149998,1672601383,1672602838,1455
10548,3886957097,3811629200,1672543472,1672544344,872
9903,3755779925,3289017988,1672545548,1672546556,1008
10672,3472901378,3505811269,1672562446,1672563105,659
9911,3730571757,3357074700,1672545749,1672548897,3148
10695,3839308659,3809871495,1672693402,1672696661,3259
10045,3468281011,3714264759,1672641746,1672642225,479
11702,3755942724,3755238321,1672565305,1672568025,2720
11166,3372596013,3703725221,1672614761,1672617188,2427
10239,3757201138,3838748301,1672532816,1672533807,991
11771,3792012147,3909399636,1672652171,1672653200,1029
10219,3703419800,3463564410,1672699504,1672700175,671
11657,3505121295,3400025324,1672635824,1672638606,2782
10946,3756695502,3813853446,1672608898,1672610773,1875
11632,3688410383,3710695372,1672657287,1672657811,524
10514,3880030249,3772251279,1672588661,1672590152,1491
11650,3432762943,3824135033,1672647646,1672650037,2391
11042,3231271498,3516359146,1672581912,1672585402,3490
10599,3977337501,3534543864,1672605162,1672608417,3255
10327,3973138649,3936871734,1672686952,1672687107,155
10669,3292050211,3774109138,1672637943,1672640374,2431
10479,3519754667,3755369666,1672594122,1672595405,1283
10646,3501244753,3756536476,1672675246,1672678418,3172
10213,3914947393,3299052917,1672572501,1672575833,3332
11218,3501628472,3829761380,1672612398,1672614247,1849
10940,3409078869,3760854788,1672701694,1672702658,964
10562,3774401596,3938129916,1672670067,1672670572,505
11123,3773878451,3519448648,1672663338,1672666396,3058
10790,3278430820,3509996827,1672605967,1672606281,314
9827,3447696555,3756493561,1672645245,1672647905,2660
11742,3783067048,3515548696,1672534797,1672537086,2289
9794,3621812406,3335139032,1672663331,1672663604,273
10441,3793704155,3227919286,1672649787,1672651417,1630
10381,3772569860,3703732445,1672553476,1672553983,507
11263,3241855333,3440582836,1672643105,1672643188,83
10661,3408408584,3512794667,1672573854,1672573990,136
11629,3838039092,3500688476,1672632456,1672635926,3470
9872,3534812391,3243651036,1672684475,1672685009,534
10859,3501550490,3779604279,1672614891,1672615279,388
10683,3880549316,3604908372,1672700641,1672701996,1355
11555,3501988762,3371184929,1672615989,1672616788,799
11096,3701685828,3555954355,1672650588,1672651044,456
10780,3979115924,3307997700,1672628765,1672630599,1834
10969,3905571273,3445733121,1672700645,1672702144,1499
11528,3716595760,3472718723,1672672478,1672674100,1622
11614,3239279744,3713923960,1672539167,1672541851,2684
10376,3354015456,3730571757,1672586347,1672587413,1066
10187,3793987483,3519730914,1672691833,1672692558,725
10093,3772114731,3606804618,1672688548,1672691300,2752
10504,3511883778,3826418889,1672680884,1672683235,2351
11220,3777909822,3518572231,1672661552,1672664460,2908
11561,3493679801,3716233100,1672620857,1672623096,2239
11166,3755729826,3244495586,1672537040,1672540281,3241
10197,3276231633,3793274957,1672535366,1672535627,261
10703,3713923960,3203151036,1672643657,1672644312,655
11313,3423346297,3514352989,1672566621,1672569871,3250
10557,3505845400,3516103646,1672681036,1672683197,2161
10330,3499711458,3334824744,1672605122,1672607191,2069
10643,3920155862,3890278838,1672543889,1672547153,3264
10921,3922430928,3733796228,1672613657,1672614953,1296
10569,3730935770,3885339157,1672549765,1672550991,1226
10891,3514455363,3247193800,1672614332,1672617492,3160
10705,3609335008,3370751461,1672684228,1672685295,1067
10503,3428325402,3783373085,1672632467,1672635392,2925
10445,3716994924,3917004141,1672600625,1672600727,102
10642,3516249472,3480270940,1672617580,1672620030,2450
10173,3413236071,3756363182,1672570423,1672571388,965
11511,3684108920,3499142934,1672661941,1672663704,1763
10344,3534278019,3716209499,1672678769,1672681587,2818
10574,3534174363,3558567160,1672600036,1672602102,2066
10602,3703048107,3760390822,1672595765,1672597875,2110
11525,3505183641,3386323728,1672631678,1672633439,1761
10899,3244397548,3416079461,1672594455,1672596496,2041
10341,3779778679,3207497598,1672618805,1672619149,344
11480,3235313062,3239279744,1672617424,1672619481,2057
10975,3703031637,3755203055,1672567586,1672569996,2410
11197,3974264211,3480259863,1672599332,1672600083,751
10435,3244495586,3514306458,1672635859,1672637316,1457
10881,3513850048,3512750313,1672603241,1672605508,2267
11079,3711367577,3311200541,1672644499,1672646014,1515
11604,3378729459,3600699873,1672697568,1672700388,2820
10811,3500741534,3834643026,1672696324,1672696938,614
10353,3783826338,3236360179,1672580013,1672582237,2224
11267,3517151644,3517136772,1672557875,1672558785,910
10560,3499711458,3293157673,1672652856,1672655063,2207
10401,3805704844,3534604516,1672533978,1672536842,2864
11519,3518794921,3376842515,1672601081,1672603900,2819
10812,3922409420,3500473064,1672629946,1672633110,3164
11271,3730290851,3910020031,1672617067,1672617159,92
10297,3780648744,3511500932,1672549955,1672551489,1534
10457,3285515107,3812880543,1672585480,1672588657,3177
10599,3664523809,3831864108,1672572943,1672575717,2774
11781,3631444265,3607288879,1672678672,1672680122,1450
10630,3505531432,3430823498,1672576623,1672579432,2809
11127,3756119976,3534168768,1672635198,1672636728,1530
10431,3513140146,3711179193,1672562092,1672563109,1017
10328,3972729768,3517810375,1672563862,1672565374,1512
11399,3510022922,3442181067,1672580380,1672583145,2765
11439,3505786561,3361635547,1672658691,1672658973,282
10668,3668955834,3231963246,1672535998,1672539052,3054
11202,3351728355,3345896913,1672637931,1672638008,77
10924,3739844610,3511341866,1672602390,1672605501,3111
10839,3520506192,3770574826,1672635842,1672636716,874
10130,3905571273,3373802545,1672696998,1672697564,566
11121,3534374523,3898595916,1672662866,1672666036,3170
11060,3710271021,3361865467,1672609215,1672610258,1043
11724,3779930476,3245755569,1672604254,1672605821,1567
10070,3533113740,3684199077,1672684265,1672686341,2076
10901,3813111107,3902548260,1672621398,1672624073,2675
11088,3287968403,3792162098,1672589649,1672592821,3172
9922,3380357490,3793569914,1672668562,1672668876,314
9837,3778909412,3621591266,1672679539,1672679937,398
10570,3633294415,3442181067,1672532366,1672534507,2141
10148,3243056734,3755342153,1672667863,1672668326,463
9986,3813986705,3623953446,1672539020,1672541356,2336
11328,3505853594,3777655401,1672608032,1672608242,210
10686,3487231844,3513586642,1672638487,1672639209,722
10835,3793569914,3972847837,1672698564,1672701856,3292
11602,3830962592,3760382349,1672587598,1672588426,828
11583,3783809405,3392482187,1672626223,1672627257,1034
10415,3688410383,3235074007,1672627526,1672630308,2782
10747,3711187791,3773736248,1672576374,1672577311,937
11099,3783357035,3295530454,1672649032,1672649939,907
10883,3272581469,3760979523,1672639544,1672641897,2353
11452,3755502373,3755357292,1672668244,1672671381,3137
10644,3792162098,3517426473,1672586000,1672588396,2396
9917,3400112498,3394959062,1672644867,1672646323,1456
10839,3244397548,3501271930,1672569268,1672569693,425
9805,3487395357,3912915644,1672640214,1672641030,816
11229,3469780362,3899156705,1672636557,1672639617,3060
10264,3736941123,3636852764,1672600111,1672603200,3089
9845,3886879696,3305612422,1672547842,1672550490,2648
9948,3291936679,3733796228,1672608240,1672609064,824
11611,3819315404,3514244308,1672559580,1672560732,1152
10246,3554174421,3792289287,1672578358,1672580525,2167
10984,3468066881,3439036305,1672649317,1672652521,3204
10853,3886957097,3500776597,1672540601,1672542282,1681
10732,3518209090,3703474558,1672558178,1672558943,765
9933,3520553959,3837885956,1672620951,1672621049,98
10020,3755507566,3715700639,1672595508,1672597281,1773
10426,3780733404,3780173788,1672681296,1672682151,855
10540,3909220912,3236563828,1672587133,1672588125,992
11456,3515379622,3368176107,1672667215,1672670558,3343
10030,3880030249,3776249160,1672567973,1672569329,1356
10821,3512871568,3241593146,1672647338,1672649868,2530
10289,3716526314,3773161055,1672656407,1672658163,1756
11281,3419378107,3737946004,1672668442,1672670405,1963
10541,3203954795,3793274957,1672680531,1672681490,959
10496,3405303958,3501171785,1672577205,1672580260,3055
11755,3224053074,3435715962,1672535052,1672538546,3494
10941,3380281484,3500695402,1672639795,1672640009,214
9984,3778909412,3778927933,1672680399,1672681776,1377
10053,3518335611,3394986304,1672610323,1672613158,2835
10815,3301403047,3479585868,1672613468,1672615406,1938
11763,3713805968,3791108593,1672648087,1672650798,2711
11672,3774359137,3666823095,1672634123,1672634372,249
10059,3904846341,3511615015,1672686799,1672690228,3429
11080,3334936138,3208962614,1672647273,1672648193,920
10743,3342837214,3534362749,1672609659,1672610331,672
10970,3770981604,3520344592,1672693448,1672696682,3234
11346,3513624915,3777641081,1672659431,1672660973,1542
11000,3772282008,3513545735,1672677218,1672678041,823
10091,3832745283,3517469005,1672593456,1672596340,2884
11142,3756850160,3348343425,1672703920,1672705860,1940
10813,3806720019,3930475498,1672610787,1672613167,2380
9829,3520362238,3630462406,1672592624,1672592869,245
10615,3858497718,3703206956,1672581415,1672581704,289
9947,3780956975,3716541851,1672668139,1672669618,1479
11141,3778605154,3773714494,1672564228,1672567196,2968
11746,3776600696,3903994989,1672561594,1672564778,3184
10306,3904485393,3701919083,1672657097,1672659397,2300
10885,3793899166,3510795808,1672567441,1672569238,1797
11219,3492728794,3687183789,1672539960,1672540218,258
10180,3510240661,3337673625,1672647350,1672650944,3594
10519,3623113240,3351856699,1672572368,1672575942,3574
10101,3309178914,3792173463,1672589489,1672591001,1512
10749,3511744756,3517552930,1672666490,1672667403,913
10285,3511069449,3939422411,1672695218,1672698505,3287
10874,3824259677,3418382025,1672536102,1672539519,3417
10540,3972653129,3711404205,1672540652,1672542479,1827
11781,3518989186,3793232021,1672543220,1672546535,3315
11472,3445733121,3713373455,1672612946,1672616279,3333
11550,3907088952,3922301238,1672656863,1672659763,2900
11586,3780482864,3772425253,1672646910,1672648219,1309
10160,3713566527,3350169064,1672569536,1672572026,2490
10388,3558567160,3274239253,1672682918,1672683822,904
11251,3241567995,3476416072,1672619893,1672623302,3409
9996,3714595459,3518794921,1672660816,1672660942,126
11387,3484483775,3302988745,1672607716,1672609088,1372
10706,3628423403,3452024572,1672640381,1672642630,2249
10194,3505183641,3760687922,1672558790,1672559644,854
11399,3770764940,3509828883,1672668665,1672671454,2789
9970,3703351452,3514389188,1672679557,1672682349,2792
11670,3511003541,3501027795,1672571658,1672572105,447
10208,3636877469,3774792696,1672600903,1672601181,278
11440,3932566114,3519922921,1672639987,1672641789,1802
11317,3423940256,3284829602,1672576681,1672579357,2676
11147,3836586875,3510826414,1672669958,1672673136,3178
10506,3730935770,3493598658,1672579336,1672579444,108
10567,3500442370,3354015456,1672588324,1672588774,450
11456,3511458926,3233965781,1672632187,1672632865,678
10529,3371759044,3423940256,1672586929,1672587876,947
10159,3902023467,3731905251,1672641415,1672643965,2550
11471,3520926977,3770991234,1672657946,1672659035,1089
10762,3475560058,3557653200,1672648607,1672648771,164
11019,3638126174,3533440294,1672551523,1672554895,3372
10185,3395610742,3701865589,1672639877,1672640614,737
9906,3364718040,3773440794,1672586510,1672590058,3548
10359,3711258452,3774673193,1672638294,1672638920,626
11630,3778100960,3772695548,1672685520,1672687245,1725
11433,3625779003,3778738044,1672622051,1672623093,1042
11647,3899156705,3772131127,1672550583,1672554113,3530
11587,3783727937,3716423829,1672534999,1672536835,1836
10515,3206926634,3500776597,1672668551,1672670970,2419
10049,3462985379,3509651954,1672634091,1672635146,1055
11039,3304235700,3500251781,1672564657,1672564862,205
11691,3290097447,3520009158,1672692469,1672692805,336
10323,3472561941,3972856326,1672599988,1672600869,881
10063,3342252701,3559759778,1672544032,1672545530,1498
10059,3770275898,3519448648,1672586844,1672587740,896
11199,3417360319,3505500523,1672703394,1672704129,735
9826,3500591274,3710819760,1672670741,1672671855,1114
11142,3390438262,3515607283,1672562103,1672565394,3291
10492,3791994414,3501171785,1672556608,1672556863,255
10248,3509431396,3857344874,1672699607,1672702258,2651
10133,3893527651,3435342362,1672556988,1672559211,2223
11525,3823307824,3629248353,1672578725,1672580991,2266
9965,3793689267,3491104534,1672561663,1672563917,2254
11787,3342235058,3450342110,1672650631,1672651028,397
11639,3287821258,3352493805,1672616834,1672619597,2763
9914,3500922040,3666022373,1672665433,1672666297,864
9929,3517377614,3713875941,1672638937,1672640518,1581
10601,3533473206,3385006834,1672541580,1672543072,1492
11590,3207307681,3311739926,1672548864,1672550280,1416
10224,3900540310,3517195738,1672591579,1672594089,2510
11305,3664478769,3711404205,1672533881,1672535366,1485
11087,3452090950,3757198930,1672552658,1672553157,499
11379,3830599959,3356972733,1672683401,1672685513,2112
10325,3896615831,3390438262,1672596953,1672600208,3255
11752,3828568868,3512492332,1672685930,1672688144,2214
9820,3783408830,3514926921,1672600019,1672601902,1883
9962,3343859998,3480560014,1672611474,1672613885,2411
9980,3827836825,3398151217,1672677157,1672678882,1725
9877,3337903727,3406492167,1672533522,1672536183,2661
10549,3249380931,3757549235,1672697338,1672700522,3184
10053,3887382548,3473520701,1672531500,1672532522,1022
11334,3776319560,3287689454,1672561359,1672563576,2217
11758,3443004958,3407734098,1672688419,1672689669,1250
10594,3792021895,3494560663,1672599597,1672600358,761
10586,3732533330,3757607649,1672566690,1672568698,2008
10647,3311409212,3510750299,1672564815,1672565622,807
10376,3755502373,3916955566,1672680098,1672681172,1074
10852,3756413374,3780749789,1672580368,1672583028,2660
11272,3206853747,3714640103,1672612440,1672613204,764
11320,3380218091,3338016147,1672602162,1672604027,1865
10712,3240622654,3505684690,1672534128,1672537570,3442
10768,3311133296,3623067708,1672537609,1672539294,1685
10751,3283785820,3810584695,1672571354,1672574291,2937
10722,3814672661,3288920399,1672668339,1672669313,974
11263,3888642876,3443191792,1672637433,1672638310,877
10032,3932566114,3783679478,1672591702,1672592190,488
10347,3411626917,3773840321,1672667147,1672669894,2747
11690,3367109648,3491390365,1672662533,1672663258,725
10572,3469350379,3423800775,1672660334,1672663136,2802
10302,3774448657,3683047199,1672588743,1672590263,1520
11724,3711854614,3662495290,1672575240,1672577551,2311
11109,3449020351,3609166109,1672702150,1672702371,221
11646,3606688595,3273771395,1672588259,1672591854,3595
10169,3421956717,3800434325,1672537888,1672538808,920
11752,3791368349,3505980138,1672570557,1672571149,592
10937,3510819040,3379517265,1672580594,1672580779,185
11419,3501370430,3271780525,1672661038,1672662360,1322
11461,3285587972,3499142934,1672660086,1672663141,3055
9900,3715897627,3354015456,1672701678,1672705111,3433
10383,3668202976,3930766276,1672571358,1672573087,1729
11126,3757924067,3714074120,1672546780,1672548200,1420
11297,3937636109,3756675909,1672551645,1672552879,1234
10433,3555764822,3276393542,1672582975,1672585755,2780
11678,3616403486,3852014884,1672686096,1672687051,955
10487,3602054754,3275975921,1672568968,1672571521,2553
10024,3552309108,3373135211,1672555353,1672556577,1224
11335,3851451801,3777290300,1672534888,1672535187,299
10894,3835982340,3733243990,1672609671,1672612046,2375
10968,3509431396,3811419378,1672552969,1672553696,727
11598,3906075386,3512411326,1672680922,1672681961,1039
10211,3501612813,3817029483,1672562368,1672563411,1043
10329,3249614888,3621439107,1672616829,1672617217,388
11116,3735497729,3516965624,1672541167,1672541506,339
10764,3783563043,3518157683,1672660732,1672661063,331
11523,3481019442,3715680249,1672658481,1672660765,2284
10455,3623953446,3275057862,1672574579,1672577284,2705
10491,3488399075,3406169279,1672625251,1672626933,1682
11220,3773085258,3505769529,1672542075,1672543390,1315
11339,3273771395,3971051020,1672636953,1672640382,3429
10402,3755924094,3513250976,1672654868,1672657525,2657
11140,3772869013,3509274030,1672614908,1672618288,3380
10146,3341738186,3851877325,1672557409,1672557647,238
11136,3735422623,3496579251,1672613905,1672617051,3146
11550,3738526914,3819024145,1672581556,1672581947,391
11765,3553694590,3387989658,1672629808,1672632097,2289
11044,3446575109,3778100960,1672686395,1672686711,316
10453,3454151554,3929391979,1672614159,1672615989,1830
10608,3780171640,3713159131,1672544164,1672547620,3456
11434,3903994989,3289771213,1672699976,1672702774,2798
10619,3231963246,3496591885,1672587833,1672591210,3377
9918,3811354125,3780500764,1672660360,1672663169,2809
11250,3514329209,3661856558,1672604279,1672604479,200
10358,3520725149,3915195160,1672621321,1672623365,2044
9992,3772893815,3791974273,1672608241,1672610064,1823
10034,3516586325,3516472352,1672548000,1672548286,286
11137,3227874229,3287683210,1672572670,1672573297,627
10890,3304697982,3416474842,1672604130,1672604591,461
11504,3474879231,3703588004,1672651416,1672654472,3056
9900,3710125627,3701387745,1672613203,1672615881,2678
10876,3500654356,3614944981,1672578970,1672581517,2547
10613,3385006834,3738526914,1672630750,1672634250,3500
11025,3367202274,3701675183,1672618109,1672619587,1478
11775,3792455305,3792411831,1672604153,1672606921,2768
10897,3238779889,3774744663,1672653760,1672654360,600
11551,3777074709,3715282492,1672555520,1672556315,795
11475,3500630465,3238056215,1672581773,1672582864,1091
11583,3517448452,3836757034,1672562486,1672565169,2683
11226,3278629965,3390537737,1672564880,1672568161,3281
10360,3364948616,3395082458,1672593064,1672595436,2372
11489,3685396470,3276230295,1672571546,1672575061,3515
11345,3239990061,3714658474,1672622375,1672625532,3157
11188,3711367577,3207586072,1672603797,1672605432,1635
10467,3738103378,3929355087,1672577935,1672578626,691
10491,3330799389,3710865678,1672651270,1672651694,424
11262,3358675021,3275975921,1672625022,1672627994,2972
11777,3311805161,3621960662,1672659294,1672660837,1543
10925,3505438826,3450234157,1672613135,1672615892,2757
10696,3850904092,3837378340,1672544673,1672547906,3233
10684,3779478448,3972847837,1672626741,1672627528,787
11360,3783122313,3970851830,1672565520,1672566901,1381
10381,3341985886,3756763585,1672561003,1672561241,238
9850,3806034626,3703737650,1672695390,1672698575,3185
10665,3780013266,3272827860,1672698075,1672700018,1943
10636,3518205307,3229570647,1672657542,1672658522,980
11456,3520189871,3915460293,1672650944,1672652157,1213
10001,3517377614,3511750850,1672540129,1672543534,3405
11611,3715106566,3663902064,1672607693,1672608748,1055
10599,3519356606,3515284733,1672569532,1672570687,1155
10014,3770019143,3408111327,1672656413,1672658778,2365
11339,3772489471,3912625932,1672555201,1672555920,719
10871,3515597467,3510240661,1672539524,1672543122,3598
11417,3774447975,3772877723,1672590135,1672591550,1415
10845,3783594246,3971996397,1672573270,1672574666,1396
11063,3511640720,3289771213,1672586721,1672589675,2954
10950,3772296376,3735152111,1672617820,1672620624,2804
10394,3279851026,3770709417,1672553901,1672556756,2855
10219,3716492409,3348100657,1672613512,1672616272,2760
10209,3534284132,3279726491,1672655321,1672655903,582
10173,3778842400,3416079461,1672532426,1672532710,284
10207,3505720915,3510153173,1672699915,1672701421,1506
10133,3888057649,3240877710,1672546097,1672548822,2725
11453,3622729771,3812261241,1672639503,1672639768,265
11149,3772877723,3470135167,1672610677,1672612796,2119
10153,3233712975,3512072679,1672635135,1672635963,828
11671,3512343029,3715320359,1672597884,1672599704,1820
9990,3710865678,3305656670,1672568832,1672569755,923
10979,3665603628,3500928990,1672686651,1672690172,3521
11294,3332840671,3519322066,1672546938,1672548978,2040
10192,3509431396,3330238204,1672543330,1672546567,3237
10006,3757796416,3774401596,1672652794,1672656000,3206
9843,3777932581,3792267993,1672531317,1672533542,2225
11380,3534531039,3716669659,1672653079,1672654286,1207
10726,3533325993,3711889178,1672552146,1672554991,2845
9999,3687183789,3238056215,1672538125,1672540138,2013
10714,3904184638,3817038422,1672701352,1672702236,884
10390,3410788026,3927202773,1672540536,1672542452,1916
10498,3418683594,3701919083,1672590094,1672592431,2337
11289,3511663572,3236886943,1672535772,1672536145,373
10173,3514576083,3780900318,1672599930,1672600912,982
11104,3285201542,3311626308,1672679929,1672682456,2527
11402,3770533588,3482639402,1672700478,1672702409,1931
10673,3716468783,3364286028,1672602757,1672603974,1217
10450,3533960602,3301431129,1672574450,1672577973,3523
11097,3319529422,3770480149,1672686075,1672686535,460
9885,3793407883,3837271330,1672550906,1672553538,2632
9996,3487395357,3533867833,1672548910,1672550711,1801
11785,3509355477,3772966919,1672652510,1672652874,364
11438,3209925780,3236886943,1672559922,1672560016,94
11386,3825234433,3624307518,1672583782,1672583998,216
11266,3516969689,3628556590,1672679428,1672680038,610
10296,3229890340,3513661302,1672559790,1672561972,2182
10488,3444295435,3228997424,1672634095,1672636320,2225
11630,3302988745,3385124073,1672544569,1672545893,1324
10231,3610517436,3780626668,1672582107,1672583532,1425
10518,3241855333,3512697456,1672565614,1672566053,439
11187,3780500764,3783373085,1672627129,1672629961,2832
11691,3511476353,3355430975,1672666921,1672669062,2141
11149,3376842515,3226761201,1672589136,1672591655,2519
11059,3393376416,3711959141,1672579944,1672580249,305
10598,3777060250,3440305508,1672632881,1672635143,2262
9949,3757728121,3792289287,1672591849,1672594269,2420
11535,3491948594,3632189887,1672616871,1672618269,1398
10263,3517552930,3520697518,1672542888,1672544950,2062
11532,3711810752,3826418889,1672538191,1672539410,1219
11395,3791072829,3501225887,1672576698,1672578019,1321
10656,3466149998,3224053074,1672583923,1672584012,89
10808,3364067937,3500776597,1672577459,1672580617,3158
10924,3378534521,3929446196,1672561109,1672561921,812
11097,3927699036,3760554453,1672584118,1672586110,1992
10436,3791332226,3793081195,1672603417,1672606318,2901
11019,3733123020,3501619113,1672599956,1672600441,485
10438,3512638952,3778741325,1672649021,1672650613,1592
10451,3452677710,3805831563,1672613518,1672616381,2863
10649,3908177413,3505392452,1672589234,1672591198,1964
11632,3505500665,3881012415,1672619965,1672621706,1741
10387,3619796619,3814289471,1672531895,1672534451,2556
11362,3637105495,3921736061,1672581195,1672582253,1058
11441,3824259677,3617771673,1672569460,1672570463,1003
10508,3757064623,3355903597,1672561255,1672561508,253
10601,3233712975,3925792265,1672641086,1672642744,1658
11257,3519108639,3895944547,1672661146,1672663677,2531
11361,3713514933,3404187438,1672667367,1672667735,368
11428,3809216145,3440770466,1672626265,1672626921,656
11776,3512555384,3249614888,1672559374,1672561692,2318
9980,3397783490,3501137133,1672571597,1672573690,2093
11790,3774965463,3435159896,1672647186,1672650410,3224
11263,3912811715,3609997804,1672583122,1672584747,1625
11723,3777041132,3357026115,1672619231,1672622575,3344
11450,3774965463,3757851680,1672601444,1672602421,977
11516,3511645260,3737738751,1672589688,1672591676,1988
10075,3893527651,3500720752,1672670259,1672672443,2184
10416,3293553295,3520470646,1672605645,1672607519,1874
10428,3520473111,3791332226,1672575712,1672577246,1534
11744,3231654754,3434052463,1672571275,1672574783,3508
10545,3714516404,3500473064,1672546032,1672548376,2344
11529,3760679372,3739395381,1672577361,1672577453,92
11293,3553229537,3512477276,1672583554,1672586773,3219
11484,3755154460,3932919664,1672681922,1672684058,2136
10590,3930475498,3635433296,1672572503,1672572894,391
11025,3681737865,3894328297,1672587328,1672590512,3184
11106,3681504869,3755924094,1672564777,1672566701,1924
10944,3975796415,3783238023,1672697774,1672698835,1061
10670,3350169064,3454151554,1672535344,1672536890,1546
11037,3713636175,3899205452,1672600255,1672600948,693
10630,3887382548,3714645218,1672587169,1672587419,250
10195,3701668745,3405200303,1672639390,1672639501,111
10788,3856699097,3774682234,1672572703,1672575075,2372
10900,3476308535,3971447562,1672641262,1672642579,1317
10276,3779174993,3793902476,1672680101,1672683494,3393
10460,3505496725,3932566114,1672691291,1672693066,1775
11653,3773697080,3534459983,1672697110,1672698821,1711
10188,3682802569,3516706935,1672674017,1672677142,3125
10532,3783942518,3933562725,1672626207,1672627205,998
11192,3411213032,3757713457,1672684125,1672687608,3483
10826,3770972037,3511382748,1672541170,1672543804,2634
10422,3509208005,3284407073,1672628460,1672631395,2935
9814,3500741534,3512769522,1672670992,1672673929,2937
10985,3477511446,3776068937,1672604104,1672607303,3199
10789,3802374620,3512826895,1672627933,1672631087,3154
9926,3770276815,3516867729,1672685994,1672686661,667
10234,3517810375,3231227362,1672535750,1672536215,465
10882,3757032266,3304227085,1672645020,1672645730,710
11028,3780511388,3701685828,1672576238,1672577092,854
11229,3668063289,3716982179,1672682330,1672682422,92
11636,3713878219,3378172464,1672676980,1672678327,1347
11391,3779468781,3701493094,1672557768,1672560435,2667
11528,3469370398,3240443426,1672657832,1672660629,2797
10069,3229570647,3520057139,1672659412,1672661145,1733
11735,3701925712,3772509599,1672646366,1672648304,1938
10649,3732871856,3777937949,1672591418,1672591509,91
11032,3778741325,3773688906,1672645122,1672647979,2857
10799,3270502801,3533265491,1672541933,1672544648,2715
10072,3316117186,3505684690,1672581415,1672582163,748
9938,3513140146,3429047448,1672619063,1672620517,1454
9979,3715441786,3925208102,1672623079,1672626358,3279
10232,3757523596,3513092056,1672550644,1672551659,1015
11419,3912181197,3510819040,1672671682,1672672281,599
10488,3772659062,3496591885,1672596177,1672598868,2691
11521,3500015630,3510189563,1672622144,1672625643,3499
11147,3287403291,3509208005,1672701212,1672704070,2858
10191,3390537737,3303747093,1672665485,1672668612,3127
10589,3783060739,3378729459,1672548319,1672550808,2489
11534,3756119976,3834949242,1672659763,1672660734,971
10881,3773714494,3779930476,1672642484,1672645821,3337
10483,3685083275,3617771673,1672573352,1672573484,132
11091,3779212271,3716020849,1672590324,1672591589,1265
10053,3281935691,3913746581,1672703589,1672704145,556
10926,3515047288,3248409083,1672624325,1672627536,3211
10244,3905889514,3760397450,1672655839,1672658792,2953
10889,3317887374,3309178914,1672563778,1672564247,469
10289,3242149533,3636877469,1672613948,1672615519,1571
10742,3422081502,3304030474,1672667953,1672668844,891
10787,3519513219,3534775239,1672531977,1672533177,1200
11201,3351856699,3505593034,1672606853,1672607277,424
11021,3271762055,3206926634,1672647001,1672648534,1533
9876,3394394262,3270502801,1672595850,1672597052,1202
10172,3783679478,3505119470,1672589800,1672592028,2228
11733,3221126799,3446066492,1672617221,1672620757,3536
11264,3791194984,3382308738,1672670617,1672673485,2868
11599,3319660530,3220660616,1672679587,1672680398,811
11189,3520725149,3515047288,1672620296,1672622180,1884
11509,3714283424,3364286028,1672702407,1672705498,3091
10522,3509508477,3287734830,1672546245,1672549590,3345
10078,3533419409,3533628528,1672612356,1672615697,3341
11656,3400025324,3882905311,1672684249,1672687023,2774
10609,3855222429,3430399931,1672598051,1672600575,2524
11599,3666655293,3341129425,1672560509,1672562182,1673
10551,3908878965,3224053840,1672657927,1672659499,1572
10108,3774939922,3701065296,1672568846,1672571894,3048
11762,3201573194,3778927933,1672669523,1672670139,616
10106,3458753033,3463883997,1672615568,1672618716,3148
10431,3703725221,3638823001,1672533013,1672535499,2486
11253,3601214648,3450621820,1672551902,1672552560,658
11597,3777074709,3311037445,1672628302,1672630891,2589
10607,3715140418,3793442891,1672613194,1672614895,1701
10984,3778909412,3715490209,1672636592,1672637540,948
10408,3553640169,3716647407,1672634115,1672635569,1454
11011,3463892928,3772019557,1672690437,1672694020,3583
10811,3703737650,3376842515,1672615254,1672617070,1816
11461,3559759778,3344710271,1672532319,1672532768,449
10947,3512417724,3501573548,1672672560,1672672738,178
11614,3231271498,3703614781,1672580465,1672581326,861
10757,3301765144,3713191326,1672535401,1672536836,1435
10770,3778842400,3342545285,1672684305,1672685116,811
11079,3436774112,3316537706,1672543919,1672545620,1701
11582,3558349840,3510819040,1672595645,1672595931,286
10924,3487622510,3800434325,1672618384,1672620865,2481
11326,3663902064,3500927619,1672563469,1672564957,1488
10648,3476308535,3501261089,1672662134,1672662611,477
10265,3554437212,3273537848,1672703081,1672703191,110
10749,3418382025,3517816581,1672607274,1672610364,3090
10553,3534374523,3419378107,1672630438,1672632849,2411
11365,3497138014,3520779124,1672619660,1672620817,1157
10369,3661543201,3733423371,1672610195,1672612395,2200
10795,3330799389,3703611876,1672536799,1672539843,3044
10954,3927365255,3318590083,1672543035,1672546032,2997
10793,3496579251,3851877325,1672633275,1672633660,385
10586,3306066522,3755465396,1672579515,1672580003,488
11615,3509394912,3611939581,1672693989,1672696098,2109
10942,3605078841,3515753241,1672650941,1672651522,581
10522,3687024828,3519357822,1672578962,1672582523,3561
11130,3736885568,3916673751,1672532074,1672533770,1696
11321,3714179543,3358434853,1672615340,1672617338,1998
11230,3927805949,3773408491,1672637176,1672637818,642
10681,3369270860,3736010012,1672693372,1672694675,1303
11509,3307791650,3500438542,1672590811,1672591103,292
10967,3478915403,3480259863,1672701762,1672703939,2177
10994,3603452936,3903065952,1672695909,1672696585,676
10355,3517325365,3803382101,1672680297,1672681326,1029
10618,3476144563,3711518637,1672607386,1672608832,1446
11267,3238796398,3779169946,1672549338,1672549992,654
9865,3500062408,3783942518,1672667580,1672670100,2520
9909,3884388188,3857909328,1672661453,1672663108,1655
10868,3760144712,3774606418,1672696820,1672700375,3555
10723,3791434207,3400793223,1672625777,1672627991,2214
10995,3402338011,3605101443,1672685742,1672687909,2167
11151,3736987749,3513890046,1672670095,1672673020,2925
11068,3778605154,3241567995,1672681224,1672684715,3491
10562,3501205057,3736010012,1672643620,1672645312,1692
10280,3779815753,3246567963,1672564792,1672565868,1076
11332,3809871495,3777499535,1672645533,1672648316,2783
11599,3817376705,3505825767,1672592027,1672595402,3375
10494,3791108593,3247075753,1672638558,1672641074,2516
11087,3921736061,3514455363,1672549631,1672550114,483
9950,3756948477,3730226545,1672583502,1672586159,2657
10848,3486509752,3803996569,1672595264,1672595899,635
10373,3500544306,3716676869,1672532855,1672533361,506
11661,3500405175,3636877469,1672668970,1672672165,3195
9912,3342368576,3275274182,1672615683,1672616430,747
11598,3783809405,3780467276,1672623936,1672626325,2389
11633,3311989687,3505697295,1672678387,1672681727,3340
11684,3778479297,3776279305,1672691569,1672692915,1346
10115,3534111498,3514980025,1672611615,1672612451,836
10615,3772966919,3773768643,1672657070,1672657542,472
11247,3447948483,3834311054,1672587738,1672588695,957
11224,3501356814,3606688595,1672557660,1672559291,1631
9992,3520470646,3680988889,1672649296,1672650796,1500
10364,3415228763,3288346356,1672652282,1672655710,3428
10292,3713694278,3826418889,1672590479,1672591204,725
10988,3512638952,3447696555,1672651051,1672653789,2738
10864,3791688526,3505560793,1672603543,1672605149,1606
10395,3783060739,3513661302,1672670294,1672673459,3165
9826,3311529105,3512492332,1672580167,1672582793,2626
10567,3513894659,3755570137,1672634480,1672636401,1921
10511,3770424892,3804840997,1672658207,1672660290,2083
11168,3440401725,3736621212,1672664828,1672664933,105
10641,3755465396,3714283424,1672650090,1672653456,3366
11672,3511750695,3620105539,1672669701,1672673139,3438
9972,3517992521,3792597493,1672700415,1672701392,977
10749,3394364348,3512337054,1672597767,1672598175,408
10086,3772188086,3777112124,1672638506,1672640634,2128
11071,3714179543,3835262447,1672655036,1672655711,675
11203,3791628195,3227919286,1672583589,1672583818,229
11432,3711938229,3919814073,1672619202,1672619733,531
10025,3520182275,3755570137,1672605777,1672608194,2417
10382,3755729826,3888642876,1672586203,1672588059,1856
11497,3399173821,3757523596,1672679643,1672681433,1790
10640,3231859576,3511289729,1672654166,1672655114,948
10922,3304697982,3809216145,1672703092,1672706547,3455
10350,3715490209,3534081527,1672693942,1672695317,1375
10981,3773017746,3791074200,1672682701,1672685404,2703
11654,3440671139,3511640720,1672551860,1672552151,291
11265,3520473111,3517426473,1672595775,1672596851,1076
11353,3772609551,3774589551,1672607003,1672607894,891
10434,3394959062,3400025324,1672604532,1672604974,442
11637,3710060386,3716371766,1672688986,1672690608,1622
9901,3474097405,3710107905,1672638252,1672640160,1908
10238,3780048608,3773953689,1672554948,1672555037,89
10137,3223144610,3313579674,1672547473,1672550349,2876
10259,3520049965,3443521234,1672561788,1672564596,2808
10042,3533265491,3638018906,1672582960,1672583239,279
11708,3500671218,3361952532,1672575127,1672575381,254
10333,3756616853,3450679913,1672627953,1672628755,802
11555,3615742989,3770180844,1672609126,1672611926,2800
10422,3487395357,3500429731,1672619925,1672622309,2384
10751,3515047288,3509508477,1672622814,1672624120,1306
10945,3884191432,3624307518,1672551916,1672555397,3481
11359,3510535683,3511864772,1672598904,1672599941,1037
11163,3777686966,3512857020,1672566994,1672568363,1369
11774,3804840997,3345896913,1672597905,1672601462,3557
10156,3824657614,3735152111,1672677951,1672678625,674
11730,3660980656,3452090950,1672538384,1672541630,3246
10732,3278443807,3510680251,1672654287,1672656921,2634
10507,3311805161,3468066881,1672696723,1672698844,2121
10423,3793003432,3533976217,1672623461,1672625971,2510
10091,3779835734,3772569860,1672595761,1672598153,2392
9952,3618024815,3639081201,1672693811,1672694418,607
9925,3780626668,3924205112,1672630106,1672632894,2788
11283,3229615214,3908883591,1672575883,1672578983,3100
10236,3710695372,3439532406,1672596728,1672598129,1401
11369,3813986705,3534328311,1672652458,1672656001,3543
11243,3711287751,3505066871,1672554388,1672556053,1665
10518,3703462221,3927504954,1672532475,1672532961,486
10521,3500864577,3516965624,1672688266,1672691049,2783
11513,3382696725,3500591274,1672561815,1672564481,2666
10413,3332840671,3501977123,1672639537,1672641114,1577
11345,3783408469,3342252701,1672577269,1672577449,180
10913,3780482864,3792824886,1672616592,1672617511,919
9999,3912915644,3928508375,1672599206,1672601202,1996
11468,3511640720,3517558635,1672534775,1672535023,248
10237,3313282478,3755075988,1672545655,1672547067,1412
10474,3701534043,3739387948,1672688171,1672689769,1598
10026,3810818108,3511640720,1672676932,1672677671,739
11487,3755411110,3623953446,1672657229,1672659842,2613
10658,3887030182,3245121919,1672565277,1672566635,1358
11514,3805718871,3447312353,1672532445,1672535459,3014
10003,3780500764,3811419378,1672541140,1672543055,1915
10447,3770391782,3311409212,1672546091,1672548388,2297
11508,3755209597,3713416106,1672629444,1672630802,1358
11227,3832312129,3713159131,1672547553,1672548669,1116
11591,3340897079,3701385831,1672693648,1672694343,695
11141,3714903456,3830599959,1672588302,1672589552,1250
11034,3908331271,3930727474,1672573406,1672574200,794
10451,3713107380,3505720915,1672667985,1672668599,614
10067,3780612543,3734957248,1672603743,1672606847,3104
11314,3515597467,3433196933,1672626628,1672629969,3341
11643,3203630241,3516153301,1672639777,1672642945,3168
10977,3772320856,3778124514,1672656431,1672658409,1978
11515,3792475476,3855629383,1672569668,1672570837,1169
11243,3311449914,3772227820,1672619319,1672621913,2594
11389,3492350318,3384170206,1672654039,1672654262,223
10542,3716647407,3756843139,1672655948,1672656164,216
11189,3509317054,3519108639,1672674899,1672678207,3308
9819,3703722212,3515715968,1672610157,1672611530,1373
11593,3307236682,3780942505,1672602936,1672603209,273
11474,3276231633,3885422379,1672674414,1672676259,1845
11504,3505490878,3888409038,1672619621,1672620913,1292
11496,3635599307,3703476890,1672539081,1672541648,2567
10884,3804075198,3366961580,1672697405,1672699904,2499
10009,3489212992,3977666815,1672619209,1672619731,522
10204,3902292032,3505538902,1672559325,1672561762,2437
10045,3437023385,3358530225,1672572443,1672572578,135
10813,3756740153,3220987526,1672543355,1672546463,3108
9879,3240877710,3714897456,1672680089,1672682750,2661
11127,3812756400,3510856388,1672531710,1672533804,2094
11023,3416079461,3393001196,1672620976,1672621638,662
10994,3558203963,3248061684,1672587271,1672588815,1544
11297,3668681400,3710891331,1672702463,1672702681,218
11534,3510894809,3760537855,1672683185,1672685865,2680
11009,3711671702,3703896751,1672678385,1672681293,2908
11775,3513563152,3701028092,1672613425,1672613509,84
10824,3703611876,3440582836,1672547969,1672548372,403
11303,3665478011,3701779683,1672677947,1672681547,3600
11338,3274239253,3501548163,1672549199,1672550295,1096
11223,3510111365,3505266343,1672656193,1672656397,204
10215,3714142299,3756890980,1672534606,1672538089,3483
11660,3500062408,3791584994,1672681629,1672681940,311
10073,3777715675,3246395239,1672685880,1672688277,2397
10779,3774436159,3533077580,1672683133,1672685672,2539
10776,3423147369,3205687719,1672676154,1672678752,2598
10618,3534206917,3916955566,1672576271,1672578042,1771
11655,3442181067,3884934977,1672625043,1672626146,1103
10763,3505786561,3500049870,1672534591,1672537185,2594
11718,3755924094,3760481622,1672635757,1672637868,2111
10897,3808849597,3558349840,1672676280,1672677705,1425
11763,3770924034,3359929534,1672599347,1672602051,2704
10897,3713969196,3338115824,1672689747,1672691618,1871
10398,3776182849,3505155858,1672627726,1672628358,632
10035,3520515739,3424476995,1672635485,1672638277,2792
10718,3855222429,3505234868,1672670895,1672671454,559
11788,3518157683,3406169279,1672653999,1672656472,2473
11385,3398483531,3491250381,1672618820,1672621073,2253
10518,3516777819,3668202976,1672664316,1672665685,1369
10365,3500922040,3509556649,1672677879,1672681064,3185
10730,3773895671,3703031637,1672610536,1672611182,646
11343,3516572212,3716976932,1672636450,1672639552,3102
11269,3931767736,3511415786,1672692052,1672694442,2390
10520,3353326305,3445733121,1672566084,1672567563,1479
9796,3666655293,3316406470,1672693951,1672697028,3077
11421,3792255406,3465227623,1672632691,1672633436,745
10230,3773738817,3684651755,1672635785,1672637531,1746
10905,3285322570,3791205793,1672576622,1672579876,3254
11468,3791351852,3487779363,1672670802,1672673816,3014
11384,3716178116,3627081426,1672669073,1672672264,3191
10529,3613828705,3500928990,1672564835,1672566623,1788
10675,3245642576,3509663119,1672656901,1672657787,886
10090,3617135064,3485468650,1672595786,1672598614,2828
11028,3438470128,3919258737,1672683821,1672686591,2770
10819,3827981800,3776593726,1672638818,1672641242,2424
10101,3341311972,3458130310,1672585411,1672585793,382
11332,3703168159,3667654673,1672604962,1672607879,2917
10168,3512700007,3516867729,1672543236,1672544865,1629
9972,3501873139,3515764058,1672549079,1672549833,754
10046,3519357822,3447696555,1672627381,1672627616,235
11619,3666655293,3285201542,1672623799,1672625508,1709
11752,3791796190,3227956115,1672589124,1672591743,2619
10044,3481700413,3851451801,1672542844,1672546325,3481
10426,3713514933,3755767856,1672571823,1672575260,3437
10954,3685522474,3662495290,1672554208,1672557630,3422
11492,3517552930,3716647407,1672600398,1672603247,2849
11622,3773083407,3824657614,1672604555,1672606496,1941
10185,3939851140,3514327931,1672692964,1672694989,2025
10012,3450735824,3384151770,1672703012,1672706081,3069
11322,3462985379,3837378340,1672673110,1672675304,2194
10157,3776053084,3818532143,1672643394,1672645447,2053
10394,3372079985,3773017746,1672619689,1672622331,2642
10747,3662507634,3505853594,1672558992,1672561119,2127
10678,3902292032,3711755596,1672649641,1672652222,2581
11257,3820422111,3505175620,1672590664,1672593584,2920
11478,3738103378,3473520701,1672633219,1672634696,1477
10341,3912181197,3496591885,1672555048,1672555188,140
10543,3552309108,3517227599,1672532889,1672534027,1138
10198,3934070285,3756784813,1672696535,1672698584,2049
11415,3668154066,3505472087,1672551492,1672553359,1867
9795,3429315500,3492064037,1672546136,1672546478,342
11453,3377883705,3880788853,1672649948,1672650640,692
10064,3402338011,3367121615,1672650881,1672651978,1097
11668,3519908593,3755922811,1672684986,1672686472,1486
10508,3204149913,3505624416,1672679124,1672681684,2560
11706,3449672240,3733915784,1672691729,1672693830,2101
11784,3755570137,3517380144,1672665376,1672667617,2241
11783,3792107875,3770408300,1672571114,1672573239,2125
9800,3533841983,3513764665,1672558430,1672559418,988
11010,3710397477,3534174363,1672634030,1672635378,1348
10423,3557528150,3601214648,1672688259,1672689441,1182
10001,3826542169,3780074082,1672546009,1672546289,280
10632,3505887814,3756763585,1672690935,1672694102,3167
10252,3900195680,3823600319,1672694637,1672696979,2342
10992,3638035545,3501261089,1672554184,1672555081,897
9980,3517227599,3518425740,1672541292,1672544451,3159
11526,3773556853,3513740840,1672558153,1672560008,1855
11401,3334488428,3283106998,1672535919,1672536415,496
10314,3680939042,3520009158,1672635967,1672639009,3042
11744,3890813040,3294326116,1672545539,1672547959,2420
11466,3515259326,3467232654,1672669734,1672671885,2151
11106,3757311529,3514541800,1672643981,1672646813,2832
11766,3777992576,3287689454,1672693012,1672695365,2353
10028,3400560073,3809860102,1672552102,1672553349,1247
11110,3347996015,3514628916,1672556912,1672557213,301
9860,3337673625,3233712975,1672596839,1672599248,2409
10437,3442181067,3355899481,1672666625,1672667106,481
11338,3550887623,3336501403,1672548791,1672550528,1737
10251,3619538249,3519448648,1672701554,1672701878,324
10124,3311569360,3738429905,1672605281,1672608240,2959
9934,3600302127,3472774606,1672650091,1672650658,567
10995,3204473480,3711671702,1672618587,1672619948,1361
10699,3534372899,3680075399,1672677891,1672680993,3102
9840,3511907179,3714640103,1672633783,1672636786,3003
9950,3777118499,3516486526,1672669764,1672672078,2314
11152,3779778679,3783594729,1672682932,1672685290,2358
9870,3701387745,3783238023,1672635038,1672637924,2886
11006,3791070926,3397330170,1672568569,1672570249,1680
11675,3227059650,3783935976,1672699519,1672700270,751
11642,3511003541,3488399075,1672698435,1672699102,667
10669,3920116284,3381055770,1672572035,1672574287,2252
11463,3757607649,3271719569,1672536456,1672536767,311
11737,3387700451,3301332095,1672642005,1672645311,3306
11388,3510882576,3406492167,1672660636,1672663748,3112
11511,3226172318,3512288503,1672586291,1672589290,2999
11617,3284829602,3440401725,1672644294,1672647746,3452
11612,3534667712,3890194669,1672571522,1672574782,3260
9877,3516472352,3971422524,1672617929,1672620203,2274
11357,3419789418,3832902787,1672622804,1672625532,2728
10884,3638050763,3922786716,1672688283,1672690116,1833
11713,3756736726,3510535683,1672591773,1672594302,2529
10455,3606688595,3907225070,1672596743,1672599954,3211
10322,3437703650,3533642281,1672593432,1672593868,436
10201,3239423794,3559125467,1672571526,1672574175,2649
11111,3778706119,3882580580,1672677715,1672679461,1746
10656,3514306458,3465227623,1672584995,1672585115,120
11687,3826315540,3780466967,1672678322,1672678532,210
9956,3770172119,3432466467,1672666541,1672667128,587
10852,3791974273,3501843187,1672565548,1672567532,1984
10547,3359012188,3633622298,1672577343,1672580535,3192
10526,3792277399,3778318250,1672692224,1672695501,3277
11155,3793081195,3926065090,1672648096,1672649466,1370
11258,3343193067,3446575109,1672691847,1672692261,414
9880,3342252701,3520725149,1672658117,1672661683,3566
10115,3454151554,3514033319,1672634684,1672637037,2353
10048,3534604516,3500654356,1672669230,1672671952,2722
11245,3850181934,3510750299,1672622009,1672622893,884
11094,3714074120,3711938229,1672657451,1672658495,1044
10649,3500793739,3939851140,1672588585,1672588864,279
10492,3800434325,3516572212,1672671873,1672672061,188
10017,3736987749,3624307518,1672620053,1672621130,1077
9839,3447253775,3884458862,1672548037,1672549280,1243
11601,3732104286,3379666159,1672617543,1672618362,819
10967,3333355914,3812261241,1672619919,1672620270,351
11321,3472774606,3512203553,1672601071,1672602540,1469
11377,3427527462,3387388336,1672619874,1672621005,1131
10495,3509394912,3514776568,1672658651,1672660282,1631
9824,3711770853,3272838634,1672580546,1672581789,1243
11358,3350631472,3701453343,1672652377,1672654136,1759
11097,3783408830,3534278019,1672642745,1672646139,3394
11051,3929391979,3757198930,1672648532,1672651191,2659
10809,3398489033,3772131127,1672693269,1672694358,1089
10758,3662794240,3519494023,1672578757,1672581058,2301
11099,3770709417,3774673193,1672678090,1672681030,2940
10737,3701512498,3779340538,1672631749,1672635277,3528
10459,3403988682,3458753033,1672535985,1672539289,3304
11145,3770105006,3494560663,1672570843,1672573756,2913
9797,3773876312,3516359146,1672626000,1672627576,1576
11413,3819024145,3791269060,1672578616,1672580883,2267
10196,3686644062,3772114731,1672563667,1672564815,1148
11172,3369938668,3714690161,1672561288,1672564357,3069
10639,3689420679,3812880543,1672691924,1672692748,824
10312,3510373076,3922786716,1672620119,1672620222,103
10094,3301332095,3205687719,1672607989,1672611020,3031
10235,3516497645,3505502819,1672534268,1672536943,2675
11228,3361635547,3440305508,1672573321,1672575047,1726
11589,3350169064,3516335333,1672534831,1672536503,1672
11405,3774652449,3472718723,1672568425,1672569708,1283
9802,3315432466,3915962248,1672619210,1672622484,3274
10012,3757001552,3511245705,1672612268,1672614519,2251
11593,3710695372,3500317923,1672533375,1672533936,561
11139,3711613085,3384170206,1672583966,1672586401,2435
10836,3519924982,3733796228,1672554231,1672554793,562
11631,3338016147,3732090606,1672613578,1672614707,1129
10502,3629869834,3777290300,1672660175,1672663373,3198
11478,3780423516,3358211034,1672682735,1672685804,3069
11215,3830771832,3395505794,1672664704,1672668275,3571
10017,3919814073,3755361692,1672659869,1672660248,379
11577,3755273361,3501253130,1672695960,1672698083,2123
10872,3311449914,3371184929,1672586929,1672589902,2973
11280,3500931474,3445896667,1672665625,1672668802,3177
10152,3517469005,3554437212,1672683781,1672687271,3490
10589,3714283424,3713694278,1672661966,1672664570,2604
10722,3773434690,3453538201,1672593451,1672593835,384
10341,3703206956,3290797257,1672669970,1672672166,2196
11170,3501828287,3666655293,1672651855,1672652435,580
10533,3509663119,3377883705,1672683748,1672686641,2893
10136,3908883591,3623512088,1672667996,1672670669,2673
11429,3976742903,3358473096,1672593617,1672595618,2001
11674,3776407517,3475560058,1672602819,1672605941,3122
11138,3452090950,3230250213,1672566083,1672568863,2780
11117,3512700007,3518882056,1672540507,1672541269,762
10294,3776968640,3454151554,1672570181,1672572478,2297
11433,3905358065,3711959141,1672653975,1672656213,2238
11224,3757064623,3511078598,1672647731,1672650564,2833
9924,3367262509,3711223297,1672618888,1672621178,2290
11094,3757497708,3888903181,1672679933,1672682357,2424
10642,3510795808,3497904539,1672596512,1672596597,85
10256,3494157939,3512784888,1672646990,1672650408,3418
9989,3515259326,3701387745,1672580363,1672583241,2878
10684,3511296895,3283295213,1672651535,1672652787,1252
11115,3715419141,3668369938,1672660630,1672662226,1596
11074,3774627091,3703818358,1672666686,1672669726,3040
10795,3772893815,3716633983,1672539719,1672543287,3568
9984,3519228207,3791072829,1672673716,1672675778,2062
11463,3701284535,3519341916,1672590728,1672593670,2942
10356,3897107253,3510143850,1672636029,1672639586,3557
11463,3309651238,3933106901,1672696511,1672696785,274
10558,3703443664,3710147457,1672690607,1672692066,1459
10169,3779130507,3777672363,1672685624,1672686414,790
9955,3520016705,3755630085,1672654566,1672657251,2685
10332,3500928990,3917811545,1672623424,1672626662,3238
11438,3715106566,3812261241,1672535578,1672537720,2142
10069,3421674406,3311037445,1672641605,1672643165,1560
10748,3714806574,3400793223,1672699610,1672701228,1618
11243,3783277159,3617135064,1672538154,1672541086,2932
10891,3435159896,3419648004,1672685526,1672687468,1942
11423,3447554599,3739395381,1672605628,1672608006,2378
10430,3792633495,3895507040,1672600542,1672603826,3284
11095,3738547113,3353335252,1672573023,1672573491,468
11348,3711844574,3239990061,1672655941,1672659509,3568
10279,3505936495,3669283586,1672590041,1672590869,828
9956,3312959324,3311739926,1672586147,1672587120,973
10458,3388537708,3852014884,1672565111,1672568013,2902
10693,3501759031,3757446082,1672692145,1672693277,1132
10388,3228056289,3309528048,1672587187,1672590635,3448
11667,3711176990,3428325402,1672587142,1672588374,1232
10550,3760346746,3783727937,1672690776,1672691756,980
11477,3287821258,3668063289,1672641386,1672641855,469
11367,3777937949,3515699732,1672632270,1672635003,2733
10572,3512726649,3228033254,1672612338,1672614100,1762
11258,3711404205,3520473111,1672632860,1672633051,191
11421,3780982229,3513186622,1672672973,1672676457,3484
11629,3809871495,3715441786,1672545301,1672548436,3135
10899,3500928990,3791547827,1672580293,1672580504,211
10380,3304661369,3716233100,1672676114,1672678618,2504
11257,3337673625,3450164574,1672614133,1672616503,2370
11435,3374552204,3518408734,1672567660,1672570863,3203
10769,3533841983,3793732968,1672531388,1672531928,540
9918,3308965136,3519724388,1672681577,1672683740,2163
11164,3602680347,3284865931,1672546121,1672549188,3067
10055,3209417223,3239279744,1672531772,1672534703,2931
10864,3362127525,3500654356,1672573902,1672575244,1342
11739,3513816744,3488399075,1672604073,1672606628,2555
9870,3710487368,3420854927,1672663322,1672666830,3508
10261,3756675909,3772461583,1672630084,1672632831,2747
11433,3615245840,3716209499,1672564647,1672567764,3117
9872,3378534521,3501759031,1672532724,1672535581,2857
10477,3880637958,3618672178,1672676463,1672679469,3006
10605,3274894848,3777655401,1672550895,1672552593,1698
10269,3880549316,3367526113,1672676548,1672677876,1328
9832,3970851830,3809216145,1672682275,1672682513,238
10003,3478052226,3418382025,1672580885,1672581133,248
10887,3711836873,3311959533,1672641036,1672641345,309
9823,3938409715,3756740153,1672694322,1672695743,1421
10009,3491104534,3716676869,1672663342,1672666331,2989
10123,3822634862,3614944981,1672596004,1672597486,1482
9959,3605101443,3313282478,1672632973,1672635644,2671
11556,3519228207,3636605690,1672619521,1672620982,1461
10297,3730115019,3974264211,1672538902,1672540604,1702
11086,3274894848,3209925780,1672566765,1672567107,342
10438,3441737317,3855629383,1672605836,1672608184,2348
10862,3713969196,3772980989,1672558185,1672561594,3409
10757,3910190872,3512251592,1672652757,1672653073,316
10682,3510368377,3300238532,1672548703,1672549132,429
11088,3515984911,3461743188,1672584457,1672586645,2188
11422,3755378125,3517552930,1672610536,1672612749,2213
10387,3274223335,3791522832,1672694122,1672694831,709
11129,3484483775,3445172440,1672665456,1672668430,2974
10555,3783172505,3681737865,1672696906,1672698600,1694
10540,3400793223,3514515499,1672617757,1672620670,2913
11771,3399504157,3468343480,1672571241,1672573877,2636
10071,3776727271,3824135033,1672540140,1672541954,1814
10602,3779427180,3779282072,1672613127,1672615413,2286
11386,3450621820,3227498870,1672678370,1672681410,3040
9807,3772869013,3511382748,1672651900,1672655127,3227
10271,3221736756,3920116284,1672584077,1672586233,2156
11571,3757869138,3318250647,1672676471,1672679264,2793
11034,3319436533,3429333292,1672664098,1672665276,1178
11455,3500105301,3935333166,1672615587,1672618983,3396
11157,3509317054,3770497768,1672667837,1672669505,1668
10076,3778702093,3772262649,1672688406,1672689016,610
11363,3338195686,3810818108,1672539682,1672541053,1371
11721,3517045396,3711430738,1672653184,1672654674,1490
11109,3779169946,3388830370,1672551377,1672554879,3502
10386,3331228758,3701453343,1672531265,1672533485,2220
11706,3555763674,3311260898,1672605690,1672607005,1315
10102,3342495377,3713807459,1672680230,1672683183,2953
10733,3509208005,3755119166,1672559277,1672560697,1420
10564,3490008012,3973582279,1672588546,1672590413,1867
10664,3443191792,3418683594,1672554435,1672556335,1900
11236,3757089924,3930475498,1672674869,1672677208,2339
11675,3438028077,3909457959,1672631141,1672632434,1293
11397,3755411110,3271762055,1672578440,1672580520,2080
10403,3755342153,3469780362,1672673821,1672675123,1302
11459,3714074120,3776034313,1672679584,1672681158,1574
11600,3791236983,3811354125,1672585915,1672586559,644
10037,3511364193,3444680955,1672639261,1672639413,152
10784,3515507526,3419378107,1672619751,1672621608,1857
10042,3817076003,3344778261,1672566119,1672566929,810
10387,3603740088,3284407073,1672665296,1672666186,890
10765,3359472956,3710919244,1672586705,1672588549,1844
10938,3612705426,3273537848,1672661111,1672664479,3368
10389,3703659324,3811419378,1672651540,1672654490,2950
10804,3701596047,3897003751,1672606754,1672607540,786
10686,3755736024,3703697059,1672558151,1672561251,3100
10740,3971282455,3511580693,1672617997,1672620477,2480
11274,3924963918,3500889287,1672557676,1672560878,3202
10631,3770972037,3773041843,1672669091,1672670787,1696
10700,3520473111,3624307518,1672637889,1672640465,2576
11410,3772882440,3475560058,1672600400,1672602717,2317
10070,3533777032,3403150349,1672542217,1672544784,2567
11311,3393955069,3311264420,1672589601,1672590929,1328
11608,3701971784,3837271330,1672679776,1672680504,728
11089,3398483531,3415562576,1672639667,1672641036,1369
11324,3609166109,3500863429,1672540095,1672541147,1052
11083,3489205994,3347205332,1672651471,1672653406,1935
11027,3286938590,3730600658,1672595774,1672598215,2441
11014,3624307518,3505811269,1672607514,1672607581,67
10087,3501192566,3933872044,1672548026,1672551447,3421
10990,3443521234,3780173788,1672657004,1672657591,587
10421,3293579860,3455430943,1672664579,1672667707,3128
10835,3755175497,3909067335,1672556955,1672560301,3346
10955,3533859712,3777498160,1672615578,1672617716,2138
10296,3776583229,3733953055,1672578308,1672578725,417
11458,3827889533,3505173665,1672646420,1672648641,2221
10560,3715419141,3809207482,1672544299,1672544626,327
10427,3780956975,3818532143,1672559254,1672560628,1374
10053,3295710494,3240443426,1672570257,1672572082,1825
10626,3756642173,3310021925,1672675004,1672676688,1684
11353,3689223632,3780048608,1672573113,1672576344,3231
11769,3685396470,3518088154,1672619738,1672620827,1089
10373,3240877710,3780786276,1672606344,1672609890,3546
9809,3516969689,3734957248,1672646262,1672649060,2798
10198,3505164060,3715126587,1672575607,1672578803,3196
11269,3513629502,3783043346,1672600772,1672602722,1950
10557,3490008012,3414510793,1672654222,1672655253,1031
10522,3757639274,3510864325,1672659868,1672662542,2674
10761,3313282478,3435159896,1672599214,1672599934,720
10489,3491250381,3756113624,1672605500,1672606917,1417
10134,3732440502,3779413388,1672702707,1672705379,2672
10790,3534102440,3760397450,1672702230,1672703492,1262
10028,3732871856,3760687922,1672618173,1672621628,3455
11093,3713219299,3688130094,1672566021,1672566156,135
10936,3534531039,3442096275,1672588892,1672589491,599
11015,3378430760,3499142934,1672632090,1672635660,3570
9910,3772131127,3931917809,1672616704,1672618425,1721
10613,3306475287,3818570577,1672606373,1672609205,2832
11744,3480405740,3445406685,1672666132,1672666732,600
9864,3809194824,3711770773,1672536067,1672537701,1634
10457,3357097510,3633294415,1672648702,1672652279,3577
9917,3478052226,3925792265,1672583648,1672586675,3027
11197,3403218814,3714179543,1672669585,1672672238,2653
10653,3760749218,3825153408,1672551076,1672553953,2877
10611,3791074200,3517718901,1672699435,1672699909,474
10660,3357026115,3807717766,1672658529,1672660862,2333
11246,3278805844,3231271498,1672658000,1672660658,2658
11718,3555763674,3511198566,1672621260,1672622695,1435
10739,3608973523,3246296769,1672697080,1672699821,2741
10377,3284374600,3242082716,1672636074,1672638320,2246
11258,3384151770,3667072319,1672628914,1672631636,2722
10103,3311626308,3514327931,1672654136,1672657176,3040
11007,3686211958,3511003541,1672645351,1672647416,2065
10297,3367262509,3713374884,1672642833,1672644121,1288
11778,3777672363,3519174861,1672675346,1672678229,2883
11652,3519351747,3774673193,1672699723,1672699998,275
11150,3493047640,3343511947,1672611995,1672614412,2417
10183,3713336088,3777204977,1672547727,1672549462,1735
11442,3337903727,3311904032,1672559298,1672562308,3010
11137,3710260848,3356972733,1672685320,1672687208,1888
9964,3682802569,3732871856,1672673779,1672676157,2378
10082,3710316008,3206926634,1672637586,1672641081,3495
11524,3710173412,3512087090,1672541556,1672544293,2737
10081,3737738751,3480270940,1672537195,1672539263,2068
11468,3208894215,3407403080,1672670507,1672671563,1056
10988,3792682835,3760554453,1672564807,1672565907,1100
10529,3821082558,3793699467,1672587164,1672589804,2640
11586,3415032547,3824259677,1672684202,1672685911,1709
10655,3757604311,3736203662,1672583112,1672584148,1036
10332,3776187150,3770544738,1672624251,1672626511,2260
10626,3732467455,3688410383,1672591067,1672594371,3304
10048,3391612879,3519034304,1672563325,1672566057,2732
10876,3455955489,3520339198,1672605012,1672605228,216
11214,3791688526,3499142934,1672678574,1672681080,2506
10704,3701529552,3405303958,1672685687,1672688659,2972
10431,3852310652,3553229537,1672639984,1672641719,1735
10584,3491239350,3500741005,1672670667,1672670971,304
11305,3779478448,3223512565,1672601424,1672603693,2269
10798,3773083407,3510373076,1672543389,1672545149,1760
10546,3332124606,3360949039,1672594732,1672597462,2730
10072,3711176990,3770595035,1672617857,1672619324,1467
10135,3272096922,3514306458,1672683651,1672685334,1683
10566,3500555856,3306037126,1672617809,1672620641,2832
10702,3304235700,3403738461,1672694342,1672696023,1681
11664,3760080378,3519065870,1672539418,1672540810,1392
11287,3510939082,3756759239,1672692701,1672694319,1618
11299,3342027511,3277061226,1672647856,1672650128,2272
10350,3806471413,3830962592,1672543163,1672544536,1373
10420,3755736024,3793029132,1672601068,1672604094,3026
10097,3605760561,3505908965,1672639047,1672640532,1485
10022,3906874577,3370401047,1672585289,1672586551,1262
10933,3737745988,3710487368,1672695354,1672696026,672
11177,3716160006,3978417055,1672649453,1672652056,2603
11057,3779503296,3512965991,1672673773,1672674260,487
11743,3311904032,3473706746,1672650112,1672652740,2628
10439,3357097510,3394976623,1672633665,1672634016,351
11494,3516444589,3285136057,1672621848,1672623234,1386
10206,3884933821,3419648004,1672583635,1672584486,851
11505,3534624672,3832902787,1672586897,1672587311,414
10812,3393001196,3345896913,1672565050,1672566292,1242
9952,3716341323,3928421417,1672682032,1672682499,467
11512,3780435349,3859191694,1672616178,1672617565,1387
9858,3380418745,3916463490,1672641007,1672641105,98
10749,3390444181,3976400190,1672638135,1672640903,2768
11273,3780148144,3714142299,1672622740,1672622858,118
11090,3792455305,3774782065,1672701824,1672703219,1395
10314,3333477908,3838748301,1672694455,1672695877,1422
10030,3364067937,3755357292,1672580122,1672581249,1127
10166,3500329674,3510987684,1672604278,1672605012,734
11722,3513563152,3791236983,1672569363,1672569534,171
11132,3509167758,3441840658,1672583457,1672585804,2347
11185,3384151770,3511608609,1672625965,1672628442,2477
10768,3715622084,3701060732,1672695028,1672698413,3385
11014,3288346356,3716541851,1672616022,1672616745,723
11193,3492728794,3501548163,1672628630,1672631071,2441
11718,3513250976,3515405509,1672662391,1672663787,1396
9981,3701725839,3438204844,1672616598,1672618000,1402
11157,3774939922,3756843139,1672613023,1672616376,3353
11634,3344478603,3893932944,1672700441,1672700842,401
11259,3552309108,3501137133,1672572163,1672575513,3350
10410,3380167818,3515803462,1672545084,1672546476,1392
11163,3300238532,3519000878,1672552838,1672555399,2561
11160,3229615214,3620105539,1672543586,1672546283,2697
10265,3760385591,3516257130,1672592434,1672593947,1513
10589,3793003432,3397330170,1672644110,1672646872,2762
10929,3509431396,3770976984,1672699986,1672703006,3020
11056,3517652011,3837885956,1672638670,1672641693,3023
10639,3897003751,3500456339,1672648107,1672651140,3033
10523,3239401337,3509445318,1672541618,1672542926,1308
10778,3730226545,3620105539,1672570754,1672573939,3185
9880,3445558740,3630802959,1672535447,1672537193,1746
9897,3357074700,3715737742,1672617468,1672618077,609
9832,3295530454,3520344592,1672635310,1672637912,2602
10300,3701769970,3457249798,1672619136,1672619909,773
10859,3791547827,3355899481,1672618818,1672620321,1503
10766,3352057037,3482786946,1672623090,1672624995,1905
10814,3368079099,3701311947,1672684778,1672685172,394
10316,3379400553,3713606829,1672568810,1672569967,1157
9975,3638823001,3793902476,1672580957,1672582768,1811
10772,3533030343,3714903253,1672698618,1672702205,3587
10694,3513250976,3899970524,1672688345,1672690277,1932
10864,3297624618,3379076106,1672532074,1672534545,2471
11303,3500595432,3770972037,1672620372,1672621159,787
11613,3393955069,3500814753,1672651467,1672652102,635
10080,3516167000,3533816813,1672652496,1672653635,1139
11239,3516706935,3242082716,1672644676,1672648195,3519
11187,3516321814,3770671714,1672608097,1672608393,296
11310,3772296376,3880000841,1672534921,1672537204,2283
10803,3284334297,3439532406,1672635257,1672637134,1877
11482,3306491253,3774436159,1672615068,1672615657,589
11228,3783021859,3915035136,1672687969,1672691038,3069
10496,3290797257,3514005973,1672628674,1672629000,326
10413,3778479297,3427049290,1672553094,1672555522,2428
10175,3516965624,3714951681,1672616984,1672617185,201
10446,3379400553,3882580580,1672579118,1672580224,1106
9864,3713726267,3278805844,1672658339,1672658993,654
10549,3519260216,3205908584,1672692270,1672692485,215
10598,3371497614,3311583437,1672633204,1672636022,2818
10218,3756680289,3776468503,1672557904,1672560899,2995
10150,3792432763,3937299996,1672591579,1672592023,444
11779,3905358065,3511028193,1672543788,1672544796,1008
10398,3474879231,3505538902,1672642519,1672645437,2918
11299,3511615015,3512645289,1672573393,1672574322,929
11461,3778182724,3349475873,1672561567,1672562060,493
11572,3533340292,3520925688,1672549959,1672550601,642
10814,3776348451,3779413388,1672549793,1672551466,1673
9901,3505491969,3636877469,1672605914,1672607804,1890
10744,3423800775,3776348472,1672647274,1672648842,1568
11140,3792337863,3516034245,1672657302,1672659626,2324
11399,3374552204,3977209952,1672628601,1672631820,3219
10412,3516535558,3351856699,1672659594,1672662468,2874
9972,3714883746,3907225070,1672622173,1672622449,276
10456,3229890340,3520009158,1672561857,1672563677,1820
11494,3774450494,3755129708,1672701710,1672704439,2729
10614,3509562377,3779723939,1672656637,1672658990,2353
10543,3510143850,3733953055,1672659592,1672661329,1737
10824,3364286028,3711938229,1672624571,1672625045,474
10157,3301489209,3311331205,1672644936,1672647574,2638
11204,3294164983,3513250976,1672618633,1672618973,340
9871,3938398160,3430310785,1672547829,1672548697,868
10852,3505538902,3716183063,1672623651,1672624455,804
10081,3894756677,3772708314,1672620070,1672621052,982
10439,3514508773,3434581257,1672624646,1672624811,165
9932,3755154460,3703031637,1672531842,1672532752,910
10544,3306491253,3514638555,1672640635,1672643690,3055
11595,3510368377,3835599049,1672700041,1672700117,76
9919,3408828584,3735679000,1672561955,1672564921,2966
11424,3836757034,3411626917,1672555635,1672559057,3422
10540,3346755179,3793874490,1672591192,1672592211,1019
11780,3856552205,3757407184,1672558647,1672559172,525
10715,3357026115,3852310652,1672625759,1672626430,671
11618,3711862792,3686860179,1672593914,1672594113,199
10177,3510484107,3510987684,1672547281,1672548973,1692
10664,3311231911,3713954144,1672538255,1672540116,1861
11204,3778370462,3447948483,1672638402,1672638524,122
11417,3511382748,3398862999,1672539852,1672541471,1619
11364,3501427691,3509018337,1672599926,1672601290,1364
10005,3304447950,3367526113,1672607609,1672609699,2090
10116,3245121919,3779282072,1672588561,1672591922,3361
10337,3911431642,3887382548,1672596918,1672600371,3453
10455,3701350519,3813276198,1672697365,1672699957,2592
11606,3791542842,3756066765,1672644187,1672647233,3046
9981,3772223331,3439045964,1672651836,1672652570,734
10233,3480108752,3668681400,1672664672,1672665802,1130
10249,3730414796,3701865589,1672617555,1672617738,183
10310,3776291254,3630802959,1672580079,1672583073,2994
9816,3428788958,3639081201,1672661815,1672663342,1527
11008,3505624416,3311529105,1672618539,1672621676,3137
10723,3772708314,3517756624,1672668722,1672670542,1820
11782,3757212744,3739395381,1672616762,1672620210,3448
10064,3774221318,3406238754,1672535837,1672536837,1000
11318,3294164983,3822315407,1672620040,1672621622,1582
11517,3533620069,3415562576,1672575694,1672576101,407
10434,3783095041,3852310652,1672676147,1672679498,3351
10654,3937747312,3415032547,1672693614,1672694619,1005
10276,3238310644,3774921252,1672646584,1672647489,905
10523,3433196933,3716944983,1672647191,1672648580,1389
9880,3813085701,3779454060,1672692629,1672693483,854
10275,3936851114,3660980656,1672679978,1672681604,1626
10921,3622729771,3779340538,1672588152,1672591639,3487
10211,3402020492,3715724166,1672631925,1672632288,363
10035,3272328752,3732467455,1672687235,1672689923,2688
10202,3772262649,3701865589,1672672636,1672674637,2001
9873,3772282008,3371184929,1672567078,1672567702,624
10574,3755769731,3243651036,1672687389,1672688566,1177
11475,3318590083,3518088154,1672664418,1672666441,2023
10025,3636885498,3281935691,1672614860,1672617238,2378
10711,3341311972,3701841013,1672556027,1672559408,3381
10754,3783408469,3516497645,1672575629,1672576798,1169
10811,3919994216,3510244209,1672536178,1672537491,1313
10894,3410602007,3512417028,1672576171,1672577115,944
9873,3482786946,3812756400,1672692502,1672693063,561
11463,3505490878,3297100323,1672623806,1672624735,929
11309,3248409083,3755769731,1672570205,1672573544,3339
11270,3776600696,3471131277,1672557563,1672557890,327
10950,3821082558,3773344258,1672614766,1672616841,2075
11380,3780206849,3511864772,1672656112,1672658276,2164
10154,3821087562,3274239253,1672575918,1672578995,3077
10282,3402338011,3512768285,1672545450,1672548384,2934
10145,3461877104,3433189219,1672622559,1672625227,2668
11770,3207586072,3311159418,1672631961,1672634118,2157
10559,3924963918,3443102414,1672636593,1672639514,2921
10134,3813111107,3710783759,1672653753,1672655631,1878
11470,3714074120,3932955949,1672561653,1672562431,778
10234,3713996094,3897851509,1672594326,1672595721,1395
10913,3440582836,3935333166,1672703141,1672705056,1915
9971,3757732853,3505438826,1672566483,1672568633,2150
10265,3714919471,3533036499,1672676193,1672678682,2489
11366,3774706478,3716467469,1672585128,1672587790,2662
10740,3516517348,3385416697,1672695976,1672699058,3082
11373,3770595035,3501253130,1672537546,1672540105,2559
11022,3517552930,3774792696,1672622957,1672625963,3006
10591,3279851026,3773688906,1672614099,1672614970,871
9846,3772164469,3403120725,1672632390,1672634663,2273
11769,3703168159,3711810268,1672614874,1672616460,1586
10766,3413511621,3513586642,1672638797,1672641572,2775
10480,3447948483,3201419050,1672583744,1672587234,3490
10868,3473520701,3665478011,1672598749,1672601340,2591
11715,3792578118,3369938668,1672676149,1672678865,2716
11350,3792785261,3783408469,1672534406,1672536961,2555
10456,3925823748,3839744168,1672628519,1672631398,2879
10628,3387388336,3356972733,1672694191,1672697030,2839
11787,3371759126,3512492332,1672659841,1672660103,262
10083,3514515499,3558567160,1672700180,1672703511,3331
11562,3774450494,3354877289,1672573492,1672576538,3046
11387,3902292032,3505066871,1672532870,1672534019,1149
10215,3779689733,3501843187,1672587233,1672590534,3301
10657,3555764822,3829412384,1672549559,1672550093,534
11600,3520339198,3817478012,1672622430,1672622915,485
10810,3505234868,3812880543,1672554338,1672556752,2414
10775,3469780362,3249614888,1672556442,1672558983,2541
11173,3505665253,3791758175,1672547468,1672548365,897
10300,3772844451,3500104976,1672680887,1672683330,2443
10650,3883640904,3534284132,1672671708,1672672983,1275
10182,3915962248,3511883778,1672581629,1672583072,1443
10481,3770391782,3452104161,1672673362,1672674503,1141
11048,3373677765,3854390432,1672660289,1672662027,1738
11388,3533201269,3908331271,1672641332,1672641821,489
10092,3520395850,3783373085,1672607940,1672611089,3149
10012,3510240661,3732467455,1672612291,1672612591,300
11441,3606804618,3613216900,1672612610,1672613398,788
9908,3606688595,3776593726,1672677224,1672679229,2005
11118,3520012007,3534589501,1672551828,1672554398,2570
11594,3776053084,3757001552,1672679385,1672680886,1501
11791,3246296769,3424997707,1672641953,1672643150,1197
10590,3760679372,3511883778,1672554405,1672556033,1628
11519,3307791650,3501548163,1672558903,1672561557,2654
10292,3792719263,3514776568,1672569754,1672571783,2029
10307,3638823001,3774355339,1672696327,1672699489,3162
11716,3370512945,3518067857,1672603098,1672604346,1248
11239,3204149913,3516706935,1672658534,1672660440,1906
10554,3388537708,3505836431,1672570986,1672573075,2089
11546,3772055279,3505414878,1672605550,1672609001,3451
9825,3855440101,3780964089,1672547107,1672548650,1543
11051,3773202954,3534604516,1672561451,1672561593,142
10860,3247075753,3601214648,1672535174,1672535612,438
11727,3505500523,3351856699,1672652375,1672652657,282
11293,3605760561,3516340010,1672683795,1672684424,629
11200,3805926853,3779174993,1672610321,1672612186,1865
10099,3492064037,3422915648,1672640607,1672642254,1647
11604,3513143959,3482786946,1672573931,1672574317,386
10946,3509186338,3454924050,1672646198,1672648121,1923
10360,3780129338,3514455363,1672531722,1672535294,3572
10243,3233993993,3519886257,1672559800,1672562609,2809
10504,3777569538,3511750850,1672576778,1672577474,696
10375,3826542169,3710807030,1672629346,1672630474,1128
11414,3756168814,3660702754,1672638825,1672640142,1317
10368,3500785888,3518205307,1672644511,1672646759,2248
9812,3760776967,3511729562,1672678528,1672680403,1875
10142,3411355804,3512306195,1672643806,1672645018,1212
11689,3351728355,3716233100,1672635946,1672637932,1986
10992,3470962222,3731905251,1672541427,1672542025,598
10434,3403870769,3501828287,1672663851,1672665904,2053
10347,3910190872,3500415589,1672645510,1672648368,2858
11207,3409514897,3380444321,1672537004,1672537439,435
11176,3418367752,3516867729,1672634094,1672636208,2114
10296,3476416072,3625400710,1672575884,1672576495,611
10439,3716669659,3505853594,1672601057,1672601175,118
11586,3803473387,3810818108,1672652820,1672654196,1376
10989,3773378103,3620157388,1672648655,1672649857,1202
10682,3516319492,3738160394,1672563101,1672566640,3539
11735,3368848936,3912915644,1672578227,1672581411,3184
10731,3904045870,3760069457,1672686240,1672689798,3558
9814,3519351747,3227874229,1672590719,1672593692,2973
10632,3402774497,3757584114,1672641281,1672643558,2277
11581,3244395841,3515939841,1672630281,1672633648,3367
11517,3274739459,3713805968,1672592029,1672594284,2255
11788,3483078667,3476958001,1672675726,1672677624,1898
10865,3757796416,3755507566,1672679979,1672681049,1070
9893,3701540249,3713954144,1672679160,1672679994,834
10444,3500442370,3440305508,1672570749,1672570908,159
11072,3714268380,3501927452,1672661243,1672661450,207
10907,3711223297,3378430760,1672691533,1672693884,2351
11454,3519034304,3513740840,1672575824,1672578768,2944
11652,3500864577,3511069449,1672697766,1672700962,3196
11483,3424476995,3713858538,1672662575,1672663602,1027
10215,3822634862,3295787354,1672672018,1672675124,3106
10621,3907245259,3711065081,1672536844,1672540292,3448
10500,3533593766,3505245692,1672693853,1672697133,3280
10179,3423940256,3489205994,1672590356,1672591677,1321
10321,3907390925,3854202447,1672596909,1672597216,307
11192,3772695548,3534111498,1672674037,1672675530,1493
10380,3366801723,3684199077,1672601127,1672602183,1056
10638,3455430943,3224053840,1672691471,1672691847,376
10863,3755942724,3701065296,1672591547,1672593500,1953
10011,3516463579,3852992961,1672567543,1672570021,2478
9960,3715291931,3857847527,1672664140,1672666361,2221
10645,3471177177,3533225084,1672676612,1672678582,1970
11559,3893950585,3621439107,1672613368,1672613468,100
10706,3249771731,3533365834,1672584810,1672586696,1886
10107,3737622701,3732871856,1672663919,1672664345,426
10948,3938398160,3684651755,1672543096,1672543687,591
9867,3791206902,3276499910,1672627767,1672628675,908
9935,3500734346,3372778334,1672545316,1672547651,2335
11283,3447948483,3226761201,1672699551,1672700754,1203
10955,3732533330,3517136772,1672626903,1672627306,403
10121,3466492108,3491390365,1672657017,1672658477,1460
10583,3554236075,3385481989,1672657228,1672658048,820
11504,3778702093,3534988162,1672687176,1672689152,1976
11337,3364302157,3342056927,1672567172,1672568802,1630
10678,3905889514,3756113624,1672606565,1672609879,3314
11567,3360309868,3623953446,1672648559,1672651029,2470
11653,3311142523,3500640854,1672581306,1672581412,106
11530,3774251051,3918126468,1672563156,1672564709,1553
11257,3518335611,3715204544,1672642003,1672642424,421
10152,3710529628,3715712376,1672541480,1672542323,843
11128,3519065870,3805704844,1672686581,1672689976,3395
11115,3511458926,3500079479,1672577244,1672579520,2276
10447,3510535683,3624365837,1672629734,1672630627,893
11329,3515405509,3716445184,1672533414,1672535096,1682
11438,3416474842,3200320674,1672615953,1672616393,440
10249,3505183641,3206241691,1672605282,1672606935,1653
11459,3711119575,3287689454,1672648517,1672649664,1147
11161,3517377614,3512251592,1672638310,1672640084,1774
10553,3514244308,3312651192,1672610599,1672613006,2407
10890,3778182724,3911431642,1672670532,1672673265,2733
9878,3519951586,3203172170,1672594158,1672596963,2805
11072,3307454562,3777686966,1672562663,1672564601,1938
11003,3792107875,3516067011,1672560803,1672563545,2742
10524,3432050858,3811354125,1672603114,1672606713,3599
10781,3511289729,3780050146,1672642325,1672645322,2997
10859,3414387263,3235470567,1672653344,1672656082,2738
10901,3520273299,3972856326,1672556852,1672559763,2911
10861,3777758203,3774251051,1672548993,1672550521,1528
11619,3756685732,3778382224,1672641341,1672644211,2870
10149,3557653200,3760271237,1672625511,1672627418,1907
10217,3703999217,3307997700,1672693888,1672694544,656
10548,3399943757,3209958726,1672531782,1672534028,2246
11041,3634670780,3756413374,1672626480,1672628171,1691
9952,3468871103,3311177439,1672649520,1672652327,2807
10630,3817120976,3710223875,1672670071,1672672012,1941
10123,3714294005,3423353911,1672603805,1672607147,3342
11522,3516034245,3233965781,1672542548,1672545064,2516
10251,3779255367,3475090917,1672591673,1672593130,1457
9904,3519948471,3890813040,1672614578,1672616040,1462
11728,3435801763,3857389270,1672684366,1672687617,3251
10207,3637522163,3716389356,1672695686,1672697424,1738
11413,3516706935,3511867383,1672587925,1672589063,1138
11438,3387388336,3381244346,1672649527,1672652149,2622
11226,3809860102,3776583229,1672673138,1672674471,1333
11313,3354968884,3499820963,1672594962,1672598153,3191
11282,3500031401,3516965624,1672697838,1672698598,760
10317,3703896751,3469663062,1672648206,1672648608,402
10625,3601214648,3899903158,1672691707,1672694509,2802
10937,3826542169,3472173212,1672561683,1672565079,3396
10964,3228997424,3756157377,1672642188,1672644117,1929
11742,3827889533,3505828210,1672550228,1672550325,97
10691,3774448657,3806720019,1672560736,1672561845,1109
11573,3773523569,3501244753,1672569478,1672571577,2099
11611,3246971044,3616371564,1672684784,1672686880,2096
11306,3825877848,3406029706,1672664789,1672667317,2528
11488,3770631449,3534696810,1672673594,1672676199,2605
11011,3777149336,3703443664,1672536301,1672539124,2823
10811,3630462406,3732104286,1672535442,1672538944,3502
10620,3511245705,3304227085,1672557355,1672557886,531
10402,3757823215,3505697295,1672613043,1672616396,3353
11280,3487988841,3276209319,1672570489,1672570971,482
10596,3373018943,3501004005,1672624208,1672625495,1287
9844,3491104534,3516019206,1672612303,1672613657,1354
10318,3713434898,3287683210,1672571307,1672571468,161
11033,3514571807,3760396348,1672657908,1672659026,1118
11093,3977880564,3713416756,1672689494,1672690864,1370
11118,3760069457,3823600319,1672660562,1672662290,1728
10296,3701311947,3977880564,1672585056,1672586505,1449
10628,3490953301,3619705594,1672573806,1672574053,247
11434,3351728355,3334824744,1672552461,1672554671,2210
10089,3711767051,3417969824,1672650397,1672651553,1156
11599,3716492409,3716475340,1672661525,1672664859,3334
11234,3820922991,3300238532,1672658253,1672660372,2119
10034,3415803494,3639081201,1672546155,1672548009,1854
11074,3770709417,3703336988,1672606302,1672608514,2212
11388,3755107521,3738873928,1672635719,1672637112,1393
11028,3533726421,3520022175,1672561042,1672563931,2889
11541,3435801763,3713195480,1672626285,1672629650,3365
11698,3793978936,3533009565,1672683304,1672685469,2165
10384,3500473064,3683047199,1672537013,1672537309,296
11486,3832312129,3416225867,1672589965,1672592351,2386
10948,3793860209,3682906048,1672581125,1672581610,485
10397,3420664407,3505011956,1672666386,1672668509,2123
11116,3837435907,3827981800,1672587238,1672587390,152
9967,3639503148,3360837082,1672549074,1672551310,2236
10298,3884458862,3701041860,1672621116,1672624469,3353
10240,3318250647,3247193800,1672571522,1672574245,2723
9830,3773697080,3520506192,1672689069,1672689994,925
11103,3519730914,3377446376,1672600165,1672601216,1051
11194,3791031227,3518205307,1672575832,1672577679,1847
11652,3802757611,3668764192,1672587226,1672589293,2067
9906,3505547832,3312651192,1672541152,1672542354,1202
11762,3440770466,3972442654,1672601228,1672602308,1080
10009,3780423516,3509317054,1672644984,1672648176,3192
11183,3777758203,3622218289,1672601046,1672603183,2137
11617,3830771832,3513739060,1672533413,1672536856,3443
10085,3505845400,3701519251,1672599972,1672600229,257
11503,3247193800,3711040761,1672605719,1672606087,368
11747,3505720915,3638018906,1672542669,1672543700,1031
10593,3893043842,3413799143,1672586604,1672589773,3169
11181,3384601925,3519947298,1672544875,1672547881,3006
11444,3738132114,3319436533,1672557539,1672560295,2756
11551,3733953055,3971422524,1672561015,1672563599,2584
10068,3400112498,3393955069,1672599142,1672601001,1859
10703,3907245259,3367526113,1672580896,1672583326,2430
9980,3736036532,3812756400,1672545551,1672546624,1073
9942,3851737350,3770981604,1672565149,1672567507,2358
11587,3773411968,3933731871,1672599334,1672602090,2756
10990,3370448531,3422959249,1672663675,1672664285,610
11724,3512504247,3384151770,1672654110,1672655898,1788
11673,3427527462,3311177439,1672602312,1672602975,663
11200,3667814788,3783695231,1672571346,1672574234,2888
10378,3778125688,3825234433,1672637075,1672638762,1687
10080,3488333295,3428788958,1672601144,1672604264,3120
11163,3739618347,3445077330,1672642605,1672645073,2468
11096,3663902064,3605760561,1672572156,1672572924,768
10446,3501370430,3515970536,1672651752,1672655270,3518
10025,3484739955,3456795601,1672548869,1672551735,2866
10849,3510149298,3441336851,1672592862,1672594673,1811
10926,3638050763,3509556649,1672641179,1672642443,1264
11262,3885545415,3245774173,1672666241,1672668937,2696
10488,3206926634,3445406685,1672624361,1672625497,1136
11287,3791548838,3812261241,1672675379,1672675545,166
10477,3533976217,3274341934,1672551362,1672554326,2964
11043,3664719070,3777200549,1672697650,1672699964,2314
11050,3783043346,3457249798,1672601629,1672605197,3568
10561,3472272792,3936851114,1672549397,1672550249,852
11234,3773798215,3777304517,1672600455,1672600526,71
9798,3203630241,3429047448,1672625903,1672626465,562
11632,3821103640,3221290808,1672679724,1672682978,3254
10481,3730935770,3533974355,1672662999,1672664081,1082
10392,3242082716,3703443664,1672605169,1672607596,2427
10382,3341129425,3780287649,1672687274,1672689223,1949
11293,3756717136,3772251279,1672606238,1672608866,2628
11325,3510638085,3855977674,1672674903,1672675180,277
10982,3632303304,3714250543,1672534047,1672537577,3530
10724,3510968599,3302988745,1672687173,1672687664,491
11266,3730935770,3405435885,1672552133,1672553228,1095
10931,3514353133,3737467358,1672596180,1672597630,1450
11546,3780956975,3373851012,1672590169,1672593348,3179
10963,3520470646,3833993674,1672620605,1672623420,2815
10383,3277634944,3826997668,1672617569,1672620201,2632
10049,3739387948,3779818784,1672551522,1672555021,3499
11459,3760144712,3272096922,1672602227,1672605698,3471
10054,3772169046,3505756991,1672620753,1672623020,2267
9914,3792277399,3856601074,1672612957,1672613326,369
10708,3393909269,3755729826,1672645437,1672648114,2677
11758,3778100960,3295787354,1672582426,1672585868,3442
9942,3422314045,3511069449,1672662990,1672663924,934
10891,3397783490,3500695402,1672568961,1672571548,2587
10246,3770630937,3500011591,1672645510,1672647681,2171
9941,3711040761,3286938590,1672588110,1672588398,288
10319,3757311529,3514327931,1672612342,1672612671,329
11098,3601063076,3274894848,1672692741,1672696310,3569
9836,3701919083,3783021859,1672649977,1672651366,1389
10514,3469663062,3701971784,1672613877,1672615064,1187
10852,3500442370,3517558635,1672656649,1672659190,2541
10098,3509317776,3317989975,1672556549,1672558121,1572
10988,3515558215,3515378306,1672549820,1672552617,2797
11275,3308481706,3713923960,1672536691,1672539645,2954
10152,3465690527,3804840997,1672688060,1672688945,885
11615,3304252969,3398489033,1672634544,1672638100,3556
10467,3519297683,3669475165,1672583616,1672586475,2859
11359,3440305508,3428303756,1672620923,1672622276,1353
10628,3511078598,3778100960,1672580330,1672581500,1170
11761,3780168985,3780466967,1672685543,1672688402,2859
10250,3783172505,3791072829,1672598817,1672602141,3324
11471,3832312129,3793822639,1672666834,1672669808,2974
10416,3512072679,3779255367,1672668130,1672671648,3518
10247,3500251781,3713728777,1672579259,1672581790,2531
11085,3247545468,3755922811,1672660382,1672661379,997
10983,3920526713,3716740576,1672561838,1672564513,2675
11678,3703624327,3906693728,1672672845,1672673846,1001
9873,3816184951,3489340327,1672574514,1672575817,1303
10850,3711836873,3505839395,1672541831,1672544325,2494
10558,3449020351,3285136057,1672620330,1672621751,1421
11752,3349319959,3512596743,1672690635,1672694017,3382
10117,3356599815,3772893815,1672561196,1672564135,2939
11517,3977157565,3774090455,1672563963,1672564754,791
11420,3777992576,3783554600,1672600254,1672602821,2567
11182,3238056215,3512700007,1672624749,1672627689,2940
9954,3341432459,3514216460,1672550277,1672552277,2000
10809,3533628528,3511206717,1672657019,1672658377,1358
10436,3439532406,3710228292,1672596254,1672597135,881
11006,3713475356,3501171785,1672596096,1672598791,2695
11395,3501992314,3417969824,1672572276,1672573651,1375
11096,3307454562,3774673193,1672628863,1672632170,3307
11060,3273242177,3611298237,1672662944,1672663758,814
10001,3783594729,3663505156,1672622804,1672625715,2911
10591,3306475287,3341432459,1672638948,1672641577,2629
10018,3777135415,3220987526,1672611124,1672611489,365
10445,3791289855,3756616853,1672655273,1672657046,1773
11183,3500693568,3513840186,1672598269,1672601711,3442
11217,3278251248,3822634862,1672532482,1672532981,499
10482,3450679913,3534578428,1672643799,1672644869,1070
11290,3518205307,3201920708,1672563191,1672564666,1475
10491,3224053074,3311188620,1672679766,1672682721,2955
10650,3519924982,3852992961,1672583691,1672585893,2202
11376,3856897914,3407398464,1672592065,1672592837,772
10847,3703999217,3713219299,1672566286,1672568195,1909
10104,3511476353,3471177177,1672698502,1672701677,3175
10752,3971280379,3429333292,1672701766,1672703512,1746
11573,3973582279,3505032644,1672533063,1672535313,2250
11553,3774236212,3733243990,1672648953,1672649232,279
9826,3514698862,3624164232,1672586709,1672587181,472
10841,3509394912,3313579674,1672665641,1672666753,1112
10995,3304592684,3500543341,1672584940,1672585817,877
11073,3772609551,3792797648,1672616382,1672618818,2436
9882,3711187791,3518205307,1672670457,1672673032,2575
10615,3711770853,3520779124,1672584726,1672588172,3446
10296,3533816813,3444881567,1672683479,1672686682,3203
10684,3481365330,3613940925,1672655994,1672657597,1603
10790,3516034245,3474852115,1672541707,1672545149,3442
10144,3780467276,3245642576,1672551847,1672553997,2150
11689,3409514897,3610723722,1672650913,1672652921,2008
10011,3520725149,3510484107,1672572278,1672572833,555
10382,3480418192,3311904032,1672592000,1672593375,1375
10824,3355880028,3779723939,1672636891,1672640435,3544
11530,3207586072,3777655401,1672673467,1672674486,1019
11252,3779160052,3715101177,1672650888,1672652514,1626
11752,3932919664,3760267158,1672658387,1672661112,2725
10625,3533822490,3773554767,1672551025,1672551214,189
9858,3304252969,3792633495,1672664192,1672667033,2841
11113,3711258452,3701893620,1672650518,1672651607,1089
11431,3893527651,3271282663,1672684853,1672688148,3295
10193,3715897627,3505032644,1672548191,1672548492,301
11791,3711015176,3355880028,1672694260,1672697115,2855
11541,3733953055,3284483177,1672546386,1672549559,3173
10297,3756991235,3511794841,1672541368,1672542076,708
11595,3664523809,3853188285,1672547401,1672549016,1615
11133,3715246385,3713471446,1672550270,1672553225,2955
9901,3519463038,3500695402,1672619604,1672622751,3147
10745,3887069914,3637105495,1672674794,1672677891,3097
11053,3770486161,3703624327,1672538210,1672538406,196
10486,3637566026,3780224882,1672625190,1672626756,1566
11111,3505140123,3423940256,1672703074,1672706217,3143
11466,3305093237,3922153821,1672641915,1672645319,3404
10607,3776811587,3510149298,1672669549,1672670459,910
11271,3760731595,3755502373,1672683901,1672685240,1339
11370,3284334297,3276499910,1672635172,1672635819,647
10862,3505786561,3772164469,1672550730,1672551844,1114
10823,3703614781,3510801769,1672553319,1672555953,2634
11417,3778479297,3500741534,1672555687,1672558813,3126
9974,3756948477,3932919664,1672592599,1672593774,1175
9977,3209280342,3977880564,1672664360,1672666785,2425
10594,3770533588,3732440502,1672688301,1672689334,1033
10768,3435801763,3235198316,1672552067,1672553818,1751
11024,3760854788,3834643026,1672606566,1672609776,3210
10764,3716209499,3246381831,1672653354,1672654844,1490
11751,3880637958,3429315500,1672567214,1672567896,682
11391,3447948483,3505032773,1672628592,1672630565,1973
10134,3791074200,3779478448,1672579383,1672581104,1721
10806,3791628195,3337903727,1672635972,1672639338,3366
11421,3792432763,3505331083,1672536871,1672538214,1343
11385,3756685732,3780287649,1672610171,1672610340,169
10563,3907923381,3534328311,1672537083,1672537183,100
10247,3357026115,3714951681,1672595967,1672597048,1081
10897,3756066765,3934980229,1672569950,1672572922,2972
10730,3703722212,3312651192,1672604578,1672607612,3034
10585,3509912164,3791688526,1672579368,1672581781,2413
10094,3500922040,3336501403,1672559858,1672561031,1173
10118,3934564437,3929002318,1672577013,1672579905,2892
11059,3613703906,3555954355,1672670318,1672672173,1855
10505,3505720915,3714731729,1672593945,1672596187,2242
10330,3711938229,3519341916,1672532409,1672535667,3258
9992,3714806574,3730115019,1672601582,1672604455,2873
11040,3663902064,3294164983,1672631658,1672632029,371
11278,3973134902,3830771832,1672656144,1672659680,3536
9882,3202787155,3281148858,1672591635,1672594410,2775
9837,3970775805,3772980989,1672658636,1672661483,2847
10240,3780740477,3780956975,1672561128,1672562309,1181
11332,3780921044,3783157469,1672659908,1672661632,1724
10837,3500590302,3791698084,1672693031,1672695388,2357
10408,3534988162,3713694278,1672682768,1672682954,186
10662,3520012007,3514761434,1672549029,1672549844,815
10098,3287753579,3307535495,1672658651,1672658935,284
11369,3756784813,3394364348,1672608077,1672609008,931
9839,3490008012,3974264211,1672701884,1672702908,1024
10191,3922786716,3490804766,1672678056,1672679021,965
10671,3857847527,3458271585,1672607562,1672607689,127
11729,3713621169,3435652260,1672683204,1672685232,2028
11521,3715441777,3277061226,1672556451,1672558356,1905
10437,3780224882,3783730769,1672620240,1672623327,3087
11314,3447948483,3899756737,1672604786,1672608084,3298
9951,3713444403,3505007498,1672597628,1672600482,2854
10939,3902682060,3440305508,1672623480,1672626541,3061
11743,3385006834,3774448657,1672695239,1672695418,179
11074,3701218904,3515753241,1672622801,1672625269,2468
9805,3461630842,3334824744,1672662566,1672664050,1484
10885,3772845364,3514747345,1672618284,1672620440,2156
11173,3778924002,3792173463,1672557210,1672559648,2438
11188,3484739955,3807111856,1672599622,1672599717,95
11451,3512371853,3517426473,1672678494,1672679026,532
11615,3309415277,3832002939,1672647505,1672650826,3321
10094,3776200012,3780298499,1672655304,1672656935,1631
9996,3314363575,3513508737,1672578116,1672579236,1120
11379,3235074007,3777655401,1672605540,1672605623,83
11209,3518931700,3533365834,1672559786,1672563037,3251
10821,3780942505,3512744657,1672682593,1672683194,601
10389,3476416072,3933106901,1672644991,1672648215,3224
11006,3512768285,3756493561,1672614839,1672617104,2265
9965,3509912164,3737685967,1672547486,1672549663,2177
11274,3757050615,3364683368,1672696548,1672699592,3044
11435,3510218188,3510454018,1672667385,1672670317,2932
10340,3515803462,3304235700,1672627061,1672629278,2217
11260,3892177203,3440671139,1672625704,1672629024,3320
11688,3487622510,3380357490,1672657680,1672660942,3262
11562,3887382548,3778370462,1672629789,1672631478,1689
11683,3899756737,3757713457,1672636586,1672639491,2905
10019,3792578118,3922430928,1672576898,1672577832,934
11393,3618895679,3510680251,1672685721,1672688482,2761
10075,3500317923,3778819352,1672613688,1672616082,2394
10060,3777655401,3715790104,1672602481,1672603900,1419
11699,3903088144,3557129226,1672550660,1672551947,1287
10275,3534499421,3513859809,1672593702,1672594493,791
10784,3293579860,3500776597,1672602177,1672604461,2284
10681,3897107253,3602054754,1672532499,1672533173,674
11371,3777706200,3853275529,1672669364,1672672936,3572
11537,3500544306,3715261950,1672545625,1672548762,3137
10116,3688768189,3755129708,1672620873,1672623229,2356
10119,3285322570,3405435885,1672635873,1672638966,3093
11341,3516463579,3312651192,1672545285,1672546269,984
11734,3406937294,3227919286,1672698935,1672699284,349
11558,3701004302,3496579251,1672544968,1672547465,2497
10103,3392482187,3227059650,1672687651,1672689934,2283
10357,3478206139,3447554599,1672622904,1672623790,886
11188,3445896667,3815440588,1672593353,1672596272,2919
10231,3515096959,3919349138,1672662031,1672663562,1531
11744,3519703964,3500342408,1672643373,1672646520,3147
10238,3770764940,3505685294,1672626960,1672627500,540
10490,3317887374,3512371853,1672642246,1672645044,2798
10083,3246296769,3517083465,1672686694,1672688498,1804
11149,3711179193,3515405509,1672593754,1672596959,3205
10707,3518478484,3511198566,1672652924,1672654554,1630
11217,3392482187,3245245283,1672557035,1672558493,1458
11712,3713990030,3228033254,1672640919,1672642576,1657
9981,3701887470,3612841103,1672702829,1672705995,3166
10183,3667950469,3427741923,1672682528,1672682722,194
10779,3792719263,3851810349,1672556819,1672557892,1073
10585,3904045870,3905571273,1672605243,1672608264,3021
10822,3279726491,3756998113,1672656087,1672658181,2094
10354,3447253775,3814770073,1672590371,1672593571,3200
11428,3360949039,3390368796,1672700123,1672700755,632
11053,3974264211,3510781595,1672652544,1672654801,2257
11108,3511311554,3366433035,1672603796,1672604021,225
11001,3684108920,3500433278,1672610397,1672612164,1767
9994,3498803823,3934564437,1672583979,1672586102,2123
10782,3505845400,3369810091,1672698067,1672700950,2883
10908,3701663839,3305657559,1672551287,1672554032,2745
10701,3716178116,3393909269,1672641376,1672643416,2040
11248,3312959324,3312946269,1672540399,1672543103,2704
10709,3776034313,3340723781,1672631558,1672632589,1031
10015,3380285779,3710783759,1672625237,1672628211,2974
11427,3402774497,3757773786,1672668615,1672668795,180
11136,3773085258,3714179543,1672693807,1672694603,796
11132,3344478603,3603167427,1672541626,1672545066,3440
11310,3683047199,3311514075,1672672495,1672673806,1311
11720,3710397477,3755229631,1672590000,1672593480,3480
11031,3444598583,3711591464,1672671955,1672673617,1662
10224,3715587520,3501759031,1672532802,1672535929,3127
11207,3505129296,3701060732,1672563237,1672566812,3575
10542,3703048107,3305657559,1672690156,1672693480,3324
11048,3710813103,3772689657,1672636631,1672637647,1016
11709,3485898181,3710082615,1672672553,1672673920,1367
10953,3226761201,3791522832,1672692251,1672693244,993
11387,3467944159,3514673213,1672603474,1672603595,121
10044,3802757611,3517652011,1672681179,1672683788,2609
10680,3520339198,3342235058,1672601405,1672602634,1229
9802,3805704844,3711029952,1672592460,1672593445,985
11453,3500051606,3410788026,1672628840,1672631095,2255
10651,3715246385,3490804766,1672552670,1672554543,1873
11129,3776561263,3714294005,1672541512,1672542466,954
11061,3713191326,3471996194,1672612954,1672615415,2461
9844,3780626668,3410602007,1672672041,1672675307,3266
9864,3814289471,3716160006,1672559631,1672561657,2026
10226,3714268380,3682241594,1672654236,1672656860,2624
11107,3773554767,3500671218,1672622870,1672624165,1295
11144,3793987483,3275975921,1672628384,1672628763,379
10248,3978643889,3509470194,1672543731,1672544376,645
10771,3770180844,3487622510,1672684514,1672686630,2116
10929,3815440588,3344778261,1672547575,1672551004,3429
11414,3897107253,3600302127,1672565867,1672565969,102
9881,3774633364,3737622701,1672584461,1672586682,2221
11728,3772489471,3398489033,1672624334,1672625184,850
10404,3711029952,3772689657,1672576888,1672577302,414
10324,3913746581,3760541837,1672602982,1672605291,2309
10583,3856897914,3303432071,1672574138,1672574945,807
10984,3446575109,3793375825,1672607061,1672609961,2900
10321,3774394000,3302988745,1672638581,1672640311,1730
10138,3837885956,3773697080,1672601748,1672604685,2937
10066,3437934509,3920606331,1672556003,1672557243,1240
10417,3834424604,3938409715,1672676165,1672679281,3116
10782,3778195766,3938059867,1672609400,1672610721,1321
11169,3776950532,3500624846,1672622221,1672624137,1916
10098,3937299996,3227919286,1672562496,1672565607,3111
10980,3403395712,3558264627,1672598842,1672599784,942
10160,3715261950,3887030182,1672601726,1672603027,1301
11617,3780238637,3490804766,1672652281,1672654208,1927
10232,3513384042,3334633634,1672685062,1672687458,2396
10695,3500057674,3770991234,1672597623,1672599629,2006
9873,3701291994,3500654356,1672630998,1672633731,2733
10340,3533703578,3311449914,1672679643,1672681977,2334
10581,3447202943,3772235668,1672668703,1672670013,1310
10050,3276231633,3757660578,1672581794,1672582973,1179
11287,3714640103,3715204544,1672580185,1672583667,3482
11789,3220987526,3820280594,1672679186,1672680185,999
10248,3518759318,3880882684,1672672444,1672675253,2809
11569,3858497718,3778731000,1672563847,1672564361,514
10414,3309528048,3226037966,1672621530,1672624108,2578
10833,3914926436,3450735824,1672655894,1672658798,2904
10872,3209958726,3793003432,1672584269,1672586151,1882
10187,3666022373,3311188620,1672575711,1672576980,1269
10030,3511218261,3299052917,1672648535,1672648627,92
11437,3783554600,3755203055,1672663368,1672665253,1885
10270,3713990030,3246381831,1672619875,1672621696,1821
9847,3407398464,3499343927,1672538553,1672541187,2634
11783,3834980281,3235470567,1672685107,1672686004,897
9839,3817120976,3783122313,1672633512,1672634220,708
10923,3281148858,3770408300,1672686930,1672688022,1092
11790,3716609198,3311432176,1672639268,1672640973,1705
9835,3701978422,3736056340,1672664515,1672667952,3437
10035,3519724388,3468343480,1672571717,1672573236,1519
10606,3688130094,3715204544,1672689751,1672690874,1123
11392,3757446082,3715441777,1672660049,1672663332,3283
11261,3773032706,3444453261,1672608577,1672609266,689
10787,3313824913,3330318282,1672629484,1672630271,787
10859,3371759044,3299743638,1672622570,1672625916,3346
11299,3382757142,3452104161,1672662380,1672664454,2074
10960,3520339198,3353326305,1672625389,1672626615,1226
9801,3435342362,3773736248,1672588635,1672589809,1174
10533,3403257752,3822315407,1672578016,1672579682,1666
10260,3357026115,3970851830,1672684241,1672684578,337
11421,3513545735,3783060739,1672628598,1672630022,1424
9920,3711938229,3735679000,1672539975,1672540408,433
11719,3316821313,3731905251,1672603860,1672604724,864
11119,3924366353,3856897914,1672661637,1672661947,310
11600,3608214600,3756328353,1672652336,1672652686,350
10921,3973582279,3316821313,1672574237,1672576026,1789
11073,3519000878,3303747093,1672581381,1672582359,978
10465,3517530943,3520473111,1672592787,1672595966,3179
10260,3518209090,3711219767,1672560872,1672561013,141
11063,3332124606,3714903253,1672637384,1672637888,504
11584,3662055682,3533325993,1672634339,1672635969,1630
10223,3246971044,3369558911,1672621985,1672625481,3496
9867,3760541837,3229465607,1672563586,1672565584,1998
10533,3520016705,3701655378,1672696007,1672698071,2064
10515,3773603836,3834949242,1672627986,1672631570,3584
10849,3558264627,3330188769,1672574575,1672576962,2387
11210,3757501067,3246804115,1672569302,1672572398,3096
10526,3760749218,3313298164,1672611308,1672611677,369
10753,3716647407,3516153301,1672676982,1672677666,684
10332,3514801709,3773852157,1672553554,1672555943,2389
11579,3516655509,3515970536,1672564275,1672565881,1606
11047,3903994989,3510781595,1672697781,1672697884,103
11047,3770925016,3974400577,1672539589,1672540822,1233
10154,3287920864,3756647451,1672629393,1672631840,2447
10564,3713373455,3973582279,1672558969,1672562283,3314
11786,3500863429,3368079099,1672656037,1672657611,1574
11625,3311472321,3686644062,1672645549,1672648065,2516
10881,3715196780,3914740937,1672537322,1672538720,1398
11432,3807111856,3505593034,1672689464,1672690193,729
10355,3760801237,3713191326,1672670278,1672673120,2842
11584,3839308659,3516200419,1672668073,1672671607,3534
11332,3812261241,3368951504,1672624480,1672625528,1048
10228,3298706213,3824259677,1672635719,1672637204,1485
10895,3228056289,3454924050,1672651158,1672651328,170
10017,3534102440,3714951681,1672667587,1672669513,1926
11770,3783563043,3519494023,1672572988,1672576101,3113
11684,3830291558,3820422111,1672663213,1672663913,700
10911,3505066871,3243305367,1672644688,1672645382,694
11663,3807486812,3908331271,1672664398,1672665279,881
11163,3779454060,3510795808,1672639864,1672640405,541
10252,3777686966,3713566527,1672617725,1672619142,1417
11203,3443004958,3509073025,1672681016,1672683422,2406
10966,3510775046,3770925016,1672584262,1672584779,517
11525,3220976338,3713100169,1672661843,1672662811,968
10683,3223144610,3703614781,1672657442,1672657721,279
11155,3476308535,3511883778,1672542986,1672546585,3599
11665,3501628472,3319862687,1672601865,1672603996,2131
10116,3368079099,3776455762,1672568929,1672570275,1346
11096,3514628916,3755273361,1672607210,1672610587,3377
10212,3885422379,3480560014,1672659883,1672659966,83
9910,3221290808,3500317923,1672659626,1672661100,1474
10526,3517083465,3710185376,1672624367,1672624685,318
11740,3783879023,3668720465,1672662046,1672665552,3506
11755,3611939581,3510864325,1672634403,1672634606,203
11507,3770595035,3710852576,1672613844,1672616697,2853
11566,3439283360,3520049965,1672581662,1672584223,2561
10773,3303772923,3778817220,1672575325,1672578063,2738
10549,3501734800,3778044082,1672642040,1672643630,1590
10994,3534770827,3517045396,1672695087,1672695882,795
10167,3311569360,3511650296,1672686376,1672686799,423
11668,3500536897,3791269060,1672537341,1672540209,2868
10269,3711076751,3916463490,1672687654,1672688025,371
10970,3306037126,3223796145,1672538318,1672541888,3570
10010,3381055770,3710695372,1672600543,1672601137,594
10158,3757773786,3517558635,1672702946,1672705989,3043
11235,3500833053,3915195160,1672536953,1672540129,3176
9855,3939851140,3713139039,1672677703,1672680929,3226
10345,3474074188,3701887470,1672538495,1672539198,703
11306,3793996996,3311037445,1672615767,1672615997,230
10285,3513661302,3895944547,1672619512,1672619572,60
11346,3500120676,3755394177,1672678196,1672681663,3467
11100,3609925909,3311959533,1672563423,1672565242,1819
10343,3755357292,3308744016,1672617114,1672617942,828
9947,3902023467,3358959807,1672683063,1672683246,183
11541,3714281210,3756149282,1672688874,1672689737,863
11139,3716922925,3710185376,1672680679,1672680828,149
10509,3510159441,3888523259,1672625735,1672627821,2086
10316,3387989658,3911821258,1672638619,1672640121,1502
10567,3420983899,3505011956,1672675651,1672676345,694
11477,3509651954,3509503263,1672666448,1672668351,1903
11332,3359351267,3622152515,1672533186,1672534014,828
10250,3780213684,3783157469,1672556201,1672556512,311
11218,3778318250,3773556853,1672669039,1672669391,352
11230,3821103640,3505011956,1672621881,1672623571,1690
10248,3737050849,3683047199,1672564411,1672567765,3354
11111,3716463756,3516249472,1672552172,1672554329,2157
10014,3713858538,3517756624,1672561946,1672563582,1636
11321,3284407073,3711810268,1672665800,1672668161,2361
10183,3393001196,3278251248,1672603062,1672606124,3062
10492,3554174421,3520473111,1672551675,1672553210,1535
10305,3518335611,3738132114,1672596567,1672596929,362
10622,3279731391,3372778334,1672559804,1672562383,2579
10304,3510781595,3733836732,1672604332,1672607284,2952
10429,3338016147,3828568868,1672677597,1672680429,2832
10752,3227206772,3247193800,1672614578,1672614993,415
11563,3447267291,3343193067,1672600811,1672604241,3430
9971,3424476995,3756680289,1672629878,1672630766,888
9931,3910354786,3373851012,1672701034,1672703097,2063
11701,3661856558,3393128259,1672602169,1672604505,2336
10255,3244395841,3977880564,1672664608,1672666400,1792
10417,3608973523,3519297683,1672650912,1672651647,735
10881,3306475287,3520049965,1672681301,1672682142,841
10687,3737050849,3293898029,1672607671,1672609216,1545
9952,3772869013,3757513651,1672655731,1672656748,1017
10594,3739387948,3793874490,1672542852,1672546127,3275
10717,3517949586,3666958814,1672534385,1672535990,1605
11084,3772291207,3445733121,1672588823,1672590910,2087
10717,3534589501,3733915784,1672651260,1672653940,2680
11642,3418791124,3516444589,1672634595,1672635435,840
9931,3437934509,3402580733,1672531242,1672532510,1268
11397,3510240661,3829698950,1672611271,1672612116,845
11710,3519341916,3496591885,1672546345,1672546982,637
10703,3715320359,3374147279,1672636059,1672637680,1621
11507,3372079985,3515379622,1672693867,1672697466,3599
11790,3429047448,3510750299,1672534478,1672537166,2688
11348,3710861700,3778924002,1672681467,1672684656,3189
9993,3773041843,3402105276,1672662194,1672664326,2132
11687,3293898029,3710296607,1672544556,1672545972,1416
9898,3510869438,3713170867,1672656647,1672657533,886
10169,3500073824,3772425253,1672679766,1672680596,830
10222,3354405535,3517227599,1672699547,1672702493,2946
10783,3711219767,3835509670,1672618153,1672618670,517
11317,3420664407,3377250778,1672542888,1672544527,1639
10037,3511729562,3505665788,1672581217,1672583180,1963
10660,3307216611,3600699873,1672666229,1672666629,400
9849,3316406470,3520763492,1672630481,1672631838,1357
11454,3341985886,3501853868,1672623178,1672623428,250
9887,3755465396,3774326754,1672531939,1672532974,1035
11192,3791796190,3311463998,1672647341,1672650049,2708
10087,3772164469,3770273966,1672668203,1672669126,923
10674,3462153833,3273758330,1672659113,1672659666,553
10301,3778402454,3505653701,1672634191,1672636144,1953
10446,3832312129,3447591143,1672574320,1672574486,166
11589,3440582836,3443041059,1672607137,1672609996,2859
11596,3518205307,3760322661,1672604756,1672606345,1589
11762,3511311554,3783238023,1672696308,1672697044,736
10693,3512871568,3319862687,1672680590,1672681133,543
10396,3413799143,3513840186,1672639668,1672639770,102
11709,3288920399,3977666815,1672625098,1672625668,570
10640,3379400553,3501976169,1672667109,1672668700,1591
11335,3205324639,3791072829,1672682580,1672684320,1740
11204,3793860209,3340723781,1672608158,1672610188,2030
10413,3757201538,3715897627,1672602909,1672605123,2214
11582,3396453219,3682241594,1672626770,1672630116,3346
10009,3511963020,3330318282,1672553676,1672556387,2711
10791,3515655024,3510250740,1672542255,1672542506,251
11655,3617771673,3396656251,1672671883,1672674328,2445
10956,3396472026,3505980138,1672684546,1672686022,1476
11670,3792719263,3773826624,1672671731,1672672590,859
9857,3711258452,3519513219,1672536673,1672538399,1726
11526,3283847934,3295710494,1672651685,1672653277,1592
11601,3703624327,3509018337,1672632240,1672632848,608
11637,3701127475,3488931357,1672671479,1672673122,1643
10093,3403218814,3510775046,1672641474,1672643633,2159
10150,3473520701,3703419800,1672629663,1672632102,2439
10563,3519351747,3793274846,1672575419,1672576952,1533
9867,3736010012,3711223297,1672665510,1672665839,329
10474,3510335069,3770480149,1672584373,1672585100,727
11779,3432050858,3512072679,1672556095,1672558678,2583
11336,3223144610,3390537737,1672604814,1672607096,2282
11212,3701893620,3780308809,1672669923,1672671540,1617
11318,3318224774,3340321384,1672675901,1672676235,334
11668,3424997707,3783313202,1672538588,1672540426,1838
11398,3710865678,3888523259,1672656902,1672659258,2356
11059,3737467358,3906693728,1672700638,1672701708,1070
9798,3668063289,3687024828,1672592679,1672593623,944
9918,3505007498,3756890980,1672689941,1672691474,1533
9874,3760267158,3534204885,1672637722,1672641144,3422
11427,3755507566,3632189887,1672676033,1672676810,777
11183,3397972945,3730571757,1672681230,1672684735,3505
10263,3732540636,3465672238,1672673634,1672676548,2914
11317,3515096959,3509377714,1672696294,1672696957,663
10695,3505331083,3501612813,1672596537,1672597726,1189
10454,3418683594,3755238321,1672542030,1672543735,1705
11116,3614484939,3534206917,1672613964,1672616159,2195
9838,3910020031,3630802959,1672539856,1672541939,2083
10217,3770476738,3476144563,1672536175,1672536400,225
9957,3908464960,3534372899,1672686141,1672688163,2022
11254,3935444008,3977880564,1672635503,1672638875,3372
9992,3275274182,3311810583,1672533456,1672536249,2793
10218,3613216900,3533154906,1672578095,1672579939,1844
10783,3716160006,3713102459,1672575086,1672577192,2106
11099,3509663119,3358262975,1672627920,1672628763,843
10077,3311739926,3783408469,1672625143,1672627838,2695
11384,3925792265,3559123082,1672533995,1672536549,2554
10997,3342252701,3884394685,1672637256,1672639400,2144
9859,3534941710,3382746533,1672551633,1672554306,2673
11037,3714179543,3512490032,1672671663,1672673187,1524
10830,3684651755,3370448531,1672585863,1672589076,3213
11217,3636885498,3511867383,1672703048,1672704289,1241
11070,3780142207,3500624846,1672632699,1672634865,2166
10493,3501004005,3773432494,1672681824,1672683074,1250
11059,3372079985,3711430738,1672678288,1672681776,3488
11625,3660246433,3812516461,1672670249,1672672558,2309
10830,3476416072,3760069457,1672582760,1672584216,1456
10958,3838748301,3375905193,1672541974,1672542870,896
10770,3534812391,3397527886,1672689044,1672689937,893
11387,3408111327,3776447604,1672607670,1672608800,1130
11763,3779951373,3681504869,1672545045,1672548566,3521
11274,3516585063,3482786946,1672659232,1672659680,448
10530,3519922921,3554174421,1672607060,1672608446,1386
10546,3456795601,3501628472,1672569122,1672571475,2353
10746,3510882475,3661543201,1672558757,1672560428,1671
11162,3379076106,3839744168,1672573413,1672574912,1499
10943,3715724166,3533131937,1672674416,1672675457,1041
9827,3515893948,3713195480,1672534112,1672534714,602
10289,3755154460,3238997746,1672579937,1672580073,136
10557,3491335890,3668855144,1672668360,1672670116,1756
10574,3516904926,3519951586,1672603575,1672606643,3068
10377,3505684690,3519965717,1672572556,1672575338,2782
10741,3511286390,3613940925,1672680971,1672684118,3147
11598,3230250213,3311904032,1672571785,1672573267,1482
10152,3517816581,3478206139,1672570939,1672571140,201
10625,3494680853,3777405860,1672673657,1672674989,1332
11096,3736056340,3701887470,1672667262,1672668218,956
10845,3311197635,3777439655,1672690451,1672693626,3175
10363,3245755569,3517645656,1672654589,1672656472,1883
11293,3755670258,3915035136,1672697396,1672698862,1466
11777,3414387263,3713416756,1672532981,1672533681,700
11736,3227647190,3701171318,1672648360,1672649493,1133
11134,3388937390,3311197635,1672590435,1672590546,111
11033,3407734098,3639926564,1672567096,1672568882,1786
11192,3826997668,3347172556,1672550320,1672553724,3404
10162,3497562878,3513859809,1672687941,1672691513,3572
10984,3669427589,3298113026,1672637189,1672638287,1098
10636,3505129296,3776583229,1672573575,1672573695,120
10980,3517800171,3714690161,1672584789,1672588370,3581
11469,3358434853,3451757423,1672679237,1672682193,2956
10750,3760687922,3776200012,1672595775,1672598486,2711
11501,3399173821,3206544535,1672650529,1672652053,1524
11418,3444397804,3334633634,1672538005,1672540853,2848
10253,3701887470,3880882684,1672669642,1672670165,523
10431,3380628097,3513661302,1672593414,1672595984,2570
10823,3783238023,3311015817,1672667532,1672668764,1232
10256,3714806574,3452802329,1672597711,1672600323,2612
10330,3513894659,3358262975,1672533442,1672537016,3574
10589,3505547832,3246296769,1672539435,1672540503,1068
10335,3777552831,3792008302,1672610081,1672611496,1415
10842,3783651407,3783967375,1672632564,1672636024,3460
10951,3685396470,3703206956,1672658836,1672659404,568
11334,3236563828,3510694464,1672659169,1672661920,2751
11208,3832902787,3511883778,1672597083,1672598347,1264
10323,3710125627,3714658474,1672690735,1672692031,1296
10985,3514698862,3500544306,1672581850,1672584069,2219
11764,3484483775,3505496725,1672617791,1672619086,1295
10923,3772845364,3313282478,1672649668,1672650257,589
11039,3358675021,3613940925,1672584060,1672585508,1448
11035,3246567963,3770486161,1672631833,1672632919,1086
11786,3714731729,3452389513,1672649050,1672650398,1348
10160,3493679801,3812277991,1672638357,1672638792,435
11287,3233965781,3772343750,1672612579,1672616085,3506
11299,3273242177,3772250554,1672608902,1672610795,1893
11589,3811351746,3807584987,1672648548,1672651840,3292
11611,3311159418,3285136057,1672697853,1672700322,2469
10023,3517718901,3703849264,1672596119,1672597934,1815
11775,3514013999,3681274982,1672695404,1672696524,1120
10727,3774663639,3777928067,1672702343,1672704147,1804
11176,3330238204,3505416534,1672680235,1672681035,800
10837,3517440258,3497562878,1672594304,1672596892,2588
10327,3534589501,3776534957,1672665872,1672667203,1331
9991,3509562377,3512495325,1672673160,1672676027,2867
10609,3516815069,3770105006,1672555271,1672557561,2290
9802,3410788026,3409098014,1672689476,1672691658,2182
11668,3755630085,3735152111,1672701485,1672702128,643
10814,3515970536,3398151217,1672653016,1672653618,602
9812,3505173665,3241593146,1672644754,1672645903,1149
11214,3533340292,3777751979,1672615761,1672616963,1202
11778,3505331083,3500473064,1672614092,1672615654,1562
10424,3680278447,3201957157,1672578571,1672578835,264
10115,3513111053,3517558635,1672634515,1672637194,2679
11301,3776561263,3307521389,1672596764,1672597750,986
9996,3688410383,3627431396,1672630428,1672632399,1971
10213,3295787354,3519886257,1672637103,1672640385,3282
9948,3513890046,3517645656,1672662722,1672665663,2941
11692,3774251051,3301403047,1672602026,1672602311,285
10158,3238997746,3517136772,1672572547,1672575682,3135
10840,3313502623,3277061226,1672586674,1672589248,2574
10607,3513840186,3472774606,1672548544,1672550961,2417
10735,3450164574,3820922991,1672555681,1672558991,3310
11082,3756784813,3714287902,1672621588,1672622757,1169
10464,3792797648,3514926921,1672573205,1672574716,1511
11539,3713514933,3925835590,1672659041,1672661636,2595
10758,3512784888,3516463579,1672543752,1672546892,3140
11011,3361865467,3493598658,1672676361,1672678091,1730
10922,3776455762,3776727271,1672658635,1672660109,1474
10047,3755229631,3511744756,1672650425,1672653186,2761
10353,3686211958,3711947828,1672671484,1672674115,2631
11657,3773688906,3638126174,1672634951,1672636528,1577
11322,3772882440,3248409083,1672681991,1672683981,1990
11538,3441944896,3912878303,1672671317,1672672147,830
10301,3884458862,3500087325,1672642793,1672644991,2198
9963,3509503263,3236360179,1672540371,1672542449,2078
11681,3815440588,3501253130,1672559684,1672560163,479
10694,3500814753,3359929534,1672564703,1672564967,264
11035,3444881567,3509431396,1672615050,1672616356,1306
11031,3378430760,3505560793,1672656606,1672657129,523
10025,3777729184,3600441934,1672630826,1672631470,644
10484,3517766135,3710819760,1672610257,1672613012,2755
11440,3344478603,3826068495,1672622946,1672625413,2467
11237,3701529552,3436401020,1672661882,1672663378,1496
9908,3925823748,3514737648,1672598327,1672600920,2593
10530,3925208102,3603452936,1672561306,1672563038,1732
10601,3905571273,3703938162,1672602637,1672602827,190
10401,3701296091,3701453343,1672650896,1672651097,201
11724,3783826338,3628556590,1672579652,1672580686,1034
11207,3907390925,3609925909,1672662541,1672666012,3471
10811,3271389160,3793822639,1672700079,1672702133,2054
11537,3414510793,3228997424,1672650470,1672653050,2580
10545,3313282478,3703938162,1672547621,1672551130,3509
11777,3714435747,3668369938,1672689906,1672691533,1627
11579,3398489033,3333355914,1672684753,1672686646,1893
9907,3393955069,3773876312,1672662454,1672663678,1224
11148,3853275529,3912181197,1672698945,1672700627,1682
10229,3410788026,3713996094,1672558156,1672558671,515
11112,3382757142,3428303756,1672543492,1672544376,884
11484,3484483775,3415803494,1672610726,1672613146,2420
11207,3976400190,3772251279,1672601088,1672603488,2400
10582,3510864325,3772227820,1672608719,1672611572,2853
11399,3734957248,3473520701,1672536184,1672539287,3103
10935,3732596503,3512072679,1672682628,1672684397,1769
10396,3780749789,3407398464,1672696022,1672699400,3378
10855,3701412729,3292663993,1672641672,1672643011,1339
10272,3703614781,3455430943,1672560835,1672561084,249
11610,3881579907,3519463038,1672689373,1672691304,1931
10069,3734957248,3206377955,1672631450,1672633368,1918
9817,3313101243,3220123678,1672603032,1672606382,3350
10775,3703415246,3406492167,1672543285,1672546668,3383
10525,3713416106,3780142207,1672623897,1672627037,3140
10821,3773411968,3906693728,1672650005,1672651767,1762
10723,3933872044,3519831322,1672623638,1672624878,1240
10282,3505500523,3776193847,1672656653,1672658007,1354
9997,3397972945,3517426473,1672543344,1672543568,224
11210,3713444403,3617771673,1672648802,1672650436,1634
10960,3665478011,3916955566,1672659042,1672662396,3354
9808,3792627762,3509626590,1672563929,1672564618,689
10010,3203457161,3518164450,1672590025,1672590452,427
10690,3899294071,3243056734,1672607487,1672609213,1726
10360,3516429380,3774706478,1672600846,1672602832,1986
11729,3206377955,3519165527,1672586038,1672588582,2544
11613,3488887919,3600871715,1672579600,1672582418,2818
10743,3830291558,3774394000,1672537168,1672538752,1584
10176,3394394262,3359351267,1672574475,1672574757,282
10096,3715106566,3926724515,1672584396,1672586148,1752
10884,3344710271,3520763492,1672587759,1672591053,3294
10993,3804707712,3756843139,1672662047,1672662702,655
11425,3516020922,3515577866,1672614905,1672615602,697
10770,3519924982,3509663119,1672656783,1672659369,2586
10912,3520165730,3710783759,1672701999,1672702743,744
11670,3511864772,3774436159,1672571480,1672574124,2644
10288,3301403047,3517499844,1672628897,1672629935,1038
10200,3976225898,3927365255,1672533733,1672534774,1041
10756,3932491622,3933731871,1672697707,1672698201,494
10174,3809207482,3517530943,1672661745,1672662372,627
11283,3783095041,3773895671,1672645502,1672647780,2278
9995,3773768643,3514107131,1672688419,1672691512,3093
10261,3733243990,3500079479,1672675971,1672676691,720
9900,3792455305,3399726243,1672665868,1672668908,3040
9886,3505331014,3505500665,1672639351,1672642655,3304
11187,3793902476,3429047448,1672660061,1672660369,308
10962,3713195480,3207307681,1672695851,1672696696,845
11222,3713476192,3927365255,1672548412,1672551799,3387
10005,3801379377,3610806770,1672692273,1672694372,2099
10224,3613936929,3515804844,1672570782,1672572793,2011
10815,3242082716,3501208658,1672683205,1672683675,470
10410,3663505156,3553640169,1672539719,1672540855,1136
10176,3711862792,3906874577,1672687099,1672690218,3119
10630,3772114731,3490008012,1672537719,1672541217,3498
11249,3501554468,3511640720,1672603100,1672605124,2024
10361,3501583486,3688130094,1672560941,1672561460,519
11054,3687183789,3935333166,1672602661,1672603362,701
11442,3373018943,3247545468,1672664900,1672665280,380
10828,3533154906,3495427619,1672571074,1672573863,2789
10819,3732223664,3446218191,1672592291,1672593393,1102
11275,3511415786,3446764595,1672608624,1672611064,2440
11443,3443580855,3710891331,1672649173,1672651757,2584
11101,3471585513,3505825767,1672612950,1672613658,708
11277,3730169449,3496407500,1672533414,1672534527,1113
10184,3491104534,3515893948,1672658221,1672660106,1885
10917,3512343029,3450621820,1672685490,1672687708,2218
10765,3793407883,3757514745,1672656186,1672658019,1833
11594,3206926634,3513384042,1672673228,1672675322,2094
11780,3600302127,3760748418,1672653316,1672655119,1803
10187,3714903456,3777304517,1672544483,1672546711,2228
11340,3809871495,3920116284,1672582531,1672583562,1031
11337,3510919509,3716982179,1672701700,1672703642,1942
10636,3780740477,3513384042,1672561941,1672564243,2302
11550,3619796619,3714892312,1672642171,1672643935,1764
11722,3338016147,3608214600,1672548115,1672549778,1663
11579,3240622654,3473706746,1672667841,1672669461,1620
10956,3755924094,3369938668,1672556008,1672556652,644
11208,3770019143,3811629200,1672663419,1672664199,780
11077,3509562377,3311045951,1672701495,1672704319,2824
10409,3905934770,3311331205,1672703674,1672705602,1928
11072,3714903456,3703588004,1672671835,1672674278,2443
10143,3517617472,3772659062,1672547360,1672550497,3137
11037,3774401596,3756525103,1672672948,1672673754,806
11009,3713336088,3620836520,1672694259,1672695508,1249
11150,3755630085,3817038422,1672657662,1672660615,2953
10290,3703614781,3450735824,1672639345,1672640906,1561
11517,3636885498,3977360666,1672534798,1672535502,704
11623,3513508737,3701387745,1672617899,1672619433,1534
11408,3714883746,3380444321,1672568063,1672569499,1436
11590,3757089924,3891272544,1672686352,1672689919,3567
11240,3928421417,3757855416,1672546656,1672547355,699
11405,3471131277,3837888196,1672679934,1672680451,517
10752,3359472956,3755230010,1672533029,1672536167,3138
11357,3629248353,3394976623,1672547727,1672550315,2588
9968,3756998113,3732533330,1672625425,1672627450,2025
10919,3419789418,3505500665,1672626927,1672630440,3513
9941,3534506090,3772282008,1672570894,1672573592,2698
10447,3510968599,3471585513,1672697687,1672699628,1941
10612,3515970536,3621812406,1672702191,1672703439,1248
10125,3822786416,3276393542,1672679555,1672680941,1386
10811,3557129226,3371184929,1672686247,1672686737,490
11609,3703779674,3450234157,1672573495,1672576921,3426
10674,3488887919,3780511388,1672606969,1672608132,1163
9845,3342495377,3930727474,1672685592,1672688050,2458
10706,3440991826,3367242388,1672584327,1672587906,3579
10351,3381254180,3231227362,1672608050,1672609938,1888
10738,3311602936,3701475090,1672554125,1672554994,869
11274,3774792696,3714294005,1672688774,1672690356,1582
9935,3533265491,3770976984,1672601367,1672601721,354
10544,3517253559,3664719070,1672676938,1672680452,3514
11634,3600871715,3914926436,1672698167,1672699478,1311
11167,3516378356,3713100169,1672564088,1672564399,311
11542,3757660578,3533986052,1672651666,1672652724,1058
11306,3444295435,3780050328,1672612502,1672614834,2332
10958,3774316305,3511580693,1672699594,1672703057,3463
10443,3355903597,3440582836,1672685593,1672686633,1040
10366,3519055736,3518989186,1672544814,1672545219,405
11079,3772648837,3380218091,1672666440,1672667497,1057
10583,3500922040,3513739060,1672569815,1672570395,580
11723,3710852576,3311771689,1672692094,1672693246,1152
10067,3783554600,3837435907,1672674435,1672675027,592
11614,3853182912,3228218081,1672610018,1672611386,1368
11367,3274341934,3904846341,1672671554,1672674675,3121
9910,3779382417,3853275529,1672622304,1672625146,2842
10892,3393376416,3776187150,1672592753,1672593459,706
11413,3287920864,3231654754,1672564054,1672566849,2795
11296,3609997804,3830599959,1672553164,1672555372,2208
10437,3378172464,3792021895,1672635793,1672636962,1169
11422,3714806574,3817315443,1672690417,1672692871,2454
10650,3777498160,3511382748,1672606511,1672610047,3536
9955,3791698084,3510864325,1672610483,1672612867,2384
9908,3730115019,3406029706,1672659403,1672659522,119
11223,3487988841,3514673213,1672628054,1672631206,3152
9867,3613940925,3715246385,1672655548,1672657753,2205
11245,3711804184,3791332226,1672686421,1672686863,442
10984,3311177439,3505097206,1672643371,1672644683,1312
9853,3505234868,3933731871,1672674109,1672675597,1488
11189,3501927452,3520165730,1672539483,1672539593,110
10713,3770630937,3924963918,1672591821,1672592742,921
11010,3770966950,3484739955,1672540160,1672542150,1990
11486,3757199889,3603167427,1672548269,1672551090,2821
9918,3911821258,3609166109,1672695986,1672697014,1028
11625,3757201138,3858330969,1672558026,1672559652,1626
10944,3510373076,3520339198,1672584052,1672586254,2202
11240,3517132086,3710082615,1672625966,1672626103,137
10976,3380285779,3516472352,1672700134,1672701909,1775
10293,3713805968,3241682278,1672666791,1672669638,2847
10782,3311200541,3430296808,1672559459,1672560778,1319
11444,3780648744,3509445318,1672590327,1672591639,1312
11381,3905889514,3365519448,1672688202,1672688478,276
10911,3772216305,3500456339,1672600492,1672600887,395
10576,3713159131,3904184638,1672697268,1672698076,808
11535,3533030343,3505500665,1672588155,1672590428,2273
9901,3772943811,3639081201,1672618329,1672618809,480
11127,3509701363,3478937459,1672655351,1672655844,493
10424,3423940256,3778370462,1672655279,1672658209,2930
11614,3494680853,3517149023,1672561768,1672564805,3037
10063,3773475506,3737050849,1672641342,1672642428,1086
11244,3711770853,3773083407,1672541416,1672543645,2229
10896,3452104161,3500726347,1672596677,1672598022,1345
9998,3364302157,3379666159,1672624017,1672624989,972
10555,3497904539,3534068874,1672566700,1672568956,2256
10997,3474074188,3776811587,1672622370,1672625032,2662
11345,3557528150,3660246433,1672598994,1672602405,3411
10528,3366501813,3701060732,1672604224,1672607596,3372
10150,3783238023,3689223632,1672651604,1672652944,1340
9901,3780423516,3343193067,1672689522,1672692976,3454
10606,3461743188,3205113625,1672576881,1672580110,3229
11396,3779975575,3437934509,1672622106,1672622268,162
10919,3913746581,3884192843,1672671792,1672674664,2872
11279,3516167000,3714892312,1672564275,1672567132,2857
10699,3793978936,3512753567,1672592689,1672593248,559
11399,3756367938,3465107990,1672538501,1672540376,1875
9869,3280208630,3897186782,1672577516,1672580519,3003
10636,3519341916,3715700639,1672616069,1672617333,1264
11342,3897003751,3553229537,1672690556,1672692647,2091
10827,3480418192,3512645289,1672683503,1672684989,1486
10568,3834949242,3501027795,1672650462,1672652452,1990
10941,3391612879,3778702093,1672685174,1672686202,1028
9939,3379076106,3515726910,1672564992,1672568396,3404
10884,3336225953,3511908639,1672637054,1672637936,882
10916,3888057649,3362368123,1672646050,1672648574,2524
10239,3301431129,3501612813,1672583396,1672585721,2325
11653,3604908372,3792075871,1672584738,1672585961,1223
11597,3915460293,3800434325,1672653535,1672655955,2420
11220,3714806574,3772844451,1672600473,1672602106,1633
11151,3370751461,3638018906,1672626119,1672627817,1698
10301,3338195686,3422915648,1672641685,1672643313,1628
11626,3701519251,3465107990,1672684692,1672685510,818
11117,3792475476,3915460293,1672605820,1672607429,1609
10864,3243056734,3559112196,1672579077,1672581635,2558
10212,3778741325,3500079479,1672533453,1672533885,432
10435,3339331632,3636015050,1672589677,1672592841,3164
10906,3883640454,3454924050,1672532796,1672534535,1739
10274,3514980025,3711810268,1672586732,1672587843,1111
11677,3365519448,3770976984,1672696131,1672696623,492
10488,3760107540,3227339675,1672566456,1672567231,775
9804,3701887470,3755502373,1672635841,1672637536,1695
10362,3478915403,3834424604,1672570952,1672574522,3570
10073,3755767856,3888057649,1672577362,1672577478,116
10024,3756428507,3887382548,1672567578,1672567841,263
10471,3462153833,3338187803,1672597027,1672597652,625
9796,3436774112,3662354016,1672662555,1672663394,839
10004,3818532143,3884458862,1672575157,1672577787,2630
11387,3206377955,3792267993,1672628150,1672631345,3195
9966,3501126057,3505234868,1672600860,1672602405,1545
10268,3756668747,3293157673,1672667928,1672670868,2940
10158,3776561263,3772282008,1672632605,1672633420,815
10143,3776279305,3776950532,1672585323,1672587234,1911
11124,3701841013,3888409038,1672627704,1672630331,2627
10001,3755107521,3931917809,1672703593,1672706229,2636
11504,3470962222,3813986705,1672673461,1672675945,2484
10324,3510781595,3892487982,1672565687,1672568178,2491
9836,3485151614,3394394262,1672590535,1672593028,2493
10691,3884192843,3500821475,1672561164,1672564504,3340
10242,3550887623,3512072679,1672668957,1672670765,1808
11009,3715106566,3710807030,1672583893,1672585496,1603
10909,3792075871,3627431396,1672592875,1672595749,2874
10848,3425260097,3483701493,1672593958,1672596605,2647
11746,3756113624,3714640103,1672614726,1672616824,2098
10924,3245501577,3882905311,1672631844,1672633477,1633
10641,3520049965,3512857020,1672655054,1672658241,3187
11212,3382746533,3792289287,1672688766,1672691598,2832
10700,3519730914,3807800457,1672672176,1672673648,1472
10233,3533131937,3773411968,1672546013,1672548454,2441
9841,3908883591,3756736726,1672687433,1672688235,802
10212,3773376762,3614944981,1672585877,1672588522,2645
10622,3403988682,3398489033,1672674994,1672675440,446
11663,3501600785,3534190196,1672661213,1672663914,2701
9936,3756890980,3279731391,1672540251,1672541657,1406
11378,3777060250,3405435885,1672589862,1672590756,894
10489,3820200446,3534941710,1672655172,1672657260,2088
11154,3559759778,3306037126,1672670128,1672672876,2748
11741,3622458047,3760749218,1672547466,1672550994,3528
10359,3271282663,3853783593,1672610635,1672611643,1008
10401,3453538201,3533593766,1672697378,1672697579,201
9973,3756616853,3716423829,1672670574,1672671931,1357
11188,3780749789,3914353062,1672568342,1672571772,3430
10116,3703737650,3439532406,1672678870,1672681595,2725
11689,3509208005,3388937390,1672547085,1672550667,3582
11315,3714525519,3906874577,1672558996,1672562013,3017
10294,3347996015,3776125503,1672585475,1672588568,3093
9902,3710060386,3435342362,1672533035,1672534748,1713
10128,3379517265,3472018395,1672535633,1672537177,1544
10503,3715039960,3812677669,1672636320,1672638174,1854
11626,3666022373,3301431129,1672598261,1672599527,1266
11519,3454343398,3533154906,1672564595,1672564711,116
11427,3835509670,3496579251,1672692253,1672695468,3215
10867,3519924982,3773032706,1672569454,1672572956,3502
10808,3772296376,3932491622,1672541586,1672543636,2050
11515,3444646562,3715106566,1672582759,1672584082,1323
11560,3899294071,3343511947,1672538380,1672540948,2568
10534,3760541837,3701956841,1672684595,1672685105,510
11098,3228997424,3358675021,1672569919,1672570906,987
9996,3772962072,3311774510,1672612657,1672615330,2673
11384,3825795004,3202740652,1672607194,1672607437,243
10983,3713139039,3774946684,1672590385,1672591908,1523
11719,3500555856,3288920399,1672589886,1672591304,1418
11329,3435342362,3493047640,1672682241,1672682452,211
11143,3624307518,3938129916,1672578452,1672580958,2506
10978,3551833298,3792075871,1672700443,1672703246,2803
9953,3772882440,3475830203,1672675879,1672677062,1183
10475,3681504869,3683562111,1672576235,1672577684,1449
10151,3500799617,3411626917,1672694874,1672697617,2743
11691,3665478011,3716233100,1672685009,1672687122,2113
10632,3500251781,3511466117,1672551249,1672551895,646
11393,3227919286,3551972633,1672561690,1672563321,1631
10312,3776166086,3510826414,1672682741,1672686257,3516
10583,3681737865,3517632796,1672594074,1672597568,3494
10079,3755129708,3299845453,1672666532,1672669779,3247
11388,3468871103,3892487982,1672576394,1672578955,2561
11080,3409078869,3711187791,1672696444,1672698369,1925
11580,3505155858,3791796190,1672606897,1672608707,1810
10611,3373802545,3476431618,1672640104,1672642653,2549
10583,3880788853,3772695548,1672610905,1672613593,2688
11100,3500049870,3292936094,1672562091,1672565316,3225
9799,3793081195,3627431396,1672640771,1672642119,1348
11024,3839744168,3485468650,1672570530,1672572622,2092
10751,3500776597,3711854614,1672613801,1672614688,887
11200,3772489471,3739217535,1672625923,1672627377,1454
10692,3367109648,3283847934,1672580934,1672581886,952
11232,3301449986,3277061226,1672699862,1672702597,2735
11115,3603452936,3240683148,1672649465,1672652465,3000
10378,3777767907,3806471413,1672680526,1672680717,191
11219,3228477490,3685645561,1672575932,1672578526,2594
9831,3715008501,3914926436,1672698771,1672701903,3132
9885,3461877104,3514515499,1672667359,1672668247,888
10650,3814378625,3821103640,1672670788,1672671032,244
11243,3313392810,3511311554,1672607764,1672608103,339
11597,3516572212,3830291558,1672534682,1672537209,2527
11492,3774035405,3505278562,1672545904,1672549046,3142
11363,3792633495,3285971415,1672553742,1672555244,1502
10665,3856316719,3520305100,1672603313,1672605353,2040
11029,3399504157,3333505404,1672565066,1672566115,1049
11107,3393128259,3512794667,1672633737,1672634182,445
11633,3558264627,3438204844,1672693386,1672696904,3518
10159,3461137945,3520832066,1672601473,1672604053,2580
10524,3715590997,3632303304,1672685999,1672688434,2435
10992,3823307824,3515577866,1672684932,1672685560,628
11253,3209925780,3479207976,1672671483,1672675044,3561
10993,3636852764,3285201542,1672665853,1672667629,1776
11690,3505839395,3905955166,1672624333,1672626101,1768
10574,3757924067,3396440259,1672567174,1672569557,2383
11708,3517652011,3430310785,1672646938,1672647317,379
10255,3815440588,3480270940,1672652881,1672655934,3053
10536,3311472321,3552261072,1672575005,1672577663,2658
9915,3246062632,3622218289,1672551386,1672553960,2574
11302,3505331083,3687445224,1672664990,1672666373,1383
10376,3711065081,3853182912,1672560354,1672563538,3184
9901,3611298237,3713471446,1672683966,1672685978,2012
10106,3710515351,3273242177,1672683512,1672684864,1352
11659,3757728121,3776581518,1672638881,1672640868,1987
10448,3411213032,3916924978,1672589692,1672590512,820
11107,3203876438,3387322545,1672575605,1672578251,2646
10837,3660163550,3919349138,1672624038,1672625963,1925
10479,3425545115,3930501172,1672612337,1672615274,2937
11179,3515096959,3482687604,1672579944,1672581675,1731
11093,3412605548,3472561941,1672558782,1672559298,516
9827,3600699873,3512625661,1672676825,1672676965,140
9869,3772169046,3777041132,1672590354,1672591809,1455
11548,3231963246,3516904926,1672553231,1672554990,1759
11067,3516585063,3701412729,1672645045,1672645296,251
10096,3515548696,3772216305,1672537381,1672539332,1951
10939,3439283360,3241567995,1672666927,1672669255,2328
10646,3792277399,3776316903,1672596733,1672598280,1547
9986,3770476738,3779413388,1672677937,1672678123,186
10911,3439662051,3701265238,1672691301,1672692079,778
11074,3505560793,3519730914,1672575013,1672577510,2497
11023,3505560793,3505032773,1672678840,1672680379,1539
10034,3664478769,3517045396,1672592475,1672595634,3159
11634,3971051020,3372617110,1672697687,1672697935,248
11207,3902300755,3388923880,1672553369,1672556772,3403
10416,3757639274,3779665641,1672609807,1672611753,1946
10403,3228575883,3500994763,1672599097,1672600812,1715
11755,3515803462,3500093945,1672606143,1672609280,3137
10198,3636877469,3779340538,1672540143,1672542879,2736
10724,3755357292,3888409038,1672635227,1672637418,2191
10008,3631444265,3401215739,1672703624,1672706908,3284
11389,3519841427,3520694387,1672551598,1672552155,557
10048,3285587972,3792063616,1672632584,1672633381,797
10444,3711243126,3309528048,1672629135,1672631935,2800
11163,3514007122,3236206821,1672702276,1672704099,1823
10563,3512154443,3226761201,1672578453,1672579717,1264
10993,3909399636,3500438542,1672645902,1672646828,926
11570,3274239253,3337903727,1672540951,1672543733,2782
10931,3772055279,3312651192,1672586487,1672586720,233
10529,3882851213,3777751979,1672653300,1672656698,3398
11307,3316117186,3829698950,1672645399,1672647511,2112
11262,3280208630,3783313202,1672546884,1672549862,2978
10963,3770012744,3331471764,1672627189,1672627578,389
10565,3443191792,3514455363,1672664776,1672664920,144
10526,3780969898,3387971464,1672593261,1672595998,2737
11657,3382746533,3791206902,1672682741,1672682847,106
10046,3207586072,3703572036,1672649499,1672652464,2965
11416,3600842635,3792719263,1672569422,1672572825,3403
10896,3534589501,3924583142,1672616651,1672616780,129
10280,3713954144,3534372899,1672666376,1672668035,1659
10003,3703818358,3774326754,1672612740,1672614452,1712
10494,3711810268,3774394000,1672544517,1672546352,1835
10291,3703659324,3316117186,1672578365,1672581449,3084
10293,3505129296,3500145103,1672534341,1672534908,567
9890,3517132086,3780467276,1672654601,1672656890,2289
9817,3802757611,3613703906,1672678861,1672681747,2886
11597,3773411968,3231859576,1672695219,1672697990,2771
10816,3824135033,3783651407,1672544399,1672546344,1945
10045,3517113478,3313282478,1672636395,1672638106,1711
11712,3286862903,3501980730,1672595235,1672595536,301
11468,3632720032,3686853863,1672642264,1672643448,1184
10989,3716609198,3439651226,1672609078,1672610095,1017
9955,3513250976,3660702754,1672535162,1672535327,165
10362,3714424237,3773770134,1672657518,1672660398,2880
11125,3520471156,3510153173,1672684194,1672686700,2506
10613,3925835590,3372236721,1672576615,1672579515,2900
10954,3500821475,3423346297,1672632901,1672636062,3161
10878,3238779889,3311188620,1672570208,1672573126,2918
10961,3534206917,3629869834,1672582748,1672582899,151
11375,3793003432,3247545468,1672565501,1672567538,2037
9886,3397783490,3760979523,1672571247,1672573322,2075
10617,3737685967,3779778679,1672617883,1672618775,892
10910,3895944547,3287821258,1672701443,1672702034,591
10689,3770476738,3499820963,1672576617,1672577996,1379
11717,3773688906,3513859809,1672543133,1672543237,104
9960,3516153301,3248061684,1672585140,1672588035,2895
9990,3516668203,3931495845,1672552956,1672553553,597
11791,3318220119,3499998389,1672641474,1672644755,3281
11767,3425545115,3852461753,1672602667,1672605869,3202
10613,3519055736,3476308535,1672633255,1672636141,2886
11763,3891586951,3777932225,1672686597,1672688684,2087
10412,3615447269,3359012188,1672600558,1672603427,2869
10052,3471131277,3603740088,1672606065,1672607433,1368
10548,3770630937,3299845453,1672595849,1672596969,1120
11212,3701493094,3428303756,1672624893,1672627916,3023
10827,3505826673,3893950585,1672644625,1672647976,3351
10831,3755924094,3711671702,1672652530,1672653279,749
11161,3632720032,3395615598,1672659865,1672661437,1572
11602,3931028233,3236206821,1672664040,1672666123,2083
9824,3780956975,3618024815,1672575277,1672576385,1108
10093,3361789225,3333505404,1672604617,1672606418,1801
10157,3533017131,3520305100,1672665929,1672668462,2533
9806,3313579674,3246381831,1672581041,1672582490,1449
10826,3476431618,3367202274,1672681448,1672684558,3110
9909,3509317776,3791688526,1672548007,1672551332,3325
10655,3827889533,3388774559,1672660457,1672661215,758
10070,3305656670,3973134902,1672567052,1672567614,562
11750,3664523809,3403120725,1672665556,1672665747,191
10952,3514585995,3353326305,1672692028,1672694168,2140
10969,3714897456,3473562779,1672699205,1672699828,623
10885,3333477908,3293579860,1672682412,1672685032,2620
10765,3505709407,3510680251,1672689288,1672689656,368
9889,3450164574,3773083407,1672577618,1672578148,530
10721,3424997707,3791617239,1672597821,1672601054,3233
10562,3394959062,3776348451,1672605133,1672607376,2243
10146,3514980025,3520305100,1672602656,1672603913,1257
11693,3777992576,3512625661,1672674989,1672678090,3101
10980,3518335611,3792785261,1672671072,1672674207,3135
11755,3783157469,3514611187,1672682008,1672684617,2609
10680,3757201538,3510301454,1672572443,1672575512,3069
11380,3783357035,3298113026,1672623905,1672624031,126
10598,3774663639,3701493094,1672674579,1672676133,1554
10533,3220976338,3905358065,1672602761,1672604631,1870
11192,3510856388,3755075988,1672630002,1672630952,950
10470,3779102237,3509167758,1672579031,1672580832,1801
10507,3444680955,3755175497,1672594318,1672597382,3064
10150,3509614126,3772250554,1672567466,1672570155,2689
11651,3392573386,3688768189,1672686485,1672689023,2538
11583,3791905743,3732104286,1672536401,1672536476,75
10428,3660246433,3518157683,1672642133,1672643075,942
11567,3505836431,3480405740,1672573951,1672575107,1156
10376,3895944547,3922153821,1672626194,1672626890,696
10696,3512744657,3791532324,1672635813,1672637313,1500
11520,3300810210,3770564547,1672568268,1672569622,1354
10076,3710515351,3380357490,1672671724,1672674488,2764
11524,3773556853,3512726649,1672629796,1672632886,3090
10229,3852014884,3239082508,1672580834,1672582386,1552
10353,3777149336,3317887374,1672561083,1672564016,2933
10509,3819024145,3516969689,1672601867,1672604147,2280
11483,3555954355,3772425253,1672676127,1672678020,1893
11560,3517325365,3492728794,1672685172,1672685294,122
10646,3495482863,3517021928,1672689548,1672692816,3268
11373,3404395454,3342545285,1672660622,1672660807,185
10554,3533974355,3713224038,1672541329,1672543699,2370
9869,3428303756,3776440009,1672542994,1672545622,2628
11706,3737946004,3880562532,1672661685,1672665125,3440
11591,3513816744,3516321814,1672552201,1672554288,2087
11003,3307454562,3804779247,1672626292,1672628314,2022
11365,3772114731,3353326305,1672577640,1672579236,1596
10596,3519947298,3355899481,1672542824,1672546049,3225
10231,3710051427,3818236682,1672636792,1672637759,967
10047,3432838598,3505490878,1672622673,1672624554,1881
11300,3505190512,3713606829,1672666831,1672669177,2346
10108,3817478012,3661359073,1672695445,1672696288,843
9846,3926724515,3436018575,1672688977,1672691016,2039
10218,3730226545,3511750695,1672569891,1672573072,3181
11742,3534667712,3359929534,1672603096,1672606128,3032
9975,3285515107,3501657158,1672686795,1672688224,1429
11541,3703336988,3801501384,1672696832,1672699619,2787
10895,3735197034,3908464960,1672662379,1672662466,87
11005,3495482863,3287689454,1672586500,1672588897,2397
10701,3812277991,3278779955,1672639065,1672641040,1975
11193,3686885442,3201920708,1672577160,1672578212,1052
10187,3534506090,3470135167,1672563581,1672567160,3579
11143,3714806574,3829761380,1672598399,1672601520,3121
11281,3513850048,3413511621,1672683050,1672684553,1503
11716,3772425253,3555215568,1672612673,1672615674,3001
10174,3534499421,3513171472,1672587352,1672588553,1201
10644,3773736248,3520155898,1672618375,1672619605,1230
11169,3714688409,3514352989,1672645623,1672648612,2989
9961,3701459978,3471996194,1672533140,1672533558,418
11150,3449233346,3474852115,1672692981,1672695560,2579
10014,3823600319,3619796619,1672572881,1672573925,1044
9971,3249380931,3514450836,1672572828,1672575452,2624
10366,3274341934,3500198430,1672703457,1672705610,2153
10633,3534537581,3714067998,1672646531,1672649343,2812
10713,3344778261,3513739060,1672601539,1672602165,626
10375,3505007498,3716922925,1672637061,1672640544,3483
9803,3500073824,3806720019,1672660635,1672661346,711
11768,3514508773,3851877325,1672682223,1672683554,1331
11136,3514560138,3606804618,1672626471,1672628915,2444
10816,3201573194,3515304526,1672547801,1672548154,353
11637,3883640904,3824657614,1672692445,1672695867,3422
10393,3201634072,3701971784,1672553924,1672555015,1091
11792,3737622701,3505121295,1672686856,1672688343,1487
10070,3607288879,3668681400,1672655882,1672658026,2144
9815,3553008208,3439662051,1672658325,1672660765,2440
9854,3511907179,3636015050,1672546779,1672549711,2932
10088,3489205994,3772751765,1672665987,1672667530,1543
10456,3376487118,3368441333,1672561738,1672562018,280
11056,3837435907,3791581138,1672569257,1672571553,2296
10740,3681701931,3514033319,1672662912,1672664302,1390
11231,3703999217,3774652449,1672630165,1672630867,702
10153,3296970170,3714897456,1672536256,1672539662,3406
10504,3770846374,3366164642,1672629243,1672630561,1318
11384,3499142934,3710919244,1672676616,1672677472,856
11277,3480259863,3534578428,1672662559,1672666151,3592
9804,3559221089,3514980025,1672554415,1672557598,3183
10047,3772262649,3550206045,1672703089,1672704591,1502
11088,3505936495,3682906048,1672690423,1672691669,1246
9987,3249380931,3730348493,1672667086,1672670581,3495
9809,3715590997,3471507117,1672600072,1672601695,1623
9974,3760966645,3887382548,1672688777,1672689325,548
10030,3770273966,3304028109,1672699841,1672703358,3517
9997,3701725839,3703611876,1672532895,1672533896,1001
10125,3231271498,3898592058,1672641797,1672644557,2760
10504,3447078933,3500317923,1672561210,1672563912,2702
10737,3783679478,3667654673,1672663601,1672666849,3248
10954,3485151614,3382308738,1672648937,1672650033,1096
11680,3518534560,3853783593,1672609598,1672611468,1870
10946,3409514897,3716467469,1672533219,1672534804,1585
11763,3887502536,3621812406,1672652579,1672655905,3326
10825,3482519872,3510209505,1672545164,1672546232,1068
11674,3553640169,3505331014,1672577118,1672579187,2069
11698,3304235700,3701296091,1672625934,1672626231,297
11526,3770457058,3515507526,1672558920,1672560926,2006
11392,3342368576,3977337501,1672586690,1672587909,1219
11060,3713444403,3519260216,1672532771,1672534315,1544
11154,3773475506,3366501813,1672534806,1672536144,1338
11340,3669418238,3432466467,1672604811,1672606827,2016
10853,3850108828,3516497645,1672597766,1672600501,2735
11732,3317190427,3519947298,1672564251,1672564957,706
11191,3505392452,3736885568,1672645071,1672645712,641
10213,3783238023,3755865626,1672583689,1672585362,1673
9897,3293157673,3779748270,1672626596,1672630183,3587
10227,3773798215,3554174421,1672669409,1672671667,2258
9862,3436401020,3377250778,1672641439,1672641631,192
11701,3792719263,3755769254,1672601405,1672604082,2677
10400,3533620069,3510826414,1672695345,1672698321,2976
10106,3516819320,3431317400,1672678686,1672681196,2510
10253,3494748808,3370245766,1672647031,1672648800,1769
11422,3414510793,3881012415,1672684176,1672685267,1091
11132,3601063076,3711854614,1672633165,1672635186,2021
9916,3468281011,3330466913,1672691424,1672693369,1945
11593,3602054754,3509018337,1672625163,1672627142,1979
10477,3774238066,3755378125,1672667309,1672668710,1401
9795,3459799131,3243763209,1672642721,1672643315,594
10417,3514005973,3703742071,1672591354,1672593068,1714
11698,3783879023,3240683148,1672677510,1672678790,1280
10248,3500720752,3375257546,1672647839,1672648186,347
10910,3929002318,3533986052,1672620472,1672622270,1798
10413,3519553933,3449020351,1672697187,1672698539,1352
11610,3756428507,3475830203,1672647656,1672648976,1320
10296,3779413388,3517766135,1672561006,1672562003,997
11655,3887069914,3780563627,1672583269,1672585395,2126
11296,3513250976,3509626590,1672673917,1672676302,2385
10742,3615846003,3778695895,1672637884,1672640510,2626
10587,3770846374,3370448531,1672532350,1672534905,2555
10948,3515726910,3972196462,1672701085,1672702331,1246
9971,3467232654,3279851026,1672660113,1672660214,101
11453,3517083465,3829358750,1672575625,1672577753,2128
11648,3756119976,3505839395,1672676878,1672678440,1562
10612,3397330170,3415032547,1672642390,1672644443,2053
11270,3774447975,3364718040,1672603662,1672603786,124
10542,3236886943,3360783381,1672547872,1672548883,1011
11769,3208594306,3714250543,1672578799,1672579074,275
11592,3375324190,3512965991,1672569663,1672572800,3137
11752,3417268745,3710060386,1672592582,1672592962,380
11212,3909067335,3371497614,1672569004,1672569553,549
10607,3777686966,3380218091,1672604414,1672605295,881
10650,3505593034,3273771395,1672608562,1672610226,1664
10776,3435342362,3714287902,1672549760,1672550985,1225
10706,3856601074,3770391782,1672652919,1672653872,953
10200,3824259677,3885147558,1672552437,1672553204,767
10163,3701824335,3445355677,1672557908,1672558426,518
11613,3760232135,3701448521,1672565597,1672566202,605
11048,3772893815,3778605154,1672665261,1672668675,3414
10439,3490804766,3311197635,1672605803,1672606222,419
11267,3511526885,3825526565,1672693914,1672696400,2486
9915,3701453343,3500864577,1672621395,1672624318,2923
10281,3371184929,3346755179,1672618261,1672621280,3019
11137,3755502373,3209417223,1672630937,1672631279,342
10967,3858330969,3899756737,1672567634,1672569144,1510
10825,3500799617,3780298499,1672702304,1672702473,169
10228,3713858538,3735197034,1672695407,1672696138,731
11605,3509274030,3515259326,1672605363,1672608353,2990
10081,3714892312,3293579860,1672697783,1672699180,1397
9991,3774251051,3916463490,1672655062,1672656754,1692
10301,3919494952,3222364320,1672598879,1672599193,314
10986,3701779683,3505331014,1672609656,1672612570,2914
11527,3710228292,3505624416,1672680724,1672683533,2809
10931,3972442654,3792075871,1672617081,1672619329,2248
11258,3780733404,3445558740,1672649367,1672651804,2437
11623,3311264420,3701385831,1672550647,1672551611,964
10495,3778318250,3601063076,1672627172,1672627392,220
10632,3820422111,3774744663,1672659953,1672661638,1685
9887,3517469005,3283785820,1672699799,1672700750,951
9841,3791994414,3931319307,1672668750,1672671284,2534
11298,3773032706,3716633983,1672602391,1672604583,2192
10647,3452104161,3278805844,1672550180,1672552781,2601
10855,3333477908,3783506190,1672642686,1672643384,698
11079,3520160414,3520395850,1672657862,1672661192,3330
10010,3801501384,3510869438,1672626935,1672628082,1147
11239,3519322066,3292050211,1672612354,1672615743,3389
10452,3372596013,3480405740,1672632949,1672634452,1503
11638,3929391979,3439651226,1672620453,1672620907,454
11244,3432466467,3610806770,1672566210,1672566959,749
10865,3715923089,3533037906,1672565208,1672567653,2445
11630,3711722554,3534204885,1672618936,1672619980,1044
10115,3291936679,3228033254,1672654266,1672654593,327
10305,3802374620,3475845921,1672671647,1672673333,1686
9834,3603740088,3935333166,1672595955,1672599134,3179
11458,3520725149,3713514933,1672626771,1672628956,2185
10196,3387971464,3711765138,1672564553,1672567937,3384
11138,3519055736,3713416106,1672542719,1672545760,3041
10013,3755630085,3342056927,1672662862,1672665727,2865
10041,3737946004,3703725221,1672686150,1672686715,565
10861,3602401154,3446233783,1672657834,1672661380,3546
10444,3202787155,3344778261,1672582613,1672585211,2598
11062,3403177609,3668369938,1672701007,1672703884,2877
10330,3359418136,3516429380,1672659496,1672662681,3185
11726,3510882576,3472173212,1672694951,1672696149,1198
9991,3533728729,3533960602,1672659176,1672661826,2650
10574,3510801769,3777370992,1672690965,1672692609,1644
11632,3472561941,3514145752,1672694915,1672698391,3476
11205,3334381941,3362706073,1672638635,1672640409,1774
9934,3783554600,3920890008,1672664845,1672667966,3121
9822,3510278533,3552922094,1672558365,1672560240,1875
11298,3834980281,3626631210,1672604162,1672607052,2890
11739,3756345026,3916955566,1672544275,1672546789,2514
9955,3225356349,3309651238,1672637217,1672639407,2190
11317,3906693728,3516572212,1672651466,1672654830,3364
10557,3893950585,3738103378,1672599951,1672603333,3382
11568,3516655509,3638126174,1672552539,1672552765,226
11234,3516472352,3792012147,1672621610,1672624452,2842
10517,3933562725,3776455762,1672572367,1672574105,1738
9907,3779169946,3290060215,1672672031,1672673880,1849
11732,3623113240,3297684667,1672587446,1672587685,239
9970,3406937294,3755922811,1672555145,1672555794,649
10124,3813276198,3609997804,1672569148,1672570268,1120
9869,3332124606,3556684272,1672584344,1672587919,3575
11377,3486824047,3701359045,1672590357,1672592934,2577
10218,3756157377,3880562532,1672535532,1672535885,353
10404,3513840186,3505491969,1672654262,1672657709,3447
10607,3515100211,3276499910,1672661450,1672662218,768
11027,3638823001,3902023467,1672574780,1672577754,2974
10041,3352057037,3291936679,1672538921,1672540969,2048
10334,3519356606,3613216900,1672679345,1672680528,1183
10384,3501976169,3780294116,1672550355,1672553823,3468
10732,3433902955,3534204885,1672622239,1672623153,914
11342,3716178116,3774029494,1672651866,1672655400,3534
10975,3476144563,3509186338,1672670869,1672672847,1978
11023,3477511446,3505175620,1672544578,1672545881,1303
11362,3246381831,3777751979,1672620278,1672620763,485
11724,3772943811,3519435459,1672692875,1672695870,2995
10001,3772909073,3715881104,1672581045,1672583963,2918
11264,3500928990,3511663572,1672687848,1672688355,507
10229,3500093945,3318250647,1672570345,1672573067,2722
11634,3472561941,3274239253,1672607999,1672608507,508
11355,3776617627,3416105769,1672678874,1672681329,2455
11164,3515637968,3452104161,1672545859,1672547544,1685
11765,3347205332,3520515739,1672571103,1672573226,2123
10790,3779609338,3304030474,1672617002,1672619687,2685
10778,3316121649,3359929534,1672594785,1672595247,462
10449,3534626053,3509433155,1672575582,1672576373,791
10788,3791121243,3903088144,1672689872,1672692851,2979
11663,3779818784,3505720915,1672539016,1672540829,1813
11188,3755170743,3624307518,1672674826,1672675423,597
10203,3774706478,3783730769,1672686995,1672687575,580
11442,3505521491,3519997661,1672552934,1672555457,2523
10013,3431317400,3773134128,1672593450,1672594589,1139
9815,3514306458,3505392452,1672660378,1672662379,2001
10857,3778842400,3441683673,1672674088,1672675123,1035
10628,3971422524,3621591266,1672629263,1672631828,2565
10875,3457249798,3900540310,1672673216,1672676175,2959
11312,3916463490,3829698950,1672629043,1672629768,725
10998,3518205307,3910354786,1672669632,1672671300,1668
10586,3519341916,3408828584,1672574469,1672577787,3318
11780,3297624618,3559123082,1672670259,1672672537,2278
10212,3715858201,3446764595,1672601575,1672602717,1142
10765,3755790149,3792432094,1672623543,1672625620,2077
11320,3713740434,3791688526,1672587237,1672589133,1896
10826,3509996827,3495446254,1672568415,1672568786,371
11501,3330318282,3533960602,1672634786,1672635954,1168
11655,3664523809,3510638085,1672591528,1672592303,775
10508,3235578852,3760687922,1672690349,1672693635,3286
10047,3354405535,3802625412,1672697338,1672700210,2872
11075,3533620069,3716423829,1672619031,1672620701,1670
10308,3500864577,3662507634,1672626905,1672626981,76
11744,3518164450,3514585995,1672538110,1672540743,2633
10406,3922301238,3793902476,1672620212,1672622999,2787
11739,3665603628,3809194824,1672599803,1672600370,567
11337,3617135064,3619494735,1672666155,1672666667,512
11055,3223512565,3510758718,1672543350,1672544381,1031
11689,3512768285,3809871495,1672670979,1672672961,1982
9935,3633949990,3319660530,1672689455,1672691468,2013
10883,3510801769,3501554468,1672585176,1672585952,776
10587,3838748301,3366433035,1672574877,1672575007,130
11326,3776811587,3514564903,1672608878,1672610211,1333
10450,3819315404,3517377614,1672636738,1672638346,1608
10988,3207586072,3293898029,1672556181,1672558713,2532
9840,3755688231,3372617110,1672585622,1672586610,988
11491,3822368676,3780148144,1672610702,1672612107,1405
10584,3682266017,3500342408,1672690444,1672690934,490
10345,3516249472,3492728794,1672584670,1672587658,2988
10123,3475560058,3713434898,1672636675,1672638387,1712
11016,3291446384,3369938668,1672590585,1672590937,352
11454,3829412384,3791509334,1672574167,1672577629,3462
10205,3780168985,3306491253,1672642345,1672642656,311
9941,3520145112,3358959807,1672662771,1672665991,3220
10362,3316821313,3520057139,1672637857,1672638024,167
11742,3398489033,3311331205,1672571852,1672572293,441
10418,3632720032,3484490325,1672583418,1672585905,2487
11007,3893527651,3388937390,1672632706,1672636210,3504
11499,3443521234,3510856388,1672537539,1672538457,918
11786,3396440259,3519621901,1672690166,1672690740,574
10175,3333355914,3414510793,1672598996,1672601196,2200
10417,3830599959,3730348493,1672657130,1672658433,1303
11605,3443191792,3760390822,1672652543,1672653379,836
10862,3435037864,3713566527,1672698371,1672699418,1047
10175,3776953418,3774822697,1672595647,1672598447,2800
11321,3349319959,3931767736,1672578004,1672579837,1833
11560,3382746533,3839744168,1672538173,1672539333,1160
10685,3405200303,3293673220,1672691979,1672692282,303
10825,3820422111,3515507526,1672695503,1672696680,1177
10480,3551972633,3783095041,1672560023,1672560635,612
11103,3475560058,3500251781,1672603708,1672604127,419
11617,3666367524,3778195766,1672696379,1672699122,2743
10319,3773840321,3923133978,1672535764,1672538366,2602
11428,3534696810,3622218289,1672533758,1672535300,1542
10115,3854202447,3380444321,1672573235,1672573734,499
11247,3240683148,3734957248,1672557040,1672557949,909
11684,3899294071,3976225898,1672678037,1672679724,1687
10840,3359351267,3311904032,1672570881,1672573511,2630
10813,3831981073,3730115019,1672624056,1672624873,817
10049,3772869013,3774273260,1672636291,1672636920,629
9913,3444295435,3881012415,1672595458,1672596574,1116
10025,3275057862,3733953055,1672577696,1672578360,664
11280,3414841458,3352057037,1672574714,1672577010,2296
11443,3505697295,3231654754,1672600677,1672601220,543
10674,3792021895,3494560663,1672560641,1672562815,2174
10441,3209075485,3780142207,1672646708,1672648716,2008
10851,3513802404,3901217668,1672539915,1672540046,131
10493,3669918958,3839417558,1672633920,1672636752,2832
11473,3756363182,3884394685,1672642860,1672643298,438
10088,3793926338,3809871495,1672656199,1672658407,2208
9869,3662522808,3311774510,1672698717,1672699232,515
10154,3857244486,3850181934,1672554510,1672554627,117
10523,3510919509,3505571800,1672546523,1672547634,1111
11695,3716609198,3519703964,1672650563,1672652144,1581
10601,3411355804,3714516404,1672670553,1672672537,1984
11685,3669418238,3811503860,1672597734,1672600275,2541
11792,3778318250,3882851213,1672591378,1672591925,547
11665,3351153781,3618895679,1672665989,1672666669,680
10765,3351153781,3311904032,1672693646,1672695120,1474
10382,3772164469,3478915403,1672674821,1672677566,2745
10569,3334461288,3757944870,1672605669,1672607439,1770
11363,3512504247,3715712376,1672542754,1672543429,675
10163,3378747834,3773891827,1672572975,1672575874,2899
11707,3772869013,3971447562,1672603680,1672604518,838
10177,3372778334,3317989975,1672664771,1672667582,2811
10499,3505245692,3288675710,1672690379,1672691055,676
10194,3755107521,3779160052,1672662335,1672662451,116
10103,3774702364,3772223331,1672610130,1672611459,1329
11371,3505560793,3777200549,1672547603,1672550134,2531
11709,3755769254,3501574882,1672591494,1672593151,1657
10302,3622458047,3533265491,1672563053,1672564716,1663
10311,3901217668,3520473111,1672611336,1672611691,355
10852,3780352400,3517902505,1672637640,1672641207,3567
10262,3760024021,3662821438,1672614485,1672614552,67
11087,3515304526,3811354125,1672594937,1672595138,201
9879,3201957157,3776187150,1672580596,1672582278,1682
10364,3550405857,3500927619,1672583627,1672585625,1998
10513,3278629965,3792930090,1672697533,1672700842,3309
10279,3500821475,3511645260,1672587371,1672589287,1916
10277,3501759031,3710271021,1672617745,1672619043,1298
10436,3534984243,3345902033,1672610056,1672612870,2814
10250,3231654754,3343193067,1672666091,1672666520,429
11357,3907225070,3804779247,1672677120,1672679963,2843
11242,3355903597,3276393542,1672558031,1672560539,2508
10877,3791587717,3756991235,1672545640,1672547396,1756
10472,3610723722,3778182724,1672571398,1672573138,1740
10719,3512802259,3289771213,1672638160,1672640970,2810
9861,3205161801,3793407883,1672569234,1672569878,644
11716,3499998389,3774195369,1672552665,1672553411,746
10630,3711770773,3240622654,1672663656,1672664281,625
10425,3466655775,3514353133,1672613122,1672614819,1697
10338,3774822697,3204473480,1672666071,1672666362,291
9941,3760554453,3477511446,1672686408,1672689641,3233
10812,3917467642,3756668747,1672603455,1672604244,789
10638,3513171472,3500931474,1672595418,1672597007,1589
10800,3760420315,3710487368,1672647221,1672650001,2780
10055,3614484939,3777729184,1672656566,1672660011,3445
9844,3483347530,3716982179,1672672431,1672672960,529
11690,3513092056,3505314920,1672652903,1672656349,3446
10268,3907923381,3791194984,1672596919,1672598683,1764
10607,3517645656,3511580693,1672573894,1672576558,2664
10128,3519059808,3837885956,1672684076,1672686370,2294
11528,3313824913,3757513651,1672531236,1672533349,2113
11186,3669497617,3358473096,1672662169,1672663856,1687
11539,3520558137,3241567995,1672551289,1672552838,1549
9810,3393376416,3462153833,1672591701,1672593705,2004
10350,3514698862,3755849241,1672654207,1672654450,243
10377,3207586072,3430399931,1672607329,1672610067,2738
9939,3505248368,3433902955,1672582086,1672584531,2445
11679,3760749218,3500251781,1672690797,1672692989,2192
11286,3517021928,3303432071,1672630896,1672632274,1378
11191,3738132114,3275975921,1672633304,1672633954,650
11126,3714645218,3229621693,1672633970,1672637221,3251
10463,3340321384,3905571273,1672647831,1672650481,2650
11230,3445733121,3715320359,1672536042,1672538671,2629
10671,3713159131,3201573194,1672651388,1672651590,202
10214,3505173665,3776791436,1672701560,1672703292,1732
11342,3447554599,3356972733,1672663163,1672665988,2825
10065,3297624618,3896200048,1672569778,1672572075,2297
10879,3241567995,3773134128,1672543765,1672546285,2520
11309,3370448531,3313392810,1672697870,1672699214,1344
9832,3423940256,3332010532,1672645312,1672645438,126
10239,3500079479,3438470128,1672609611,1672611712,2101
10586,3884388188,3240443426,1672649164,1672651335,2171
9901,3343616490,3520395850,1672681169,1672681345,176
10120,3776319560,3384001094,1672552229,1672555512,3283
11476,3515548696,3534626053,1672689554,1672691997,2443
10986,3399504157,3979115924,1672553466,1672553682,216
11724,3380418745,3405221863,1672630258,1672632021,1763
11415,3398862999,3514576083,1672571022,1672573028,2006
9928,3512645289,3774359137,1672562251,1672564802,2551
10297,3605078841,3375324190,1672599621,1672601195,1574
11473,3755374000,3973582279,1672678652,1672680288,1636
9993,3520305100,3715111016,1672681954,1672685299,3345
10709,3779174993,3512769522,1672548907,1672549355,448
9973,3501657158,3402338011,1672581454,1672581871,417
10917,3511908639,3776561263,1672671828,1672671937,109
10215,3510775046,3509677530,1672560479,1672561940,1461
11740,3231227362,3520860199,1672632770,1672634421,1651
10628,3292663993,3517227599,1672605363,1672605431,68
10268,3434052463,3466492108,1672623047,1672623742,695
11079,3371497614,3423147369,1672544618,1672547204,2586
11551,3898989233,3898965585,1672618568,1672619661,1093
11583,3520395850,3710529628,1672679496,1672682989,3493
11013,3509912164,3773899531,1672659370,1672661047,1677
10370,3919349138,3520779124,1672601717,1672604279,2562
10175,3461630842,3505449070,1672662097,1672662287,190
10177,3395505794,3715566511,1672593142,1672594711,1569
10878,3501126057,3375324190,1672615552,1672617807,2255
11708,3397783490,3497732613,1672607466,1672609237,1771
10257,3906693728,3711854614,1672696269,1672697817,1548
11541,3519108639,3681274982,1672696045,1672697039,994
10030,3777135415,3805616707,1672696385,1672698837,2452
11582,3938021614,3938409715,1672603584,1672604330,746
11644,3515970536,3227919286,1672687794,1672690467,2673
10392,3735197034,3760107540,1672608840,1672610097,1257
11484,3370401047,3715111016,1672684518,1672687619,3101
10080,3371759044,3836586875,1672587268,1672589144,1876
9851,3511382748,3505175620,1672667309,1672670295,2986
11391,3354968884,3310737478,1672606731,1672607342,611
10207,3682266017,3715261950,1672542436,1672544994,2558
9991,3440671139,3929446196,1672540189,1672542086,1897
11499,3778702093,3534604516,1672603005,1672603624,619
11111,3935333166,3360972732,1672594948,1672595703,755
11134,3533986052,3711844574,1672547216,1672550480,3264
10368,3778561231,3779951373,1672575943,1672576513,570
10649,3511466117,3827889533,1672646553,1672647104,551
9943,3517380144,3916673751,1672640184,1672640660,476
11459,3480405740,3735679000,1672695665,1672698388,2723
10406,3711518637,3338642026,1672546834,1672547133,299
9837,3780308809,3791509334,1672571107,1672574257,3150
11471,3774450494,3821087562,1672630186,1672630840,654
10702,3287689454,3534537581,1672613074,1672616311,3237
11040,3737738751,3770273459,1672614344,1672616322,1978
10310,3929391979,3904184638,1672562835,1672563208,373
10511,3884934977,3896123242,1672694395,1672695259,864
10681,3352295704,3248409083,1672682340,1672685443,3103
11306,3516586325,3398483531,1672668329,1672670821,2492
11758,3550206045,3559619861,1672622891,1672623391,500
11144,3757497708,3609166109,1672573987,1672575371,1384
10752,3818236682,3533009565,1672610842,1672611013,171
10967,3669497617,3220976338,1672545961,1672548127,2166
10843,3601340045,3905934770,1672565629,1672566132,503
11080,3302348002,3375324190,1672596877,1672599787,2910
10514,3780969898,3777564559,1672571750,1672574621,2871
10195,3435159896,3513764665,1672683586,1672686913,3327
10114,3703611876,3421040626,1672603187,1672606179,2992
10379,3756157377,3471585513,1672691646,1672692062,416
11294,3311045951,3858330969,1672610592,1672614186,3594
9988,3486824047,3756843139,1672696617,1672699420,2803
10192,3511750695,3286938590,1672583542,1672585048,1506
10689,3780308809,3735679000,1672555046,1672558351,3305
11408,3772869013,3820280594,1672696786,1672700300,3514
10285,3509544691,3510680251,1672693435,1672695160,1725
10958,3494748808,3735197034,1672662226,1672665776,3550
11083,3792930090,3912878303,1672564019,1672565601,1582
11432,3281148858,3500473064,1672567693,1672571167,3474
11653,3245501577,3713740434,1672656579,1672659122,2543
11301,3774029494,3516321993,1672696286,1672699276,2990
10274,3360972732,3711190257,1672540758,1672543068,2310
10757,3300238532,3505175620,1672692382,1672693577,1195
11119,3713621169,3447078933,1672652683,1672653395,712
11000,3409514897,3666367524,1672576758,1672578297,1539
9862,3619705594,3517718901,1672615780,1672618070,2290
10735,3703104365,3518368900,1672682106,1672684221,2115
10736,3773085258,3311626308,1672571265,1672573592,2327
10064,3821082558,3505245692,1672543471,1672544718,1247
11101,3415803494,3518058151,1672614316,1672616330,2014
10188,3711223297,3511028193,1672596435,1672597997,1562
11760,3770180844,3703438617,1672532748,1672533048,300
10100,3533976217,3791409441,1672597647,1672600843,3196
11559,3783942518,3737622701,1672582041,1672583510,1469
11275,3533859712,3235470567,1672591946,1672593072,1126
10172,3791070926,3513996288,1672568877,1672569824,947
10351,3330238204,3418997135,1672653546,1672654971,1425
10657,3301332095,3391612879,1672667740,1672669928,2188
11333,3909399636,3902357342,1672535941,1672539179,3238
11226,3463883997,3505066871,1672541441,1672541655,214
9873,3779815753,3514638555,1672667083,1672667220,137
10550,3776182849,3926065090,1672673157,1672675500,2343
10426,3469663062,3402580733,1672612310,1672613275,965
10478,3805616707,3853275529,1672647223,1672648134,911
11791,3290797257,3505148522,1672546122,1672547977,1855
10463,3519356606,3779427180,1672570459,1672572961,2502
11339,3290797257,3519102732,1672567697,1672571084,3387
9950,3294326116,3710107905,1672557341,1672557691,350
11310,3825795004,3778604070,1672691671,1672693239,1568
11259,3770631449,3715204544,1672678059,1672679276,1217
10490,3711889178,3500785888,1672624385,1672627031,2646
9815,3500799617,3488988274,1672600582,1672603713,3131
10755,3970851830,3509317054,1672644622,1672644765,143
10749,3776122272,3776348472,1672675555,1672679149,3594
11504,3714377201,3888903181,1672643405,1672645570,2165
10308,3660496328,3490953301,1672659657,1672662943,3286
11640,3273758330,3716633983,1672588677,1672590699,2022
9886,3304661369,3605591994,1672675810,1672678942,3132
11088,3518088154,3715724166,1672531874,1672534979,3105
10766,3884192843,3276231633,1672542775,1672546075,3300
11021,3228056289,3773876312,1672703226,1672703978,752
10030,3505500665,3450164574,1672540191,1672542064,1873
10586,3783172505,3977337501,1672697523,1672698494,971
10847,3403035480,3246971044,1672669426,1672671678,2252
10467,3618895679,3714645218,1672654412,1672656826,2414
10658,3466149998,3534626053,1672531588,1672532765,1177
11631,3760541837,3808442442,1672639131,1672641657,2526
9831,3533960602,3353326305,1672609263,1672611741,2478
11686,3938059867,3505234868,1672639387,1672640818,1431
11415,3515047288,3357496255,1672591744,1672592819,1075
11089,3713566527,3500342408,1672662928,1672664561,1633
9918,3347140733,3778370462,1672531883,1672532233,350
11098,3228056289,3666561358,1672685017,1672685814,797
11143,3773394570,3662354016,1672703525,1672705063,1538
10148,3895422995,3515528947,1672703966,1672704031,65
9814,3780733404,3638823001,1672684422,1672686593,2171
10637,3668855144,3347205332,1672558805,1672561288,2483
10106,3732104286,3732540636,1672669815,1672673204,3389
10982,3333505404,3309651238,1672594694,1672595149,455
10396,3275057862,3514737648,1672605857,1672608832,2975
10134,3370512945,3428198021,1672548289,1672551761,3472
11007,3710919244,3519780867,1672553861,1672554147,286
10466,3406132280,3517797610,1672645969,1672647781,1812
10285,3453519360,3713875941,1672624999,1672625997,998
9804,3500726347,3520189871,1672535045,1672538220,3175
11573,3367262509,3811419378,1672653845,1672654707,862
11778,3703779674,3793274846,1672594066,1672595303,1237
11583,3667950469,3371564186,1672690463,1672692175,1712
9950,3512965991,3852461753,1672619748,1672623264,3516
9920,3514297012,3510775046,1672619185,1672621717,2532
11771,3793274846,3501027795,1672566899,1672567187,288
11518,3755218683,3342027511,1672698238,1672699848,1610
10041,3384001094,3452802329,1672580097,1672581090,993
11244,3351728355,3509377714,1672668455,1672669041,586
11152,3501115299,3884862164,1672556722,1672557274,552
10056,3713805968,3370751461,1672595347,1672596104,757
10206,3823600319,3606688595,1672671752,1672674712,2960
9814,3711767051,3770544738,1672655583,1672656582,999
9950,3713726267,3710865678,1672686962,1672689926,2964
11163,3792173463,3909220912,1672615919,1672616673,754
11336,3850904092,3350169064,1672591731,1672592281,550
11569,3783826338,3513545735,1672661592,1672662234,642
11423,3422548081,3514673213,1672610704,1672611371,667
11319,3850735936,3505234868,1672636350,1672638097,1747
10032,3636885498,3780648744,1672652152,1672652248,96
11071,3853386575,3756363182,1672535974,1672537118,1144
10910,3274341934,3343767438,1672606376,1672608580,2204
11325,3857590978,3701540249,1672545147,1672546439,1292
10249,3817038422,3667654673,1672651305,1672651792,487
11685,3500590302,3205161801,1672541715,1672542042,327
10081,3235313062,3774598935,1672633104,1672634139,1035
10830,3313824913,3443521234,1672550465,1672553363,2898
10495,3337675386,3835509670,1672565002,1672568489,3487
11491,3776187150,3285136057,1672679858,1672683053,3195
11549,3231271498,3829412384,1672594597,1672595344,747
11454,3621591266,3534122907,1672671232,1672673023,1791
11070,3777715675,3513250976,1672675992,1672678828,2836
11469,3283847934,3772845364,1672541793,1672543789,1996
10169,3318056480,3772296376,1672577560,1672578216,656
11750,3884458862,3776710698,1672651177,1672652205,1028
11210,3465672238,3793375825,1672681608,1672684490,2882
11350,3773424266,3760537855,1672595384,1672596038,654
11333,3814672661,3534626053,1672666921,1672667538,617
11562,3773688906,3917811545,1672639616,1672641618,2002
10027,3200372897,3381244346,1672592234,1672595747,3513
10895,3500726347,3778370462,1672650048,1672650888,840
11174,3703624327,3505173665,1672531691,1672533030,1339
11791,3403150349,3495427619,1672654982,1672656431,1449
10977,3405435885,3668063289,1672622797,1672624695,1898
10832,3512492332,3770180844,1672608564,1672608878,314
11231,3370751461,3716467469,1672699637,1672700184,547
11404,3885339157,3273537848,1672541504,1672544582,3078
10404,3855077502,3347205332,1672684969,1672688317,3348
11168,3611570003,3793899166,1672589652,1672592742,3090
11068,3239082508,3716468783,1672691289,1672693313,2024
10277,3636877469,3667814788,1672658657,1672661251,2594
10316,3776125503,3510869438,1672609765,1672610362,597
11367,3770846374,3364286028,1672640560,1672642786,2226
10146,3776291254,3739395381,1672672905,1672674533,1628
9932,3783060739,3711131262,1672600984,1672603458,2474
10681,3377446376,3478206139,1672655599,1672657269,1670
11443,3835509670,3755584983,1672589771,1672593106,3335
10176,3760481622,3511650296,1672683645,1672685832,2187
10543,3519730914,3900793652,1672700426,1672703902,3476
10796,3501027795,3441683673,1672616493,1672618025,1532
11568,3714870496,3770457058,1672638510,1672640928,2418
10771,3881579907,3417223898,1672667820,1672669732,1912
9880,3509544691,3773408491,1672606721,1672607300,579
11530,3310702648,3703572036,1672607434,1672608365,931
9895,3601063076,3515939841,1672564032,1672566260,2228
10137,3716468783,3513816744,1672605979,1672607388,1409
11176,3400903513,3512625661,1672571880,1672572731,851
10527,3500049870,3927805949,1672694315,1672696621,2306
11003,3793822639,3817076003,1672586569,1672587225,656
9819,3303772923,3772169046,1672659656,1672661314,1658
11242,3369482983,3226037966,1672563482,1672563566,84
11326,3398483531,3793822639,1672643693,1672646447,2754
10222,3360837082,3434452046,1672574293,1672576069,1776
11042,3406390503,3439532406,1672602815,1672604045,1230
11167,3738132114,3792497486,1672566771,1672569450,2679
11521,3313101243,3737685967,1672567864,1672570908,3044
11227,3443004958,3342235058,1672689330,1672691606,2276
11284,3505121295,3854202447,1672545421,1672546710,1289
9907,3619494735,3388463477,1672694033,1672695850,1817
11387,3783086267,3552261072,1672611703,1672612937,1234
10626,3485151614,3792597493,1672622445,1672624787,2342
10148,3917811545,3914353062,1672581791,1672584394,2603
10528,3468201976,3817478012,1672532017,1672533506,1489
10847,3714067998,3491948594,1672641736,1672643968,2232
11020,3512546783,3913847876,1672608236,1672608510,274
11369,3517195738,3757089924,1672563979,1672564679,700
10965,3756781024,3475090917,1672634539,1672636068,1529
10265,3515838621,3971447562,1672571786,1672572624,838
10165,3409514897,3755849241,1672636249,1672637550,1301
10391,3622458047,3715724166,1672607512,1672610860,3348
11209,3660702754,3477582923,1672700028,1672701602,1574
11220,3335353798,3231153513,1672677325,1672680864,3539
11060,3335055096,3919349138,1672656315,1672656736,421
11166,3627377299,3738132114,1672591596,1672592085,489
10754,3804095239,3908550561,1672691836,1672693579,1743
10825,3791509881,3446218191,1672683615,1672685725,2110
10502,3343511947,3352057037,1672566520,1672567825,1305
11375,3685877449,3509208005,1672620996,1672623090,2094
10348,3703938162,3343859998,1672617912,1672619433,1521
11624,3779393140,3757311529,1672575443,1672577539,2096
10597,3243056734,3500251781,1672657349,1672658186,837
9893,3923524564,3733243990,1672570798,1672571626,828
10665,3851877325,3397330170,1672634489,1672635180,691
10496,3519228207,3450342110,1672658395,1672659740,1345
10120,3416079461,3472774606,1672625623,1672627375,1752
10576,3908177413,3533325993,1672694374,1672697325,2951
10889,3223796145,3701377471,1672539880,1672540903,1023
9877,3602570831,3713767153,1672595369,1672598371,3002
11129,3686885442,3930727474,1672550765,1672551145,380
11006,3820200446,3505007498,1672689447,1672691147,1700
10189,3342056927,3394394262,1672703218,1672703839,621
9931,3514033319,3774450494,1672641362,1672644871,3509
11548,3773826624,3482519872,1672644396,1672646116,1720
10634,3390438262,3505769529,1672666053,1672668717,2664
10988,3779748270,3382757142,1672549308,1672551829,2521
10931,3370448531,3791434207,1672694005,1672695526,1521
11427,3710397477,3810584695,1672551591,1672554668,3077
10477,3487231844,3517499844,1672672967,1672673206,239
9831,3779413388,3703742071,1672664195,1672666095,1900
9852,3897107253,3714281795,1672682034,1672684538,2504
10110,3551833298,3517377614,1672675598,1672678048,2450
11509,3511069449,3396440259,1672671225,1672671701,476
11770,3514560138,3760271237,1672593666,1672594504,838
10198,3501828287,3770981604,1672574061,1672575335,1274
11724,3520832066,3756740153,1672650651,1672651690,1039
10816,3757198930,3534812391,1672638522,1672639977,1455
9907,3533265491,3341738186,1672634947,1672636986,2039
9816,3284865931,3770273966,1672698416,1672701478,3062
11533,3783443095,3400560073,1672632894,1672636441,3547
10825,3463883997,3396453219,1672551260,1672553223,1963
11602,3515706117,3755502373,1672540083,1672540449,366
11598,3757607649,3773432494,1672567332,1672568486,1154
10968,3342495377,3338465050,1672667413,1672667814,401
9826,3935569749,3413511621,1672638652,1672640259,1607
9924,3713069234,3826068495,1672587585,1672590575,2990
10414,3819024145,3715284599,1672573254,1672574795,1541
10647,3520009158,3201502111,1672694287,1672694717,430
9883,3358434853,3228056289,1672543278,1672544242,964
10601,3710861700,3439532406,1672626904,1672627657,753
11504,3756119976,3517800171,1672664548,1672667409,2861
10563,3270502801,3422314045,1672688391,1672689252,861
10723,3534102440,3755849241,1672694454,1672695863,1409
10086,3917905192,3498803823,1672628266,1672631116,2850
10054,3825877848,3509355477,1672664734,1672666164,1430
10548,3716341323,3441944896,1672632449,1672634587,2138
10254,3774589551,3311696372,1672551010,1672552037,1027
9807,3360949039,3410602007,1672550046,1672551519,1473
11132,3971280379,3229615214,1672609899,1672610339,440
11475,3821082558,3774304163,1672665050,1672668614,3564
9885,3520155898,3625952981,1672566092,1672567885,1793
10649,3480270940,3778382224,1672689551,1672690201,650
10763,3792440162,3908464960,1672611803,1672615044,3241
11383,3446810761,3715790104,1672573483,1672577017,3534
11232,3904485393,3927763819,1672621369,1672622469,1100
11597,3511663572,3791587717,1672642466,1672642916,450
10837,3888903181,3513384042,1672653709,1672657077,3368
10717,3780171640,3780173788,1672601434,1672603533,2099
10266,3501927452,3739395381,1672658659,1672658812,153
10571,3487278983,3422460919,1672535275,1672538546,3271
9955,3779413388,3488333295,1672665588,1672667689,2101
10488,3716595760,3361865467,1672628728,1672631197,2469
10007,3340723781,3395505794,1672614527,1672617850,3323
10069,3600842635,3509394912,1672584693,1672587576,2883
10881,3773085258,3755411110,1672638811,1672639921,1110
10507,3307236682,3490008012,1672609349,1672612387,3038
10535,3757497708,3505547832,1672561740,1672563184,1444
11288,3936871734,3284829602,1672685144,1672688683,3539
11253,3927763819,3755769731,1672552895,1672553840,945
11008,3806720019,3533154906,1672573685,1672574973,1288
11293,3624307518,3812559393,1672531673,1672532084,411
11675,3760390822,3772227820,1672697942,1672700166,2224
11405,3519848902,3238796398,1672647347,1672647506,159
11056,3623067708,3505839395,1672607300,1672609734,2434
10833,3907039612,3779665641,1672544166,1672544555,389
9831,3817478012,3793364952,1672609710,1672611381,1671
11331,3770631449,3273242177,1672617128,1672619856,2728
11681,3373677765,3429047448,1672694155,1672696956,2801
10652,3888903181,3772188086,1672540380,1672543466,3086
10516,3711187791,3467232654,1672589644,1672592079,2435
10225,3342031426,3713434898,1672561126,1672563381,2255
10685,3779413388,3791269060,1672572477,1672574283,1806
10464,3857847527,3730935770,1672569185,1672572766,3581
11642,3774539067,3500854711,1672566444,1672568374,1930
9964,3757872458,3313579674,1672679531,1672683039,3508
10356,3856316719,3287920864,1672537660,1672538666,1006
10875,3714294005,3517499844,1672581106,1672582921,1815
11061,3880000841,3914353062,1672592443,1672593666,1223
10902,3703611876,3505720915,1672627372,1672629343,1971
10096,3770276815,3770273966,1672642865,1672646247,3382
10578,3772609551,3311449914,1672650173,1672650345,172
11519,3515507526,3394986304,1672552964,1672554997,2033
10820,3756272704,3242082716,1672616058,1672617297,1239
11697,3534328311,3772689657,1672642989,1672643911,922
10675,3783563043,3628556590,1672537639,1672538745,1106
10650,3926724515,3433196933,1672532829,1672535895,3066
11581,3906260966,3776316903,1672596285,1672598233,1948
11477,3533201269,3730459093,1672651106,1672651829,723
9900,3304697982,3243763209,1672681717,1672683975,2258
9916,3353811455,3923910914,1672628500,1672628986,486
9869,3614944981,3516965624,1672560568,1672563430,2862
11650,3835509670,3403035480,1672582520,1672585435,2915
10671,3410602007,3756113624,1672642476,1672642618,142
10279,3757549235,3666655293,1672651189,1672652641,1452
11337,3805718871,3791194984,1672627858,1672631205,3347
11366,3760525465,3776727271,1672566294,1672569813,3519
9879,3516572212,3380444321,1672628810,1672629441,631
9826,3500793739,3380418745,1672577081,1672578253,1172
10263,3289771213,3757851680,1672638306,1672638862,556
10202,3792440162,3714287902,1672542944,1672544118,1174
10722,3313502623,3772131127,1672652908,1672655176,2268
10840,3209417223,3344710271,1672653983,1672654317,334
11452,3701218904,3600871715,1672582529,1672584974,2445
10596,3779706467,3513111053,1672617091,1672618410,1319
11628,3811419378,3501174621,1672678979,1672680330,1351
10474,3434052463,3403870769,1672657862,1672660254,2392
11741,3516153301,3311260898,1672702448,1672704913,2465
11098,3509355477,3772844451,1672618934,1672621754,2820
10476,3351153781,3395615598,1672669290,1672669688,398
10945,3477248170,3511500932,1672538720,1672539673,953
11515,3426207439,3513800589,1672553157,1672554965,1808
11187,3666823095,3783679478,1672641730,1672643010,1280
11048,3471996194,3501208658,1672654587,1672657907,3320
11527,3928421417,3354877289,1672683993,1672684402,409
10134,3520470646,3897107253,1672624039,1672624620,581
11095,3701004302,3284865931,1672599469,1672601144,1675
11035,3772188086,3612042508,1672700102,1672700745,643
11362,3203457161,3664719070,1672596133,1672598790,2657
10688,3299587876,3922301238,1672692680,1672693738,1058
10104,3783122313,3285515107,1672668327,1672671704,3377
11263,3272838634,3512072679,1672533459,1672536430,2971
11317,3308759754,3373802545,1672702396,1672705083,2687
10573,3850735936,3311771689,1672547688,1672548896,1208
10183,3711171132,3793719515,1672635380,1672636756,1376
10544,3773394570,3792107875,1672686826,1672690410,3584
11700,3770941125,3755154460,1672564563,1672567560,2997
10572,3335055096,3755989680,1672635818,1672636954,1136
9890,3755584983,3856129522,1672539532,1672540481,949
9973,3760420315,3660176760,1672683046,1672684677,1631
11572,3517195738,3514980025,1672660561,1672661136,575
9964,3505593034,3505438826,1672601924,1672603978,2054
11405,3510240661,3366801723,1672544344,1672544502,158
11099,3756761603,3302929858,1672680065,1672682848,2783
10738,3501828287,3482687604,1672563738,1672565081,1343
9845,3779689733,3929355087,1672556580,1672557555,975
11288,3357097510,3312946269,1672587851,1672591193,3342
10550,3309651238,3701887470,1672568967,1672571872,2905
10375,3380628097,3420854927,1672629279,1672629830,551
11367,3921736061,3518335611,1672639941,1672641702,1761
10058,3384713976,3770630937,1672601685,1672605251,3566
11749,3773017746,3714435747,1672584133,1672586821,2688
11212,3334488428,3625931630,1672611630,1672613004,1374
11737,3791584994,3756717136,1672586482,1672589934,3452
11515,3389367628,3792708936,1672596122,1672598049,1927
10598,3835599049,3509508477,1672703223,1672706644,3421
10925,3403150349,3474879231,1672550038,1672552339,2301
11365,3452389513,3773891827,1672693288,1672696178,2890
10271,3311414429,3687183789,1672684346,1672685097,751
11557,3348343425,3688768189,1672564223,1672564829,606
10110,3882580580,3382746533,1672606852,1672607555,703
10425,3791070926,3773378103,1672614377,1672616529,2152
10733,3716467469,3780786276,1672607917,1672608134,217
10466,3736056340,3313795594,1672693658,1672695527,1869
11274,3637522163,3780500764,1672603888,1672605848,1960
11613,3311805161,3513111053,1672683907,1672684872,965
10981,3783277159,3295691964,1672560557,1672563973,3416
10213,3303432071,3793860209,1672654335,1672656291,1956
9828,3351856699,3777498160,1672531866,1672532587,721
10815,3533628528,3736036532,1672544543,1672547719,3176
10948,3512337054,3290060215,1672658826,1672661928,3102
11221,3760271237,3615245840,1672673628,1672676592,2964
11440,3500863429,3380281484,1672640611,1672643921,3310
11341,3308149799,3631444265,1672584783,1672587352,2569
9853,3518794921,3927365255,1672532738,1672534276,1538
10624,3733915784,3710149975,1672654826,1672655619,793
10021,3818532143,3512638952,1672596438,1672598488,2050
10169,3823600319,3938409715,1672688687,1672689792,1105
10468,3774782065,3711810268,1672660599,1672661056,457
10043,3224053074,3793783685,1672580601,1672581755,1154
10757,3501976169,3783826338,1672611229,1672611472,243
10583,3716233100,3756119976,1672690697,1672693596,2899
10833,3893932944,3701311947,1672556080,1672558009,1929
9969,3514352989,3773083407,1672621088,1672623103,2015
9920,3835982340,3715490209,1672601469,1672603719,2250
11238,3880788853,3377250778,1672584544,1672585684,1140
11529,3453464785,3880562532,1672654626,1672655971,1345
10675,3391612879,3887918622,1672698675,1672700061,1386
10543,3710585241,3373851012,1672668954,1672672099,3145
10137,3852275715,3552309108,1672675012,1672677140,2128
9836,3200785194,3516359146,1672545812,1672546414,602
10700,3519937708,3619676231,1672620419,1672623358,2939
11416,3244397548,3500799617,1672566579,1672568812,2233
10403,3773895671,3850735936,1672625095,1672627490,2395
11505,3755107521,3935569749,1672699772,1672699863,91
10707,3714142299,3793497672,1672614176,1672615039,863
11762,3776593726,3772489471,1672562196,1672565311,3115
10330,3374552204,3519730914,1672554207,1672556765,2558
11173,3509379617,3783067048,1672637819,1672638119,300
11574,3774316305,3792063616,1672607521,1672610094,2573
11107,3856601074,3429047448,1672635397,1672638279,2882
9890,3510919509,3971051020,1672663583,1672664715,1132
11760,3783594246,3358385652,1672691462,1672691591,129
10720,3437023385,3898592058,1672643440,1672646636,3196
10740,3774921252,3611570003,1672655045,1672657735,2690
11511,3500211484,3774205060,1672663026,1672663664,638
10435,3776166086,3424997707,1672571980,1672575534,3554
10302,3814672661,3710173412,1672613945,1672615296,1351
10920,3519356606,3931028233,1672565675,1672568245,2570
11340,3301369282,3793902476,1672635937,1672636106,169
10802,3318224774,3625931630,1672659220,1672661616,2396
11268,3898965585,3912878303,1672557021,1672559277,2256
11312,3760525465,3893950585,1672592674,1672595717,3043
11168,3808442442,3512504247,1672640224,1672642586,2362
11745,3778544203,3737946004,1672666756,1672668145,1389
10324,3778695895,3773852157,1672655589,1672657673,2084
11678,3792063616,3519831322,1672674209,1672674489,280
10912,3419762444,3623512088,1672586646,1672590029,3383
11331,3310737478,3516321814,1672592579,1672595302,2723
10968,3500073824,3756784813,1672667669,1672670779,3110
11740,3228056289,3370751461,1672613032,1672613281,249
10455,3710861700,3774606418,1672550204,1672551950,1746
11344,3824259677,3313579674,1672634666,1672635772,1106
11485,3513384042,3247075753,1672657899,1672659696,1797
10496,3773161055,3514980025,1672695758,1672696553,795
10646,3440991826,3711367577,1672596643,1672597737,1094
11156,3730115019,3714718326,1672572386,1672575037,2651
10574,3220987526,3716492409,1672601555,1672602018,463
11322,3793704155,3828906027,1672567715,1672568098,383
10001,3278251248,3480560014,1672669752,1672670452,700
10738,3358675021,3494157939,1672670604,1672672686,2082
10170,3806471413,3714645218,1672617048,1672617419,371
9980,3713636175,3518408734,1672587303,1672589917,2614
10151,3500928990,3772689657,1672609477,1672609666,189
10855,3406937294,3701359045,1672629696,1672633183,3487
10087,3770925016,3533030343,1672579421,1672580105,684
10029,3276393542,3666367524,1672652338,1672653957,1619
11519,3971996397,3622729771,1672567836,1672568420,584
11495,3400545490,3275751794,1672540027,1672541573,1546
9845,3311515179,3756642173,1672662582,1672664478,1896
11215,3438818153,3774946684,1672570348,1672573268,2920
10833,3515304526,3730052916,1672558679,1672559004,325
11756,3701529552,3534531061,1672673976,1672676289,2313
10105,3792267993,3937747312,1672539862,1672543296,3434
10141,3792578118,3305093237,1672536236,1672538837,2601
10353,3520395850,3534531039,1672699131,1672701957,2826
10127,3534589501,3836586875,1672693443,1672696272,2829
11544,3713170867,3757592622,1672618564,1672620222,1658
11050,3287920864,3823600319,1672625168,1672627501,2333
10992,3471177177,3902548260,1672693318,1672696854,3536
10703,3772019557,3236948071,1672618082,1672619749,1667
10771,3520697518,3931028233,1672654492,1672657466,2974
10795,3897851509,3851451801,1672563025,1672566521,3496
11707,3837271330,3730600658,1672660307,1672662900,2593
11491,3246062632,3534531039,1672636872,1672639897,3025
10234,3500555856,3772112976,1672637876,1672641343,3467
9988,3932919664,3519165527,1672653230,1672656692,3462
11416,3899970524,3512826895,1672610032,1672610587,555
9931,3902292032,3780467276,1672658662,1672659719,1057
9809,3343767438,3760656396,1672657805,1672658816,1011
9864,3776319560,3711190257,1672581430,1672581495,65
10186,3778824229,3774195369,1672565133,1672568499,3366
10338,3239279744,3509377714,1672543902,1672546989,3087
10505,3703481882,3807646028,1672581819,1672582279,460
11144,3316821313,3505500665,1672677393,1672680568,3175
11220,3500776597,3533974355,1672639821,1672642307,2486
11595,3886837151,3509297453,1672559403,1672562223,2820
10568,3493047640,3887918622,1672634077,1672635744,1667
10381,3625931630,3514761434,1672689129,1672689781,652
11682,3518335611,3480418192,1672553692,1672555841,2149
11158,3773895671,3935444008,1672672787,1672676136,3349
10673,3273242177,3515405509,1672579896,1672579968,72
10530,3613703906,3224053840,1672686258,1672687318,1060
9927,3392573386,3444453261,1672684448,1672685126,678
10874,3423217578,3428788958,1672610091,1672612732,2641
10482,3285136057,3205161801,1672677177,1672679456,2279
10025,3701519251,3223796145,1672652294,1672654435,2141
11736,3776455762,3935444008,1672610859,1672614200,3341
10607,3777499535,3505032644,1672567464,1672569190,1726
10430,3301765144,3302988745,1672678519,1672680356,1837
10385,3716801088,3932566114,1672635094,1672635936,842
11480,3514685272,3774706478,1672572447,1672574436,1989
10152,3516067011,3756784813,1672551025,1672552908,1883
11249,3444453261,3203172170,1672659162,1672659636,474
10719,3793926338,3557324887,1672594297,1672595828,1531
9906,3311015817,3760656396,1672621037,1672621563,526
11556,3347996015,3900540310,1672685755,1672687401,1646
10871,3773895671,3516572212,1672636536,1672637643,1107
10677,3907039612,3916924978,1672608279,1672610963,2684
10687,3738760498,3466655775,1672544710,1672546235,1525
10751,3711258452,3773408491,1672701480,1672704130,2650
10988,3344710271,3533473206,1672552301,1672555324,3023
10368,3780435349,3519553933,1672676602,1672678664,2062
10825,3236206821,3925175853,1672653837,1672654075,238
11525,3349475873,3814289471,1672558293,1672560059,1766
11275,3387322545,3817376705,1672643786,1672646626,2840
9936,3294821709,3832002939,1672599813,1672600428,615
10483,3902682060,3414510793,1672607463,1672608577,1114
11443,3793987483,3701350519,1672699486,1672700622,1136
10488,3311331205,3505845400,1672548504,1672551316,2812
11388,3505248368,3667072319,1672668128,1672670963,2835
10558,3619796619,3827981800,1672701397,1672702744,1347
11212,3902548260,3511311554,1672640221,1672642921,2700
10023,3791825536,3500785888,1672604796,1672607045,2249
11638,3774273260,3715126587,1672678268,1672679052,784
10925,3931319307,3500473064,1672682320,1672683641,1321
10731,3400793223,3408828584,1672628440,1672628699,259
10821,3505482210,3756345026,1672559249,1672559346,97
11121,3533876927,3499820963,1672597038,1672597464,426
10106,3703611876,3791236983,1672632822,1672635527,2705
11265,3773408491,3760901975,1672703091,1672706633,3542
10887,3509317776,3501873139,1672564518,1672564737,219
10234,3898989233,3400793223,1672536934,1672539999,3065
11535,3793987483,3887382548,1672644614,1672647293,2679
11090,3352295704,3770533675,1672619664,1672619893,229
9893,3295710494,3500595432,1672569146,1672570003,857
10028,3230612965,3509379617,1672620122,1672620806,684
11078,3291617477,3274739459,1672553151,1672556215,3064
10368,3517756624,3415562576,1672614942,1672616634,1692
10564,3296970170,3517530943,1672678833,1672680683,1850
10243,3352374868,3209075485,1672681141,1672682583,1442
10871,3519297683,3353811455,1672532535,1672535066,2531
10257,3520926977,3701534043,1672636906,1672639828,2922
11500,3772968080,3319862687,1672573458,1672573636,178
10081,3348343425,3701296091,1672641838,1672643039,1201
10852,3907390925,3517800171,1672616272,1672617592,1320
11117,3733423371,3226913558,1672683545,1672684803,1258
11473,3432050858,3318590083,1672646464,1672649066,2602
11758,3505032773,3668154066,1672653364,1672654721,1357
10327,3336225953,3770846374,1672564427,1672565127,700
11257,3310021925,3689223632,1672677232,1672678723,1491
11465,3856975623,3368441333,1672661136,1672663913,2777
11002,3639503148,3924366353,1672559995,1672562975,2980
11421,3716445184,3881579907,1672560825,1672562854,2029
10245,3791194984,3319645922,1672634861,1672638349,3488
11112,3916656185,3603452936,1672580396,1672583321,2925
9869,3246395239,3971447562,1672685004,1672685540,536
11252,3534537581,3311479294,1672659759,1672662009,2250
10718,3287920864,3359351267,1672582028,1672584331,2303
10588,3366501813,3505980138,1672656613,1672659358,2745
9872,3520697518,3621629499,1672583526,1672585288,1762
10530,3973138649,3501171785,1672628367,1672629900,1533
11258,3285587972,3469370398,1672599069,1672602060,2991
10854,3509562377,3825082811,1672563519,1672563737,218
11281,3382757142,3711223297,1672643096,1672643537,441
11129,3757513651,3730052916,1672577672,1672581070,3398
10430,3772962072,3755192104,1672646632,1672647856,1224
11033,3533036499,3520189871,1672569747,1672569888,141
11739,3756272704,3755229631,1672665912,1672668539,2627
11019,3773408491,3615245840,1672581627,1672582390,763
10355,3515577866,3500555856,1672562798,1672563709,911
9807,3893527651,3500011591,1672599271,1672599586,315
9970,3533929043,3533427742,1672695389,1672695549,160
11303,3355903597,3403120725,1672575047,1672575293,246
11070,3778695895,3284334297,1672647076,1672649081,2005
10284,3304697982,3310961923,1672606577,1672608085,1508
10491,3372079985,3778842400,1672656207,1672657745,1538
11130,3497138014,3884180202,1672645688,1672648897,3209
10864,3534374523,3272096922,1672681472,1672684330,2858
11021,3438818153,3514776568,1672558647,1672561529,2882
10007,3783730769,3935256825,1672554973,1672557608,2635
10875,3776617627,3977337501,1672581894,1672582397,503
11418,3791224239,3203837944,1672565174,1672566298,1124
10800,3899294071,3334936138,1672551316,1672551498,182
10338,3516153301,3666958814,1672536552,1672539539,2987
10674,3516819320,3778819352,1672606169,1672609017,2848
11016,3772227820,3713878219,1672692500,1672695791,3291
10335,3360837082,3780964089,1672700656,1672702001,1345
9898,3271282663,3604908372,1672603534,1672606801,3267
10578,3713107380,3855209450,1672601382,1672601876,494
11606,3494157939,3780969898,1672665895,1672668732,2837
10745,3501126057,3701060732,1672626423,1672628644,2221
11055,3505769529,3559619861,1672556359,1672559366,3007
10786,3443004958,3815184540,1672656125,1672658159,2034
10317,3482172065,3770544738,1672622926,1672626300,3374
9838,3663353552,3927763819,1672656536,1672657710,1174
11386,3803382101,3500630465,1672631971,1672632446,475
11159,3805926853,3284407073,1672580863,1672583329,2466
11471,3364302157,3534696810,1672680880,1672682089,1209
10007,3308965136,3500695402,1672606771,1672609238,2467
10338,3791509334,3976225898,1672640271,1672641387,1116
9811,3207586072,3773826624,1672628615,1672628708,93
10313,3318250647,3737738751,1672632353,1672635462,3109
10338,3701041860,3514327931,1672586683,1672587611,928
11079,3395565040,3839417558,1672555409,1672558994,3585
11682,3240877710,3447591143,1672586518,1672587606,1088
11506,3716526314,3384151770,1672680020,1672683053,3033
10563,3509355477,3760385591,1672581956,1672584873,2917
11684,3931164237,3779413388,1672553813,1672554933,1120
10289,3342368576,3509996827,1672682671,1672685835,3164
9812,3422460919,3285201542,1672539666,1672542525,2859
10970,3778695017,3777263928,1672683952,1672686602,2650
11434,3711718368,3611298237,1672671064,1672672033,969
10287,3774946684,3928421417,1672669748,1672670764,1016
10895,3304030474,3831981073,1672696859,1672700377,3518
10009,3713875941,3387413950,1672555348,1672557047,1699
11654,3666823095,3703476890,1672621914,1672623698,1784
10442,3388537708,3501583486,1672626089,1672628086,1997
11521,3701887470,3905955166,1672579170,1672579239,69
11731,3760481622,3204473480,1672608017,1672611240,3223
11064,3307236682,3271282663,1672702200,1672703428,1228
11029,3855629383,3757872458,1672606917,1672610077,3160
9823,3514564903,3440743218,1672661728,1672663829,2101
11008,3792021895,3520165730,1672669410,1672671914,2504
11374,3467944159,3311037445,1672576937,1672579011,2074
10168,3415032547,3757032266,1672634629,1672635790,1161
10146,3519322066,3757212744,1672628827,1672629604,777
10752,3365519448,3630462406,1672618075,1672618797,722
10286,3835509670,3701779683,1672537422,1672540133,2711
11142,3710149975,3332840671,1672549013,1672549081,68
11582,3773475506,3710119555,1672569336,1672572071,2735
10598,3880637958,3515753241,1672587357,1672588337,980
11572,3500198430,3422915648,1672633549,1672634758,1209
10283,3487231844,3908878965,1672608618,1672608764,146
11204,3922786716,3394394262,1672558967,1672561108,2141
10039,3302348002,3826418889,1672550087,1672553393,3306
9824,3519465545,3783730769,1672621144,1672622404,1260
10400,3772968080,3304661369,1672694818,1672695109,291
11753,3793814153,3602401154,1672596661,1672599490,2829
11143,3534372899,3855222429,1672644033,1672644376,343
10791,3791994414,3519000878,1672688344,1672689611,1267
10787,3624365837,3711065081,1672700313,1672702779,2466
11636,3757660578,3510486220,1672584166,1672584759,593
10743,3512641538,3778842400,1672548438,1672548958,520
11704,3779174993,3931917809,1672590496,1672592361,1865
11743,3372596013,3308481706,1672587880,1672591154,3274
11332,3430296808,3757446082,1672534015,1672534131,116
11766,3311904032,3278251248,1672701973,1672703713,1740
10041,3552261072,3907088952,1672601067,1672602817,1750
10697,3440991826,3311514075,1672679862,1672682937,3075
10690,3533627473,3811419378,1672606839,1672609866,3027
10896,3505531432,3711770773,1672685861,1672688198,2337
9797,3783408830,3925208102,1672557415,1672557763,348
11309,3445733121,3757128722,1672589958,1672593042,3084
9951,3501126057,3224824355,1672620074,1672622194,2120
10999,3406101720,3756850160,1672694251,1672696692,2441
11125,3505825767,3665603628,1672670207,1672672616,2409
11720,3439532406,3517440258,1672639008,1672642266,3258
11335,3776034313,3500889287,1672620708,1672622996,2288
10009,3637566026,3347996015,1672631497,1672633982,2485
11185,3428325402,3377883705,1672626233,1672628915,2682
11256,3420854927,3492728794,1672631040,1672633131,2091
10829,3856699097,3499142934,1672590268,1672592190,1922
10090,3501843187,3493047640,1672561494,1672562822,1328
10656,3703697059,3500211484,1672652397,1672654768,2371
9996,3755229631,3485468650,1672667380,1672667705,325
10314,3792719263,3755357292,1672546697,1672548210,1513
9943,3601214648,3755989680,1672553291,1672556808,3517
11583,3229734741,3778605154,1672664674,1672668161,3487
10687,3505266343,3605101443,1672702659,1672705679,3020
11088,3313824913,3901169230,1672599184,1672601268,2084
11308,3416079461,3738429905,1672550292,1672551394,1102
9811,3452024572,3516335333,1672625908,1672628399,2491
10146,3510262025,3884001167,1672660262,1672662229,1967
10262,3776841808,3755075988,1672562138,1672562490,352
10028,3558264627,3619538249,1672622197,1672623225,1028
10682,3881785069,3517991042,1672604465,1672607011,2546
10704,3714283424,3756525103,1672668512,1672670405,1893
10873,3205161801,3472561941,1672594251,1672595363,1112
10278,3894495222,3294326116,1672622176,1672622718,542
11503,3513661302,3359880163,1672544142,1672547517,3375
10813,3412605548,3793920312,1672594334,1672595306,972
11029,3601063076,3394394262,1672692183,1672693716,1533
10303,3491758029,3533201269,1672586930,1672590204,3274
11129,3780013266,3510826414,1672702614,1672703388,774
10512,3243056734,3341129425,1672676623,1672677682,1059
11448,3806034626,3316121649,1672625155,1672627640,2485
9860,3920526713,3437703650,1672593445,1672596362,2917
10313,3305093237,3756079870,1672641327,1672643187,1860
11433,3500019810,3352044245,1672590192,1672592030,1838
11598,3356599815,3851810349,1672579153,1672579752,599
10062,3738429905,3519621901,1672687608,1672689156,1548
11155,3277634944,3222357355,1672702505,1672704765,2260
10825,3760024021,3714067998,1672539765,1672540729,964
10477,3238056215,3637566026,1672660061,1672662549,2488
10048,3534362749,3701865589,1672552117,1672553185,1068
11475,3516103646,3711862792,1672599967,1672601283,1316
11035,3685877449,3406101720,1672646134,1672649189,3055
11719,3514341451,3733243990,1672702604,1672703555,951
10639,3662507634,3774682234,1672591823,1672595389,3566
11194,3857389270,3462985379,1672678091,1672681119,3028
10091,3613703906,3480108752,1672641665,1672644322,2657
10550,3713996094,3735152111,1672531399,1672533336,1937
10261,3791688526,3505560793,1672607328,1672609675,2347
11731,3366501813,3519055736,1672567978,1672569245,1267
10091,3226037966,3710316008,1672698237,1672698673,436
9837,3714525519,3500821475,1672535406,1672538724,3318
10163,3888409038,3760443176,1672603637,1672604719,1082
10271,3710487368,3664478769,1672649337,1672651044,1707
10335,3488988274,3517331746,1672589713,1672592284,2571
11209,3783157469,3774921252,1672600197,1672600300,103
9968,3715039960,3411626917,1672634753,1672637296,2543
10965,3774744663,3919345990,1672536794,1672538362,1568
11495,3402580733,3774673193,1672639952,1672640896,944
10470,3793497672,3520506192,1672617556,1672619086,1530
10933,3715419141,3286862903,1672615794,1672618088,2294
11357,3311739926,3739567072,1672627459,1672630622,3163
10359,3902023467,3404187438,1672622156,1672622770,614
10291,3716609198,3791825536,1672664875,1672668202,3327
11255,3438028077,3500695402,1672655389,1672658754,3365
11092,3512857020,3826068495,1672577937,1672580343,2406
9894,3893043842,3317989975,1672639817,1672643138,3321
11072,3355430975,3293898029,1672587021,1672588380,1359
10273,3783935976,3623512088,1672535923,1672537298,1375
11723,3732871856,3668855144,1672697742,1672699409,1667
9824,3379517265,3305727497,1672647915,1672648869,954
11598,3886837151,3715737742,1672537410,1672538240,830
11166,3347760784,3516429380,1672536000,1672536353,353
9798,3423800775,3500776597,1672678927,1672679022,95
11642,3500785888,3916656185,1672560060,1672560838,778
11204,3776166086,3478915403,1672568415,1672571334,2919
11769,3520016705,3344710271,1672677452,1672680419,2967
11187,3379076106,3826068495,1672542194,1672542319,125
11728,3711187791,3738160394,1672657665,1672660799,3134
10173,3778702093,3361952532,1672696114,1672698619,2505
10528,3792337863,3427049290,1672576690,1672577840,1150
10837,3757549235,3756149282,1672584398,1672585708,1310
10995,3534696810,3779454060,1672665620,1672668567,2947
11446,3394986304,3554317844,1672675456,1672678015,2559
10721,3669283586,3711214982,1672568766,1672569114,348
10320,3732846295,3772905073,1672667451,1672670255,2804
10787,3368951504,3463883997,1672654998,1672658484,3486
10012,3757855416,3424425746,1672617322,1672620418,3096
11232,3895839169,3358211034,1672686740,1672688009,1269
10341,3703588004,3813986705,1672685678,1672687068,1390
9854,3396440259,3772556646,1672561594,1672563324,1730
10332,3668063289,3772114731,1672652842,1672654433,1591
11411,3710622746,3304252969,1672531689,1672532389,700
9881,3884933821,3558349840,1672687346,1672687804,458
11071,3239401337,3756736726,1672648788,1672650455,1667
11323,3319585148,3836757034,1672654491,1672655786,1295
10523,3780148144,3510795808,1672613444,1672615397,1953
10692,3505685294,3836757034,1672571591,1672572892,1301
10006,3338642026,3716423829,1672536634,1672537487,853
9912,3338465050,3778713526,1672602277,1672604192,1915
10845,3505908965,3459799131,1672640173,1672640555,382
11732,3512411326,3500317923,1672595486,1672596226,740
11706,3777499535,3811503860,1672647845,1672648493,648
11065,3505351253,3714731729,1672563495,1672565837,2342
10189,3534988162,3277061226,1672549600,1672550800,1200
11178,3770273966,3519108639,1672602663,1672605701,3038
10059,3387989658,3917905192,1672598328,1672600001,1673
11646,3512477276,3713807753,1672656236,1672658606,2370
10367,3791245127,3515284733,1672561977,1672562256,279
10634,3756119976,3919494952,1672598334,1672598797,463
11480,3970775805,3341129425,1672534842,1672537069,2227
11258,3773432494,3510278533,1672671539,1672674473,2934
10149,3236563828,3500741005,1672605770,1672609013,3243
11220,3338187803,3902357342,1672669054,1672669149,95
11769,3613216900,3435159896,1672559806,1672560915,1109
9998,3510750299,3715441777,1672549335,1672552297,2962
11368,3757378286,3288920399,1672698021,1672700520,2499
11758,3358211034,3206544535,1672546227,1672548991,2764
11776,3777290300,3491527603,1672581980,1672585169,3189
10872,3920155862,3424425746,1672701594,1672703364,1770
11194,3902023467,3772893815,1672557541,1672557989,448
10325,3400025324,3760749218,1672589182,1672590899,1717
9902,3710919244,3715923089,1672607028,1672608280,1252
10085,3710622746,3284334297,1672588486,1672590535,2049
11641,3613940925,3440401725,1672593514,1672593735,221
10431,3310961923,3294164983,1672584837,1672587194,2357
11217,3881579907,3514021667,1672685037,1672686434,1397
9946,3513800589,3710865678,1672533227,1672533856,629
10363,3713444403,3911821258,1672700794,1672701019,225
11555,3713920790,3409098014,1672600591,1672603651,3060
10387,3360972732,3370448531,1672672768,1672675706,2938
11781,3780626668,3912625932,1672574560,1672574705,145
10816,3773853619,3513508737,1672557825,1672559565,1740
11729,3509208005,3970775805,1672641569,1672644830,3261
10665,3713920790,3735838864,1672603442,1672606258,2816
11571,3390368796,3776950532,1672665651,1672668407,2756
11791,3403988682,3660257653,1672648508,1672650657,2149
10460,3778838936,3500630465,1672591621,1672592422,801
11347,3713767153,3414510793,1672624762,1672627168,2406
11609,3365519448,3223512565,1672592777,1672595880,3103
11614,3637522163,3793926338,1672651683,1672654058,2375
10361,3710223875,3770925016,1672671816,1672673380,1564
10851,3242149533,3437108337,1672601141,1672604530,3389
10248,3285322570,3359418136,1672631309,1672631573,264
10461,3534696810,3733243990,1672675306,1672675875,569
11561,3915460293,3516904926,1672644923,1672645705,782
10362,3517949586,3774682234,1672684468,1672686776,2308
11080,3716423829,3755670258,1672538426,1672538980,554
11464,3852310652,3311805161,1672536297,1672537400,1103
11446,3534543864,3774325486,1672546213,1672548648,2435
10959,3919342147,3770925016,1672620038,1672621939,1901
10849,3505825767,3814770073,1672611001,1672611271,270
11093,3836757034,3447938130,1672540081,1672541426,1345
10793,3514541800,3772251279,1672581151,1672584111,2960
11594,3395565040,3715008501,1672626778,1672628095,1317
11225,3711029952,3714250543,1672635030,1672636036,1006
11697,3289017988,3410602007,1672537567,1672537845,278
9902,3929923442,3828354855,1672679429,1672682029,2600
10963,3978417055,3756642173,1672560035,1672560860,825
10468,3517021928,3517558635,1672634122,1672634336,214
11045,3286938590,3500695402,1672571974,1672574860,2886
11131,3534111498,3770105006,1672558178,1672560148,1970
9964,3519162582,3686860179,1672638588,1672641117,2529
11663,3711854614,3512072679,1672561414,1672564830,3416
10870,3500073824,3853182912,1672543472,1672543698,226
10259,3619796619,3850181934,1672669413,1672671996,2583
10141,3701512498,3311739926,1672633137,1672636298,3161
10040,3514508773,3733836732,1672587339,1672587914,575
10771,3777060250,3711430738,1672598885,1672599949,1064
10534,3736010012,3354405535,1672636560,1672639805,3245
10086,3520273299,3858330969,1672607242,1672607997,755
10459,3629248353,3682802569,1672674838,1672676022,1184
11108,3793407883,3909632424,1672633757,1672634614,857
11364,3686860179,3858429342,1672580438,1672582940,2502
10039,3286862903,3857244486,1672685831,1672688161,2330
11429,3418683594,3916463490,1672698554,1672699434,880
10641,3436099135,3916924978,1672664029,1672666718,2689
11408,3511969443,3533859712,1672700051,1672701871,1820
11317,3311924005,3711190257,1672682342,1672684539,2197
10304,3310702648,3735838864,1672666809,1672670125,3316
11162,3382696725,3249771731,1672675811,1672677703,1892
11407,3476958001,3519553933,1672657301,1672659960,2659
11608,3911376818,3770709417,1672538692,1672539669,977
11366,3472272792,3686860179,1672649865,1672653024,3159
10832,3636605690,3934991640,1672560509,1672560786,277
10157,3780612543,3393955069,1672554400,1672555927,1527
10653,3927365255,3773688906,1672609375,1672610645,1270
11345,3793274846,3613781977,1672584754,1672585654,900
11461,3516340010,3778253021,1672544310,1672545704,1394
10546,3491390365,3665478011,1672646865,1672650410,3545
10451,3316406470,3505521491,1672558106,1672559949,1843
11332,3773895671,3401215739,1672575675,1672577272,1597
11762,3776447604,3359472956,1672590385,1672590760,375
10808,3273674596,3884394685,1672693940,1672695793,1853
10049,3298706213,3755865626,1672650066,1672651736,1670
10728,3519621901,3783201950,1672681599,1672681747,148
10795,3823307824,3534758256,1672594181,1672596525,2344
10901,3772169046,3613936929,1672588492,1672591410,2918
11750,3509626590,3408982612,1672690608,1672694199,3591
10215,3792063616,3404375908,1672692297,1672695596,3299
10596,3772845364,3500342408,1672587259,1672587509,250
11777,3632720032,3534111498,1672669899,1672672600,2701
10707,3510882475,3773826624,1672561502,1672562944,1442
11316,3270607273,3835262447,1672536044,1672538135,2091
10090,3378172464,3228477490,1672540628,1672542033,1405
10933,3804075198,3776811587,1672641086,1672644530,3444
10696,3666367524,3345954031,1672637479,1672638842,1363
10566,3273537848,3378747834,1672661350,1672664841,3491
11618,3770671714,3511415786,1672621023,1672624289,3266
11534,3509651954,3415032547,1672617906,1672619936,2030
11744,3415840750,3501976169,1672698971,1672700102,1131
10146,3209075485,3501988762,1672561574,1672562183,609
11715,3760481622,3513996288,1672604349,1672605337,988
9975,3738429905,3714787207,1672617347,1672619104,1757
11469,3855977674,3636877469,1672646323,1672647660,1337
11475,3511289729,3830599959,1672672164,1672673671,1507
11730,3922480066,3382670400,1672697709,1672700040,2331
11226,3703659324,3225554956,1672644157,1672647101,2944
10980,3772425253,3760776967,1672644772,1672645154,382
9954,3880549316,3516819320,1672671273,1672672265,992
11401,3703502114,3896200048,1672668895,1672671205,2310
10769,3380357490,3774939922,1672572363,1672575829,3466
10271,3619796619,3978643889,1672536986,1672540221,3235
10453,3714688409,3313282478,1672657426,1672659789,2363
10039,3896123242,3971051020,1672672229,1672674298,2069
11252,3201957157,3441336851,1672570419,1672572443,2024
10905,3701385831,3493515706,1672662181,1672665673,3492
11322,3474350534,3818236682,1672664378,1672665440,1062
11250,3939851140,3201656220,1672677589,1672679617,2028
10911,3777715675,3792255406,1672549578,1672549690,112
10407,3512769522,3853275529,1672555989,1672557787,1798
10316,3806034626,3793274846,1672640459,1672641952,1493
11441,3311739926,3298831109,1672563341,1672565001,1660
10825,3834643026,3385006834,1672591355,1672593939,2584
11147,3715320359,3833993674,1672645557,1672646955,1398
10830,3615846003,3715852330,1672607669,1672608107,438
10576,3231153513,3908862092,1672668804,1672670829,2025
10676,3757607649,3491335890,1672546411,1672546731,320
11672,3738103378,3375905193,1672602272,1672605329,3057
11293,3669427589,3932955949,1672646635,1672646917,282
11512,3772802020,3770564547,1672612796,1672614447,1651
11323,3811503860,3682802569,1672678274,1672679002,728
10973,3418367752,3908177413,1672641544,1672642840,1296
10448,3912915644,3810818108,1672538118,1672538319,201
11059,3714806574,3284334297,1672629611,1672630024,413
10344,3397330170,3334381941,1672598823,1672599790,967
11156,3760271237,3509912164,1672627515,1672627663,148
11577,3772114731,3511671476,1672681846,1672683491,1645
10703,3283106998,3617771673,1672675165,1672678129,2964
9931,3938021614,3703419800,1672699762,1672702445,2683
9872,3510178791,3509370016,1672583300,1672583725,425
10002,3760271237,3716341323,1672702552,1672703107,555
11334,3773876312,3783201950,1672696575,1672697110,535
10830,3231271498,3895507040,1672632305,1672634296,1991
10013,3334381941,3222364320,1672663030,1672665285,2255
10778,3919258737,3757924067,1672676629,1672679203,2574
10132,3772343750,3774606418,1672561801,1672562014,213
11764,3773899531,3441336851,1672680296,1672681509,1213
10119,3814289471,3822496670,1672598464,1672599919,1455
11522,3487622510,3342235058,1672637072,1672639964,2892
11686,3772489471,3313298164,1672690501,1672691313,812
9939,3374652108,3519908593,1672571176,1672572012,836
11221,3612705426,3774598935,1672692834,1672693173,339
10415,3505234868,3774355339,1672603038,1672604617,1579
9798,3516497645,3489340327,1672617941,1672618281,340
11749,3603682643,3516585063,1672582280,1672582399,119
11307,3714377201,3443521234,1672619727,1672620550,823
11281,3733123020,3505560793,1672559346,1672560805,1459
11500,3397972945,3515804844,1672686532,1672689674,3142
11456,3627377299,3757064623,1672684476,1672686595,2119
11466,3311015817,3791236983,1672622356,1672624976,2620
9910,3518882056,3793232021,1672677964,1672680421,2457
10654,3713740434,3555764822,1672686188,1672688444,2256
10704,3343193067,3375257546,1672688398,1672689989,1591
10314,3505190512,3516249472,1672606629,1672607888,1259
9960,3512492332,3483701493,1672660287,1672663791,3504
11494,3501977123,3760443176,1672635258,1672638031,2773
11397,3770941125,3755154460,1672555078,1672558588,3510
10222,3501619113,3921736061,1672535934,1672538926,2992
10014,3499622352,3424425746,1672603951,1672607184,3233
10472,3897500723,3334461288,1672546785,1672548704,1919
10004,3793899166,3792851584,1672616402,1672617319,917
10635,3739820448,3805718871,1672559207,1672559339,132
9988,3279851026,3825877848,1672580071,1672581589,1518
10759,3906874577,3669140241,1672662077,1672663407,1330
10364,3227874229,3685396470,1672654521,1672655865,1344
10440,3434452046,3500429731,1672645823,1672648822,2999
10047,3800434325,3734233216,1672539137,1672542164,3027
11679,3517627003,3777715675,1672667869,1672668272,403
11543,3312959324,3247193800,1672606816,1672607787,971
10160,3681274982,3534206917,1672674925,1672678103,3178
11531,3701534043,3519351747,1672562246,1672562739,493
11639,3711862792,3341738186,1672679942,1672680076,134
10480,3838119022,3501115299,1672638664,1672640315,1651
11358,3533867833,3774483862,1672591312,1672591998,686
11296,3774359137,3714101349,1672665284,1672666601,1317
11496,3239401337,3971422524,1672535403,1672537256,1853
10398,3203630241,3362368123,1672696597,1672699414,2817
11266,3783554600,3902292032,1672650249,1672653023,2774
10665,3755175497,3519167605,1672656941,1672658954,2013
11026,3776583229,3361789225,1672610016,1672612657,2641
11186,3756850160,3287821258,1672653519,1672655816,2297
11331,3885674996,3516319492,1672637700,1672639611,1911
10206,3511645260,3777641081,1672694197,1672696635,2438
11579,3315432466,3405200303,1672545330,1672546112,782
10641,3428076194,3501992314,1672614606,1672617442,2836
10286,3517380144,3343193067,1672558152,1672561482,3330
9909,3621439107,3488988274,1672578640,1672581491,2851
11266,3602570831,3241593146,1672561492,1672564437,2945
11402,3225356349,3710891331,1672647459,1672648189,730
10873,3757060033,3792107875,1672533397,1672534532,1135
10621,3914947393,3518995270,1672683583,1672684611,1028
11520,3760901975,3603740088,1672572638,1672573537,899
10585,3716647407,3510542303,1672583140,1672583507,367
10163,3505314920,3517132086,1672655765,1672657226,1461
11606,3793899166,3662507634,1672579835,1672580161,326
10831,3783947742,3757212744,1672655413,1672656879,1466
9889,3488988274,3306491253,1672554480,1672557453,2973
9975,3714281795,3515100211,1672678594,1672679372,778
11091,3533867833,3515699732,1672561219,1672562255,1036
11228,3773738817,3505839395,1672622961,1672625003,2042
11586,3777405860,3802374620,1672666669,1672668732,2063
10988,3403218814,3314965818,1672606234,1672608372,2138
11571,3387870683,3805268739,1672582841,1672585528,2687
9972,3772869013,3468066881,1672662172,1672664644,2472
10263,3434052463,3703694139,1672665533,1672669119,3586
9956,3353326305,3938059867,1672695386,1672697393,2007
10124,3519937708,3298113026,1672642558,1672644345,1787
11718,3713875941,3912878303,1672579157,1672581953,2796
11492,3303552616,3359880163,1672645987,1672648579,2592
10734,3510856388,3500590302,1672689296,1672690270,974
10835,3776124041,3701685828,1672571801,1672573951,2150
10941,3793222045,3856147380,1672570768,1672572320,1552
11613,3500726347,3554437212,1672561067,1672561974,907
10985,3350631472,3780308809,1672700781,1672703542,2761
11637,3778544203,3711591464,1672533439,1672534518,1079
11578,3517800171,3776455762,1672576967,1672577742,775
10770,3471996194,3311810583,1672652334,1672654375,2041
11045,3203630241,3807717766,1672629541,1672630774,1233
10555,3533628528,3511198566,1672544921,1672545587,666
11774,3792900315,3311529105,1672680000,1672683146,3146
11123,3223144610,3714897456,1672647168,1672650499,3331
10438,3226761201,3832002939,1672678438,1672680388,1950
10514,3711671702,3478052226,1672621073,1672621911,838
9968,3424988692,3513186578,1672651945,1672654186,2241
10805,3686644062,3319436533,1672594911,1672596391,1480
11752,3600871715,3422915648,1672624460,1672624754,294
11081,3814289471,3713416106,1672589751,1672591109,1358
9894,3924963918,3513432588,1672681757,1672682960,1203
10283,3978643889,3509252934,1672640192,1672643089,2897
11488,3534537581,3519831322,1672703592,1672705686,2094
10057,3715622084,3710107905,1672608210,1672610932,2722
10151,3311771689,3778909412,1672665164,1672666677,1513
10365,3509433155,3736621212,1672608536,1672611914,3378
11150,3239423794,3471585513,1672608453,1672609454,1001
11420,3304227085,3287920864,1672626953,1672628267,1314
11089,3440305508,3600842635,1672610533,1672613930,3397
10336,3516867729,3902682060,1672574238,1672574331,93
11096,3822496670,3231859576,1672593426,1672595668,2242
11308,3770533675,3683047199,1672684354,1672684875,521
11218,3666655293,3400025324,1672606497,1672610076,3579
11062,3776001441,3792797648,1672653350,1672654478,1128
10727,3311774510,3505449070,1672620991,1672624410,3419
11372,3809194824,3485521840,1672553988,1672557588,3600
10804,3887918622,3279726491,1672637551,1672638847,1296
10224,3919258737,3855440101,1672678795,1672681582,2787
10223,3774355339,3773394570,1672540209,1672543144,2935
9837,3371184929,3279726491,1672570438,1672573702,3264
11253,3915679140,3354015456,1672615104,1672616187,1083
10545,3516706935,3822786416,1672581070,1672581638,568
10201,3713990030,3887382548,1672565141,1672568465,3324
10590,3793860209,3301403047,1672532132,1672533013,881
11498,3613547091,3520832066,1672661532,1672662781,1249
10296,3780423516,3366566029,1672694928,1672697669,2741
11540,3415803494,3833520635,1672623777,1672626854,3077
10028,3755192104,3246395239,1672692135,1672693990,1855
11422,3471996194,3509274030,1672633855,1672635678,1823
10069,3534459983,3403870769,1672605514,1672608903,3389
10334,3810949170,3900793652,1672687778,1672690726,2948
10441,3514801709,3907390925,1672629056,1672631328,2272
11523,3512087090,3515637968,1672603315,1672605297,1982
10903,3832333115,3400560073,1672559931,1672560548,617
10196,3505756991,3505980138,1672548718,1672551392,2674
11259,3714179543,3701060732,1672585401,1672586788,1387
11553,3512395783,3283295213,1672670539,1672671297,758
11521,3701865589,3776304080,1672601757,1672602102,345
10960,3629869834,3738734246,1672540028,1672542811,2783
10988,3681504869,3773953689,1672648786,1672650365,1579
9852,3480405740,3793860209,1672645853,1672648542,2689
10335,3511069449,3822496670,1672612104,1672615325,3221
10215,3793996996,3510159441,1672555186,1672557686,2500
9812,3512819376,3757796416,1672663857,1672664387,530
10164,3851515560,3380357490,1672583577,1672587060,3483
10593,3814289471,3638126174,1672607021,1672607695,674
11270,3932491622,3780956975,1672683390,1672685005,1615
11534,3450679913,3495427619,1672612579,1672613791,1212
10822,3710228292,3818324410,1672699411,1672702623,3212
10299,3821103640,3558567160,1672568902,1672569049,147
9844,3247075753,3442073613,1672657641,1672660189,2548
10593,3518209090,3509360869,1672557786,1672560245,2459
11095,3393128259,3332124606,1672611023,1672613468,2445
11161,3245755569,3498803823,1672628204,1672628688,484
10438,3835262447,3733953055,1672577942,1672579393,1451
11788,3516517348,3756850160,1672689484,1672691600,2116
11317,3777074709,3923910914,1672622844,1672624499,1655
9939,3685396470,3756876537,1672687686,1672691029,3343
11666,3716976932,3360309868,1672639115,1672641890,2775
9984,3419378107,3366961580,1672540275,1672542634,2359
10574,3804779247,3715441777,1672584518,1672586235,1717
10007,3904846341,3225371682,1672613185,1672615306,2121
10790,3683047199,3516103646,1672552451,1672554960,2509
11227,3716891903,3330799389,1672592653,1672596221,3568
9961,3399726243,3933731871,1672656303,1672656394,91
9806,3447078933,3512101369,1672574045,1672577271,3226
10385,3284334297,3738760498,1672557147,1672557933,786
10940,3441336851,3776316903,1672641729,1672643063,1334
9836,3336225953,3779212271,1672595881,1672596530,649
11140,3757128722,3715441786,1672564925,1672567682,2757
10157,3711258452,3832902787,1672661421,1672663998,2577
11495,3714903253,3736010012,1672689023,1672692230,3207
9938,3738734246,3440671139,1672627457,1672628664,1207
10318,3683677062,3669427589,1672654374,1672656214,1840
10963,3290060215,3780563627,1672592770,1672593599,829
9956,3501115299,3976400190,1672545933,1672546216,283
10015,3907923381,3519255644,1672630268,1672632146,1878
10979,3715441777,3359880163,1672635334,1672638219,2885
11336,3435652260,3637105495,1672655512,1672656089,577
11295,3514353133,3891586951,1672625287,1672627844,2557
10306,3342426430,3505500523,1672680622,1672682801,2179
10223,3439532406,3519260216,1672672154,1672673813,1659
10346,3369938668,3929002318,1672659230,1672660874,1644
11010,3811354125,3836586875,1672657821,1672658101,280
11524,3419829238,3484739955,1672687541,1672690529,2988
10571,3510250740,3668369938,1672579203,1672581801,2598
11219,3880549316,3518947256,1672619839,1672620027,188
10991,3905934770,3233965781,1672614139,1672617450,3311
11371,3501977123,3776455762,1672570336,1672572533,2197
11338,3898595916,3755769731,1672581111,1672582942,1831
10615,3935444008,3515378306,1672601623,1672604943,3320
11481,3244397548,3825234433,1672611928,1672613051,1123
10063,3613703906,3534122907,1672601021,1672603616,2595
10393,3780206849,3201957157,1672632788,1672634871,2083
11463,3780168985,3311200541,1672564753,1672566526,1773
10375,3241855333,3454924050,1672672051,1672675280,3229
10566,3379517265,3444881567,1672556293,1672557860,1567
10496,3500145103,3916463490,1672555986,1672557684,1698
10757,3888057649,3716669659,1672675313,1672676298,985
11385,3424425746,3381055770,1672553500,1672555124,1624
10969,3979366845,3791070926,1672567069,1672570209,3140
11265,3606804618,3791664049,1672567455,1672569262,1807
11027,3773041843,3733123020,1672682788,1672686142,3354
10130,3500726347,3701512498,1672576474,1672577410,936
11748,3299845453,3779818784,1672682140,1672684094,1954
10639,3445077330,3710149975,1672682272,1672683669,1397
11310,3511412229,3711223297,1672676488,1672677857,1369
10969,3311472321,3516454693,1672667032,1672668973,1941
10369,3500922040,3368441333,1672558665,1672561457,2792
9917,3279851026,3905934770,1672594256,1672594948,692
9980,3755849241,3519319233,1672625923,1672629150,3227
11592,3711767051,3514327931,1672555332,1672557820,2488
10545,3818570577,3637566026,1672673846,1672673983,137
11409,3517380144,3778819352,1672695542,1672697529,1987
10241,3390537737,3380357490,1672587431,1672590538,3107
10283,3737571883,3701028092,1672614076,1672617593,3517
10395,3829698950,3533830748,1672647297,1672650367,3070
11725,3776124041,3770408300,1672635118,1672636251,1133
10805,3714806574,3807646028,1672547769,1672551032,3263
10774,3518425740,3533960602,1672700112,1672703681,3569
10708,3286862903,3520763492,1672573184,1672576151,2967
10150,3925098136,3829358750,1672535552,1672537076,1524
9800,3371759044,3685083275,1672607538,1672610459,2921
11704,3427741923,3481019442,1672625007,1672628252,3245
10333,3779102237,3394364348,1672628183,1672629466,1283
11085,3894328297,3898989233,1672654742,1672656576,1834
11094,3359929534,3475090917,1672545381,1672548706,3325
10001,3793274846,3439045964,1672677998,1672681552,3554
9906,3515970536,3486509752,1672549636,1672549725,89
11550,3395615598,3517377614,1672645559,1672645824,265
10487,3857344874,3851515560,1672626097,1672629479,3382
11177,3907225070,3402338011,1672584742,1672585892,1150
11069,3822786416,3885339157,1672639866,1672641475,1609
11078,3270502801,3505825767,1672677818,1672680236,2418
10071,3555954355,3898989233,1672573552,1672576236,2684
9923,3756642173,3553229537,1672659376,1672660305,929
10877,3710819760,3801379377,1672603409,1672606282,2873
10425,3500444748,3510301454,1672557471,1672558305,834
11730,3494748808,3235198316,1672589937,1672592508,2571
11671,3505502819,3512417028,1672601766,1672603526,1760
11740,3710865678,3703031637,1672563056,1672565200,2144
10913,3780129338,3629869834,1672612645,1672615650,3005
9920,3404187438,3505032773,1672543477,1672545707,2230
11521,3406937294,3515637968,1672579330,1672580351,1021
11238,3907039612,3511744756,1672612601,1672613035,434
9899,3792512768,3290097447,1672566624,1672569550,2926
11703,3454151554,3884934977,1672664218,1672665058,840
10027,3442181067,3534278019,1672639105,1672639410,305
11353,3505980138,3203457161,1672595231,1672597318,2087
10086,3760749218,3620105539,1672675026,1672676006,980
11210,3512826895,3898592058,1672551715,1672552036,321
10436,3770671714,3373851012,1672689740,1672690114,374
11216,3756345026,3730226545,1672607312,1672610847,3535
10556,3512203553,3773411968,1672606531,1672609483,2952
10211,3805616707,3462153833,1672659658,1672661862,2204
11673,3713906305,3774663639,1672610591,1672613432,2841
10752,3533627473,3755849241,1672551271,1672551774,503
11218,3774359137,3512343029,1672629095,1672629996,901
11691,3511500932,3419829238,1672580119,1672581015,896
11604,3683514731,3295710494,1672557396,1672557589,193
10463,3772055279,3280208630,1672600209,1672601847,1638
10512,3774447975,3478206139,1672610901,1672611091,190
11084,3730169449,3500209015,1672622133,1672622302,169
10395,3806471413,3514853709,1672624125,1672626910,2785
10142,3365839890,3811419378,1672656617,1672659038,2421
11267,3495152069,3510373076,1672689724,1672693268,3544
10023,3500734346,3514508773,1672679344,1672680347,1003
10516,3487395357,3791547827,1672577706,1672581082,3376
11045,3907923381,3241567995,1672533030,1672535202,2172
10885,3201502111,3757678397,1672572745,1672575725,2980
10635,3701412729,3246567963,1672581242,1672583117,1875
11686,3231153513,3505331014,1672533620,1672536554,2934
10566,3772786559,3342235058,1672683211,1672683914,703
10549,3890194669,3206544535,1672575199,1672577164,1965
10449,3774682234,3505994703,1672666786,1672668656,1870
9929,3558264627,3617135064,1672694371,1672696463,2092
10322,3512337054,3505037247,1672635698,1672636683,985
11232,3514244308,3513802404,1672540702,1672540908,206
11723,3770018912,3901217668,1672631554,1672634581,3027
10774,3366433035,3791664049,1672580514,1672583565,3051
11706,3711804184,3303747093,1672676892,1672680209,3317
11021,3780074082,3701453343,1672604944,1672606622,1678
11127,3505665788,3397972945,1672652620,1672652987,367
10189,3612841103,3311414429,1672537513,1672541060,3547
11201,3688845298,3896840409,1672571412,1672571788,376
10770,3231654754,3516249472,1672586256,1672587404,1148
10512,3793232021,3311133296,1672579009,1672581191,2182
10939,3472272792,3519947298,1672543768,1672545991,2223
10898,3701493094,3515974881,1672624609,1672627192,2583
11292,3510826414,3311904032,1672639475,1672642943,3468
11667,3534812391,3247075753,1672582944,1672583833,889
10651,3770457058,3756119976,1672561673,1672563307,1634
11104,3669427589,3514926921,1672632701,1672632899,198
10299,3633622298,3511640720,1672664066,1672666310,2244
11770,3713621169,3685083275,1672644728,1672644792,64
10274,3904045870,3756991235,1672615284,1672616061,777
11282,3703462221,3901169230,1672544821,1672546239,1418
10919,3633294415,3735422623,1672581880,1672585241,3361
11148,3922301238,3792900315,1672557333,1672557754,421
11031,3933469838,3926724515,1672617210,1672620622,3412
11058,3711349327,3533077580,1672614680,1672615682,1002
10126,3363549860,3510542303,1672598964,1672600017,1053
10588,3391854325,3510836047,1672594217,1672596273,2056
10494,3533265491,3516819320,1672588348,1672588947,599
10466,3896123242,3520273299,1672563642,1672564522,880
9973,3505416534,3760997159,1672617156,1672618119,963
10884,3394959062,3755119166,1672651463,1672651651,188
11637,3316121649,3780969898,1672622199,1672624552,2353
11614,3517558635,3778842400,1672576661,1672579947,3286
11300,3505826673,3770924034,1672624017,1672624830,813
10716,3500473064,3380218091,1672618732,1672620791,2059
10913,3701956841,3780238637,1672673384,1672676320,2936
11220,3773523569,3779689733,1672620434,1672623594,3160
11427,3347760784,3434052463,1672632286,1672635673,3387
10623,3713878219,3491250381,1672548360,1672551306,2946
9861,3812880543,3509186338,1672654235,1672656618,2383
11456,3515528947,3510244209,1672585262,1672586821,1559
11758,3511296895,3390537737,1672633631,1672636435,2804
10569,3774436159,3417360319,1672533932,1672535418,1486
10072,3221126799,3311188620,1672666995,1672670505,3510
11177,3884933821,3703474558,1672681921,1672683716,1795
10505,3777370601,3470962222,1672661237,1672663292,2055
9946,3311015817,3913847876,1672616594,1672617172,578
10138,3757050615,3511645260,1672592986,1672593795,809
11410,3923133978,3760443176,1672532745,1672534989,2244
10512,3205948776,3715284599,1672597812,1672601162,3350
10064,3701449715,3836586875,1672613107,1672613619,512
11214,3315094386,3852275715,1672694019,1672696343,2324
10726,3478455812,3304661369,1672632180,1672634456,2276
11163,3895944547,3317190427,1672624665,1672627588,2923
11508,3473520701,3757032266,1672581801,1672583068,1267
10139,3243056734,3500405175,1672701498,1672704048,2550
10107,3205324639,3887069914,1672609197,1672609337,140
10506,3515803462,3977360666,1672682370,1672683077,707
10807,3755502373,3975799349,1672572534,1672573273,739
9848,3472901378,3701779683,1672615300,1672615697,397
11427,3515802579,3382670400,1672576853,1672579670,2817
11697,3772882440,3714645218,1672557198,1672559760,2562
11774,3343616490,3330318282,1672698128,1672701649,3521
10761,3519297683,3773378103,1672694122,1672694535,413
11537,3391854325,3622152515,1672625797,1672626539,742
10817,3715106566,3922430928,1672553439,1672554326,887
10236,3444453261,3777149336,1672587006,1672589722,2716
11129,3495482863,3453538201,1672689790,1672692136,2346
10049,3276393542,3631444265,1672607141,1672609962,2821
11216,3511729562,3905889514,1672701750,1672703561,1811
10224,3514297012,3500720752,1672534025,1672537530,3505
11003,3509556649,3814770073,1672630745,1672632385,1640
9943,3519831322,3838423363,1672572315,1672574002,1687
10492,3513802404,3893932944,1672645762,1672648674,2912
11486,3770595035,3517949586,1672701300,1672703419,2119
9986,3663353552,3512395783,1672623307,1672625930,2623
11308,3793497672,3773017746,1672594368,1672596282,1914
11756,3505278562,3817029483,1672568114,1672568306,192
11056,3516321814,3313392810,1672559371,1672561415,2044
10573,3668369938,3516731917,1672535224,1672536839,1615
11561,3791382196,3604908372,1672644372,1672646253,1881
10141,3938059867,3970265139,1672657286,1672659186,1900
10102,3380628097,3518117078,1672576475,1672576726,251
11339,3685877449,3783238023,1672647119,1672647381,262
10625,3857909328,3517149023,1672637212,1672639437,2225
11458,3206217657,3791796190,1672590172,1672590311,139
10410,3516668203,3774251051,1672605728,1672608281,2553
10249,3511744756,3773085258,1672646216,1672649279,3063
11285,3895944547,3512288503,1672575172,1672575439,267
10024,3816184951,3505826673,1672639390,1672642492,3102
10823,3347172556,3411355804,1672550919,1672551765,846
11095,3224053840,3533030343,1672581579,1672581651,72
10831,3519356606,3501261089,1672566501,1672569387,2886
9929,3435159896,3772343750,1672564055,1672567587,3532
11771,3783201950,3713807753,1672652116,1672653092,976
10970,3515405509,3311924005,1672617080,1672620520,3440
11060,3935256825,3710119555,1672662066,1672663050,984
10874,3824135033,3774251051,1672556115,1672559688,3573
11658,3517144269,3501192566,1672603725,1672604591,866
11370,3856316719,3235074007,1672607959,1672609372,1413
11439,3534775239,3272581469,1672574189,1672576343,2154
9890,3479207976,3755129708,1672638649,1672642082,3433
10357,3388481990,3774448657,1672537831,1672539536,1705
10045,3318250647,3514005973,1672668574,1672670264,1690
10798,3666022373,3505560793,1672639149,1672642597,3448
11510,3505665253,3791698084,1672602796,1672604571,1775
10600,3804840997,3301489209,1672567577,1672570252,2675
10727,3423353911,3783201950,1672629136,1672629808,672
11442,3703742071,3710296607,1672548550,1672551505,2955
9851,3612705426,3638018906,1672613369,1672615008,1639
9808,3235470567,3826542169,1672568980,1672571906,2926
10097,3779312237,3701887470,1672558161,1672559028,867
10107,3400560073,3509544691,1672700682,1672702895,2213
10954,3520182275,3917243005,1672697968,1672698919,951
10121,3817038422,3483078667,1672605930,1672607246,1316
10090,3500864577,3377446376,1672629175,1672629587,412
11118,3834311054,3803382101,1672616026,1672618818,2792
9911,3519448648,3552922094,1672693826,1672696428,2602
10304,3688870751,3403988682,1672584934,1672585726,792
10879,3792930090,3501225887,1672627587,1672628765,1178
10458,3310702648,3270502801,1672571765,1672574594,2829
9927,3770019143,3703725221,1672564204,1672565048,844
10392,3491104534,3510240661,1672683253,1672685520,2267
10502,3459799131,3491758029,1672538510,1672541487,2977
10694,3475560058,3755865626,1672577989,1672578799,810
10356,3533859712,3713444403,1672696373,1672699730,3357
11046,3517499844,3970851830,1672679282,1672680423,1141
10937,3938409715,3777439655,1672562319,1672564720,2401
10982,3783430498,3715700639,1672638831,1672641042,2211
10344,3388537708,3856129522,1672573964,1672575281,1317
11055,3972847837,3783594246,1672691756,1672694711,2955
10063,3832745283,3713927376,1672571344,1672572766,1422
10805,3495152069,3783067048,1672685163,1672687272,2109
10501,3713374884,3839417558,1672652881,1672655702,2821
11663,3714471069,3770966950,1672584033,1672585623,1590
9993,3239423794,3520016705,1672691955,1672694165,2210
10075,3772262649,3505245692,1672536096,1672536716,620
11773,3553229537,3518157683,1672553329,1672556244,2915
9860,3368079099,3716595760,1672534824,1672534986,162
10345,3505994703,3501711464,1672617566,1672619749,2183
11026,3519034304,3711258452,1672596838,1672597280,442
11595,3792682835,3334824744,1672665771,1672668520,2749
10724,3791584994,3809216145,1672532526,1672534401,1875
10965,3515939841,3919814073,1672644531,1672646618,2087
10149,3500440602,3772893815,1672645375,1672646286,911
10669,3625952981,3918126468,1672605743,1672607262,1519
9998,3461741050,3783594729,1672654762,1672654851,89
11222,3901169230,3316406470,1672607515,1672609012,1497
11379,3783594729,3510535683,1672621743,1672625275,3532
11638,3310702648,3491104534,1672632957,1672634208,1251
10110,3792411831,3500356342,1672553308,1672554972,1664
10521,3783809405,3512154443,1672535248,1672536577,1329
10023,3757407184,3559125467,1672683900,1672684303,403
11314,3476416072,3340897079,1672638690,1672641116,2426
11285,3402105276,3738429905,1672562385,1672564795,2410
10066,3224824355,3513563152,1672687047,1672689002,1955
10312,3774447975,3278805844,1672545527,1672545843,316
11408,3350631472,3534190196,1672694369,1672694770,401
11075,3772262649,3403988682,1672590784,1672593012,2228
11293,3710228292,3783506190,1672645544,1672646297,753
11523,3897003751,3711179193,1672674021,1672674259,238
10880,3510869438,3519754667,1672591306,1672591509,203
11009,3615245840,3638071975,1672612560,1672613825,1265
11517,3713471446,3824657614,1672615441,1672616109,668
10575,3500630465,3906260966,1672621678,1672622313,635
10148,3432466467,3287920864,1672685040,1672686990,1950
10049,3739618347,3208519320,1672605098,1672607891,2793
10756,3760382349,3713031958,1672692152,1672694179,2027
10195,3377250778,3520558137,1672622574,1672622698,124
11526,3358473096,3778253021,1672558266,1672560599,2333
10330,3447312353,3482639402,1672550518,1672551704,1186
10152,3500590302,3311188620,1672588468,1672590735,2267
10536,3434581257,3458753033,1672674724,1672675749,1025
11727,3757406215,3510869438,1672618304,1672619269,965
10156,3772188086,3416079461,1672576071,1672578410,2339
10914,3446218191,3633949990,1672641322,1672642743,1421
10522,3361635547,3500922040,1672575152,1672578214,3062
11416,3516249472,3777931341,1672624772,1672627938,3166
9803,3519848902,3516585063,1672538024,1672538389,365
10216,3516588277,3505593034,1672532985,1672535168,2183
11753,3809860102,3358530225,1672548766,1672550142,1376
10748,3534362749,3311231911,1672634201,1672635372,1171
11068,3313824913,3388463477,1672577422,1672580785,3363
11654,3803996569,3319660530,1672631671,1672632735,1064
11312,3239423794,3891272544,1672605952,1672608549,2597
10281,3714471069,3407398464,1672562992,1672564291,1299
10883,3912811715,3776583229,1672702483,1672702799,316
10487,3778370462,3701567668,1672623469,1672624416,947
11700,3736885568,3779604279,1672611362,1672614089,2727
11503,3834456158,3520344592,1672566755,1672568546,1791
11088,3757407184,3791825536,1672670543,1672672635,2092
10880,3778370462,3335974305,1672599787,1672602940,3153
11094,3716195780,3792475476,1672591360,1672591858,498
10852,3713927376,3509556649,1672650868,1672651711,843
10986,3714268380,3406029706,1672675138,1672678016,2878
10309,3853783593,3774483862,1672583204,1672585404,2200
10360,3777204977,3730414796,1672589823,1672591167,1344
10625,3516651799,3780050146,1672680963,1672682974,2011
10037,3791359168,3443004958,1672549492,1672551081,1589
9992,3332124606,3205324639,1672680806,1672682060,1254
11124,3375257546,3235373942,1672668327,1672671195,2868
9857,3662307789,3471177177,1672702745,1672704091,1346
10128,3501711464,3500120676,1672691791,1672693849,2058
10762,3714595459,3480270940,1672701149,1672704575,3426
10827,3660496328,3416225867,1672633036,1672635276,2240
10986,3701265238,3515764058,1672630241,1672632502,2261
10470,3347172556,3615447269,1672672548,1672673752,1204
10153,3436774112,3899294071,1672589896,1672591342,1446
10043,3418367752,3710585241,1672587380,1672589918,2538
10998,3517991042,3516454693,1672541372,1672543603,2231
9871,3501171785,3369482983,1672631811,1672632071,260
10487,3447948483,3912915644,1672571098,1672571536,438
10384,3832902787,3413799143,1672593200,1672594903,1703
11243,3791269060,3627358016,1672557992,1672560673,2681
10773,3394394262,3857847527,1672578651,1672581984,3333
9870,3349475873,3776600696,1672559229,1672560500,1271
11645,3412605548,3500421940,1672552512,1672553108,596
10105,3501225887,3703749690,1672613187,1672613436,249
11757,3811354125,3662507634,1672579363,1672579465,102
9970,3711518637,3738132114,1672654878,1672657816,2938
9981,3423217578,3311264420,1672613889,1672616438,2549
10866,3487231844,3772216305,1672691007,1672691588,581
10212,3680278447,3201957157,1672649671,1672652253,2582
11490,3289771213,3923910914,1672577194,1672577683,489
10214,3534506090,3783443095,1672568247,1672568953,706
9832,3760687922,3923524564,1672544355,1672544584,229
10018,3732871856,3514638555,1672602809,1672603308,499
10208,3209958726,3793860209,1672543602,1672546941,3339
11531,3495427619,3520625600,1672644064,1672644845,781
10624,3701004302,3908331271,1672681008,1672683138,2130
10512,3519703964,3791121243,1672579743,1672582081,2338
11463,3834456158,3736621212,1672669413,1672671116,1703
10962,3370961012,3917467642,1672531290,1672531478,188
11384,3827889533,3912625932,1672678903,1672681961,3058
10029,3496591885,3779427180,1672558974,1672560133,1159
10072,3494748808,3792851584,1672634230,1672635007,777
11497,3777992576,3715039960,1672554564,1672556296,1732
10456,3505828210,3713170867,1672674392,1672674669,277
11460,3303432071,3634670780,1672674382,1672674860,478
10345,3924366353,3732540636,1672669265,1672670658,1393
11664,3505183641,3716463756,1672650835,1672654101,3266
10056,3483078667,3703048107,1672628629,1672631523,2894
10909,3311463998,3311037445,1672568054,1672568246,192
11337,3206241691,3475653510,1672532627,1672533276,649
9811,3716371766,3777135415,1672682588,1672682984,396
10790,3711219767,3305727497,1672580438,1672580795,357
11253,3714688409,3783408830,1672649912,1672652331,2419
10057,3514033319,3235373942,1672665550,1672666253,703
10009,3757514745,3730052916,1672582693,1672585949,3256
10381,3512645289,3770476738,1672607320,1672607810,490
11632,3511078598,3774598935,1672556826,1672557301,475
10160,3760541837,3418997135,1672622743,1672622877,134
11024,3777909822,3772751765,1672556077,1672556885,808
11455,3772893815,3778253021,1672588088,1672590805,2717
11070,3488887919,3927675706,1672636675,1672637125,450
11303,3629869834,3463883997,1672617693,1672620584,2891
11311,3716195780,3519322066,1672699750,1672701746,1996
11392,3600302127,3317887374,1672574804,1672576293,1489
11381,3756781024,3421524698,1672617443,1672619986,2543
11446,3342031426,3757855416,1672596790,1672597205,415
9968,3272328752,3736203662,1672653916,1672655841,1925
10261,3382757142,3379517265,1672558554,1672559930,1376
9813,3856316719,3351153781,1672698492,1672701055,2563
9897,3772845364,3636015050,1672701805,1672703749,1944
10467,3366961580,3520558137,1672545982,1672548322,2340
9956,3715291931,3625779003,1672692247,1672694819,2572
11675,3500720752,3713416106,1672616674,1672617073,399
10480,3509394912,3917905192,1672703464,1672705760,2296
9819,3500105301,3233712975,1672697334,1672700151,2817
10201,3534206917,3887502536,1672604590,1672606792,2202
10649,3476431618,3776791436,1672583412,1672586260,2848
10462,3516019206,3779818784,1672701237,1672704500,3263
10786,3510856388,3369810091,1672643172,1672643233,61
10872,3364948616,3429047448,1672686222,1672688436,2214
9855,3857609616,3511580693,1672588584,1672589263,679
10191,3612841103,3511245705,1672620440,1672623099,2659
10395,3776593726,3497904539,1672569343,1672572935,3592
11402,3856129522,3904846341,1672584527,1672587145,2618
10227,3977880564,3429610195,1672545068,1672546590,1522
10283,3400545490,3927365255,1672701031,1672701888,857
11151,3227874229,3384151770,1672623808,1672625057,1249
10872,3516200419,3739297004,1672621914,1672623217,1303
11383,3904045870,3711287751,1672628513,1672629597,1084
10972,3311626308,3820200446,1672533263,1672534530,1267
10239,3755729826,3367109648,1672558196,1672558909,713
10024,3773017746,3367262509,1672625723,1672628473,2750
9824,3893629892,3313795594,1672591704,1672594871,3167
10696,3783809405,3756536476,1672597522,1672600740,3218
10077,3397527886,3757872458,1672584491,1672587138,2647
10412,3756781024,3793860209,1672649732,1672651325,1593
10088,3553229537,3427741923,1672567817,1672568523,706
11756,3905934770,3791825536,1672657426,1672660014,2588
11327,3509701363,3228033254,1672553162,1672555263,2101
11608,3513624915,3307997700,1672635457,1672637873,2416
11262,3509167758,3246567963,1672673816,1672677391,3575
11031,3703438617,3517943697,1672591525,1672592691,1166
11467,3500793739,3792107875,1672685422,1672687201,1779
11785,3463564410,3736010012,1672683474,1672684115,641
10333,3394364348,3378172464,1672621417,1672623799,2382
10899,3757514745,3331471764,1672646004,1672648955,2951
10072,3791206902,3688845298,1672622259,1672623746,1487
10207,3501208658,3337903727,1672574810,1672574874,64
10335,3703896751,3804840997,1672535241,1672538436,3195
10735,3780626668,3447948483,1672580546,1672582657,2111
10005,3924583142,3500630465,1672676649,1672679096,2447
11255,3341738186,3555954355,1672568380,1672569085,705
10641,3511963020,3701725839,1672575459,1672578786,3327
10772,3299847117,3220123678,1672697731,1672701226,3495
10191,3933731871,3780074082,1672694236,1672696123,1887
11200,3444646562,3662354016,1672585151,1672586837,1686
9845,3368176107,3760997159,1672554177,1672556749,2572
11252,3288791629,3713219299,1672628972,1672629459,487
9935,3737946004,3533209168,1672610409,1672613011,2602
11328,3791584994,3811419378,1672636025,1672639563,3538
9885,3738429905,3716178116,1672702572,1672703588,1016
11040,3289258397,3533627473,1672667708,1672668656,948
11147,3760525465,3770530739,1672573141,1672576321,3180
10173,3519357822,3615742989,1672674490,1672677047,2557
9932,3500741534,3912625932,1672618094,1672620366,2272
10547,3271282663,3933469838,1672593119,1672593211,92
11033,3245245283,3244495586,1672611436,1672614118,2682
10841,3906874577,3227339675,1672653697,1672655635,1938
11444,3510824484,3511526885,1672692356,1672693330,974
10198,3893629892,3711599043,1672608361,1672609611,1250
11479,3715602742,3770391782,1672675484,1672677396,1912
9807,3760801237,3471585513,1672628423,1672630063,1640
10111,3925208102,3515230715,1672690709,1672693587,2878
11515,3793814153,3971051020,1672550603,1672551575,972
10314,3780171640,3757089924,1672534218,1672535616,1398
10105,3307454562,3770925016,1672651094,1672654328,3234
11758,3783368855,3505500523,1672571245,1672573919,2674
11766,3609997804,3760687922,1672639800,1672642172,2372
10944,3772509599,3436774112,1672608975,1672611148,2173
11020,3770285500,3791548838,1672612814,1672616152,3338
11590,3341738186,3312946269,1672574746,1672576754,2008
10297,3366801723,3668063289,1672565954,1672567880,1926
11728,3715441777,3421674406,1672663596,1672666737,3141
10440,3756759239,3701865589,1672558041,1672558520,479
10991,3936871734,3855209450,1672562534,1672565479,2945
10850,3249771731,3516321814,1672591898,1672592619,721
11288,3978643889,3423147369,1672643585,1672645096,1511
10976,3776950532,3925823748,1672602575,1672604785,2210
11244,3610806770,3701359045,1672594873,1672598378,3505
11589,3757393413,3516378356,1672545960,1672549500,3540
10323,3200785194,3738873928,1672600272,1672600945,673
10067,3387322545,3385416697,1672695279,1672696066,787
11320,3601214648,3774035405,1672647007,1672649013,2006
10359,3681274982,3793689267,1672634391,1672635947,1556
11611,3500720752,3703481882,1672552592,1672553974,1382
11748,3511466117,3778182724,1672537036,1672538172,1136
11001,3439532406,3850904092,1672574623,1672575126,503
11146,3520022175,3446537819,1672663809,1672666776,2967
11722,3662354016,3370512945,1672645811,1672648439,2628
11691,3520471156,3387706541,1672615662,1672618852,3190
10466,3304227085,3500057674,1672639846,1672641203,1357
10267,3602054754,3513250976,1672665798,1672668448,2650
9805,3618895679,3380185102,1672697975,1672700762,2787
11414,3201634072,3205161801,1672596092,1672596421,329
10957,3772070986,3419829238,1672572710,1672576179,3469
10968,3505804611,3278629965,1672598601,1672601618,3017
11272,3739075176,3662507634,1672616594,1672619203,2609
11082,3393376416,3780127017,1672652408,1672655698,3290
10419,3463564410,3517331746,1672589755,1672592071,2316
11778,3777370601,3925835590,1672611465,1672613837,2372
9929,3382670400,3713923960,1672671819,1672673531,1712
9901,3688410383,3399726243,1672587782,1672589565,1783
10383,3909067335,3517800171,1672536923,1672538628,1705
9930,3830291558,3779212271,1672645964,1672646729,765
11694,3381055770,3509470194,1672629208,1672630383,1175
9952,3930727474,3284407073,1672701011,1672701891,880
9997,3501356814,3514216460,1672587652,1672587854,202
9980,3819024145,3223796145,1672593820,1672596210,2390
11445,3976400190,3514747345,1672571508,1672573914,2406
10443,3311142523,3500049870,1672684629,1672685208,579
9953,3905571273,3774965463,1672643228,1672645458,2230
10971,3236254381,3915962248,1672571262,1672574320,3058
10098,3773899531,3733123020,1672583885,1672584415,530
9899,3332010532,3613936929,1672645990,1672647781,1791
11104,3916673751,3835262447,1672638841,1672641112,2271
10960,3793719515,3910020031,1672700742,1672703084,2342
11079,3917243005,3935520819,1672554596,1672557680,3084
11301,3772282008,3730226545,1672701045,1672702797,1752
11570,3334633634,3829761380,1672686557,1672690056,3499
11336,3342545285,3777569538,1672561947,1672562403,456
10049,3619796619,3533830748,1672597127,1672598053,926
10977,3505685294,3558567160,1672627899,1672630382,2483
11349,3885422379,3755767856,1672628106,1672631083,2977
10006,3716609198,3282053097,1672686210,1672686522,312
11166,3926065090,3514638555,1672544788,1672546833,2045
11571,3975796415,3435652260,1672532295,1672533816,1521
11483,3755357292,3534122907,1672665192,1672666953,1761
9919,3513545735,3703104365,1672591998,1672594198,2200
10018,3896211741,3520515739,1672653689,1672653947,258
10906,3774921252,3511069449,1672664228,1672667325,3097
11624,3760074281,3611832288,1672694898,1672698417,3519
10075,3827981800,3666823095,1672604125,1672605262,1137
10083,3500019810,3361926328,1672655403,1672656826,1423
11000,3398075553,3777715675,1672571566,1672574180,2614
10695,3924366353,3425545115,1672640242,1672642845,2603
10900,3780921044,3515802579,1672696451,1672699834,3383
11642,3624164232,3439662051,1672621669,1672623859,2190
11777,3513140146,3447696555,1672596100,1672597594,1494
11198,3777569538,3468281011,1672655039,1672658399,3360
11676,3509394912,3629248353,1672598066,1672598893,827
11208,3518989186,3977209952,1672658436,1672661336,2900
10115,3510694464,3501427691,1672619183,1672621575,2392
11260,3511199555,3337715675,1672703518,1672704554,1036
10729,3533009565,3233993993,1672552087,1672554985,2898
10982,3930501172,3286862903,1672699056,1672699924,868
10203,3501619113,3443041059,1672677848,1672678362,514
10238,3780224882,3907923381,1672677668,1672678958,1290
10785,3714074120,3906260966,1672559553,1672562347,2794
11210,3245501577,3703572036,1672615217,1672617920,2703
11342,3510301454,3755230010,1672646603,1672649043,2440
11009,3820422111,3783443095,1672585765,1672586992,1227
11465,3777439655,3414510793,1672565064,1672565682,618
10079,3425545115,3520012007,1672667224,1672670610,3386
10443,3808849597,3701475090,1672611323,1672614314,2991
10592,3509663119,3755229631,1672635388,1672636581,1193
10481,3220660616,3935256825,1672559566,1672562887,3321
11352,3934280144,3711599043,1672701013,1672701309,296
10264,3519015940,3500178849,1672561281,1672562584,1303
11215,3977666815,3246381831,1672591115,1672592744,1629
10030,3501548163,3516572212,1672540550,1672542354,1804
10046,3778253021,3444453261,1672669461,1672669779,318
11607,3429610195,3791522832,1672686441,1672689179,2738
9804,3222357355,3777937949,1672548403,1672551372,2969
10992,3512337054,3774304163,1672659959,1672662808,2849
10699,3505140123,3436774112,1672640484,1672641323,839
10637,3534537581,3441737317,1672600880,1672602257,1377
11663,3208519320,3361711720,1672595549,1672597396,1847
10133,3703168159,3555764822,1672598580,1672598753,173
9938,3239279744,3773798215,1672637640,1672640866,3226
9824,3474097405,3509470194,1672648326,1672650001,1675
11160,3710487368,3757514745,1672621964,1672624217,2253
9935,3703031637,3519924982,1672588864,1672589424,560
10391,3884192843,3731644240,1672621681,1672624102,2421
11721,3315432466,3772966919,1672685724,1672687980,2256
10908,3772844451,3505245692,1672600418,1672603416,2998
9961,3505414878,3756680289,1672563735,1672564806,1071
9818,3755229631,3614112171,1672644134,1672647434,3300
11160,3853386575,3715441777,1672553478,1672556643,3165
10116,3520926977,3683677062,1672560359,1672561441,1082
9989,3776867553,3881785069,1672607385,1672609234,1849
11270,3500062408,3710783759,1672580518,1672580926,408
11278,3511500932,3505908965,1672547591,1672547857,266
10640,3500442370,3778706119,1672640090,1672643036,2946
10474,3773826624,3518425740,1672681521,1672684588,3067
11434,3711810268,3779561601,1672699628,1672703178,3550
10558,3825795004,3293553295,1672610724,1672610858,134
11382,3497562878,3757944870,1672646410,1672646696,286
10593,3756536512,3496407500,1672622322,1672622457,135
11058,3509503263,3739387948,1672535879,1672538591,2712
10149,3505531432,3809216145,1672550890,1672552503,1613
10077,3517132086,3715844082,1672701115,1672703553,2438
10806,3776279305,3738132114,1672550110,1672551145,1035
11537,3890813040,3714453773,1672562202,1672564336,2134
9853,3757851680,3342837214,1672639083,1672642436,3353
10628,3825795004,3738160394,1672568266,1672570716,2450
10692,3228997424,3236206821,1672568529,1672570373,1844
11219,3434581257,3515284733,1672656678,1672656778,100
9954,3883640904,3370512945,1672634640,1672637322,2682
11670,3783122313,3666655293,1672667370,1672670769,3399
10830,3500429731,3435037864,1672658903,1672661236,2333
11030,3713100169,3714806574,1672702761,1672703306,545
10169,3733730342,3360309868,1672589968,1672592262,2294
11742,3783373085,3778924002,1672606112,1672608547,2435
9819,3362368123,3517552930,1672601644,1672601829,185
10629,3452878062,3358675021,1672538463,1672538902,439
9874,3779975575,3774965463,1672554680,1672557003,2323
11469,3778706119,3668154066,1672587793,1672589156,1363
9847,3919994216,3770180844,1672657544,1672659470,1926
11494,3533440294,3515706117,1672565556,1672568117,2561
10703,3857344874,3793902476,1672544202,1672547069,2867
10794,3774627091,3394357241,1672615486,1672618937,3451
10233,3453164933,3756157377,1672559074,1672559492,418
11359,3919814073,3311142523,1672692389,1672695771,3382
9805,3685083275,3511182297,1672687531,1672687873,342
9989,3617135064,3509996827,1672694901,1672696407,1506
10242,3515047288,3733123020,1672566560,1672567906,1346
11268,3369108286,3701449715,1672552686,1672554357,1671
11577,3730052916,3337903727,1672539154,1672540761,1607
10897,3291446384,3776001441,1672574234,1672577396,3162
11659,3500595432,3625931630,1672682493,1672685506,3013
10830,3715858201,3911821258,1672564245,1672567744,3499
9911,3703818358,3513802404,1672630230,1672633184,2954
11277,3622654885,3773579644,1672647178,1672649567,2389
9999,3627431396,3434052463,1672633160,1672634953,1793
11568,3505438826,3927504954,1672636266,1672638687,2421
11483,3711040761,3780435349,1672670609,1672672526,1917
11150,3558203963,3780206849,1672574991,1672576248,1257
10836,3342235058,3919494952,1672599553,1672600005,452
11710,3505538902,3243056734,1672669284,1672670201,917
11570,3420854927,3520049965,1672626244,1672628915,2671
10943,3420854927,3666022373,1672685899,1672689257,3358
10896,3757201538,3358473096,1672633508,1672635567,2059
11711,3918981936,3710119555,1672650665,1672653927,3262
10275,3452878062,3491250381,1672544212,1672546625,2413
10100,3774598935,3856129522,1672603324,1672605442,2118
10293,3615846003,3353326305,1672566558,1672566930,372
10222,3501356814,3519255644,1672674113,1672674767,654
11251,3734233216,3780921044,1672648173,1672651424,3251
11719,3493047640,3295691964,1672595705,1672597528,1823
10578,3279726491,3519015940,1672684301,1672684909,608
11282,3519108639,3807584987,1672578472,1672580343,1871
10640,3278805844,3777569538,1672673976,1672675026,1050
9896,3517195738,3510547682,1672607313,1672609396,2083
11717,3780982229,3271780525,1672598016,1672601326,3310
11263,3345028045,3478937459,1672702705,1672703406,701
10613,3755342153,3430296808,1672551652,1672552983,1331
9910,3716609198,3519521903,1672538551,1672539995,1444
11115,3429315500,3777715675,1672687793,1672689401,1608
10663,3711591464,3514007122,1672652486,1672654086,1600
10504,3518088154,3373018943,1672660579,1672662443,1864
11620,3760997159,3555378248,1672607879,1672609530,1651
10337,3224053840,3770631449,1672598957,1672601361,2404
10088,3534204885,3517627003,1672614238,1672614873,635
11205,3895944547,3372617110,1672554455,1672556352,1897
10881,3939422411,3515577866,1672638770,1672641570,2800
11476,3805926853,3468343480,1672636452,1672636728,276
10532,3290097447,3780956975,1672624065,1672624446,381
11655,3372596013,3512645289,1672584090,1672584620,530
11337,3272581469,3882580580,1672584926,1672586451,1525
10044,3779609338,3898989233,1672619211,1672620488,1277
9824,3405200303,3515764058,1672570075,1672570205,130
11601,3349573092,3773895671,1672683415,1672684858,1443
9929,3534081527,3770180844,1672564046,1672564203,157
10417,3756876537,3910049345,1672670671,1672672185,1514
10020,3710783759,3469370398,1672689275,1672692401,3126
11441,3517136772,3533822490,1672593543,1672595890,2347
11003,3757198930,3888057649,1672673372,1672673943,571
10450,3438204844,3777112124,1672540332,1672542846,2514
10289,3701956841,3516827471,1672534063,1672537651,3588
10968,3778253021,3514455363,1672610342,1672610428,86
10703,3773554767,3354968884,1672583690,1672585058,1368
10923,3341432459,3714067998,1672619966,1672621843,1877
10246,3519831322,3777387533,1672623962,1672625158,1196
11405,3209925780,3514776568,1672678178,1672679214,1036
11397,3505839395,3777552831,1672696320,1672696601,281
11394,3772320856,3505538902,1672657651,1672660460,2809
10053,3685522474,3855629383,1672564452,1672564818,366
10345,3398483531,3516965624,1672673584,1672674484,900
10770,3439045964,3811419378,1672622576,1672625402,2826
10723,3461877104,3812261241,1672606566,1672608495,1929
11187,3556684272,3445172440,1672584045,1672586696,2651
10243,3294949958,3930766276,1672658403,1672658575,172
11754,3370751461,3713476192,1672703935,1672704800,865
10295,3778838936,3714142299,1672656489,1672657286,797
11753,3667072319,3772234939,1672632199,1672635660,3461
10560,3334482021,3227874229,1672598615,1672598920,305
10214,3783172505,3638018906,1672668597,1672670858,2261
10657,3443041059,3776187150,1672536897,1672537297,400
11544,3516867729,3343767438,1672551771,1672554368,2597
10529,3204473480,3715441786,1672581848,1672585020,3172
10678,3516904926,3512154443,1672589023,1672592519,3496
11421,3466149998,3421524698,1672657250,1672657725,475
10181,3510301454,3513624915,1672688496,1672688969,473
11525,3756119976,3510547682,1672579553,1672581770,2217
11321,3342027511,3835599049,1672679219,1672682278,3059
10363,3278779955,3792900315,1672553808,1672555068,1260
11681,3520305100,3884934977,1672584794,1672585215,421
10957,3515681585,3773603836,1672548392,1672551326,2934
10083,3703624327,3500415589,1672688324,1672689114,790
10898,3716633983,3511466117,1672575966,1672579517,3551
11681,3687183789,3516019206,1672535223,1672538397,3174
9926,3661543201,3703737650,1672537422,1672540921,3499
10607,3516335333,3892177203,1672683539,1672683887,348
9951,3442073613,3701971784,1672596617,1672596926,309
10543,3770780655,3534499421,1672534142,1672536175,2033
10914,3855440101,3603167427,1672608802,1672611649,2847
9942,3827981800,3792597493,1672645686,1672646638,952
10952,3516904926,3203954795,1672662471,1672662860,389
10526,3778195766,3760966645,1672692822,1672694613,1791
10444,3207307681,3770285500,1672661573,1672663909,2336
11354,3779689733,3808849597,1672574641,1672575254,613
10899,3701663839,3714281795,1672671967,1672675424,3457
9931,3310712221,3403120725,1672630534,1672633905,3371
10559,3501261089,3881012415,1672542548,1672544515,1967
10986,3688410383,3777304517,1672536408,1672538788,2380
10296,3466655775,3236360179,1672643658,1672646903,3245
10191,3817376705,3773376762,1672678371,1672678769,398
11002,3337675386,3701127475,1672568796,1672569447,651
11116,3777878462,3482172065,1672612839,1672613697,858
11613,3713374884,3500415589,1672560360,1672562587,2227
11285,3511206717,3791644831,1672667137,1672667245,108
10241,3509274030,3735679000,1672594984,1672595113,129
9855,3520339198,3313298164,1672600664,1672601566,902
10258,3430399931,3776732532,1672639709,1672642849,3140
10042,3755273361,3515681585,1672612809,1672613165,356
11615,3396440259,3715602742,1672686161,1672688864,2703
11029,3510750299,3772296376,1672557294,1672558465,1171
11207,3684199077,3435652260,1672690780,1672693913,3133
10490,3271780525,3882580580,1672674963,1672677190,2227
11197,3514628916,3900195680,1672620597,1672623618,3021
10465,3779706467,3703849264,1672567501,1672570913,3412
10755,3478052226,3818570577,1672613870,1672617275,3405
10450,3634670780,3738873928,1672562770,1672565250,2480
10431,3468201976,3714455496,1672602281,1672604914,2633
9904,3776122272,3792173463,1672700491,1672703439,2948
11442,3458130310,3772131127,1672633448,1672636368,2920
10094,3500776597,3452175941,1672652980,1672655920,2940
10669,3622654885,3770925016,1672610049,1672613138,3089
10463,3853188285,3534937492,1672629674,1672632832,3158
11557,3413799143,3311626308,1672679910,1672682712,2802
11763,3305657559,3520763492,1672651742,1672652512,770
11442,3311904032,3509018337,1672535417,1672538966,3549
11410,3362706073,3336501403,1672695375,1672695752,377
10240,3227874229,3760267158,1672588372,1672590983,2611
10307,3519034304,3229465607,1672589654,1672590548,894
10684,3783408469,3760069457,1672684145,1672686572,2427
10187,3899205452,3898965585,1672700916,1672703861,2945
10557,3701377471,3905571273,1672625811,1672628734,2923
10221,3406390503,3793996996,1672616626,1672617443,817
11305,3465227623,3505538902,1672557151,1672557593,442
11537,3884180202,3302879906,1672571487,1672574638,3151
11671,3533209168,3770595035,1672702519,1672705527,3008
10495,3514560138,3510250740,1672566113,1672566578,465
10827,3804095239,3555215568,1672688718,1672690915,2197
11281,3919814073,3852161626,1672688370,1672688847,477
10431,3793860209,3480270940,1672562396,1672563692,1296
11699,3710487368,3774702364,1672703660,1672705483,1823
10152,3517021928,3621439107,1672580738,1672582970,2232
9999,3774627091,3919494952,1672693414,1672696178,2764
11028,3203630241,3614112171,1672629728,1672630210,482
9903,3887069914,3938398160,1672586531,1672589676,3145
10274,3238779889,3220660616,1672629707,1672630590,883
10740,3783043346,3228033254,1672581970,1672583808,1838
10826,3738103378,3731644240,1672674192,1672674926,734
9898,3828906027,3495427619,1672615659,1672617224,1565
11788,3713191326,3701512498,1672644511,1672647258,2747
11661,3517469005,3793689267,1672618795,1672619558,763
10050,3394394262,3701284535,1672544746,1672545572,826
9868,3833520635,3515753241,1672672153,1672673872,1719
9830,3304235700,3772251279,1672572759,1672573502,743
10832,3396472026,3297624618,1672563853,1672564863,1010
9912,3665478011,3755374000,1672587761,1672589664,1903
11089,3804707712,3475090917,1672613044,1672616337,3293
10779,3755119166,3388915945,1672610063,1672612776,2713
10548,3776068937,3512700007,1672638142,1672640101,1959
11127,3500421940,3516429380,1672682072,1672684845,2773
10116,3760966645,3404461403,1672590607,1672592316,1709
11331,3780308809,3755865626,1672610877,1672614027,3150
11138,3755849241,3772867078,1672659498,1672661804,2306
9911,3204821370,3701060732,1672633664,1672637123,3459
10493,3779665641,3760656396,1672624970,1672627953,2983
10111,3662307789,3400545490,1672700452,1672702744,2292
10754,3505449070,3350631472,1672678212,1672679662,1450
10499,3793375825,3780298499,1672583625,1672586774,3149
10887,3501828287,3338195686,1672569026,1672569951,925
9866,3773895671,3505709407,1672609903,1672611253,1350
11621,3444680955,3343511947,1672668141,1672670435,2294
10049,3773024346,3501628472,1672642336,1672642750,414
10529,3384170206,3291936679,1672577033,1672578021,988
11259,3435652260,3760382349,1672538034,1672538638,604
10727,3534758256,3380218091,1672653040,1672654540,1500
10365,3501027795,3772845364,1672668501,1672670443,1942
11425,3614112171,3500209015,1672692704,1672693714,1010
10513,3710861700,3736010012,1672538841,1672540009,1168
11436,3779503296,3359929534,1672534900,1672536845,1945
10452,3934980229,3929446196,1672572937,1672574053,1116
10198,3205161801,3397972945,1672587957,1672588039,82
10170,3892177203,3776867553,1672585838,1672588075,2237
10495,3509360869,3780964089,1672567685,1672570577,2892
10853,3793860209,3332010532,1672702775,1672703664,889
11191,3534941710,3780749789,1672669474,1672670152,678
10410,3755769731,3343616490,1672680275,1672682871,2596
9907,3970265139,3777204977,1672636604,1672638340,1736
10474,3897500723,3514941815,1672694338,1672696989,2651
10246,3533974355,3760267158,1672581347,1672584902,3555
10967,3510159441,3793003432,1672552065,1672555414,3349
9993,3512645289,3509360869,1672666746,1672670088,3342
11645,3284374600,3701519251,1672632554,1672632855,301
10412,3710223875,3663902064,1672617480,1672618101,621
10562,3492350318,3884388188,1672639777,1672641572,1795
11611,3513508737,3500695402,1672597082,1672597894,812
11354,3903115138,3931164237,1672554549,1672557439,2890
10914,3791796190,3701296091,1672586871,1672588172,1301
11531,3487622510,3714892312,1672653733,1672655328,1595
10371,3513661302,3478915403,1672689753,1672691940,2187
11294,3505496725,3243305367,1672550360,1672552412,2052
10179,3925175853,3772216305,1672594798,1672595265,467
10641,3355430975,3621439107,1672620623,1672622251,1628
11231,3513111053,3774965463,1672564314,1672566331,2017
10358,3922480066,3619676231,1672614041,1672615766,1725
10837,3812261241,3615447269,1672572772,1672573874,1102
9893,3919814073,3511218261,1672555835,1672558387,2552
11633,3713923960,3792337863,1672629993,1672633331,3338
9832,3510819040,3534696810,1672583435,1672585737,2302
11168,3238997746,3520860199,1672593281,1672594836,1555
9905,3487395357,3909504515,1672595692,1672596242,550
9819,3851451801,3819024145,1672692375,1672694916,2541
10710,3772169046,3979115924,1672653404,1672655250,1846
11182,3770275898,3733123020,1672603141,1672603608,467
11145,3713416106,3438470128,1672549700,1672552019,2319
11373,3779312237,3514450836,1672658177,1672658905,728
11198,3492064037,3703168159,1672691851,1672693102,1251
10081,3772343750,3520779124,1672587467,1672590466,2999
10400,3973138649,3442073613,1672566517,1672569422,2905
11525,3624307518,3358262975,1672604774,1672604882,108
11717,3370961012,3388915945,1672546784,1672547249,465
11156,3701385831,3778817220,1672593685,1672594815,1130
10912,3783506190,3514698862,1672694098,1672695857,1759
11577,3813986705,3518335611,1672651723,1672654867,3144
10355,3792432094,3382746533,1672697373,1672699441,2068
10832,3358211034,3441840658,1672619116,1672621994,2878
10282,3770276815,3515655024,1672672479,1672675820,3341
10711,3780224882,3519494023,1672615117,1672616525,1408
10240,3516335333,3520926977,1672585974,1672588136,2162
11340,3711947828,3701668745,1672671286,1672674116,2830
10098,3510159441,3519689906,1672669797,1672673340,3543
10645,3470997293,3500433278,1672672266,1672675635,3369
10148,3334633634,3773534165,1672603904,1672604357,453
10606,3509208005,3395615598,1672615661,1672617472,1811
10379,3514776568,3294164983,1672561089,1672561396,307
11697,3925098136,3904184638,1672565708,1672567135,1427
11651,3666367524,3275171954,1672693366,1672694983,1617
11608,3555215568,3908177413,1672557065,1672558063,998
10355,3773344258,3780466967,1672614153,1672616629,2476
11071,3614112171,3534068874,1672660329,1672662118,1789
11313,3510638085,3559125467,1672543008,1672545102,2094
11436,3439651226,3776124041,1672541932,1672545412,3480
11358,3929002318,3344478603,1672621313,1672624753,3440
9945,3519948471,3512154443,1672653604,1672656834,3230
10773,3249771731,3446810761,1672552741,1672555023,2282
10516,3505011956,3450503086,1672615343,1672617636,2293
11416,3370245766,3458271585,1672676266,1672677186,920
10505,3735679000,3316406470,1672562517,1672563409,892
11305,3373135211,3519831322,1672700213,1672700929,716
9832,3227206772,3512826895,1672631475,1672631538,63
11061,3715284599,3440401725,1672634080,1672635436,1356
9957,3772509599,3779723939,1672638300,1672640956,2656
11055,3514801709,3755286041,1672573743,1672574977,1234
11181,3701919083,3500624846,1672682521,1672682888,367
11188,3311331205,3757869138,1672568343,1672571463,3120
10806,3437934509,3792682835,1672583074,1672585013,1939
10034,3311904032,3519997661,1672630304,1672632411,2107
10933,3516067011,3438204844,1672676500,1672677923,1423
10437,3513203127,3509394912,1672567132,1672570211,3079
10143,3773534165,3425260097,1672617234,1672618049,815
10755,3791206902,3291446384,1672546503,1672549899,3396
11321,3779340538,3513293711,1672663227,1672666388,3161
9895,3514853709,3245642576,1672691859,1672692259,400
11278,3916656185,3710149975,1672577189,1672580282,3093
10743,3550206045,3772188086,1672580931,1672582009,1078
11712,3602401154,3757212744,1672658682,1672660436,1754
10264,3272838634,3715587520,1672678610,1672681802,3192
11532,3783313202,3778986795,1672668356,1672671536,3180
11183,3471585513,3271762055,1672666889,1672669327,2438
10184,3534374523,3682906048,1672635242,1672636298,1056
9878,3533365834,3335055096,1672539985,1672541879,1894
10671,3510335069,3311410533,1672668076,1672669898,1822
9923,3434581257,3733123020,1672636117,1672638840,2723
10370,3500854711,3812277991,1672600663,1672603040,2377
11458,3488333295,3447938130,1672590152,1672591499,1347
10093,3701291994,3406492167,1672634879,1672635177,298
11542,3516378356,3514498259,1672569989,1672572742,2753
11605,3908883591,3511095300,1672605247,1672608154,2907
10631,3287094447,3773408491,1672677870,1672681067,3197
10217,3505359060,3776122272,1672618383,1672620331,1948
10616,3688845298,3394357241,1672654591,1672657403,2812
11353,3516378356,3514628916,1672670867,1672671504,637
10736,3837435907,3852992961,1672553651,1672554416,765
10088,3920526713,3977666815,1672655825,1672657648,1823
10643,3783967375,3609103278,1672539056,1672541662,2606
10380,3442403264,3922409420,1672673150,1672676291,3141
10693,3516706121,3243305367,1672570923,1672573313,2390
10245,3896123242,3638823001,1672608776,1672610553,1777
11767,3713969196,3624164232,1672549897,1672553310,3413
10435,3515681585,3242149533,1672678628,1672679867,1239
9843,3317989975,3770544738,1672687655,1672687834,179
9817,3665603628,3665603628,1672545746,1672549320,3574
10729,3512784888,3777387533,1672672522,1672674536,2014
10577,3780749789,3681701931,1672644133,1672647648,3515
10229,3730348493,3603167427,1672565378,1672565769,391
11585,3520694387,3200372897,1672602983,1672604972,1989
10518,3295748489,3516517348,1672673987,1672674460,473
11773,3804779247,3364302157,1672632662,1672633768,1106
11771,3714516404,3832289185,1672546954,1672548706,1752
11251,3856552205,3774792696,1672578467,1672578931,464
10161,3371184929,3505980138,1672686392,1672689197,2805
11730,3615447269,3919342147,1672690304,1672692331,2027
9904,3373802545,3444295435,1672643042,1672643235,193
11279,3500329674,3420881591,1672599324,1672600224,900
10364,3770574826,3471555057,1672544365,1672547787,3422
10022,3276499910,3499820963,1672572519,1672573390,871
10654,3501759031,3475845921,1672686106,1672686625,519
10354,3395069149,3500105301,1672586410,1672587621,1211
11626,3534937492,3515597467,1672655667,1672656808,1141
10098,3271762055,3500555856,1672625260,1672627823,2563
10451,3778738044,3920606331,1672620861,1672623389,2528
11565,3466149998,3309178914,1672679494,1672680773,1279
11003,3396656251,3837887478,1672537620,1672538512,892
11183,3289258397,3283847934,1672544535,1672545795,1260
10278,3419648004,3316121649,1672686868,1672687136,268
10069,3779382417,3632303304,1672690726,1672693559,2833
11280,3517617472,3792267993,1672612566,1672613752,1186
10795,3710891331,3934980229,1672564168,1672565058,890
11720,3517358336,3773161055,1672610929,1672614467,3538
11250,3374652108,3827836825,1672540212,1672541258,1046
11039,3371759126,3756876537,1672614041,1672617121,3080
10505,3519724388,3772114731,1672548594,1672550085,1491
11761,3517991042,3470135167,1672656494,1672659650,3156
11267,3555954355,3377446376,1672582105,1672584485,2380
9976,3387971464,3770981604,1672688162,1672691679,3517
11092,3703694139,3755767856,1672536129,1672538024,1895
10808,3442462115,3710316008,1672681877,1672682402,525
10669,3487779363,3792107875,1672606305,1672608553,2248
11560,3779255367,3446537819,1672553365,1672553789,424
10696,3479452888,3516668203,1672542428,1672545418,2990
11466,3715126587,3389367628,1672665592,1672665896,304
11594,3388923880,3804095239,1672599276,1672602670,3394
10057,3780500331,3714268380,1672563193,1672565581,2388
11656,3703336988,3242082716,1672612225,1672615003,2778
9993,3791070926,3703624327,1672568729,1672570794,2065
11351,3793442891,3780171640,1672547148,1672549082,1934
10286,3669918958,3855209450,1672560476,1672561577,1101
10871,3665603628,3773636983,1672688405,1672689340,935
11232,3505665788,3319660530,1672642292,1672642639,347
10295,3509457543,3711870537,1672582325,1672585605,3280
10863,3516319492,3855629383,1672693263,1672696676,3413
11100,3500909455,3505117019,1672629273,1672631846,2573
10186,3910049345,3290060215,1672576201,1672578485,2284
11458,3203909360,3512645289,1672581225,1672581901,676
10757,3907923381,3770764940,1672601645,1672604520,2875
11370,3920155862,3505547832,1672595450,1672597870,2420
10124,3779130507,3925098136,1672540445,1672542190,1745
10968,3829761380,3533419409,1672549627,1672550786,1159
11291,3454343398,3711187791,1672673811,1672675113,1302
10127,3730600658,3851451801,1672540657,1672541376,719
10132,3518209090,3835599049,1672606034,1672609227,3193
11200,3501828287,3512794667,1672584499,1672584836,337
10558,3713920790,3760854788,1672637661,1672638512,851
10981,3452024572,3618024815,1672577869,1672578258,389
11766,3316117186,3360972732,1672637879,1672641388,3509
10239,3225554956,3711029952,1672604449,1672606095,1646
11384,3620157388,3757823215,1672554213,1672554861,648
10940,3514508773,3756363182,1672666264,1672667244,980
10012,3414841458,3515558215,1672694809,1672695981,1172
10338,3818570577,3635433296,1672662311,1672663882,1571
9815,3330238204,3514341451,1672562595,1672562758,163
11730,3715622084,3533859712,1672598094,1672599813,1719
10498,3611533094,3732846295,1672625196,1672628060,2864
10193,3501759031,3392010033,1672648810,1672652058,3248
10234,3425646356,3772070986,1672554740,1672558329,3589
10447,3791509334,3716976932,1672629473,1672630577,1104
10286,3773738817,3423782420,1672656408,1672657608,1200
11115,3714312797,3302929858,1672589586,1672592062,2476
11152,3711870537,3770172119,1672614064,1672616415,2351
11574,3774029494,3371238318,1672588427,1672588655,228
10371,3319645922,3613781977,1672531851,1672532117,266
11687,3895944547,3515304526,1672544243,1672545896,1653
10327,3776953418,3711223297,1672542397,1672545403,3006
10397,3701824335,3515096959,1672675331,1672676287,956
11270,3904184638,3824259677,1672678136,1672679600,1464
10893,3757201138,3512641538,1672651718,1672654433,2715
11044,3932955949,3505908965,1672687035,1672687923,888
11594,3514033319,3441737317,1672584861,1672587075,2214
11755,3755230010,3755507566,1672665709,1672666637,928
10570,3360525513,3739618347,1672670418,1672670998,580
10556,3534869444,3638018906,1672608901,1672610028,1127
9843,3360525513,3791236983,1672695795,1672696028,233
10913,3714065165,3516335333,1672602604,1672604260,1656
11042,3505010941,3515096959,1672628139,1672628969,830
10059,3505685294,3304235700,1672573925,1672574229,304
10567,3716423829,3533017131,1672562860,1672565789,2929
11686,3714870496,3703336988,1672625842,1672626395,553
10479,3772216305,3201920708,1672631626,1672633143,1517
11427,3371132167,3773579644,1672688321,1672690173,1852
11433,3365839890,3516651799,1672550734,1672552088,1354
10052,3283106998,3733796228,1672535135,1672536554,1419
10475,3791409441,3774296721,1672533096,1672534805,1709
10088,3500671218,3240683148,1672622003,1672625151,3148
11500,3755361692,3760396348,1672655030,1672658525,3495
9896,3666958814,3927365255,1672678490,1672680740,2250
10027,3471555057,3464622743,1672690605,1672693317,2712
11713,3554236075,3520273299,1672602657,1672605400,2743
10655,3793704155,3513545735,1672692925,1672694036,1111
9932,3477951091,3882851213,1672635263,1672635731,468
9823,3899156705,3893629892,1672656014,1672658717,2703
11419,3351728355,3616403486,1672664384,1672665297,913
11527,3896123242,3772802020,1672676411,1672677736,1325
10320,3792578118,3335353798,1672533321,1672535184,1863
10064,3472173212,3458130310,1672696372,1672698905,2533
10266,3518511124,3713069234,1672638447,1672639359,912
11565,3514801709,3516167000,1672644361,1672646671,2310
10608,3780942505,3777135415,1672550775,1672552780,2005
10597,3509382404,3476958001,1672595636,1672597990,2354
11212,3351728355,3756367938,1672534753,1672535887,1134
9874,3555764822,3514737648,1672595508,1672597091,1583
10591,3514698862,3473520701,1672635857,1672638602,2745
10390,3440305508,3974264211,1672660235,1672660419,184
11305,3713767153,3349573092,1672601025,1672604274,3249
11306,3710585241,3811503860,1672689385,1672690452,1067
11751,3780127017,3853783593,1672557913,1672561333,3420
10924,3245755569,3773475506,1672533464,1672536683,3219
9821,3235578852,3520860199,1672616886,1672620318,3432
11225,3715249954,3779382417,1672549455,1672549579,124
10558,3914740937,3792719263,1672689771,1672691393,1622
10402,3278779955,3287734830,1672631131,1672632820,1689
11133,3445406685,3226172318,1672662561,1672665345,2784
10370,3757855416,3485898181,1672572944,1672574103,1159
10369,3783611957,3490953301,1672606242,1672607010,768
9855,3772905073,3737738751,1672689092,1672689744,652
10261,3624872714,3445077330,1672690412,1672690766,354
9956,3204473480,3379666159,1672653148,1672653763,615
11555,3922786716,3511963020,1672630182,1672631829,1647
11529,3689386663,3757523596,1672639379,1672639681,302
9937,3406937294,3681701931,1672688484,1672691122,2638
10016,3435652260,3420983899,1672644423,1672644872,449
11286,3825526565,3364302157,1672586836,1672586963,127
10343,3511198566,3500049870,1672568265,1672571444,3179
10586,3512826895,3500833053,1672569958,1672572048,2090
11355,3203151036,3605760561,1672571516,1672572427,911
10871,3405200303,3929923442,1672583047,1672585120,2073
9801,3770480149,3701841013,1672639986,1672642707,2721
11085,3385416697,3406029706,1672543607,1672543711,104
10395,3478052226,3665478011,1672658657,1672661199,2542
10134,3505720915,3715261950,1672652679,1672654572,1893
9961,3500909455,3715680249,1672614367,1672616183,1816
10460,3888903181,3715881104,1672630489,1672632587,2098
11416,3757050615,3500776597,1672563740,1672566721,2981
10364,3505140123,3534667712,1672571020,1672573082,2062
10666,3516486526,3510968599,1672599657,1672601241,1584
10164,3713283029,3206544535,1672701664,1672702669,1005
11194,3517149023,3713139039,1672679929,1672681773,1844
10268,3756740153,3302879906,1672553140,1672554476,1336
10144,3358675021,3513996288,1672591639,1672592148,509
10226,3770631449,3505502819,1672598742,1672599505,763
9865,3330466913,3776125503,1672583511,1672586329,2818
10748,3633860380,3464622743,1672607419,1672609872,2453
9959,3714718326,3711844574,1672539249,1672541171,1922
10595,3501027795,3227059650,1672596244,1672598371,2127
9811,3828568868,3519621901,1672666535,1672668056,1521
11367,3445406685,3793442891,1672554686,1672557041,2355
10174,3610517436,3884001167,1672542006,1672543417,1411
10061,3295530454,3715844082,1672537539,1672540838,3299
10906,3241593146,3505825767,1672679262,1672682451,3189
11526,3307791650,3621812406,1672653740,1672654153,413
10477,3517144269,3977157565,1672585815,1672589392,3577
10458,3909504515,3317887374,1672686969,1672687718,749
10386,3714892312,3418683594,1672547175,1672549033,1858
10924,3770285500,3856129522,1672681799,1672683906,2107
10259,3375905193,3389069291,1672699437,1672702028,2591
10762,3273537848,3716197140,1672630226,1672632873,2647
10074,3505665253,3395565040,1672603600,1672605289,1689
10401,3710119555,3511382748,1672696278,1672699843,3565
10328,3809871495,3501174621,1672538189,1672540499,2310
10571,3468871103,3514306458,1672549790,1672550119,329
10457,3703031637,3302929858,1672703047,1672703480,433
11549,3770533588,3500579482,1672559071,1672560715,1644
11422,3474097405,3559754304,1672689149,1672689854,705
10292,3402105276,3773603836,1672675283,1672675870,587
10143,3515379622,3418791124,1672552057,1672555403,3346
11236,3893932944,3450679913,1672533386,1672533791,405
11201,3774682234,3922480066,1672693144,1672693315,171
11717,3450735824,3339331632,1672661587,1672663119,1532
10248,3394976623,3822496670,1672657180,1672658426,1246
11031,3905358065,3513661302,1672600018,1672600850,832
10609,3500544306,3516588277,1672591716,1672594841,3125
11614,3243305367,3623953446,1672564805,1672565641,836
11053,3777304517,3777878462,1672654834,1672655071,237
10350,3760144712,3900766525,1672569663,1672572209,2546
11526,3837888196,3378534521,1672680841,1672682683,1842
10995,3777878462,3287753579,1672557286,1672559231,1945
11332,3906075386,3519435459,1672643824,1672644604,780
11775,3516932899,3792440162,1672602299,1672604517,2218
9903,3400560073,3486824047,1672699427,1672702706,3279
11183,3384151770,3511245705,1672537958,1672540960,3002
10542,3244495586,3710865678,1672565560,1672566566,1006
11238,3780148144,3681701931,1672693231,1672693509,278
10112,3792719263,3380218091,1672667959,1672669984,2025
10572,3505502819,3375906394,1672594556,1672597185,2629
11362,3664478769,3907390925,1672558222,1672560918,2696
10786,3780048608,3853182912,1672618181,1672620021,1840
10840,3976400190,3760396348,1672649741,1672653073,3332
11601,3619494735,3733411026,1672555588,1672556068,480
10420,3295530454,3715602742,1672549936,1672550302,366
11526,3916924978,3713069234,1672558889,1672559947,1058
10960,3294326116,3638126174,1672637585,1672640867,3282
9953,3231153513,3472272792,1672617345,1672620523,3178
10263,3505331083,3501550490,1672693347,1672693925,578
11516,3413511621,3364948616,1672632774,1672634102,1328
10559,3310712221,3497562878,1672586279,1672587040,761
10731,3639503148,3899970524,1672697673,1672699889,2216
11479,3519297683,3516340010,1672645761,1672646167,406
10803,3510939082,3514585995,1672631744,1672632422,678
11190,3511296895,3438028077,1672681438,1672681811,373
10889,3776600696,3733953055,1672657586,1672661082,3496
10203,3682241594,3281970147,1672659184,1672660947,1763
10586,3294952405,3703896751,1672654581,1672655703,1122
11749,3200785194,3518478484,1672566683,1672569284,2601
10688,3392482187,3311188620,1672633328,1672636154,2826
11441,3772962072,3477248170,1672561542,1672563194,1652
10903,3755570137,3319585148,1672675999,1672677250,1251
9872,3931164237,3381244346,1672561825,1672565029,3204
9816,3225371682,3809207482,1672616795,1672619441,2646
11348,3338115824,3437286595,1672603371,1672606217,2846
11055,3978254945,3247193800,1672634755,1672636929,2174
11158,3398489033,3501628472,1672642922,1672643812,890
10139,3791796190,3716209499,1672572920,1672574291,1371
10413,3304028109,3510262025,1672672950,1672673782,832
10017,3444168914,3399430522,1672616715,1672618914,2199
11079,3818461836,3440305508,1672677950,1672678252,302
10612,3802625412,3715204544,1672685775,1672689105,3330
11099,3783021859,3302348002,1672617466,1672619537,2071
11615,3227956115,3203172170,1672566033,1672568928,2895
10126,3710397477,3924583142,1672612528,1672614334,1806
11309,3770275898,3791574640,1672610031,1672611193,1162
10420,3779505358,3513629502,1672609974,1672610934,960
10566,3903088144,3780308809,1672548007,1672548892,885
9820,3923524564,3359929534,1672688205,1672689622,1417
10253,3713636175,3908464960,1672624325,1672626550,2225
11080,3510968599,3476308535,1672569002,1672571632,2630
11261,3477248170,3807584987,1672625072,1672628278,3206
11101,3307997700,3510439480,1672655784,1672656217,433
11222,3779160052,3239423794,1672534341,1672534438,97
9868,3479207976,3688410383,1672619636,1672622206,2570
10022,3703031637,3970851830,1672682809,1672684573,1764
10414,3501192566,3806720019,1672596871,1672599011,2140
10395,3856699097,3733423371,1672616182,1672616576,394
11047,3791628195,3710529628,1672665614,1672666787,1173
11080,3612841103,3625400710,1672548718,1672549152,434
10911,3611832288,3519703964,1672579117,1672582552,3435
11357,3501759031,3934564437,1672620312,1672623721,3409
10354,3492056330,3935520819,1672679743,1672682816,3073
11332,3885147558,3755286041,1672666148,1672668462,2314
11497,3855077502,3361865467,1672679162,1672682512,3350
11294,3757060033,3533929043,1672598505,1672600440,1935
10835,3912181197,3903065952,1672582505,1672584126,1621
11500,3883640454,3519341916,1672647835,1672648061,226
10363,3770275898,3924583142,1672693247,1672694213,966
10184,3711029952,3703277359,1672640042,1672641046,1004
10106,3701265238,3713954144,1672582934,1672586009,3075
10876,3288675710,3826542169,1672618917,1672619764,847
10668,3773378103,3630802959,1672656055,1672657756,1701
10052,3686081254,3440770466,1672683239,1672685277,2038
10850,3896622009,3500018566,1672583746,1672584549,803
10313,3418997135,3778044082,1672546510,1672549616,3106
11550,3417360319,3501548163,1672557726,1672558065,339
9889,3681504869,3355880028,1672666243,1672668267,2024
9984,3909067335,3914740937,1672574470,1672578041,3571
11430,3716976932,3398021818,1672627303,1672628818,1515
11525,3713475356,3778182724,1672564669,1672567294,2625
11327,3776617627,3311410533,1672635751,1672639300,3549
11725,3355903597,3510882475,1672585687,1672588636,2949
10816,3714658474,3732090606,1672585868,1672586908,1040
10434,3623067708,3240443426,1672580822,1672582795,1973
11089,3500440602,3780238637,1672628617,1672631540,2923
11639,3922786716,3477248170,1672626077,1672627410,1333
10214,3822368676,3333355914,1672571602,1672575045,3443
10171,3713475356,3813111107,1672637523,1672639446,1923
11289,3667814788,3443041059,1672593593,1672597083,3490
11011,3518205307,3774273260,1672602371,1672603109,738
10739,3554174421,3715008501,1672604929,1672607494,2565
10714,3817478012,3760382349,1672623535,1672624136,601
10965,3505845400,3447202943,1672548058,1672549079,1021
11123,3663353552,3293673220,1672618075,1672620547,2472
9898,3757501067,3757623259,1672607131,1672609171,2040
11356,3249771731,3778932673,1672588214,1672591315,3101
9806,3774447975,3757994002,1672533732,1672534579,847
10895,3770276815,3478455812,1672701747,1672705278,3531
10584,3772882440,3516034245,1672572985,1672575099,2114
11211,3311771689,3774965463,1672591093,1672591264,171
9951,3505117019,3370448531,1672592491,1672594589,2098
10475,3755369666,3319529422,1672544925,1672545957,1032
10479,3432838598,3812756400,1672695460,1672697651,2191
11556,3505500665,3505359060,1672551228,1672552093,865
10759,3904045870,3783443095,1672594397,1672596313,1916
11046,3609925909,3500105301,1672641835,1672644744,2909
11500,3776901443,3778604070,1672696410,1672698110,1700
10450,3440743218,3510368377,1672637143,1672640336,3193
10827,3505624416,3777118499,1672567099,1672568542,1443
9971,3792283334,3469780362,1672538932,1672540464,1532
10054,3825153408,3442181067,1672650470,1672653643,3173
10945,3410602007,3520926977,1672632458,1672635671,3213
11217,3277634944,3783021859,1672547623,1672548554,931
10346,3701041860,3780733404,1672638984,1672641003,2019
9876,3716179251,3774205060,1672600270,1672603011,2741
11233,3501427691,3779604279,1672692701,1672693617,916
11059,3518067857,3205113625,1672670541,1672672082,1541
9934,3513186622,3238796398,1672623861,1672624188,327
9980,3450342110,3772877723,1672554089,1672556292,2203
11277,3660176760,3857609616,1672576374,1672578448,2074
10568,3937636109,3772659062,1672544247,1672545176,929
10791,3514853709,3908464960,1672681795,1672682507,712
10658,3452982957,3713547793,1672602787,1672603089,302
10652,3619705594,3309528048,1672557859,1672558295,436
11492,3424476995,3633294415,1672611189,1672612892,1703
10743,3710865678,3353194923,1672660957,1672663538,2581
10092,3803996569,3931495845,1672568132,1672569063,931
11082,3739297004,3516731917,1672584455,1672584785,330
11079,3970851830,3805831563,1672582320,1672584140,1820
11276,3780213684,3291936679,1672599102,1672599448,346
9916,3713767153,3488931357,1672686790,1672690300,3510
10499,3505117019,3511500932,1672631025,1672633465,2440
10667,3666823095,3240622654,1672596491,1672596970,479
10648,3917905192,3510240661,1672554410,1672555214,804
10353,3509431396,3760385591,1672613655,1672616609,2954
10271,3891586951,3500928990,1672607365,1672608178,813
11397,3374652108,3311231911,1672639609,1672640357,748
11496,3792289287,3710813103,1672598839,1672600805,1966
11658,3510869438,3520763492,1672605080,1672606988,1908
10431,3910020031,3888523259,1672585623,1672587060,1437
10450,3394394262,3511663572,1672638542,1672640011,1469
10265,3308481706,3737622701,1672581220,1672582774,1554
10892,3519948471,3853386575,1672594685,1672596287,1602
11460,3533816813,3513486828,1672614533,1672617006,2473
11384,3638071975,3519513219,1672573474,1672574001,527
10440,3220976338,3272838634,1672644087,1672646852,2765
10981,3772019557,3342252701,1672643832,1672646709,2877
9843,3501835995,3680278447,1672567575,1672568360,785
10879,3831864108,3533473206,1672556780,1672560017,3237
10102,3832333115,3791994414,1672631094,1672632680,1586
10482,3755107521,3773424266,1672547070,1672547881,811
11438,3515838621,3514515499,1672637748,1672640977,3229
10330,3405303958,3776600696,1672697406,1672698865,1459
11201,3380185102,3509317776,1672660902,1672661304,402
11312,3511466117,3772509599,1672570731,1672573580,2849
11622,3773161055,3512371853,1672607298,1672610857,3559
11296,3902300755,3832002939,1672687973,1672688448,475
10186,3304592684,3501550490,1672630257,1672633323,3066
11779,3510694464,3298113026,1672563428,1672565473,2045
11430,3612042508,3703415246,1672700717,1672701208,491
10324,3737467358,3777060250,1672665804,1672668036,2232
11016,3501759031,3489205994,1672608072,1672610745,2673
10515,3248061684,3517800171,1672684496,1672685767,1271
10571,3703749690,3500543341,1672581048,1672582804,1756
11152,3703611876,3509167758,1672578145,1672580364,2219
10794,3403035480,3304592684,1672576048,1672576489,441
10630,3886879696,3246296769,1672609851,1672610900,1049
10117,3533036499,3491390365,1672701157,1672703164,2007
10513,3919494952,3484739955,1672617569,1672620781,3212
10814,3510209505,3776249160,1672558752,1672558898,146
11718,3505825767,3778695017,1672574886,1672577949,3063
11300,3917905192,3509208005,1672614788,1672616248,1460
11267,3447078933,3974264211,1672552404,1672555502,3098
10623,3472561941,3515944817,1672690947,1672692435,1488
10408,3713476192,3716197140,1672683032,1672683694,662
11729,3518882056,3711862792,1672681813,1672684430,2617
9831,3779212271,3773736248,1672566491,1672566950,459
9883,3403395712,3887918622,1672623670,1672623865,195
11756,3938398160,3515528947,1672621748,1672624382,2634
11510,3505685294,3682150740,1672557692,1672559495,1803
11346,3701655378,3205948776,1672616995,1672618229,1234
11691,3931495845,3757001552,1672695217,1672695588,371
11135,3624365837,3519689906,1672540160,1672543241,3081
9833,3246062632,3505392452,1672544302,1672544415,113
11322,3609644043,3773376762,1672612036,1672614301,2265
10605,3755502373,3776841808,1672683337,1672685446,2109
11047,3387870683,3910354786,1672610157,1672612655,2498
10211,3820200446,3606804618,1672701297,1672701964,667
10825,3793364952,3366164642,1672605616,1672606540,924
10721,3912915644,3505496725,1672601596,1672604446,2850
11436,3391854325,3440743218,1672563129,1672565245,2116
11331,3311045951,3688870751,1672569726,1672571817,2091
10175,3208560443,3776778306,1672550674,1672552790,2116
10268,3399943757,3500317923,1672568469,1672571964,3495
9817,3793232021,3505449070,1672633296,1672635300,2004
10154,3713969196,3313824913,1672579032,1672580102,1070
11290,3278629965,3757924067,1672563328,1672564403,1075
10336,3971280379,3755107521,1672653450,1672653779,329
11760,3387413950,3509663119,1672584716,1672586763,2047
10161,3367299721,3909220912,1672634939,1672635620,681
10393,3501208658,3369938668,1672596303,1672597224,921
11349,3710060386,3472018395,1672532655,1672534015,1360
10791,3447696555,3534426696,1672579551,1672581764,2213
11694,3406169279,3778479297,1672628736,1672628858,122
10718,3533325993,3934991640,1672541734,1672544764,3030
10451,3783935976,3533593766,1672656159,1672656818,659
10270,3533976217,3406132280,1672617980,1672621072,3092
10489,3738132114,3779689733,1672641950,1672644679,2729
10578,3778932673,3298706213,1672542465,1672543405,940
11442,3511750695,3837888196,1672632424,1672633437,1013
10006,3757584114,3918981936,1672622072,1672622588,516
10890,3513140146,3445558740,1672590933,1672592197,1264
10529,3735056027,3513111053,1672643652,1672645794,2142
10203,3770925016,3895944547,1672626356,1672627909,1553
10952,3837435907,3519319233,1672601588,1672605182,3594
9870,3711810752,3793222045,1672634843,1672635416,573
10007,3760271237,3625779003,1672680570,1672681603,1033
11224,3608973523,3770276815,1672703482,1672705171,1689
11094,3500442370,3931495845,1672651978,1672654197,2219
10915,3776316903,3454151554,1672667109,1672668313,1204
10790,3500221079,3772055279,1672586805,1672588485,1680
10184,3779382417,3971422524,1672642130,1672643568,1438
10258,3814770073,3500776597,1672671697,1672674325,2628
10338,3513586642,3514571807,1672684434,1672685707,1273
11760,3714116241,3779382417,1672535107,1672536810,1703
9882,3287753579,3239990061,1672584142,1672587412,3270
11028,3791106473,3344710271,1672671077,1672672548,1471
10283,3818570577,3231271498,1672690303,1672690412,109
10850,3361789225,3783679478,1672702650,1672703873,1223
11700,3305093237,3779415433,1672639213,1672642565,3352
10670,3850904092,3972442654,1672619820,1672621877,2057
10079,3853188285,3511296895,1672677100,1672679375,2275
10260,3701449715,3452389513,1672573552,1672576918,3366
11641,3319436533,3713606829,1672665930,1672667369,1439
11769,3388774559,3516497645,1672566424,1672567803,1379
10803,3511412229,3772509599,1672560827,1672562441,1614
10776,3515655024,3360972732,1672536120,1672539096,2976
11301,3306491253,3921138062,1672671307,1672673366,2059
10431,3399504157,3757050615,1672680872,1672681677,805
10574,3370401047,3971282455,1672653831,1672655336,1505
11232,3713726267,3311159418,1672643258,1672644332,1074
11204,3756168814,3476416072,1672569255,1672569455,200
10768,3756736726,3505571800,1672607253,1672610651,3398
10100,3469663062,3783430498,1672541511,1672543637,2126
11218,3331228758,3903088144,1672600488,1672603401,2913
11557,3760997159,3715881104,1672683925,1672684017,92
11357,3513850048,3776534957,1672689819,1672692946,3127
10149,3711287751,3776953418,1672690367,1672691910,1543
11438,3240683148,3230612965,1672593749,1672595091,1342
10632,3939882169,3703779674,1672595341,1672595503,162
11134,3510149298,3450503086,1672575948,1672579073,3125
10943,3512769522,3915679140,1672620047,1672621494,1447
11660,3511415786,3316551382,1672617134,1672619179,2045
10088,3514638555,3395565040,1672642681,1672645392,2711
11048,3514455363,3406169279,1672542474,1672544515,2041
10656,3203151036,3668764192,1672582219,1672583996,1777
10859,3774296721,3715590997,1672612293,1672615547,3254
10763,3317190427,3777672363,1672658864,1672662005,3141
11725,3398862999,3917905192,1672693760,1672694808,1048
10846,3405303958,3311515179,1672675457,1672678731,3274
11257,3378430760,3975796415,1672659416,1672659555,139
11021,3403177609,3515259326,1672556152,1672559092,2940
10771,3814672661,3287094447,1672628267,1672629863,1596
10028,3491104534,3780941637,1672567212,1672568079,867
11025,3373677765,3500329674,1672684005,1672686281,2276
10498,3894756677,3793003432,1672546753,1672547303,550
10082,3285971415,3205161801,1672551668,1672553010,1342
11302,3713805968,3663902064,1672566639,1672567769,1130
10131,3711015176,3832312129,1672608952,1672610366,1414
11128,3517045396,3624365837,1672595284,1672597257,1973
10387,3494680853,3821082558,1672552264,1672554711,2447
9824,3533976217,3500909455,1672632018,1672634221,2203
10410,3703277359,3715844082,1672591158,1672592654,1496
11036,3398862999,3682802569,1672588812,1672592011,3199
10811,3516517348,3311583437,1672633403,1672636607,3204
10110,3780168985,3772296376,1672600110,1672602962,2852
11252,3738526914,3435652260,1672613935,1672616832,2897
10785,3513384042,3834643026,1672664021,1672667056,3035
10395,3760024021,3354968884,1672664491,1672665426,935
11073,3701925712,3374652108,1672541477,1672544507,3030
10879,3514564903,3924366353,1672614843,1672615920,1077
11154,3516026189,3445077330,1672607479,1672608567,1088
10328,3509677530,3516932899,1672532719,1672533314,595
11488,3294326116,3779130507,1672587262,1672588937,1675
11691,3626631210,3533593766,1672544939,1672546767,1828
11588,3811629200,3773603836,1672632614,1672633445,831
9974,3780956975,3534372899,1672692363,1672694249,1886
9958,3275751794,3206544535,1672576839,1672579522,2683
10970,3500821475,3516969689,1672641199,1672643974,2775
11411,3834643026,3517810375,1672645082,1672647216,2134
11532,3756675909,3520779124,1672555114,1672558486,3372
11398,3755630085,3534696810,1672587398,1672588101,703
10616,3533037906,3772845364,1672666821,1672668664,1843
10361,3760346746,3414841458,1672696616,1672698943,2327
10007,3714101349,3471507117,1672579892,1672581063,1171
10118,3839308659,3467232654,1672697526,1672698717,1191
10924,3703588004,3306037126,1672672720,1672676191,3471
10462,3400560073,3500440602,1672703475,1672705153,1678
10237,3756413374,3342056927,1672636044,1672639147,3103
11433,3510819040,3330466913,1672657438,1672659841,2403
9890,3756413374,3934991640,1672702674,1672705179,2505
10920,3660246433,3519356606,1672669664,1672673112,3448
10472,3291153514,3510836047,1672656295,1672658948,2653
11701,3505839395,3791688526,1672655455,1672655516,61
11420,3510535683,3979366845,1672557351,1672557581,230
9886,3828354855,3711015176,1672654228,1672657447,3219
11736,3510916875,3505538902,1672639451,1672641470,2019
11144,3917243005,3209075485,1672637130,1672639222,2092
9884,3455907179,3890813040,1672599103,1672601958,2855
10924,3755238321,3902023467,1672693129,1672693691,562
11092,3774652449,3901169230,1672596219,1672599748,3529
11111,3818532143,3387322545,1672637156,1672638961,1805
10181,3519319233,3715587520,1672555868,1672556274,406
11416,3773953689,3818570577,1672562164,1672562693,529
10272,3382757142,3355899481,1672667842,1672668751,909
11726,3501554468,3714179543,1672533401,1672536290,2889
10786,3773024346,3716994924,1672544636,1672545216,580
10545,3534362749,3357026115,1672681766,1672682292,526
11555,3733870816,3832902787,1672618787,1672621938,3151
10103,3511663572,3533566754,1672560973,1672562231,1258
10084,3770709417,3757212744,1672624851,1672626811,1960
11778,3813853446,3619676231,1672566714,1672566901,187
10610,3494748808,3533841983,1672562089,1672564800,2711
11673,3791269060,3500688476,1672572514,1672573070,556
11125,3779665641,3390438262,1672669023,1672670876,1853
10211,3817120976,3776124041,1672690106,1672691032,926
10498,3435652260,3452802329,1672673807,1672674472,665
11150,3716095450,3343616490,1672623894,1672624907,1013
10848,3283785820,3505129296,1672567064,1672568606,1542
10469,3316117186,3780921044,1672628184,1672628387,203
10551,3424476995,3856699097,1672673439,1672673588,149
11679,3306066522,3838423363,1672592702,1672594554,1852
9969,3829358750,3770019143,1672685190,1672685661,471
10791,3739075176,3398483531,1672552473,1672552794,321
10875,3934980229,3934980229,1672695993,1672697038,1045
11494,3737745988,3826997668,1672643729,1672644941,1212
10882,3822786416,3494680853,1672575131,1672578200,3069
10628,3465672238,3357496255,1672557515,1672558073,558
10172,3339649817,3515378306,1672594661,1672595120,459
10492,3477951091,3885422379,1672542435,1672542852,417
10265,3500018566,3509297453,1672682658,1672684481,1823
11217,3394986304,3514498259,1672693853,1672694412,559
10168,3912878303,3512495325,1672539905,1672542454,2549
10273,3773697080,3534122907,1672636477,1672638115,1638
11445,3505769529,3791070926,1672698659,1672698776,117
10292,3716669659,3510244209,1672702034,1672705424,3390
10526,3770671714,3793874490,1672539087,1672539574,487
11590,3711187791,3760416450,1672548723,1672549486,763
10659,3559125467,3713336088,1672693483,1672696885,3402
9882,3515100211,3884933821,1672646778,1672648845,2067
11292,3770276815,3282053097,1672682318,1672684902,2584
11221,3331228758,3776200012,1672694234,1672697207,2973
10072,3779818784,3298706213,1672673773,1672675835,2062
11495,3882580580,3509912164,1672536984,1672539410,2426
11325,3444397804,3435715962,1672635735,1672638321,2586
10904,3472018395,3793375825,1672591623,1672593770,2147
11260,3463883997,3474350534,1672565101,1672567801,2700
11766,3340723781,3623894390,1672682775,1672683488,713
10341,3512395783,3885545415,1672604797,1672607181,2384
10219,3793987483,3813986705,1672562855,1672563135,280
11767,3701655378,3447253775,1672686484,1672688804,2320
11015,3364067937,3757607649,1672693233,1672693325,92
9830,3783563043,3461931154,1672539071,1672539223,152
10971,3929391979,3505756991,1672602262,1672602438,176
9968,3830291558,3513563152,1672682816,1672685696,2880
10880,3311305760,3533325993,1672635009,1672636525,1516
10774,3496579251,3634670780,1672679635,1672679786,151
9928,3713920790,3374147279,1672630673,1672631328,655
10492,3505119470,3205948776,1672611491,1672614510,3019
11054,3437703650,3924963918,1672547383,1672549530,2147
11696,3310712221,3772131127,1672701097,1672704680,3583
9877,3505786561,3716922925,1672701776,1672702271,495
10152,3495446254,3311583437,1672614861,1672616257,1396
11666,3380357490,3533009565,1672694431,1672697526,3095
10127,3792597493,3378534521,1672621805,1672622627,822
10425,3611533094,3774205060,1672551847,1672552357,510
11280,3837887478,3278443807,1672696760,1672696989,229
10146,3554317844,3501271930,1672600960,1672601485,525
10301,3510278533,3243305367,1672666950,1672668824,1874
11186,3533113740,3772869013,1672581701,1672585085,3384
11042,3421040626,3825153408,1672688379,1672689370,991
10710,3203172170,3791522832,1672683773,1672684976,1203
11264,3779951373,3713434898,1672594364,1672597249,2885
11145,3716389356,3501557463,1672592061,1672593313,1252
10889,3485468650,3760966645,1672670978,1672674246,3268
10896,3501192566,3513186622,1672693356,1672696433,3077
10350,3733796228,3281935691,1672560043,1672563195,3152
10397,3552261072,3517136772,1672674523,1672677966,3443
10209,3733796228,3517810375,1672690818,1672693473,2655
10527,3366164642,3501711464,1672595997,1672598507,2510
11550,3615742989,3772164469,1672643792,1672645622,1830
11045,3381055770,3360783381,1672572365,1672572435,70
11477,3298706213,3341738186,1672684562,1672685309,747
11047,3792337863,3445172440,1672691707,1672693863,2156
11751,3703419800,3633860380,1672659903,1672661240,1337
10321,3776125503,3348100657,1672658596,1672659918,1322
10778,3357097510,3774236212,1672691412,1672693303,1891
11072,3783430498,3780213684,1672624635,1672626362,1727
11162,3513111053,3496591885,1672692671,1672693836,1165
11398,3780964089,3519724388,1672644762,1672646201,1439
11092,3774109138,3778370462,1672672423,1672673757,1334
11387,3423353911,3667814788,1672666914,1672668859,1945
9983,3772282008,3364286028,1672640713,1672641746,1033
10635,3730459093,3277634944,1672695788,1672696580,792
10330,3295748489,3510795808,1672603944,1672605901,1957
11535,3791796190,3774436159,1672616233,1672618665,2432
10751,3510189563,3914947393,1672699816,1672702127,2311
10665,3701449715,3854229296,1672531678,1672532822,1144
10725,3791825536,3935256825,1672652751,1672654805,2054
11204,3514352989,3241593146,1672624779,1672625346,567
10543,3513186622,3710008760,1672692909,1672693583,674
10662,3792633495,3778044082,1672679580,1672680585,1005
11535,3501853868,3223796145,1672702181,1672702487,306
10118,3825153408,3710228292,1672647079,1672648835,1756
10560,3436401020,3359351267,1672680067,1672680372,305
11581,3500031401,3511963020,1672695708,1672697272,1564
11359,3238056215,3486509752,1672555011,1672556463,1452
11530,3934280144,3509677530,1672597936,1672601161,3225
10826,3793689267,3774109138,1672624047,1672624528,481
10188,3716841469,3682150740,1672666442,1672670003,3561
9952,3774316305,3511078598,1672688689,1672690254,1565
10451,3447078933,3472774606,1672632119,1672634387,2268
10626,3733730342,3770391782,1672702761,1672706031,3270
11110,3469663062,3494748808,1672611914,1672614736,2822
10989,3820200446,3533419409,1672545228,1672547171,1943
10502,3830962592,3514564903,1672531947,1672535492,3545
10094,3372617110,3510894809,1672635779,1672636622,843
10889,3822634862,3558349840,1672670593,1672672635,2042
11239,3313298164,3509073025,1672641908,1672644476,2568
10322,3778195766,3533628528,1672576832,1672578604,1772
11567,3509431396,3552309108,1672661678,1672665222,3544
9988,3534869444,3408111327,1672577273,1672580781,3508
10446,3770476738,3239990061,1672682016,1672683796,1780
11428,3425646356,3517377614,1672540361,1672541911,1550
11775,3701655378,3519465545,1672600505,1672603643,3138
11206,3716526314,3710147457,1672644011,1672644396,385
10805,3639503148,3733730342,1672566105,1672566443,338
10393,3501628472,3518088154,1672648824,1672649391,567
10795,3701350519,3624365837,1672606025,1672609349,3324
9877,3837378340,3852014884,1672680207,1672681056,849
10335,3516586325,3517440258,1672534275,1672534918,643
10096,3755411110,3312733562,1672618827,1672619938,1111
10202,3793996996,3533859712,1672647435,1672647648,213
10362,3421956717,3534278019,1672579569,1672581763,2194
10760,3780142207,3710819760,1672646023,1672647172,1149
11287,3315432466,3511650296,1672700163,1672702803,2640
10308,3739387948,3600871715,1672564784,1672566621,1837
11119,3342252701,3330466913,1672600814,1672602008,1194
11258,3773891827,3917243005,1672699572,1672701158,1586
10161,3776841808,3757501067,1672598898,1672598980,82
10442,3757393413,3701127475,1672576069,1672578800,2731
10019,3974400577,3934564437,1672551026,1672553611,2585
11639,3760901975,3206544535,1672685427,1672686386,959
10834,3378430760,3500974385,1672568777,1672568901,124
11544,3897500723,3533642281,1672653635,1672657010,3375
10183,3836757034,3701127475,1672612267,1672615660,3393
10159,3622458047,3793920312,1672558885,1672561177,2292
10116,3426207439,3511526885,1672619187,1672619344,157
10864,3609335008,3977360666,1672566980,1672569197,2217
11757,3601063076,3509996827,1672550790,1672552276,1486
11212,3515939841,3792578118,1672617937,1672620797,2860
10477,3505173665,3500011591,1672606319,1672608364,2045
10445,3776867553,3311602936,1672636997,1672638593,1596
10150,3517800171,3476308535,1672698766,1672699505,739
10566,3288675710,3311331205,1672549183,1672551907,2724
10667,3304252969,3468066881,1672565732,1672568063,2331
9932,3451757423,3683514731,1672558642,1672560947,2305
10573,3773636983,3500927619,1672586715,1672589014,2299
11402,3779255367,3776053084,1672649046,1672650427,1381
11111,3398483531,3512726649,1672640797,1672643605,2808
10029,3776309810,3779382417,1672609807,1672613002,3195
10646,3465227623,3357026115,1672535787,1672537842,2055
10852,3791074200,3513740840,1672664701,1672667399,2698
9989,3520049965,3853188285,1672668155,1672670577,2422
10703,3661359073,3715712376,1672613415,1672615826,2411
10874,3755502373,3513816744,1672658450,1672658562,112
11536,3807646028,3519922921,1672686235,1672688802,2567
11323,3227059650,3713373455,1672531654,1672533878,2224
10003,3371132167,3533628528,1672662086,1672665176,3090
11751,3636857871,3730115019,1672702456,1672704536,2080
10698,3713285095,3791509881,1672573346,1672575855,2509
9827,3756119976,3509996827,1672657190,1672658689,1499
10169,3774304163,3701519251,1672654584,1672657867,3283
10647,3714294005,3510244209,1672674306,1672677835,3529
10449,3518067857,3306491253,1672586823,1672588983,2160
9994,3882851213,3783176874,1672564306,1672566933,2627
11020,3517797610,3776440009,1672576471,1672576656,185
10366,3512857020,3510987684,1672665826,1672666443,617
10487,3510149298,3310712221,1672646759,1672647915,1156
9949,3666561358,3478915403,1672652307,1672654615,2308
9982,3220976338,3362368123,1672665540,1672666852,1312
10291,3477951091,3342426430,1672614152,1672614299,147
10367,3822496670,3793783685,1672669787,1672671212,1425
11559,3825795004,3792797648,1672632701,1672635297,2596
10388,3714142299,3274239253,1672602976,1672605229,2253
11062,3774946684,3703742071,1672665098,1672665827,729
10956,3621439107,3793407883,1672541692,1672544945,3253
11124,3897003751,3279726491,1672672369,1672673355,986
11760,3516020922,3505032773,1672619268,1672621521,2253
11723,3459694275,3757872458,1672615309,1672615455,146
10449,3248061684,3854229296,1672583159,1672586750,3591
10311,3311197635,3710865678,1672664496,1672667000,2504
11772,3815184540,3615742989,1672573359,1672573721,362
10474,3511750850,3511218261,1672646666,1672647864,1198
11433,3627377299,3343511947,1672684576,1672685305,729
10670,3366801723,3246296769,1672680708,1672681423,715
11359,3235198316,3372596013,1672553758,1672554258,500
10073,3825153408,3793899166,1672541285,1672541902,617
10728,3773736248,3716669659,1672692925,1672695010,2085
10262,3515304526,3447202943,1672561993,1672564316,2323
10779,3505175620,3515047288,1672570983,1672571218,235
10062,3500693568,3755238321,1672555899,1672558256,2357
9949,3772055279,3284334297,1672658418,1672659372,954
11120,3518209090,3880549316,1672543402,1672545053,1651
10846,3517902505,3972856326,1672662399,1672663414,1015
10925,3439532406,3932491622,1672654673,1672658074,3401
11337,3772291207,3715441777,1672611962,1672612615,653
10711,3306066522,3514021667,1672563782,1672566133,2351
10224,3776319560,3312959324,1672640369,1672643187,2818
11205,3512495325,3519513219,1672539397,1672542566,3169
11127,3306475287,3511908639,1672658600,1672661278,2678
10045,3896622009,3512555384,1672656484,1672658485,2001
11637,3629248353,3792255406,1672672805,1672673947,1142
10288,3510987684,3515284733,1672600623,1672602287,1664
10638,3633860380,3469778316,1672615917,1672618454,2537
10098,3517227599,3552922094,1672542596,1672545826,3230
10231,3402774497,3488988274,1672688196,1672690863,2667
11781,3304235700,3760396348,1672698271,1672699212,941
10231,3772980989,3370512945,1672689723,1672691516,1793
11753,3220976338,3517440258,1672567763,1672570983,3220
11308,3778044082,3227498870,1672572908,1672575977,3069
10100,3701663839,3792512768,1672667080,1672670383,3303
11066,3791548838,3880637958,1672685830,1672687036,1206
9846,3505066871,3639081201,1672657968,1672658390,422
10376,3792432094,3514033319,1672598081,1672598679,598
11776,3513890046,3733411026,1672664775,1672667909,3134
9915,3792900315,3934991640,1672552256,1672555268,3012
11264,3505331083,3780648744,1672647689,1672649045,1356
10863,3505291330,3285136057,1672647692,1672650299,2607
10971,3778741325,3776583229,1672638209,1672638386,177
11026,3929446196,3791547827,1672612861,1672613755,894
9827,3772708314,3780941637,1672637155,1672637253,98
10076,3295691964,3904004824,1672566755,1672569647,2892
10292,3711770773,3311159418,1672580360,1672583117,2757
11549,3783879023,3469780362,1672585790,1672588461,2671
11236,3338187803,3701065296,1672691243,1672693073,1830
11522,3500854711,3783939161,1672701154,1672704749,3595
11689,3776583229,3701919083,1672593166,1672595916,2750
11596,3488333295,3241567995,1672627778,1672629293,1515
10363,3444646562,3703588004,1672563607,1672566839,3232
10036,3774782065,3770275898,1672581359,1672581463,104
10348,3500591274,3249380931,1672589315,1672591564,2249
10167,3515405509,3716341323,1672700516,1672701445,929
9932,3360309868,3552922094,1672651481,1672653606,2125
10741,3278071998,3776068937,1672638760,1672639514,754
10119,3505665253,3711179193,1672681427,1672682877,1450
10594,3351949206,3316537706,1672697547,1672698447,900
11740,3760710525,3318590083,1672616403,1672617879,1476
11634,3333477908,3922301238,1672695148,1672697742,2594
10131,3534988162,3760385591,1672693662,1672694255,593
10641,3501612813,3279731391,1672556540,1672557208,668
9928,3791547827,3360949039,1672596077,1672596442,365
10781,3755823805,3716423829,1672612541,1672613689,1148
10948,3730935770,3512700007,1672593846,1672595932,2086
11289,3519494023,3209075485,1672630782,1672633803,3021
9950,3520012007,3520145112,1672582499,1672585132,2633
9858,3485468650,3778838936,1672654299,1672655050,751
11477,3934070285,3417969824,1672574615,1672575692,1077
11247,3505037247,3602054754,1672546715,1672547944,1229
11160,3776053981,3510209505,1672667820,1672670348,2528
11591,3371759126,3205687719,1672610249,1672612468,2219
10276,3520009158,3273674596,1672648140,1672649387,1247
10823,3500087325,3818461836,1672644758,1672646754,1996
9947,3793081195,3500741005,1672615054,1672617414,2360
9926,3681701931,3772251279,1672678763,1672678926,163
10016,3517083465,3919258737,1672695276,1672697677,2401
11580,3772461583,3388537708,1672686495,1672689683,3188
11439,3281148858,3391612879,1672567186,1672570252,3066
11012,3406937294,3906075386,1672674516,1672675366,850
11556,3779951373,3933469838,1672569448,1672570832,1384
11414,3334488428,3500671218,1672549215,1672552393,3178
10739,3792851584,3892487982,1672567110,1672570296,3186
11496,3815700240,3819315404,1672654807,1672655258,451
11772,3335055096,3924205112,1672616640,1672619261,2621
10948,3311142523,3238997746,1672612603,1672613844,1241
10244,3701028092,3332124606,1672625692,1672626730,1038
9919,3760024021,3500356342,1672677351,1672678050,699
10260,3556684272,3375324190,1672675299,1672677219,1920
11399,3512750313,3510824484,1672556316,1672557154,838
10341,3447312353,3774325486,1672663877,1672667025,3148
11256,3300238532,3972442654,1672655733,1672657784,2051
10125,3516586325,3713139039,1672553579,1672554326,747
9819,3478052226,3783594246,1672594571,1672597687,3116
10885,3735422623,3837885956,1672532091,1672533608,1517
10047,3510535683,3713636175,1672559938,1672560748,810
11586,3899205452,3505684690,1672567105,1672570479,3374
9967,3710173412,3836757034,1672682582,1672684963,2381
10128,3934564437,3778695017,1672686232,1672687290,1058
10606,3303432071,3243056734,1672685291,1672688714,3423
11158,3360525513,3482639402,1672606478,1672607043,565
11075,3280208630,3925208102,1672618130,1672618449,319
11658,3831981073,3701350519,1672667555,1672668794,1239
11634,3459694275,3922480066,1672587836,1672590841,3005
11252,3514450836,3887030182,1672680676,1672684007,3331
10399,3783947742,3760854788,1672628870,1672629270,400
11731,3778909412,3756876537,1672644784,1672645163,379
10882,3835982340,3821087562,1672681569,1672684747,3178
10190,3777878462,3479585868,1672692702,1672695025,2323
10802,3231859576,3923524564,1672536804,1672537546,742
11119,3757311529,3714640103,1672660863,1672664396,3533
11559,3780308809,3636605690,1672640648,1672643825,3177
10742,3400025324,3337675386,1672617635,1672620154,2519
10297,3772251279,3206926634,1672666028,1672669193,3165
11515,3510244209,3360309868,1672674240,1672677679,3439
11578,3793232021,3501557463,1672623963,1672624942,979
10100,3616371564,3683562111,1672599041,1672601908,2867
11303,3975799349,3463892928,1672544105,1672545234,1129
9910,3294326116,3517902505,1672589493,1672590161,668
11791,3737738751,3319061210,1672655617,1672658400,2783
10065,3620157388,3755790149,1672538766,1672540676,1910
11753,3505697295,3501126057,1672555493,1672557649,2156
9796,3517652011,3755175497,1672598934,1672600844,1910
11379,3207307681,3519754667,1672588123,1672589146,1023
9807,3310712221,3271762055,1672703015,1672704219,1204
10677,3520022175,3793442891,1672593640,1672596137,2497
10601,3450511428,3317887374,1672675416,1672675781,365
9971,3906260966,3333477908,1672637188,1672640215,3027
10496,3424476995,3311514075,1672649849,1672652968,3119
11072,3687445224,3713102459,1672596270,1672599382,3112
10591,3777706200,3714281795,1672552295,1672553841,1546
10621,3852461753,3423346297,1672559346,1672561309,1963
10397,3770941125,3710107905,1672593871,1672596775,2904
11682,3377446376,3791974273,1672703693,1672707136,3443
11741,3777992576,3513111053,1672584655,1672586178,1523
11306,3770966950,3428198021,1672653387,1672655355,1968
11746,3362368123,3512490032,1672701406,1672702406,1000
10496,3510022922,3509317054,1672615931,1672617724,1793
10732,3890278838,3710228292,1672605171,1672605804,633
11540,3398021818,3772802020,1672552700,1672553252,552
10027,3512871568,3703694139,1672596638,1672599851,3213
11450,3701978422,3832902787,1672622588,1672624596,2008
10522,3932491622,3342368576,1672545829,1672547960,2131
11772,3512288503,3682266017,1672684010,1672685492,1482
9933,3517617472,3839308659,1672625438,1672625859,421
10835,3623113240,3636927297,1672648002,1672649122,1120
10769,3501843187,3793003432,1672652778,1672655003,2225
11728,3703048107,3910020031,1672686560,1672688203,1643
11570,3613216900,3757728121,1672688927,1672690881,1954
11682,3505121295,3459694275,1672643833,1672646895,3062
11539,3280208630,3936851114,1672568874,1672571012,2138
10131,3429610195,3369810091,1672536243,1672539175,2932
9943,3505097206,3783043346,1672669440,1672671172,1732
9981,3390368796,3318056480,1672660786,1672663605,2819
11090,3715441777,3703572036,1672577874,1672581193,3319
10045,3737946004,3340723781,1672667959,1672668828,869
9921,3470997293,3235198316,1672687392,1672689180,1788
10597,3468066881,3226037966,1672620909,1672624495,3586
11686,3555764822,3703423962,1672685710,1672685874,164
10554,3501619113,3773556853,1672621520,1672623375,1855
10954,3514455363,3304672737,1672624433,1672626508,2075
9815,3778731000,3514455363,1672642795,1672643429,634
11691,3500928990,3402020492,1672700239,1672701792,1553
10007,3441840658,3517800171,1672677524,1672679583,2059
10902,3793978936,3931028233,1672694826,1672695219,393
11148,3517149023,3533365834,1672592884,1672595013,2129
10995,3444295435,3824135033,1672534868,1672536043,1175
11783,3511069449,3627358016,1672628057,1672631001,2944
9894,3343511947,3974400577,1672551211,1672554709,3498
10346,3897851509,3774109138,1672579284,1672580680,1396
10046,3770630937,3770925016,1672668195,1672671366,3171
10038,3233965781,3513800589,1672544750,1672547883,3133
10354,3505816624,3710680073,1672626211,1672627324,1113
11394,3814378625,3830254808,1672659836,1672663279,3443
11373,3519848902,3714116241,1672656086,1672659091,3005
10921,3908862092,3689420679,1672589116,1672591380,2264
10544,3660980656,3735838864,1672647869,1672650946,3077
11450,3660980656,3780969898,1672605147,1672606606,1459
11293,3772882440,3487622510,1672575143,1672575879,736
11242,3473706746,3824135033,1672630708,1672631622,914
11504,3245121919,3518511124,1672583199,1672585652,2453
10514,3711844574,3318590083,1672702868,1672705677,2809
11124,3621812406,3619494735,1672632594,1672634795,2201
10476,3791236983,3835262447,1672685031,1672686450,1419
10902,3510149298,3500536897,1672641297,1672642686,1389
10587,3757150421,3519886257,1672581862,1672583420,1558
11231,3312959324,3303747093,1672686402,1672688374,1972
11035,3511500932,3516019206,1672541131,1672543946,2815
11611,3284865931,3245245283,1672547942,1672550357,2415
10184,3474879231,3501192566,1672584699,1672585138,439
10548,3824135033,3416079461,1672536493,1672539757,3264
11064,3778273230,3715284599,1672546391,1672547140,749
10596,3423147369,3509431396,1672570901,1672571725,824
11006,3772845364,3713906305,1672602285,1672603117,832
9925,3896859936,3882851213,1672695970,1672696030,60
11504,3714453773,3519046342,1672572567,1672574138,1571
10956,3228477490,3512555384,1672700816,1672703401,2585
11221,3604908372,3735497729,1672620067,1672620595,528
11763,3713195480,3900766525,1672586186,1672586637,451
11209,3793860209,3770012744,1672614728,1672616209,1481
10447,3610806770,3303772923,1672575893,1672577669,1776
9863,3809860102,3511382748,1672604080,1672606100,2020
11702,3378172464,3776953418,1672674799,1672677994,3195
11095,3824259677,3665841655,1672635853,1672638138,2285
11467,3715490209,3713858538,1672655324,1672657818,2494
9992,3927202773,3737622701,1672567342,1672570261,2919
11739,3778382224,3770991234,1672612179,1672614921,2742
9958,3755507566,3779282072,1672609858,1672613458,3600
10299,3778605154,3459163055,1672630442,1672633288,2846
11554,3713807459,3894495222,1672662181,1672663261,1080
10467,3928508375,3505887814,1672636961,1672638903,1942
11186,3710487368,3776710698,1672671820,1672673318,1498
10037,3681737865,3611570003,1672598143,1672601014,2871
10311,3510439480,3500741005,1672573758,1672576601,2843
11128,3831864108,3512555384,1672693126,1672693566,440
11071,3276499910,3393955069,1672628712,1672629166,454
11734,3414510793,3357074700,1672582700,1672586119,3419
11571,3445733121,3779478448,1672596295,1672597631,1336
10963,3793407883,3357026115,1672566824,1672567700,876
9795,3757514745,3833520635,1672592350,1672594383,2033
10342,3755769731,3933106901,1672698536,1672700059,1523
11318,3533440294,3636857871,1672588347,1672589451,1104
10511,3934070285,3409078869,1672584356,1672587818,3462
11063,3533986052,3517227599,1672656973,1672658413,1440
10877,3757311529,3713069234,1672605478,1672606834,1356
11473,3791435852,3461877104,1672627769,1672630240,2471
10095,3407734098,3884394685,1672647771,1672650837,3066
10892,3513624915,3807584987,1672695247,1672697810,2563
11333,3776068937,3311529105,1672690164,1672691179,1015
9903,3638126174,3613547091,1672595140,1672595542,402
10637,3920526713,3378534521,1672545955,1672547367,1412
11662,3479585868,3819315404,1672609578,1672610943,1365
10503,3505266343,3225554956,1672601133,1672604655,3522
11007,3231227362,3815184540,1672582919,1672586145,3226
10869,3351856699,3512819376,1672559932,1672560190,258
11389,3387322545,3857609616,1672584548,1672588102,3554
10639,3513624915,3340321384,1672656016,1672657006,990
10363,3703031637,3910049345,1672587390,1672587844,454
11354,3783373085,3783408830,1672553627,1672553930,303
9860,3455955489,3220987526,1672632800,1672634717,1917
10716,3776950532,3371238318,1672689845,1672692564,2719
11364,3511415786,3621591266,1672572747,1672573152,405
10141,3514628916,3422460919,1672703308,1672703564,256
11119,3512768285,3925208102,1672656755,1672657336,581
11197,3778909412,3316821313,1672546493,1672548768,2275
10844,3757549235,3501171785,1672607285,1672608227,942
11418,3501963428,3489340327,1672558143,1672558665,522
9803,3855440101,3792075871,1672610513,1672611387,874
10635,3352044245,3756642173,1672689293,1672692787,3494
10268,3342545285,3914926436,1672531243,1672532842,1599
10885,3496591885,3772943811,1672623314,1672626070,2756
11657,3390438262,3780050328,1672546563,1672548231,1668
9867,3385416697,3388915945,1672675764,1672676670,906
10384,3809207482,3305612422,1672620648,1672623456,2808
11070,3887030182,3505786561,1672615412,1672618807,3395
11000,3755779925,3339649817,1672557154,1672560032,2878
11264,3711131262,3505491969,1672664554,1672664915,361
10523,3270607273,3733870816,1672695399,1672695712,313
11649,3852275715,3349573092,1672621551,1672623712,2161
10223,3772980989,3977209952,1672661835,1672661965,130
11432,3422460919,3477951091,1672666426,1672666632,206
11628,3468281011,3517331746,1672631149,1672634034,2885
11340,3511580693,3372778334,1672539346,1672541111,1765
11118,3387989658,3757604311,1672555693,1672557514,1821
11211,3783727937,3909457959,1672601370,1672603956,2586
11666,3792633495,3516067011,1672641999,1672645045,3046
11643,3919342147,3778382224,1672691135,1672694132,2997
10003,3931495845,3510178791,1672691975,1672693534,1559
10331,3755670258,3666561358,1672667635,1672667704,69
11239,3399726243,3977666815,1672696866,1672698448,1582
11466,3500591274,3559112196,1672538277,1672541616,3339
10247,3476308535,3516200419,1672573534,1672574281,747
10880,3783651407,3772980989,1672599975,1672601908,1933
10650,3900540310,3445355677,1672542018,1672544867,2849
9801,3273771395,3519165527,1672554138,1672554269,131
11495,3910049345,3509370016,1672701570,1672703725,2155
10326,3791584994,3509208005,1672559212,1672561067,1855
10377,3330318282,3446233783,1672554125,1672554385,260
11349,3815184540,3701971784,1672539493,1672541623,2130
10282,3494748808,3936871734,1672577019,1672577123,104
10292,3770180844,3770533588,1672568427,1672568956,529
11204,3519908593,3855977674,1672658334,1672661377,3043
10529,3520189871,3774273260,1672564488,1672567505,3017
9950,3533929043,3311924005,1672623820,1672624279,459
11298,3824259677,3519319233,1672697155,1672698262,1107
9839,3447696555,3367526113,1672675024,1672676614,1590
11426,3639465750,3909632424,1672560563,1672561598,1035
10417,3492350318,3710051427,1672558211,1672561321,3110
10203,3519724388,3703277359,1672605810,1672608740,2930
11153,3713805968,3305656670,1672614890,1672618325,3435
11407,3774702364,3774663639,1672621580,1672624421,2841
11318,3683047199,3791435852,1672631479,1672634608,3129
11456,3755342153,3802625412,1672669675,1672671591,1916
11301,3517800171,3711722554,1672554641,1672557169,2528
11394,3201634072,3668063289,1672602518,1672604019,1501
9930,3303432071,3520763492,1672673753,1672675153,1400
11769,3559754304,3341311972,1672654247,1672656156,1909
10169,3858330969,3600842635,1672641073,1672642582,1509
10889,3301431129,3711722554,1672670974,1672671426,452
11733,3682802569,3813111107,1672542355,1672544571,2216
9930,3887030182,3824135033,1672577339,1672579134,1795
11084,3318220119,3777715675,1672549639,1672553148,3509
10697,3710813103,3792455305,1672681980,1672683539,1559
11037,3399726243,3710515351,1672656015,1672656493,478
11423,3920890008,3520694387,1672665585,1672667502,1917
9969,3973138649,3516585063,1672569229,1672569657,428
11472,3774782065,3780224882,1672689848,1672692726,2878
11142,3682906048,3350966326,1672660547,1672663133,2586
11164,3270502801,3893527651,1672586967,1672587729,762
10357,3682802569,3829698950,1672578552,1672579498,946
10294,3510894809,3624872714,1672646794,1672649253,2459
10642,3510535683,3519167605,1672686265,1672686627,362
9852,3204149913,3783727937,1672631513,1672631843,330
9904,3203837944,3375324190,1672600930,1672603702,2772
10261,3364660506,3755922811,1672616510,1672618055,1545
11108,3463892928,3405221863,1672648907,1672651281,2374
11744,3555378248,3496407500,1672652719,1672655930,3211
9967,3511341866,3779503296,1672703024,1672706218,3194
10013,3685645561,3773017746,1672694361,1672694907,546
11529,3773083407,3513545735,1672579879,1672580954,1075
11073,3770530739,3713636175,1672694325,1672697204,2879
10743,3931767736,3715680249,1672622315,1672622950,635
11000,3393128259,3511466117,1672682748,1672685938,3190
10220,3534284132,3792162098,1672678905,1672682018,3113
10193,3801379377,3501115299,1672609710,1672613151,3441
11285,3334488428,3807646028,1672634878,1672635154,276
9832,3716526314,3226761201,1672608862,1672612297,3435
10007,3510750299,3495427619,1672691002,1672693772,2770
10577,3912878303,3661543201,1672672970,1672673070,100
10078,3514628916,3757001552,1672573641,1672574005,364
10391,3757497708,3288675710,1672654390,1672656434,2044
11450,3639081201,3755170743,1672634665,1672638209,3544
10052,3779478448,3311959533,1672543613,1672547149,3536
9831,3490008012,3778838936,1672697695,1672698832,1137
10116,3534667712,3472173212,1672603786,1672606289,2503
10066,3289258397,3395615598,1672556003,1672556970,967
10951,3313101243,3385006834,1672662491,1672665698,3207
10448,3716178116,3345896913,1672551870,1672553271,1401
10107,3500695402,3716976932,1672641982,1672642495,513
11340,3664719070,3519924982,1672564195,1672567187,2992
10701,3703443664,3282053097,1672595084,1672596616,1532
10406,3360949039,3501126057,1672551823,1672552913,1090
11779,3533974355,3714903253,1672554092,1672557056,2964
11748,3774598935,3514576083,1672647288,1672648952,1664
11444,3381244346,3298113026,1672661232,1672663178,1946
10411,3714281795,3715140418,1672604204,1672607619,3415
10684,3318220119,3500145103,1672685180,1672685846,666
10328,3317887374,3384713976,1672610316,1672613852,3536
9986,3932919664,3500543341,1672669792,1672672336,2544
10449,3776309810,3278629965,1672642863,1672644793,1930
11101,3665841655,3501583486,1672638446,1672641110,2664
11032,3501980730,3905358065,1672558509,1672560747,2238
10758,3246804115,3474350534,1672555222,1672556299,1077
10368,3231963246,3757773786,1672593183,1672595945,2762
10969,3811503860,3311696372,1672599678,1672601198,1520
10482,3510916875,3773697080,1672640826,1672644140,3314
11462,3550887623,3512638952,1672575290,1672577132,1842
11396,3777928067,3931319307,1672629112,1672632503,3391
11438,3516319492,3820922991,1672659168,1672660633,1465
10899,3783879023,3817120976,1672628337,1672631638,3301
11147,3365839890,3518931700,1672693759,1672696416,2657
10878,3431317400,3515405509,1672547925,1672549226,1301
10709,3909067335,3533628528,1672584226,1672586034,1808
10777,3431317400,3533113740,1672629610,1672632769,3159
11356,3774663639,3703659324,1672584875,1672585396,521
11683,3534696810,3355430975,1672531870,1672533087,1217
10709,3773134128,3514576083,1672630635,1672633325,2690
10326,3497904539,3783277159,1672697483,1672701020,3537
10548,3364302157,3908331271,1672611289,1672612774,1485
11249,3394986304,3792578118,1672670504,1672670669,165
9968,3925098136,3793081195,1672562271,1672564208,1937
10972,3710107905,3615245840,1672599872,1672600492,620
10047,3770023722,3938409715,1672582613,1672583919,1306
10848,3520339198,3733915784,1672577552,1672578722,1170
10103,3811419378,3319529422,1672538851,1672540329,1478
11645,3493679801,3233712975,1672637693,1672638905,1212
10920,3511286390,3514611187,1672595378,1672598719,3341
11293,3793442891,3311037445,1672699366,1672702211,2845
11414,3770564547,3856147380,1672601333,1672602946,1613
10141,3382696725,3711755596,1672677398,1672677618,220
11136,3929002318,3792283334,1672636076,1672638146,2070
11558,3492728794,3711671702,1672582837,1672586394,3557
9884,3926065090,3918126468,1672618606,1672621810,3204
10608,3756079870,3601063076,1672649389,1672652535,3146
11384,3533037906,3774652449,1672615508,1672617014,1506
11488,3302348002,3777112124,1672586021,1672586344,323
9944,3619705594,3423940256,1672633095,1672634560,1465
10552,3510836047,3774483862,1672686692,1672688298,1606
9982,3426468199,3303552616,1672650123,1672653069,2946
10221,3519780867,3487988841,1672606653,1672607184,531
11530,3519848902,3780213684,1672655437,1672655934,497
10754,3779340538,3805926853,1672611046,1672612459,1413
10234,3443580855,3757713457,1672576790,1672577207,417
11635,3511908639,3485898181,1672531578,1672532903,1325
10568,3662354016,3612042508,1672623930,1672625649,1719
10023,3247193800,3713141087,1672689868,1672691320,1452
11638,3228575883,3534174363,1672647238,1672650456,3218
11124,3609335008,3534543864,1672652406,1672654058,1652
11296,3520725149,3420854927,1672646217,1672646668,451
11355,3816184951,3512555384,1672646531,1672649352,2821
10688,3779160052,3822368676,1672554726,1672556544,1818
10117,3373802545,3344778261,1672693813,1672695217,1404
11262,3924205112,3715587520,1672592356,1672594019,1663
11276,3715712376,3293579860,1672533404,1672535668,2264
10000,3713547793,3772962072,1672688285,1672688752,467
11235,3738526914,3757872458,1672606071,1672608107,2036
10405,3331228758,3415840750,1672675789,1672679154,3365
10382,3630802959,3309455369,1672655659,1672657989,2330
9940,3509360869,3501548163,1672697910,1672701090,3180
11710,3510535683,3605905645,1672583633,1672584036,403
9994,3483347530,3501027795,1672537529,1672537787,258
11399,3308149799,3711179193,1672703229,1672705291,2062
10342,3710861700,3776122272,1672651849,1672654407,2558
11454,3756740153,3757851680,1672607977,1672611002,3025
11531,3421674406,3477248170,1672583901,1672585443,1542
10382,3392482187,3779748270,1672657845,1672660913,3068
10232,3825795004,3776122272,1672645253,1672648332,3079
10200,3606688595,3711854614,1672667170,1672670516,3346
11142,3430399931,3613940925,1672578755,1672580370,1615
11379,3533131937,3711258452,1672685178,1672688168,2990
10810,3614112171,3922786716,1672644461,1672646573,2112
10897,3356599815,3910190872,1672630387,1672632640,2253
10805,3906075386,3517756624,1672693222,1672696186,2964
10776,3714903253,3517902505,1672607675,1672609869,2194
10265,3792455305,3358262975,1672596692,1672596841,149
11502,3533867833,3501980730,1672601822,1672603869,2047
9812,3637522163,3703749690,1672537142,1672539857,2715
10017,3714690161,3478052226,1672532487,1672535503,3016
11739,3512504247,3730348493,1672600458,1672600920,462
10378,3856975355,3510694464,1672668666,1672668774,108
9888,3793814153,3757501067,1672535390,1672537188,1798
10336,3792930090,3515558215,1672555043,1672556248,1205
9837,3387388336,3515259326,1672539716,1672541378,1662
11080,3715284599,3559112196,1672543724,1672544404,680
10108,3515378306,3510233949,1672641653,1672642819,1166
11406,3777767907,3625779003,1672573774,1672574845,1071
9922,3293673220,3510819040,1672533850,1672536493,2643
10757,3807584987,3779454060,1672657778,1672661288,3510
11697,3514761434,3517766135,1672702307,1672703087,780
10607,3500018566,3792173463,1672601953,1672603404,1451
10472,3776811587,3805704844,1672665038,1672666402,1364
10725,3777405860,3883640904,1672595599,1672598116,2517
10538,3361926328,3245882008,1672552109,1672554529,2420
10669,3770275898,3377311502,1672663833,1672665843,2010
10909,3730052916,3509556649,1672538298,1672540602,2304
10175,3855077502,3804095239,1672669573,1672672916,3343
11618,3283847934,3682266017,1672695914,1672698615,2701
10473,3716891903,3773083407,1672586751,1672586830,79
11219,3271389160,3661543201,1672676060,1672677510,1450
10954,3511663572,3777672363,1672661741,1672665152,3411
10056,3275057862,3363549860,1672654278,1672655227,949
11054,3380285779,3422314045,1672693893,1672695985,2092
11357,3415803494,3500178849,1672535736,1672538219,2483
10838,3792255406,3603682643,1672575457,1672577637,2180
11110,3516792348,3403150349,1672570429,1672571704,1275
11568,3716733618,3774355339,1672695482,1672695907,425
11556,3880030249,3802757611,1672647441,1672650123,2682
11036,3517358336,3778253021,1672690031,1672692523,2492
9969,3770180844,3804840997,1672563781,1672563907,126
9916,3898965585,3512625661,1672610098,1672610355,257
11034,3685083275,3703999217,1672567206,1672568548,1342
11121,3469780362,3278805844,1672702623,1672706106,3483
11552,3773848111,3376487118,1672679377,1672682500,3123
11379,3416474842,3710585241,1672666436,1672667950,1514
11078,3238779889,3770273966,1672613461,1672614095,634
10172,3446764595,3733836732,1672666265,1672668647,2382
11387,3755273361,3446066492,1672620949,1672624502,3553
9923,3533728729,3916924978,1672615169,1672615464,295
11063,3701769970,3426468199,1672621984,1672624742,2758
10068,3701663839,3756668747,1672654644,1672657787,3143
9826,3792824886,3755823805,1672598589,1672600601,2012
10653,3760525465,3791716170,1672596110,1672596675,565
10949,3772943811,3783095041,1672566861,1672568035,1174
10504,3418997135,3713996094,1672552729,1672553722,993
10842,3319660530,3778695017,1672682996,1672683298,302
11064,3461741050,3516586325,1672691304,1672693882,2578
10847,3559759778,3774359137,1672670623,1672671347,724
11625,3385416697,3613216900,1672640945,1672643907,2962
10291,3793814153,3777499535,1672578008,1672580841,2833
9820,3703572036,3716841469,1672701492,1672702894,1402
11209,3534775239,3730169449,1672627682,1672629159,1477
11721,3494748808,3500785888,1672553614,1672556875,3261
11136,3505756991,3701475090,1672613006,1672613349,343
10342,3472018395,3307236682,1672542999,1672546421,3422
10877,3812756400,3453519360,1672627562,1672630752,3190
10227,3773085258,3853783593,1672560529,1672563067,2538
10174,3204473480,3714688409,1672641336,1672642246,910
10111,3603682643,3514329209,1672645569,1672646083,514
10814,3469780362,3884862164,1672628047,1672631137,3090
10927,3505291330,3330799389,1672659065,1672660956,1891
11658,3372079985,3730459093,1672565334,1672567311,1977
10699,3378172464,3236886943,1672563591,1672563711,120
9974,3613940925,3701218904,1672553086,1672554187,1101
10446,3910049345,3370401047,1672646035,1672647530,1495
9930,3809194824,3209280342,1672542362,1672543317,955
11069,3777878462,3286938590,1672560121,1672561896,1775
10066,3978643889,3313824913,1672676100,1672678625,2525
10262,3909399636,3291153514,1672548145,1672548220,75
10633,3478455812,3517377614,1672569002,1672571411,2409
10430,3520625600,3311810583,1672673028,1672675380,2352
11167,3491527603,3638050763,1672615951,1672617393,1442
11453,3354968884,3317989975,1672567755,1672569022,1267
10713,3772968080,3715441786,1672575513,1672577061,1548
9894,3382757142,3359880163,1672626971,1672627996,1025
11766,3520694387,3757378286,1672610512,1672610845,333
11677,3780171640,3517377614,1672569022,1672571299,2277
11776,3493515706,3774325486,1672659922,1672660576,654
10927,3551972633,3371497614,1672615411,1672617661,2250
10528,3685522474,3454554552,1672538406,1672541914,3508
11176,3811351746,3827981800,1672538533,1672540495,1962
10123,3772648837,3270502801,1672625343,1672627472,2129
11532,3307454562,3407734098,1672552892,1672555727,2835
10839,3534122907,3417223898,1672659530,1672662554,3024
10534,3780969898,3319529422,1672686503,1672687600,1097
9965,3791628263,3855222429,1672694986,1672695496,510
11050,3666367524,3738873928,1672604085,1672605998,1913
10500,3272096922,3778838936,1672600651,1672601801,1150
10686,3770533675,3429333292,1672647165,1672650088,2923
10459,3516359146,3317190427,1672658435,1672661928,3493
10580,3791905743,3387621912,1672617335,1672617874,539
11245,3512965991,3776053981,1672604638,1672608173,3535
11427,3773697080,3776319560,1672580827,1672583969,3142
11067,3805616707,3511289729,1672630214,1672633490,3276
11226,3307791650,3776166086,1672534612,1672534852,240
10073,3791409441,3931028233,1672678919,1672680305,1386
10459,3514508773,3516731917,1672684214,1672685568,1354
11344,3830291558,3341129425,1672585122,1672587587,2465
10447,3792075871,3778124514,1672561528,1672561637,109
10526,3668955834,3711852131,1672651672,1672652359,687
11139,3516167000,3236360179,1672625485,1672627814,2329
10659,3703938162,3621629499,1672671487,1672674211,2724
10318,3415840750,3480560014,1672663858,1672664712,854
10593,3236563828,3809860102,1672578244,1672579927,1683
10526,3918981936,3711287751,1672573139,1672575768,2629
10237,3302879906,3770273966,1672640820,1672641523,703
10206,3774195369,3311602936,1672541903,1672544351,2448
11699,3501574882,3613940925,1672531394,1672532294,900
11735,3711219767,3770391782,1672631529,1672634974,3445
11194,3534068874,3778731000,1672664043,1672666847,2804
11048,3756168814,3511289729,1672532753,1672533235,482
11411,3517227599,3716285196,1672700255,1672702966,2711
11583,3421956717,3411213032,1672639021,1672641802,2781
10443,3361789225,3933731871,1672596958,1672599482,2524
9997,3384151770,3773556853,1672642746,1672645268,2522
11552,3919349138,3756717136,1672596882,1672597740,858
11535,3441944896,3928421417,1672575955,1672579025,3070
11448,3776455762,3770981604,1672672252,1672673001,749
11152,3772262649,3517440258,1672632419,1672635202,2783
10857,3630462406,3343616490,1672564577,1672564902,325
11263,3509186338,3703336988,1672611171,1672614220,3049
10399,3780466967,3205687719,1672665146,1672665546,400
11747,3472901378,3772845364,1672536199,1672537356,1157
11514,3714525519,3509445318,1672580477,1672583800,3323
11517,3778932673,3518058151,1672565137,1672565438,301
11771,3701925712,3755769254,1672700403,1672701298,895
10079,3509073025,3203909360,1672660165,1672662164,1999
10062,3533777032,3501550490,1672638905,1672640483,1578
11408,3534531039,3500974385,1672548112,1672550375,2263
10723,3716445184,3304235700,1672556350,1672557617,1267
11060,3447938130,3774506868,1672544399,1672545169,770
10165,3701459978,3778318250,1672565139,1672565701,562
11703,3533365834,3927699036,1672573599,1672577003,3404
10294,3390438262,3461137945,1672616478,1672617958,1480
9828,3793689267,3828906027,1672683274,1672685788,2514
10500,3483347530,3668369938,1672663386,1672664865,1479
11373,3773376762,3779478448,1672563196,1672566493,3297
9996,3244397548,3757796416,1672652151,1672654142,1991
10295,3757944870,3510218188,1672667536,1672669582,2046
11371,3352374868,3520395850,1672682215,1672682849,634
10514,3780921044,3663505156,1672578613,1672578703,90
10781,3534624672,3669418238,1672584037,1672586995,2958
10280,3779340538,3780563627,1672618910,1672622315,3405
10023,3247193800,3770273459,1672632568,1672634555,1987
11309,3716341323,3241682278,1672617499,1672619035,1536
9844,3732596503,3513143959,1672598773,1672599018,245
11229,3501583486,3462645981,1672636600,1672638551,1951
11371,3779382417,3534626053,1672581078,1672581772,694
9933,3515100211,3515304526,1672549386,1672552606,3220
11625,3513661302,3270502801,1672583022,1672586490,3468
10009,3534190196,3711770853,1672593202,1672596408,3206
10221,3316117186,3553694590,1672577559,1672579615,2056
10269,3772250554,3368339963,1672629506,1672632549,3043
11058,3316117186,3714116241,1672587063,1672590467,3404
10657,3701065296,3299052917,1672599381,1672599963,582
10630,3501554468,3908331271,1672569836,1672571203,1367
11141,3311924005,3505769529,1672540561,1672541030,469
10380,3772648837,3477582923,1672682895,1672683627,732
11376,3780013266,3236948071,1672631677,1672635276,3599
9936,3933562725,3277634944,1672532212,1672535687,3475
10423,3415562576,3369482983,1672647816,1672648526,710
10791,3933106901,3772893815,1672632802,1672633343,541
11452,3418367752,3780213684,1672598121,1672601297,3176
10223,3515470462,3831981073,1672643131,1672644775,1644
10320,3342495377,3310961923,1672701636,1672703316,1680
10364,3756675909,3715923089,1672673159,1672676248,3089
10030,3600441934,3380285779,1672558597,1672560957,2360
11717,3518947256,3703588004,1672629549,1672629745,196
10313,3271762055,3772893815,1672576725,1672579370,2645
10253,3809860102,3501225887,1672564172,1672566823,2651
11547,3501628472,3715261950,1672584156,1672586782,2626
10659,3855222429,3505140123,1672573899,1672576976,3077
10399,3488887919,3713927376,1672610092,1672610525,433
10868,3517558635,3395069149,1672661135,1672663512,2377
10220,3400025324,3411355804,1672697724,1672697813,89
10699,3813853446,3382757142,1672590785,1672593663,2878
10387,3783060739,3505560793,1672598269,1672600310,2041
11327,3418382025,3714870496,1672640333,1672641836,1503
11143,3534506090,3311774510,1672664096,1672664285,189
10264,3514021667,3924583142,1672536813,1672538930,2117
10036,3622654885,3402774497,1672647403,1672647601,198
11710,3972653129,3837378340,1672673807,1672675432,1625
10668,3711836873,3713224986,1672631647,1672634401,2754
11780,3777498160,3205161801,1672571636,1672573157,1521
11288,3245755569,3295691964,1672702545,1672705012,2467
11755,3701521510,3501407804,1672583782,1672584663,881
11399,3438818153,3355880028,1672679871,1672681004,1133
10940,3228575883,3791584994,1672586210,1672588840,2630
10491,3791269060,3772683155,1672560308,1672561321,1013
11626,3760385591,3513894659,1672647002,1672649789,2787
11554,3921736061,3912811715,1672581051,1672582391,1340
10764,3604908372,3370961012,1672645301,1672648351,3050
11040,3902300755,3305093237,1672632993,1672634436,1443
10185,3791664049,3245121919,1672564968,1672568214,3246
10407,3703742071,3778370462,1672682769,1672684525,1756
10571,3519435459,3756297396,1672588506,1672590645,2139
9813,3661359073,3783201950,1672561837,1672564499,2662
11607,3344778261,3397972945,1672591095,1672593366,2271
11559,3388946581,3505119470,1672686936,1672687516,580
11787,3855077502,3908177413,1672563755,1672566336,2581
11340,3450735824,3459163055,1672634756,1672636056,1300
10073,3354405535,3534604516,1672620325,1672620681,356
11011,3353335252,3792173463,1672660138,1672661175,1037
11459,3398483531,3683677062,1672553215,1672555237,2022
10245,3509394912,3818236682,1672666864,1672669964,3100
9882,3422314045,3711029952,1672532959,1672536094,3135
11284,3660176760,3358262975,1672637345,1672640925,3580
11604,3358434853,3711029952,1672593507,1672595153,1646
11789,3600699873,3777931341,1672660434,1672663251,2817
11202,3755361692,3423940256,1672626854,1672629352,2498
9839,3223512565,3352057037,1672663540,1672664184,644
10447,3452389513,3469663062,1672622535,1672623845,1310
10519,3402338011,3667654673,1672574352,1672575316,964
11030,3713566527,3512337054,1672671486,1672672129,643
10747,3511466117,3305727497,1672613229,1672613608,379
10870,3922409420,3516444589,1672690662,1672691507,845
11525,3703476890,3520155898,1672581505,1672583162,1657
11449,3732467455,3516969689,1672622319,1672625479,3160
10017,3760979523,3819024145,1672532361,1672533855,1494
11237,3505266343,3283847934,1672679254,1672681992,2738
11008,3352374868,3449020351,1672549680,1672551397,1717
11613,3805704844,3228575883,1672593278,1672595003,1725
10751,3625931630,3777932225,1672648252,1672651586,3334
10172,3428076194,3518511124,1672629776,1672632849,3073
9802,3778695017,3812277991,1672690660,1672691632,972
10677,3396472026,3281970147,1672555361,1672556695,1334
11685,3403120725,3770846374,1672620543,1672621697,1154
11204,3519886257,3713285095,1672600115,1672600827,712
10430,3493047640,3774447975,1672551670,1672553750,2080
11777,3687445224,3701493094,1672701252,1672704356,3104
10006,3436099135,3510894809,1672645270,1672646640,1370
10262,3373802545,3684199077,1672557596,1672558670,1074
11232,3774606418,3791332226,1672606517,1672607139,622
11242,3605078841,3807646028,1672543549,1672546000,2451
10949,3714806574,3500793739,1672630104,1672633088,2984
9890,3760396348,3783043346,1672684177,1672685311,1134
11372,3352374868,3405200303,1672590982,1672592032,1050
11608,3803382101,3734957248,1672661902,1672664748,2846
11077,3513586642,3897851509,1672688043,1672690618,2575
11548,3558203963,3513840186,1672575500,1672575898,398
10942,3287968403,3369938668,1672603624,1672604829,1205
10454,3971996397,3813085701,1672689887,1672690873,986
11443,3608214600,3533703578,1672580409,1672580867,458
10447,3715039960,3550887623,1672562871,1672565733,2862
11048,3288346356,3519947298,1672658402,1672658543,141
11316,3755570137,3419762444,1672591778,1672593617,1839
10010,3715249954,3466620548,1672541328,1672542452,1124
10532,3495637721,3311159418,1672626932,1672628750,1818
11396,3791628263,3381244346,1672652468,1672652729,261
10765,3760267158,3283295213,1672626279,1672628703,2424
11499,3519102732,3887030182,1672575936,1672578973,3037
11510,3773852157,3838748301,1672540876,1672543216,2340
10546,3774273260,3246381831,1672627755,1672631282,3527
11300,3514329209,3666022373,1672600123,1672602283,2160
9934,3791548838,3900793652,1672656243,1672658722,2479
11135,3852992961,3778842400,1672656405,1672659059,2654
10545,3514585995,3533009565,1672576312,1672579595,3283
11167,3371759126,3519948471,1672537298,1672537488,190
11257,3512411326,3812677669,1672673411,1672675699,2288
10220,3915962248,3403257752,1672568686,1672571964,3278
10902,3312612693,3906075386,1672686441,1672689287,2846
11038,3774205060,3701171318,1672609578,1672611952,2374
11019,3501550490,3511198566,1672582581,1672584320,1739
10119,3337675386,3517469005,1672678987,1672682024,3037
11778,3517530943,3515939841,1672586263,1672588838,2575
11427,3731644240,3500854711,1672538499,1672540664,2165
11547,3922480066,3520145112,1672654150,1672656979,2829
11660,3533036499,3624365837,1672607082,1672607784,702
10049,3430032005,3931495845,1672633534,1672635945,2411
10458,3500793739,3716526314,1672540603,1672543438,2835
11347,3515284733,3337715675,1672619370,1672621923,2553
11739,3311515179,3533976217,1672660818,1672661715,897
10674,3715737742,3780013266,1672602416,1672604303,1887
11079,3686860179,3757030923,1672635287,1672636032,745
11161,3415803494,3783430498,1672620238,1672622481,2243
10464,3629248353,3475830203,1672669156,1672669911,755
11096,3770981604,3897851509,1672571849,1672572594,745
11271,3554236075,3716475340,1672532755,1672533443,688
10972,3668202976,3736941123,1672535748,1672535808,60
11369,3494680853,3200372897,1672683984,1672684136,152
10397,3500356342,3774090455,1672537979,1672540805,2826
11780,3428878402,3779815753,1672630899,1672631561,662
9952,3458432407,3783408469,1672633774,1672636429,2655
10572,3350631472,3405221863,1672626498,1672628657,2159
11301,3333477908,3534770827,1672674140,1672675882,1742
10035,3711223297,3337673625,1672599201,1672599380,179
11704,3511526885,3514021667,1672582899,1672585861,2962
11085,3464622743,3927202773,1672633167,1672636417,3250
9989,3714471069,3898989233,1672569347,1672571630,2283
10839,3791434207,3379517265,1672567851,1672568654,803
10612,3452802329,3711131262,1672539606,1672543142,3536
10287,3519780867,3701387745,1672632927,1672634398,1471
9895,3391854325,3499998389,1672589893,1672590861,968
11461,3500654356,3972196462,1672594874,1672595788,914
10123,3701041860,3491239350,1672678002,1672680568,2566
10723,3469370398,3777909822,1672687281,1672688642,1361
11729,3203837944,3478052226,1672676461,1672678692,2231
10876,3774236212,3919814073,1672589419,1672591876,2457
11037,3512490032,3755378125,1672668002,1672668177,175
11402,3489340327,3519494023,1672619861,1672622236,2375
11517,3335139032,3465107990,1672621447,1672623714,2267
11337,3625400710,3484490325,1672634678,1672635205,527
11073,3755779925,3936851114,1672637688,1672638770,1082
11231,3701978422,3534770827,1672540796,1672542851,2055
10767,3302988745,3755507566,1672674796,1672677014,2218
10972,3488749569,3471996194,1672683221,1672685681,2460
11782,3403395712,3777135415,1672631560,1672634633,3073
10581,3757872458,3515558215,1672580587,1672581232,645
9937,3514450836,3374195945,1672645463,1672648284,2821
10470,3893932944,3616371564,1672675692,1672677141,1449
11632,3366961580,3711947828,1672576445,1672579624,3179
11592,3756079870,3714287902,1672693679,1672696366,2687
10032,3770966950,3497732613,1672686945,1672689432,2487
11445,3480405740,3900766525,1672688630,1672690597,1967
10710,3469350379,3449233346,1672594399,1672597476,3077
10078,3830962592,3773085258,1672662924,1672664419,1495
10302,3819400315,3395505794,1672558133,1672558457,324
10603,3713728777,3332010532,1672570209,1672571157,948
11057,3335139032,3516655509,1672635942,1672636790,848
10257,3778318250,3701512498,1672617953,1672620207,2254
11706,3760232135,3779951373,1672602812,1672603610,798
11426,3439651226,3976742903,1672536030,1672537913,1883
10493,3442073613,3779723939,1672670841,1672674405,3564
11016,3838119022,3299845453,1672582644,1672586203,3559
11463,3755209597,3760656396,1672595714,1672598256,2542
10294,3932955949,3509317776,1672679142,1672680274,1132
10739,3347140733,3514145752,1672686370,1672688620,2250
10234,3223144610,3517766135,1672550506,1672553883,3377
11522,3736036532,3979366845,1672582360,1672585958,3598
11336,3509379617,3793902476,1672561730,1672561998,268
11750,3777715675,3475830203,1672555014,1672556417,1403
11369,3770564547,3780626668,1672548459,1672550647,2188
10788,3887030182,3510278533,1672667388,1672667462,74
11287,3239401337,3558567160,1672616257,1672618802,2545
11708,3500814753,3510894809,1672596336,1672596401,65
11563,3423800775,3714787207,1672621840,1672623888,2048
10811,3395505794,3793699467,1672675508,1672675936,428
10703,3510233949,3501261089,1672566794,1672569737,2943
9936,3468281011,3778842400,1672574278,1672577733,3455
10504,3777370992,3760854788,1672652073,1672654573,2500
9838,3491250381,3533340292,1672584834,1672585231,397
10474,3779561601,3512768285,1672589960,1672591341,1381
10896,3703419800,3201573194,1672533869,1672534432,563
10513,3455955489,3456795601,1672577342,1672577446,104
10505,3517991042,3367299721,1672579797,1672581107,1310
11153,3710271021,3853182912,1672679761,1672681023,1262
10654,3832745283,3917243005,1672605451,1672609046,3595
10986,3882851213,3360837082,1672653880,1672654624,744
10097,3446537819,3714903253,1672566780,1672568444,1664
11691,3772234939,3239082508,1672596477,1672598400,1923
11400,3514329209,3387322545,1672611948,1672615065,3117
10930,3902357342,3890194669,1672537830,1672538193,363
10007,3756668747,3901169230,1672581792,1672582039,247
10844,3358982831,3922786716,1672563618,1672564056,438
11019,3511750850,3773878451,1672643602,1672644755,1153
10846,3436018575,3815440588,1672546910,1672550173,3263
11414,3777928067,3912878303,1672537392,1672540562,3170
11332,3411355804,3902357342,1672577614,1672579840,2226
10314,3516167000,3514033319,1672562162,1672565545,3383
10354,3533473206,3295691964,1672598049,1672600015,1966
10733,3534984243,3736987749,1672669160,1672672284,3124
10339,3367526113,3512768285,1672540203,1672543459,3256
11300,3345954031,3445077330,1672548463,1672550026,1563
10023,3774921252,3916463490,1672597131,1672600720,3589
11273,3713195480,3505936495,1672618028,1672619518,1490
10943,3469778316,3446233783,1672594066,1672596305,2239
10478,3777552831,3422460919,1672562104,1672563489,1385
11122,3757678397,3519059808,1672678301,1672679460,1159
11027,3437934509,3756113624,1672581047,1672582749,1702
11559,3680939042,3509663119,1672565289,1672567608,2319
10151,3773202954,3519435459,1672628098,1672631580,3482
10566,3715284599,3307535495,1672676488,1672676982,494
10914,3389069291,3756345026,1672570014,1672572622,2608
10573,3793274846,3365519448,1672622201,1672623213,1012
11202,3885147558,3516792348,1672664277,1672665140,863
11762,3519341916,3517797610,1672539674,1672542975,3301
11257,3205687719,3471507117,1672675452,1672676713,1261
11402,3770276815,3701978422,1672697571,1672697814,243
11582,3779468781,3479402555,1672579871,1672581659,1788
11095,3534531039,3407398464,1672587708,1672590386,2678
11520,3500630465,3793874490,1672629758,1672633209,3451
11057,3429333292,3777715675,1672592335,1672593598,1263
9985,3776600696,3778702093,1672691122,1672691788,666
10207,3602570831,3776122272,1672668993,1672669752,759
10039,3906075386,3440582836,1672646907,1672649923,3016
11144,3895944547,3458753033,1672567837,1672568193,356
10067,3338195686,3617771673,1672593425,1672594753,1328
11573,3938059867,3755286041,1672664296,1672667734,3438
10398,3518335611,3207586072,1672663003,1672665310,2307
10364,3714595459,3518572231,1672675158,1672677438,2280
11374,3453538201,3710046567,1672613574,1672616551,2977
11044,3815700240,3533728729,1672568156,1672570915,2759
11419,3682150740,3438470128,1672615198,1672615600,402
11394,3500814753,3360972732,1672591882,1672595446,3564
11644,3453164933,3920155862,1672655982,1672658090,2108
11439,3917905192,3779815753,1672701198,1672704074,2876
10936,3359012188,3204473480,1672598993,1672601616,2623
10000,3776583229,3488749569,1672586158,1672587968,1810
11169,3757713457,3839417558,1672688051,1672689703,1652
10577,3501976169,3711844574,1672570853,1672571857,1004
10683,3493515706,3516792348,1672681419,1672682844,1425
10712,3760679372,3924963918,1672618319,1672621872,3553
9930,3774448657,3776291254,1672578090,1672581449,3359
10742,3501573548,3391854325,1672567959,1672570688,2729
11384,3334936138,3760390822,1672624986,1672628448,3462
10121,3533816813,3770671714,1672657976,1672661000,3024
9975,3505836431,3287683210,1672662882,1672664494,1612
10504,3636015050,3834424604,1672536920,1672537044,124
11124,3733243990,3710173412,1672561268,1672563050,1782
9959,3306491253,3246381831,1672570186,1672570787,601
10470,3534122907,3776166086,1672594136,1672595880,1744
9902,3760346746,3939882169,1672612466,1672613085,619
11715,3896622009,3783967375,1672588219,1672591513,3294
10516,3457249798,3413799143,1672653811,1672654640,829
11395,3757393413,3501734800,1672691419,1672694125,2706
10554,3618895679,3882851213,1672556307,1672559403,3096
11062,3757406215,3513816744,1672587063,1672590376,3313
11748,3302929858,3622654885,1672545428,1672548732,3304
10792,3791509881,3627377299,1672534289,1672537505,3216
10029,3388537708,3239082508,1672657673,1672660731,3058
10532,3353335252,3447267291,1672540977,1672543576,2599
9948,3791584994,3714903456,1672677764,1672680774,3010
10454,3755584983,3305093237,1672556265,1672558489,2224
11526,3227874229,3773603836,1672589364,1672592600,3236
11441,3520057139,3739387948,1672628947,1672631552,2605
9800,3517227599,3400903513,1672667325,1672670094,2769
11256,3701265238,3493047640,1672684152,1672687518,3366
9927,3312733562,3505624416,1672536947,1672538523,1576
10813,3293673220,3791542842,1672631747,1672634810,3063
11415,3484490325,3311774510,1672663268,1672664306,1038
9872,3780482864,3380218091,1672619085,1672621314,2229
11429,3834643026,3711119575,1672587958,1672588799,841
9921,3512641538,3819024145,1672577046,1672580393,3347
9975,3451757423,3201656220,1672553455,1672556466,3011
11790,3310702648,3510301454,1672552643,1672555232,2589
10422,3882580580,3732467455,1672563321,1672566396,3075
9846,3290060215,3778932673,1672621320,1672624439,3119
10832,3337675386,3774702364,1672632952,1672635498,2546
10647,3755736024,3510206323,1672610761,1672612068,1307
11166,3500421940,3710397477,1672621387,1672623986,2599
10720,3286938590,3519965717,1672683008,1672685902,2894
10604,3516969689,3828906027,1672564393,1672566875,2482
10048,3716423829,3778544203,1672576591,1672579248,2657
11721,3358982831,3319585148,1672665805,1672666113,308
10124,3403988682,3715204544,1672589689,1672591528,1839
11134,3756991235,3344478603,1672683978,1672684991,1013
10872,3393128259,3756998113,1672586812,1672586960,148
11401,3783172505,3274739459,1672632893,1672635493,2600
11328,3756066765,3279102372,1672683113,1672685146,2033
11618,3512417028,3342545285,1672533528,1672535176,1648
10236,3500776597,3501988762,1672655223,1672656241,1018
11279,3394394262,3660257653,1672684767,1672687313,2546
10198,3519228207,3380167818,1672573882,1672576933,3051
10837,3246804115,3445733121,1672613647,1672617207,3560
10442,3756675909,3778273230,1672613318,1672614340,1022
11724,3821082558,3469780362,1672588695,1672590387,1692
11103,3772943811,3234445133,1672663794,1672664055,261
10172,3510368377,3509208005,1672698702,1672700692,1990
11467,3760443176,3776001441,1672668819,1672670472,1653
10786,3367262509,3501115299,1672548159,1672549738,1579
10446,3770715115,3392573386,1672656353,1672659556,3203
11300,3553229537,3907039612,1672637027,1672639338,2311
11220,3500863429,3774921252,1672675569,1672679106,3537
10446,3791222330,3604908372,1672593422,1672595616,2194
11229,3342495377,3533620069,1672694098,1672696203,2105
10489,3972442654,3517960157,1672629184,1672631342,2158
10390,3298831109,3669140241,1672564491,1672565432,941
11099,3475830203,3442462115,1672666254,1672669398,3144
10993,3633860380,3820422111,1672627785,1672628151,366
11358,3514389188,3291617477,1672652067,1672652869,802
11516,3710271021,3344478603,1672619112,1672622619,3507
11680,3770486161,3830771832,1672581913,1672584905,2992
10170,3737745988,3442096275,1672627226,1672629162,1936
11719,3711671702,3733870816,1672688914,1672692413,3499
9850,3793274957,3783021859,1672550564,1672551970,1406
11206,3780733404,3793232021,1672680266,1672681510,1244
9843,3245121919,3925175853,1672661281,1672662211,930
10503,3559754304,3231271498,1672595639,1672599012,3373
10827,3774221318,3792267993,1672627313,1672628801,1488
9986,3446218191,3817038422,1672643213,1672645065,1852
10464,3516067011,3770441717,1672630246,1672633717,3471
11779,3300238532,3315094386,1672613225,1672616190,2965
10836,3976742903,3516706121,1672675342,1672678750,3408
10120,3555954355,3710173412,1672665949,1672668542,2593
10297,3760232135,3977615973,1672617978,1672621442,3464
10314,3760801237,3428788958,1672622636,1672623459,823
11194,3713611960,3497138014,1672605624,1672608909,3285
10991,3780740477,3822634862,1672579896,1672580401,505
10486,3733953055,3533154906,1672548726,1672550900,2174
10673,3207307681,3783939161,1672628816,1672632209,3393
11492,3311696372,3931319307,1672608985,1672609516,531
10823,3388774559,3716994924,1672696436,1672697127,691
10488,3513215373,3622654885,1672628800,1672631646,2846
11114,3793978936,3400545490,1672582120,1672585660,3540
11317,3534459983,3555954355,1672581100,1672583716,2616
10441,3711945923,3622729771,1672647760,1672651132,3372
11552,3716982179,3559221089,1672568339,1672568787,448
9794,3802101760,3614484939,1672672317,1672673772,1455
10441,3514564903,3495427619,1672620277,1672622195,1918
11768,3509274030,3558264627,1672699274,1672702207,2933
10241,3362368123,3755584983,1672648470,1672651098,2628
11058,3450164574,3422959249,1672683504,1672684132,628
10609,3777552831,3777304517,1672572669,1672575077,2408
11337,3239423794,3459163055,1672565189,1672567358,2169
11343,3533642281,3205324639,1672551514,1672552290,776
11145,3661856558,3533703578,1672686835,1672689854,3019
10323,3778370462,3618024815,1672646129,1672648696,2567
9996,3791863922,3245642576,1672611229,1672612518,1289
11447,3713906305,3340321384,1672639488,1672640289,801
10565,3973582279,3311771689,1672533443,1672535801,2358
10819,3291936679,3711190257,1672640945,1672644435,3490
10148,3919345990,3912625932,1672658595,1672660868,2273
10902,3248409083,3710783759,1672608980,1672611842,2862
11690,3760901975,3780941637,1672553448,1672556779,3331
11680,3713069234,3779413388,1672697234,1672699374,2140
11679,3779393140,3791206902,1672592428,1672592539,111
10721,3364683368,3927675706,1672628218,1672631191,2973
11249,3714595459,3778604070,1672697578,1672699897,2319
11359,3334708091,3773083407,1672593093,1672596584,3491
11768,3818236682,3778273230,1672679114,1672680467,1353
11281,3370961012,3777041132,1672574065,1672576414,2349
10022,3716160006,3774109138,1672652265,1672653171,906
9927,3791359168,3518759318,1672584286,1672585196,910
10062,3278071998,3770564547,1672616871,1672620381,3510
9900,3331228758,3299847117,1672609236,1672611871,2635
9965,3755922811,3430823498,1672533835,1672536438,2603
10855,3773840321,3713694278,1672536195,1672539654,3459
10653,3780612543,3205324639,1672622729,1672625076,2347
11446,3896840409,3710060386,1672684965,1672685417,452
11045,3512681214,3235578121,1672564977,1672566874,1897
11753,3770476738,3203837944,1672595674,1672597918,2244
9925,3783095041,3793569914,1672662120,1672662554,434
10326,3714074120,3515528947,1672625295,1672628114,2819
9899,3716233100,3836757034,1672559336,1672560663,1327
11291,3885674996,3249614888,1672663015,1672664356,1341
11738,3756297396,3311177439,1672580508,1672582567,2059
9960,3713740434,3804707712,1672613225,1672615265,2040
11403,3400112498,3756876537,1672560175,1672560895,720
10630,3440305508,3510836047,1672587116,1672589942,2826
11217,3202740652,3773603836,1672678316,1672680294,1978
10992,3554437212,3486824047,1672630076,1672632222,2146
11207,3773432494,3353194923,1672642494,1672642883,389
10291,3756413374,3770924034,1672702237,1672705342,3105
11151,3791382196,3780142207,1672630699,1672632604,1905
10499,3779815753,3443191792,1672700197,1672702954,2757
10518,3511078598,3465690527,1672682688,1672683433,745
10142,3380218091,3772802020,1672539319,1672539562,243
10803,3345896913,3778741325,1672574773,1672578037,3264
11307,3755230010,3292050211,1672611785,1672615105,3320
10414,3306037126,3341738186,1672693784,1672696960,3176
11612,3501843187,3608214600,1672577002,1672578418,1416
10197,3974668678,3359472956,1672613306,1672614749,1443
10417,3367299721,3801379377,1672693962,1672695329,1367
10896,3770275898,3912878303,1672695916,1672697017,1101
11039,3829761380,3515984911,1672545643,1672548130,2487
10869,3715441777,3711219767,1672569672,1672570543,871
11250,3452175941,3452175941,1672613993,1672615692,1699
11263,3347172556,3293540333,1672665360,1672666299,939
11037,3793978936,3517902505,1672667457,1672667873,416
9924,3302416197,3350169064,1672589436,1672590644,1208
10951,3615245840,3666958814,1672612409,1672613921,1512
11522,3510244209,3518947256,1672657002,1672660208,3206
11400,3319862687,3701925712,1672693574,1672697084,3510
9859,3612705426,3205948776,1672604567,1672605659,1092
11670,3689223632,3511095300,1672634373,1672634870,497
9834,3308149799,3512490032,1672561844,1672562479,635
11120,3780786276,3447078933,1672593149,1672594819,1670
11597,3427527462,3805704844,1672639692,1672641734,2042
11656,3856316719,3511908639,1672672049,1672674436,2387
11168,3238056215,3207307681,1672701742,1672702125,383
11030,3792267993,3852014884,1672611516,1672611838,322
10659,3430399931,3305612422,1672543739,1672545026,1287
10551,3663505156,3803473387,1672560361,1672561818,1457
10129,3422548081,3779951373,1672569903,1672573065,3162
10161,3774744663,3387322545,1672543541,1672545837,2296
11775,3361635547,3713444403,1672640800,1672642735,1935
10318,3505291330,3487231844,1672703992,1672705894,1902
10515,3444168914,3391854325,1672579115,1672580800,1685
11719,3517718901,3533986052,1672553103,1672553432,329
11741,3895507040,3810584695,1672616477,1672619547,3070
10432,3394959062,3791532324,1672656320,1672659175,2855
10332,3971289056,3505438826,1672663792,1672666916,3124
10118,3791688526,3281970147,1672557363,1672557840,477
11613,3273758330,3468343480,1672542274,1672542350,76
11143,3773024346,3273537848,1672699493,1672701602,2109
11248,3770966950,3739297004,1672643955,1672646523,2568
11696,3335974305,3773041843,1672686709,1672687437,728
10047,3207586072,3367299721,1672534520,1672537055,2535
10304,3305727497,3756685732,1672558919,1672559861,942
11199,3477582923,3223144610,1672590632,1672592907,2275
10047,3792682835,3611570003,1672620515,1672621626,1111
10720,3554437212,3773440794,1672641922,1672643433,1511
9850,3509208005,3731905251,1672605094,1672608535,3441
10285,3681504869,3500854711,1672623193,1672624594,1401
11781,3400560073,3388537708,1672661779,1672664836,3057
11041,3606688595,3792075871,1672575934,1672577223,1289
11176,3662507634,3413799143,1672544757,1672546355,1598
10181,3280208630,3710185376,1672619862,1672620963,1101
10810,3403988682,3887382548,1672689355,1672690837,1482
11357,3689420679,3716595760,1672590032,1672591345,1313
10442,3330238204,3893043842,1672555493,1672556740,1247
11029,3284829602,3716233100,1672677599,1672679959,2360
10471,3458271585,3455430943,1672680743,1672683524,2781
10980,3715204544,3476144563,1672577050,1672580580,3530
9882,3776279305,3773432494,1672585911,1672586539,628
10826,3311159418,3791796190,1672647115,1672650312,3197
10392,3380167818,3791289855,1672703219,1672706553,3334
11510,3342027511,3238796398,1672614440,1672614916,476
11731,3827836825,3515802579,1672699197,1672700824,1627
10371,3337715675,3774627091,1672652386,1672653526,1140
11493,3701770921,3500429731,1672650170,1672653243,3073
11701,3417223898,3710296607,1672645580,1672649016,3436
11280,3714658474,3660257653,1672532651,1672535923,3272
10234,3461743188,3505097206,1672548545,1672550682,2137
11672,3367299721,3711770773,1672669175,1672669807,632
11125,3716994924,3309528048,1672642978,1672646140,3162
11167,3443004958,3452677710,1672667464,1672668986,1522
10507,3711613085,3791359168,1672531587,1672533358,1771
11217,3288346356,3688410383,1672618796,1672621445,2649
11289,3534624672,3345902033,1672629299,1672629828,529
11740,3776053084,3309528048,1672658457,1672660418,1961
11248,3906693728,3519055736,1672677751,1672678439,688
10890,3791088014,3513203127,1672588047,1672590352,2305
11443,3824135033,3505593034,1672621269,1672621877,608
10691,3732846295,3347205332,1672593949,1672594577,628
11552,3395505794,3755230010,1672606342,1672609857,3515
11253,3777387533,3500093945,1672681313,1672683918,2605
9922,3469350379,3514776568,1672552476,1672553751,1275
10174,3777878462,3442096275,1672666513,1672667665,1152
10326,3509433155,3666823095,1672648374,1672649848,1474
11086,3423782420,3773891827,1672693950,1672695184,1234
10583,3715039960,3471996194,1672617799,1672619460,1661
11710,3755688231,3520057139,1672615998,1672619385,3387
10151,3559759778,3907923381,1672541564,1672542029,465
10210,3505155858,3552922094,1672573571,1672575327,1756
11764,3454151554,3739618347,1672616346,1672617567,1221
11719,3688130094,3376842515,1672654519,1672654890,371
10423,3338115824,3520553959,1672560671,1672563928,3257
10605,3505571800,3273758330,1672534265,1672536767,2502
10028,3509508477,3664478769,1672624182,1672627729,3547
11624,3385416697,3631444265,1672571873,1672574069,2196
9886,3511069449,3715039960,1672681019,1672682132,1113
10732,3915962248,3505129296,1672663089,1672664978,1889
10969,3791409441,3756642173,1672651228,1672653047,1819
11183,3387322545,3505392452,1672643941,1672644838,897
11609,3298706213,3512337054,1672553724,1672557112,3388
10054,3463729805,3519922921,1672591310,1672593927,2617
9924,3516585063,3930475498,1672562963,1672565217,2254
10991,3359418136,3811419378,1672554164,1672557443,3279
10056,3483078667,3604908372,1672590796,1672591644,848
10713,3807486812,3669497617,1672651232,1672651704,472
11314,3501253130,3514341451,1672588511,1672591781,3270
11704,3520160414,3772296376,1672599933,1672602505,2572
10520,3715140418,3520305100,1672531274,1672533848,2574
10067,3249771731,3391854325,1672548198,1672550262,2064
10443,3443041059,3780173788,1672531881,1672533244,1363
10141,3519055736,3445896667,1672558690,1672560224,1534
11305,3738429905,3881579907,1672682568,1672684798,2230
10102,3714101349,3732846295,1672612613,1672613935,1322
10093,3275171954,3533593766,1672619339,1672622750,3411
10713,3408111327,3793332600,1672632884,1672635541,2657
11071,3713514933,3520725149,1672566418,1672567886,1468
11775,3757311529,3202787155,1672636100,1672638394,2294
9848,3483078667,3245245283,1672613079,1672614903,1824
10707,3480270940,3440671139,1672609656,1672612871,3215
11734,3932491622,3773798215,1672657351,1672659558,2207
10574,3703722212,3792063616,1672608680,1672608785,105
9986,3513545735,3483078667,1672583180,1672586209,3029
10782,3774251051,3805704844,1672595306,1672598781,3475
9814,3337675386,3822634862,1672666659,1672667552,893
9853,3773603836,3510233949,1672638855,1672641549,2694
10775,3774939922,3501711464,1672668534,1672669505,971
10445,3853182912,3931028233,1672670090,1672672174,2084
10944,3505248368,3776968640,1672625618,1672625776,158
10817,3778824229,3714424237,1672597654,1672601004,3350
10402,3347172556,3505392452,1672557746,1672559227,1481
10119,3309651238,3832002939,1672573728,1672576065,2337
10517,3915195160,3510149298,1672608696,1672610603,1907
10110,3855209450,3387621912,1672657635,1672659576,1941
10304,3505140123,3713767153,1672669251,1672670786,1535
10460,3715587520,3500015630,1672637998,1672638682,684
11662,3500654356,3505521491,1672663489,1672665242,1753
11085,3760346746,3368079099,1672663926,1672667088,3162
10517,3302988745,3606804618,1672586026,1672589467,3441
10762,3294821709,3903879740,1672584103,1672584966,863
11548,3534068874,3500741005,1672685890,1672686649,759
11708,3636857871,3534696810,1672623623,1672626814,3191
9991,3716285196,3773895671,1672684028,1672684641,613
11596,3368951504,3505994703,1672692948,1672694996,2048
11412,3515838621,3520926977,1672618018,1672618452,434
10730,3777928067,3505119470,1672669926,1672672424,2498
10156,3345896913,3919258737,1672551433,1672551883,450
11290,3812516461,3703694139,1672667863,1672671279,3416
11398,3755790149,3714268380,1672566095,1672568517,2422
11345,3701668745,3330238204,1672558400,1672561398,2998
11296,3934980229,3669918958,1672701182,1672703547,2365
11055,3533642281,3435342362,1672613274,1672615233,1959
11221,3519297683,3757549235,1672652917,1672654750,1833
9999,3477582923,3510439480,1672564070,1672566298,2228
10650,3714074120,3978417055,1672614336,1672616876,2540
11142,3755769254,3516153301,1672662718,1672665142,2424
10483,3776407517,3713219299,1672560530,1672561581,1051
10877,3481365330,3500931474,1672650557,1672653323,2766
10800,3890278838,3820280594,1672608688,1672609374,686
10622,3500654356,3601340045,1672639286,1672642874,3588
10514,3472173212,3929923442,1672649184,1672650035,851
11689,3509701363,3245755569,1672580628,1672582050,1422
11078,3978254945,3714787207,1672534049,1672534568,519
11204,3669497617,3703779674,1672556290,1672556494,204
9955,3906693728,3534984243,1672594690,1672598053,3363
10563,3935569749,3898592058,1672637712,1672638516,804
10118,3233993993,3914947393,1672600001,1672600203,202
11405,3397527886,3231859576,1672547145,1672548626,1481
11699,3382308738,3501988762,1672644727,1672645824,1097
11319,3505839395,3716118473,1672630891,1672632489,1598
10947,3757851680,3444453261,1672562584,1672565857,3273
11533,3515577866,3757598610,1672642228,1672642707,479
9829,3912878303,3756998113,1672630027,1672630527,500
10554,3205324639,3457249798,1672565265,1672568177,2912
11023,3229465607,3856699097,1672669975,1672672384,2409
10455,3476958001,3607583720,1672544264,1672545392,1128
10254,3973582279,3613781977,1672589772,1672591671,1899
11357,3433196933,3855440101,1672666950,1672668255,1305
10139,3682673884,3773161055,1672595215,1672597144,1929
9991,3817038422,3412605548,1672545441,1672548429,2988
10977,3714281210,3512744657,1672636457,1672637502,1045
10063,3756668747,3480560014,1672660880,1672662492,1612
11050,3304235700,3756297396,1672532269,1672535544,3275
11508,3825795004,3342837214,1672655661,1672658481,2820
10462,3905934770,3711430738,1672687342,1672687534,192
10798,3778382224,3777074709,1672608263,1672609870,1607
10157,3701841013,3778838936,1672667414,1672668988,1574
11478,3978254945,3701412729,1672666746,1672668429,1683
10584,3510638085,3371759126,1672649305,1672649956,651
10710,3668063289,3513563152,1672613851,1672617405,3554
10449,3716541851,3773876312,1672553978,1672555039,1061
11047,3730414796,3779835734,1672625626,1672629067,3441
10706,3715490209,3783611957,1672559888,1672561078,1190
11508,3500057674,3711810752,1672584461,1672584835,374
10361,3730052916,3710852576,1672619159,1672622680,3521
9879,3776125503,3516463579,1672567956,1672570257,2301
11197,3494560663,3510775046,1672698928,1672701729,2801
11126,3512306195,3505278562,1672700870,1672702975,2105
11758,3883640454,3713728777,1672673890,1672676780,2890
11778,3281970147,3773636983,1672627468,1672628655,1187
11054,3447948483,3513143959,1672692061,1672694778,2717
11212,3733796228,3495446254,1672548890,1672551153,2263
10629,3813111107,3510178791,1672617408,1672618503,1095
11733,3662522808,3660246433,1672557523,1672558763,1240
11298,3500051606,3449672240,1672671028,1672672577,1549
11127,3452175941,3559619861,1672551530,1672552276,746
11196,3931319307,3517617472,1672690331,1672692859,2528
10114,3513802404,3715320359,1672583147,1672583953,806
11708,3519951586,3812277991,1672641861,1672643976,2115
10758,3491104534,3714101349,1672573833,1672576844,3011
10288,3777290300,3778044082,1672534412,1672536552,2140
9857,3772055279,3757773786,1672698574,1672699709,1135
11256,3479585868,3701865589,1672594761,1672597615,2854
10345,3534696810,3780942505,1672651205,1672653322,2117
10082,3241567995,3513739060,1672650757,1672653679,2922
11787,3520339198,3306037126,1672583408,1672585577,2169
11289,3777931341,3777909822,1672593506,1672594897,1391
11454,3925792265,3241855333,1672591177,1672593935,2758
10590,3714658474,3274739459,1672674102,1672676503,2401
11505,3927181190,3518995270,1672642993,1672645225,2232
10670,3756272704,3778731000,1672633002,1672634688,1686
10121,3701453343,3364302157,1672535789,1672538034,2245
10394,3977666815,3205113625,1672632519,1672634662,2143
11522,3732312480,3936486724,1672597809,1672598050,241
11586,3896200048,3520558137,1672577276,1672579537,2261
10630,3513092056,3792930090,1672573857,1672575352,1495
9832,3902357342,3517499844,1672681102,1672681602,500
10699,3632189887,3716118473,1672681527,1672683824,2297
10476,3936851114,3505472087,1672664646,1672667772,3126
10860,3662307789,3338187803,1672585424,1672585693,269
11156,3737467358,3755922811,1672683146,1672683386,240
9804,3614484939,3519356606,1672660018,1672660280,262
11326,3975796415,3349475873,1672609057,1672610065,1008
10634,3714787207,3791841318,1672653164,1672653349,185
10272,3793081195,3310737478,1672539415,1672541492,2077
11051,3773085258,3500536897,1672676200,1672678839,2639
10164,3449233346,3755767856,1672702560,1672705720,3160
10676,3513293711,3509614126,1672603300,1672604752,1452
11505,3600441934,3732312480,1672601967,1672604721,2754
11276,3515803462,3245642576,1672661257,1672662802,1545
10221,3713416106,3228218081,1672670088,1672671178,1090
11448,3738760498,3332124606,1672560646,1672564042,3396
11513,3779835734,3773440794,1672688997,1672691059,2062
10178,3884001167,3511907179,1672605922,1672609408,3486
9818,3711176990,3713224986,1672674114,1672675980,1866
11493,3793689267,3395082458,1672609404,1672612512,3108
10558,3686860179,3738526914,1672617587,1672619109,1522
11255,3510894809,3318250647,1672668243,1672669245,1002
10046,3517960740,3755119166,1672534305,1672535506,1201
11457,3777499535,3332124606,1672629228,1672630525,1297
10880,3475090917,3310021925,1672625962,1672626974,1012
9904,3974668678,3623953446,1672641078,1672641794,716
10159,3292050211,3533841983,1672648652,1672652210,3558
11347,3486509752,3555764822,1672652598,1672654814,2216
11163,3755584983,3730169449,1672622957,1672625526,2569
11770,3827889533,3639926564,1672629751,1672633066,3315
11077,3815184540,3516249472,1672634238,1672634496,258
10579,3770480149,3682150740,1672685891,1672687780,1889
10203,3711770853,3369558911,1672651155,1672652378,1223
11095,3511286390,3715790104,1672544277,1672545811,1534
10144,3509167758,3311410533,1672573946,1672576161,2215
10738,3381254180,3791332226,1672615482,1672618529,3047
10292,3882851213,3511908639,1672703868,1672705561,1693
11662,3406029706,3710819760,1672553709,1672556558,2849
10771,3755378125,3714718326,1672582592,1672583679,1087
10433,3447253775,3366961580,1672619897,1672620904,1007
11117,3922409420,3519000878,1672624585,1672625927,1342
11485,3715291931,3760420315,1672611414,1672611854,440
11361,3892177203,3908883591,1672544882,1672546612,1730
10204,3505032773,3714658474,1672584429,1672587362,2933
9942,3703849264,3495446254,1672588838,1672592430,3592
11525,3500799617,3792162098,1672660563,1672662294,1731
11638,3436018575,3756272704,1672669792,1672671291,1499
9931,3395505794,3639503148,1672657545,1672659018,1473
10589,3424997707,3245642576,1672665091,1672667904,2813
11218,3774296721,3756328353,1672689413,1672691016,1603
11705,3662495290,3834424604,1672643777,1672646821,3044
9823,3368951504,3774822697,1672629214,1672629416,202
10188,3772689657,3832902787,1672643436,1672645272,1836
11419,3668063289,3755570137,1672562632,1672566055,3423
10670,3907225070,3243305367,1672564700,1672567428,2728
10697,3716179251,3755286041,1672662518,1672664338,1820
11145,3505867821,3627377299,1672691469,1672694058,2589
10716,3499343927,3770564547,1672573861,1672574316,455
11514,3773378103,3777992576,1672587534,1672589367,1833
9987,3770476738,3778273230,1672626617,1672627325,708
10411,3716389356,3512417724,1672688808,1672691528,2720
10501,3332010532,3776534957,1672659786,1672663174,3388
10938,3463729805,3755361692,1672570404,1672573412,3008
11398,3513545735,3317190427,1672652651,1672655342,2691
11129,3474879231,3519297683,1672699573,1672700665,1092
10494,3808442442,3755924094,1672579040,1672580733,1693
11341,3514455363,3772227820,1672559088,1672560467,1379
11256,3389069291,3505331014,1672611637,1672612281,644
10515,3792578118,3515304526,1672570426,1672572180,1754
11687,3284865931,3916924978,1672644901,1672646659,1758
11449,3711187791,3283106998,1672649655,1672649921,266
10459,3367299721,3777672363,1672703525,1672706997,3472
11461,3756113624,3715291931,1672622983,1672625174,2191
11178,3972856326,3828354855,1672545805,1672547836,2031
11500,3517331746,3385006834,1672672506,1672673088,582
10552,3772262649,3227874229,1672603900,1672604505,605
10769,3447696555,3500854711,1672608250,1672610136,1886
11182,3851737350,3415840750,1672673334,1672674604,1270
10793,3710861700,3777041132,1672683801,1672686384,2583
10075,3458432407,3904485393,1672576294,1672577966,1672
11624,3509663119,3484490325,1672549028,1672551232,2204
11157,3755924094,3791206902,1672621611,1672623115,1504
10729,3344478603,3500589560,1672633549,1672634125,576
10364,3810818108,3629869834,1672624177,1672624590,413
11110,3780511388,3511526885,1672675836,1672679257,3421
11704,3518205307,3244397548,1672558165,1672558996,831
11090,3713990030,3308965136,1672561267,1672562045,778
10966,3703722212,3360309868,1672641100,1672642611,1511
10412,3345902033,3469663062,1672637716,1672640306,2590
10724,3851877325,3331228758,1672558022,1672558622,600
10570,3501901313,3774316305,1672603000,1672606118,3118
10839,3512288503,3335974305,1672554647,1672557507,2860
10676,3505331083,3772968080,1672611327,1672613375,2048
10704,3711856534,3368339963,1672697966,1672698975,1009
11287,3472718723,3317989975,1672542667,1672543509,842
10721,3356972733,3505653701,1672585490,1672585923,433
11312,3793222045,3713875941,1672569790,1672570160,370
9867,3512784888,3919342147,1672654447,1672656326,1879
11646,3715039960,3894495222,1672535863,1672537623,1760
9832,3513890046,3817029483,1672696238,1672697517,1279
11397,3284407073,3512251592,1672554744,1672557436,2692
11161,3533859712,3413799143,1672657511,1672657588,77
10805,3400560073,3714294005,1672643617,1672644385,768
11295,3701534043,3372778334,1672667566,1672670131,2565
11246,3683562111,3229615214,1672600576,1672603659,3083
10206,3500640854,3510143850,1672605083,1672606096,1013
11100,3716647407,3613547091,1672635611,1672638747,3136
11366,3777751979,3611570003,1672667354,1672668531,1177
10990,3475830203,3533473206,1672620957,1672622822,1865
10093,3501515425,3813853446,1672684010,1672687002,2992
11750,3669427589,3623894390,1672552896,1672555817,2921
10405,3515507526,3780786276,1672556244,1672559251,3007
11245,3422460919,3500544306,1672583687,1672586475,2788
10952,3465672238,3517358336,1672681697,1672684999,3302
11151,3342027511,3611939581,1672682202,1672684692,2490
11139,3430399931,3367526113,1672565960,1672568561,2601
10125,3660496328,3624872714,1672544283,1672545909,1626
10800,3839417558,3372079985,1672625612,1672627420,1808
10613,3755218683,3777686966,1672641635,1672643679,2044
10547,3345896913,3664523809,1672607934,1672610118,2184
10180,3776791436,3893629892,1672640178,1672640763,585
11444,3773024346,3757678397,1672666517,1672669422,2905
11431,3500096103,3510373076,1672646708,1672647078,370
10814,3711613085,3509317054,1672614138,1672617305,3167
10649,3703938162,3499820963,1672579867,1672580573,706
11566,3710260848,3715587520,1672642698,1672643380,682
11687,3207586072,3339649817,1672542734,1672545950,3216
11595,3516026189,3236886943,1672664508,1672666747,2239
11002,3299845453,3311177439,1672598704,1672599205,501
11437,3519465545,3519260216,1672673675,1672674451,776
10139,3241567995,3710147457,1672606994,1672609243,2249
10981,3474097405,3825234433,1672587367,1672589989,2622
10887,3447938130,3337903727,1672614608,1672617292,2684
10798,3686885442,3713141087,1672597760,1672600796,3036
10997,3710865678,3931028233,1672677179,1672680670,3491
10336,3231153513,3552309108,1672696100,1672699675,3575
11218,3600302127,3311529105,1672601676,1672603182,1506
10492,3780129338,3294952405,1672698541,1672699283,742
10578,3894756677,3755924094,1672538707,1672538911,204
10955,3827836825,3407398464,1672556235,1672559052,2817
10695,3494560663,3774296721,1672563547,1672564171,624
10132,3223796145,3274341934,1672692677,1672694994,2317
9833,3783679478,3927675706,1672564511,1672565563,1052
11167,3772867078,3757201538,1672701718,1672703194,1476
11522,3279102372,3936486724,1672673440,1672676775,3335
10221,3772114731,3520471156,1672626879,1672629294,2415
10181,3228997424,3510694464,1672540328,1672541648,1320
11549,3776319560,3760731595,1672670269,1672672636,2367
10448,3511476353,3557528150,1672542207,1672544687,2480
11115,3311739926,3520725149,1672531785,1672533530,1745
11688,3500579482,3710149975,1672604941,1672606048,1107
11272,3352057037,3438028077,1672578528,1672581097,2569
10674,3304030474,3235313062,1672546554,1672548173,1619
10102,3220976338,3777686966,1672680452,1672681761,1309
10372,3350169064,3505998260,1672579190,1672580201,1011
11408,3515893948,3970265139,1672563935,1672566414,2479
9947,3774450494,3513384042,1672650545,1672652875,2330
11373,3520145112,3979366845,1672633847,1672636103,2256
10670,3830962592,3311260898,1672617648,1672620818,3170
10305,3533440736,3776468503,1672548068,1672548237,169
11238,3279731391,3463892928,1672637945,1672641270,3325
11377,3835509670,3971282455,1672592371,1672592584,213
10027,3500342408,3773826624,1672624388,1672625419,1031
11147,3892177203,3600871715,1672653477,1672653955,478
10500,3514747345,3783826338,1672536723,1672539042,2319
10067,3289017988,3738547113,1672548756,1672552151,3395
10625,3803996569,3413236071,1672661633,1672664855,3222
10670,3271389160,3366433035,1672623406,1672626554,3148
10229,3714658474,3343511947,1672674815,1672675250,435
11217,3780969898,3279726491,1672601712,1672603179,1467
9914,3292663993,3293157673,1672648168,1672651589,3421
10446,3318056480,3713170867,1672597394,1672597885,491
10291,3735497729,3710695372,1672686154,1672686429,275
10791,3516827471,3703502114,1672649366,1672652036,2670
10346,3893629892,3621629499,1672558783,1672559925,1142
10304,3404375908,3509370633,1672649392,1672650669,1277
11644,3361789225,3916924978,1672593300,1672596061,2761
9823,3437703650,3510486220,1672572609,1672575069,2460
10469,3772844451,3756736726,1672680661,1672682270,1609
9830,3832902787,3779415433,1672564812,1672566646,1834
10422,3711015176,3716463756,1672568449,1672570869,2420
11428,3770276815,3513894659,1672531496,1672533955,2459
11037,3299847117,3756493561,1672606799,1672609440,2641
10787,3814289471,3803382101,1672610116,1672611919,1803
10244,3812261241,3488887919,1672562394,1672565897,3503
10330,3757150421,3773434690,1672535136,1672537652,2516
11386,3479207976,3510542303,1672617992,1672618498,506
9996,3534531061,3701127475,1672648804,1672649641,837
10436,3505155858,3736941123,1672608375,1672611114,2739
10696,3703694139,3760074281,1672613488,1672615417,1929
10415,3914926436,3755790149,1672558376,1672559679,1303
11067,3814289471,3311463998,1672569261,1672571622,2361
9797,3512306195,3245755569,1672697311,1672699751,2440
11074,3514508773,3615245840,1672594157,1672594681,524
11488,3772659062,3915652382,1672593697,1672594988,1291
10362,3236360179,3664523809,1672642049,1672645149,3100
9847,3856975355,3738429905,1672531359,1672531849,490
10900,3715204544,3792455305,1672558597,1672562040,3443
11346,3757311529,3736941123,1672605403,1672607281,1878
11275,3819400315,3783277159,1672647268,1672648009,741
11307,3517377614,3772569860,1672654158,1672654798,640
10815,3478455812,3472272792,1672568425,1672570808,2383
11162,3780964089,3444646562,1672546263,1672547857,1594
10273,3430310785,3238779889,1672687356,1672688804,1448
10969,3317989975,3500799617,1672681734,1672684940,3206
10104,3395082458,3229615214,1672573236,1672575955,2719
11418,3417969824,3716445184,1672557549,1672558246,697
10424,3364302157,3511645260,1672543491,1672545911,2420
10585,3632189887,3454554552,1672570972,1672572838,1866
10741,3416079461,3385481989,1672631327,1672634162,2835
10323,3857590978,3230250213,1672552577,1672553394,817
10860,3517440258,3711518637,1672633324,1672634036,712
9820,3912878303,3513545735,1672555050,1672558127,3077
10999,3929923442,3760274119,1672606745,1672606962,217
11465,3793732968,3550206045,1672650034,1672650811,777
10796,3701449715,3509701363,1672619281,1672619616,335
10210,3418382025,3856601074,1672541945,1672543551,1606
11312,3713807459,3519754667,1672593300,1672594112,812
11562,3471177177,3511466117,1672697274,1672698468,1194
10205,3500793739,3245755569,1672592429,1672594779,2350
10161,3774448657,3240622654,1672573401,1672576547,3146
10466,3240443426,3710228292,1672584951,1672586037,1086
10092,3384151770,3703938162,1672612911,1672614350,1439
10334,3553694590,3772070986,1672622205,1672625326,3121
11775,3335974305,3510233949,1672536848,1672537274,426
10884,3510824484,3602401154,1672589697,1672591367,1670
9899,3885674996,3227956115,1672553270,1672556515,3245
11048,3931917809,3703779674,1672612327,1672614860,2533
10950,3851515560,3227647190,1672560132,1672562211,2079
9996,3366566029,3821103640,1672634753,1672638083,3330
11091,3772234939,3399726243,1672593774,1672595250,1476
11665,3715490209,3440991826,1672625961,1672626315,354
10024,3516517348,3513143959,1672678227,1672681745,3518
11639,3884388188,3854202447,1672567590,1672568494,904
11330,3793949077,3471177177,1672683215,1672683483,268
10552,3701453343,3778182724,1672690835,1672693322,2487
11192,3514297012,3757514745,1672697126,1672697187,61
10998,3777767907,3774598935,1672628445,1672631816,3371
9966,3816184951,3757604311,1672641163,1672641493,330
10678,3814378625,3518882056,1672645969,1672649318,3349
11753,3376487118,3231654754,1672532046,1672534708,2662
10504,3388463477,3509614126,1672679722,1672683194,3472
10171,3500640854,3619676231,1672560892,1672563321,2429
10410,3710397477,3938129916,1672540090,1672541914,1824
11644,3885645840,3902682060,1672612863,1672615940,3077
10388,3513563152,3715737742,1672563196,1672563897,701
9933,3381055770,3517652011,1672633735,1672636580,2845
9811,3294164983,3881579907,1672645866,1672648311,2445
10354,3519351747,3919814073,1672618274,1672621852,3578
10166,3465227623,3756493561,1672565137,1672566352,1215
11388,3310702648,3896859936,1672544110,1672545130,1020
9858,3780050146,3780435349,1672538545,1672539449,904
11508,3921138062,3710397477,1672566875,1672567402,527
10399,3804779247,3311583437,1672659341,1672662551,3210
11068,3755465396,3772262649,1672550233,1672553241,3008
10998,3755465396,3779975575,1672667300,1672668114,814
11328,3917811545,3510535683,1672702654,1672704679,2025
10782,3777290300,3739387948,1672646547,1672647834,1287
10743,3737050849,3284407073,1672594394,1672596391,1997
10508,3505756991,3925175853,1672634083,1672635320,1237
11161,3334708091,3307791650,1672666892,1672670231,3339
11734,3774238066,3777370992,1672660245,1672662899,2654
11083,3907039612,3418382025,1672653724,1672655746,2022
11583,3885545415,3285515107,1672692384,1672693448,1064
9800,3774090455,3319862687,1672554590,1672554946,356
10248,3235470567,3533131937,1672665974,1672668600,2626
11782,3689223632,3825153408,1672634170,1672636120,1950
11679,3760396348,3446218191,1672565824,1672567250,1426
10642,3517440258,3510939082,1672693228,1672693630,402
11709,3778125688,3774663639,1672651995,1672652705,710
10941,3739297004,3440305508,1672616472,1672619793,3321
10901,3236206821,3481700413,1672675709,1672676764,1055
11183,3311037445,3514498259,1672671618,1672673585,1967
10862,3388463477,3854229296,1672640566,1672643625,3059
11486,3733915784,3976400190,1672534518,1672536955,2437
11653,3246971044,3713726267,1672544657,1672546134,1477
11743,3519848902,3757514745,1672624793,1672625742,949
11454,3533777032,3469663062,1672535346,1672538554,3208
11373,3534589501,3358675021,1672612156,1672613572,1416
11160,3701387745,3285201542,1672621752,1672623087,1335
11292,3275975921,3421040626,1672533373,1672536287,2914
10124,3505278562,3378430760,1672622092,1672623951,1859
10913,3715008501,3512625661,1672675170,1672678231,3061
11162,3910354786,3512596743,1672659818,1672662100,2282
10595,3780511388,3500096103,1672579836,1672581003,1167
10388,3819024145,3613547091,1672563478,1672566328,2850
11125,3792475476,3619494735,1672540714,1672542287,1573
9887,3773134128,3793332600,1672658758,1672659286,528
10993,3773636983,3511364193,1672679119,1672682699,3580
11007,3516497645,3519465545,1672597557,1672600043,2486
11535,3898595916,3509828883,1672619040,1672621947,2907
11334,3832333115,3804840997,1672628899,1672631712,2813
10439,3452878062,3291617477,1672694777,1672697029,2252
10459,3912811715,3278430820,1672696580,1672699486,2906
10098,3452982957,3396656251,1672591833,1672591951,118
11720,3437934509,3822786416,1672622816,1672623198,382
10348,3505560793,3480418192,1672536843,1672537061,218
9842,3926724515,3551833298,1672622972,1672624634,1662
10661,3480259863,3360783381,1672607570,1672609282,1712
10660,3632303304,3606688595,1672673589,1672674782,1193
11746,3773697080,3757212744,1672534399,1672536439,2040
11230,3711367577,3300238532,1672598366,1672598476,110
9812,3780969898,3500544306,1672533580,1672536727,3147
10976,3773017746,3533427742,1672573983,1672577026,3043
11130,3343193067,3417360319,1672671173,1672673159,1986
10667,3701004302,3501573548,1672543612,1672547182,3570
11090,3710819760,3358530225,1672694882,1672697343,2461
11698,3711179193,3898595916,1672569302,1672572287,2985
10597,3756149282,3778713526,1672645526,1672646758,1232
11745,3358385652,3249771731,1672632359,1672633133,774
10068,3711870537,3500145103,1672678346,1672681154,2808
10596,3480270940,3937636109,1672582877,1672582946,69
11515,3908177413,3455430943,1672561947,1672563927,1980
9928,3779212271,3438470128,1672679561,1672680390,829
9802,3909822999,3511526885,1672673663,1672674789,1126
10387,3476958001,3517210356,1672559954,1672563435,3481
10027,3791974273,3516867729,1672660149,1672662711,2562
11454,3500720752,3733411026,1672626473,1672627184,711
11749,3515939841,3429587594,1672547469,1672548037,568
10055,3800434325,3491527603,1672671107,1672672911,1804
11518,3417223898,3713475356,1672628338,1672628794,456
11246,3475033290,3311142523,1672639241,1672641356,2115
10044,3805268739,3779778679,1672549256,1672551729,2473
10609,3500799617,3452104161,1672602576,1672605345,2769
10664,3511671476,3770273459,1672646333,1672649538,3205
9878,3434452046,3356972733,1672702486,1672702922,436
10688,3500555856,3755849241,1672567755,1672568197,442
11654,3505828210,3813853446,1672697242,1672700338,3096
10748,3616242727,3776124041,1672606276,1672608407,2131
10885,3519463038,3735056027,1672681625,1672681827,202
11620,3278629965,3934611532,1672641050,1672644195,3145
10812,3730226545,3516731917,1672664730,1672667496,2766
11091,3772227820,3438470128,1672576938,1672577713,775
11419,3791906680,3514013999,1672655122,1672656134,1012
9811,3274223335,3701978422,1672583430,1672586192,2762
10758,3388923880,3772234939,1672660198,1672662388,2190
11530,3519965717,3791906680,1672627028,1672629943,2915
9899,3619538249,3500785888,1672663834,1672667007,3173
11006,3884862164,3934280144,1672645206,1672647131,1925
10925,3732223664,3241593146,1672672927,1672673013,86
10780,3483078667,3609997804,1672589644,1672592059,2415
10387,3335974305,3755218683,1672533126,1672534984,1858
10170,3509556649,3228218081,1672699333,1672700089,756
10360,3710271021,3780127017,1672581933,1672582150,217
11661,3774273260,3778909412,1672655981,1672656238,257
10462,3516867729,3306066522,1672664231,1672667798,3567
11518,3344710271,3711770773,1672587368,1672588632,1264
11157,3855440101,3713069234,1672674945,1672677844,2899
11768,3425260097,3738103378,1672582604,1672585966,3362
9968,3478052226,3388915945,1672608916,1672610716,1800
9908,3856975355,3519174861,1672673333,1672675648,2315
9804,3235313062,3458753033,1672563081,1672566124,3043
11259,3715419141,3478915403,1672667541,1672668909,1368
10663,3243651036,3756413374,1672632022,1672634256,2234
11195,3974668678,3517331746,1672551558,1672552296,738
11170,3533154906,3714787207,1672669855,1672671513,1658
11169,3791542842,3898989233,1672697741,1672699172,1431
10902,3500433278,3779212271,1672604631,1672605023,392
10378,3802757611,3618895679,1672642159,1672643478,1319
9931,3435159896,3433902955,1672561755,1672563867,2112
11405,3792512768,3241855333,1672634443,1672636866,2423
11135,3475830203,3505786561,1672695190,1672696352,1162
9866,3770018912,3394959062,1672630602,1672632241,1639
10163,3738873928,3835509670,1672696937,1672698016,1079
11081,3423940256,3630802959,1672572248,1672572722,474
11130,3925175853,3887382548,1672564074,1672565652,1578
11785,3368951504,3777937949,1672579056,1672579245,189
10138,3772188086,3410602007,1672580051,1672581159,1108
11636,3715196780,3757607649,1672541049,1672541328,279
11459,3500974385,3770486161,1672538744,1672539337,593
10564,3851737350,3885339157,1672534300,1672536055,1755
11006,3514013999,3916955566,1672596281,1672598325,2044
10737,3398075553,3776732532,1672540044,1672540539,495
10644,3511750695,3777751979,1672580919,1672583664,2745
11743,3792475476,3714250543,1672699216,1672700451,1235
10141,3938409715,3517949586,1672611245,1672614671,3426
9916,3517195738,3882851213,1672555690,1672558298,2608
10879,3516249472,3922153821,1672639650,1672640186,536
11363,3639081201,3201573194,1672638331,1672640383,2052
11070,3703438617,3555763674,1672580777,1672581435,658
10073,3501980730,3517045396,1672637161,1672638394,1233
11176,3518989186,3792440162,1672637874,1672641444,3570
10981,3776182849,3850108828,1672551013,1672554085,3072
11138,3701448521,3755670258,1672642707,1672645916,3209
11570,3476416072,3770671714,1672703200,1672706656,3456
11458,3509274030,3856552205,1672690171,1672693538,3367
11785,3351153781,3881579907,1672612707,1672615841,3134
11091,3915652382,3625931630,1672590820,1672592764,1944
11357,3933106901,3770972037,1672696462,1672697529,1067
11213,3349319959,3245882008,1672532785,1672534908,2123
10564,3910020031,3533726421,1672655844,1672656296,452
11393,3518376262,3380218091,1672549205,1672550298,1093
10843,3780969898,3713566527,1672671688,1672674245,2557
10078,3925208102,3919258737,1672604651,1672607093,2442
11000,3278779955,3773840321,1672594304,1672597081,2777
10011,3533325993,3710680073,1672673431,1672676124,2693
10258,3914926436,3852310652,1672624826,1672625402,576
10650,3500927619,3511969443,1672685769,1672688825,3056
9971,3278805844,3511218261,1672547878,1672550949,3071
11472,3483347530,3703351452,1672544230,1672546881,2651
9962,3639503148,3808442442,1672674741,1672676766,2025
11069,3311569360,3505593034,1672565919,1672566311,392
11261,3505121295,3852461753,1672642387,1672645224,2837
11656,3777263928,3533830748,1672674792,1672677625,2833
11611,3440743218,3221736756,1672555002,1672556162,1160
11051,3882580580,3710260848,1672682807,1672684738,1931
10694,3774355339,3280208630,1672601686,1672604728,3042
10791,3888523259,3486509752,1672632518,1672632822,304
10490,3930727474,3559619861,1672655278,1672655683,405
10860,3906260966,3423217578,1672655548,1672658082,2534
11229,3837435907,3710119555,1672641432,1672642855,1423
11058,3500444748,3519947298,1672560298,1672560688,390
10162,3513850048,3554174421,1672692500,1672694094,1594
10347,3513586642,3471131277,1672627056,1672628216,1160
11085,3227874229,3393955069,1672538482,1672538597,115
11366,3334381941,3439283360,1672533413,1672533585,172
11274,3934991640,3246971044,1672637470,1672638215,745
11187,3778479297,3909399636,1672577673,1672578302,629
10953,3505853594,3885339157,1672696878,1672700132,3254
11264,3779415433,3491250381,1672689158,1672692623,3465
11670,3505786561,3609103278,1672535962,1672538086,2124
10811,3668764192,3783651407,1672561002,1672564098,3096
9934,3513486828,3814770073,1672703640,1672706417,2777
10933,3772164469,3660163550,1672596634,1672599523,2889
11600,3780148144,3341311972,1672612900,1672616202,3302
10526,3903879740,3778370462,1672542994,1672545321,2327
11089,3701971784,3817038422,1672599844,1672601865,2021
10089,3517652011,3856147380,1672664500,1672665199,699
10115,3298706213,3471585513,1672668208,1672669113,905
10069,3738734246,3501407804,1672604789,1672605850,1061
11773,3894495222,3682906048,1672658845,1672659305,460
10002,3414510793,3756784813,1672651654,1672654003,2349
10070,3204473480,3780749789,1672686230,1672689386,3156
10728,3500473064,3701725839,1672606613,1672609541,2928
10040,3360949039,3667654673,1672540005,1672540183,178
10286,3500595432,3313282478,1672629132,1672629566,434
11520,3757855416,3305093237,1672681831,1672685303,3472
10082,3774706478,3714455496,1672684800,1672685551,751
10251,3379666159,3477951091,1672622207,1672625596,3389
10499,3534984243,3403218814,1672553784,1672554693,909
11720,3501992314,3390438262,1672679104,1672682689,3585
11381,3776125503,3505816624,1672680025,1672683155,3130
10177,3284865931,3364948616,1672638244,1672638546,302
10326,3777932581,3609166109,1672543369,1672543536,167
11062,3510484107,3505248368,1672610085,1672612603,2518
9981,3223144610,3516651799,1672645840,1672648873,3033
10634,3893527651,3933106901,1672557602,1672557734,132
10339,3791644831,3780013266,1672647418,1672648917,1499
11520,3621591266,3534531039,1672566760,1672569861,3101
11217,3514638555,3779609338,1672586909,1672590320,3411
10322,3559123082,3310737478,1672678230,1672681702,3472
11695,3466620548,3732871856,1672671745,1672672800,1055
11236,3309455369,3353335252,1672657444,1672660478,3034
11057,3783060739,3436099135,1672659564,1672660084,520
10884,3776001441,3938129916,1672700427,1672701559,1132
11689,3493598658,3792337863,1672651236,1672653973,2737
10482,3912625932,3804075198,1672609774,1672611954,2180
10903,3505908965,3881012415,1672702072,1672703122,1050
11324,3533440736,3472173212,1672589786,1672592215,2429
10864,3778044082,3310702648,1672650974,1672654165,3191
10237,3772966919,3783095041,1672612504,1672614022,1518
10326,3313392810,3713621169,1672535832,1672537916,2084
10566,3275057862,3356599815,1672533577,1672534737,1160
10099,3368951504,3636852764,1672622928,1672625266,2338
10579,3485898181,3207748225,1672552179,1672553692,1513
10690,3715680249,3347520239,1672536079,1672537613,1534
11760,3776068937,3773876312,1672639193,1672642343,3150
11790,3500695402,3757050615,1672554631,1672555166,535
11017,3518205307,3501427691,1672697741,1672698453,712
9846,3437934509,3505653701,1672562844,1672563184,340
11236,3370751461,3514145752,1672677667,1672679179,1512
10118,3220798451,3417223898,1672568780,1672571255,2475
11352,3716179251,3600302127,1672648736,1672649782,1046
10957,3351949206,3343511947,1672680482,1672681866,1384
10607,3774326754,3739297004,1672596267,1672597929,1662
11332,3710919244,3756740153,1672587155,1672590095,2940
11118,3520049965,3792255406,1672589093,1672591963,2870
10350,3227647190,3791108593,1672586649,1672587815,1166
9864,3488399075,3780013266,1672578331,1672580300,1969
10152,3780969898,3447938130,1672647597,1672648994,1397
11390,3779312237,3309455369,1672635156,1672636251,1095
10554,3713444403,3668202976,1672582132,1672582991,859
10075,3778738044,3779478448,1672561031,1672562399,1368
11524,3368951504,3779382417,1672630802,1672631668,866
10975,3898595916,3319585148,1672658757,1672660959,2202
11448,3774109138,3513186578,1672607314,1672609316,2002
10277,3301403047,3307535495,1672576436,1672576809,373
11527,3884191432,3362385373,1672599775,1672600847,1072
10023,3272096922,3318250647,1672673610,1672674357,747
10222,3791269060,3220976338,1672644578,1672645214,636
10693,3778986795,3500595432,1672676992,1672678189,1197
11769,3468871103,3906260966,1672689732,1672692981,3249
11768,3619705594,3713102459,1672556490,1672556706,216
10852,3501192566,3713191326,1672562534,1672565774,3240
9984,3778182724,3770544738,1672681568,1672683724,2156
9796,3715126587,3793232021,1672566743,1672568376,1633
10112,3292936094,3435652260,1672646079,1672647255,1176
10868,3284374600,3701567668,1672579047,1672581345,2298
11676,3303772923,3373677765,1672657913,1672660249,2336
10145,3713954144,3500096103,1672597744,1672598778,1034
11252,3779706467,3509828883,1672570043,1672572333,2290
10836,3501734800,3716460706,1672681379,1672682878,1499
11390,3482687604,3756784813,1672540491,1672542367,1876
10963,3886896755,3791332061,1672660986,1672662040,1054
10658,3200372897,3311479294,1672542009,1672543662,1653
10770,3204149913,3422205569,1672642284,1672643142,858
11106,3453164933,3491527603,1672569822,1672572816,2994
10339,3689386663,3235373942,1672586088,1672589470,3382
11069,3229621693,3919342147,1672649570,1672652952,3382
10355,3450735824,3730169449,1672649617,1672650360,743
10151,3500833053,3403218814,1672559491,1672562813,3322
11656,3518511124,3474852115,1672604387,1672606422,2035
10923,3770424892,3288920399,1672641162,1672642793,1631
10530,3341432459,3773636983,1672571975,1672572532,557
10837,3505936495,3287968403,1672626371,1672627676,1305
11505,3774401596,3701412729,1672667285,1672668023,738
9983,3495637721,3332840671,1672671934,1672675218,3284
10158,3304030474,3203876438,1672618426,1672620339,1913
10230,3760267158,3792411831,1672550657,1672551669,1012
10532,3938021614,3534491112,1672625025,1672627547,2522
9851,3793029132,3776561263,1672661067,1672662162,1095
10002,3235074007,3311231911,1672615990,1672616766,776
10618,3777063455,3313579674,1672546911,1672549326,2415
11378,3380218091,3791758175,1672669525,1672670823,1298
10170,3343616490,3773895671,1672612015,1672614302,2287
11784,3852992961,3432762943,1672585517,1672588492,2975
11481,3227059650,3851810349,1672666454,1672669611,3157
10491,3776279305,3203172170,1672543590,1672544885,1295
10467,3701596047,3916924978,1672606372,1672609188,2816
9915,3517652011,3703611876,1672585384,1672587408,2024
11491,3756876537,3716183063,1672606354,1672607595,1241
11594,3533154906,3732871856,1672653112,1672654454,1342
10608,3514498259,3367121615,1672596566,1672599313,2747
9980,3615447269,3857244486,1672621954,1672623474,1520
10651,3533017131,3505571800,1672573385,1672574469,1084
11722,3367121615,3405200303,1672588514,1672588825,311
9836,3509651954,3436099135,1672612215,1672613017,802
11695,3500814753,3391612879,1672686704,1672688518,1814
11371,3374652108,3505449070,1672596373,1672599450,3077
11680,3904485393,3977666815,1672660274,1672661940,1666
11450,3915652382,3513203127,1672684695,1672684810,115
9817,3779102237,3938059867,1672562417,1672565202,2785
10598,3347205332,3387388336,1672541439,1672544208,2769
10219,3887069914,3701685828,1672659619,1672662095,2476
9908,3730935770,3554317844,1672534174,1672534962,788
11592,3306037126,3505786561,1672567121,1672570329,3208
9921,3732533330,3512087090,1672595819,1672597021,1202
11565,3480270940,3288675710,1672591549,1672592102,553
10341,3791617239,3682150740,1672587132,1672587925,793
10062,3402020492,3605078841,1672655856,1672659441,3585
10576,3778932673,3477248170,1672612477,1672615590,3113
11266,3517810375,3783809405,1672561777,1672562794,1017
10322,3828354855,3683677062,1672560717,1672562602,1885
10265,3471507117,3517645656,1672537624,1672538647,1023
11143,3613940925,3687183789,1672675367,1672675916,549
9923,3972729768,3755229631,1672558320,1672561078,2758
10362,3826542169,3319061210,1672626572,1672628345,1773
10892,3341738186,3730052916,1672702171,1672704755,2584
11779,3517718901,3755273361,1672570939,1672574039,3100
10634,3514297012,3757497708,1672604747,1672607750,3003
10195,3605760561,3511864772,1672650146,1672651536,1390
10821,3511729562,3500674240,1672589065,1672589248,183
11579,3711518637,3669918958,1672639501,1672641568,2067
9970,3228465044,3850735936,1672623656,1672625068,1412
11296,3716669659,3890813040,1672533439,1672533523,84
10675,3476431618,3400793223,1672601242,1672602567,1325
10631,3783563043,3337675386,1672533737,1672534506,769
10346,3971422524,3429409539,1672640293,1672643091,2798
10653,3715284599,3559123082,1672700789,1672701497,708
9901,3885339157,3890813040,1672631039,1672631298,259
11723,3511341866,3429610195,1672606048,1672609422,3374
10730,3510454018,3510244209,1672634890,1672637820,2930
10642,3446537819,3501992314,1672624029,1672624873,844
11197,3512784888,3355430975,1672562603,1672565152,2549
10525,3295748489,3553008208,1672651574,1672654644,3070
10022,3779723939,3243763209,1672599516,1672600714,1198
9888,3757678397,3357026115,1672622661,1672624517,1856
11702,3514585995,3516486526,1672548436,1672550169,1733
10046,3777672363,3774325486,1672636209,1672637164,955
11099,3919258737,3638050763,1672587193,1672587434,241
11368,3238779889,3296970170,1672558601,1672559483,882
10723,3776193847,3380285779,1672696586,1672696845,259
11611,3480185839,3505482210,1672557609,1672559817,2208
10080,3226761201,3364286028,1672658702,1672659870,1168
10630,3510819040,3756066765,1672689583,1672690567,984
11312,3381244346,3534696810,1672602618,1672605976,3358
9981,3387322545,3977880564,1672534816,1672537755,2939
10447,3976400190,3512769522,1672607935,1672610526,2591
11520,3416105769,3367526113,1672597154,1672600312,3158
11614,3793719515,3792851584,1672635738,1672638558,2820
10645,3518534560,3776316903,1672561867,1672562206,339
11457,3622729771,3912181197,1672547845,1672550790,2945
11592,3714067998,3666958814,1672631766,1672634245,2479
11148,3463892928,3715204544,1672693136,1672695322,2186
10262,3777387533,3793822639,1672654396,1672656464,2068
9825,3476144563,3858330969,1672545275,1672546473,1198
9926,3398075553,3445172440,1672681889,1672685129,3240
9911,3628423403,3757150421,1672622715,1672624563,1848
11030,3209417223,3814672661,1672611317,1672612700,1383
10308,3890278838,3730459093,1672694581,1672695473,892
10230,3779468781,3310712221,1672610543,1672613384,2841
10485,3505720915,3428303756,1672607591,1672611012,3421
10883,3505547832,3791121243,1672555079,1672556943,1864
11285,3339649817,3492350318,1672532718,1672534132,1414
10645,3220976338,3932919664,1672644737,1672645188,451
9927,3972856326,3500209015,1672666700,1672667500,800
10641,3773085258,3519463038,1672600431,1672600845,414
10999,3792475476,3817120976,1672576892,1672579952,3060
11368,3783277159,3492350318,1672571469,1672573195,1726
11273,3772689657,3774682234,1672607007,1672608200,1193
11220,3783939161,3429315500,1672564767,1672566946,2179
10571,3895839169,3819024145,1672552852,1672554512,1660
11309,3425646356,3447202943,1672661325,1672663858,2533
10242,3903115138,3780964089,1672569329,1672569773,444
11303,3927763819,3710852576,1672686778,1672689024,2246
10238,3510278533,3501557463,1672595335,1672595503,168
10064,3770273966,3613940925,1672613434,1672613785,351
10722,3293157673,3447267291,1672686119,1672688140,2021
10361,3793902476,3908883591,1672646165,1672648637,2472
9900,3974400577,3924366353,1672601234,1672603256,2022
11380,3774355339,3305612422,1672593405,1672595329,1924
10631,3498803823,3332840671,1672568208,1672568692,484
11194,3345896913,3687183789,1672694074,1672695832,1758
10028,3474879231,3776950532,1672564237,1672567638,3401
11380,3776867553,3403035480,1672625301,1672625656,355
11499,3501174621,3307454562,1672696778,1672698477,1699
10632,3311159418,3669475165,1672629883,1672630417,534
9839,3516706121,3500688476,1672552596,1672555751,3155
9856,3421524698,3684199077,1672669223,1672671679,2456
10908,3517210356,3937636109,1672699442,1672701420,1978
10156,3224053074,3836586875,1672632369,1672635114,2745
10448,3757060033,3783826338,1672693331,1672694745,1414
11628,3312959324,3777569538,1672635800,1672637107,1307
9987,3738160394,3770925016,1672604894,1672607284,2390
11341,3201634072,3457249798,1672651543,1672654221,2678
9928,3772802020,3667654673,1672595534,1672597652,2118
10157,3511750850,3515706117,1672602266,1672603703,1437
10750,3454151554,3887069914,1672656105,1672656741,636
10828,3637105495,3800434325,1672601836,1672603079,1243
11216,3284374600,3362385373,1672645678,1672646741,1063
10795,3900766525,3385481989,1672676860,1672677655,795
11787,3295691964,3373677765,1672542846,1672544281,1435
11116,3288346356,3602401154,1672553215,1672555873,2658
9959,3780294116,3929923442,1672691636,1672695202,3566
10186,3622152515,3757514745,1672641857,1672644920,3063
10170,3777706200,3756149282,1672609737,1672611718,1981
10149,3792432763,3444598583,1672691200,1672692782,1582
11295,3509503263,3780168985,1672668739,1672671605,2866
10947,3611939581,3837885956,1672630950,1672634260,3310
11737,3512490032,3816184951,1672584612,1672584674,62
10243,3445558740,3682802569,1672662256,1672664794,2538
11611,3715111016,3770595035,1672560195,1672560732,537
10471,3972442654,3435652260,1672615711,1672616050,339
11247,3774355339,3916463490,1672611945,1672612611,666
11683,3791628263,3772962072,1672616779,1672620196,3417
10394,3400560073,3395610742,1672628702,1672629555,853
10281,3701453343,3783942518,1672702062,1672704204,2142
11339,3792289287,3483078667,1672574764,1672576456,1692
10984,3387322545,3665841655,1672699752,1672701778,2026
9875,3684108920,3224053074,1672677457,1672679846,2389
11353,3400793223,3354968884,1672649433,1672651490,2057
9853,3476308535,3490008012,1672577473,1672579527,2054
9978,3435652260,3534081527,1672593018,1672595632,2614
11500,3466655775,3776319560,1672635536,1672638598,3062
11769,3534937492,3885339157,1672618312,1672619017,705
10941,3757869138,3311264420,1672590393,1672592496,2103
10296,3430823498,3438470128,1672615495,1672615984,489
11280,3293898029,3975796415,1672693150,1672694448,1298
11003,3398151217,3361865467,1672570978,1672571806,828
10205,3703277359,3817029483,1672660360,1672663634,3274
10363,3312946269,3703624327,1672649363,1672651400,2037
10406,3791245127,3814770073,1672644752,1672648119,3367
10285,3683047199,3479910993,1672557005,1672558869,1864
10840,3520473111,3792512768,1672562499,1672564433,1934
11619,3776953418,3739387948,1672609598,1672610690,1092
10037,3906874577,3714116241,1672611026,1672613005,1979
10731,3618895679,3685645561,1672625877,1672629323,3446
11486,3534537581,3733423371,1672559917,1672561346,1429
10078,3229734741,3710051427,1672544087,1672546014,1927
11763,3520725149,3776124041,1672639034,1672639899,865
10130,3714377201,3557653200,1672703292,1672705393,2101
11206,3890813040,3231654754,1672601542,1672603919,2377
10860,3711258452,3509167758,1672679235,1672681888,2653
9912,3408982612,3291617477,1672675760,1672676549,789
10367,3903994989,3832289185,1672611939,1672613402,1463
11431,3272827860,3249614888,1672664953,1672665389,436
10789,3774145748,3757513651,1672586297,1672589478,3181
11153,3976225898,3514541800,1672554691,1672557837,3146
10617,3403218814,3354968884,1672619636,1672623107,3471
10713,3534206917,3917004141,1672692566,1672695022,2456
9882,3515893948,3357097510,1672568106,1672571552,3446
9823,3337675386,3291446384,1672685989,1672687985,1996
11548,3770023722,3201573194,1672608118,1672610470,2352
10743,3235373942,3932919664,1672566847,1672569792,2945
10574,3520049965,3512819376,1672615849,1672617191,1342
10223,3414510793,3778382224,1672548209,1672549268,1059
11762,3701540249,3286938590,1672596326,1672598682,2356
11378,3465672238,3772169046,1672534421,1672537544,3123
11335,3701596047,3933562725,1672628873,1672629037,164
11183,3505839395,3935444008,1672620459,1672622942,2483
10474,3627377299,3500342408,1672661323,1672663243,1920
10211,3493598658,3510694464,1672660772,1672661158,386
10597,3275171954,3335353798,1672547434,1672548171,737
10324,3817315443,3777767907,1672585636,1672587515,1879
10332,3711214982,3352044245,1672604302,1672605623,1321
9966,3757406215,3774238066,1672601611,1672602129,518
10638,3760396348,3732104286,1672680031,1672681960,1929
10271,3791905743,3818324410,1672698086,1672700924,2838
10844,3553229537,3733796228,1672617275,1672617912,637
10012,3517810375,3514576083,1672605827,1672607972,2145
9835,3710861700,3755465396,1672583814,1672585998,2184
11273,3337903727,3489212992,1672639326,1672641645,2319
11663,3791108593,3710149975,1672681908,1672683106,1198
10983,3760731595,3287683210,1672535566,1672537805,2239
11127,3826068495,3852275715,1672703744,1672706753,3009
10807,3350966326,3331471764,1672632087,1672632869,782
10799,3534068874,3377883705,1672674515,1672677424,2909
11182,3500079479,3367262509,1672593426,1672595268,1842
10047,3884001167,3710487368,1672570565,1672573069,2504
11231,3620836520,3783086267,1672617573,1672617883,310
10857,3616242727,3352374868,1672560358,1672560942,584
11517,3409514897,3319061210,1672557767,1672558178,411
10545,3779312237,3319436533,1672698929,1672700283,1354
10338,3243651036,3515893948,1672540023,1672541419,1396
10967,3444881567,3792785261,1672656167,1672659647,3480
10035,3914740937,3300810210,1672609964,1672612043,2079
9859,3287094447,3516167000,1672543033,1672544291,1258
11654,3804779247,3505117019,1672623586,1672626932,3346
10407,3206262649,3732440502,1672560250,1672561936,1686
9817,3415228763,3416079461,1672680226,1672682666,2440
9805,3512101369,3515715968,1672603561,1672606880,3319
10322,3904184638,3463729805,1672538279,1672539134,855
11173,3934564437,3520558137,1672695337,1672697620,2283
11496,3783947742,3501356814,1672569842,1672573319,3477
10820,3714718326,3817478012,1672654920,1672658174,3254
11780,3296970170,3534775239,1672701138,1672702932,1794
11759,3916656185,3367299721,1672555840,1672558970,3130
10573,3245121919,3422314045,1672585721,1672586154,433
10711,3501988762,3509370016,1672587604,1672590077,2473
11026,3773636983,3757393413,1672553242,1672554387,1145
11703,3776279305,3420881591,1672546270,1672549781,3511
10522,3436099135,3773688906,1672696578,1672696788,210
10349,3813986705,3826315540,1672651083,1672652289,1206
10484,3636857871,3779169946,1672614809,1672617403,2594
10203,3703438617,3636877469,1672532401,1672534263,1862
11711,3505502819,3271389160,1672563256,1672565022,1766
10909,3774706478,3778824229,1672572906,1672573924,1018
9874,3972442654,3520832066,1672687754,1672689746,1992
9915,3495637721,3680988889,1672612414,1672613800,1386
9829,3534206917,3780050328,1672607128,1672610537,3409
11504,3505164060,3770273966,1672638114,1672638975,861
10307,3500814753,3701567668,1672600932,1672602346,1414
11134,3914353062,3423217578,1672660008,1672661237,1229
10584,3240443426,3446575109,1672541284,1672541901,617
10260,3517810375,3791222330,1672578348,1672578950,602
11697,3499142934,3316121649,1672675547,1672675846,299
10446,3757607649,3850108828,1672616879,1672617586,707
10197,3342426430,3533030343,1672538783,1672541113,2330
10898,3912811715,3501835995,1672657914,1672659925,2011
10889,3755411110,3319585148,1672566986,1672567682,696
10227,3811629200,3774652449,1672702255,1672703324,1069
11534,3934611532,3793375825,1672628696,1672632252,3556
10465,3827889533,3791628263,1672607734,1672608210,476
11216,3772320856,3911376818,1672556419,1672556902,483
10443,3713990030,3519689906,1672647574,1672647785,211
11724,3978643889,3778842400,1672607617,1672608136,519
11079,3792497486,3302348002,1672535681,1672538023,2342
11245,3454924050,3917905192,1672566131,1672567520,1389
10130,3907390925,3511095300,1672650088,1672650609,521
11344,3400186699,3770105006,1672662649,1672663075,426
10247,3660496328,3770273459,1672554270,1672554388,118
11628,3780127017,3400793223,1672679793,1672681393,1600
10102,3440305508,3757713457,1672542721,1672544130,1409
11544,3238056215,3436774112,1672653843,1672655373,1530
11747,3554317844,3701663839,1672535869,1672538600,2731
11278,3972856326,3732540636,1672547697,1672548728,1031
11735,3732104286,3618672178,1672652951,1672654995,2044
11575,3479585868,3444680955,1672535778,1672537314,1536
10038,3774663639,3520009158,1672542876,1672546092,3216
11357,3857344874,3774822697,1672658891,1672661063,2172
10743,3853275529,3407398464,1672699453,1672701745,2292
10741,3900793652,3627431396,1672577716,1672579257,1541
10176,3703423962,3342056927,1672554282,1672556959,2677
10499,3791863922,3703481882,1672628996,1672629715,719
11423,3449233346,3489212992,1672673781,1672674595,814
10450,3760232135,3770709417,1672564371,1672564943,572
10889,3898592058,3601214648,1672633280,1672635568,2288
10854,3501927452,3772786559,1672667294,1672668388,1094
10859,3450511428,3351856699,1672560266,1672561102,836
10790,3403257752,3337903727,1672659373,1672662303,2930
10954,3621439107,3826418889,1672536813,1672537176,363
10079,3422314045,3793442891,1672634285,1672636588,2303
10927,3500776597,3774447975,1672587309,1672589899,2590
10675,3309651238,3238779889,1672675105,1672676785,1680
10991,3760731595,3519341916,1672579856,1672582460,2604
11743,3783373085,3778182724,1672541753,1672543934,2181
9846,3421040626,3371759044,1672624465,1672624698,233
10556,3467756698,3351153781,1672565765,1672567819,2054
10265,3505266343,3600441934,1672656628,1672659010,2382
11106,3509208005,3515405509,1672607419,1672610207,2788
10782,3517380144,3229890340,1672656450,1672658173,1723
10977,3760144712,3313392810,1672551895,1672555331,3436
10760,3714897456,3774090455,1672607543,1672609608,2065
10434,3760901975,3311432176,1672575429,1672577783,2354
10347,3757514745,3311959533,1672686618,1672687396,778
10022,3515681585,3513203127,1672556016,1672558975,2959
10537,3500693568,3497562878,1672687942,1672689679,1737
10302,3484490325,3755119166,1672672543,1672673379,836
11618,3501988762,3311409212,1672595260,1672596203,943
11726,3927699036,3714902042,1672603307,1672606714,3407
10217,3814770073,3715114417,1672669541,1672670114,573
10053,3344778261,3311805161,1672620389,1672622526,2137
10379,3711889178,3220660616,1672695125,1672697127,2002
10727,3488988274,3757851680,1672607753,1672608470,717
10078,3500440602,3366501813,1672566896,1672570068,3172
10750,3807111856,3773134128,1672661978,1672662375,397
11212,3793996996,3777758203,1672556332,1672557544,1212
11770,3307216611,3500734346,1672640179,1672642360,2181
10213,3510209505,3711836873,1672610856,1672612841,1985
10222,3756536512,3853783593,1672553787,1672556724,2937
10870,3501427691,3621591266,1672696145,1672699160,3015
10932,3519319233,3458130310,1672645721,1672645828,107
10485,3907225070,3772708314,1672648197,1672650671,2474
11327,3378172464,3756647451,1672606653,1672608313,1660
10611,3290797257,3927181190,1672593513,1672596072,2559
11297,3774296721,3917243005,1672533286,1672534691,1405
9958,3517210356,3533154906,1672564974,1672566055,1081
10369,3791224239,3774450494,1672640293,1672642550,2257
11286,3933469838,3355880028,1672698440,1672701757,3317
11123,3733836732,3418791124,1672659783,1672662780,2997
11283,3348343425,3449233346,1672668959,1672670670,1711
10288,3851515560,3516103646,1672658308,1672661495,3187
10082,3533419409,3776166086,1672564476,1672565958,1482
11496,3856147380,3855209450,1672553631,1672554418,787
10290,3632720032,3716733618,1672550256,1672552744,2488
10756,3755107521,3281970147,1672549579,1672552026,2447
10677,3207586072,3755989680,1672571399,1672574808,3409
10132,3703572036,3500234771,1672593461,1672596670,3209
11736,3500591274,3777715675,1672632601,1672634854,2253
9942,3500051606,3396440259,1672576571,1672577525,954
11129,3361926328,3755192104,1672641971,1672643066,1095
10837,3402020492,3359929534,1672578841,1672582406,3565
11333,3713514933,3516167000,1672656248,1672657033,785
11292,3713996094,3760096466,1672686627,1672689378,2751
10345,3534506090,3342426430,1672589063,1672592191,3128
10561,3509503263,3703624327,1672666332,1672668584,2252
10510,3618895679,3510486220,1672657976,1672661521,3545
10357,3406029706,3403988682,1672621407,1672623092,1685
10520,3500079479,3361926328,1672535176,1672537750,2574
11055,3515944817,3509208005,1672640377,1672643710,3333
10738,3477582923,3773556853,1672541949,1672543560,1611
10385,3919211457,3760385591,1672690748,1672690827,79
11537,3491250381,3295787354,1672557699,1672559770,2071
10468,3338465050,3516867729,1672594777,1672596037,1260
10130,3339331632,3714718326,1672682494,1672683649,1155
10645,3904184638,3839744168,1672563122,1672565194,2072
10525,3519351747,3516586325,1672653425,1672656217,2792
10651,3922430928,3777729184,1672681089,1672682104,1015
11212,3780482864,3701655378,1672595909,1672598605,2696
11137,3513629502,3793222045,1672627377,1672630754,3377
10461,3512343029,3490008012,1672689075,1672692042,2967
11687,3711836873,3908883591,1672575575,1672578759,3184
10179,3378430760,3601063076,1672676692,1672677022,330
9952,3399504157,3520553959,1672694442,1672694620,178
10668,3513777705,3505845400,1672664073,1672666014,1941
10090,3774822697,3388946581,1672627610,1672630764,3154
10674,3514329209,3733836732,1672667627,1672670261,2634
11541,3518534560,3501261089,1672637507,1672638013,506
10823,3772968080,3779282072,1672699930,1672702162,2232
9835,3452982957,3406492167,1672699401,1672702160,2759
9889,3625952981,3825526565,1672566048,1672567929,1881
10624,3410788026,3714640103,1672561364,1672564750,3386
11236,3500821475,3639081201,1672536500,1672536827,327
11334,3667654673,3203630241,1672589521,1672591889,2368
9885,3710529628,3801379377,1672541636,1672543129,1493
9915,3713927376,3382308738,1672622704,1672625460,2756
10239,3853182912,3313824913,1672553695,1672555907,2212
10415,3774273260,3485468650,1672638356,1672641390,3034
11242,3513293711,3382757142,1672537084,1672538022,938
11448,3714455496,3899903158,1672690111,1672692635,2524
11239,3499711458,3342545285,1672648385,1672651474,3089
10369,3714294005,3710783759,1672678046,1672679183,1137
10438,3299052917,3517380144,1672693393,1672695402,2009
9829,3770391782,3432050858,1672628680,1672631540,2860
11230,3238056215,3466492108,1672702722,1672704620,1898
11400,3839417558,3630802959,1672626548,1672628166,1618
10347,3908550561,3733123020,1672698076,1672699970,1894
11080,3714923092,3421040626,1672688193,1672690317,2124
10479,3301403047,3826418889,1672549714,1672550931,1217
10312,3730169449,3207748225,1672608148,1672611277,3129
11354,3770530739,3756647451,1672549860,1672552826,2966
9853,3505709407,3780050146,1672594873,1672597797,2924
11515,3737050849,3514341451,1672567843,1672571025,3182
11710,3710125627,3511004622,1672599319,1672600812,1493
10456,3701512498,3515597467,1672692423,1672694121,1698
10430,3474350534,3713224038,1672570816,1672571555,739
10962,3783939161,3793987483,1672631886,1672632682,796
10179,3505190512,3347140733,1672544154,1672545464,1310
9964,3340897079,3403395712,1672672491,1672675638,3147
10166,3516668203,3519712497,1672559462,1672562574,3112
10641,3278779955,3928508375,1672637578,1672640890,3312
10101,3974400577,3714731729,1672599610,1672601005,1395
11551,3476958001,3283847934,1672550538,1672553740,3202
11746,3714377201,3711349327,1672613449,1672614882,1433
10852,3778370462,3340321384,1672549823,1672551612,1789
9862,3307997700,3227498870,1672616602,1672617297,695
10134,3792440162,3733730342,1672636419,1672639477,3058
10095,3360309868,3791224239,1672625812,1672629106,3294
11235,3411355804,3791222330,1672589040,1672591127,2087
10278,3898989233,3354405535,1672666538,1672666713,175
10490,3755192104,3895944547,1672560609,1672561638,1029
11145,3355903597,3714718326,1672702382,1672703702,1320
11449,3500062408,3855629383,1672693483,1672695642,2159
9930,3792021895,3716669659,1672683281,1672686308,3027
10919,3401215739,3341432459,1672561662,1672563856,2194
11144,3814289471,3500342408,1672563290,1672564067,777
10268,3899205452,3757407184,1672551485,1672554493,3008
10598,3498857406,3856601074,1672644084,1672646080,1996
9992,3756119976,3668764192,1672632763,1672636052,3289
11365,3970851830,3516586325,1672618796,1672621298,2502
10670,3513586642,3756413374,1672608765,1672610333,1568
9933,3777729184,3519754667,1672627016,1672629442,2426
10444,3898965585,3513250976,1672703364,1672706373,3009
10403,3815440588,3304447950,1672542188,1672545247,3059
11415,3310702648,3663353552,1672557298,1672557534,236
10501,3770486161,3397972945,1672541811,1672542409,598
9924,3826542169,3850904092,1672665598,1672668085,2487
10914,3710819760,3716733618,1672606623,1672608487,1864
11598,3895507040,3760648750,1672686491,1672688336,1845
11126,3517144269,3407734098,1672684158,1672684221,63
10608,3701041860,3615846003,1672667231,1672669660,2429
10948,3636877469,3511476353,1672629303,1672629780,477
10556,3271389160,3666655293,1672626223,1672627668,1445
9893,3772556646,3358385652,1672535908,1672537472,1564
10257,3777878462,3512596743,1672567801,1672571114,3313
11034,3701041860,3358211034,1672684729,1672686135,1406
11207,3906693728,3773579644,1672645742,1672647391,1649
10480,3442462115,3777928067,1672617812,1672618583,771
10102,3621812406,3534941710,1672674467,1672674596,129
10585,3403150349,3447202943,1672666912,1672670282,3370
10418,3290097447,3937299996,1672649984,1672652532,2548
10928,3890194669,3701284535,1672588263,1672590300,2037
10045,3380185102,3884933821,1672558391,1672560900,2509
11703,3772227820,3611570003,1672573212,1672576298,3086
10384,3452175941,3477511446,1672684413,1672686093,1680
10803,3450503086,3509394912,1672638317,1672641642,3325
10392,3505032644,3472774606,1672531862,1672532964,1102
11097,3609925909,3452389513,1672570045,1672570647,602
10580,3517426473,3793274846,1672598077,1672599275,1198
11706,3516932899,3442462115,1672618921,1672621546,2625
11555,3394357241,3757660578,1672644291,1672647016,2725
10350,3770172119,3776581518,1672672044,1672672147,103
10420,3701685828,3757513651,1672690365,1672691019,654
11530,3510826414,3836757034,1672541425,1672543120,1695
11031,3479207976,3358959807,1672701782,1672702594,812
9937,3755465396,3509445318,1672564413,1672566210,1797
9861,3776053981,3441737317,1672686186,1672689503,3317
11153,3444881567,3510159441,1672685811,1672687172,1361
11271,3505756991,3855977674,1672627354,1672629826,2472
10307,3757678397,3513111053,1672624975,1672625424,449
10850,3714312797,3715737742,1672532686,1672534213,1527
10206,3516429380,3778927933,1672656648,1672657778,1130
10456,3515405509,3480418192,1672585546,1672586483,937
10286,3777499535,3240622654,1672681120,1672683804,2684
10576,3385481989,3292936094,1672547092,1672547933,841
11206,3311521176,3513894659,1672568825,1672571157,2332
9999,3669140241,3711015176,1672597026,1672600589,3563
10344,3510250740,3839308659,1672547370,1672549819,2449
11102,3299847117,3710487368,1672563197,1672566296,3099
10260,3713336088,3270502801,1672671548,1672673768,2220
10291,3483347530,3516517348,1672574375,1672576053,1678
10457,3520165730,3791664049,1672625619,1672627190,1571
9827,3511182297,3780648744,1672586758,1672589785,3027
11254,3500105301,3902300755,1672652400,1672652836,436
11704,3480270940,3515681585,1672677751,1672678534,783
10278,3416225867,3836586875,1672679812,1672680670,858
11340,3287734830,3343767438,1672670119,1672670345,226
9908,3492064037,3350631472,1672604285,1672607095,2810
9800,3804707712,3779778679,1672671905,1672674862,2957
11402,3361711720,3792455305,1672572253,1672573645,1392
11599,3510801769,3776053981,1672558288,1672561646,3358
10294,3332010532,3512087090,1672695792,1672696369,577
10454,3306475287,3907923381,1672609063,1672611987,2924
10138,3614484939,3500051606,1672628140,1672630676,2536
10253,3662307789,3715246385,1672587574,1672589814,2240
10320,3500317923,3605591994,1672587883,1672588198,315
10318,3312651192,3793081195,1672659214,1672660380,1166
10252,3715680249,3427527462,1672613597,1672615521,1924
9911,3713805968,3778195766,1672677246,1672680826,3580
10822,3304235700,3686081254,1672643029,1672644726,1697
10668,3516819320,3512784888,1672641299,1672643224,1925
10354,3716445184,3773848111,1672619806,1672620091,285
11374,3716341323,3972653129,1672584814,1672587432,2618
10023,3411355804,3713878219,1672612011,1672615047,3036
10913,3505245692,3275735969,1672572408,1672575988,3580
10094,3311414429,3500734346,1672685961,1672688713,2752
9911,3780942505,3933872044,1672643789,1672645811,2022
9844,3238796398,3760901975,1672532866,1672533167,301
11556,3387388336,3520558137,1672667688,1672669601,1913
11650,3446537819,3500693568,1672583260,1672583551,291
10532,3501115299,3755342153,1672662428,1672664450,2022
10219,3491527603,3602054754,1672538469,1672538681,212
10073,3519435459,3331471764,1672564287,1672565791,1504
11745,3510301454,3513215373,1672672607,1672673492,885
10969,3500051606,3289258397,1672574490,1672576515,2025
11760,3510864325,3713336088,1672630842,1672633619,2777
11273,3279102372,3913746581,1672651094,1672652081,987
10245,3822496670,3366501813,1672644326,1672644736,410
10790,3780435349,3626631210,1672658758,1672659851,1093
10477,3512965991,3813986705,1672597737,1672600924,3187
10356,3357097510,3716118473,1672664522,1672664839,317
11036,3334936138,3713159131,1672664722,1672668175,3453
11364,3202787155,3423147369,1672591825,1672591942,117
10943,3909504515,3519352855,1672612503,1672614431,1928
9923,3783021859,3854957153,1672537862,1672539779,1917
10364,3318056480,3971280379,1672571662,1672574857,3195
11070,3791617239,3505190512,1672536050,1672537579,1529
11440,3428788958,3427741923,1672610307,1672613709,3402
11754,3229615214,3620105539,1672636669,1672639786,3117
11135,3773878451,3225554956,1672688813,1672690076,1263
11559,3818461836,3512371853,1672602560,1672604734,2174
11528,3714690161,3510250740,1672678447,1672681926,3479
9907,3294821709,3533131937,1672537160,1672539459,2299
9816,3284407073,3734233216,1672561592,1672563008,1416
11497,3387388336,3497138014,1672638471,1672641005,2534
10378,3772250554,3384713976,1672619789,1672620610,821
10045,3813853446,3686885442,1672593589,1672595876,2287
10106,3204821370,3518511124,1672634861,1672637239,2378
10461,3908331271,3757584114,1672547018,1672547960,942
11403,3509317054,3791222330,1672561277,1672563630,2353
10093,3511645260,3534284132,1672574485,1672577477,2992
9917,3520697518,3519034304,1672605278,1672607926,2648
11188,3824259677,3512495325,1672627511,1672628786,1275
11467,3452024572,3894756677,1672606689,1672607069,380
10892,3500031401,3512641538,1672644593,1672648067,3474
9906,3819400315,3501192566,1672617931,1672618484,553
11549,3773554767,3913847876,1672638532,1672640809,2277
11054,3616403486,3520860199,1672543154,1672545865,2711
11752,3755286041,3509018337,1672583751,1672586050,2299
10866,3511218261,3518931700,1672537535,1672538929,1394
11230,3272838634,3772882440,1672533208,1672534905,1697
11786,3803473387,3757212744,1672642500,1672643559,1059
11618,3364683368,3895944547,1672576396,1672577100,704
11029,3295787354,3710852576,1672662247,1672664385,2138
11505,3227206772,3236886943,1672610246,1672611373,1127
11598,3783043770,3440582836,1672629353,1672629509,156
9824,3206262649,3505816624,1672603486,1672606045,2559
11267,3378534521,3356972733,1672614988,1672617340,2352
10831,3701004302,3520779124,1672553093,1672556646,3553
11700,3667814788,3780921044,1672550468,1672551508,1040
11311,3505697295,3714471069,1672584444,1672586350,1906
10046,3711613085,3534775239,1672630149,1672633671,3522
10013,3780308809,3509996827,1672592964,1672594722,1758
11094,3809871495,3776867553,1672608221,1672611552,3331
9918,3777200549,3903879740,1672628762,1672629965,1203
10697,3757523596,3288791629,1672640877,1672642874,1997
9888,3888523259,3220976338,1672546370,1672548406,2036
11675,3612841103,3716197140,1672663898,1672664333,435
10958,3493515706,3770180844,1672595353,1672597857,2504
10589,3398483531,3471555057,1672646985,1672649794,2809
11782,3898989233,3489205994,1672588356,1672590808,2452
10580,3249614888,3517083465,1672583459,1672586688,3229
11047,3511476353,3359418136,1672686762,1672689316,2554
10822,3512826895,3760749218,1672610342,1672612268,1926
10900,3772509599,3517960157,1672630410,1672631849,1439
10587,3519341916,3505190512,1672552319,1672555047,2728
10639,3471131277,3342235058,1672540002,1672542071,2069
11570,3243651036,3500720752,1672608588,1672610547,1959
10327,3413511621,3200785194,1672665792,1672667380,1588
11224,3791351852,3280208630,1672681693,1672684016,2323
10029,3403738461,3221290808,1672564795,1672567593,2798
11173,3500536897,3284407073,1672553408,1672553488,80
10325,3510916875,3666655293,1672577506,1672580800,3294
11640,3446066492,3484483775,1672675016,1672676083,1067
11054,3206377955,3773953689,1672614011,1672615327,1316
11674,3515577866,3701448521,1672610343,1672610750,407
10143,3755865626,3755465396,1672604701,1672607338,2637
10577,3203151036,3511198566,1672536956,1672537148,192
10365,3505769529,3634670780,1672658571,1672660849,2278
11136,3610806770,3792455305,1672555089,1672557199,2110
11240,3501253130,3778986795,1672645628,1672647546,1918
9964,3630462406,3352493805,1672583209,1672583606,397
10736,3714787207,3519922921,1672638576,1672639562,986
9946,3555954355,3634766042,1672664100,1672667185,3085
9906,3853188285,3832745283,1672646705,1672647384,679
11402,3513293711,3501208658,1672639185,1672640079,894
10207,3299052917,3711862792,1672585357,1672587567,2210
10946,3304030474,3819024145,1672601714,1672605167,3453
11253,3533642281,3778738044,1672632827,1672635699,2872
10714,3505980138,3854390432,1672557496,1672559355,1859
10085,3701459978,3760997159,1672675998,1672678445,2447
10559,3243651036,3970775805,1672659234,1672662163,2929
9886,3400793223,3420881591,1672671488,1672671626,138
11477,3519065870,3533325993,1672609598,1672612116,2518
11694,3501208658,3403738461,1672559791,1672561095,1304
10132,3711770773,3793902476,1672632380,1672633390,1010
11428,3774506868,3534111498,1672699346,1672700382,1036
10089,3801379377,3302416197,1672677428,1672680874,3446
11596,3805718871,3488887919,1672578429,1672578796,367
10571,3296970170,3882580580,1672703365,1672703730,365
11403,3516815069,3783651407,1672693768,1672694599,831
10992,3371184929,3820922991,1672694177,1672697319,3142
10837,3225554956,3520832066,1672683435,1672684053,618
10422,3713159131,3482639402,1672566814,1672569159,2345
9948,3716676869,3518088154,1672593298,1672595242,1944
10422,3701311947,3838119022,1672675315,1672677251,1936
11750,3500671218,3977360666,1672657288,1672660363,3075
10349,3429315500,3414387263,1672697658,1672699414,1756
11508,3534278019,3792455305,1672612367,1672612611,244
11571,3625779003,3932566114,1672703127,1672705181,2054
11753,3776187150,3509317776,1672579346,1672581177,1831
11656,3793732968,3791072829,1672631642,1672635145,3503
11745,3660980656,3393502004,1672660445,1672662600,2155
11655,3760069457,3837378340,1672635804,1672638414,2610
10204,3922430928,3534775239,1672681724,1672682774,1050
9855,3778909412,3701453343,1672650306,1672651817,1511
11185,3736203662,3611533094,1672583167,1672584735,1568
9930,3375257546,3774782065,1672663624,1672665383,1759
10810,3509018337,3666561358,1672654257,1672654327,70
9853,3511671476,3343767438,1672658740,1672662249,3509
9980,3756781024,3514021667,1672590764,1672594033,3269
10233,3353335252,3774450494,1672613770,1672615371,1601
10033,3514564903,3826997668,1672687293,1672688823,1530
11497,3609103278,3517149023,1672629256,1672632726,3470
10234,3836090778,3779130507,1672662396,1672662566,170
11204,3760397450,3366433035,1672608157,1672610324,2167
11042,3633622298,3245121919,1672545571,1672546722,1151
10656,3424997707,3886837151,1672598946,1672601096,2150
11553,3825153408,3511341866,1672616982,1672617116,134
10364,3770544738,3224824355,1672635359,1672637487,2128
11773,3838423363,3518117078,1672656962,1672659255,2293
11109,3792785261,3514107131,1672637668,1672637777,109
9911,3711938229,3553694590,1672686019,1672686758,739
9942,3334936138,3500051606,1672595274,1672596516,1242
11291,3783095041,3755107521,1672540475,1672541966,1491
10647,3934611532,3474074188,1672602450,1672605989,3539
10632,3533593766,3505117019,1672566899,1672567310,411
10991,3200320674,3491104534,1672551509,1672552422,913
10448,3206241691,3338195686,1672593025,1672594702,1677
11730,3681701931,3511458926,1672649101,1672651667,2566
9928,3777370992,3779706467,1672646082,1672649069,2987
10851,3757064623,3478455812,1672682228,1672685819,3591
11745,3209280342,3206262649,1672640755,1672641496,741
10125,3201419050,3772250554,1672558051,1672560558,2507
10799,3783157469,3513213122,1672649102,1672649209,107
9908,3855077502,3791289855,1672631686,1672632672,986
11682,3713990030,3500741005,1672638839,1672639394,555
11114,3776617627,3716526314,1672683678,1672686804,3126
10772,3915035136,3791628195,1672563624,1672564139,515
10258,3505140123,3777932225,1672645945,1672649415,3470
11469,3512784888,3311696372,1672700507,1672703062,2555
10155,3511458926,3834456158,1672553166,1672556750,3584
11231,3819024145,3713920790,1672640127,1672642953,2826
9970,3425545115,3930766276,1672618065,1672618260,195
10053,3335353798,3791994414,1672672490,1672672550,60
9847,3346755179,3436099135,1672689908,1672691989,2081
11210,3756685732,3319061210,1672632691,1672635302,2611
11374,3770424892,3453519360,1672568186,1672568590,404
10532,3411626917,3939851140,1672614044,1672616609,2565
10165,3505248368,3791332226,1672597931,1672601360,3429
11368,3703732445,3757497708,1672661165,1672663714,2549
10752,3516026189,3206262649,1672617408,1672619209,1801
11133,3837887478,3701956841,1672612842,1672614286,1444
10146,3288791629,3511907179,1672610613,1672613784,3171
11108,3517380144,3780563627,1672549466,1672550961,1495
10985,3793860209,3713191326,1672602540,1672605296,2756
10773,3835509670,3515378306,1672693712,1672695174,1462
11746,3424997707,3204149913,1672589751,1672593141,3390
10486,3380444321,3513890046,1672602905,1672605199,2294
10664,3209075485,3399430522,1672657183,1672659076,1893
10686,3397972945,3360783381,1672599920,1672602819,2899
11021,3701459978,3517943697,1672644728,1672646974,2246
11562,3909504515,3776053084,1672686095,1672688804,2709
10200,3393001196,3516706121,1672576304,1672578791,2487
10329,3714903253,3770976984,1672576873,1672577923,1050
10674,3792597493,3501711464,1672557460,1672560583,3123
9944,3756647451,3817315443,1672645930,1672648792,2862
11009,3776791436,3773344258,1672584475,1672585100,625
11406,3716445184,3828906027,1672666482,1672669922,3440
10986,3430310785,3776727271,1672536584,1672538056,1472
10478,3519712497,3416079461,1672541054,1672542278,1224
10549,3295530454,3330466913,1672604009,1672604521,512
11287,3776600696,3491104534,1672598699,1672600133,1434
10103,3238796398,3514353133,1672585699,1672588259,2560
10376,3509433155,3735679000,1672546660,1672548768,2108
9825,3505560793,3510111365,1672610455,1672613575,3120
10174,3445733121,3344710271,1672668525,1672668867,342
10252,3669140241,3478915403,1672651979,1672652884,905
11078,3495482863,3710695372,1672592584,1672594596,2012
10894,3783060739,3358262975,1672590731,1672594227,3496
11010,3774633364,3716183063,1672674472,1672677238,2766
10421,3306475287,3714595459,1672534062,1672535400,1338
9870,3632094087,3791905743,1672580090,1672582921,2831
10141,3755865626,3711755596,1672623171,1672626367,3196
10546,3711214982,3559125467,1672651686,1672652073,387
10196,3793569914,3457249798,1672597126,1672600082,2956
10520,3396453219,3915962248,1672699967,1672703418,3451
11374,3360837082,3639926564,1672582147,1672583891,1744
11658,3509208005,3935256825,1672576864,1672578696,1832
11186,3343511947,3517448452,1672644519,1672645471,952
10786,3619676231,3514941815,1672703765,1672707291,3526
10220,3509370633,3802374620,1672561200,1672562525,1325
10838,3632303304,3310961923,1672679838,1672683162,3324
10616,3495637721,3772893815,1672657215,1672660094,2879
11190,3510240661,3516651799,1672628954,1672632428,3474
11217,3399726243,3756948477,1672593103,1672595131,2028
11712,3332840671,3777498160,1672578127,1672581601,3474
10423,3912878303,3714903253,1672581885,1672583047,1162
11396,3907225070,3811629200,1672693411,1672693908,497
10957,3757944870,3974264211,1672649958,1672653513,3555
9903,3909399636,3637522163,1672539453,1672541219,1766
11033,3783043346,3711029952,1672583168,1672584113,945
11067,3501927452,3783679478,1672572438,1672574626,2188
9918,3774782065,3714640103,1672692395,1672693963,1568
11407,3450679913,3773083407,1672701563,1672703485,1922
10313,3757497708,3780423516,1672653258,1672653650,392
10801,3852461753,3246062632,1672537980,1672538783,803
11503,3534624672,3778402454,1672667416,1672667730,314
10584,3757201538,3519015940,1672539055,1672539831,776
11757,3375324190,3805616707,1672551521,1672554951,3430
10777,3203630241,3669427589,1672582151,1672582658,507
11282,3919258737,3777706200,1672594054,1672594949,895
10174,3534459983,3518067857,1672659867,1672660624,757
11619,3680832669,3703336988,1672591036,1672594291,3255
10307,3334708091,3358982831,1672651207,1672652272,1065
10035,3235198316,3827981800,1672681586,1672682566,980
10535,3311514075,3415032547,1672656201,1672658372,2171
11321,3513111053,3459694275,1672563899,1672566759,2860
10266,3666022373,3533816813,1672593792,1672594316,524
10147,3518368900,3514216460,1672617063,1672620319,3256
10081,3793899166,3519951586,1672647684,1672649992,2308
10015,3817478012,3773798215,1672690122,1672691138,1016
10165,3510836047,3779312237,1672566904,1672567699,795
10690,3777655401,3485898181,1672620798,1672623508,2710
9915,3714690161,3776455762,1672539930,1672539991,61
10758,3783043346,3701925712,1672542358,1672543536,1178
10977,3466655775,3773032706,1672664687,1672665621,934
10721,3287753579,3361865467,1672597217,1672599889,2672
10189,3207748225,3610723722,1672586097,1672587881,1784
10914,3779815753,3314363575,1672628701,1672631072,2371
9819,3497562878,3388774559,1672646029,1672647680,1651
9924,3620105539,3637105495,1672690623,1672693702,3079
10865,3339649817,3903879740,1672549360,1672552664,3304
10000,3403218814,3682150740,1672676066,1672678954,2888
10633,3482172065,3779454060,1672623164,1672623619,455
9868,3469778316,3510694464,1672589624,1672591554,1930
11443,3370245766,3836090778,1672649622,1672650370,748
10460,3830599959,3711671702,1672646469,1672647059,590
10436,3793949077,3902300755,1672662052,1672663629,1577
10080,3516153301,3793949077,1672567468,1672569807,2339
11476,3605905645,3772869013,1672659949,1672660208,259
11386,3357496255,3770533675,1672650496,1672651041,545
10625,3912878303,3610806770,1672653730,1672656519,2789
10110,3230250213,3516257130,1672547989,1672549657,1668
11543,3379517265,3624365837,1672535966,1672538095,2129
10472,3756536512,3357097510,1672608312,1672609643,1331
11271,3500096103,3435342362,1672623228,1672623641,413
10932,3514297012,3293157673,1672627977,1672628567,590
10934,3373135211,3309178914,1672682989,1672683085,96
10801,3499820963,3226761201,1672671549,1672672910,1361
10645,3368339963,3619538249,1672684043,1672685900,1857
9825,3421040626,3500994763,1672541230,1672544164,2934
11635,3791863922,3713728777,1672639792,1672639908,116
11630,3792708936,3825526565,1672577750,1672578155,405
10332,3500799617,3422915648,1672534554,1672535231,677
11594,3757713457,3701350519,1672650118,1672650719,601
11398,3682802569,3510836047,1672624187,1672625325,1138
10074,3815700240,3364302157,1672579713,1672580138,425
11350,3910020031,3783238023,1672556983,1672560307,3324
11190,3311924005,3357097510,1672586173,1672588958,2785
11564,3688410383,3908464960,1672695736,1672697711,1975
10313,3686211958,3511671476,1672624752,1672627335,2583
10419,3770285500,3756493561,1672598228,1672601818,3590
11419,3372079985,3621960662,1672625776,1672629159,3383
11495,3714283424,3550206045,1672579879,1672580291,412
11044,3247075753,3511382748,1672693047,1672694611,1564
11186,3517766135,3392010033,1672578966,1672580045,1079
10767,3380218091,3500799617,1672641271,1672641515,244
11007,3515893948,3516706121,1672565883,1672568035,2152
11445,3756736726,3776125503,1672658271,1672661671,3400
10751,3852461753,3714453773,1672640616,1672641116,500
10921,3777387533,3485898181,1672641452,1672642659,1207
10450,3419378107,3757198930,1672578444,1672581099,2655
11784,3714903456,3780050146,1672572363,1672575644,3281
10018,3715490209,3517083465,1672538596,1672540848,2252
10075,3458432407,3453519360,1672554981,1672556600,1619
10106,3713107380,3776122272,1672596511,1672599597,3086
10627,3715106566,3520344592,1672653371,1672653626,255
10196,3472561941,3410788026,1672696029,1672696870,841
11114,3270502801,3235470567,1672682190,1672682576,386
10645,3831864108,3450164574,1672685181,1672686171,990
10668,3804707712,3710119555,1672658977,1672660259,1282
11442,3288346356,3519435459,1672641246,1672641530,284
10395,3509544691,3516359146,1672635502,1672637274,1772
11546,3715737742,3911821258,1672645479,1672648979,3500
11182,3783443095,3338016147,1672694824,1672697857,3033
10023,3551972633,3916955566,1672689223,1672689613,390
10978,3243651036,3505901826,1672670935,1672672734,1799
9928,3310021925,3701265238,1672535182,1672538377,3195
11048,3703999217,3418683594,1672541264,1672542112,848
11230,3518067857,3462153833,1672691705,1672695240,3535
10681,3366961580,3711856534,1672575959,1672576661,702
11450,3639926564,3896200048,1672628073,1672628386,313
10727,3466620548,3398489033,1672626092,1672626427,335
11542,3710861700,3899156705,1672622178,1672624540,2362
10133,3501828287,3426207439,1672573174,1672573506,332
11119,3703659324,3903994989,1672616691,1672619559,2868
10660,3714806574,3834424604,1672600913,1672603466,2553
10787,3783043770,3778909412,1672590646,1672591908,1262
10946,3858429342,3701453343,1672571785,1672573366,1581
9964,3437703650,3779689733,1672649438,1672651049,1611
11687,3447938130,3281148858,1672535753,1672536176,423
11496,3515681585,3772291207,1672534871,1672535379,508
11644,3857244486,3517627003,1672541079,1672544671,3592
11069,3273674596,3519831322,1672662693,1672665999,3306
11761,3888903181,3772882440,1672592643,1672592987,344
11720,3519465545,3776440009,1672560894,1672564253,3359
9922,3853188285,3774450494,1672544814,1672546332,1518
10455,3205687719,3776053084,1672606420,1672608021,1601
11331,3760679372,3774706478,1672602209,1672602307,98
10759,3276499910,3514628916,1672542491,1672545305,2814
11069,3818532143,3838119022,1672612726,1672614755,2029
11636,3488399075,3615742989,1672551534,1672554858,3324
11668,3554174421,3716595760,1672639419,1672642745,3326
10503,3534562354,3774236212,1672625663,1672628453,2790
10297,3880549316,3710397477,1672701752,1672704428,2676
10359,3628556590,3367299721,1672679856,1672683436,3580
9848,3380167818,3520145112,1672580220,1672580565,345
10485,3236948071,3417969824,1672580391,1672580941,550
10761,3516517348,3923910914,1672629663,1672630496,833
10743,3332124606,3227339675,1672669109,1672670775,1666
9936,3609166109,3755767856,1672660406,1672661183,777
9907,3773134128,3773394570,1672655688,1672656456,768
10274,3505811269,3533325993,1672621834,1672625250,3416
11718,3791548838,3776534957,1672605058,1672605272,214
11468,3278251248,3505140123,1672663262,1672663622,360
9957,3806720019,3311260898,1672587880,1672591450,3570
11178,3500909455,3404375908,1672607626,1672610268,2642
9936,3857590978,3770595035,1672570982,1672573441,2459
10200,3509370633,3613828705,1672534905,1672535194,289
11017,3817120976,3510454018,1672577439,1672579529,2090
10351,3516517348,3501356814,1672688142,1672690488,2346
10531,3533620069,3783313202,1672604305,1672606227,1922
11281,3780956975,3888903181,1672640448,1672643302,2854
10776,3366433035,3922430928,1672600773,1672603067,2294
10931,3416079461,3516706935,1672544369,1672545958,1589
11085,3776447604,3424988692,1672695944,1672697780,1836
9988,3730290851,3498803823,1672587303,1672588043,740
10644,3621591266,3220123678,1672592946,1672595330,2384
11057,3660496328,3776968640,1672609312,1672611599,2287
10285,3770846374,3479207976,1672622115,1672625667,3552
11315,3477951091,3551972633,1672531965,1672533955,1990
11144,3881785069,3756428507,1672564898,1672566670,1772
10445,3971280379,3701725839,1672676233,1672677736,1503
11347,3509018337,3270502801,1672650101,1672650849,748
10190,3306066522,3514980025,1672636802,1672639819,3017
10382,3757089924,3855674398,1672609947,1672611232,1285
10808,3800434325,3774652449,1672625979,1672627013,1034
9977,3792173463,3505853594,1672682475,1672685314,2839
10493,3731905251,3755823805,1672590884,1672593048,2164
9860,3776187150,3358262975,1672603833,1672607295,3462
11006,3770180844,3501600785,1672631815,1672632464,649
10257,3779255367,3710149975,1672589491,1672591723,2232
10974,3278251248,3453164933,1672675049,1672677598,2549
11383,3330318282,3398075553,1672646459,1672647146,687
10625,3733423371,3487988841,1672617931,1672618262,331
9803,3304252969,3516792348,1672653135,1672656641,3506
10873,3792277399,3311331205,1672641762,1672642989,1227
10934,3610723722,3293898029,1672670009,1672673439,3430
11017,3511963020,3511794841,1672678784,1672682190,3406
10360,3770533588,3772227820,1672542535,1672543917,1382
11661,3622729771,3804779247,1672616742,1672616841,99
11057,3851451801,3391854325,1672671193,1672672025,832
10447,3554437212,3776348451,1672589980,1672590576,596
10717,3685877449,3779393140,1672570129,1672572250,2121
10452,3929002318,3602680347,1672630216,1672630739,523
11310,3827889533,3500234771,1672675680,1672676124,444
9994,3757513651,3553694590,1672562534,1672565965,3431
10683,3932919664,3520189871,1672612233,1672612566,333
11076,3776348451,3772609551,1672636660,1672639600,2940
10801,3472561941,3638823001,1672614473,1672617589,3116
11187,3505482210,3494560663,1672625352,1672628875,3523
11000,3236563828,3732312480,1672550981,1672552640,1659
9950,3792597493,3613216900,1672568431,1672569759,1328
10790,3793699467,3812277991,1672531205,1672533699,2494
11610,3792008302,3450342110,1672701010,1672702473,1463
10523,3774633364,3779130507,1672537405,1672539424,2019
10772,3495446254,3615245840,1672657973,1672658550,577
11177,3756272704,3501988762,1672537658,1672540858,3200
11599,3313824913,3915460293,1672682528,1672683536,1008
11004,3297624618,3812277991,1672686246,1672687844,1598
10219,3510250740,3715590997,1672670503,1672672009,1506
10882,3716233100,3716475340,1672694591,1672697054,2463
9849,3738132114,3514638555,1672533998,1672535993,1995
11269,3780294116,3307521389,1672551042,1672552127,1085
11620,3517380144,3715320359,1672539340,1672539946,606
11559,3837885956,3777149336,1672580466,1672583092,2626
10450,3880000841,3933106901,1672546312,1672546832,520
11216,3505392452,3307997700,1672588565,1672591454,2889
11149,3475830203,3772425253,1672634098,1672634355,257
11709,3511963020,3884933821,1672611352,1672613190,1838
10360,3776193847,3226761201,1672678006,1672679983,1977
11672,3821103640,3776183353,1672681503,1672681595,92
10273,3520763492,3516867729,1672624353,1672625647,1294
11015,3501980730,3711804184,1672642128,1672645609,3481
10999,3714690161,3780168985,1672684492,1672687783,3291
11377,3330238204,3421040626,1672566693,1672567530,837
10725,3603167427,3222357355,1672696593,1672699507,2914
10194,3493047640,3395082458,1672691333,1672693842,2509
11733,3513629502,3916656185,1672634972,1672635992,1020
10652,3422081502,3792267993,1672642798,1672644910,2112
10210,3905889514,3772019557,1672667185,1672669198,2013
9901,3246062632,3511750850,1672549469,1672552993,3524
9850,3492728794,3756736726,1672666834,1672666994,160
9969,3440743218,3472718723,1672538466,1672541905,3439
11167,3631444265,3509208005,1672551563,1672555072,3509
10939,3533427742,3229621693,1672671987,1672675143,3156
10331,3366501813,3668955834,1672696034,1672698561,2527
11057,3793375825,3921138062,1672679189,1672679869,680
9883,3509701363,3895839169,1672656247,1672657473,1226
10197,3905889514,3559619861,1672571554,1672574224,2670
11249,3505531432,3780050328,1672572119,1672574354,2235
11456,3822496670,3421674406,1672548543,1672550792,2249
11594,3501853868,3209280342,1672559441,1672559575,134
10065,3711613085,3818532143,1672534617,1672536613,1996
10735,3614484939,3447591143,1672654100,1672657161,3061
10666,3287734830,3931917809,1672645327,1672648816,3489
11472,3633949990,3312800145,1672552469,1672555340,2871
10418,3716541851,3757378286,1672660776,1672662218,1442
11408,3805616707,3778932673,1672645639,1672645754,115
10964,3226172318,3357074700,1672661411,1672661908,497
10608,3776053981,3517718901,1672669594,1672670828,1234
11212,3318220119,3287760230,1672697612,1672700690,3078
11172,3476431618,3403257752,1672647528,1672648853,1325
10158,3711889178,3499998389,1672569773,1672570860,1087
10205,3204821370,3714179543,1672684654,1672685902,1248
10559,3473520701,3517045396,1672560026,1672562956,2930
9887,3488333295,3298831109,1672651085,1672653322,2237
11433,3471507117,3491239350,1672611670,1672613401,1731
11081,3520182275,3714268380,1672654268,1672656406,2138
10856,3517210356,3480560014,1672595262,1672597017,1755
10616,3518376262,3516706121,1672606718,1672610117,3399
10610,3927202773,3713875941,1672579842,1672582464,2622
11434,3399726243,3287920864,1672702715,1672703331,616
11076,3826315540,3205908584,1672575860,1672578677,2817
10221,3352374868,3463892928,1672559133,1672562633,3500
11291,3227059650,3505010941,1672644095,1672644441,346
10941,3896622009,3714903456,1672604001,1672604886,885
11271,3440991826,3601340045,1672675483,1672678855,3372
11402,3773697080,3716463756,1672598848,1672600200,1352
10748,3756066765,3238796398,1672595968,1672597769,1801
11072,3533830748,3880788853,1672621880,1672624940,3060
11113,3312959324,3442096275,1672674640,1672677484,2844
10262,3851737350,3472561941,1672550874,1672552561,1687
10911,3509360869,3534937492,1672621481,1672625051,3570
11222,3629248353,3311602936,1672619179,1672620312,1133
10481,3511415786,3780171640,1672545986,1672548869,2883
11040,3533642281,3419378107,1672570164,1672573389,3225
10062,3732540636,3791688526,1672634056,1672634339,283
10826,3773408491,3776953418,1672647299,1672647860,561
10681,3476144563,3331228758,1672664199,1672666504,2305
10883,3285201542,3378534521,1672660066,1672663598,3532
11647,3389367628,3701663839,1672690087,1672691013,926
9944,3711287751,3501574882,1672631397,1672633301,1904
10057,3474350534,3777655401,1672572155,1672572250,95
10019,3716460706,3757823215,1672695987,1672696066,79
10542,3518511124,3701284535,1672670305,1672671446,1141
9829,3459951739,3501759031,1672684832,1672685474,642
11212,3417223898,3467415939,1672574290,1672577064,2774
10821,3287968403,3779561601,1672532017,1672532795,778
9976,3472901378,3792972270,1672639013,1672642563,3550
11690,3247193800,3779312237,1672581225,1672581300,75
10487,3439651226,3510801769,1672558563,1672562080,3517
10024,3739618347,3516655509,1672669527,1672671665,2138
9829,3931767736,3776727271,1672534242,1672536589,2347
11365,3311696372,3505756991,1672672152,1672673265,1113
10087,3310021925,3475033290,1672543222,1672546361,3139
11658,3710119555,3776583229,1672561027,1672564220,3193
10346,3519319233,3757198930,1672542816,1672545271,2455
11497,3514005973,3519463038,1672660999,1672662760,1761
10286,3811629200,3793569914,1672543709,1672546712,3003
10006,3512638952,3487622510,1672616184,1672617224,1040
10787,3757796416,3937636109,1672627283,1672630655,3372
11185,3619796619,3937299996,1672654622,1672655589,967
10425,3760080378,3441840658,1672614770,1672616487,1717
10150,3715844082,3793860209,1672618469,1672620333,1864
11161,3505685294,3791688526,1672647398,1672650243,2845
11754,3661543201,3755170743,1672562661,1672563853,1192
10928,3778544203,3519322066,1672545601,1672548453,2852
11702,3518205307,3220976338,1672551724,1672553539,1815
10406,3713906305,3406238754,1672556351,1672557157,806
11437,3688768189,3662055682,1672686996,1672687446,450
11356,3856897914,3920890008,1672655627,1672657091,1464
9979,3703779674,3520471156,1672575791,1672578718,2927
11420,3513739060,3772282008,1672663797,1672664335,538
11436,3519513219,3811503860,1672598958,1672602014,3056
10689,3638018906,3519034304,1672550470,1672553573,3103
10292,3908331271,3665841655,1672585174,1672588068,2894
10675,3518882056,3681274982,1672673778,1672676582,2804
10355,3682086200,3907923381,1672692947,1672695342,2395
11155,3519165527,3685396470,1672623650,1672624554,904
11413,3505720915,3359351267,1672680073,1672681991,1918
10108,3711959141,3974264211,1672543874,1672545640,1766
10321,3755357292,3887502536,1672670632,1672672152,1520
11472,3344478603,3626631210,1672698349,1672700968,2619
10205,3915460293,3533929043,1672550484,1672552302,1818
10144,3791359168,3360949039,1672656741,1672659064,2323
10014,3738547113,3710046567,1672591681,1672593783,2102
11341,3496352027,3466620548,1672574063,1672575869,1806
10153,3417223898,3480560014,1672624016,1672626000,1984
10506,3756536476,3516651799,1672693815,1672695746,1931
11559,3909067335,3334488428,1672555405,1672555826,421
10484,3224824355,3473520701,1672618696,1672619734,1038
10106,3512504247,3513624915,1672614670,1672615024,354
10250,3850108828,3333477908,1672576698,1672578535,1837
10236,3487779363,3783043770,1672628811,1672630990,2179
10602,3520339198,3408111327,1672590846,1672592647,1801
10882,3355903597,3886957097,1672624937,1672625945,1008
10742,3236206821,3919814073,1672663649,1672665942,2293
11677,3520273299,3229890340,1672592406,1672592828,422
11660,3515100211,3423346297,1672672537,1672675862,3325
11342,3855977674,3360949039,1672691196,1672691570,374
11200,3777290300,3534122907,1672665192,1672667551,2359
10000,3505482210,3829412384,1672548573,1672549060,487
10180,3351153781,3773852157,1672617653,1672618483,830
10329,3777118499,3519780867,1672703843,1672706863,3020
9961,3308965136,3881579907,1672683931,1672684879,948
11509,3701519251,3710008760,1672580985,1672582319,1334
11606,3703277359,3894328297,1672639692,1672640560,868
9962,3755075988,3897851509,1672568359,1672570882,2523
11364,3756668747,3493515706,1672625364,1672627938,2574
10741,3468343480,3534168768,1672534252,1672535502,1250
11233,3409514897,3791716170,1672675668,1672677417,1749
11218,3780287649,3703048107,1672547734,1672550657,2923
10084,3480185839,3688768189,1672651146,1672651230,84
11103,3244098077,3517627003,1672630234,1672631999,1765
10976,3406132280,3755286041,1672668171,1672669287,1116
10746,3938409715,3701685828,1672553617,1672556862,3245
11013,3887069914,3333355914,1672596513,1672599530,3017
10632,3518931700,3715700639,1672604383,1672604628,245
9837,3461741050,3514747345,1672669191,1672670970,1779
10719,3630802959,3773083407,1672532529,1672535792,3263
9992,3731905251,3235578852,1672585889,1672587596,1707
11456,3732440502,3430823498,1672544705,1672547720,3015
9894,3332124606,3711852131,1672618604,1672620418,1814
10530,3505839395,3304235700,1672616488,1672617120,632
10808,3455430943,3839417558,1672695636,1672696852,1216
9954,3459951739,3812516461,1672596833,1672600103,3270
11507,3505826673,3801501384,1672640204,1672641235,1031
10504,3854390432,3851810349,1672619862,1672621383,1521
11079,3703031637,3791644831,1672674878,1672676056,1178
11736,3500579482,3406492167,1672567666,1672570883,3217
10086,3512492332,3755570137,1672600672,1672601662,990
11593,3703351452,3668855144,1672640745,1672643686,2941
10853,3760069457,3666958814,1672536076,1672538079,2003
10619,3770023722,3703896751,1672592280,1672595244,2964
10351,3423346297,3558264627,1672681452,1672682038,586
9916,3440991826,3311463998,1672570270,1672572958,2688
10024,3291446384,3239401337,1672699743,1672700322,579
9848,3909632424,3772683155,1672568485,1672569028,543
10703,3807717766,3519055736,1672648129,1672648654,525
11224,3443521234,3776950532,1672566521,1672567302,781
11247,3716095450,3534190196,1672555926,1672559136,3210
11003,3505825767,3517144269,1672639198,1672641969,2771
11190,3447078933,3510638085,1672653810,1672655065,1255
10086,3835509670,3501734800,1672586775,1672589925,3150
10842,3627081426,3755203055,1672574352,1672575282,930
11707,3512371853,3791332061,1672643028,1672645049,2021
11445,3519322066,3735197034,1672548182,1672551025,2843
11061,3345896913,3885147558,1672615694,1672617813,2119
10476,3669918958,3827836825,1672661486,1672663476,1990
10532,3558203963,3518117078,1672662184,1672662689,505
10138,3756363182,3777569538,1672571377,1672573380,2003
10849,3821087562,3774273260,1672643562,1672645020,1458
10109,3339331632,3236948071,1672563315,1672565380,2065
11064,3857244486,3880000841,1672611191,1672612871,1680
10501,3273537848,3354877289,1672663725,1672665674,1949
10739,3533037906,3714250543,1672544737,1672548281,3544
11607,3449233346,3779609338,1672595260,1672595769,509
11394,3509562377,3774706478,1672539501,1672540270,769
10945,3626631210,3359012188,1672670253,1672670869,616
9865,3667072319,3471177177,1672612544,1672613875,1331
10384,3406169279,3286938590,1672617841,1672620801,2960
10046,3278805844,3519055736,1672598841,1672601827,2986
11323,3516706935,3636885498,1672596311,1672596782,471
10320,3520016705,3600171014,1672663310,1672665063,1753
11282,3403120725,3416079461,1672592835,1672594483,1648
11347,3500049870,3498857406,1672537761,1672540050,2289
11427,3510240661,3505482210,1672692405,1672695017,2612
10218,3755203055,3500415589,1672656903,1672658778,1875
11239,3515715968,3710585241,1672663003,1672663915,912
9809,3220976338,3491335890,1672636374,1672639380,3006
10216,3804840997,3505010941,1672614770,1672617254,2484
10739,3780298499,3757924067,1672556028,1672559170,3142
10737,3505097206,3735838864,1672600642,1672603978,3336
11434,3277634944,3618024815,1672563212,1672564812,1600
11158,3500695402,3235578121,1672685126,1672686161,1035
10419,3817076003,3278071998,1672559275,1672559382,107
10906,3892487982,3778479297,1672649149,1672652083,2934
11478,3534984243,3513764665,1672677018,1672679483,2465
11641,3350966326,3202787155,1672531240,1672534689,3449
10957,3686644062,3510638085,1672599342,1672599899,557
11592,3617771673,3228465044,1672697073,1672697526,453
11516,3825932442,3416079461,1672685336,1672685729,393
9819,3666958814,3776053981,1672701668,1672702192,524
10894,3407734098,3399726243,1672700313,1672701921,1608
11439,3510373076,3222364320,1672665160,1672667504,2344
10276,3668720465,3397527886,1672576488,1672578182,1694
10349,3971051020,3701675183,1672566961,1672569002,2041
11601,3228056289,3736987749,1672687343,1672687892,549
9880,3756066765,3772751765,1672614239,1672616353,2114
11597,3710185376,3356972733,1672662510,1672663528,1018
11393,3667814788,3286862903,1672587550,1672588790,1240
11198,3349319959,3468281011,1672689663,1672693155,3492
10646,3756761603,3505804611,1672686444,1672687762,1318
11588,3773895671,3515528947,1672641672,1672643744,2072
10114,3505980138,3299052917,1672572043,1672574729,2686
10710,3619676231,3442181067,1672590820,1672592673,1853
10414,3774682234,3625952981,1672615458,1672615736,278
10392,3501427691,3337715675,1672573759,1672577176,3417
9943,3814672661,3830254808,1672649631,1672650112,481
11341,3201957157,3454151554,1672641467,1672642562,1095
9986,3402774497,3918126468,1672680494,1672680569,75
9831,3899903158,3505836431,1672620676,1672622261,1585
10958,3710515351,3701350519,1672689728,1672692164,2436
10401,3615245840,3395082458,1672649448,1672651278,1830
11298,3780900318,3713858538,1672581377,1672582668,1291
11305,3275057862,3760080378,1672681469,1672684948,3479
10510,3209417223,3770023722,1672536216,1672538165,1949
11788,3500421940,3372236721,1672536620,1672539512,2892
11204,3468201976,3898595916,1672653787,1672654409,622
10663,3772962072,3755823805,1672609478,1672609972,494
11235,3518157683,3735152111,1672648664,1672650347,1683
11501,3377883705,3229621693,1672657006,1672658104,1098
11237,3370751461,3660257653,1672625860,1672627969,2109
10184,3770981604,3533030343,1672544401,1672547520,3119
10181,3793949077,3604569804,1672586268,1672588865,2597
10757,3780213684,3778909412,1672592759,1672595364,2605
10476,3701284535,3505684690,1672579791,1672581083,1292
10937,3509317776,3207586072,1672633687,1672636436,2749
10732,3715587520,3516026189,1672559007,1672562500,3493
10536,3755790149,3500734346,1672665822,1672669112,3290
11737,3471507117,3533822490,1672668540,1672671860,3320
10175,3429587594,3773848111,1672649152,1672651981,2829
10348,3851810349,3662495290,1672558535,1672562022,3487
10929,3311805161,3779169946,1672539115,1672539720,605
11304,3837887478,3818570577,1672613291,1672616571,3280
10783,3241593146,3505032644,1672637611,1672639553,1942
9907,3783043770,3902357342,1672545149,1672545981,832
10458,3791434207,3905571273,1672680748,1672682818,2070
10685,3515096959,3242082716,1672542016,1672544472,2456
11666,3461743188,3509379617,1672620813,1672622176,1363
10468,3929355087,3917467642,1672617421,1672619248,1827
11150,3899205452,3302348002,1672656516,1672659554,3038
10569,3716982179,3777729184,1672662831,1672663004,173
10800,3854390432,3710149975,1672663951,1672665260,1309
10953,3400025324,3628556590,1672603558,1672606096,2538
11046,3418997135,3780466967,1672692449,1672693718,1269
10038,3557129226,3770172119,1672546704,1672550003,3299
10921,3780129338,3518931700,1672608786,1672610928,2142
9993,3370512945,3777135415,1672563666,1672565420,1754
10896,3711349327,3313101243,1672617873,1672619226,1353
11451,3756784813,3390444181,1672546933,1672549442,2509
10034,3519465545,3760397450,1672595956,1672596481,525
10449,3886896755,3755342153,1672553180,1672556451,3271
10784,3774682234,3773083407,1672636047,1672637824,1777
10197,3755849241,3476958001,1672615533,1672618764,3231
10257,3442462115,3515706117,1672692511,1672695486,2975
11263,3970851830,3319529422,1672571932,1672572173,241
10735,3511794841,3248409083,1672604953,1672606726,1773
10534,3311805161,3459799131,1672561963,1672564930,2967
11069,3815184540,3792972270,1672692933,1672693942,1009
10024,3791758175,3273674596,1672625599,1672628557,2958
11169,3715261950,3925175853,1672609933,1672612765,2832
10670,3287760230,3780213684,1672576015,1672578562,2547
11253,3680832669,3885147558,1672641562,1672644940,3378
11468,3515681585,3925208102,1672591042,1672592696,1654
10935,3922301238,3439036305,1672693399,1672695273,1874
10595,3513624915,3394976623,1672559048,1672560825,1777
10102,3226761201,3815184540,1672620503,1672622253,1750
10610,3716526314,3409078869,1672652413,1672654231,1818
10819,3388774559,3896200048,1672695935,1672696109,174
11118,3519848902,3776187150,1672618499,1672621312,2813
9955,3513203127,3711599043,1672543535,1672545145,1610
10875,3756668747,3519341916,1672536836,1672539944,3108
11380,3533593766,3351837521,1672539569,1672540005,436
10370,3511296895,3509663119,1672649553,1672652298,2745
10235,3465107990,3349573092,1672634797,1672638011,3214
11380,3773899531,3830771832,1672592318,1672594401,2083
10106,3517469005,3366164642,1672564353,1672567818,3465
10862,3756536512,3442073613,1672629539,1672629973,434
11231,3757678397,3505032644,1672582545,1672583076,531
10528,3481019442,3813085701,1672701070,1672704659,3589
9797,3209417223,3822315407,1672644196,1672644796,600
9812,3773017746,3757592622,1672677357,1672678037,680
10262,3473562779,3204149913,1672618301,1672620596,2295
10652,3777263928,3778695017,1672584610,1672587490,2880
10406,3390537737,3713923960,1672599424,1672602245,2821
10527,3246296769,3509370633,1672621389,1672622809,1420
11411,3318056480,3387322545,1672551884,1672553156,1272
10533,3514747345,3668063289,1672661287,1672663409,2122
11791,3436774112,3701540249,1672561429,1672564299,2870
10398,3911431642,3499142934,1672555556,1672555962,406
10197,3703694139,3714065165,1672678245,1672679550,1305
10375,3509274030,3281148858,1672589975,1672591023,1048
10568,3239990061,3711349327,1672663763,1672666262,2499
10576,3622458047,3330238204,1672582055,1672583694,1639
10045,3625952981,3810949170,1672646676,1672649514,2838
10432,3714471069,3884862164,1672606089,1672608425,2336
11608,3201634072,3606804618,1672602678,1672603671,993
11739,3417431173,3500079479,1672647965,1672650283,2318
10432,3710296607,3936871734,1672629477,1672629747,270
11700,3776455762,3711856534,1672613624,1672615239,1615
11247,3835599049,3350966326,1672597993,1672600338,2345
10433,3288791629,3512417724,1672688952,1672691951,2999
10394,3206926634,3515804844,1672534701,1672536177,1476
11399,3774450494,3444168914,1672675480,1672676722,1242
10786,3338187803,3559759778,1672567224,1672568953,1729
10730,3459951739,3776968640,1672623453,1672625808,2355
10783,3515304526,3505804611,1672650884,1672651387,503
11444,3233712975,3779212271,1672542806,1672544305,1499
10158,3228465044,3910020031,1672669041,1672669983,942
10196,3977880564,3520344592,1672700039,1672700432,393
11701,3361926328,3201920708,1672652942,1672656117,3175
10982,3453538201,3517380144,1672673110,1672673693,583
11521,3399726243,3473520701,1672608745,1672611459,2714
10706,3773768643,3533822490,1672568422,1672571895,3473
10833,3972442654,3361865467,1672589318,1672592190,2872
10916,3924583142,3821082558,1672536838,1672538035,1197
11455,3509996827,3772845364,1672564479,1672567912,3433
10899,3519841427,3515804844,1672625398,1672628843,3445
11419,3830771832,3437703650,1672658127,1672658828,701
11506,3919258737,3783172505,1672582751,1672585277,2526
9817,3343616490,3353326305,1672594529,1672594814,285
11169,3517358336,3716733618,1672600463,1672603292,2829
10433,3777686966,3516454693,1672591336,1672593366,2030
10505,3477248170,3776193847,1672584261,1672585514,1253
11128,3757678397,3200785194,1672612120,1672613192,1072
10268,3299587876,3452982957,1672672595,1672675151,2556
10289,3908862092,3711947828,1672570862,1672574301,3439
9889,3293157673,3777552831,1672640708,1672643432,2724
10847,3777758203,3711765138,1672567439,1672569846,2407
11740,3305657559,3396472026,1672533356,1672536403,3047
10961,3792008302,3517331746,1672630091,1672630640,549
10517,3822786416,3363549860,1672677976,1672678988,1012
9845,3931495845,3516517348,1672547118,1672550062,2944
11538,3777686966,3792455305,1672667992,1672671093,3101
10319,3778932673,3427049290,1672618233,1672621723,3490
9798,3755670258,3362385373,1672556892,1672557722,830
10424,3397972945,3902023467,1672618269,1672620680,2411
11735,3478206139,3515974881,1672695756,1672699340,3584
11170,3792063616,3364302157,1672659546,1672660665,1119
11605,3208962614,3623512088,1672658356,1672659839,1483
11467,3791628263,3710622746,1672584839,1672584901,62
10362,3887382548,3665478011,1672656040,1672656406,366
11306,3509370016,3711947828,1672661020,1672662324,1304
10975,3774251051,3486509752,1672615911,1672617744,1833
11602,3510968599,3627081426,1672620409,1672621012,603
11225,3772055279,3478937459,1672665130,1672668673,3543
11783,3319645922,3311569360,1672595720,1672597158,1438
9839,3515548696,3625779003,1672680352,1672682012,1660
11132,3279726491,3534491112,1672550684,1672552648,1964
10253,3505037247,3802625412,1672592148,1672592292,144
11233,3772802020,3495637721,1672659449,1672659586,137
10493,3714471069,3505175620,1672630390,1672631383,993
10601,3900540310,3773768643,1672543723,1672543995,272
11311,3856316719,3361711720,1672559977,1672563303,3326
10607,3666561358,3715126587,1672556639,1672557449,810
11411,3413511621,3427741923,1672592266,1672595073,2807
10881,3385006834,3779604279,1672580350,1672580543,193
11177,3516651799,3441683673,1672674560,1672677480,2920
9948,3285515107,3774663639,1672686607,1672689984,3377
10569,3772659062,3513186578,1672670205,1672673060,2855
10179,3514216460,3713191326,1672618279,1672621837,3558
10800,3774539067,3617771673,1672563319,1672565491,2172
11666,3792075871,3738873928,1672674085,1672675093,1008
11286,3827889533,3919994216,1672674149,1672674764,615
10360,3713285095,3791644831,1672644937,1672648107,3170
11478,3773697080,3917243005,1672571049,1672571122,73
10553,3887502536,3450735824,1672535335,1672537525,2190
11582,3476308535,3380185102,1672544921,1672546085,1164
11139,3505786561,3500799617,1672554015,1672557567,3552
11735,3509544691,3916656185,1672676156,1672678363,2207
10997,3519102732,3550405857,1672570253,1672572268,2015
9889,3301369282,3443191792,1672668631,1672669036,405
10972,3310702648,3715566511,1672546893,1672547011,118
9951,3716982179,3737745988,1672589192,1672591487,2295
10547,3534168768,3505032644,1672630702,1672633948,3246
10342,3478937459,3332124606,1672682515,1672684741,2226
10277,3423147369,3638071975,1672659824,1672662725,2901
10879,3395615598,3533154906,1672618802,1672621217,2415
9922,3898592058,3701893620,1672580289,1672582033,1744
10622,3500726347,3518478484,1672691257,1672694043,2786
10608,3701675183,3509508477,1672657597,1672659570,1973
10516,3701493094,3755175497,1672586916,1672589738,2822
9835,3512819376,3500720752,1672548314,1672550401,2087
10583,3684199077,3519948471,1672569262,1672572749,3487
10005,3714377201,3459951739,1672556784,1672559293,2509
10042,3515558215,3430032005,1672586263,1672587109,846
11537,3519034304,3432050858,1672611941,1672615140,3199
11353,3513508737,3224053074,1672675007,1672677334,2327
10238,3701893620,3639081201,1672691008,1672691546,538
11031,3505720915,3505248368,1672620258,1672621600,1342
10252,3776561263,3505449070,1672632340,1672633880,1540
11747,3342368576,3518511124,1672570828,1672571692,864
11272,3501225887,3733836732,1672537005,1672539222,2217
10416,3501600785,3925175853,1672570600,1672570693,93
11705,3760024021,3778318250,1672591399,1672593145,1746
11372,3632189887,3817376705,1672620182,1672622100,1918
11504,3422548081,3714897456,1672652942,1672655891,2949
11169,3387870683,3474879231,1672535504,1672537318,1814
11050,3791106473,3515637968,1672568331,1672571295,2964
11130,3501980730,3477582923,1672584392,1672587895,3503
9889,3493679801,3231153513,1672664844,1672664963,119
11752,3501843187,3290797257,1672677768,1672680625,2857
11719,3446537819,3340897079,1672597635,1672598858,1223
11249,3469350379,3311159418,1672576293,1672576991,698
9913,3400545490,3735197034,1672693065,1672695475,2410
11323,3224053074,3359012188,1672663583,1672663802,219
10575,3358385652,3271389160,1672658533,1672659163,630
11759,3227206772,3777751979,1672549038,1672550704,1666
11741,3669497617,3701512498,1672597442,1672598666,1224
10540,3519848902,3517766135,1672577010,1672578058,1048
10327,3715282492,3701374160,1672653123,1672653947,824
10109,3505593034,3850735936,1672681674,1672683112,1438
11266,3519065870,3396453219,1672616875,1672620129,3254
11668,3934280144,3369938668,1672671479,1672672449,970
10870,3603740088,3513802404,1672614267,1672615954,1687
11531,3828906027,3512480125,1672653691,1672655041,1350
11693,3773697080,3379517265,1672640883,1672641790,907
11179,3792162098,3713102459,1672560460,1672561548,1088
9900,3791548838,3783695231,1672531584,1672533608,2024
11055,3311774510,3512965991,1672546660,1672547085,425
11252,3701284535,3410788026,1672648923,1672650840,1917
10446,3452982957,3783947742,1672591451,1672594000,2549
11156,3772962072,3437023385,1672628976,1672631952,2976
10965,3711179193,3831981073,1672643382,1672646261,2879
11316,3224053074,3605591994,1672630482,1672632857,2375
11021,3682086200,3244098077,1672591734,1672592398,664
10920,3353811455,3476958001,1672658204,1672660645,2441
11335,3732596503,3730459093,1672585780,1672586725,945
10039,3500429731,3395069149,1672631504,1672634716,3212
9897,3203954795,3760731595,1672602472,1672603289,817
10125,3204473480,3832902787,1672634905,1672638027,3122
10767,3716492409,3518088154,1672617658,1672619348,1690
11166,3513186578,3311774510,1672607244,1672607949,705
11346,3603167427,3241682278,1672546734,1672549380,2646
11543,3411626917,3465107990,1672657886,1672659757,1871
10831,3511908639,3973134902,1672564484,1672564778,294
10398,3888057649,3662354016,1672625287,1672627851,2564
9927,3714453773,3668369938,1672586041,1672586963,922
11203,3311410533,3668720465,1672639746,1672642499,2753
10479,3375324190,3760346746,1672531892,1672534127,2235
11668,3512726649,3926065090,1672588523,1672588931,408
10757,3701512498,3713434898,1672618718,1672620172,1454
9960,3476144563,3311529105,1672688068,1672691050,2982
11166,3511963020,3491104534,1672585856,1672586402,546
11341,3783095041,3533365834,1672641833,1672644525,2692
11043,3313795594,3774296721,1672549669,1672551299,1630
11249,3714065165,3770533588,1672575156,1672575400,244
11242,3450164574,3932955949,1672596485,1672597465,980
11617,3515378306,3514576083,1672695058,1672696036,978
9886,3509663119,3505653701,1672548404,1672549305,901
10295,3500211484,3909220912,1672575323,1672578798,3475
11131,3287403291,3979366845,1672590591,1672590764,173
10472,3500909455,3793996996,1672581440,1672581759,319
10101,3511969443,3931767736,1672656535,1672660016,3481
11477,3492728794,3836136159,1672604434,1672607280,2846
11231,3505665788,3605760561,1672584187,1672587723,3536
10691,3613216900,3715419141,1672553510,1672556100,2590
9918,3713611960,3735056027,1672635468,1672637345,1877
10252,3446764595,3243056734,1672670625,1672672603,1978
10063,3238310644,3938409715,1672696659,1672698156,1497
9950,3500928990,3714281210,1672586854,1672587681,827
11268,3770019143,3510939082,1672578574,1672579843,1269
11541,3533777032,3891586951,1672653333,1672655225,1892
11650,3977337501,3518882056,1672548106,1672548692,586
11316,3514585995,3776249160,1672559325,1672562662,3337
11223,3757497708,3783201950,1672598679,1672600440,1761
10541,3512965991,3716183063,1672557762,1672560450,2688
10037,3778479297,3247193800,1672553859,1672556288,2429
11267,3427049290,3200785194,1672666481,1672669821,3340
10271,3342545285,3513215373,1672535917,1672536189,272
10348,3366801723,3774663639,1672610269,1672613500,3231
11239,3221126799,3859191694,1672691598,1672692552,954
11430,3703588004,3500087325,1672698461,1672701363,2902
10176,3857389270,3441683673,1672628295,1672629636,1341
10341,3492728794,3452104161,1672688525,1672691723,3198
9983,3669140241,3425646356,1672679300,1672680875,1575
10035,3776593726,3312612693,1672560600,1672560692,92
10359,3713547793,3390438262,1672543914,1672544449,535
11202,3926065090,3793497672,1672641818,1672643234,1416
10960,3783430498,3519162582,1672673332,1672674853,1521
11538,3711945923,3933106901,1672594177,1672594911,734
9910,3637566026,3715700639,1672553768,1672556780,3012
11179,3453538201,3505449070,1672642812,1672644631,1819
11310,3774706478,3711287751,1672684209,1672685085,876
11238,3233712975,3755670258,1672608813,1672610465,1652
11564,3505011956,3774145748,1672531833,1672535357,3524
11476,3755286041,3791581138,1672630662,1672631263,601
11601,3776561263,3514013999,1672650271,1672653848,3577
9887,3341311972,3422460919,1672611409,1672612213,804
9864,3275735969,3835599049,1672702636,1672703481,845
9857,3609335008,3772882440,1672679903,1672681435,1532
11077,3937636109,3244395841,1672679522,1672682723,3201
10126,3773953689,3316821313,1672664195,1672666137,1942
9804,3807486812,3611832288,1672693305,1672693914,609
11046,3756685732,3632189887,1672541232,1672541721,489
11011,3345954031,3418382025,1672675879,1672678450,2571
10495,3374195945,3500234771,1672603067,1672603858,791
10989,3373135211,3793860209,1672602096,1672605074,2978
11675,3886957097,3515259326,1672684447,1672686436,1989
10164,3902357342,3449672240,1672546259,1672547956,1697
10599,3736941123,3297624618,1672534088,1672535964,1876
11302,3392573386,3278779955,1672604854,1672607806,2952
10634,3686211958,3511296895,1672603773,1672604346,573
10571,3780352400,3499622352,1672589437,1672591539,2102
11533,3505266343,3736036532,1672593881,1672597359,3478
11575,3287821258,3776455762,1672685966,1672686149,183
10151,3362706073,3939851140,1672595782,1672597546,1764
11722,3516965624,3731905251,1672675929,1672677689,1760
10597,3602401154,3388463477,1672534243,1672536953,2710
11050,3733423371,3772966919,1672548896,1672551336,2440
11580,3228477490,3450503086,1672547427,1672549473,2046
10048,3494560663,3512555384,1672537850,1672541407,3557
11106,3512700007,3505786561,1672660871,1672664439,3568
11176,3406132280,3361789225,1672624022,1672627384,3362
10483,3301449986,3714294005,1672633166,1672636171,3005
11674,3755230010,3520471156,1672542861,1672543824,963
11662,3500909455,3716492409,1672686772,1672689246,2474
11638,3884934977,3509544691,1672655125,1672656704,1579
11123,3294821709,3229890340,1672593762,1672594170,408
9851,3770457058,3501873139,1672594723,1672596813,2090
11073,3200372897,3780171640,1672547329,1672547482,153
11520,3833520635,3777439655,1672616437,1672618524,2087
10014,3534362749,3756876537,1672640823,1672641961,1138
10659,3793497672,3773408491,1672564155,1672566208,2053
10958,3833520635,3703896751,1672677833,1672678168,335
10355,3337903727,3715261950,1672590746,1672593749,3003
9927,3776183353,3774273260,1672664207,1672667033,2826
11095,3501550490,3660980656,1672535752,1672537030,1278
10119,3512072679,3498857406,1672678933,1672680095,1162
10454,3440305508,3284483177,1672581249,1672583771,2522
10085,3760382349,3638035545,1672701431,1672701553,122
10789,3783942518,3756695502,1672575043,1672577697,2654
9934,3736621212,3305612422,1672577935,1672579192,1257
10768,3399726243,3393909269,1672575975,1672579098,3123
11033,3359929534,3780048608,1672571147,1672573221,2074
11083,3885422379,3714658474,1672535046,1672535785,739
10107,3738873928,3716341323,1672661805,1672664073,2268
10638,3936851114,3804707712,1672552592,1672555578,2986
10566,3505908965,3352044245,1672640799,1672642102,1303
10351,3777263928,3516167000,1672651208,1672651472,264
11371,3907245259,3710008760,1672679633,1672681160,1527
11548,3229615214,3755849241,1672600762,1672603907,3145
11757,3246804115,3755374000,1672691172,1672694192,3020
10265,3393128259,3285515107,1672621340,1672623296,1956
10569,3780171640,3501253130,1672624539,1672628018,3479
11478,3406029706,3517816581,1672628929,1672631657,2728
11224,3711029952,3471177177,1672637235,1672639340,2105
10463,3505836431,3760679372,1672550221,1672553596,3375
10959,3619705594,3510919509,1672578124,1672578993,869
11769,3971422524,3632303304,1672699624,1672700155,531
10012,3432762943,3308149799,1672577488,1672580396,2908
10039,3419378107,3776291254,1672623601,1672623954,353
10403,3857847527,3713471446,1672561441,1672561652,211
10946,3616242727,3375905193,1672533604,1672536869,3265
11212,3756066702,3792075871,1672570086,1672570953,867
11225,3737571883,3637566026,1672572392,1672573929,1537
11411,3442462115,3500473064,1672601914,1672604005,2091
11510,3442564712,3756363182,1672540550,1672541496,946
11643,3891586951,3501574882,1672634994,1672638373,3379
11197,3890278838,3791974273,1672678721,1672682023,3302
11414,3516535558,3476308535,1672691358,1672692242,884
11495,3505248368,3469778316,1672571632,1672574448,2816
11783,3778817220,3713069234,1672565231,1672566433,1202
11236,3519951586,3701534043,1672568851,1672569759,908
9805,3290060215,3884388188,1672617721,1672619110,1389
10829,3278071998,3472173212,1672554524,1672557033,2509
11141,3772164469,3773408491,1672630459,1672632783,2324
10200,3534459983,3505032644,1672632550,1672635311,2761
9803,3907390925,3452802329,1672583061,1672585018,1957
11461,3701971784,3689386663,1672594711,1672596701,1990
10295,3345902033,3608973523,1672644389,1672647268,2879
11467,3635599307,3480418192,1672681452,1672684421,2969
11789,3710852576,3497904539,1672694634,1672697670,3036
10030,3703415246,3373851012,1672545709,1672547411,1702
11511,3311602936,3203909360,1672603273,1672604504,1231
10847,3614944981,3514033319,1672689475,1672691557,2082
10411,3518794921,3345954031,1672565123,1672566848,1725
11072,3774273260,3505173665,1672630390,1672630865,475
10462,3510368377,3773848111,1672628561,1672629515,954
10612,3358959807,3938129916,1672624439,1672624848,409
10383,3636015050,3687183789,1672580284,1672582389,2105
11481,3343511947,3520553959,1672550854,1672550944,90
9810,3333355914,3399504157,1672625361,1672627776,2415
10810,3495152069,3510240661,1672637582,1672640216,2634
10066,3203837944,3686885442,1672650410,1672651979,1569
10304,3710060386,3334708091,1672701246,1672704101,2855
11590,3897186782,3755075988,1672553038,1672556164,3126
11749,3288920399,3714268380,1672696488,1672698741,2253
9828,3534068874,3396453219,1672615557,1672616770,1213
10814,3627081426,3780626668,1672700444,1672700873,429
11227,3710008760,3912878303,1672631964,1672635551,3587
11745,3519831322,3850181934,1672701997,1672703069,1072
9795,3364067937,3201634072,1672547457,1672549192,1735
10768,3715126587,3715858201,1672621296,1672621602,306
10854,3391612879,3703476890,1672557472,1672559547,2075
11622,3520515739,3241567995,1672549101,1672551812,2711
11298,3791584994,3519351747,1672658399,1672660969,2570
10953,3687024828,3435037864,1672678031,1672681532,3501
10691,3420881591,3902300755,1672574320,1672577450,3130
10840,3373018943,3772425253,1672537918,1672539808,1890
11074,3916673751,3500221079,1672583012,1672586207,3195
10898,3231963246,3814378625,1672702160,1672705290,3130
10558,3604908372,3509252934,1672666185,1672667214,1029
10883,3623894390,3511580693,1672587107,1672587197,90
10864,3668720465,3715680249,1672652545,1672652820,275
10363,3533036499,3515984911,1672576388,1672577779,1391
10165,3711755596,3206853747,1672695903,1672697972,2069
11765,3520009158,3711862792,1672638476,1672639585,1109
11106,3514005973,3510795808,1672640227,1672642817,2590
10304,3716341323,3233993993,1672557092,1672559748,2656
10475,3489205994,3733730342,1672600446,1672603428,2982
11157,3793497672,3480405740,1672556177,1672556331,154
10215,3501976169,3757030923,1672651573,1672655017,3444
11021,3682266017,3311015817,1672671908,1672672479,571
9934,3605101443,3429047448,1672581075,1672581312,237
10781,3755769254,3272328752,1672564256,1672564695,439
11176,3793232021,3500209015,1672625102,1672628178,3076
11279,3703779674,3534531061,1672660877,1672662779,1902
11536,3310737478,3225554956,1672609776,1672612437,2661
10998,3501427691,3500864577,1672552174,1672552499,325
10740,3883640904,3505140123,1672615028,1672618542,3514
10326,3307535495,3370512945,1672581729,1672584081,2352
9992,3362127525,3534667712,1672637115,1672637455,340
10351,3512395783,3701311947,1672537479,1672538463,984
11030,3904485393,3793814153,1672646075,1672648148,2073
10560,3351837521,3710051427,1672648380,1672651480,3100
11522,3760096466,3791581138,1672532479,1672535036,2557
9918,3406492167,3813986705,1672636673,1672639888,3215
11015,3442181067,3278443807,1672571482,1672572514,1032
10122,3777063455,3430823498,1672665596,1672668767,3171
10287,3774946684,3517992521,1672550284,1672550582,298
11118,3510486220,3777715675,1672695026,1672697098,2072
10187,3509186338,3891586951,1672617497,1672619344,1847
10631,3793232021,3682086200,1672686307,1672688975,2668
10642,3453464785,3703415246,1672603608,1672604057,449
11256,3472901378,3777932225,1672665706,1672667199,1493
11357,3490953301,3501573548,1672542467,1672543504,1037
10999,3319645922,3716389356,1672542227,1672545382,3155
11563,3633860380,3703624327,1672618525,1672621205,2680
10435,3772844451,3533473206,1672537914,1672541403,3489
11169,3430399931,3444295435,1672591669,1672593981,2312
10498,3395082458,3443102414,1672557300,1672557390,90
11742,3501976169,3770480149,1672579701,1672580873,1172
11514,3883640904,3335139032,1672657827,1672659965,2138
10621,3927675706,3512802259,1672667351,1672669064,1713
11057,3917467642,3395505794,1672572224,1672572335,111
10066,3713514933,3977615973,1672703199,1672704790,1591
10237,3501835995,3773636983,1672671081,1672673974,2893
11366,3738103378,3505980138,1672586655,1672586929,274
11149,3417223898,3792708936,1672567794,1672570637,2843
10727,3791863922,3485521840,1672592007,1672595338,3331
11616,3770530739,3471131277,1672670840,1672673571,2731
10820,3900195680,3399504157,1672651119,1672652853,1734
10994,3899756737,3738103378,1672694105,1672694561,456
10515,3516572212,3915460293,1672588044,1672590663,2619
10527,3440743218,3500015630,1672628922,1672629723,801
9834,3513890046,3852275715,1672583887,1672586436,2549
11203,3414510793,3453164933,1672665814,1672668714,2900
10783,3689420679,3438204844,1672595724,1672596879,1155
10485,3772227820,3972847837,1672589542,1672592872,3330
10175,3513629502,3778702093,1672669452,1672670912,1460
11186,3311188620,3776583229,1672663860,1672667147,3287
10362,3445896667,3714923092,1672539894,1672540060,166
11628,3439283360,3487779363,1672689392,1672689759,367
11653,3222357355,3772556646,1672674092,1672677004,2912
11026,3287094447,3284374600,1672630242,1672632309,2067
11754,3415840750,3400903513,1672612756,1672613118,362
10618,3880788853,3200372897,1672585374,1672588697,3323
10719,3805616707,3283785820,1672607938,1672609354,1416
11575,3607288879,3793407883,1672655396,1672656402,1006
11584,3934980229,3880562532,1672668487,1672669940,1453
9927,3773714494,3510819040,1672691828,1672692602,774
9956,3425260097,3393543588,1672661736,1672664604,2868
10576,3512857020,3710585241,1672604212,1672604618,406
10515,3500889287,3423800775,1672532710,1672534153,1443
10120,3514352989,3520506192,1672574210,1672576520,2310
11399,3299052917,3620836520,1672574511,1672576222,1711
10923,3779689733,3774782065,1672698450,1672699331,881
11005,3734957248,3500455935,1672687666,1672690828,3162
11730,3354877289,3294949958,1672700478,1672703253,2775
10009,3755230010,3701596047,1672556741,1672559304,2563
10554,3783730769,3773899531,1672654798,1672654887,89
10540,3411626917,3518882056,1672650233,1672650688,455
11177,3711190257,3348343425,1672670743,1672674320,3577
10840,3517797610,3204821370,1672679424,1672680259,835
9988,3445172440,3516969689,1672594959,1672595622,663
11029,3619676231,3357074700,1672564642,1672567700,3058
10518,3412605548,3484490325,1672578926,1672581822,2896
11560,3462645981,3713141087,1672597912,1672599197,1285
11463,3517210356,3667950469,1672656552,1672660132,3580
9956,3468201976,3701493094,1672683353,1672685073,1720
10889,3812277991,3445406685,1672581331,1672584170,2839
11176,3890194669,3777149336,1672657896,1672659420,1524
11542,3510022922,3715126587,1672553199,1672555383,2184
10563,3447554599,3512480125,1672552970,1672556251,3281
10032,3500555856,3890638402,1672554938,1672555091,153
10892,3285515107,3770172119,1672605485,1672608344,2859
9967,3912811715,3273771395,1672546816,1672549500,2684
10472,3500909455,3739217535,1672671789,1672674316,2527
9926,3772223331,3492064037,1672562447,1672564852,2405
11631,3779415433,3783695231,1672684917,1672687745,2828
11493,3624164232,3358434853,1672622166,1672624196,2030
11656,3716423829,3757446082,1672615777,1672617078,1301
10920,3716179251,3760687922,1672573173,1672575116,1943
10733,3736056340,3884394685,1672555041,1672558148,3107
