cell_site,calling,called,startdate,enddate,duration
7738,3756601594,3475396323,1672672515,1672673371,856
7737,3489217083,3778780511,1672546624,1672548146,1522
7825,3792883665,3809916577,1672692509,1672692694,185
7890,3780974443,3760561634,1672689136,1672691720,2584
7711,3777929708,3333896808,1672636160,1672637411,1251
7962,3683766533,3511312803,1672683797,1672684619,822
7613,3319752091,3774125065,1672589218,1672590345,1127
7514,3404058699,3757602960,1672579204,1672581375,2171
7640,3480687894,3791594391,1672637061,1672639103,2042
7657,3683766533,3852391257,1672579855,1672581569,1714
7533,3518496488,3342131135,1672700369,1672701950,1581
7881,3409474775,3773598056,1672678976,1672680490,1514
7599,3701967560,3739106581,1672563099,1672566231,3132
7706,3852391257,3511271692,1672652127,1672654512,2385
7617,3505530961,3244173074,1672588266,1672588768,502
7701,3703871468,3793286136,1672572071,1672573951,1880
7519,3701995648,3736419952,1672584189,1672584349,160
7645,3311274543,3783509527,1672582604,1672583697,1093
7815,3664170666,3792789881,1672612574,1672612772,198
7840,3416265063,3518014404,1672648988,1672649972,984
7511,3791334389,3668005723,1672596729,1672597593,864
7933,3779976989,3415546117,1672657914,1672661453,3539
7818,3899204805,3234541252,1672694633,1672695594,961
7852,3899371911,3778305740,1672573936,1672575553,1617
7610,3533653428,3505599848,1672587096,1672590598,3502
7893,3311274543,3311603601,1672589401,1672590444,1043
7902,3517864478,3882291183,1672638465,1672638588,123
7778,3774556560,3511312803,1672650053,1672650777,724
7759,3533810360,3278365525,1672690274,1672693260,2986
7723,3926700506,3778266283,1672694667,1672695865,1198
7677,3235635976,3910454786,1672594241,1672596275,2034
7835,3512166013,3520888296,1672616879,1672617592,713
7805,3780503655,3534313900,1672672161,1672673924,1763
7970,3716168623,3383922351,1672580441,1672584041,3600
7746,3837094550,3859663348,1672607068,1672607966,898
7500,3276993580,3688418210,1672699865,1672700835,970
7905,3777983879,3820354437,1672702604,1672703495,891
7584,3777936328,3511841857,1672575896,1672576755,859
7628,3792768129,3972709319,1672550050,1672551210,1160
7733,3229665776,3882997884,1672545878,1672547505,1627
7689,3411618230,3510247121,1672636078,1672638456,2378
7676,3365830990,3716843669,1672631811,1672635403,3592
7554,3370636709,3471220483,1672545995,1672548187,2192
7775,3519803045,3826759140,1672561710,1672564124,2414
7846,3510857360,3666553782,1672628037,1672628186,149
7903,3852595551,3760492950,1672612356,1672615435,3079
7787,3201324715,3477375368,1672640128,1672642471,2343
7696,3533025282,3206254161,1672684562,1672685982,1420
7656,3520165601,3778108318,1672569098,1672572288,3190
7964,3917088658,3783196518,1672567203,1672569136,1933
7580,3778266283,3780609808,1672536602,1672539911,3309
7959,3606987130,3490191091,1672663957,1672665089,1132
7519,3338703270,3774298222,1672552309,1672555400,3091
7739,3779740455,3236102733,1672584380,1672586184,1804
7794,3711380716,3713808837,1672645813,1672649211,3398
7622,3380035798,3478194807,1672657568,1672658527,959
7550,3208844525,3970117174,1672557373,1672560597,3224
7592,3518791447,3304056063,1672567920,1672568479,559
7623,3813052709,3476232529,1672656516,1672657454,938
7731,3855602893,3918674986,1672630847,1672632389,1542
7758,3206603608,3519152550,1672697216,1672698752,1536
7774,3302626661,3778108318,1672584062,1672586189,2127
7488,3517476351,3883861463,1672545375,1672548389,3014
7906,3451432842,3378436155,1672626284,1672626792,508
7643,3516960534,3397418363,1672625550,1672625905,355
7911,3201848640,3500803339,1672571099,1672571751,652
7645,3736229191,3512969370,1672639766,1672640167,401
7966,3514245078,3501692334,1672612212,1672613017,805
7910,3311274543,3887270940,1672669102,1672669851,749
7895,3859663348,3932051427,1672684630,1672685807,1177
7541,3249247700,3809059934,1672616335,1672619912,3577
7916,3454042520,3755436115,1672598286,1672599200,914
7817,3783705817,3244389794,1672555367,1672557531,2164
7556,3756966035,3777079686,1672658933,1672662232,3299
7944,3901877072,3737079798,1672681933,1672684336,2403
7914,3835382117,3276993580,1672648174,1672650370,2196
7573,3760294205,3683959482,1672632071,1672635326,3255
7686,3496269445,3513454145,1672560392,1672563232,2840
7571,3737154119,3318697153,1672605763,1672607076,1313
7718,3483164654,3886298125,1672620242,1672622523,2281
7820,3839849341,3510969660,1672587680,1672588727,1047
7973,3291883916,3501364586,1672636552,1672638100,1548
7529,3515284591,3303751772,1672673221,1672675982,2761
7572,3519703355,3500499542,1672542710,1672543952,1242
7601,3613995936,3837094550,1672641403,1672643799,2396
7553,3812176780,3336742544,1672614251,1672614539,288
7653,3793848402,3858918246,1672567849,1672568240,391
7620,3622054816,3772359096,1672533600,1672536549,2949
7673,3242408357,3505904952,1672663590,1672664074,484
7931,3715974031,3774268456,1672625670,1672627431,1761
7942,3516011407,3509630174,1672612188,1672614953,2765
7576,3716746253,3291227780,1672641232,1672641631,399
7693,3701274634,3757447189,1672654119,1672655390,1271
7732,3516258476,3516514391,1672702886,1672703691,805
7674,3778980116,3383922351,1672625636,1672627915,2279
7561,3613995936,3246596716,1672579486,1672582949,3463
7494,3287105466,3732481297,1672625556,1672627405,1849
7607,3613995936,3772746272,1672572850,1672574733,1883
7913,3711370563,3373384732,1672531480,1672534983,3503
7490,3820354437,3914259449,1672638330,1672640716,2386
7943,3624761861,3829764737,1672586631,1672589365,2734
7681,3336751428,3284832486,1672638181,1672640031,1850
7889,3302626661,3685818092,1672584647,1672586542,1895
7843,3783206719,3556951786,1672693334,1672695306,1972
7931,3516606733,3505649239,1672666328,1672669482,3154
7931,3710408395,3975287541,1672672587,1672674485,1898
7722,3825229501,3276993580,1672544798,1672545137,339
7866,3518014404,3505859863,1672633853,1672637071,3218
7675,3512567240,3220716272,1672572087,1672573020,933
7486,3909238838,3701146057,1672551064,1672554289,3225
7561,3933210486,3833889105,1672536995,1672539620,2625
7638,3756462516,3903962771,1672699156,1672699843,687
7892,3387966152,3224716315,1672591456,1672594495,3039
7748,3229058858,3935127663,1672612521,1672616084,3563
7552,3755872268,3511350608,1672615054,1672618029,2975
7784,3859525941,3534492426,1672538160,1672538229,69
7544,3622054816,3827626797,1672628893,1672630257,1364
7483,3809059934,3388372715,1672609790,1672610219,429
7791,3534424200,3391261292,1672551202,1672552484,1282
7892,3394539273,3351554343,1672652459,1672655162,2703
7651,3976390453,3307097200,1672624990,1672625651,661
7819,3774119563,3778341199,1672689160,1672692215,3055
7691,3760077057,3512567240,1672671422,1672674804,3382
7860,3505477652,3776066388,1672676360,1672676860,500
7730,3427219654,3533025282,1672664301,1672666738,2437
7912,3312829208,3826633236,1672628014,1672630511,2497
7529,3378436155,3880310724,1672612663,1672614785,2122
7932,3511271692,3783779671,1672630552,1672634069,3517
7651,3505649239,3610348516,1672691707,1672693549,1842
7899,3388637594,3756528686,1672692844,1672694550,1706
7633,3931941795,3887270940,1672607533,1672611011,3478
7673,3249401741,3777514571,1672611853,1672612496,643
7763,3774501422,3501184421,1672596650,1672598328,1678
7894,3774066725,3514283243,1672573390,1672574967,1577
7700,3505145247,3903962771,1672703825,1672707095,3270
7506,3773429448,3976633198,1672683313,1672686365,3052
7512,3604539807,3883085535,1672664115,1672665750,1635
7621,3221899927,3880285638,1672701377,1672703991,2614
7612,3510703546,3633420270,1672682317,1672683813,1496
7792,3772578994,3883085535,1672601074,1672603201,2127
7552,3779629905,3783206719,1672641615,1672642382,767
7728,3772053179,3533827120,1672625483,1672628280,2797
7785,3206603608,3312333615,1672578771,1672579365,594
7963,3336742544,3714197325,1672672155,1672675665,3510
7719,3828432634,3711262377,1672692304,1672693059,755
7887,3914290246,3855424474,1672642460,1672643356,896
7932,3518791447,3236102733,1672552766,1672553397,631
7695,3467773920,3311152102,1672637905,1672638636,731
7522,3501955238,3622054816,1672665975,1672666910,935
7692,3388637594,3826760240,1672688121,1672690348,2227
7850,3247815299,3510711755,1672650300,1672653897,3597
7621,3296471982,3777477395,1672612000,1672612349,349
7837,3972709319,3418534998,1672595427,1672598099,2672
7517,3513454145,3434642576,1672546909,1672550091,3182
7584,3883861463,3242408357,1672595574,1672598364,2790
7687,3972709319,3500803339,1672587708,1672590348,2640
7606,3511271692,3736229191,1672651494,1672653467,1973
7625,3277605882,3774050956,1672556411,1672559701,3290
7658,3399004969,3701274634,1672532250,1672534186,1936
7698,3505000737,3791334389,1672641094,1672642365,1271
7624,3533193862,3520730271,1672642188,1672644771,2583
7508,3518014404,3780609808,1672586673,1672588242,1569
7806,3776800213,3313541986,1672578947,1672582061,3114
7706,3730517636,3760561634,1672604137,1672604320,183
7808,3711380716,3285400528,1672557209,1672559554,2345
7849,3222521619,3510711755,1672632999,1672634300,1301
7853,3206254161,3791957752,1672655695,1672656164,469
7537,3713644518,3780828689,1672628005,1672630441,2436
7920,3496051529,3933210486,1672593681,1672595877,2196
7558,3202120784,3432689543,1672590974,1672593072,2098
7893,3891751546,3756930948,1672547580,1672549534,1954
7713,3817316561,3534424200,1672665895,1672666665,770
7752,3791602225,3637008488,1672571460,1672573042,1582
7557,3662180254,3792789881,1672551196,1672554707,3511
7678,3287105466,3516960534,1672671418,1672672083,665
7917,3520719611,3780609808,1672658268,1672658584,316
7789,3390068992,3512720680,1672602362,1672605690,3328
7651,3534702203,3688683847,1672597223,1672597451,228
7521,3311648200,3714488548,1672670490,1672671648,1158
7978,3772359096,3342131135,1672580767,1672582060,1293
7688,3777717988,3777079686,1672619101,1672620597,1496
7887,3976633198,3811694763,1672614557,1672614856,299
7612,3500229033,3774045700,1672594043,1672597059,3016
7547,3755798867,3488244966,1672656618,1672658459,1841
7663,3466229085,3288764520,1672645787,1672646289,502
7649,3780788622,3899266183,1672608506,1672609136,630
7730,3855424474,3626156564,1672668367,1672670142,1775
7511,3475258557,3755881905,1672661495,1672661905,410
7955,3711198793,3511862351,1672701739,1672704660,2921
7951,3909606423,3516716179,1672604558,1672605871,1313
7874,3559110998,3701178711,1672675502,1672676138,636
7962,3517509185,3428964059,1672659166,1672660803,1637
7865,3715998609,3792844210,1672650237,1672653023,2786
7608,3716746253,3344364444,1672564116,1672566053,1937
7531,3294803686,3736786443,1672645778,1672646498,720
7529,3881477378,3828624701,1672643415,1672645660,2245
7526,3618873142,3518014404,1672666884,1672668051,1167
7893,3757151210,3318166135,1672622589,1672624650,2061
7850,3827377568,3407725581,1672599640,1672600413,773
7784,3832902928,3348261553,1672551884,1672553714,1830
7902,3510380060,3533810360,1672657485,1672659945,2460
7925,3910454786,3909331423,1672677375,1672680670,3295
7830,3777936328,3510703546,1672626553,1672627723,1170
7640,3756424865,3489545239,1672604031,1672605740,1709
7885,3778341199,3337544549,1672538984,1672541560,2576
7690,3234541252,3714962248,1672596730,1672599153,2423
7739,3432689543,3939952128,1672652594,1672654378,1784
7821,3770763956,3493507965,1672619908,1672623268,3360
7536,3391261292,3505530961,1672568859,1672570061,1202
7869,3501692334,3736786443,1672559243,1672561643,2400
7736,3772746272,3930791338,1672612080,1672613504,1424
7738,3778305740,3736790081,1672659083,1672659748,665
7967,3392121505,3780503655,1672696738,1672697652,914
7615,3534424200,3600647945,1672619193,1672620145,952
7795,3911245524,3510173870,1672658365,1672659694,1329
7792,3859663348,3221899927,1672658669,1672661580,2911
7785,3533242305,3200691026,1672671558,1672674236,2678
7642,3477649378,3516629436,1672669977,1672670546,569
7709,3829764737,3793086311,1672672815,1672673393,578
7633,3779629905,3359910781,1672643010,1672646476,3466
7651,3714488548,3505193212,1672554698,1672554862,164
7948,3772884106,3773205565,1672668749,1672671088,2339
7502,3512837326,3716273414,1672618021,1672620151,2130
7915,3384240055,3246596716,1672578618,1672581960,3342
7815,3779629905,3779629905,1672544424,1672544760,336
7884,3685818092,3534488837,1672684345,1672685429,1084
7504,3780503655,3247428249,1672668445,1672668886,441
7971,3701498253,3249247700,1672675453,1672678342,2889
7670,3930797455,3483949762,1672629050,1672629283,233
7956,3666507626,3685187183,1672537523,1672538734,1211
7501,3793389510,3510703546,1672596199,1672599628,3429
7508,3855000166,3614238812,1672615723,1672615975,252
7809,3518791447,3383661227,1672620111,1672620991,880
7950,3315583351,3791115967,1672557827,1672559389,1562
7743,3235635976,3519601612,1672687056,1672687781,725
7598,3511312803,3773814927,1672547236,1672550259,3023
7842,3701967560,3465202715,1672574222,1672577262,3040
7776,3805347939,3611150562,1672631639,1672633042,1403
7817,3331845324,3711265369,1672571145,1672574108,2963
7954,3420432297,3715127362,1672666362,1672666957,595
7850,3930797455,3311648200,1672597436,1672599117,1681
7636,3478194807,3639847263,1672537297,1672540706,3409
7842,3780828689,3370752401,1672659384,1672659956,572
7770,3793436995,3365614305,1672699808,1672701961,2153
7949,3249401741,3397418363,1672639956,1672642791,2835
7983,3501955238,3774066725,1672574006,1672575973,1967
7632,3755881905,3770078063,1672541906,1672544468,2562
7757,3791594391,3415443558,1672548915,1672551581,2666
7821,3805292782,3514987389,1672659653,1672660883,1230
7929,3774125065,3757246925,1672609154,1672609359,205
7702,3778305740,3488244966,1672663819,1672665617,1798
7583,3857349323,3778305740,1672634438,1672636205,1767
7764,3792902982,3385763781,1672638033,1672639662,1629
7696,3811694763,3826760240,1672661475,1672663098,1623
7576,3496269445,3307512479,1672618910,1672621022,2112
7586,3774045700,3415546117,1672641269,1672644374,3105
7895,3910886626,3899371911,1672645735,1672646824,1089
7943,3792883665,3918674986,1672701038,1672703891,2853
7790,3359239884,3467773920,1672638758,1672642354,3596
7627,3505000737,3918674986,1672573966,1672576039,2073
7672,3407725581,3731106822,1672553215,1672556521,3306
7948,3518876135,3882997884,1672610734,1672613589,2855
7556,3484995752,3792473331,1672603108,1672603559,451
7906,3318697153,3516514391,1672663792,1672665651,1859
7529,3773664987,3776948966,1672586981,1672588735,1754
7484,3384240055,3880285638,1672701449,1672702160,711
7891,3731106822,3613683164,1672630918,1672631191,273
7530,3406784491,3202120784,1672632516,1672635466,2950
7756,3314836094,3515860749,1672537328,1672537828,500
7773,3514472925,3757246925,1672669610,1672672477,2867
7570,3701863557,3715189301,1672672226,1672672589,363
7599,3792844210,3482405588,1672634976,1672637874,2898
7952,3713808837,3883312122,1672556020,1672558562,2542
7855,3500894271,3206254161,1672595705,1672597132,1427
7798,3935127663,3555214688,1672635767,1672636592,825
7561,3473765852,3465254146,1672679407,1672679741,334
7960,3485375593,3397418363,1672550978,1672553505,2527
7664,3520376528,3791997875,1672606277,1672609441,3164
7775,3911159965,3554917400,1672669327,1672672130,2803
7722,3520165601,3701691675,1672650361,1672652845,2484
7844,3755436115,3902383721,1672609707,1672613163,3456
7554,3757246925,3221899927,1672649841,1672652309,2468
7610,3812176780,3779218771,1672677871,1672678102,231
7794,3298288268,3428674539,1672550335,1672553824,3489
7605,3202120784,3755798867,1672541208,1672543392,2184
7617,3837094550,3490191091,1672668630,1672670123,1493
7684,3757562897,3533242305,1672548554,1672549581,1027
7493,3756528686,3828365570,1672616244,1672616957,713
7537,3430352815,3979339287,1672552024,1672554159,2135
7670,3338367113,3520629279,1672535043,1672538032,2989
7590,3434642576,3510771358,1672684993,1672688361,3368
7904,3338367113,3311845971,1672609820,1672610446,626
7808,3772746272,3901877072,1672606509,1672607078,569
7634,3520931254,3757562897,1672658579,1672658868,289
7576,3249791738,3710344260,1672687811,1672689088,1277
7784,3618045231,3912536808,1672622256,1672622986,730
7510,3639847263,3973560347,1672623409,1672625739,2330
7812,3466911760,3777936328,1672689839,1672692357,2518
7767,3914259449,3773664987,1672661687,1672662054,367
7823,3424922204,3509672210,1672567763,1672568951,1188
7610,3711380716,3477375368,1672675388,1672678035,2647
7573,3481502100,3621810464,1672654705,1672655637,932
7627,3970117174,3793338102,1672588008,1672590735,2727
7611,3484995752,3307512479,1672553408,1672554881,1473
7757,3407954858,3774119563,1672556920,1672557311,391
7557,3756424865,3514472925,1672667290,1672667626,336
7530,3518360734,3713969578,1672538392,1672541123,2731
7658,3489217083,3512349371,1672572259,1672573437,1178
7713,3519069599,3209551760,1672626187,1672627269,1082
7626,3774010081,3510771358,1672690168,1672692145,1977
7618,3770101921,3501483568,1672698307,1672701611,3304
7639,3756424865,3534553510,1672565921,1672568873,2952
7943,3918674986,3520888296,1672559525,1672562698,3173
7848,3909331423,3475251781,1672542996,1672543080,84
7529,3777929708,3792768129,1672664180,1672667298,3118
7531,3793470489,3421127249,1672599897,1672602107,2210
7863,3773664987,3772714862,1672693773,1672696759,2986
7714,3920801189,3757562897,1672687978,1672688488,510
7703,3511687358,3760267716,1672560464,1672562087,1623
7748,3513164386,3777936328,1672616210,1672616796,586
7889,3496269445,3500487333,1672664475,1672666869,2394
7488,3772884106,3515284591,1672626599,1672627762,1163
7940,3510594211,3760294205,1672640945,1672642764,1819
7890,3392121505,3839849341,1672533000,1672535929,2929
7508,3859663348,3430074045,1672642114,1672642288,174
7697,3505912939,3778549126,1672569373,1672569548,175
7647,3701967560,3616944364,1672615413,1672616319,906
7634,3315583351,3777936328,1672576430,1672577618,1188
7770,3311761694,3229058858,1672696429,1672698415,1986
7542,3713268590,3311208440,1672651564,1672651680,116
7637,3513599775,3365614305,1672579526,1672579962,436
7490,3534313900,3829232696,1672569876,1672573249,3373
7703,3714962248,3703735129,1672585187,1672585358,171
7596,3399535232,3666506258,1672644452,1672644749,297
7686,3399004969,3248507722,1672637221,1672637711,490
7766,3731419510,3505530961,1672620539,1672623498,2959
7923,3209048907,3836573197,1672544342,1672546603,2261
7647,3344019610,3505962865,1672617862,1672618449,587
7586,3429856982,3801089989,1672699848,1672700513,665
7857,3793753089,3489728806,1672625466,1672627047,1581
7922,3229058858,3793338102,1672599393,1672601948,2555
7886,3533137446,3883312122,1672676443,1672676539,96
7880,3234362962,3484995752,1672627822,1672628278,456
7611,3774005526,3792789881,1672585262,1672587145,1883
7964,3359239884,3760492950,1672535070,1672538209,3139
7949,3716273414,3505135325,1672685352,1672685624,272
7620,3505599848,3280964728,1672538724,1672539245,521
7970,3755625324,3757161914,1672609791,1672611844,2053
7681,3793753089,3520730271,1672641013,1672643904,2891
7888,3770851318,3800353779,1672645067,1672645490,423
7948,3930797455,3311415018,1672577695,1672578342,647
7707,3302626661,3511350608,1672666994,1672667633,639
7845,3467773920,3338703270,1672648900,1672651862,2962
7929,3880285638,3777790718,1672574142,1672577532,3390
7542,3604539807,3490191091,1672555126,1672557588,2462
7821,3713969578,3220716272,1672538812,1672539493,681
7938,3533369198,3760561634,1672590968,1672592318,1350
7720,3304625412,3791957752,1672611948,1672613670,1722
7769,3617734118,3703871468,1672621986,1672624822,2836
7619,3756623396,3780365428,1672618442,1672621524,3082
7693,3480687894,3501759100,1672626874,1672628999,2125
7709,3770763956,3359239884,1672597057,1672597674,617
7939,3505530961,3816853177,1672578097,1672580507,2410
7489,3391915886,3805342762,1672563953,1672564893,940
7717,3711198793,3501483568,1672573166,1672575717,2551
7680,3500658339,3512540951,1672564392,1672566145,1753
7847,3356860407,3713786889,1672630376,1672631410,1034
7645,3409474775,3505859863,1672578042,1672580092,2050
7720,3511312803,3404384505,1672645381,1672646166,785
7570,3629547065,3915628728,1672667146,1672670370,3224
7948,3703441914,3388286531,1672671920,1672674256,2336
7935,3338367113,3774204963,1672662826,1672663201,375
7602,3915628728,3407725581,1672568034,1672568473,439
7714,3713370078,3909238838,1672701773,1672704956,3183
7685,3244485293,3809484172,1672607588,1672610990,3402
7544,3774050956,3783531004,1672608607,1672609351,744
7606,3772746272,3534729133,1672655510,1672658308,2798
7690,3736229191,3703871468,1672569040,1672570930,1890
7713,3313541986,3416241005,1672560981,1672562875,1894
7856,3501486692,3780609808,1672697760,1672700450,2690
7706,3774338212,3772884106,1672596095,1672596997,902
7812,3713349754,3714488548,1672615526,1672616574,1048
7490,3556951786,3512683609,1672664456,1672666683,2227
7746,3518014636,3249401741,1672544936,1672548398,3462
7558,3311718847,3930797455,1672583685,1672583895,210
7804,3510247121,3904408902,1672599186,1672599253,67
7938,3512166013,3772578994,1672685719,1672686350,631
7924,3828624701,3391915886,1672597360,1672598593,1233
7972,3912536808,3757151210,1672682755,1672684122,1367
7845,3703871468,3772359096,1672606774,1672608153,1379
7969,3400918687,3516909237,1672574511,1672576558,2047
7667,3813052709,3481647420,1672561814,1672565107,3293
7711,3703955926,3777079686,1672566317,1672568471,2154
7523,3388286531,3533385867,1672685115,1672687753,2638
7701,3416265063,3662180254,1672578577,1672580332,1755
7491,3518669703,3792177074,1672566550,1672569712,3162
7970,3610695419,3778308417,1672537804,1672538300,496
7837,3519601612,3711504540,1672623420,1672623884,464
7890,3978105277,3979339287,1672650129,1672653307,3178
7712,3513599775,3497901842,1672673627,1672675924,2297
7716,3519601612,3392121505,1672652164,1672654066,1902
7563,3793389510,3311627628,1672614703,1672615910,1207
7843,3829764737,3510771358,1672562624,1672564644,2020
7690,3517255726,3829319703,1672673310,1672673971,661
7659,3533653428,3244485293,1672644309,1672646708,2399
7686,3736592744,3770553384,1672639582,1672641341,1759
7810,3828432634,3208844525,1672661103,1672664284,3181
7621,3791997875,3451432842,1672622468,1672625874,3406
7977,3891751546,3715339701,1672621054,1672622407,1353
7667,3773120434,3416241005,1672593725,1672594872,1147
7891,3477375368,3757562897,1672613452,1672615050,1598
7658,3791553060,3711973519,1672697086,1672698608,1522
7856,3811171116,3500229033,1672547207,1672548136,929
7705,3409474775,3683959482,1672664003,1672664977,974
7548,3223968713,3713370078,1672619509,1672622785,3276
7652,3513454145,3855424474,1672620967,1672623877,2910
7960,3918674986,3827626797,1672538438,1672539219,781
7726,3511312803,3608868877,1672651377,1672652539,1162
7948,3755436115,3509672210,1672642914,1672645068,2154
7552,3224716315,3500499542,1672578382,1672578813,431
7649,3920801189,3711198793,1672572838,1672574663,1825
7921,3313541986,3307097200,1672630163,1672633683,3520
7708,3760569731,3500229033,1672617349,1672620218,2869
7851,3303751772,3520888296,1672678388,1672678559,171
7944,3485008994,3858918246,1672702619,1672705526,2907
7594,3466229085,3500994774,1672646618,1672647548,930
7860,3852391257,3505962865,1672539908,1672540119,211
7652,3510969660,3756623396,1672569774,1672569836,62
7668,3780639480,3922275416,1672594549,1672596030,1481
7689,3882242815,3811171116,1672605043,1672605154,111
7796,3496051529,3778780511,1672636111,1672637892,1781
7905,3791657947,3534492426,1672567564,1672567872,308
7663,3511198618,3703275621,1672551666,1672553304,1638
7705,3209383861,3898995675,1672584543,1672587134,2591
7724,3715492942,3505193212,1672555827,1672557424,1597
7739,3613995936,3755872268,1672583335,1672586352,3017
7888,3483949762,3284832486,1672610544,1672613168,2624
7496,3429856982,3736229191,1672657418,1672657674,256
7973,3520376528,3439023335,1672615388,1672616174,786
7653,3520206212,3277939457,1672646288,1672649795,3507
7587,3920801189,3834257412,1672636894,1672639592,2698
7832,3352603894,3633420270,1672630545,1672631543,998
7794,3770021824,3307097200,1672587995,1672589914,1919
7781,3550946908,3770824086,1672624404,1672626174,1770
7884,3772758337,3666506258,1672619077,1672622197,3120
7701,3466229085,3621810464,1672684443,1672685681,1238
7805,3337544549,3889232789,1672636627,1672639840,3213
7630,3777477395,3792384220,1672561053,1672561299,246
7714,3206593906,3772309150,1672609128,1672611492,2364
7745,3806545488,3559110998,1672597701,1672597976,275
7514,3453729665,3715974031,1672567625,1672568898,1273
7979,3639847263,3380035798,1672573822,1672574816,994
7603,3520751702,3853018906,1672703141,1672705866,2725
7786,3394330287,3809484172,1672625731,1672628303,2572
7509,3303705369,3483164654,1672563559,1672563640,81
7845,3780974443,3276993580,1672610834,1672610997,163
7912,3776513891,3388637594,1672685487,1672685806,319
7908,3533280269,3518932404,1672697277,1672697556,279
7679,3820354437,3519069599,1672586988,1672587182,194
7738,3312333615,3223789409,1672676546,1672679434,2888
7711,3247780536,3209027249,1672619024,1672622188,3164
7608,3311274543,3898995675,1672673906,1672676998,3092
7557,3520931254,3776066388,1672662959,1672664912,1953
7613,3685187183,3806545488,1672556306,1672559804,3498
7882,3783206719,3780914982,1672601417,1672604472,3055
7916,3307097200,3497901842,1672548268,1672550336,2068
7531,3760077057,3314245084,1672566802,1672568021,1219
7537,3855937514,3200691026,1672614661,1672614800,139
7900,3434642576,3312333615,1672695838,1672698987,3149
7553,3311761694,3734828619,1672668588,1672671273,2685
7813,3714821932,3501364586,1672629234,1672629944,710
7622,3711198793,3930791338,1672550892,1672552041,1149
7688,3882997884,3514245078,1672564123,1672566611,2488
7661,3488244966,3448855696,1672536973,1672540373,3400
7774,3715974031,3736790081,1672592324,1672594076,1752
7514,3406784491,3432689543,1672643072,1672644220,1148
7942,3780828689,3433804879,1672699743,1672702188,2445
7944,3909606423,3736592744,1672618633,1672620179,1546
7962,3533025282,3505193212,1672582599,1672583290,691
7674,3520012395,3229665776,1672596153,1672597860,1707
7742,3776066388,3512540951,1672698514,1672699513,999
7608,3853018906,3313564074,1672546393,1672548246,1853
7930,3399052055,3791602225,1672549509,1672550812,1303
7827,3703441914,3509634629,1672553066,1672556367,3301
7618,3278365525,3774005526,1672683712,1672684345,633
7579,3774366875,3634786711,1672700975,1672702066,1091
7961,3899371911,3757455053,1672534000,1672534953,953
7521,3409474775,3701065786,1672642296,1672645265,2969
7657,3780593036,3554917400,1672609914,1672611378,1464
7707,3505098372,3517476351,1672642142,1672645309,3167
7857,3703889596,3277939457,1672652565,1672653457,892
7772,3935627557,3755798867,1672627300,1672628461,1161
7655,3519700826,3703441914,1672696063,1672696440,377
7806,3608868877,3364543015,1672583498,1672586547,3049
7660,3249247700,3311274543,1672620140,1672620969,829
7503,3714197325,3817316561,1672587396,1672588545,1149
7906,3395152943,3621810464,1672538905,1672540786,1881
7790,3370752401,3394330287,1672585603,1672588326,2723
7865,3493507965,3925402713,1672650549,1672652318,1769
7760,3921211276,3611150562,1672564301,1672567110,2809
7934,3716835696,3517509185,1672547891,1672550216,2325
7911,3421836608,3336742544,1672630257,1672630781,524
7742,3783925755,3454042520,1672623974,1672626272,2298
7952,3412980697,3774338212,1672559587,1672561405,1818
7762,3774050956,3887270940,1672671526,1672672527,1001
7807,3483949762,3780788622,1672626011,1672627300,1289
7846,3880285638,3511267139,1672703630,1672703789,159
7648,3533270638,3386707783,1672693836,1672694604,768
7727,3244173074,3222448362,1672623661,1672626749,3088
7962,3606186086,3774556560,1672633712,1672635079,1367
7906,3344364444,3760077057,1672690292,1672692425,2133
7669,3902278226,3774119563,1672558220,1672561133,2913
7762,3316222192,3229058858,1672533935,1672534719,784
7672,3773950140,3778266283,1672600726,1672603203,2477
7920,3407673904,3509352754,1672541352,1672542044,692
7803,3779629905,3475251781,1672685043,1672685672,629
7580,3505912939,3829232696,1672643466,1672643788,322
7842,3701146057,3701534009,1672609682,1672611273,1591
7934,3778549126,3520751702,1672605989,1672606906,917
7947,3734737881,3311152102,1672614048,1672615751,1703
7778,3550946908,3500994774,1672637979,1672638894,915
7642,3793436995,3626156564,1672581008,1672583382,2374
7554,3806545488,3400918687,1672672666,1672675122,2456
7866,3513956646,3701178711,1672606107,1672607141,1034
7493,3533810360,3533371364,1672702826,1672705140,2314
7775,3975287541,3899204805,1672666326,1672668773,2447
7888,3505635228,3716168623,1672593375,1672594918,1543
7792,3660493209,3616944364,1672533482,1672536447,2965
7935,3209048907,3711262377,1672571341,1672573704,2363
7797,3701984666,3716843669,1672599904,1672601473,1569
7486,3227457126,3220716272,1672557666,1672557842,176
7765,3533369198,3494290908,1672550947,1672551124,177
7729,3365278081,3514987389,1672681959,1672684903,2944
7722,3625274012,3362000049,1672651497,1672654832,3335
7624,3779218771,3772884106,1672653279,1672655714,2435
7970,3735319397,3711504540,1672646371,1672647828,1457
7635,3365278081,3903962771,1672594399,1672597888,3489
7840,3500229033,3777806071,1672572812,1672574433,1621
7554,3774520233,3511163800,1672558993,1672561621,2628
7524,3930791338,3774501422,1672669278,1672672559,3281
7974,3772309150,3229665776,1672600464,1672603865,3401
7588,3774045700,3511862351,1672599093,1672600264,1171
7626,3776066388,3783531004,1672669677,1672672749,3072
7724,3780294829,3920801189,1672536545,1672538522,1977
7932,3344364444,3736790081,1672644443,1672645789,1346
7584,3880310724,3629547065,1672686309,1672688123,1814
7565,3285400528,3770553384,1672629754,1672630319,565
7741,3519428855,3618045231,1672625951,1672627880,1929
7522,3756453423,3418728074,1672565645,1672568926,3281
7955,3792768129,3200691026,1672541811,1672542446,635
7525,3716746253,3774010081,1672611639,1672614574,2935
7906,3701184889,3828365570,1672535950,1672538201,2251
7655,3628819436,3828432634,1672564604,1672567604,3000
7768,3716746253,3534010629,1672542469,1672542844,375
7654,3912536808,3501184421,1672580809,1672581191,382
7759,3774010081,3738274418,1672692297,1672693687,1390
7904,3480687894,3685818092,1672592423,1672593984,1561
7698,3792902982,3519700826,1672622898,1672626348,3450
7507,3206603608,3483949762,1672624594,1672625397,803
7794,3494290908,3880285638,1672615809,1672618726,2917
7763,3426325549,3737051610,1672581594,1672583421,1827
7499,3714197325,3714504419,1672568072,1672571001,2929
7816,3288764520,3389115045,1672628785,1672629346,561
7877,3311871871,3501364586,1672606976,1672610013,3037
7763,3389115045,3639847263,1672578848,1672582372,3524
7513,3416265063,3277605882,1672701169,1672702359,1190
7622,3902278226,3851190615,1672652095,1672655462,3367
7497,3755943611,3774298222,1672556686,1672559956,3270
7745,3344364444,3446948848,1672702143,1672703436,1293
7893,3666506258,3760492950,1672638752,1672639761,1009
7655,3734737881,3715974031,1672587808,1672588433,625
7977,3756966035,3833889105,1672667613,1672668945,1332
7831,3446948848,3774338212,1672612518,1672616021,3503
7962,3516960534,3280964728,1672652368,1672654730,2362
7822,3607178184,3512683609,1672625737,1672626794,1057
7706,3238712269,3500729955,1672593000,1672593781,781
7874,3514719601,3516011407,1672563313,1672563984,671
7707,3369998498,3512142794,1672653367,1672656181,2814
7952,3757602960,3713786889,1672534856,1672536615,1759
7809,3509933351,3396285984,1672579389,1672581239,1850
7581,3713808837,3757161914,1672591028,1672593770,2742
7773,3534424200,3249401741,1672630939,1672631687,748
7553,3518014636,3401627165,1672668783,1672670492,1709
7612,3227457126,3334033993,1672659415,1672660163,748
7929,3716197887,3384240055,1672582598,1672583508,910
7776,3713808837,3501927421,1672618788,1672620047,1259
7876,3882242815,3837094550,1672589052,1672590689,1637
7727,3883312122,3415443558,1672616901,1672617133,232
7850,3880310724,3505203158,1672541114,1672543371,2257
7885,3777717988,3853018906,1672658774,1672659842,1068
7564,3802367797,3617055293,1672554480,1672556850,2370
7869,3400804807,3780813786,1672576702,1672580129,3427
7600,3505292701,3448855696,1672582573,1672584780,2207
7791,3417061462,3518360734,1672607100,1672610158,3058
7828,3505201246,3500374658,1672673759,1672676690,2931
7654,3972709319,3667680268,1672674572,1672676006,1434
7596,3615046771,3777790718,1672694738,1672696154,1416
7665,3365830990,3509773875,1672606679,1672608968,2289
7665,3613683164,3783245561,1672622838,1672625100,2262
7821,3805292782,3301107849,1672531719,1672534975,3256
7699,3510771358,3827626797,1672626045,1672628641,2596
7859,3513454145,3417587765,1672611898,1672614199,2301
7795,3244173074,3417061462,1672606382,1672609660,3278
7968,3715339701,3307512479,1672602352,1672604705,2353
7721,3315583351,3311603601,1672550592,1672551283,691
7867,3316222192,3777776687,1672580278,1672581137,859
7605,3757562897,3792789881,1672589388,1672591799,2411
7890,3714821932,3430074045,1672627578,1672629521,1943
7718,3978115672,3249791738,1672673326,1672676740,3414
7718,3344019610,3518163778,1672625048,1672625864,816
7750,3626156564,3913251733,1672700315,1672703812,3497
7912,3416427576,3606186086,1672663063,1672664900,1837
7524,3533371364,3512349371,1672612586,1672615071,2485
7660,3291227780,3432689543,1672574339,1672577798,3459
7644,3291227780,3433804879,1672678464,1672681121,2657
7587,3297463265,3736592744,1672629536,1672632993,3457
7728,3791115967,3776338577,1672536200,1672537329,1129
7507,3311152102,3420432297,1672642255,1672644713,2458
7541,3201432789,3513956646,1672590830,1672591645,815
7504,3311718847,3774298222,1672635125,1672635428,303
7588,3716900301,3937224533,1672686924,1672689861,2937
7713,3534553510,3346327502,1672542649,1672544375,1726
7738,3733891182,3392121505,1672612178,1672612735,557
7898,3400804807,3883085535,1672587144,1672590492,3348
7944,3732481297,3716273414,1672677896,1672678425,529
7505,3777936328,3703871468,1672608366,1672609824,1458
7878,3378092448,3608633356,1672615338,1672617136,1798
7712,3773429448,3377766165,1672603975,1672606616,2641
7555,3319752091,3770553384,1672617266,1672619407,2141
7567,3516465662,3776948966,1672545304,1672547576,2272
7693,3779528381,3756462516,1672589240,1672591252,2012
7908,3826759140,3501692334,1672568327,1672570157,1830
7602,3392121505,3516716179,1672559535,1672562386,2851
7654,3777717988,3703789494,1672540399,1672541985,1586
7810,3313564074,3793286136,1672558034,1672561437,3403
7749,3277669002,3534492426,1672567978,1672568358,380
7906,3734737881,3703223015,1672672735,1672673982,1247
7572,3509634629,3930797455,1672687677,1672691111,3434
7895,3701111745,3760509236,1672568353,1672568970,617
7586,3222521619,3429856982,1672573001,1672574566,1565
7953,3716900301,3509453566,1672577458,1672579683,2225
7620,3513201436,3972364603,1672595139,1672595654,515
7799,3817316561,3774050956,1672578500,1672579192,692
7686,3505962865,3519803045,1672630074,1672630903,829
7733,3773598056,3505135325,1672617711,1672618064,353
7741,3367902229,3311274543,1672652068,1672655610,3542
7526,3533371364,3517459919,1672687068,1672690072,3004
7657,3511125626,3774010081,1672669278,1672671168,1890
7522,3280599164,3773429448,1672608644,1672609719,1075
7619,3480687894,3883085535,1672572352,1672573535,1183
7529,3509933351,3501955238,1672684802,1672687756,2954
7949,3973560347,3939952128,1672556559,1672557434,875
7746,3298433163,3936227020,1672590310,1672590982,672
7650,3475251781,3518360734,1672579566,1672580794,1228
7780,3505477652,3221899927,1672592670,1672593818,1148
7868,3388637594,3357483218,1672568080,1672568902,822
7847,3438645253,3774050956,1672650796,1672650942,146
7658,3791957752,3757812939,1672559258,1672562413,3155
7869,3701967560,3405494240,1672644685,1672647624,2939
7695,3629547065,3511271692,1672641738,1672643697,1959
7960,3668005723,3512683609,1672679880,1672679968,88
7939,3826633236,3776800213,1672592916,1672593856,940
7642,3901990690,3386707783,1672555669,1672556127,458
7747,3342131135,3774268456,1672548609,1672551949,3340
7948,3373384732,3514838220,1672578372,1672578813,441
7910,3703889596,3304056063,1672545359,1672548597,3238
7974,3513599775,3756453423,1672679742,1672683314,3572
7850,3236102733,3351554343,1672559345,1672561186,1841
7965,3485823740,3774339795,1672679001,1672681450,2449
7603,3898995675,3800886801,1672644992,1672647577,2585
7767,3511163800,3760267716,1672590000,1672591683,1683
7719,3534729133,3519803045,1672592989,1672593567,578
7526,3859525941,3519428855,1672700833,1672703244,2411
7659,3224058172,3931941795,1672570056,1672572348,2292
7925,3510244400,3505530961,1672670899,1672673785,2886
7977,3660493209,3303751772,1672686475,1672688091,1616
7551,3534729133,3501364586,1672618320,1672620059,1739
7656,3817316561,3513599775,1672539252,1672542337,3085
7820,3817316561,3738274418,1672700399,1672703678,3279
7833,3313541986,3807987001,1672562307,1672563908,1601
7949,3511435497,3510857360,1672650518,1672651369,851
7733,3791957752,3975287541,1672650932,1672653664,2732
7832,3513956646,3890149705,1672686415,1672688538,2123
7657,3505173328,3391915121,1672643319,1672644717,1398
7614,3311648200,3780609808,1672537787,1672539810,2023
7910,3772544062,3779976989,1672667104,1672669303,2199
7792,3520165601,3365614305,1672559057,1672561017,1960
7606,3902278226,3287105466,1672623388,1672625007,1619
7740,3792768129,3517077106,1672629743,1672630798,1055
7547,3465202715,3285400528,1672544139,1672547466,3327
7551,3509630174,3520751702,1672632937,1672635111,2174
7749,3509634629,3857349323,1672550553,1672553020,2467
7539,3222521619,3791657947,1672608905,1672611855,2950
7551,3792253549,3533025282,1672616637,1672619983,3346
7542,3516065852,3505599848,1672674965,1672675735,770
7712,3379589402,3701178711,1672678022,1672679366,1344
7684,3783083229,3737051610,1672591979,1672595174,3195
7755,3465202715,3505347134,1672600008,1672602699,2691
7839,3883042241,3853018906,1672600504,1672603206,2702
7785,3415443558,3711569060,1672568634,1672570351,1717
7508,3516514391,3793389510,1672654366,1672654549,183
7663,3701967560,3519428855,1672610383,1672610642,259
7886,3312664885,3783779671,1672603377,1672604049,672
7976,3792253549,3833889105,1672640796,1672644127,3331
7687,3271938399,3514283243,1672644920,1672645801,881
7648,3618873142,3791115967,1672630205,1672633489,3284
7516,3427283336,3734828619,1672625518,1672628967,3449
7607,3770635361,3517963492,1672586207,1672586298,91
7568,3859663348,3501483568,1672677553,1672680919,3366
7512,3512969370,3836573197,1672562304,1672563365,1061
7485,3601879040,3516258476,1672695709,1672698928,3219
7658,3313541986,3389115045,1672628893,1672630551,1658
7913,3701967560,3512720680,1672562386,1672562991,605
7970,3311761694,3511170269,1672621683,1672622743,1060
7853,3805292782,3475795792,1672558378,1672561034,2656
7500,3276993580,3360506772,1672683944,1672687470,3526
7668,3793959750,3715981584,1672635833,1672637754,1921
7510,3409474775,3534702203,1672623220,1672623948,728
7592,3703789494,3607748895,1672544955,1672548520,3565
7928,3774066725,3518163778,1672613591,1672614088,497
7587,3206593906,3232962003,1672654196,1672656241,2045
7812,3229665776,3716488385,1672561494,1672562026,532
7927,3756528686,3600647945,1672612912,1672615282,2370
7929,3319752091,3774066725,1672689499,1672692603,3104
7511,3428006164,3793871337,1672618319,1672620816,2497
7936,3533137446,3772544062,1672663884,1672667295,3411
7581,3899371911,3793389510,1672568894,1672571205,2311
7729,3510173870,3777120536,1672565612,1672568977,3365
7630,3930797455,3855602893,1672699493,1672700457,964
7749,3249247700,3774045700,1672587099,1672587465,366
7577,3792032359,3703441914,1672688879,1672689900,1021
7919,3913251733,3533242305,1672566604,1672569290,2686
7592,3249401741,3500374658,1672692333,1672694193,1860
7525,3833889105,3451432842,1672630870,1672632715,1845
7896,3501198706,3378092448,1672638376,1672638739,363
7912,3519654779,3518360734,1672663920,1672666800,2880
7910,3519803045,3400918687,1672551035,1672551382,347
7699,3828365570,3773814927,1672596079,1672598891,2812
7516,3296471982,3394330287,1672539016,1672541655,2639
7498,3533242305,3910886626,1672687650,1672688913,1263
7608,3511312803,3511350608,1672664073,1672666126,2053
7881,3757602960,3472130842,1672547544,1672550627,3083
7853,3520183192,3534424200,1672633323,1672634817,1494
7673,3516629436,3501692334,1672540338,1672542993,2655
7760,3801089989,3517077106,1672532560,1672533670,1110
7953,3806545488,3777936328,1672691203,1672691460,257
7501,3757403279,3533280269,1672604185,1672605213,1028
7662,3510247121,3783126683,1672575452,1672578938,3486
7878,3607748895,3206593906,1672616525,1672617033,508
7632,3903307060,3715492942,1672546190,1672547362,1172
7749,3201432789,3483949762,1672565234,1672568786,3552
7674,3416265063,3909331423,1672569390,1672570347,957
7719,3388286531,3517255726,1672632411,1672633419,1008
7853,3793848402,3791997875,1672681298,1672681843,545
7539,3777936328,3804870229,1672695452,1672695804,352
7736,3774298222,3828624701,1672667104,1672668724,1620
7726,3701178711,3519700826,1672610728,1672613012,2284
7484,3703275621,3780609808,1672638641,1672639688,1047
7970,3367029997,3972709319,1672642321,1672643699,1378
7622,3773755137,3235635976,1672682114,1672684486,2372
7560,3365278081,3505791599,1672626870,1672627001,131
7591,3791942683,3925620998,1672689876,1672693313,3437
7805,3777983879,3808324264,1672677643,1672679822,2179
7955,3703441914,3791553060,1672618247,1672621195,2948
7613,3314245084,3735733948,1672611435,1672612156,721
7948,3515723720,3505649239,1672698323,1672699061,738
7854,3801089989,3772758337,1672636048,1672638219,2171
7607,3200198928,3415546117,1672587751,1672590849,3098
7788,3857349323,3800886801,1672672792,1672673242,450
7754,3606987130,3774005526,1672546221,1672546971,750
7483,3424922204,3668005723,1672636573,1672639746,3173
7831,3517864478,3760183458,1672588617,1672592068,3451
7835,3206593906,3512683609,1672689361,1672691618,2257
7968,3511435497,3791594391,1672699186,1672700125,939
7536,3511312803,3201432789,1672625229,1672628547,3318
7593,3777790718,3791874383,1672677772,1672681305,3533
7588,3931941795,3297463265,1672628340,1672630146,1806
7838,3314836094,3918247820,1672546465,1672546680,215
7586,3617734118,3716488385,1672677513,1672680683,3170
7779,3476232529,3276640712,1672589579,1672592908,3329
7523,3296471982,3505203158,1672562519,1672566009,3490
7642,3318697153,3714504419,1672597828,1672599401,1573
7751,3396285984,3760509236,1672585929,1672589071,3142
7520,3818255890,3711571712,1672617023,1672618472,1449
7714,3815508790,3926700506,1672700225,1672701745,1520
7931,3780294829,3339907603,1672610916,1672612615,1699
7944,3385763781,3976390453,1672566998,1672569691,2693
7832,3730517636,3201324715,1672600760,1672602371,1611
7743,3534488837,3365830990,1672550096,1672552784,2688
7830,3337544549,3714962248,1672539203,1672540212,1009
7634,3496051529,3313564074,1672664535,1672666755,2220
7940,3629935998,3859525941,1672655186,1672656063,877
7798,3760561634,3614238812,1672623400,1672624006,606
7640,3883085535,3760509236,1672548075,1672549992,1917
7502,3412980697,3485375593,1672650416,1672651242,826
7912,3773429448,3500658339,1672656343,1672659196,2853
7538,3379256399,3472130842,1672648388,1672651929,3541
7933,3783083229,3837094550,1672542695,1672542777,82
7546,3311845971,3303751772,1672541079,1672541460,381
7922,3231056870,3682061100,1672596637,1672598834,2197
7817,3910886626,3783509527,1672658712,1672659907,1195
7574,3836573197,3485375593,1672592377,1672594996,2619
7847,3500066230,3384951177,1672593757,1672593827,70
7918,3359910781,3777936328,1672546368,1672547232,864
7777,3505599848,3911159965,1672566915,1672570163,3248
7876,3500658339,3483164654,1672589436,1672590752,1316
7724,3711504540,3910886626,1672588425,1672591824,3399
7737,3311415018,3520206212,1672703339,1672703677,338
7716,3600647945,3229665776,1672634185,1672635963,1778
7533,3710067113,3776800213,1672547622,1672550875,3253
7590,3399911573,3311871871,1672566956,1672569271,2315
7673,3899371911,3936227020,1672567613,1672569579,1966
7860,3510703546,3415546117,1672610023,1672612475,2452
7680,3910454786,3772578994,1672634007,1672634233,226
7891,3351008918,3416241005,1672537262,1672538699,1437
7761,3791334389,3509933351,1672589933,1672592210,2277
7728,3757161914,3497901842,1672557107,1672557950,843
7909,3314245084,3346795719,1672693836,1672696922,3086
7508,3624761861,3809916577,1672683208,1672686187,2979
7763,3772053179,3738502357,1672554496,1672557408,2912
7981,3793338102,3715998609,1672627780,1672630961,3181
7695,3780609808,3316222192,1672597312,1672600017,2705
7521,3485008994,3836573197,1672585706,1672586254,548
7820,3209027249,3613683164,1672625396,1672626528,1132
7572,3505702787,3883861463,1672535217,1672538141,2924
7656,3973560347,3244485293,1672537875,1672539968,2093
7576,3379589402,3416265063,1672683650,1672686156,2506
7666,3683959482,3808324264,1672634678,1672635659,981
7906,3662180254,3512683609,1672545431,1672547847,2416
7852,3976633198,3346327502,1672581999,1672584392,2393
7874,3221536550,3716843669,1672557513,1672558564,1051
7537,3716165213,3607748895,1672535847,1672538179,2332
7966,3792288302,3201432789,1672591953,1672592570,617
7533,3703955926,3501601840,1672604972,1672605131,159
7512,3417587765,3756966035,1672600093,1672602669,2576
7745,3716843669,3511198618,1672599929,1672600685,756
7816,3714474557,3701274634,1672644628,1672645877,1249
7613,3510380060,3453729665,1672585814,1672587789,1975
7855,3505912939,3713370078,1672566960,1672567296,336
7835,3755943611,3701691675,1672661002,1672661540,538
7699,3888559320,3492478793,1672615528,1672617118,1590
7703,3662180254,3853018906,1672565488,1672568433,2945
7866,3904408902,3783429780,1672591045,1672592070,1025
7597,3311274543,3481647420,1672632073,1672635332,3259
7851,3319752091,3828624701,1672653697,1672656121,2424
7806,3703871468,3760489031,1672573529,1672576103,2574
7770,3918247820,3511435497,1672654165,1672654841,676
7507,3394539273,3616944364,1672633331,1672636912,3581
7791,3505201246,3298288268,1672647081,1672650107,3026
7790,3505219850,3755511676,1672538749,1672541205,2456
7558,3438645253,3311065516,1672581204,1672582544,1340
7550,3917088658,3313564074,1672570149,1672570685,536
7683,3249247700,3534313900,1672555196,1672557683,2487
7651,3899266183,3518260334,1672590799,1672590963,164
7616,3820354437,3714962248,1672554023,1672556904,2881
7548,3500199935,3755042098,1672592307,1672595296,2989
7613,3825229501,3714821932,1672685314,1672687121,1807
7570,3734828619,3715974031,1672582996,1672585885,2889
7647,3520730271,3311648200,1672689868,1672691847,1979
7802,3715492942,3760561634,1672544879,1672545707,828
7500,3633420270,3244485293,1672569727,1672571567,1840
7633,3755392666,3496269445,1672584433,1672584787,354
7674,3936227020,3512166013,1672681298,1672682232,934
7838,3378092448,3713268590,1672611646,1672614127,2481
7756,3882997884,3378436155,1672651734,1672654967,3233
7872,3518496488,3331845324,1672675280,1672676956,1676
7819,3472130842,3492478793,1672686419,1672687236,817
7552,3244389794,3234362962,1672648022,1672651457,3435
7894,3756027749,3715974031,1672601864,1672603803,1939
7856,3276993580,3859525941,1672648403,1672650823,2420
7656,3235635976,3311718847,1672595953,1672597210,1257
7772,3975287541,3505098372,1672593241,1672594150,909
7537,3465202715,3466911760,1672595259,1672597007,1748
7760,3902278226,3511125626,1672677940,1672680479,2539
7505,3533095755,3791874383,1672669494,1672671126,1632
7823,3501692334,3755739653,1672676732,1672678514,1782
7827,3400804807,3736419952,1672667518,1672670803,3285
7679,3829764737,3515691540,1672569575,1672570385,810
7771,3760561634,3518014636,1672699404,1672700783,1379
7977,3430074045,3772642849,1672599993,1672601877,1884
7795,3760267716,3621810464,1672690724,1672691172,448
7968,3291883916,3716197887,1672617797,1672620473,2676
7872,3622054816,3607748895,1672695744,1672695826,82
7728,3780914982,3359239884,1672610248,1672613685,3437
7690,3277605882,3475251781,1672610978,1672613645,2667
7807,3421836608,3511841857,1672664025,1672667182,3157
7485,3511163800,3760569731,1672583107,1672583727,620
7818,3756453423,3801089989,1672671317,1672672401,1084
7827,3421127249,3851190615,1672621392,1672622233,841
7666,3511170269,3392121505,1672661995,1672664129,2134
7830,3774793839,3510857360,1672600398,1672600585,187
7784,3756528686,3242408357,1672573166,1672575247,2081
7969,3912536808,3978115672,1672574457,1672574882,425
7723,3511332835,3516465662,1672643613,1672643674,61
7889,3517963492,3429690204,1672643892,1672645444,1552
7763,3428964059,3510126867,1672588888,1672591392,2504
7554,3703441914,3396285984,1672638896,1672639108,212
7568,3792288302,3710098970,1672643408,1672643876,468
7897,3514719601,3520030713,1672558317,1672561458,3141
7895,3534729133,3970117174,1672574481,1672576304,1823
7758,3229058858,3703871468,1672682574,1672683680,1106
7765,3666457294,3201324715,1672699809,1672703021,3212
7620,3755920131,3829232696,1672547117,1672547417,300
7735,3813052709,3827626797,1672551892,1672553014,1122
7632,3314836094,3777623166,1672531913,1672533852,1939
7681,3516673015,3777983879,1672675710,1672679055,3345
7572,3621497531,3511862351,1672611284,1672612316,1032
7876,3777079686,3516673015,1672661588,1672664100,2512
7595,3783083229,3277605882,1672580776,1672581999,1223
7669,3480687894,3516909237,1672649526,1672650349,823
7814,3388637594,3899204805,1672631725,1672632324,599
7520,3475258557,3793436995,1672620243,1672621360,1117
7649,3209383861,3399433690,1672559955,1672562949,2994
7707,3346795719,3475795792,1672669463,1672671417,1954
7725,3701984666,3774005526,1672667404,1672668808,1404
7959,3624312512,3778980116,1672560318,1672562946,2628
7680,3855602893,3851190615,1672672521,1672673712,1191
7916,3339907603,3516673015,1672593395,1672594381,986
7833,3515691540,3817316561,1672610620,1672612090,1470
7898,3534702203,3760077057,1672688125,1672688343,218
7918,3793338102,3711265369,1672700619,1672701146,527
7983,3284639858,3318166135,1672566341,1672567911,1570
7782,3510173870,3304625412,1672535399,1672535566,167
7539,3405494240,3417061462,1672632607,1672634592,1985
7703,3891751546,3732481297,1672692349,1672695024,2675
7806,3773950140,3365614305,1672646149,1672647937,1788
7758,3505635228,3736786443,1672559120,1672559817,697
7851,3760509236,3688683847,1672669272,1672670960,1688
7891,3807987001,3344364444,1672631157,1672634166,3009
7567,3280964728,3755625324,1672583468,1672585785,2317
7683,3519601612,3666553782,1672559327,1672562185,2858
7527,3634340855,3777806071,1672663951,1672665165,1214
7684,3277669002,3421127249,1672547501,1672549902,2401
7541,3517077106,3500499542,1672551763,1672552759,996
7693,3510703546,3826759140,1672683765,1672684959,1194
7596,3715492942,3500994774,1672564574,1672566713,2139
7841,3312664885,3918584946,1672621951,1672622617,666
7726,3607178184,3777443199,1672555722,1672556421,699
7495,3518669703,3311274543,1672622413,1672622821,408
7493,3625274012,3416265063,1672625679,1672626830,1151
7681,3701065786,3516011407,1672667213,1672668981,1768
7835,3509604974,3511862351,1672612283,1672615340,3057
7784,3827222533,3412980697,1672595269,1672598221,2952
7867,3792473331,3711571712,1672591537,1672594685,3148
7516,3224058172,3518932404,1672686402,1672688455,2053
7870,3505477652,3634340855,1672598156,1672599897,1741
7874,3606812411,3710344260,1672568070,1672569954,1884
7773,3505638204,3755625324,1672565719,1672566284,565
7646,3710112546,3489962019,1672581456,1672581649,193
7679,3500894271,3605726278,1672557029,1672558030,1001
7690,3405494240,3610695419,1672637247,1672639578,2331
7668,3360743849,3520165601,1672634445,1672637637,3192
7711,3772578994,3780609808,1672662459,1672663373,914
7526,3880310724,3711504540,1672571569,1672573388,1819
7781,3976633198,3377766165,1672633156,1672633692,536
7983,3889232789,3800353779,1672644029,1672644590,561
7509,3500578848,3311154569,1672625880,1672626132,252
7770,3755943611,3500729955,1672590512,1672591774,1262
7971,3701146057,3291883916,1672543791,1672545029,1238
7585,3512142794,3760267716,1672701929,1672704658,2729
7667,3716165213,3937224533,1672574188,1672576540,2352
7858,3421127249,3220716272,1672582713,1672585156,2443
7916,3227457126,3731419510,1672585771,1672587268,1497
7689,3773755137,3889750851,1672574461,1672575312,851
7839,3501184421,3505912939,1672599223,1672599967,744
7493,3244389794,3223789409,1672600750,1672604248,3498
7935,3805519285,3836573197,1672689004,1672689680,676
7976,3909606423,3730517636,1672699588,1672701601,2013
7800,3735319397,3238712269,1672676495,1672678229,1734
7792,3519069599,3701863557,1672681674,1672682166,492
7588,3209551760,3780294829,1672628209,1672630230,2021
7833,3859663348,3365278081,1672698180,1672699451,1271
7913,3505098372,3420700674,1672693217,1672694179,962
7821,3201432789,3777120536,1672652842,1672655204,2362
7527,3370636709,3616944364,1672567971,1672571244,3273
7789,3755436115,3475251781,1672614480,1672615759,1279
7726,3715974031,3500805881,1672696396,1672696494,98
7923,3361230905,3383922351,1672645048,1672647176,2128
7963,3206603608,3428964059,1672555839,1672558915,3076
7950,3311203656,3489545239,1672607040,1672607549,509
7847,3736786443,3291883916,1672625550,1672628830,3280
7654,3511271692,3420700674,1672663316,1672663570,254
7502,3714197325,3755943611,1672674264,1672675404,1140
7631,3443698222,3734737881,1672661177,1672662807,1630
7597,3312333615,3903307060,1672648158,1672648393,235
7756,3738502357,3772758337,1672615756,1672616900,1144
7748,3716835696,3716165213,1672588124,1672591092,2968
7662,3519703355,3822654369,1672658358,1672659802,1444
7804,3883551721,3505635228,1672552011,1672553320,1309
7589,3505477652,3520706195,1672545097,1672545278,181
7941,3427283336,3773978034,1672657231,1672660137,2906
7673,3510173870,3774338212,1672668712,1672671467,2755
7802,3519601612,3312664885,1672701551,1672702917,1366
7893,3736786443,3386707783,1672562600,1672564587,1987
7853,3534313900,3713630656,1672540387,1672543487,3100
7982,3209383861,3520730271,1672599867,1672601307,1440
7508,3793753089,3622054816,1672697596,1672701140,3544
7483,3888559320,3710067113,1672675932,1672677628,1696
7637,3809059934,3716488385,1672537186,1672538733,1547
7671,3280615985,3505201246,1672535434,1672536786,1352
7848,3774050956,3337544549,1672556613,1672556837,224
7878,3912536808,3427219654,1672534014,1672536243,2229
7719,3390068992,3365830990,1672649375,1672651505,2130
7969,3774338212,3826759140,1672645884,1672649448,3564
7790,3288764520,3459030804,1672617240,1672618840,1600
7643,3534191820,3512683609,1672569062,1672571101,2039
7494,3417970574,3809484172,1672590661,1672593300,2639
7885,3516065852,3757812939,1672620619,1672622267,1648
7602,3682061100,3817316561,1672628236,1672628603,367
7492,3607178184,3519703355,1672616407,1672618441,2034
7557,3520888296,3497901842,1672657361,1672658707,1346
7860,3407954858,3713268590,1672617241,1672620033,2792
7796,3777079686,3793753089,1672633898,1672636355,2457
7653,3909606423,3714474557,1672589947,1672592101,2154
7850,3757161914,3428674539,1672598253,1672601433,3180
7784,3774127586,3533927138,1672692682,1672694070,1388
7932,3314245084,3760893269,1672682624,1672686157,3533
7486,3514245078,3427219654,1672633078,1672635299,2221
7933,3899266183,3509453566,1672595642,1672596043,401
7568,3621810464,3809484172,1672636979,1672637780,801
7550,3715189301,3883312122,1672673766,1672676979,3213
7668,3244436890,3517459919,1672653406,1672654235,829
7509,3972364603,3520709480,1672575747,1672576567,820
7781,3606186086,3793436995,1672601879,1672603117,1238
7630,3777806071,3332072298,1672554849,1672557799,2950
7964,3736419952,3496051529,1672547197,1672550293,3096
7698,3756930948,3512540951,1672570303,1672570466,163
7788,3493507965,3713786889,1672635707,1672637459,1752
7541,3904408902,3808324264,1672670685,1672672910,2225
7709,3828624701,3369998498,1672684298,1672687807,3509
7604,3703955926,3485008994,1672697737,1672699490,1753
7848,3922337974,3485823740,1672695665,1672697876,2211
7865,3823600322,3511687358,1672596232,1672599286,3054
7548,3417061462,3773814927,1672563984,1672566777,2793
7829,3555214688,3772714862,1672618658,1672620869,2211
7823,3505362057,3415443558,1672687708,1672690910,3202
7964,3249791738,3791594391,1672532816,1672534093,1277
7785,3774050956,3756601594,1672604510,1672607264,2754
7507,3881477378,3291227780,1672541346,1672544170,2824
7774,3880285638,3505904952,1672582983,1672585725,2742
7785,3730517636,3501955238,1672617556,1672618492,936
7580,3428674539,3735733948,1672701819,1672703645,1826
7637,3517509185,3345207877,1672690415,1672691873,1458
7905,3428006164,3688418210,1672567477,1672567692,215
7956,3773205565,3716835696,1672699262,1672700549,1287
7822,3384951177,3518408774,1672612724,1672614540,1816
7583,3520719611,3703871468,1672686899,1672690122,3223
7484,3200198928,3736229191,1672604681,1672607891,3210
7670,3683766533,3430074045,1672549327,1672549526,199
7713,3793962300,3756930948,1672551272,1672554420,3148
7766,3703718151,3885670556,1672624192,1672625074,882
7635,3755587522,3805292782,1672544786,1672545734,948
7557,3778780511,3505292701,1672673084,1672674717,1633
7940,3296471982,3610695419,1672538103,1672540033,1930
7907,3395152943,3913251733,1672614974,1672615194,220
7794,3714474557,3807987001,1672610847,1672612797,1950
7554,3930797455,3972364603,1672682038,1672683321,1283
7980,3400804807,3774204963,1672554004,1672555883,1879
7581,3284639858,3311871871,1672664433,1672666692,2259
7926,3416265063,3777514571,1672593228,1672593448,220
7674,3388286531,3811694763,1672550585,1672553826,3241
7876,3792253549,3356860407,1672573229,1672576695,3466
7690,3485008994,3500365158,1672635946,1672638209,2263
7553,3666506258,3516716179,1672583041,1672583693,652
7879,3793389510,3518669703,1672605100,1672606409,1309
7485,3734496778,3857349323,1672679980,1672681953,1973
7575,3857349323,3804870229,1672692007,1672694463,2456
7497,3505098372,3509453566,1672647172,1672650621,3449
7821,3500803339,3379256399,1672646570,1672648737,2167
7947,3734737881,3774339795,1672699170,1672699751,581
7490,3883551721,3701111745,1672703723,1672706614,2891
7838,3533385867,3713268590,1672642302,1672642447,145
7663,3703223015,3512683609,1672689282,1672692303,3021
7880,3739106581,3772578994,1672687047,1672687338,291
7582,3899204805,3621497531,1672657246,1672657571,325
7924,3627937312,3922275416,1672665810,1672669051,3241
7601,3617055293,3514245078,1672624212,1672626984,2772
7748,3314836094,3920801189,1672683614,1672686269,2655
7915,3701146057,3236102733,1672595767,1672596796,1029
7849,3716197887,3772746272,1672683444,1672685186,1742
7647,3713786889,3793086311,1672621069,1672622707,1638
7526,3774466457,3715998609,1672578933,1672581524,2591
7941,3412980697,3365614305,1672693932,1672694216,284
7823,3627937312,3518360734,1672678618,1672681765,3147
7573,3903009525,3402943525,1672670402,1672672772,2370
7505,3483949762,3780914982,1672572576,1672574865,2289
7741,3662180254,3509630174,1672544541,1672545844,1303
7707,3755436115,3287105466,1672575282,1672576861,1579
7490,3715998609,3911245524,1672676128,1672678824,2696
7502,3229665776,3817316561,1672608408,1672610287,1879
7907,3458539365,3882291183,1672614301,1672614610,309
7621,3390068992,3791020967,1672672442,1672675706,3264
7642,3715998609,3511350608,1672595080,1672596861,1781
7683,3805342762,3349613093,1672698195,1672699321,1126
7908,3416427576,3360743849,1672552856,1672555830,2974
7718,3755436115,3805292782,1672682393,1672684567,2174
7972,3777120536,3388286531,1672673731,1672677301,3570
7659,3832902928,3302626661,1672668930,1672671014,2084
7532,3407673904,3501184421,1672558124,1672558736,612
7970,3911245524,3755587522,1672569759,1672571197,1438
7803,3757562897,3511267139,1672621056,1672623751,2695
7537,3501606184,3779036831,1672665305,1672666443,1138
7686,3514472925,3711198793,1672699074,1672701327,2253
7792,3770763956,3889232789,1672567036,1672568042,1006
7664,3932051427,3533927138,1672691360,1672693082,1722
7654,3611150562,3610348516,1672648417,1672650622,2205
7632,3505201246,3756424865,1672612696,1672614430,1734
7530,3220716272,3518260334,1672648110,1672648811,701
7528,3454042520,3311603601,1672683667,1672685793,2126
7852,3511359172,3279721246,1672597395,1672597617,222
7811,3772714862,3209027249,1672651181,1672652248,1067
7699,3369998498,3516673015,1672611566,1672612758,1192
7487,3780593036,3813052709,1672587366,1672589283,1917
7666,3505973226,3510594211,1672699674,1672700647,973
7981,3770101921,3416241005,1672635737,1672636754,1017
7933,3500658339,3611150562,1672673930,1672677015,3085
7551,3454042520,3791997875,1672674414,1672676719,2305
7811,3361230905,3736229191,1672633686,1672635306,1620
7716,3209383861,3500578848,1672541783,1672542732,949
7742,3601879040,3378686918,1672574780,1672574936,156
7486,3511198618,3533626375,1672565107,1672568267,3160
7572,3509907947,3791115967,1672678438,1672681759,3321
7579,3773120434,3926700506,1672690527,1672693665,3138
7520,3500066230,3200198928,1672538246,1672541642,3396
7558,3885670556,3615046771,1672654610,1672655090,480
7886,3716835696,3701691675,1672599977,1672601693,1716
7679,3311090974,3222521619,1672561606,1672565146,3540
7538,3511312803,3367902229,1672690665,1672691169,504
7811,3715981584,3634995491,1672569145,1672569768,623
7828,3756021689,3301107849,1672627491,1672629022,1531
7623,3716273414,3438645253,1672691171,1672691501,330
7882,3915628728,3514987389,1672671913,1672672539,626
7547,3209048907,3482405588,1672574156,1672574314,158
7888,3773664987,3509634629,1672630992,1672634086,3094
7978,3777623166,3406784491,1672566583,1672567666,1083
7624,3346795719,3533927138,1672663400,1672665138,1738
7686,3500805881,3362000049,1672585996,1672588281,2285
7682,3234541252,3770101921,1672639130,1672641123,1993
7553,3714504419,3298433163,1672552620,1672553919,1299
7524,3770021824,3533025282,1672574728,1672576651,1923
7751,3760489031,3685818092,1672649763,1672650805,1042
7546,3516258476,3735733948,1672622378,1672625514,3136
7864,3611150562,3716746253,1672671813,1672674618,2805
7930,3633420270,3935127663,1672665489,1672668101,2612
7535,3511267139,3359910781,1672700933,1672701497,564
7667,3505904952,3554917400,1672597142,1672600166,3024
7957,3829319703,3793959750,1672637626,1672638263,637
7738,3701146057,3715127362,1672579123,1672580800,1677
7656,3519428855,3505145247,1672661941,1672663109,1168
7717,3608868877,3500894271,1672583259,1672586256,2997
7575,3533626375,3458539365,1672691826,1672693709,1883
7855,3222448362,3446948848,1672536677,1672540096,3419
7893,3912536808,3348261553,1672602359,1672605732,3373
7676,3518876135,3715189301,1672588796,1672591094,2298
7636,3855424474,3222448362,1672574144,1672575719,1575
7802,3520730271,3792253549,1672660962,1672661175,213
7863,3755436115,3361230905,1672548218,1672548452,234
7901,3430352815,3828432634,1672550291,1672552513,2222
7681,3755392666,3703789494,1672634367,1672636739,2372
7632,3668005723,3311871871,1672631845,1672633898,2053
7764,3757151210,3515691540,1672655564,1672656036,472
7814,3978115672,3378436155,1672575503,1672576175,672
7719,3792883665,3701863557,1672574400,1672575625,1225
7900,3509604974,3514987389,1672579280,1672579419,139
7840,3402943525,3505098372,1672666696,1672669664,2968
7780,3346327502,3238712269,1672635892,1672636502,610
7564,3970117174,3351554343,1672573203,1672576710,3507
7739,3973560347,3285400528,1672618699,1672621958,3259
7532,3774195321,3337544549,1672698359,1672698453,94
7666,3760077057,3505135325,1672628301,1672630486,2185
7967,3404384505,3399433690,1672534631,1672536554,1923
7826,3391915121,3533371364,1672543404,1672545684,2280
7532,3776066388,3484995752,1672603776,1672606756,2980
7787,3351554343,3276993580,1672615490,1672618642,3152
7681,3485823740,3827222533,1672630676,1672633429,2753
7771,3516065852,3827626797,1672555581,1672556892,1311
7853,3772746272,3883085535,1672604988,1672606071,1083
7747,3505635228,3345207877,1672575774,1672576364,590
7601,3918584946,3533653428,1672574058,1672576561,2503
7818,3666506258,3817621391,1672652097,1672652450,353
7694,3793848402,3331845324,1672597387,1672598449,1062
7490,3277669002,3501692334,1672682145,1672682211,66
7503,3711571712,3244436890,1672650711,1672652298,1587
7670,3511312803,3342131135,1672638745,1672640932,2187
7630,3756462516,3518669703,1672546577,1672547757,1180
7600,3509933351,3520730271,1672606917,1672609826,2909
7659,3391261292,3902278226,1672593238,1672596404,3166
7752,3511198618,3513599775,1672702795,1672704560,1765
7637,3516258476,3511125626,1672675550,1672677065,1515
7542,3888559320,3925620998,1672620041,1672621472,1431
7661,3634340855,3362000049,1672573348,1672573552,204
7536,3483949762,3314836094,1672601079,1672602300,1221
7661,3417587765,3236102733,1672700531,1672702928,2397
7976,3760598102,3915628728,1672539738,1672542752,3014
7977,3755392666,3518408774,1672660872,1672663636,2764
7819,3734828619,3880310724,1672654869,1672657330,2461
7786,3401627165,3278365525,1672675329,1672677828,2499
7782,3773755137,3633420270,1672626222,1672626653,431
7682,3516716179,3242408357,1672569107,1672569315,208
7488,3832902928,3822654369,1672614372,1672616247,1875
7522,3772714862,3428006164,1672597550,1672599459,1909
7787,3736786443,3518014404,1672686325,1672689752,3427
7843,3666457294,3883042241,1672666939,1672668255,1316
7503,3917278625,3773755137,1672532402,1672534267,1865
7630,3899371911,3505962865,1672637214,1672637748,534
7835,3559110998,3510711755,1672591036,1672594328,3292
7538,3311603601,3715581279,1672556480,1672556573,93
7498,3701898991,3517476351,1672623045,1672624640,1595
7982,3222521619,3297463265,1672622216,1672622391,175
7641,3399052055,3770021824,1672541118,1672543648,2530
7904,3280599164,3385763781,1672593913,1672595479,1566
7843,3505347134,3302626661,1672624851,1672626839,1988
7719,3711973519,3715981584,1672569958,1672572071,2113
7968,3501692334,3760561634,1672596466,1672599026,2560
7733,3416265063,3774066725,1672569792,1672571039,1247
7534,3776066388,3777776687,1672585831,1672588564,2733
7825,3391915121,3501198706,1672687861,1672690897,3036
7810,3509352754,3806545488,1672686608,1672688161,1553
7560,3770635361,3519152550,1672681001,1672682720,1719
7712,3826760240,3473765852,1672667442,1672667985,543
7645,3773950140,3392121505,1672582831,1672584983,2152
7901,3736419952,3485823740,1672538417,1672541740,3323
7623,3505702787,3859525941,1672638868,1672639555,687
7826,3711569060,3738502357,1672623445,1672624739,1294
7547,3515125508,3618045231,1672607885,1672608092,207
7723,3236102733,3825229501,1672599014,1672601173,2159
7568,3409474775,3737051610,1672582155,1672583331,1176
7647,3512567240,3805292782,1672575386,1672575976,590
7688,3417587765,3402943525,1672695475,1672698272,2797
7645,3711569060,3616944364,1672540536,1672542734,2198
7724,3756027749,3314245084,1672559709,1672559824,115
7515,3519428855,3406784491,1672581383,1672582884,1501
7529,3813052709,3509907947,1672690969,1672692628,1659
7587,3238712269,3780294829,1672678626,1672681601,2975
7833,3792177074,3505362057,1672645211,1672645807,596
7602,3380035798,3505347134,1672700572,1672703312,2740
7764,3711504540,3791115967,1672620509,1672621886,1377
7522,3783196518,3939952128,1672635960,1672636285,325
7726,3505203158,3297463265,1672635830,1672637242,1412
7814,3513956646,3500487333,1672642016,1672642191,175
7493,3834257412,3510594211,1672559994,1672562816,2822
7678,3773465237,3855937514,1672611136,1672614195,3059
7916,3533626375,3756528686,1672692513,1672692991,478
7750,3793086311,3779528381,1672576257,1672578850,2593
7859,3710344260,3882291183,1672674150,1672674398,248
7637,3755511676,3501198706,1672597472,1672598710,1238
7602,3621497531,3432689543,1672664781,1672665884,1103
7589,3500803339,3477375368,1672599068,1672599525,457
7691,3793962300,3284832486,1672651289,1672654211,2922
7894,3360743849,3716273414,1672691844,1672691924,80
7963,3774195321,3828432634,1672691699,1672692997,1298
7779,3713969578,3755881905,1672575764,1672578502,2738
7878,3760489031,3511170269,1672662951,1672664346,1395
7958,3701984666,3711198793,1672552443,1672554269,1826
7786,3510244400,3500374658,1672549981,1672551344,1363
7838,3224058172,3475396323,1672696229,1672698773,2544
7578,3885897503,3793086311,1672677443,1672677570,127
7911,3223968713,3714504419,1672550908,1672552310,1402
7747,3492478793,3516716179,1672544352,1672546558,2206
7732,3314245084,3519703355,1672670469,1672672903,2434
7487,3756021689,3496051529,1672589945,1672592915,2970
7561,3760294205,3615046771,1672533249,1672535911,2662
7968,3922275620,3496549058,1672552213,1672554352,2139
7935,3238712269,3818255890,1672600665,1672603736,3071
7687,3756462516,3511198618,1672546269,1672548748,2479
7860,3902383721,3401627165,1672623302,1672625406,2104
7914,3774045700,3777776687,1672553658,1672555157,1499
7628,3855602893,3399911573,1672616016,1672617537,1521
7763,3792177074,3208844525,1672564189,1672566168,1979
7625,3298288268,3514719601,1672551441,1672552438,997
7815,3412825109,3714504419,1672567434,1672571009,3575
7548,3783245561,3738502357,1672664333,1672664761,428
7777,3505292701,3783925755,1672668487,1672669766,1279
7830,3500177712,3625274012,1672585918,1672588606,2688
7487,3476232529,3520888296,1672668482,1672670174,1692
7757,3220716272,3500458761,1672537156,1672539571,2415
7794,3713268590,3777806071,1672602243,1672604333,2090
7495,3511267139,3313564074,1672643522,1672646602,3080
7541,3379589402,3711571712,1672669204,1672669798,594
7965,3505635228,3313541986,1672653847,1672656966,3119
7867,3701146057,3427283336,1672543709,1672545708,1999
7679,3512142794,3505973226,1672567511,1672567911,400
7754,3511170269,3666553782,1672593914,1672595754,1840
7670,3509933351,3793959750,1672675297,1672678499,3202
7622,3420432297,3279721246,1672592376,1672593032,656
7566,3972364603,3666506258,1672647115,1672650258,3143
7509,3930791338,3793753089,1672650445,1672650925,480
7652,3401627165,3555214688,1672639521,1672641567,2046
7948,3407673904,3806545488,1672665219,1672667756,2537
7756,3220716272,3792668962,1672630669,1672634057,3388
7511,3223968713,3779218771,1672699958,1672702172,2214
7570,3792789881,3793286136,1672539755,1672542203,2448
7558,3793338102,3755587522,1672645479,1672648739,3260
7627,3703955926,3773120434,1672570309,1672570901,592
7912,3816454165,3318166135,1672590095,1672592398,2303
7823,3517077106,3512567240,1672626275,1672627219,944
7955,3200198928,3776800213,1672607812,1672611374,3562
7694,3231056870,3909606423,1672703812,1672705460,1648
7981,3501198706,3777776687,1672566755,1672567186,431
7688,3812176780,3509604974,1672549207,1672551392,2185
7725,3836573197,3701534009,1672633402,1672634144,742
7824,3932051427,3826633236,1672662634,1672665566,2932
7516,3316173088,3912536808,1672666928,1672667924,996
7657,3534729133,3791957752,1672685094,1672688309,3215
7744,3244485293,3772758337,1672646931,1672647870,939
7605,3783509527,3716900301,1672617752,1672619179,1427
7686,3307512479,3513164386,1672550960,1672551815,855
7954,3511163800,3914259449,1672637206,1672639048,1842
7502,3889750851,3755881905,1672643879,1672645826,1947
7760,3505530961,3711571712,1672676583,1672679159,2576
7641,3432665384,3518014404,1672559999,1672561667,1668
7687,3703223015,3520931254,1672612473,1672615021,2548
7589,3629547065,3713969578,1672603709,1672604660,951
7680,3505859863,3221899927,1672576513,1672579451,2938
7535,3206254161,3731106822,1672697329,1672698567,1238
7817,3624312512,3476232529,1672642583,1672643568,985
7531,3792253549,3377766165,1672694512,1672694759,247
7740,3534553510,3885670556,1672659485,1672662898,3413
7730,3512837326,3514838220,1672533490,1672536541,3051
7641,3736790081,3833889105,1672635619,1672638280,2661
7559,3777790718,3793871337,1672667571,1672670112,2541
7648,3760992710,3829764737,1672555140,1672557384,2244
7862,3277669002,3800353779,1672599675,1672601261,1586
7935,3666553782,3534191820,1672590374,1672592587,2213
7551,3736790081,3533270638,1672698883,1672700189,1306
7983,3516716179,3516258476,1672548970,1672552107,3137
7636,3515860749,3391915121,1672578248,1672580547,2299
7918,3606186086,3516909237,1672565079,1672565854,775
7644,3778266283,3206254161,1672693296,1672694881,1585
7970,3520376528,3534010629,1672684923,1672686340,1417
7630,3716258994,3352603894,1672624931,1672626829,1898
7924,3909238838,3429856982,1672670253,1672670874,621
7734,3515394721,3519912874,1672683302,1672686345,3043
7972,3710569131,3918584946,1672558908,1672560956,2048
7855,3478194807,3935627557,1672689889,1672693084,3195
7785,3757403279,3924549929,1672674346,1672675073,727
7736,3716197887,3738502357,1672565750,1672567107,1357
7620,3519152550,3736790081,1672690074,1672690343,269
7544,3246596716,3779036831,1672619396,1672620962,1566
7813,3352603894,3710098970,1672569274,1672571474,2200
7970,3278365525,3277939457,1672675162,1672677618,2456
7928,3511125626,3519556068,1672531681,1672532397,716
7700,3783245561,3352603894,1672561828,1672564765,2937
7520,3515394721,3520709480,1672620540,1672621732,1192
7940,3500894271,3391261292,1672625410,1672627899,2489
7721,3774005526,3792902982,1672562362,1672565447,3085
7570,3792032359,3519700826,1672617588,1672619845,2257
7678,3285400528,3559110998,1672667390,1672668470,1080
7952,3832902928,3624761861,1672701932,1672702412,480
7789,3374559242,3979339287,1672592969,1672593801,832
7914,3755511676,3715998609,1672655719,1672656304,585
7856,3760077057,3505000737,1672644080,1672645183,1103
7758,3303705369,3313564074,1672625360,1672627743,2383
7646,3808324264,3713786889,1672572598,1672574544,1946
7687,3369998498,3733891182,1672564193,1672566358,2165
7857,3773429448,3394539273,1672619895,1672620179,284
7791,3307512479,3757562897,1672652321,1672653103,782
7575,3307512479,3221536550,1672557029,1672560169,3140
7828,3501601840,3500391167,1672658709,1672659772,1063
7552,3276640712,3713370078,1672647735,1672650474,2739
7926,3392121505,3688418210,1672543889,1672547140,3251
7752,3311324983,3415546117,1672646637,1672649315,2678
7551,3715127362,3242408357,1672659205,1672660707,1502
7787,3777477395,3311648200,1672604643,1672606825,2182
7689,3514283243,3379256399,1672604699,1672606171,1472
7526,3505635228,3505638204,1672674813,1672678219,3406
7912,3513080274,3344364444,1672626164,1672629495,3331
7575,3783705817,3516629436,1672574893,1672575114,221
7683,3475258557,3533137446,1672664155,1672667012,2857
7594,3311203656,3510771358,1672684457,1672687754,3297
7820,3901990690,3351008918,1672592428,1672595120,2692
7760,3915628728,3615046771,1672684963,1672688187,3224
7664,3396086535,3615046771,1672537236,1672539028,1792
7598,3533193862,3516465662,1672552952,1672553783,831
7617,3972709319,3505201246,1672624474,1672625378,904
7654,3273500349,3710569131,1672696877,1672699509,2632
7888,3780639480,3776800213,1672626005,1672627084,1079
7754,3715974031,3311627628,1672608818,1672611150,2332
7960,3400918687,3236102733,1672599472,1672600722,1250
7907,3791115967,3774066725,1672550941,1672551098,157
7878,3780828689,3359910781,1672537655,1672539566,1911
7489,3779976989,3772758337,1672636222,1672638714,2492
7570,3516011407,3222448362,1672632399,1672633917,1518
7963,3417970574,3801089989,1672559358,1672560914,1556
7565,3755920131,3902278226,1672541175,1672542472,1297
7890,3773978034,3883085535,1672587957,1672589064,1107
7915,3516039895,3889232789,1672553829,1672555931,2102
7737,3636867411,3519069599,1672549868,1672552208,2340
7920,3857349323,3416241005,1672638440,1672639801,1361
7514,3247815299,3316173088,1672560083,1672561482,1399
7672,3298288268,3760294205,1672647879,1672649716,1837
7949,3234362962,3512540951,1672574448,1672575098,650
7679,3703275621,3808324264,1672612435,1672612989,554
7583,3783531004,3780813786,1672610135,1672612003,1868
7772,3372883226,3301107849,1672536024,1672539503,3479
7649,3500229033,3505962865,1672649037,1672652358,3321
7661,3668898102,3244389794,1672641453,1672643480,2027
7917,3780914982,3510969660,1672559868,1672560862,994
7651,3312664885,3394539273,1672703263,1672706529,3266
7649,3473765852,3391915886,1672650941,1672652090,1149
7745,3776338577,3432689543,1672681747,1672684484,2737
7686,3792768129,3792384220,1672574863,1672578381,3518
7867,3611150562,3756930948,1672662031,1672664875,2844
7711,3921211276,3516039895,1672559989,1672561207,1218
7608,3417061462,3303751772,1672551967,1672555026,3059
7922,3383922351,3244485293,1672633039,1672633728,689
7729,3307097200,3618045231,1672693531,1672696253,2722
7631,3772337814,3829764737,1672542813,1672544438,1625
7882,3937224533,3711265369,1672591101,1672592378,1277
7575,3416265063,3608633356,1672687659,1672689723,2064
7807,3733189298,3793086311,1672619820,1672623014,3194
7747,3505962865,3271938399,1672621936,1672622655,719
7925,3509634629,3515125508,1672678307,1672679979,1672
7923,3916289176,3756930948,1672572525,1672573678,1153
7779,3505193212,3519556068,1672685570,1672685645,75
7601,3922275620,3774005526,1672603965,1672604874,909
7895,3808324264,3827377568,1672656855,1672660278,3423
7891,3829764737,3396086535,1672559548,1672561519,1971
7977,3516223597,3716168623,1672550464,1672552640,2176
7483,3899204805,3859663348,1672583974,1672584329,355
7917,3511312803,3772053179,1672587676,1672589652,1976
7693,3755943611,3348261553,1672620357,1672622401,2044
7812,3755739653,3917278625,1672582134,1672585562,3428
7488,3346795719,3710344260,1672678127,1672680172,2045
7744,3710067113,3714962248,1672590707,1672592795,2088
7875,3379589402,3776513891,1672702319,1672702941,622
7792,3200691026,3783509527,1672688184,1672688308,124
7542,3378092448,3918584946,1672613239,1672615841,2602
7706,3228165483,3716488385,1672664098,1672666352,2254
7510,3312664885,3518408774,1672532485,1672532723,238
7895,3667680268,3518876135,1672666556,1672667604,1048
7728,3978105277,3774501422,1672584226,1672584767,541
7738,3534729133,3760992710,1672541992,1672543617,1625
7849,3701863557,3420700674,1672595255,1672596071,816
7826,3711308224,3624312512,1672543962,1672546030,2068
7584,3446948848,3224058172,1672645521,1672646360,839
7502,3500060260,3777776687,1672677040,1672678624,1584
7912,3509453566,3489962019,1672663619,1672665389,1770
7639,3516039895,3605726278,1672666718,1672669986,3268
7632,3703441914,3683959482,1672662194,1672665013,2819
7873,3827377568,3336751428,1672541022,1672542103,1081
7640,3793086311,3505000737,1672665735,1672665838,103
7797,3311152102,3510857360,1672571287,1672571851,564
7895,3348261553,3777443199,1672565594,1672568162,2568
7802,3624312512,3688683847,1672658371,1672658905,534
7765,3399535232,3509773875,1672690413,1672692477,2064
7630,3772884106,3916289176,1672561099,1672562937,1838
7808,3783245561,3811694763,1672606607,1672608242,1635
7610,3374559242,3399433690,1672639956,1672640691,735
7757,3359239884,3485008994,1672658141,1672661547,3406
7956,3774339795,3760077057,1672701373,1672703629,2256
7710,3756453423,3703441914,1672674292,1672677631,3339
7677,3388372715,3511435497,1672611108,1672613757,2649
7887,3412980697,3511687358,1672615256,1672618690,3434
7889,3247815299,3533270638,1672649283,1672650755,1472
7958,3772309150,3773205565,1672558418,1672561452,3034
7724,3629547065,3756623396,1672557238,1672559373,2135
7853,3774204963,3247815299,1672573635,1672575343,1708
7730,3417970574,3711504540,1672568034,1672569320,1286
7564,3318166135,3378436155,1672646417,1672649631,3214
7725,3703661585,3512510536,1672633976,1672634151,175
7960,3716835696,3432689543,1672599452,1672602150,2698
7752,3517509185,3715127362,1672631956,1672633678,1722
7728,3500458761,3710344260,1672663595,1672666576,2981
7637,3783239924,3777477395,1672640382,1672642813,2431
7658,3837094550,3773598056,1672702262,1672702819,557
7644,3733189298,3311871871,1672573681,1672576919,3238
7833,3757151210,3778305740,1672660203,1672663214,3011
7564,3931941795,3428006164,1672640932,1672642744,1812
7853,3533095755,3505145247,1672617499,1672620310,2811
7853,3916289176,3755392666,1672694426,1672695235,809
7561,3774195321,3227158514,1672589388,1672592268,2880
7968,3534313900,3509604974,1672698442,1672701548,3106
7599,3792844210,3448855696,1672575045,1672576309,1264
7618,3407954858,3407673904,1672558521,1672559864,1343
7842,3510244400,3755739653,1672550906,1672551999,1093
7899,3289061738,3716168623,1672664660,1672665514,854
7907,3855424474,3516011407,1672599284,1672602362,3078
7670,3755587522,3703871468,1672645103,1672646039,936
7662,3634995491,3496269445,1672621977,1672622051,74
7699,3911245524,3332072298,1672582512,1672583349,837
7896,3519703355,3826633236,1672540715,1672540944,229
7926,3518791447,3756462516,1672677308,1672677461,153
7875,3809484172,3793871337,1672568425,1672568652,227
7687,3520376528,3772359096,1672651154,1672651990,836
7649,3774119563,3890149705,1672699851,1672700934,1083
7745,3517864478,3634995491,1672547432,1672549698,2266
7624,3222521619,3312829208,1672659325,1672659779,454
7548,3780593036,3613683164,1672676295,1672676850,555
7552,3883861463,3806545488,1672561010,1672562834,1824
7547,3887270940,3360506772,1672619644,1672620116,472
7559,3501198706,3710098970,1672681897,1672683248,1351
7940,3809916577,3554917400,1672667807,1672669560,1753
7942,3791020967,3481502100,1672542605,1672543870,1265
7518,3606812411,3783206719,1672577865,1672580981,3116
7939,3914290246,3777929708,1672703160,1672703294,134
7520,3783126683,3453729665,1672574812,1672576009,1197
7512,3500894271,3273500349,1672619593,1672622937,3344
7978,3385763781,3359239884,1672573309,1672575081,1772
7847,3791901535,3346327502,1672670236,1672670738,502
7704,3554917400,3501606184,1672608527,1672609199,672
7938,3202120784,3516980378,1672631970,1672634785,2815
7873,3792668962,3516016437,1672694641,1672697257,2616
7554,3505883609,3496269445,1672679985,1672680664,679
7703,3701967560,3501606184,1672699288,1672700371,1083
7823,3509672210,3757151210,1672639531,1672640897,1366
7975,3200198928,3713208927,1672558523,1672559903,1380
7736,3755739653,3760077057,1672653520,1672655081,1561
7671,3334033993,3783083229,1672651407,1672651468,61
7651,3534010629,3819727225,1672647503,1672647760,257
7898,3912536808,3922275620,1672683230,1672685268,2038
7693,3496549058,3889232789,1672681547,1672684057,2510
7782,3756453423,3336751428,1672692003,1672693274,1271
7531,3828365570,3483164654,1672640663,1672644220,3557
7679,3296471982,3338703270,1672552415,1672553419,1004
7905,3338367113,3221536550,1672691660,1672694243,2583
7782,3606186086,3473765852,1672561205,1672561362,157
7813,3234541252,3534488837,1672660300,1672663130,2830
7787,3505873261,3755881905,1672648366,1672649201,835
7766,3714962248,3730517636,1672647133,1672648266,1133
7652,3613683164,3774050956,1672605735,1672607039,1304
7606,3509634629,3608868877,1672643319,1672644948,1629
7746,3777443199,3500904641,1672573159,1672575758,2599
7980,3360506772,3418534998,1672642841,1672645403,2562
7571,3714197325,3976633198,1672640400,1672642690,2290
7581,3429690204,3311090974,1672569812,1672571094,1282
7700,3826633236,3777443199,1672653869,1672654015,146
7761,3774195321,3817316561,1672549242,1672549739,497
7690,3511125626,3713808837,1672660299,1672663399,3100
7539,3311603601,3298288268,1672687754,1672690168,2414
7718,3760294205,3556951786,1672538957,1672542277,3320
7634,3244485293,3284832486,1672540085,1672541335,1250
7947,3500391167,3887270940,1672623488,1672626995,3507
7757,3365278081,3883861463,1672595585,1672598324,2739
7866,3774501422,3510703546,1672655462,1672658789,3327
7670,3520719611,3311718847,1672573567,1672575857,2290
7542,3296471982,3783206719,1672586657,1672588758,2101
7622,3385763781,3453729665,1672702385,1672703408,1023
7605,3756451663,3935627557,1672617308,1672620449,3141
7548,3512166013,3534488837,1672671302,1672671649,347
7648,3505098372,3249401741,1672577811,1672579092,1281
7855,3516629436,3533626375,1672553404,1672554943,1539
7831,3701190899,3716488385,1672667743,1672670682,2939
7667,3513454145,3792384220,1672617919,1672620119,2200
7558,3534729133,3505000737,1672607446,1672608662,1216
7895,3711308224,3534191820,1672650310,1672651779,1469
7808,3500499542,3858918246,1672579084,1672579283,199
7737,3208844525,3791594391,1672658754,1672661583,2829
7983,3505791599,3904775198,1672553037,1672555076,2039
7528,3510711755,3791957752,1672598289,1672600083,1794
7540,3520888296,3509773875,1672640431,1672641987,1556
7547,3509933351,3883861463,1672647997,1672648116,119
7501,3755872268,3500658339,1672579968,1672580065,97
7832,3618045231,3516016437,1672667251,1672669363,2112
7519,3760267716,3501759100,1672559470,1672561948,2478
7569,3395152943,3311090974,1672700304,1672700611,307
7694,3391915886,3710344260,1672686959,1672688634,1675
7508,3511350608,3396285984,1672695719,1672696715,996
7819,3715581279,3793086311,1672562021,1672564604,2583
7917,3703789494,3713808837,1672686526,1672687493,967
7564,3244436890,3509352754,1672574969,1672577087,2118
7764,3757812939,3755872268,1672703304,1672705636,2332
7715,3736786443,3471220483,1672556886,1672558083,1197
7959,3683959482,3391915121,1672694561,1672696771,2210
7606,3806545488,3533025282,1672556231,1672558980,2749
7732,3770021824,3511862351,1672701455,1672703544,2089
7488,3701146057,3533748232,1672618479,1672619032,553
7682,3779629905,3510937904,1672688309,1672691722,3413
7931,3792384220,3512349371,1672547942,1672551444,3502
7800,3516606733,3473765852,1672604411,1672605820,1409
7516,3519703355,3514245078,1672560221,1672562581,2360
7629,3755436115,3931941795,1672632923,1672636296,3373
7754,3500904641,3509453566,1672587160,1672589958,2798
7770,3703223015,3395152943,1672699109,1672701503,2394
7913,3314836094,3362000049,1672546429,1672549797,3368
7910,3519654779,3774298222,1672642743,1672646205,3462
7752,3399052055,3378092448,1672644844,1672647380,2536
7785,3791957752,3918584946,1672664967,1672666635,1668
7623,3533385867,3819727225,1672682802,1672684673,1871
7917,3520376528,3404058699,1672583096,1672585011,1915
7822,3770851318,3776338577,1672609770,1672611527,1757
7581,3277669002,3510594211,1672658587,1672660117,1530
7979,3917088658,3613683164,1672551628,1672552456,828
7595,3778549126,3701190899,1672653049,1672654158,1109
7678,3511841857,3755587522,1672586254,1672587292,1038
7865,3428674539,3477649378,1672578002,1672579312,1310
7922,3736592744,3939952128,1672598200,1672601680,3480
7970,3885897503,3505292701,1672567911,1672568589,678
7565,3606812411,3391261292,1672664406,1672666216,1810
7801,3783429780,3755943611,1672695969,1672697582,1613
7753,3510247121,3836573197,1672674679,1672675690,1011
7944,3428006164,3513599775,1672540174,1672543067,2893
7875,3484995752,3520756859,1672618076,1672620421,2345
7717,3917088658,3701995648,1672669143,1672670220,1077
7727,3904775198,3302626661,1672685326,1672685577,251
7958,3613683164,3533927138,1672564975,1672566258,1283
7844,3357483218,3517476351,1672581807,1672584376,2569
7849,3793627961,3888559320,1672637561,1672637746,185
7810,3621497531,3336751428,1672683638,1672684347,709
7951,3858918246,3903962771,1672664442,1672666650,2208
7736,3316222192,3520190170,1672593281,1672595604,2323
7636,3384951177,3804870229,1672618200,1672619859,1659
7623,3487171044,3898995675,1672692873,1672694669,1796
7814,3383661227,3512683609,1672602096,1672605412,3316
7844,3533369198,3903307060,1672609993,1672611312,1319
7955,3511332835,3400918687,1672654296,1672657624,3328
7635,3515691540,3420700674,1672653318,1672653457,139
7853,3407725581,3284832486,1672588836,1672590359,1523
7684,3400804807,3755943611,1672699193,1672701017,1824
7708,3773814927,3792768129,1672691795,1672694441,2646
7892,3703441914,3772714862,1672570094,1672571212,1118
7676,3374559242,3701898991,1672544415,1672544779,364
7600,3514128943,3512217942,1672660629,1672661731,1102
7506,3605726278,3633420270,1672605469,1672607339,1870
7792,3490191091,3899371911,1672640458,1672641121,663
7982,3666507626,3518260334,1672653394,1672653730,336
7884,3757602960,3756601594,1672606911,1672609287,2376
7781,3898995675,3915628728,1672703132,1672704728,1596
7590,3297463265,3505904952,1672677322,1672677688,366
7953,3819727225,3505000737,1672555891,1672556989,1098
7963,3629935998,3930791338,1672684897,1672684971,74
7834,3774050956,3296471982,1672591777,1672594577,2800
7495,3365614305,3516016437,1672650082,1672650818,736
7893,3792789881,3359239884,1672576003,1672578893,2890
7941,3500229033,3774501422,1672607089,1672610581,3492
7570,3703223015,3519803045,1672560635,1672563572,2937
7806,3756623396,3312829208,1672610879,1672613939,3060
7708,3511687358,3711198793,1672588363,1672590564,2201
7709,3372883226,3816853177,1672627405,1672630205,2800
7633,3760598102,3780503655,1672647225,1672648134,909
7936,3411618230,3489545239,1672649874,1672652891,3017
7922,3793389510,3372883226,1672696740,1672699131,2391
7938,3351008918,3817316561,1672698066,1672698563,497
7732,3779036831,3710098970,1672613023,1672613109,86
7515,3716258994,3770553384,1672676005,1672677944,1939
7805,3777936328,3930791338,1672549038,1672549478,440
7845,3716537575,3772359096,1672672988,1672675279,2291
7941,3385763781,3512969370,1672689249,1672689862,613
7829,3201848640,3774793839,1672551317,1672553124,1807
7572,3827626797,3415443558,1672698907,1672702401,3494
7598,3973560347,3713786889,1672673611,1672675541,1930
7791,3365614305,3851190615,1672694110,1672694262,152
7560,3399004969,3639847263,1672633543,1672636618,3075
7815,3834257412,3805347939,1672599262,1672601625,2363
7845,3484995752,3777936328,1672583761,1672587264,3503
7521,3510969660,3899371911,1672642200,1672645294,3094
7662,3428674539,3404384505,1672693131,1672696200,3069
7558,3774195321,3235635976,1672628897,1672630965,2068
7666,3555214688,3511198618,1672642643,1672644638,1995
7609,3291227780,3735733948,1672565367,1672568882,3515
7645,3713208927,3520190170,1672703931,1672707024,3093
7618,3236102733,3361230905,1672611394,1672612451,1057
7924,3291883916,3514838220,1672592739,1672593258,519
7536,3278365525,3770021824,1672547991,1672548422,431
7917,3711504540,3500994774,1672620843,1672621403,560
7844,3346327502,3396086535,1672539874,1672541088,1214
7826,3770763956,3800353779,1672606602,1672606874,272
7846,3360993964,3513164386,1672550388,1672551575,1187
7879,3731106822,3711370563,1672598811,1672601883,3072
7875,3774793839,3819727225,1672582887,1672584437,1550
7582,3249791738,3505219850,1672537363,1672538225,862
7563,3835382117,3757447189,1672574323,1672576805,2482
7511,3303751772,3633420270,1672614029,1672614846,817
7962,3778305740,3284639858,1672692220,1672693431,1211
7781,3552314511,3383661227,1672570119,1672572986,2867
7592,3808324264,3970117174,1672686845,1672690196,3351
7545,3280615985,3510711755,1672620343,1672621501,1158
7541,3826633236,3772309166,1672645424,1672648488,3064
7779,3337544549,3533369198,1672621707,1672622484,777
7571,3311415018,3518669703,1672600636,1672601692,1056
7963,3374559242,3978105277,1672700533,1672702343,1810
7931,3777443199,3473765852,1672540861,1672542224,1363
7767,3373384732,3511435497,1672667002,1672668489,1487
7518,3480687894,3882291183,1672581315,1672583008,1693
7530,3514838220,3883085535,1672674762,1672677427,2665
7725,3511163800,3402943525,1672581969,1672584591,2622
7894,3793627961,3505098372,1672703077,1672703221,144
7736,3774338212,3757246925,1672574712,1672577939,3227
7518,3520719611,3492478793,1672652239,1672653432,1193
7731,3312664885,3505649239,1672595458,1672597234,1776
7713,3473562469,3701984666,1672535018,1672538080,3062
7959,3304056063,3773465237,1672672332,1672673694,1362
7503,3770447408,3733189298,1672581843,1672582152,309
7599,3359239884,3760509236,1672548057,1672550719,2662
7920,3483949762,3604539807,1672684315,1672686196,1881
7696,3683766533,3613683164,1672660361,1672661339,978
7874,3519803045,3890149705,1672535595,1672535940,345
7914,3917278625,3757447189,1672620759,1672623432,2673
7855,3791020967,3336751428,1672618621,1672621656,3035
7798,3913251733,3851190615,1672559664,1672561629,1965
7875,3301107849,3520030713,1672696739,1672698446,1707
7697,3792844210,3610348516,1672686786,1672688976,2190
7509,3533280269,3774010081,1672540654,1672540961,307
7549,3483949762,3774050956,1672576113,1672579379,3266
7697,3827626797,3534488837,1672646151,1672647722,1571
7518,3624761861,3835382117,1672562234,1672565010,2776
7812,3427219654,3793871337,1672701349,1672701770,421
7540,3776066388,3760077057,1672693317,1672696316,2999
7869,3806545488,3443698222,1672534249,1672534958,709
7661,3855000166,3756451663,1672698400,1672699853,1453
7884,3628819436,3280615985,1672637765,1672641223,3458
7694,3777514571,3703441914,1672564659,1672566044,1385
7496,3514128943,3760509236,1672572179,1672574366,2187
7568,3783126683,3385763781,1672586255,1672588049,1794
7511,3685818092,3248507722,1672701293,1672704073,2780
7859,3777776687,3716258994,1672556624,1672558585,1961
7771,3514719601,3901990690,1672684283,1672686233,1950
7487,3935127663,3772309150,1672609041,1672609733,692
7700,3512166013,3772359096,1672592767,1672593423,656
7816,3509773875,3475251781,1672661843,1672662308,465
7518,3509604974,3714488548,1672641688,1672644811,3123
7932,3716273414,3489962019,1672577959,1672580093,2134
7818,3772714862,3828624701,1672600880,1672603838,2958
7954,3931941795,3298288268,1672651088,1672653198,2110
7886,3415546117,3811694763,1672648780,1672649675,895
7720,3505000737,3501483568,1672561804,1672563255,1451
7745,3780593036,3378686918,1672539232,1672540141,909
7956,3298288268,3312829208,1672691745,1672694678,2933
7779,3736625083,3400918687,1672682753,1672684473,1720
7515,3715974031,3757562897,1672622000,1672624439,2439
7951,3793086311,3633420270,1672594410,1672594840,430
7492,3780593036,3448855696,1672666101,1672666218,117
7930,3421127249,3332072298,1672658034,1672661572,3538
7628,3777079686,3380035798,1672680132,1672681966,1834
7554,3851190615,3909606423,1672533933,1672534742,809
7648,3778305740,3685818092,1672577140,1672580330,3190
7641,3304625412,3333896808,1672643855,1672644361,506
7767,3932051427,3509453566,1672630171,1672631741,1570
7969,3533280269,3208844525,1672590651,1672591591,940
7587,3816454165,3418534998,1672606872,1672609956,3084
7929,3505962865,3356860407,1672693046,1672695727,2681
7669,3755436115,3412825109,1672660091,1672660966,875
7620,3359910781,3490191091,1672552130,1672554659,2529
7644,3512540951,3518014636,1672542633,1672544732,2099
7525,3793436995,3757403279,1672601556,1672601705,149
7549,3434642576,3533385867,1672552187,1672554171,1984
7875,3760509236,3514128943,1672598334,1672600860,2526
7777,3793627961,3380035798,1672642640,1672642739,99
7514,3512683609,3774195321,1672647970,1672649792,1822
7590,3388372715,3475396323,1672553963,1672555211,1248
7735,3383922351,3394330287,1672652203,1672653882,1679
7707,3668005723,3774501422,1672612114,1672615278,3164
7538,3780639480,3332072298,1672677199,1672678196,997
7650,3755739653,3713644518,1672588669,1672591603,2934
7799,3777079686,3885897503,1672621886,1672624470,2584
7954,3501759100,3511125626,1672593720,1672594648,928
7868,3774119563,3703789494,1672617147,1672618244,1097
7786,3359910781,3416265063,1672599355,1672599903,548
7607,3520706195,3756021689,1672674275,1672675244,969
7658,3716197887,3501927421,1672656996,1672657889,893
7892,3394330287,3505904952,1672614610,1672617736,3126
7966,3427219654,3351008918,1672683499,1672684369,870
7889,3511332835,3430074045,1672558464,1672561586,3122
7819,3332072298,3926700506,1672612016,1672612973,957
7970,3291235378,3453729665,1672685147,1672687532,2385
7983,3511435497,3600647945,1672686472,1672687780,1308
7581,3755872268,3298288268,1672662179,1672664167,1988
7970,3287105466,3783779671,1672544222,1672545017,795
7659,3316222192,3510247121,1672655069,1672657060,1991
7631,3344019610,3777936328,1672579188,1672580156,968
7546,3516258476,3755798867,1672672227,1672672795,568
7813,3902278226,3760077057,1672662546,1672663750,1204
7722,3713349754,3358871377,1672693546,1672694085,539
7833,3792473331,3777806071,1672667531,1672667661,130
7901,3780639480,3793871337,1672580558,1672582872,2314
7596,3701178711,3501483568,1672536439,1672537725,1286
7785,3776513891,3852391257,1672657165,1672659708,2543
7877,3703223015,3513201436,1672624831,1672626920,2089
7785,3778308417,3311274543,1672624263,1672626579,2316
7837,3384951177,3730517636,1672644819,1672645003,184
7558,3812176780,3783779671,1672655635,1672657092,1457
7981,3533193862,3714821932,1672535400,1672535686,286
7967,3883551721,3533193862,1672626211,1672627017,806
7542,3533371364,3793962300,1672672356,1672675581,3225
7912,3520709480,3319752091,1672697660,1672699518,1858
7878,3519601612,3755436115,1672638642,1672639948,1306
7752,3351008918,3793962300,1672553764,1672556389,2625
7594,3756424865,3500894271,1672602472,1672605509,3037
7894,3883861463,3807987001,1672566060,1672568739,2679
7560,3772642849,3406784491,1672680035,1672681941,1906
7965,3664517356,3227158514,1672626422,1672629374,2952
7712,3399004969,3420432297,1672604768,1672606190,1422
7891,3703223015,3792288302,1672699870,1672703251,3381
7641,3776338577,3249247700,1672596488,1672598188,1700
7877,3710569131,3358871377,1672601959,1672604291,2332
7780,3890149705,3777477395,1672657056,1672659499,2443
7947,3774119563,3634340855,1672577569,1672579251,1682
7540,3515284591,3774793839,1672621004,1672622251,1247
7492,3477649378,3505347134,1672673780,1672674043,263
7753,3516606733,3902278226,1672647562,1672648272,710
7814,3390068992,3511359172,1672604222,1672604284,62
7498,3791901535,3822654369,1672688304,1672690760,2456
7878,3716168623,3755943611,1672588519,1672591686,3167
7815,3716273414,3622054816,1672591371,1672593549,2178
7955,3783083229,3932051427,1672614548,1672615070,522
7552,3380035798,3792883665,1672583655,1672583767,112
7964,3809484172,3338367113,1672633459,1672636087,2628
7657,3791553060,3534010629,1672695361,1672695647,286
7597,3512720680,3621497531,1672605946,1672607585,1639
7533,3755587522,3298433163,1672642133,1672644151,2018
7865,3533025282,3228165483,1672700433,1672702826,2393
7621,3400804807,3918056059,1672548685,1672550919,2234
7535,3303751772,3513599775,1672649867,1672652854,2987
7912,3224716315,3792473331,1672599113,1672599601,488
7939,3901990690,3791657947,1672680936,1672682166,1230
7932,3774005526,3510244400,1672626955,1672629147,2192
7943,3516716179,3533242305,1672573750,1672575460,1710
7857,3221899927,3918247820,1672663325,1672665348,2023
7693,3716537575,3793962300,1672540582,1672541252,670
7977,3396086535,3314245084,1672589334,1672592487,3153
7649,3510594211,3365614305,1672665390,1672667503,2113
7928,3448855696,3774050956,1672629137,1672629839,702
7909,3512837326,3909606423,1672597135,1672599973,2838
7865,3432665384,3853018906,1672621933,1672624404,2471
7931,3516514391,3760489031,1672565943,1672566993,1050
7692,3304056063,3715974031,1672588464,1672589650,1186
7867,3701190899,3855000166,1672628870,1672632332,3462
7611,3770824086,3534488837,1672541363,1672542820,1457
7568,3925402713,3510244400,1672544272,1672546562,2290
7763,3918056059,3918584946,1672685296,1672686091,795
7717,3520165601,3311761694,1672597874,1672601349,3475
7867,3287105466,3828365570,1672572619,1672575972,3353
7560,3505883609,3774005526,1672625530,1672628233,2703
7636,3880285638,3512510536,1672570071,1672572135,2064
7483,3501759100,3780503655,1672591849,1672594426,2577
7486,3736229191,3791657947,1672589402,1672589972,570
7526,3979339287,3509630174,1672624568,1672627470,2902
7614,3477649378,3488244966,1672538210,1672538986,776
7549,3777929708,3710344260,1672557431,1672559424,1993
7906,3428674539,3534313900,1672625044,1672627375,2331
7980,3683959482,3791115967,1672675858,1672679301,3443
7703,3510771358,3489217083,1672611937,1672613722,1785
7679,3772053179,3760183458,1672625428,1672626581,1153
7651,3512510536,3780609808,1672651309,1672654159,2850
7495,3757682496,3918584946,1672659592,1672662516,2924
7861,3346795719,3809059934,1672603619,1672604601,982
7955,3248507722,3534010629,1672568623,1672572024,3401
7510,3713894336,3333896808,1672558182,1672559045,863
7957,3791020967,3311871871,1672642278,1672645218,2940
7824,3519152550,3430074045,1672667600,1672669956,2356
7568,3780828689,3229058858,1672665739,1672667288,1549
7820,3826760240,3511435497,1672652425,1672654046,1621
7666,3774045700,3438645253,1672540478,1672540812,334
7832,3346327502,3909331423,1672642089,1672643224,1135
7605,3780813786,3505203158,1672535047,1672537167,2120
7548,3352603894,3360743849,1672549913,1672552058,2145
7675,3417970574,3734828619,1672619978,1672622317,2339
7771,3715339701,3209551760,1672685050,1672685297,247
7678,3731106822,3711370563,1672601808,1672602633,825
7614,3780974443,3517476351,1672661134,1672662960,1826
7887,3615046771,3776800213,1672701549,1672702434,885
7537,3519428855,3477375368,1672598286,1672600464,2178
7804,3883312122,3512540951,1672549273,1672551634,2361
7614,3922337974,3244436890,1672661440,1672665015,3575
7743,3685187183,3336751428,1672640908,1672644272,3364
7953,3793436995,3385763781,1672629469,1672632795,3326
7553,3206603608,3737154119,1672628796,1672630064,1268
7863,3313564074,3711265369,1672620997,1672621213,216
7879,3914259449,3344019610,1672588679,1672591553,2874
7555,3505859863,3772714862,1672575736,1672578537,2801
7739,3427283336,3883551721,1672682111,1672683940,1829
7717,3438645253,3772309150,1672597504,1672597598,94
7806,3774466457,3311154569,1672576876,1672577241,365
7496,3621810464,3510594211,1672614269,1672615913,1644
7831,3338367113,3516223597,1672643794,1672644329,535
7954,3809484172,3607748895,1672598634,1672601693,3059
7983,3733891182,3936227020,1672590086,1672592530,2444
7509,3478194807,3682061100,1672664420,1672667695,3275
7981,3407725581,3710569131,1672583066,1672585986,2920
7905,3925402713,3792032359,1672670061,1672672650,2589
7772,3505292701,3668005723,1672695937,1672696805,868
7526,3756528686,3473562469,1672616807,1672617758,951
7929,3756451663,3510857360,1672610518,1672611853,1335
7928,3311627628,3516716179,1672694634,1672696291,1657
7933,3978105277,3516039895,1672641236,1672641752,516
7623,3426325549,3716537575,1672652606,1672654400,1794
7538,3978105277,3365830990,1672589706,1672591453,1747
7938,3701863557,3519700826,1672593777,1672596048,2271
7942,3534492426,3482405588,1672581623,1672582953,1330
7739,3465202715,3517476351,1672558917,1672560065,1148
7839,3805347939,3512142794,1672665685,1672667869,2184
7494,3666553782,3512540951,1672592756,1672595147,2391
7578,3505883609,3918674986,1672643143,1672646109,2966
7813,3378436155,3519428855,1672633391,1672633739,348
7519,3773465237,3880285638,1672640783,1672642443,1660
7558,3534424200,3518932404,1672686086,1672687511,1425
7827,3774127586,3777477395,1672553772,1672557141,3369
7941,3780294829,3512540951,1672665919,1672665981,62
7960,3421836608,3505962865,1672607822,1672608283,461
7856,3922275620,3394330287,1672571097,1672574483,3386
7827,3606812411,3757151210,1672575153,1672576577,1424
7489,3516980378,3285400528,1672685503,1672687018,1515
7526,3388372715,3755943611,1672660254,1672662471,2217
7497,3624312512,3430074045,1672593430,1672594826,1396
7889,3859525941,3777776687,1672565956,1672568836,2880
7551,3737051610,3617055293,1672702141,1672705093,2952
7644,3510380060,3520012395,1672535525,1672536571,1046
7685,3855000166,3311415018,1672555663,1672557141,1478
7788,3372883226,3925402713,1672689710,1672692875,3165
7816,3311154569,3716900301,1672616232,1672618553,2321
7729,3666457294,3397418363,1672617084,1672619179,2095
7814,3755798867,3500199935,1672678118,1672679534,1416
7690,3791602225,3339907603,1672671817,1672672517,700
7511,3348261553,3713969578,1672596182,1672597843,1661
7674,3399911573,3349613093,1672536771,1672539115,2344
7686,3339907603,3883312122,1672680992,1672684213,3221
7742,3511332835,3903009525,1672626072,1672626430,358
7708,3715189301,3816853177,1672604923,1672605785,862
7655,3899204805,3505973226,1672624295,1672626361,2066
7540,3501730685,3755798867,1672563074,1672563374,300
7952,3280599164,3473765852,1672628923,1672629854,931
7713,3433804879,3501759100,1672622124,1672622282,158
7757,3783126683,3533369198,1672651479,1672654035,2556
7879,3443698222,3349613093,1672593960,1672596283,2323
7976,3301107849,3783531004,1672663939,1672665047,1108
7553,3792844210,3756021689,1672627378,1672629355,1977
7697,3505962865,3895562476,1672635050,1672637644,2594
7582,3736625083,3701498253,1672637580,1672639772,2192
7496,3520888296,3773950140,1672663973,1672665107,1134
7813,3920801189,3505347134,1672699023,1672702131,3108
7779,3711973519,3518260334,1672594399,1672596393,1994
7789,3731106822,3608633356,1672600367,1672601360,993
7640,3293695955,3772758337,1672630217,1672630780,563
7709,3811694763,3505201246,1672531511,1672533475,1964
7571,3360506772,3772544062,1672611126,1672612472,1346
7571,3484995752,3520165601,1672637556,1672637616,60
7940,3820354437,3736625083,1672584683,1672587107,2424
7918,3772544062,3755511676,1672668776,1672670647,1871
7487,3783925755,3760893269,1672649404,1672649766,362
7977,3348261553,3903009525,1672615296,1672618286,2990
7863,3918247820,3505135325,1672543517,1672545285,1768
7938,3701111745,3552314511,1672583997,1672586214,2217
7584,3685187183,3793871337,1672620385,1672620478,93
7536,3716900301,3828432634,1672562686,1672565690,3004
7501,3510937904,3552314511,1672601074,1672604275,3201
7522,3925620998,3496269445,1672640258,1672641144,886
7876,3770851318,3510969660,1672553734,1672557026,3292
7596,3365942576,3511267139,1672603147,1672603491,344
7827,3501955238,3774466457,1672696725,1672696911,186
7720,3755798867,3792883665,1672687231,1672689244,2013
7775,3399052055,3247428249,1672650712,1672653489,2777
7874,3667680268,3779528381,1672556760,1672557233,473
7488,3780813786,3701967560,1672553416,1672554216,800
7944,3534010629,3783531004,1672694199,1672695705,1506
7622,3778780511,3888559320,1672553722,1672555056,1334
7647,3297463265,3459030804,1672612590,1672615500,2910
7617,3774580701,3783245561,1672615939,1672618633,2694
7600,3501692334,3519700826,1672646382,1672649276,2894
7745,3917088658,3716746253,1672666800,1672667436,636
7680,3624761861,3777776687,1672671770,1672673366,1596
7925,3301107849,3703013906,1672578152,1672578725,573
7791,3617734118,3889232789,1672589986,1672590106,120
7517,3736592744,3780788622,1672698813,1672700316,1503
7950,3311845971,3629935998,1672586240,1672586577,337
7895,3715998609,3760489031,1672637558,1672638843,1285
7839,3417061462,3500391167,1672666639,1672669317,2678
7916,3518408774,3493507965,1672615449,1672616245,796
7655,3359910781,3783925755,1672593170,1672596545,3375
7516,3277669002,3760992710,1672560502,1672561594,1092
7727,3756623396,3500894271,1672628702,1672629264,562
7747,3206254161,3533369198,1672548694,1672549489,795
7810,3703013906,3731106822,1672698469,1672699899,1430
7772,3238712269,3533653428,1672574007,1672576316,2309
7798,3833889105,3792473331,1672690872,1672693033,2161
7568,3836573197,3349613093,1672552422,1672554132,1710
7694,3465202715,3904408902,1672556826,1672558623,1797
7554,3519069599,3511312803,1672565436,1672569032,3596
7959,3505962865,3780503655,1672630767,1672630990,223
7693,3533371364,3770447408,1672572896,1672573402,506
7494,3390068992,3477375368,1672532273,1672533558,1285
7904,3332072298,3890149705,1672548345,1672549148,803
7940,3701995648,3925620998,1672627035,1672630622,3587
7934,3755392666,3791942683,1672674806,1672675924,1118
7972,3390068992,3880310724,1672594811,1672598156,3345
7868,3739106581,3760267716,1672604790,1672606180,1390
7774,3311090974,3756528686,1672555810,1672557768,1958
7554,3716537575,3614238812,1672697394,1672699006,1612
7888,3760183458,3514838220,1672637322,1672638129,807
7970,3608868877,3517255726,1672596428,1672598670,2242
7751,3333896808,3356860407,1672663144,1672664221,1077
7547,3246596716,3500177712,1672664028,1672665179,1151
7796,3737051610,3791997875,1672557317,1672557649,332
7934,3517077106,3714488548,1672624727,1672628047,3320
7734,3510173870,3634340855,1672549688,1672550010,322
7592,3793848402,3501483568,1672614810,1672615456,646
7564,3501692334,3624761861,1672547395,1672548911,1516
7922,3510126867,3200198928,1672544186,1672547751,3565
7517,3338367113,3922275416,1672622478,1672623910,1432
7736,3701498253,3500658339,1672692708,1672693071,363
7791,3516223597,3511267139,1672656619,1672659060,2441
7749,3430504438,3519556068,1672698942,1672699382,440
7659,3520719611,3615046771,1672649630,1672651627,1997
7983,3780813786,3777443199,1672618751,1672620003,1252
7788,3783206719,3716197887,1672679107,1672682521,3414
7806,3229665776,3374559242,1672697226,1672697837,611
7840,3627937312,3209383861,1672578289,1672579563,1274
7875,3756424865,3772359096,1672569214,1672571678,2464
7508,3514987389,3826633236,1672594695,1672596615,1920
7678,3516909237,3399052055,1672598806,1672600431,1625
7557,3505873261,3859525941,1672571657,1672574706,3049
7491,3304625412,3511271692,1672686652,1672686952,300
7553,3773978034,3367902229,1672620323,1672623740,3417
7892,3760267716,3917278625,1672562278,1672565017,2739
7577,3513201436,3519152550,1672568170,1672570460,2290
7615,3607178184,3373384732,1672642668,1672642860,192
7852,3716835696,3332072298,1672643068,1672646165,3097
7936,3227158514,3823600322,1672552012,1672553343,1331
7749,3904408902,3313564074,1672636936,1672638145,1209
7872,3773120434,3222448362,1672572327,1672575834,3507
7971,3777623166,3509453566,1672692995,1672694941,1946
7842,3488244966,3688683847,1672635124,1672637273,2149
7616,3417587765,3298433163,1672555030,1672558257,3227
7767,3430504438,3418534998,1672547807,1672551131,3324
7823,3533827120,3475396323,1672615417,1672617984,2567
7960,3411618230,3780828689,1672637844,1672639472,1628
7924,3520709480,3791334389,1672702531,1672705168,2637
7739,3429690204,3533810360,1672583171,1672585014,1843
7604,3394539273,3832902928,1672645034,1672647762,2728
7939,3411618230,3774119563,1672567958,1672568815,857
7519,3716273414,3515860749,1672547215,1672548792,1577
7549,3286658957,3625274012,1672640230,1672641231,1001
7889,3520190170,3360993964,1672655984,1672658523,2539
7560,3817621391,3206603608,1672692967,1672693200,233
7573,3276640712,3513454145,1672623731,1672626940,3209
7621,3518408774,3770101921,1672662501,1672664672,2171
7690,3901990690,3492478793,1672610601,1672611383,782
7516,3739106581,3939952128,1672579611,1672582039,2428
7905,3351554343,3710112546,1672576330,1672578827,2497
7970,3710098970,3774298222,1672650394,1672651624,1230
7515,3770763956,3716488385,1672696419,1672699668,3249
7707,3505962865,3516039895,1672617768,1672621350,3582
7530,3518014636,3837094550,1672638213,1672641610,3397
7794,3703013906,3701184889,1672562850,1672565815,2965
7524,3505904952,3773950140,1672588460,1672591196,2736
7657,3511163800,3776513891,1672615224,1672616716,1492
7566,3518496488,3778266283,1672562786,1672566194,3408
7855,3887270940,3519069599,1672618247,1672620201,1954
7946,3760598102,3512837326,1672581077,1672583456,2379
7957,3303705369,3513201436,1672635442,1672638867,3425
7817,3516039895,3416265063,1672679518,1672682132,2614
7558,3811694763,3772758337,1672636269,1672637123,854
7522,3715581279,3627937312,1672688853,1672692104,3251
7918,3666553782,3820354437,1672638251,1672640941,2690
7587,3409474775,3737079798,1672562050,1672563213,1163
7873,3426325549,3816853177,1672658341,1672659922,1581
7820,3978105277,3458539365,1672574381,1672577362,2981
7799,3760992710,3703889596,1672594471,1672597054,2583
7693,3921211276,3780593036,1672601274,1672604529,3255
7621,3733891182,3369998498,1672587192,1672588595,1403
7732,3683766533,3899204805,1672649716,1672651308,1592
7946,3311090974,3484995752,1672560377,1672561178,801
7788,3472130842,3312829208,1672695164,1672695625,461
7882,3511163800,3774050956,1672663883,1672666757,2874
7845,3509604974,3809484172,1672596732,1672598903,2171
7897,3360506772,3384951177,1672576340,1672577332,992
7519,3886298125,3828432634,1672602673,1672603202,529
7588,3600647945,3755881905,1672636241,1672636648,407
7794,3711265369,3793871337,1672547562,1672548119,557
7697,3715998609,3505477652,1672688368,1672691390,3022
7907,3297463265,3511125626,1672601477,1672604117,2640
7652,3396086535,3791020967,1672540382,1672541873,1491
7861,3760492950,3921211276,1672697352,1672698830,1478
7805,3716843669,3776338577,1672699978,1672702053,2075
7620,3770101921,3556951786,1672688443,1672691070,2627
7939,3534488837,3736592744,1672680232,1672683538,3306
7825,3311648200,3772359096,1672618680,1672619372,692
7863,3304625412,3342131135,1672674610,1672676822,2212
7571,3430074045,3682061100,1672649303,1672649864,561
7979,3903962771,3933210486,1672537656,1672539306,1650
7487,3244173074,3793436995,1672567788,1672570909,3121
7679,3800353779,3247428249,1672688908,1672690497,1589
7630,3734828619,3232962003,1672577429,1672578245,816
7818,3489728806,3736790081,1672651201,1672652307,1106
7635,3517077106,3772544062,1672640749,1672643344,2595
7701,3806545488,3511841857,1672623614,1672626657,3043
7615,3234541252,3533653428,1672553475,1672554339,864
7732,3388637594,3519803045,1672703036,1672703497,461
7789,3778266283,3617055293,1672598114,1672598636,522
7943,3633420270,3791334389,1672542660,1672544452,1792
7523,3773814927,3713786889,1672556489,1672557666,1177
7935,3715998609,3493507965,1672597774,1672600835,3061
7686,3800886801,3773664987,1672541501,1672543918,2417
7738,3227457126,3514128943,1672684605,1672684879,274
7494,3731106822,3519700826,1672552161,1672554228,2067
7691,3792902982,3711973519,1672575990,1672579097,3107
7548,3606812411,3627937312,1672566337,1672567280,943
7689,3755943611,3485823740,1672579328,1672579599,271
7875,3791553060,3793086311,1672631321,1672634854,3533
7774,3505859863,3791334389,1672648720,1672650016,1296
7733,3301107849,3756451663,1672676793,1672677329,536
7798,3701984666,3416427576,1672608499,1672610213,1714
7867,3807987001,3391915886,1672680923,1672681992,1069
7847,3360506772,3206593906,1672680736,1672683474,2738
7529,3417970574,3519703355,1672549284,1672552470,3186
7691,3760598102,3505702787,1672659877,1672662804,2927
7967,3514838220,3921211276,1672678881,1672681876,2995
7834,3446948848,3344364444,1672565138,1672566040,902
7972,3555214688,3510594211,1672534413,1672534821,408
7877,3485823740,3505203158,1672592473,1672593143,670
7767,3778108318,3373384732,1672665074,1672668525,3451
7499,3533810360,3383922351,1672667614,1672670225,2611
7520,3714504419,3627937312,1672547130,1672548610,1480
7711,3622054816,3713894336,1672592426,1672592521,95
7639,3809916577,3303705369,1672583778,1672584150,372
7876,3311648200,3859525941,1672562753,1672564800,2047
7624,3417587765,3374559242,1672601002,1672602507,1505
7512,3774125065,3518932404,1672617585,1672619503,1918
7920,3514283243,3760893269,1672583351,1672583962,611
7945,3634340855,3778108318,1672623737,1672624313,576
7684,3511435497,3774793839,1672573149,1672576104,2955
7614,3773978034,3666507626,1672558085,1672558765,680
7784,3404058699,3755392666,1672681756,1672684660,2904
7586,3902383721,3510857360,1672668581,1672669971,1390
7824,3807987001,3664517356,1672673263,1672676677,3414
7491,3931941795,3716900301,1672549342,1672550818,1476
7726,3418534998,3311761694,1672676466,1672679017,2551
7595,3505638204,3227158514,1672590043,1672593426,3383
7844,3735733948,3737079798,1672659777,1672660920,1143
7983,3378686918,3628819436,1672622037,1672622919,882
7931,3489728806,3774268456,1672590571,1672591383,812
7659,3311154569,3760183458,1672567791,1672570900,3109
7534,3809484172,3555214688,1672562885,1672563061,176
7922,3756453423,3509672210,1672643339,1672645201,1862
7922,3338703270,3515860749,1672583481,1672586646,3165
7707,3501730685,3774268456,1672658127,1672661726,3599
7817,3703871468,3774556560,1672625574,1672626873,1299
7931,3356860407,3511435497,1672670742,1672673434,2692
7500,3359239884,3427283336,1672575390,1672576914,1524
7861,3394330287,3533369198,1672627293,1672629994,2701
7786,3780914982,3429690204,1672647660,1672650549,2889
7691,3516909237,3307097200,1672569002,1672571544,2542
7659,3703223015,3319752091,1672551145,1672554298,3153
7704,3516909237,3738274418,1672603479,1672604782,1303
7789,3859663348,3793389510,1672658692,1672660150,1458
7579,3713370078,3249247700,1672697393,1672700105,2712
7921,3733891182,3429856982,1672692786,1672693448,662
7983,3773429448,3783531004,1672690792,1672694259,3467
7688,3348261553,3710098970,1672587344,1672589615,2271
7896,3293695955,3510380060,1672558193,1672561653,3460
7810,3511332835,3664170666,1672626351,1672627973,1622
7568,3793959750,3208844525,1672588986,1672589216,230
7834,3932051427,3885670556,1672638218,1672640954,2736
7798,3509773875,3505477652,1672645135,1672648717,3582
7943,3339907603,3400804807,1672618005,1672621056,3051
7757,3416241005,3793753089,1672565130,1672565473,343
7598,3402943525,3534424200,1672611456,1672613705,2249
7702,3711308224,3519912874,1672691117,1672692194,1077
7844,3780294829,3713208927,1672590277,1672590671,394
7857,3515723720,3772309166,1672617636,1672621143,3507
7537,3313541986,3770447408,1672581881,1672585030,3149
7973,3852595551,3500066230,1672618071,1672621015,2944
7784,3458539365,3817316561,1672649003,1672649902,899
7648,3476232529,3509933351,1672617926,1672619713,1787
7529,3777477395,3880310724,1672668943,1672669835,892
7611,3760489031,3298288268,1672580035,1672582810,2775
7901,3783925755,3514128943,1672598835,1672599985,1150
7957,3515284591,3774793839,1672676309,1672678611,2302
7620,3819727225,3533371364,1672556459,1672557799,1340
7903,3271938399,3533280269,1672566039,1672568916,2877
7686,3509907947,3783429780,1672544779,1672545085,306
7500,3755625324,3515723720,1672604612,1672606810,2198
7615,3311208440,3349613093,1672633602,1672637173,3571
7753,3882291183,3710408395,1672602040,1672605138,3098
7570,3608633356,3711265369,1672703540,1672704333,793
7642,3338367113,3887270940,1672587915,1672590233,2318
7751,3478194807,3430352815,1672683519,1672683992,473
7540,3738502357,3249247700,1672563984,1672564863,879
7903,3511687358,3458539365,1672633005,1672636552,3547
7728,3428674539,3519152550,1672581228,1672582563,1335
7889,3501364586,3780365428,1672574141,1672576515,2374
7720,3520012395,3792768129,1672641444,1672642191,747
7874,3485008994,3780788622,1672635893,1672636674,781
7696,3760598102,3711569060,1672538400,1672539548,1148
7498,3851190615,3791957752,1672561829,1672562467,638
7749,3912536808,3510247121,1672686766,1672687752,986
7757,3407673904,3756528686,1672630552,1672632837,2285
7601,3621497531,3509352754,1672589504,1672590289,785
7517,3885670556,3628819436,1672638250,1672641219,2969
7953,3774010081,3736625083,1672678949,1672679912,963
7963,3710569131,3975287541,1672555543,1672558639,3096
7681,3760492950,3636867411,1672532802,1672536068,3266
7766,3276993580,3500499542,1672659029,1672660387,1358
7504,3501606184,3518791447,1672681542,1672683755,2213
7880,3682061100,3291235378,1672634195,1672634348,153
7518,3757812939,3883551721,1672548685,1672550112,1427
7976,3534492426,3513956646,1672617551,1672620547,2996
7869,3760077057,3367029997,1672649059,1672652561,3502
7737,3430504438,3617734118,1672700933,1672701571,638
7610,3793286136,3505904952,1672680454,1672682740,2286
7604,3421836608,3520376528,1672563881,1672566338,2457
7855,3715492942,3760489031,1672598941,1672601421,2480
7656,3711308224,3386707783,1672624054,1672626591,2537
7504,3510173870,3500729955,1672641463,1672644854,3391
7729,3349613093,3520709480,1672554827,1672556635,1808
7963,3249401741,3509604974,1672625685,1672627079,1394
7881,3517721725,3399004969,1672674636,1672677666,3030
7893,3337544549,3688683847,1672629090,1672632188,3098
7959,3688683847,3778780511,1672696788,1672699121,2333
7747,3432689543,3889750851,1672572906,1672576470,3564
7982,3901990690,3249401741,1672540236,1672540452,216
7663,3777120536,3517721725,1672539524,1672540214,690
7489,3779629905,3221536550,1672533314,1672533550,236
7867,3505193212,3714504419,1672600744,1672603915,3171
7656,3509672210,3280599164,1672634481,1672635325,844
7891,3421127249,3510771358,1672696320,1672696963,643
7958,3899266183,3489728806,1672575677,1672579023,3346
7945,3703718151,3399911573,1672532707,1672534005,1298
7900,3556951786,3514838220,1672636385,1672637186,801
7501,3826633236,3384951177,1672603733,1672605734,2001
7539,3248507722,3505912939,1672680935,1672681002,67
7941,3247815299,3311154569,1672607275,1672608193,918
7651,3552314511,3396086535,1672547764,1672549326,1562
7579,3492478793,3773755137,1672684949,1672688329,3380
7619,3471220483,3703275621,1672695953,1672698365,2412
7755,3221899927,3780813786,1672595475,1672596789,1314
7706,3792384220,3801089989,1672579012,1672580018,1006
7682,3428964059,3407673904,1672697089,1672697588,499
7741,3247428249,3701111745,1672592687,1672596208,3521
7517,3505635228,3783925755,1672607683,1672607760,77
7826,3512540951,3755739653,1672590321,1672591407,1086
7686,3286658957,3515151980,1672650406,1672650816,410
7905,3280964728,3500578848,1672557118,1672559670,2552
7673,3407954858,3715339701,1672536908,1672537571,663
7688,3776066388,3820354437,1672646620,1672649344,2724
7488,3509352754,3760509236,1672676837,1672679679,2842
7721,3533385867,3466229085,1672598626,1672601355,2729
7753,3271938399,3500060260,1672681857,1672683478,1621
7694,3433804879,3448855696,1672550376,1672550892,516
7810,3739106581,3533927138,1672668817,1672669071,254
7561,3703955926,3909238838,1672671823,1672672793,970
7835,3509672210,3420700674,1672593157,1672593482,325
7606,3404384505,3404058699,1672607355,1672609370,2015
7517,3760492950,3914259449,1672588108,1672590662,2554
7939,3783531004,3402943525,1672635636,1672638746,3110
7903,3511687358,3534313900,1672695231,1672696056,825
7708,3621497531,3520751702,1672611998,1672615146,3148
7896,3501483568,3533242305,1672533137,1672535566,2429
7530,3979339287,3478194807,1672634703,1672637613,2910
7647,3434642576,3933210486,1672682989,1672683376,387
7621,3510594211,3972364603,1672605005,1672605195,190
7647,3774005526,3713630656,1672536673,1672537169,496
7802,3911159965,3639847263,1672678876,1672680930,2054
7906,3811694763,3777455223,1672587757,1672588382,625
7880,3770635361,3859525941,1672640999,1672644242,3243
7954,3792288302,3331845324,1672615532,1672615785,253
7502,3501184421,3501606184,1672696218,1672696427,209
7511,3311627628,3910454786,1672539774,1672540680,906
7601,3505347134,3791594391,1672647438,1672650743,3305
7831,3481647420,3206603608,1672650094,1672652741,2647
7937,3338703270,3518876135,1672670464,1672671978,1514
7617,3242408357,3912536808,1672656535,1672659518,2983
7888,3895562476,3716835696,1672677526,1672680988,3462
7529,3220716272,3345207877,1672650797,1672652909,2112
7794,3409474775,3346795719,1672675736,1672676091,355
7511,3500894271,3559110998,1672681268,1672681494,226
7922,3835382117,3777477395,1672594985,1672598575,3590
7662,3302626661,3825229501,1672584402,1672585850,1448
7805,3301107849,3701534009,1672567549,1672569341,1792
7645,3882242815,3206593906,1672538802,1672540170,1368
7699,3666507626,3520888296,1672698749,1672701784,3035
7636,3418728074,3361230905,1672569308,1672572217,2909
7506,3510937904,3505702787,1672584869,1672585029,160
7881,3520183192,3494290908,1672643160,1672645109,1949
7556,3818255890,3416241005,1672604874,1672607170,2296
7866,3373384732,3247428249,1672674240,1672677444,3204
7607,3829232696,3793086311,1672605985,1672607304,1319
7555,3902383721,3772884106,1672651285,1672652222,937
7610,3221536550,3509630174,1672687579,1672690985,3406
7751,3303705369,3914259449,1672647583,1672648159,576
7851,3777079686,3755920131,1672622655,1672624177,1522
7561,3664517356,3792177074,1672688827,1672688945,118
7672,3511841857,3289061738,1672690168,1672692182,2014
7953,3912536808,3777929708,1672583565,1672587129,3564
7603,3757455053,3519069599,1672573635,1672576407,2772
7662,3628819436,3271938399,1672604510,1672604990,480
7494,3606987130,3716746253,1672678548,1672680758,2210
7748,3533369198,3778549126,1672568245,1672568966,721
7660,3518260334,3912536808,1672588083,1672588742,659
7700,3737079798,3244485293,1672569584,1672570170,586
7940,3234541252,3277605882,1672537495,1672538871,1376
7888,3979339287,3509773875,1672568722,1672568991,269
7486,3716488385,3779976989,1672596533,1672598755,2222
7655,3433804879,3466911760,1672672283,1672673914,1631
7607,3791901535,3338703270,1672647081,1672648263,1182
7685,3917088658,3936227020,1672619219,1672621702,2483
7658,3792288302,3713969578,1672640340,1672643707,3367
7913,3888559320,3492478793,1672571292,1672574732,3440
7805,3519700826,3500904641,1672554807,1672557457,2650
7631,3925620998,3909238838,1672535696,1672536829,1133
7570,3494290908,3756930948,1672600427,1672603748,3321
7811,3500805881,3520030713,1672604114,1672604804,690
7687,3520629279,3912262917,1672670425,1672671708,1283
7822,3500374658,3770553384,1672575648,1672578803,3155
7657,3772746272,3793086311,1672560975,1672561687,712
7497,3378436155,3222521619,1672678049,1672679298,1249
7712,3918056059,3910886626,1672552358,1672555887,3529
7585,3520165601,3318166135,1672608734,1672612002,3268
7832,3511687358,3520730271,1672691380,1672691515,135
7765,3608868877,3518876135,1672630810,1672633189,2379
7833,3407954858,3660493209,1672640215,1672643259,3044
7808,3791115967,3333896808,1672612990,1672614654,1664
7703,3978115672,3209027249,1672576461,1672578711,2250
7780,3201324715,3242408357,1672580879,1672582470,1591
7594,3533653428,3480687894,1672610582,1672613956,3374
7946,3819727225,3713208927,1672581312,1672583679,2367
7752,3378092448,3978115672,1672630303,1672630510,207
7847,3714504419,3757246925,1672627809,1672628504,695
7506,3783509527,3500658339,1672572951,1672574289,1338
7629,3510771358,3533369198,1672671456,1672674648,3192
7868,3780828689,3489545239,1672601231,1672602113,882
7864,3293695955,3660493209,1672552861,1672556447,3586
7776,3297463265,3715127362,1672540352,1672543073,2721
7763,3348261553,3510594211,1672655780,1672656610,830
7615,3473562469,3520030713,1672580505,1672583355,2850
7868,3559110998,3760992710,1672631702,1672634564,2862
7847,3520756859,3792768129,1672544648,1672545006,358
7702,3298433163,3516039895,1672608938,1672611064,2126
7561,3970117174,3627937312,1672616141,1672617087,946
7858,3517509185,3777120536,1672695510,1672697513,2003
7510,3505869747,3227158514,1672645882,1672648233,2351
7660,3238712269,3756027749,1672588397,1672590412,2015
7795,3660493209,3713208927,1672559966,1672561408,1442
7698,3496549058,3417061462,1672575580,1672578821,3241
7946,3520030713,3757682496,1672561882,1672562838,956
7927,3289061738,3713786889,1672617892,1672618447,555
7959,3391261292,3832902928,1672531817,1672532453,636
7775,3779976989,3832902928,1672588848,1672591140,2292
7849,3922275416,3505599848,1672688652,1672691445,2793
7483,3533025282,3920801189,1672573963,1672574234,271
7825,3429856982,3404384505,1672593742,1672596343,2601
7944,3634340855,3416427576,1672556730,1672560252,3522
7882,3519069599,3487171044,1672676002,1672679175,3173
7570,3660493209,3772309150,1672653625,1672655375,1750
7856,3793848402,3514245078,1672693985,1672695129,1144
7941,3515284591,3933210486,1672633894,1672634936,1042
7713,3617734118,3629935998,1672703507,1672705294,1787
7569,3891751546,3777623166,1672617920,1672619307,1387
7810,3416427576,3835382117,1672621451,1672624156,2705
7656,3516039895,3511687358,1672652159,1672653777,1618
7782,3716488385,3505201246,1672555463,1672556202,739
7757,3206603608,3817621391,1672571761,1672574095,2334
7560,3776948966,3229665776,1672690992,1672693243,2251
7891,3352603894,3236102733,1672598472,1672600041,1569
7711,3378686918,3917088658,1672572898,1672573772,874
7514,3701065786,3313541986,1672640421,1672640859,438
7962,3510247121,3438645253,1672689102,1672692287,3185
7557,3972709319,3496549058,1672678899,1672681060,2161
7561,3833889105,3921211276,1672670121,1672671526,1405
7901,3828365570,3716900301,1672656749,1672658423,1674
7581,3979339287,3493507965,1672639523,1672639963,440
7694,3505599848,3703661585,1672537359,1672539998,2639
7795,3703661585,3235287260,1672599163,1672599230,67
7496,3311274543,3487171044,1672552915,1672556268,3353
7713,3533280269,3209027249,1672551690,1672551902,212
7782,3713370078,3793286136,1672666729,1672668549,1820
7732,3336742544,3791602225,1672584097,1672584297,200
7724,3512166013,3714821932,1672679773,1672679915,142
7514,3345207877,3246596716,1672578152,1672578503,351
7872,3736419952,3792789881,1672542482,1672543263,781
7678,3519601612,3634786711,1672669908,1672670829,921
7657,3312829208,3515394721,1672547928,1672548056,128
7916,3519069599,3487171044,1672653060,1672653792,732
7947,3515723720,3482405588,1672675941,1672677553,1612
7789,3904408902,3736786443,1672605792,1672609208,3416
7612,3417970574,3509453566,1672663700,1672665933,2233
7673,3637008488,3972709319,1672570153,1672571353,1200
7826,3500803339,3227158514,1672613454,1672613859,405
7688,3509907947,3304625412,1672614052,1672616241,2189
7715,3756930948,3500499542,1672635341,1672635926,585
7718,3396285984,3391915886,1672580628,1672580733,105
7548,3716197887,3823600322,1672548605,1672551325,2720
7768,3510771358,3515125508,1672551514,1672551746,232
7935,3533242305,3613683164,1672673043,1672673103,60
7885,3511125626,3511170269,1672571627,1672574471,2844
7872,3715974031,3774520233,1672635512,1672637904,2392
7580,3303705369,3222448362,1672563109,1672566380,3271
7699,3805347939,3713630656,1672537215,1672538515,1300
7516,3311208440,3914290246,1672584952,1672587842,2890
7896,3481647420,3772642849,1672608642,1672610572,1930
7957,3284832486,3688418210,1672556517,1672557746,1229
7768,3367902229,3793959750,1672613416,1672615773,2357
7894,3500365158,3714197325,1672578701,1672580214,1513
7865,3416241005,3509773875,1672663555,1672664103,548
7942,3520206212,3222521619,1672562314,1672565545,3231
7742,3823600322,3505362057,1672546113,1672547043,930
7541,3512142794,3774204963,1672596865,1672597321,456
7505,3778108318,3711308224,1672676953,1672677717,764
7887,3221536550,3783705817,1672588023,1672591620,3597
7498,3791602225,3828624701,1672535752,1672538340,2588
7967,3389115045,3428006164,1672690924,1672692831,1907
7804,3773120434,3286658957,1672567559,1672570229,2670
7618,3801089989,3793338102,1672688221,1672690730,2509
7727,3817621391,3772714862,1672583766,1672584982,1216
7589,3500199935,3483949762,1672568655,1672571559,2904
7535,3484995752,3793753089,1672676354,1672676518,164
7852,3608633356,3773465237,1672685894,1672687194,1300
7970,3757447189,3757151210,1672701334,1672703119,1785
7933,3804870229,3772309150,1672657014,1672660304,3290
7768,3361230905,3429856982,1672636570,1672639538,2968
7708,3917278625,3715492942,1672687069,1672688662,1593
7657,3885897503,3773978034,1672585929,1672588383,2454
7587,3737079798,3703013906,1672660195,1672662643,2448
7669,3792032359,3792902982,1672627510,1672628058,548
7884,3466911760,3296471982,1672549380,1672549718,338
7532,3935127663,3779740455,1672534126,1672537020,2894
7665,3613995936,3505098372,1672624727,1672628229,3502
7951,3206593906,3407954858,1672595874,1672596044,170
7845,3774005526,3247815299,1672649059,1672650245,1186
7792,3301107849,3773755137,1672670762,1672673303,2541
7648,3505201246,3209551760,1672626555,1672627212,657
7971,3826759140,3755042098,1672631407,1672633515,2108
7972,3344019610,3518260334,1672590389,1672593813,3424
7517,3621810464,3791957752,1672697451,1672698078,627
7724,3783126683,3779740455,1672628092,1672628402,310
7604,3756424865,3372883226,1672596987,1672599698,2711
7502,3517459919,3511862351,1672642446,1672642746,300
7743,3618873142,3807987001,1672547015,1672547652,637
7937,3774793839,3915628728,1672691397,1672693752,2355
7781,3760598102,3710067113,1672624021,1672626594,2573
7752,3276640712,3701065786,1672674731,1672676056,1325
7619,3533827120,3223968713,1672588609,1672589581,972
7654,3311871871,3716843669,1672640289,1672642427,2138
7839,3710112546,3817621391,1672656599,1672659187,2588
7694,3518791447,3446948848,1672535168,1672538403,3235
7704,3477375368,3238712269,1672625363,1672627308,1945
7980,3533137446,3714962248,1672645774,1672648515,2741
7944,3770078063,3359239884,1672610649,1672611793,1144
7843,3772578994,3685818092,1672598514,1672600545,2031
7612,3739106581,3829764737,1672697530,1672699779,2249
7648,3756623396,3514719601,1672651108,1672652746,1638
7735,3389115045,3777776687,1672677701,1672678146,445
7518,3519654779,3489217083,1672607201,1672609407,2206
7541,3379589402,3710569131,1672672715,1672676076,3361
7692,3772714862,3776948966,1672664751,1672668209,3458
7706,3792668962,3778266283,1672555706,1672557877,2171
7930,3828624701,3715581279,1672656041,1672656962,921
7743,3516065852,3883085535,1672571291,1672572994,1703
7666,3826415738,3757455053,1672583486,1672584031,545
7815,3851190615,3512166013,1672590956,1672591540,584
7959,3248507722,3496549058,1672664604,1672666213,1609
7593,3351554343,3386707783,1672564658,1672567508,2850
7918,3220716272,3978105277,1672669203,1672671486,2283
7569,3297463265,3509672210,1672555066,1672555970,904
7919,3273500349,3288764520,1672572081,1672572249,168
7743,3711571712,3505599848,1672668843,1672671640,2797
7934,3311718847,3296471982,1672637680,1672639202,1522
7773,3755739653,3772884106,1672617140,1672618872,1732
7703,3882997884,3511163800,1672571903,1672574130,2227
7941,3430352815,3533385867,1672644341,1672646989,2648
7957,3501606184,3804870229,1672645896,1672647100,1204
7964,3791997875,3510703546,1672599889,1672601308,1419
7942,3533280269,3889750851,1672617044,1672620349,3305
7491,3835382117,3883085535,1672635290,1672635694,404
7662,3404384505,3430074045,1672551953,1672553169,1216
7971,3792883665,3388637594,1672672046,1672674851,2805
7978,3774466457,3770078063,1672703376,1672704164,788
7846,3801089989,3276640712,1672618630,1672621769,3139
7903,3816454165,3227457126,1672628415,1672630101,1686
7557,3513599775,3517864478,1672702481,1672703489,1008
7687,3711198793,3518163778,1672633577,1672635739,2162
7710,3454042520,3505173328,1672540095,1672543161,3066
7895,3428964059,3809484172,1672626209,1672627836,1627
7557,3519152550,3778980116,1672655340,1672657285,1945
7720,3512567240,3311090974,1672609438,1672612547,3109
7951,3500391167,3236102733,1672598026,1672601023,2997
7618,3534729133,3428006164,1672598668,1672600689,2021
7825,3511332835,3793848402,1672549697,1672549999,302
7837,3715492942,3639847263,1672638618,1672639478,860
7825,3755392666,3510703546,1672653911,1672655082,1171
7521,3515151980,3939952128,1672689558,1672691301,1743
7970,3286658957,3711308224,1672593604,1672596163,2559
7646,3899204805,3520931254,1672570490,1672573087,2597
7507,3359239884,3365830990,1672616176,1672619646,3470
7975,3776513891,3760267716,1672649206,1672649516,310
7714,3559110998,3818255890,1672592243,1672594059,1816
7761,3339907603,3516258476,1672651532,1672652897,1365
7882,3755943611,3755739653,1672644487,1672645781,1294
7740,3391261292,3427219654,1672651855,1672652470,615
7723,3829764737,3505859863,1672532948,1672535294,2346
7779,3756462516,3770635361,1672582323,1672585741,3418
7567,3201324715,3703718151,1672605299,1672606807,1508
7532,3399052055,3625274012,1672626540,1672628355,1815
7551,3311761694,3710067113,1672539118,1672540905,1787
7909,3881477378,3736790081,1672611788,1672615009,3221
7757,3285400528,3834257412,1672616582,1672619526,2944
7489,3338367113,3773120434,1672572980,1672573661,681
7558,3773755137,3348261553,1672549480,1672550460,980
7930,3733189298,3828365570,1672688227,1672689571,1344
7530,3820354437,3783429780,1672547720,1672548707,987
7857,3733189298,3505791599,1672538654,1672542069,3415
7539,3772053179,3793286136,1672584666,1672587329,2663
7494,3201324715,3666507626,1672619947,1672622983,3036
7778,3400804807,3701534009,1672618658,1672620220,1562
7838,3411618230,3770101921,1672693256,1672694272,1016
7658,3514472925,3509604974,1672634552,1672637088,2536
7941,3361230905,3918056059,1672658780,1672658892,112
7657,3618045231,3514245078,1672576989,1672580449,3460
7492,3634340855,3533748232,1672596139,1672599576,3437
7541,3311845971,3500578848,1672670131,1672671195,1064
7656,3711569060,3777929708,1672536212,1672537265,1053
7907,3500229033,3505635228,1672560397,1672561924,1527
7912,3351008918,3777936328,1672686204,1672687829,1625
7590,3793871337,3342131135,1672637834,1672639590,1756
7893,3244485293,3715998609,1672570118,1672571630,1512
7515,3392121505,3760077057,1672692174,1672692537,363
7587,3475258557,3793871337,1672639094,1672640047,953
7598,3777936328,3466911760,1672659463,1672661238,1775
7776,3756528686,3739106581,1672562044,1672562417,373
7978,3703013906,3360506772,1672624943,1672625401,458
7907,3716197887,3505219850,1672627078,1672628982,1904
7670,3286658957,3520709480,1672609292,1672610995,1703
7703,3294803686,3520888296,1672630295,1672633605,3310
7711,3517459919,3730517636,1672654980,1672658330,3350
7932,3344364444,3909331423,1672540137,1672542211,2074
7509,3760492950,3975287541,1672585552,1672587168,1616
7601,3301107849,3345207877,1672630525,1672631944,1419
7684,3516909237,3417587765,1672683404,1672686502,3098
7953,3682061100,3357483218,1672560468,1672563048,2580
7982,3550946908,3791115967,1672538019,1672539378,1359
7761,3913251733,3505638204,1672650165,1672652472,2307
7753,3428674539,3201324715,1672611900,1672614048,2148
7890,3357483218,3439023335,1672693139,1672696068,2929
7769,3711571712,3608868877,1672681339,1672681767,428
7632,3836573197,3311415018,1672602520,1672605101,2581
7601,3777929708,3701498253,1672666232,1672668976,2744
7962,3533095755,3512969370,1672534460,1672536051,1591
7970,3378436155,3416427576,1672634976,1672637934,2958
7765,3500894271,3783925755,1672539530,1672542429,2899
7576,3912536808,3613995936,1672635455,1672636472,1017
7587,3703789494,3311648200,1672618027,1672620073,2046
7965,3807987001,3208844525,1672691769,1672693166,1397
7755,3434642576,3399433690,1672639713,1672643288,3575
7490,3517459919,3247780536,1672620159,1672621364,1205
7887,3361230905,3488244966,1672545371,1672546686,1315
7796,3500374658,3249791738,1672679468,1672681841,2373
7628,3533270638,3628819436,1672634620,1672637295,2675
7538,3780609808,3500458761,1672569187,1672569645,458
7903,3734737881,3501730685,1672547560,1672548963,1403
7531,3774580701,3512540951,1672597120,1672598369,1249
7583,3533371364,3360506772,1672535686,1672538178,2492
7915,3509352754,3735733948,1672608464,1672610636,2172
7740,3664170666,3918247820,1672551939,1672553964,2025
7975,3520629279,3483164654,1672600668,1672602497,1829
7805,3238712269,3519654779,1672546485,1672546842,357
7749,3277669002,3756462516,1672671667,1672673126,1459
7608,3792177074,3315583351,1672563605,1672564835,1230
7571,3520756859,3735733948,1672613984,1672617421,3437
7669,3439023335,3806545488,1672660784,1672663120,2336
7812,3780974443,3505173328,1672559720,1672561062,1342
7956,3484995752,3500805881,1672608921,1672612467,3546
7667,3404058699,3909331423,1672641346,1672644900,3554
7567,3859525941,3701146057,1672641847,1672643062,1215
7845,3520719611,3776800213,1672616822,1672619290,2468
7618,3377766165,3418534998,1672658615,1672659712,1097
7506,3701498253,3920801189,1672592429,1672593196,767
7652,3811694763,3311439795,1672639378,1672641094,1716
7892,3500904641,3731106822,1672640978,1672641343,365
7975,3885897503,3519428855,1672626618,1672629803,3185
7725,3633420270,3516606733,1672626366,1672628677,2311
7877,3621810464,3800353779,1672616861,1672620345,3484
7845,3625274012,3811694763,1672559607,1672563006,3399
7778,3534702203,3505219850,1672647567,1672648343,776
7801,3515691540,3409474775,1672638329,1672639664,1335
7659,3520030713,3715581279,1672687446,1672689826,2380
7873,3392121505,3384240055,1672671188,1672673067,1879
7661,3777806071,3772642849,1672582545,1672584318,1773
7826,3311274543,3610695419,1672645418,1672648427,3009
7629,3826759140,3534191820,1672565827,1672567145,1318
7503,3703889596,3606987130,1672617682,1672618448,766
7768,3500803339,3220716272,1672570860,1672572321,1461
7616,3915628728,3277605882,1672566315,1672567931,1616
7639,3517077106,3232962003,1672559999,1672562786,2787
7684,3791957752,3227158514,1672651135,1672652810,1675
7838,3685818092,3221899927,1672534014,1672536499,2485
7503,3793962300,3311439795,1672557796,1672560352,2556
7983,3235287260,3501759100,1672588777,1672592261,3484
7901,3224716315,3714504419,1672691352,1672694757,3405
7511,3511332835,3772309150,1672558096,1672559469,1373
7836,3533371364,3805292782,1672580871,1672583820,2949
7484,3518791447,3770635361,1672563561,1672566013,2452
7880,3512567240,3772309150,1672561516,1672563526,2010
7730,3774466457,3249791738,1672664720,1672665500,780
7939,3922275416,3311439795,1672558027,1672560354,2327
7558,3888559320,3533280269,1672565864,1672568775,2911
7632,3716273414,3774466457,1672618202,1672620537,2335
7756,3293695955,3827626797,1672551500,1672554677,3177
7554,3276993580,3229665776,1672674066,1672676468,2402
7855,3500060260,3774580701,1672657257,1672657712,455
7638,3755511676,3710569131,1672619535,1672619737,202
7637,3703735129,3777623166,1672592590,1672595185,2595
7758,3516465662,3783206719,1672614393,1672614938,545
7941,3224716315,3777623166,1672677564,1672678025,461
7849,3311761694,3285400528,1672589202,1672589790,588
7719,3510173870,3773664987,1672620967,1672621892,925
7628,3459030804,3713268590,1672695112,1672695977,865
7871,3891751546,3611150562,1672681098,1672681776,678
7483,3736592744,3513201436,1672649191,1672650550,1359
7856,3770447408,3777079686,1672600237,1672602664,2427
7646,3493507965,3772544062,1672623251,1672626000,2749
7762,3500803339,3772309150,1672628162,1672631322,3160
7486,3365614305,3519912874,1672643606,1672644751,1145
7630,3318166135,3500060260,1672673587,1672677011,3424
7603,3682061100,3338367113,1672686140,1672687004,864
7669,3344364444,3518260334,1672697467,1672698989,1522
7722,3512349371,3511332835,1672684460,1672685664,1204
7527,3757455053,3895562476,1672594863,1672598463,3600
7612,3421127249,3500729955,1672699983,1672701694,1711
7611,3301107849,3607178184,1672659131,1672662728,3597
7755,3520206212,3512837326,1672555956,1672559267,3311
7539,3200691026,3533369198,1672613654,1672617124,3470
7602,3755587522,3774125065,1672692865,1672694942,2077
7637,3780974443,3735319397,1672545807,1672548553,2746
7847,3760077057,3932051427,1672591603,1672592869,1266
7969,3735319397,3533270638,1672593007,1672595808,2801
7483,3621810464,3512683609,1672620237,1672621590,1353
7797,3715998609,3411618230,1672700232,1672700916,684
7844,3629547065,3760183458,1672672139,1672673956,1817
7498,3939952128,3701691675,1672586862,1672588514,1652
7967,3736625083,3373384732,1672595861,1672597962,2101
7773,3716168623,3711262377,1672674839,1672675672,833
7707,3755739653,3520165601,1672610374,1672611507,1133
7787,3755881905,3710569131,1672590774,1672593207,2433
7618,3772359096,3249401741,1672629078,1672630260,1182
7624,3512166013,3826633236,1672595701,1672598737,3036
7950,3731419510,3518260334,1672688158,1672690835,2677
7770,3342131135,3533270638,1672618860,1672619052,192
7510,3852391257,3978115672,1672703239,1672703982,743
7930,3901877072,3733891182,1672650658,1672652823,2165
7600,3793470489,3244485293,1672621975,1672624348,2373
7912,3716835696,3520888296,1672676813,1672677369,556
7594,3387674757,3975287541,1672572348,1672573812,1464
7656,3311718847,3434642576,1672683250,1672684878,1628
7559,3773429448,3629935998,1672569415,1672570437,1022
7948,3755739653,3774119563,1672609032,1672611746,2714
7677,3465202715,3515125508,1672701514,1672704990,3476
7724,3885670556,3978115672,1672603754,1672605013,1259
7847,3505135325,3443698222,1672551862,1672552776,914
7516,3512969370,3505962865,1672569181,1672569257,76
7600,3973560347,3277605882,1672544632,1672547496,2864
7787,3837094550,3273500349,1672582649,1672582971,322
7511,3307512479,3807987001,1672556312,1672559657,3345
7966,3772884106,3505135325,1672629441,1672631127,1686
7730,3808324264,3624312512,1672612678,1672613108,430
7694,3318166135,3534010629,1672665666,1672668486,2820
7589,3511332835,3834257412,1672623867,1672625074,1207
7687,3776066388,3520931254,1672550723,1672551015,292
7930,3222521619,3399004969,1672552030,1672554811,2781
7558,3512720680,3793389510,1672635896,1672637551,1655
7548,3701111745,3515151980,1672644182,1672647531,3349
7550,3770763956,3605726278,1672637086,1672637537,451
7977,3701111745,3332072298,1672669809,1672671594,1785
7676,3633420270,3895562476,1672589866,1672591761,1895
7960,3779218771,3936227020,1672661206,1672663855,2649
7939,3307097200,3311324983,1672693990,1672694676,686
7951,3505098372,3688418210,1672567798,1672570935,3137
7504,3318166135,3505962865,1672668833,1672670733,1900
7950,3811694763,3520888296,1672651300,1672653416,2116
7558,3514472925,3736419952,1672572646,1672575808,3162
7518,3515394721,3514838220,1672637689,1672641183,3494
7776,3505635228,3666507626,1672635979,1672637116,1137
7931,3760267716,3899371911,1672668649,1672671332,2683
7581,3774125065,3737154119,1672648921,1672651322,2401
7783,3624761861,3416265063,1672561755,1672564804,3049
7889,3774050956,3916289176,1672583325,1672583593,268
7711,3756930948,3778980116,1672654285,1672656068,1783
7810,3481502100,3312333615,1672580812,1672583409,2597
7641,3465202715,3931941795,1672630150,1672631980,1830
7865,3497901842,3792844210,1672655241,1672656691,1450
7977,3734496778,3662180254,1672606971,1672608333,1362
7798,3247815299,3387674757,1672554743,1672558057,3314
7542,3760561634,3711504540,1672691850,1672692559,709
7922,3466911760,3407954858,1672559906,1672562134,2228
7800,3471220483,3505477652,1672654347,1672655626,1279
7939,3509453566,3909331423,1672675643,1672678272,2629
7544,3857349323,3757602960,1672638920,1672641943,3023
7592,3505193212,3738274418,1672610424,1672612201,1777
7698,3826633236,3716197887,1672699079,1672699526,447
7694,3716273414,3369998498,1672635592,1672637912,2320
7834,3915628728,3501606184,1672555266,1672556725,1459
7634,3291227780,3701995648,1672676155,1672677442,1287
7961,3736786443,3505635228,1672669914,1672671421,1507
7563,3716537575,3554917400,1672641365,1672644124,2759
7758,3770851318,3636867411,1672670167,1672672228,2061
7945,3520165601,3348261553,1672597659,1672600450,2791
7816,3817621391,3783509527,1672614350,1672616818,2468
7878,3770635361,3711504540,1672699415,1672702676,3261
7574,3780294829,3505347134,1672577000,1672580327,3327
7759,3918056059,3757447189,1672601504,1672604572,3068
7915,3613995936,3505873261,1672570521,1672574080,3559
7607,3714962248,3770553384,1672665427,1672665706,279
7653,3778305740,3501486692,1672651711,1672652217,506
7857,3364543015,3511271692,1672551457,1672554554,3097
7895,3774005526,3509672210,1672584748,1672588307,3559
7948,3914259449,3533280269,1672587353,1672587743,390
7811,3247780536,3778549126,1672538446,1672539034,588
7560,3454042520,3505347134,1672554042,1672555407,1365
7638,3738274418,3773120434,1672681447,1672684895,3448
7852,3770851318,3417970574,1672672720,1672673281,561
7688,3516016437,3791602225,1672535597,1672538077,2480
7895,3826760240,3511359172,1672684129,1672686691,2562
7672,3608868877,3777623166,1672585320,1672586575,1255
7598,3779740455,3791594391,1672549952,1672553281,3329
7720,3516673015,3828432634,1672690455,1672690751,296
7487,3883312122,3314836094,1672591949,1672594113,2164
7937,3332072298,3533827120,1672615957,1672617579,1622
7584,3756966035,3777455223,1672584839,1672586509,1670
7737,3475251781,3715127362,1672639504,1672641056,1552
7820,3978115672,3489545239,1672693305,1672694187,882
7712,3911245524,3778780511,1672568864,1672569850,986
7499,3837094550,3793086311,1672666877,1672669004,2127
7710,3731106822,3367902229,1672557633,1672559281,1648
7600,3783509527,3852391257,1672558277,1672559705,1428
7612,3420432297,3291227780,1672686225,1672686631,406
7817,3760561634,3291227780,1672664854,1672665552,698
7871,3881477378,3510173870,1672598240,1672599646,1406
7888,3518791447,3836573197,1672571113,1672571865,752
7705,3311154569,3899266183,1672535644,1672538597,2953
7570,3783196518,3610695419,1672699565,1672700789,1224
7651,3438645253,3629935998,1672703749,1672705322,1573
7595,3511359172,3513599775,1672669742,1672672147,2405
7829,3311324983,3500060260,1672598457,1672601002,2545
7574,3829764737,3756930948,1672534127,1672537157,3030
7669,3505649239,3509453566,1672659382,1672659866,484
7630,3716835696,3516606733,1672612482,1672613342,860
7932,3520931254,3533137446,1672559166,1672561177,2011
7535,3511435497,3792177074,1672658821,1672661197,2376
7867,3223789409,3701178711,1672698262,1672698434,172
7669,3780914982,3760489031,1672660427,1672661732,1305
7900,3475396323,3852595551,1672605009,1672607996,2987
7585,3229665776,3505635228,1672580503,1672580608,105
7947,3511163800,3533385867,1672684161,1672684455,294
7744,3760598102,3509630174,1672568056,1672571628,3572
7705,3311871871,3617734118,1672635894,1672638807,2913
7562,3360993964,3311439795,1672651211,1672653866,2655
7793,3430504438,3311718847,1672589339,1672589622,283
7606,3516016437,3851190615,1672558148,1672559228,1080
7919,3294803686,3392121505,1672702683,1672703885,1202
7839,3385763781,3475396323,1672532843,1672533742,899
7942,3617734118,3411618230,1672574843,1672575771,928
7919,3607178184,3713268590,1672682582,1672683800,1218
7800,3621810464,3500658339,1672567982,1672568263,281
7831,3778341199,3365278081,1672602942,1672605298,2356
7580,3443698222,3467773920,1672665461,1672666206,745
7709,3478194807,3783126683,1672543418,1672544442,1024
7948,3505635228,3446948848,1672599925,1672600003,78
7663,3757403279,3505635228,1672656964,1672658431,1467
7676,3757682496,3634340855,1672586264,1672588232,1968
7498,3516960534,3520190170,1672633835,1672634776,941
7976,3501927421,3516606733,1672652760,1672654139,1379
7524,3482405588,3505791599,1672668773,1672670479,1706
7936,3379589402,3711569060,1672695203,1672695580,377
7578,3533095755,3395152943,1672668286,1672670135,1849
7801,3534010629,3889750851,1672672096,1672673039,943
7851,3633420270,3351008918,1672616516,1672618727,2211
7977,3777079686,3303705369,1672670285,1672670930,645
7660,3889232789,3518876135,1672626208,1672628612,2404
7929,3685187183,3501364586,1672617272,1672620456,3184
7934,3294803686,3533653428,1672645366,1672646788,1422
7822,3406784491,3509773875,1672603343,1672605043,1700
7595,3930797455,3512217942,1672556560,1672559226,2666
7796,3378686918,3910454786,1672677023,1672679248,2225
7770,3912536808,3777120536,1672623710,1672627052,3342
7745,3234541252,3386707783,1672534624,1672535259,635
7961,3703871468,3505173328,1672656522,1672659744,3222
7595,3505292701,3666507626,1672626904,1672628091,1187
7834,3505145247,3510247121,1672540094,1672541691,1597
7782,3792384220,3607178184,1672617651,1672620685,3034
7794,3802367797,3520751702,1672604325,1672606675,2350
7942,3337544549,3487171044,1672612963,1672613823,860
7675,3448855696,3777790718,1672676688,1672678757,2069
7774,3770851318,3286658957,1672597558,1672600884,3326
7966,3774125065,3473765852,1672679429,1672681790,2361
7936,3209383861,3756451663,1672626516,1672627057,541
7593,3533626375,3914290246,1672617064,1672620156,3092
7605,3517459919,3713969578,1672688808,1672690521,1713
7580,3430504438,3809484172,1672632489,1672633767,1278
7789,3890149705,3827377568,1672573339,1672574459,1120
7558,3209383861,3411618230,1672606097,1672608980,2883
7624,3774366875,3473765852,1672623269,1672625823,2554
7849,3791594391,3805342762,1672594043,1672595332,1289
7743,3505859863,3500374658,1672626640,1672628413,1773
7839,3780813786,3500894271,1672679599,1672682808,3209
7619,3710408395,3500365158,1672683802,1672684677,875
7666,3903962771,3780813786,1672666397,1672669963,3566
7967,3473765852,3379256399,1672659926,1672662576,2650
7966,3660493209,3756027749,1672667705,1672670895,3190
7631,3816454165,3520376528,1672613025,1672614532,1507
7487,3701178711,3770824086,1672636347,1672639235,2888
7553,3737079798,3513201436,1672652159,1672653114,955
7542,3935127663,3713268590,1672581867,1672582230,363
7559,3514719601,3778980116,1672701787,1672705245,3458
7937,3221536550,3701146057,1672621753,1672623182,1429
7492,3332072298,3505635228,1672561141,1672561646,505
7946,3925620998,3222448362,1672646404,1672648981,2577
7578,3637008488,3777717988,1672619611,1672620789,1178
7934,3209027249,3760294205,1672576560,1672576684,124
7748,3666553782,3384240055,1672588321,1672591103,2782
7744,3501198706,3412980697,1672540972,1672542853,1881
7513,3383922351,3515860749,1672589567,1672592544,2977
7707,3399004969,3760509236,1672541279,1672542728,1449
7568,3316222192,3710098970,1672618272,1672618670,398
7514,3489962019,3688418210,1672702227,1672704077,1850
7611,3298433163,3913251733,1672691088,1672693056,1968
7564,3483949762,3895562476,1672554629,1672557640,3011
7540,3772758337,3518014636,1672671371,1672672049,678
7686,3918056059,3791874383,1672595630,1672598988,3358
7589,3519428855,3732481297,1672617290,1672617871,581
7941,3513454145,3384951177,1672547882,1672548670,788
7829,3973560347,3224716315,1672675477,1672677317,1840
7522,3791997875,3478194807,1672604941,1672605211,270
7602,3757455053,3500177712,1672655915,1672658456,2541
7572,3223789409,3756027749,1672579493,1672580569,1076
7488,3776800213,3756601594,1672534042,1672537265,3223
7616,3617734118,3514245078,1672654482,1672656831,2349
7533,3209027249,3826760240,1672682437,1672684430,1993
7577,3839849341,3359239884,1672630551,1672633944,3393
7824,3443698222,3518496488,1672665993,1672668519,2526
7977,3880285638,3394330287,1672595273,1672596304,1031
7485,3315583351,3911245524,1672544146,1672546553,2407
7921,3481502100,3227158514,1672649997,1672651222,1225
7763,3244485293,3201432789,1672691461,1672693325,1864
7760,3791657947,3374559242,1672547458,1672548172,714
7919,3512969370,3736786443,1672612607,1672614094,1487
7810,3517476351,3716746253,1672552303,1672553417,1114
7741,3774520233,3512349371,1672567489,1672569476,1987
7788,3520751702,3793286136,1672553030,1672554729,1699
7693,3783705817,3516514391,1672596154,1672597730,1576
7581,3604539807,3311090974,1672659424,1672659905,481
7736,3383661227,3311603601,1672594137,1672597582,3445
7955,3774501422,3227457126,1672605159,1672608130,2971
7966,3889750851,3760294205,1672621011,1672622039,1028
7584,3209027249,3811171116,1672675190,1672677164,1974
7961,3793086311,3338367113,1672654558,1672657349,2791
7975,3399433690,3520629279,1672678308,1672681320,3012
7620,3616944364,3792384220,1672551392,1672551582,190
7922,3229058858,3783206719,1672592789,1672593622,833
7750,3514838220,3520931254,1672590579,1672592910,2331
7893,3825229501,3917278625,1672696386,1672696835,449
7947,3533095755,3792768129,1672693172,1672694831,1659
7945,3533748232,3518791447,1672591309,1672592826,1517
7718,3807987001,3811694763,1672693642,1672695170,1528
7814,3416427576,3418534998,1672675477,1672677205,1728
7983,3416241005,3792768129,1672560806,1672562760,1954
7567,3606987130,3713808837,1672664275,1672664664,389
7939,3756451663,3311415018,1672699460,1672702477,3017
7596,3836573197,3416265063,1672579333,1672580073,740
7922,3772309150,3976390453,1672552387,1672554396,2009
7697,3791997875,3301107849,1672579560,1672583099,3539
7911,3500199935,3297463265,1672656456,1672659351,2895
7681,3386707783,3757161914,1672648921,1672651074,2153
7638,3778305740,3533369198,1672618452,1672620909,2457
7544,3505859863,3776513891,1672671612,1672673442,1830
7561,3715998609,3778308417,1672615375,1672617599,2224
7621,3509630174,3485823740,1672629800,1672631176,1376
7641,3760992710,3511267139,1672644359,1672646985,2626
7958,3774045700,3505201246,1672601686,1672603487,1801
7814,3791115967,3303705369,1672580125,1672583025,2900
7658,3332072298,3517864478,1672637183,1672637716,533
7763,3516514391,3792789881,1672664003,1672665708,1705
7777,3514245078,3520190170,1672622551,1672624729,2178
7765,3756021689,3735733948,1672636765,1672638981,2216
7876,3399535232,3289061738,1672533555,1672535517,1962
7862,3628819436,3816853177,1672570967,1672572047,1080
7534,3911245524,3511312803,1672687788,1672689245,1457
7531,3334033993,3778980116,1672582522,1672585076,2554
7723,3520719611,3505791599,1672590628,1672592562,1934
7907,3316222192,3505649239,1672691828,1672693068,1240
7714,3346795719,3439023335,1672531632,1672534479,2847
7843,3793470489,3915628728,1672546168,1672549645,3477
7809,3774556560,3533137446,1672577079,1672577226,147
7875,3466229085,3511841857,1672613055,1672614225,1170
7627,3925620998,3774045700,1672695109,1672695744,635
7655,3772746272,3389115045,1672544375,1672546614,2239
7980,3511312803,3500374658,1672629758,1672630501,743
7978,3391915886,3511350608,1672652813,1672656080,3267
7712,3505962865,3518260334,1672622849,1672624295,1446
7800,3484995752,3883312122,1672631091,1672634343,3252
7549,3683959482,3772642849,1672603433,1672604783,1350
7597,3420700674,3770763956,1672539094,1672540148,1054
7981,3818255890,3793753089,1672677334,1672679436,2102
7727,3396285984,3512837326,1672642933,1672646311,3378
7799,3396086535,3516258476,1672606803,1672607502,699
7594,3514245078,3779528381,1672547844,1672547985,141
7790,3756528686,3772309166,1672646628,1672647194,566
7728,3336751428,3209551760,1672701535,1672704902,3367
7804,3518876135,3505635228,1672699887,1672703130,3243
7936,3236102733,3616944364,1672634481,1672637719,3238
7846,3701967560,3311415018,1672547705,1672549428,1723
7760,3793338102,3415443558,1672599076,1672600616,1540
7552,3756601594,3497901842,1672553335,1672553991,656
7822,3395152943,3311065516,1672585170,1672586156,986
7935,3791942683,3426325549,1672656682,1672659627,2945
7954,3489962019,3931941795,1672534491,1672535917,1426
7677,3311274543,3921211276,1672609397,1672610717,1320
7557,3514838220,3294803686,1672670179,1672670621,442
7794,3513454145,3791657947,1672649507,1672652674,3167
7956,3505904952,3791874383,1672689347,1672690980,1633
7558,3774125065,3518014404,1672699831,1672700260,429
7714,3304625412,3432665384,1672614072,1672615790,1718
7673,3668005723,3383922351,1672673411,1672674789,1378
7641,3891751546,3303751772,1672541781,1672543592,1811
7940,3394330287,3365830990,1672602735,1672604539,1804
7523,3682061100,3760267716,1672618105,1672618446,341
7624,3760294205,3688418210,1672701834,1672704100,2266
7753,3774556560,3827222533,1672616770,1672617884,1114
7587,3244436890,3733189298,1672676996,1672678094,1098
7809,3715974031,3805292782,1672596935,1672598668,1733
7963,3791901535,3416427576,1672583540,1672585167,1627
7951,3533280269,3606186086,1672634653,1672636665,2012
7702,3516606733,3972364603,1672585114,1672585959,845
7700,3515284591,3515151980,1672645717,1672645978,261
7623,3488244966,3777455223,1672663499,1672666364,2865
7674,3206593906,3284832486,1672603951,1672605120,1169
7628,3511125626,3511312803,1672597915,1672600120,2205
7560,3511163800,3377766165,1672611637,1672614881,3244
7631,3509773875,3711504540,1672577672,1672579586,1914
7729,3500060260,3780813786,1672614170,1672614926,756
7854,3829764737,3231056870,1672546435,1672546799,364
7674,3231056870,3617055293,1672587506,1672588665,1159
7891,3415443558,3209027249,1672613612,1672614527,915
7629,3664517356,3755739653,1672681872,1672683272,1400
7845,3500803339,3534191820,1672693486,1672694203,717
7664,3773598056,3777079686,1672552454,1672554099,1645
7613,3608868877,3760992710,1672676386,1672676952,566
7956,3412980697,3756424865,1672650659,1672650925,266
7501,3510247121,3703735129,1672606058,1672608230,2172
7735,3882291183,3714962248,1672536583,1672539037,2454
7505,3362000049,3429690204,1672578209,1672578329,120
7649,3688683847,3509453566,1672545545,1672547079,1534
7597,3774050956,3772544062,1672608117,1672609811,1694
7588,3731106822,3559110998,1672648413,1672649819,1406
7842,3346327502,3519803045,1672545904,1672547843,1939
7545,3428674539,3534488837,1672544575,1672547358,2783
7906,3517509185,3247815299,1672649924,1672651616,1692
7537,3827222533,3610695419,1672622148,1672622552,404
7974,3735733948,3510126867,1672573153,1672574401,1248
7723,3520183192,3793286136,1672654411,1672656891,2480
7857,3716488385,3291235378,1672588147,1672591413,3266
7721,3399004969,3701863557,1672703824,1672705330,1506
7886,3339907603,3515723720,1672608746,1672611643,2897
7713,3389115045,3534191820,1672613189,1672613600,411
7524,3903307060,3301107849,1672617379,1672617593,214
7720,3774298222,3791997875,1672634473,1672635950,1477
7715,3901877072,3713349754,1672653627,1672655169,1542
7737,3827377568,3533369198,1672677811,1672679278,1467
7898,3519556068,3701190899,1672623603,1672624191,588
7880,3933210486,3485375593,1672573477,1672574124,647
7582,3505145247,3505702787,1672598835,1672600200,1365
7934,3519912874,3703735129,1672604585,1672607965,3380
7599,3277605882,3639847263,1672683947,1672685245,1298
7704,3312333615,3805342762,1672588849,1672590039,1190
7930,3222521619,3683766533,1672614142,1672614539,397
7643,3516065852,3932051427,1672682200,1672683111,911
7581,3505173328,3827377568,1672669527,1672670380,853
7631,3209027249,3433804879,1672627912,1672629049,1137
7717,3505869747,3311627628,1672547912,1672548349,437
7888,3791553060,3220716272,1672635364,1672637299,1935
7721,3773978034,3311603601,1672627360,1672627804,444
7780,3666457294,3505347134,1672661358,1672663192,1834
7700,3519152550,3291227780,1672602607,1672604929,2322
7940,3533371364,3633420270,1672699211,1672702678,3467
7727,3505635228,3791942683,1672589620,1672592070,2450
7526,3428674539,3736229191,1672606594,1672607936,1342
7810,3520206212,3247815299,1672597733,1672599886,2153
7623,3829764737,3755943611,1672665849,1672667074,1225
7730,3338703270,3713268590,1672599785,1672603066,3281
7778,3778305740,3448855696,1672648661,1672651165,2504
7954,3668005723,3459030804,1672663344,1672665415,2071
7534,3773205565,3556951786,1672697889,1672701429,3540
7648,3481647420,3559110998,1672603626,1672605612,1986
7875,3485008994,3793959750,1672593492,1672593837,345
7635,3513080274,3783705817,1672632590,1672635488,2898
7966,3516960534,3206254161,1672649309,1672650334,1025
7695,3827222533,3391261292,1672568845,1672570092,1247
7706,3500060260,3446948848,1672674911,1672676878,1967
7708,3666506258,3857349323,1672613599,1672614381,782
7728,3227158514,3792902982,1672548930,1672551581,2651
7738,3682061100,3351554343,1672611225,1672612201,976
7541,3836573197,3500658339,1672623179,1672626665,3486
7744,3924549929,3511312803,1672635300,1672635920,620
7963,3489962019,3780609808,1672629286,1672629872,586
7521,3298288268,3315583351,1672579083,1672582216,3133
7719,3496549058,3801089989,1672614228,1672615482,1254
7893,3701178711,3533137446,1672689923,1672690072,149
7850,3792902982,3757246925,1672568035,1672569005,970
7956,3711198793,3505912939,1672615196,1672616991,1795
7821,3421127249,3510247121,1672660467,1672661208,741
7535,3277669002,3224058172,1672590110,1672592428,2318
7966,3903962771,3519428855,1672614264,1672615396,1132
7567,3909331423,3716537575,1672600002,1672600851,849
7635,3783509527,3701111745,1672582822,1672585356,2534
7832,3311603601,3518260334,1672638539,1672642103,3564
7664,3976633198,3358871377,1672588389,1672589999,1610
7807,3294803686,3453729665,1672563134,1672566362,3228
7570,3518408774,3811694763,1672670265,1672671425,1160
7948,3556951786,3430504438,1672658026,1672658345,319
7587,3559110998,3832902928,1672599154,1672601504,2350
7559,3312829208,3883312122,1672636140,1672638123,1983
7529,3819727225,3229665776,1672547196,1672550194,2998
7893,3815508790,3780609808,1672695812,1672696630,818
7507,3774045700,3512837326,1672629951,1672632769,2818
7848,3701190899,3805347939,1672671952,1672672779,827
7575,3412980697,3891751546,1672557537,1672558192,655
7614,3514719601,3772714862,1672637446,1672640481,3035
7773,3509672210,3791957752,1672663733,1672664122,389
7507,3756930948,3475251781,1672589982,1672592930,2948
7513,3505859863,3222448362,1672666784,1672668012,1228
7932,3489962019,3533385867,1672685723,1672685994,271
7666,3277669002,3489728806,1672616753,1672618709,1956
7970,3832902928,3312664885,1672630918,1672634517,3599
7712,3533095755,3701146057,1672534996,1672535809,813
7504,3519601612,3514987389,1672617639,1672620697,3058
7578,3714962248,3333896808,1672689459,1672692684,3225
7832,3509933351,3714474557,1672656818,1672659270,2452
7915,3430074045,3915628728,1672562480,1672564184,1704
7813,3333896808,3500658339,1672608343,1672608958,615
7643,3209551760,3776948966,1672586257,1672588307,2050
7483,3783531004,3517963492,1672616117,1672616694,577
7825,3513454145,3855424474,1672648200,1672650988,2788
7779,3514472925,3783925755,1672649068,1672649703,635
7635,3972709319,3420700674,1672589767,1672590281,514
7841,3755881905,3510969660,1672645879,1672648493,2614
7546,3384240055,3913251733,1672595589,1672598930,3341
7788,3755436115,3409474775,1672696118,1672697307,1189
7562,3816853177,3618873142,1672539659,1672540550,891
7798,3801089989,3793286136,1672691104,1672694088,2984
7618,3701984666,3277939457,1672692785,1672694866,2081
7820,3634995491,3510703546,1672651092,1672653404,2312
7612,3666506258,3318697153,1672676003,1672676817,814
7545,3484995752,3516960534,1672574991,1672578120,3129
7889,3426325549,3783429780,1672622534,1672624885,2351
7851,3344364444,3777790718,1672548916,1672551675,2759
7961,3487171044,3512510536,1672538016,1672539465,1449
7785,3517864478,3791020967,1672534863,1672535355,492
7913,3757682496,3247815299,1672694560,1672696618,2058
7569,3629547065,3298433163,1672542445,1672545733,3288
7839,3607178184,3791657947,1672657715,1672661091,3376
7519,3501730685,3755943611,1672690145,1672691694,1549
7937,3427283336,3277669002,1672661274,1672664566,3292
7978,3291883916,3533193862,1672632911,1672635899,2988
7599,3514128943,3242408357,1672613576,1672616426,2850
7925,3291235378,3817621391,1672574068,1672576343,2275
7486,3715998609,3315583351,1672539341,1672542089,2748
7854,3430074045,3826415738,1672550112,1672551975,1863
7725,3514472925,3519803045,1672625787,1672627718,1931
7909,3384240055,3882242815,1672655728,1672656289,561
7572,3756966035,3518496488,1672572746,1672573171,425
7731,3805347939,3520706195,1672608519,1672610771,2252
7665,3839849341,3780914982,1672534477,1672536095,1618
7806,3235635976,3636867411,1672609084,1672611623,2539
7699,3510711755,3520709480,1672700371,1672701424,1053
7668,3912262917,3520012395,1672565606,1672568303,2697
7514,3772578994,3780828689,1672690382,1672690730,348
7958,3465202715,3792789881,1672577371,1672579031,1660
7546,3511435497,3516673015,1672549581,1672550793,1212
7571,3918674986,3500805881,1672582712,1672582995,283
7494,3731419510,3407673904,1672678107,1672680315,2208
7963,3792032359,3757246925,1672576296,1672576472,176
7697,3836573197,3534191820,1672599552,1672603032,3480
7522,3930791338,3899266183,1672697864,1672701323,3459
7735,3882242815,3978105277,1672643252,1672644172,920
7615,3760077057,3733189298,1672568287,1672571879,3592
7971,3701534009,3772714862,1672571440,1672573353,1913
7584,3556951786,3772578994,1672567435,1672570721,3286
7499,3713786889,3701995648,1672594873,1672598290,3417
7568,3336751428,3360506772,1672568747,1672572012,3265
7747,3791997875,3828365570,1672689164,1672689345,181
7868,3358871377,3412980697,1672683794,1672684529,735
7617,3774339795,3505883609,1672690948,1672692628,1680
7771,3773598056,3776066388,1672657701,1672658433,732
7511,3735733948,3361230905,1672604913,1672605175,262
7637,3972364603,3533270638,1672570402,1672571971,1569
7534,3514838220,3774501422,1672535522,1672537655,2133
7499,3228165483,3664170666,1672544515,1672545489,974
7785,3514245078,3805292782,1672538616,1672539535,919
7846,3774466457,3416427576,1672548084,1672548565,481
7674,3303705369,3791115967,1672697323,1672700298,2975
7945,3359910781,3475251781,1672556694,1672556983,289
7522,3517721725,3511841857,1672545457,1672547719,2262
7651,3509630174,3412825109,1672690774,1672692359,1585
7734,3925402713,3415546117,1672641453,1672643580,2127
7839,3772714862,3516258476,1672644157,1672644380,223
7490,3453729665,3904775198,1672551624,1672552822,1198
7709,3512142794,3534729133,1672693438,1672694154,716
7673,3439023335,3773978034,1672546305,1672549205,2900
7686,3885670556,3783083229,1672617792,1672618177,385
7927,3511170269,3418534998,1672701524,1672702273,749
7675,3505962865,3439023335,1672655759,1672658433,2674
7851,3793338102,3475396323,1672566443,1672567428,985
7917,3406784491,3509352754,1672541137,1672542789,1652
7767,3510771358,3416265063,1672689095,1672690112,1017
7744,3311648200,3516716179,1672542694,1672546221,3527
7878,3828365570,3533371364,1672604241,1672604709,468
7838,3935127663,3512540951,1672623436,1672626837,3401
7902,3519563836,3701691675,1672606908,1672609980,3072
7704,3383922351,3734737881,1672538970,1672542518,3548
7844,3516980378,3304625412,1672594899,1672596234,1335
7740,3534424200,3792902982,1672622624,1672622977,353
7786,3489545239,3713349754,1672581522,1672582022,500
7684,3639847263,3513599775,1672605312,1672607686,2374
7787,3284639858,3756623396,1672583188,1672584871,1683
7826,3668898102,3505098372,1672644058,1672646340,2282
7537,3520206212,3465202715,1672695807,1672698517,2710
7833,3287105466,3202120784,1672555644,1672556271,627
7625,3780593036,3480687894,1672637773,1672638486,713
7544,3882242815,3755798867,1672572662,1672574357,1695
7619,3316222192,3855424474,1672660390,1672660941,551
7578,3516039895,3391915121,1672635725,1672637821,2096
7903,3703275621,3886298125,1672553845,1672554652,807
7968,3979339287,3891751546,1672566096,1672569643,3547
7504,3701995648,3713644518,1672609016,1672612481,3465
7502,3617055293,3511687358,1672634034,1672635632,1598
7964,3739106581,3911245524,1672679342,1672680693,1351
7561,3505292701,3511170269,1672617467,1672617596,129
7782,3244436890,3607178184,1672557399,1672560471,3072
7615,3776948966,3970117174,1672553692,1672554305,613
7663,3688418210,3518932404,1672590860,1672591706,846
7830,3242408357,3736419952,1672697534,1672699035,1501
7693,3280615985,3477649378,1672563185,1672563326,141
7801,3859663348,3511198618,1672599029,1672602333,3304
7494,3222448362,3739106581,1672578104,1672578374,270
7913,3772714862,3404058699,1672669524,1672670042,518
7693,3792844210,3912262917,1672657347,1672660056,2709
7834,3311603601,3388372715,1672570459,1672572730,2271
7583,3200691026,3756623396,1672645479,1672645756,277
7563,3779218771,3338703270,1672564877,1672565725,848
7659,3481647420,3716273414,1672687934,1672688229,295
7824,3773755137,3777806071,1672535318,1672536758,1440
7550,3780609808,3519703355,1672636429,1672637670,1241
7705,3883085535,3505193212,1672676247,1672676830,583
7607,3932051427,3379256399,1672632936,1672635944,3008
7545,3287105466,3280599164,1672531720,1672532602,882
7629,3820354437,3773664987,1672693342,1672694449,1107
7760,3500365158,3454042520,1672625583,1672628598,3015
7494,3501730685,3701065786,1672541952,1672544802,2850
7825,3822654369,3608633356,1672607329,1672608635,1306
7923,3755872268,3793389510,1672566795,1672569894,3099
7959,3224716315,3918674986,1672578337,1672580678,2341
7911,3819727225,3229665776,1672665503,1672666121,618
7870,3515151980,3913251733,1672702760,1672704853,2093
7522,3889750851,3793086311,1672598545,1672600325,1780
7665,3883042241,3314836094,1672634697,1672635429,732
7843,3235287260,3855602893,1672680386,1672682842,2456
7787,3244485293,3407725581,1672620755,1672623830,3075
7916,3855000166,3716165213,1672597660,1672598660,1000
7863,3516065852,3770553384,1672642696,1672643783,1087
7946,3899204805,3701190899,1672619987,1672623351,3364
7510,3360993964,3682061100,1672580291,1672581571,1280
7665,3279721246,3774119563,1672573037,1672576553,3516
7743,3883551721,3280599164,1672654649,1672655001,352
7686,3533242305,3357483218,1672696979,1672698343,1364
7548,3925402713,3664170666,1672637894,1672640216,2322
7732,3402943525,3757246925,1672647556,1672647629,73
7925,3501692334,3772359096,1672669854,1672671833,1979
7539,3312333615,3533193862,1672586740,1672589507,2767
7618,3477649378,3391915121,1672565601,1672568999,3398
7613,3783509527,3756021689,1672682177,1672682976,799
7645,3828365570,3853018906,1672545875,1672546589,714
7944,3703889596,3770101921,1672546116,1672548859,2743
7703,3666457294,3703735129,1672628063,1672629648,1585
7579,3701995648,3311871871,1672598671,1672599408,737
7707,3772746272,3809916577,1672692081,1672694391,2310
7861,3487171044,3505193212,1672561114,1672561436,322
7780,3518014636,3277605882,1672592991,1672594525,1534
7572,3313541986,3882997884,1672700094,1672702863,2769
7501,3774066725,3666506258,1672544507,1672546621,2114
7885,3298288268,3533371364,1672629530,1672631981,2451
7968,3509672210,3518408774,1672550674,1672551810,1136
7536,3633420270,3404384505,1672548256,1672551626,3370
7645,3757246925,3770635361,1672683050,1672684872,1822
7631,3387674757,3273500349,1672595789,1672599345,3556
7910,3774338212,3467773920,1672681131,1672682447,1316
7834,3223968713,3361230905,1672604929,1672605260,331
7487,3311993075,3520030713,1672566932,1672567608,676
7950,3294803686,3613995936,1672574341,1672575403,1062
7945,3859525941,3809484172,1672694085,1672697330,3245
7716,3346327502,3505649239,1672551056,1672552509,1453
7632,3703223015,3511332835,1672639356,1672640787,1431
7547,3701146057,3311065516,1672680731,1672681589,858
7693,3360506772,3238712269,1672685939,1672687058,1119
7958,3428006164,3433804879,1672579397,1672579458,61
7726,3895562476,3278365525,1672579268,1672581833,2565
7881,3337544549,3390068992,1672559217,1672562696,3479
7578,3315583351,3512720680,1672631219,1672633033,1814
7714,3916289176,3489217083,1672580869,1672582944,2075
7566,3715127362,3755436115,1672652112,1672655003,2891
7787,3342131135,3660493209,1672651296,1672654808,3512
7596,3516065852,3626156564,1672569537,1672571662,2125
7663,3518260334,3519428855,1672608561,1672609186,625
7949,3427219654,3485823740,1672616330,1672618663,2333
7568,3770553384,3703718151,1672696041,1672697382,1341
7880,3715189301,3520719611,1672598179,1672598538,359
7568,3312829208,3828365570,1672701144,1672702935,1791
7970,3516514391,3284639858,1672580906,1672582794,1888
7863,3234362962,3505098372,1672577824,1672580157,2333
7591,3736592744,3296471982,1672699012,1672699413,401
7502,3711265369,3738274418,1672561395,1672564179,2784
7603,3779740455,3501692334,1672553204,1672555131,1927
7816,3344019610,3405494240,1672585871,1672586140,269
7920,3779218771,3713644518,1672594996,1672595221,225
7718,3809059934,3510703546,1672593074,1672596247,3173
7902,3242408357,3791957752,1672592609,1672593877,1268
7852,3409474775,3770021824,1672696599,1672697404,805
7848,3533927138,3755881905,1672606956,1672607849,893
7720,3792032359,3703441914,1672545076,1672548538,3462
7549,3242408357,3716165213,1672601782,1672603210,1428
7584,3388637594,3773755137,1672542993,1672543811,818
7611,3520709480,3770447408,1672592809,1672595772,2963
7689,3514838220,3516016437,1672698991,1672700860,1869
7795,3533137446,3489545239,1672534689,1672536713,2024
7919,3701863557,3533827120,1672619185,1672621233,2048
7881,3407725581,3397418363,1672618421,1672620664,2243
7565,3296471982,3520206212,1672661420,1672662241,821
7839,3805342762,3713630656,1672533515,1672535864,2349
7707,3505347134,3610695419,1672591496,1672593559,2063
7914,3701534009,3624761861,1672624606,1672625855,1249
7798,3505362057,3485375593,1672545101,1672545801,700
7847,3512969370,3379256399,1672644349,1672645946,1597
7905,3770635361,3783779671,1672582566,1672583857,1291
7922,3496269445,3791334389,1672587443,1672590979,3536
7714,3228165483,3510703546,1672606442,1672606815,373
7833,3701967560,3770851318,1672669563,1672670291,728
7719,3477649378,3774366875,1672587040,1672589897,2857
7625,3731106822,3399433690,1672612145,1672612477,332
7671,3736625083,3855000166,1672682097,1672684481,2384
7523,3778549126,3777806071,1672658415,1672658863,448
7637,3757682496,3682061100,1672585460,1672588600,3140
7797,3520206212,3755042098,1672563929,1672566714,2785
7913,3533280269,3910454786,1672579206,1672580968,1762
7927,3518360734,3703871468,1672609806,1672613245,3439
7512,3777806071,3505869747,1672618071,1672621114,3043
7915,3500177712,3420700674,1672620385,1672622030,1645
7872,3760267716,3777806071,1672585701,1672588122,2421
7979,3389115045,3505347134,1672656681,1672658548,1867
7643,3710098970,3501955238,1672560897,1672562034,1137
7741,3918584946,3880285638,1672641229,1672642601,1372
7501,3760509236,3703735129,1672647311,1672650386,3075
7494,3779976989,3303705369,1672606599,1672607366,767
7683,3756021689,3774010081,1672551084,1672551383,299
7708,3756424865,3273500349,1672608312,1672608807,495
7581,3755625324,3311154569,1672660613,1672662807,2194
7638,3780609808,3314836094,1672630474,1672630552,78
7755,3730517636,3428964059,1672650468,1672651514,1046
7690,3809059934,3779036831,1672655863,1672656746,883
7863,3505859863,3520376528,1672569692,1672570419,727
7505,3428964059,3903009525,1672598245,1672598695,450
7864,3774466457,3439023335,1672611124,1672612940,1816
7802,3356860407,3427219654,1672557356,1672558523,1167
7862,3779740455,3490191091,1672670238,1672672559,2321
7544,3792668962,3737079798,1672583873,1672586943,3070
7644,3755587522,3634340855,1672651754,1672652174,420
7881,3774125065,3316173088,1672673744,1672676768,3024
7883,3311439795,3228165483,1672558004,1672561092,3088
7569,3386707783,3231056870,1672543811,1672545190,1379
7578,3926700506,3336742544,1672688677,1672691738,3061
7698,3277669002,3224058172,1672570837,1672571373,536
7527,3778341199,3443698222,1672687819,1672690923,3104
7786,3424922204,3756601594,1672564065,1672564889,824
7504,3918584946,3466911760,1672680156,1672683509,3353
7868,3360506772,3500729955,1672599749,1672602270,2521
7951,3813052709,3791874383,1672628328,1672631010,2682
7749,3780813786,3834257412,1672692453,1672693276,823
7576,3898995675,3917088658,1672688329,1672688400,71
7930,3554917400,3505530961,1672602900,1672603990,1090
7764,3791602225,3770447408,1672618405,1672620545,2140
7582,3774338212,3500391167,1672549525,1672551128,1603
7951,3774045700,3509933351,1672577165,1672577717,552
7579,3936227020,3772359096,1672644090,1672647174,3084
7735,3510126867,3387674757,1672584220,1672585862,1642
7602,3415443558,3227158514,1672692083,1672695108,3025
7721,3485008994,3930791338,1672607175,1672607754,579
7795,3779218771,3285400528,1672647162,1672650219,3057
7553,3555214688,3311845971,1672617355,1672619243,1888
7818,3711569060,3314836094,1672622951,1672625015,2064
7736,3783429780,3800353779,1672562651,1672565881,3230
7649,3358871377,3520888296,1672571107,1672571576,469
7670,3505000737,3793338102,1672547337,1672550358,3021
7886,3668898102,3711370563,1672627135,1672628478,1343
7652,3451432842,3822654369,1672667874,1672670155,2281
7743,3783509527,3774119563,1672658404,1672660397,1993
7755,3247428249,3936227020,1672686867,1672690319,3452
7804,3783705817,3774045700,1672702714,1672705376,2662
7493,3485375593,3520012395,1672580895,1672582262,1367
7609,3533748232,3484995752,1672633498,1672636393,2895
7829,3473562469,3780828689,1672583225,1672586270,3045
7565,3736592744,3774338212,1672675662,1672676452,790
7918,3494290908,3416241005,1672623532,1672624047,515
7644,3886298125,3224058172,1672554522,1672556380,1858
7686,3304625412,3511841857,1672697984,1672701292,3308
7877,3509453566,3778549126,1672681727,1672682881,1154
7648,3925402713,3206603608,1672695007,1672696419,1412
7956,3533095755,3925402713,1672611113,1672612597,1484
7970,3734737881,3826415738,1672698560,1672700960,2400
7792,3701967560,3490191091,1672619402,1672621298,1896
7831,3792789881,3760561634,1672562818,1672563860,1042
7806,3351008918,3511435497,1672632277,1672633619,1342
7927,3780788622,3911245524,1672565913,1672568974,3061
7800,3883042241,3273500349,1672597413,1672598679,1266
7735,3776800213,3511271692,1672555262,1672557010,1748
7855,3396285984,3716537575,1672591380,1672594835,3455
7805,3519654779,3780828689,1672623962,1672625026,1064
7646,3505098372,3505859863,1672558893,1672560195,1302
7815,3518876135,3914259449,1672703950,1672704850,900
7750,3500374658,3924549929,1672640987,1672644128,3141
7716,3826759140,3407673904,1672671998,1672673291,1293
7882,3465202715,3434642576,1672679568,1672681991,2423
7796,3277669002,3737154119,1672588139,1672590113,1974
7737,3430352815,3351008918,1672590734,1672592851,2117
7733,3418534998,3883085535,1672652400,1672655872,3472
7799,3428674539,3756021689,1672571177,1672572993,1816
7836,3518408774,3505135325,1672687344,1672687500,156
7522,3711571712,3701178711,1672554119,1672557636,3517
7778,3770021824,3783196518,1672701814,1672702242,428
7847,3407725581,3783429780,1672568101,1672569248,1147
7602,3637008488,3773664987,1672702223,1672704713,2490
7688,3401627165,3889750851,1672580114,1672583612,3498
7885,3703718151,3500374658,1672599574,1672603105,3531
7967,3779629905,3489728806,1672568501,1672570160,1659
7489,3418728074,3387674757,1672536436,1672539770,3334
7873,3812176780,3904408902,1672572939,1672574956,2017
7837,3710067113,3772053179,1672584276,1672585795,1519
7623,3716197887,3389115045,1672696128,1672697093,965
7739,3736592744,3783509527,1672562368,1672562737,369
7881,3378092448,3666507626,1672582504,1672583053,549
7982,3332072298,3793753089,1672634206,1672636367,2161
7934,3319752091,3825229501,1672700802,1672702241,1439
7632,3909238838,3510771358,1672534143,1672536399,2256
7764,3336751428,3511271692,1672681732,1672685248,3516
7790,3855000166,3613683164,1672597382,1672600210,2828
7704,3511841857,3800353779,1672591574,1672593941,2367
7704,3512540951,3405494240,1672532634,1672533796,1162
7625,3428964059,3756453423,1672589141,1672589506,365
7932,3703718151,3337544549,1672624211,1672624707,496
7800,3933210486,3757812939,1672646063,1672648792,2729
7547,3520190170,3273500349,1672674029,1672676211,2182
7873,3711569060,3370752401,1672532465,1672535732,3267
7759,3914259449,3780828689,1672665336,1672667280,1944
7798,3776066388,3714962248,1672559359,1672560435,1076
7488,3685187183,3613995936,1672546408,1672547137,729
7828,3466911760,3634786711,1672599847,1672602191,2344
7764,3772053179,3826759140,1672678657,1672679111,454
7566,3516039895,3716168623,1672675290,1672678460,3170
7510,3533280269,3201324715,1672621663,1672624793,3130
7860,3777079686,3515284591,1672640618,1672643143,2525
7612,3229665776,3777717988,1672584389,1672584618,229
7820,3828624701,3939952128,1672564237,1672566908,2671
7910,3501483568,3937224533,1672675260,1672675550,290
7542,3710067113,3360743849,1672665070,1672665814,744
7933,3516223597,3533193862,1672667686,1672668501,815
7921,3711198793,3311718847,1672633466,1672634284,818
7665,3668898102,3472130842,1672680838,1672682098,1260
7747,3774268456,3777443199,1672658875,1672661385,2510
7901,3793436995,3792384220,1672691009,1672693429,2420
7654,3228165483,3978115672,1672566513,1672567209,696
7680,3465254146,3701178711,1672609970,1672610543,573
7882,3774556560,3915628728,1672558952,1672560782,1830
7650,3533369198,3760489031,1672596895,1672598939,2044
7907,3688418210,3556951786,1672533805,1672534219,414
7781,3512683609,3367029997,1672563589,1672563671,82
7617,3791657947,3278365525,1672615369,1672618421,3052
7728,3200198928,3378436155,1672653706,1672654970,1264
7900,3505869747,3438645253,1672595437,1672596491,1054
7771,3826759140,3520719611,1672642134,1672644617,2483
7689,3276993580,3520709480,1672543272,1672546503,3231
7648,3836573197,3509453566,1672679884,1672682419,2535
7526,3882997884,3513599775,1672638992,1672641317,2325
7569,3513599775,3637008488,1672581723,1672581893,170
7709,3284639858,3510126867,1672583093,1672584345,1252
7509,3973560347,3505477652,1672664210,1672664285,75
7543,3487171044,3716168623,1672643812,1672646008,2196
7670,3895562476,3801089989,1672632259,1672632605,346
7667,3755739653,3512720680,1672618216,1672621390,3174
7759,3416427576,3337544549,1672578214,1672578744,530
7688,3311415018,3772359096,1672576010,1672576972,962
7975,3509630174,3791874383,1672652624,1672654846,2222
7840,3312664885,3805292782,1672617353,1672620569,3216
7542,3911245524,3601879040,1672551713,1672551884,171
7599,3935127663,3244173074,1672556592,1672558369,1777
7906,3426325549,3774520233,1672555153,1672558558,3405
7569,3917278625,3732481297,1672684844,1672685259,415
7614,3774204963,3416241005,1672631848,1672633194,1346
7970,3417970574,3716168623,1672690990,1672691515,525
7944,3288764520,3825229501,1672560951,1672561328,377
7505,3972364603,3829319703,1672679786,1672681757,1971
7738,3311439795,3710408395,1672634363,1672635684,1321
7721,3505362057,3244436890,1672698793,1672701818,3025
7660,3500803339,3415443558,1672532331,1672532510,179
7940,3514472925,3384240055,1672590850,1672593493,2643
7494,3736229191,3496051529,1672701688,1672704353,2665
7911,3618045231,3666457294,1672687942,1672688604,662
7627,3514472925,3514987389,1672664482,1672665441,959
7899,3515723720,3791020967,1672568861,1672569410,549
7630,3311627628,3244485293,1672580270,1672583027,2757
7950,3809059934,3509634629,1672646325,1672648894,2569
7684,3812176780,3912262917,1672693764,1672696246,2482
7565,3511435497,3373384732,1672599996,1672601729,1733
7781,3973560347,3756966035,1672578873,1672582149,3276
7743,3778305740,3811171116,1672702148,1672702821,673
7495,3476232529,3780593036,1672698586,1672700909,2323
7571,3209383861,3344364444,1672694526,1672697711,3185
7564,3501606184,3517255726,1672536718,1672539514,2796
7832,3713969578,3791594391,1672703192,1672705995,2803
7541,3516960534,3277605882,1672604095,1672606147,2052
7825,3772337814,3311065516,1672620682,1672623678,2996
7538,3933210486,3701111745,1672694720,1672695443,723
7726,3518669703,3409474775,1672560041,1672560912,871
7969,3432689543,3311871871,1672531458,1672534766,3308
7911,3802367797,3509453566,1672563723,1672564423,700
7974,3505791599,3701065786,1672687737,1672690465,2728
7931,3505859863,3509672210,1672663524,1672665893,2369
7533,3417061462,3666507626,1672550566,1672551356,790
7673,3332072298,3516016437,1672698421,1672700895,2474
7955,3805347939,3303751772,1672563594,1672564177,583
7500,3280615985,3287105466,1672615271,1672616774,1503
7712,3500458761,3227457126,1672533563,1672534395,832
7609,3513454145,3223968713,1672645972,1672646540,568
7547,3818255890,3713969578,1672686533,1672688216,1683
7894,3550946908,3733891182,1672603090,1672604537,1447
7779,3500177712,3400918687,1672615951,1672617544,1593
7953,3772578994,3222448362,1672687301,1672688271,970
7981,3505904952,3512837326,1672638337,1672641887,3550
7490,3297463265,3533095755,1672644893,1672647184,2291
7849,3807987001,3501364586,1672540352,1672542022,1670
7545,3760509236,3628819436,1672642381,1672644624,2243
7703,3817316561,3510711755,1672659029,1672662288,3259
7918,3339907603,3402943525,1672545934,1672547600,1666
7565,3918584946,3760267716,1672623602,1672625468,1866
7955,3533371364,3500904641,1672649740,1672651954,2214
7824,3477649378,3606812411,1672604613,1672607537,2924
7980,3668005723,3485008994,1672549588,1672550469,881
7941,3277939457,3511687358,1672695360,1672698015,2655
7821,3501730685,3668898102,1672675956,1672678257,2301
7488,3483164654,3909331423,1672546428,1672549139,2711
7839,3552314511,3428674539,1672619869,1672622746,2877
7554,3405494240,3736625083,1672557593,1672561131,3538
7828,3517255726,3489962019,1672702671,1672703320,649
7941,3505599848,3828365570,1672649132,1672649676,544
7847,3505873261,3773205565,1672584054,1672584773,719
7905,3367902229,3512349371,1672673761,1672674388,627
7741,3224058172,3904408902,1672625044,1672628328,3284
7689,3701995648,3917088658,1672652256,1672653592,1336
7554,3606987130,3773465237,1672598395,1672599031,636
7483,3755739653,3365830990,1672586920,1672589012,2092
7979,3791901535,3910886626,1672695911,1672696679,768
7644,3811171116,3514128943,1672567817,1672567879,62
7687,3909331423,3701534009,1672643756,1672646375,2619
7954,3517459919,3509773875,1672640486,1672641613,1127
7654,3912262917,3736229191,1672686614,1672687041,427
7770,3501601840,3732481297,1672635705,1672636171,466
7787,3772053179,3206603608,1672665356,1672668144,2788
7506,3227158514,3616944364,1672631844,1672635026,3182
7613,3345207877,3505791599,1672590077,1672593459,3382
7725,3501198706,3917088658,1672605034,1672607126,2092
7901,3514283243,3244173074,1672539567,1672541737,2170
7668,3913251733,3516673015,1672689783,1672690314,531
7918,3778549126,3783239924,1672692721,1672693543,822
7820,3515151980,3777455223,1672652215,1672652392,177
7977,3760561634,3407954858,1672684653,1672688214,3561
7629,3664170666,3505973226,1672663657,1672664712,1055
7495,3512683609,3882242815,1672626206,1672628807,2601
7706,3510857360,3420432297,1672683429,1672685258,1829
7751,3412825109,3505193212,1672619015,1672621534,2519
7841,3901877072,3404058699,1672682079,1672684457,2378
7951,3224058172,3484995752,1672628722,1672631347,2625
7706,3772578994,3808324264,1672532227,1672535820,3593
7588,3244436890,3600647945,1672534283,1672536391,2108
7719,3800886801,3777443199,1672659400,1672662096,2696
7513,3475251781,3792177074,1672689172,1672691047,1875
7848,3731419510,3770635361,1672644400,1672647635,3235
7879,3520709480,3701184889,1672575077,1672576296,1219
7687,3637008488,3519601612,1672703540,1672706983,3443
7863,3224716315,3533270638,1672681446,1672684337,2891
7509,3760598102,3703661585,1672641902,1672644603,2701
7576,3714504419,3307512479,1672604423,1672607604,3181
7715,3402943525,3512540951,1672657648,1672658339,691
7970,3319752091,3477649378,1672664951,1672666711,1760
7630,3915628728,3891751546,1672662156,1672665499,3343
7509,3772758337,3232962003,1672676148,1672677115,967
7743,3380035798,3520751702,1672608090,1672610970,2880
7749,3519601612,3421127249,1672652285,1672652356,71
7709,3244485293,3889750851,1672591560,1672594151,2591
7950,3601879040,3319752091,1672670987,1672673336,2349
7630,3513454145,3828365570,1672633721,1672634668,947
7665,3518260334,3514838220,1672653180,1672656480,3300
7590,3816454165,3303751772,1672614332,1672617919,3587
7715,3514838220,3534553510,1672614146,1672615468,1322
7780,3778549126,3777776687,1672619684,1672620212,528
7660,3809484172,3880285638,1672604573,1672607275,2702
7531,3715492942,3505702787,1672683658,1672683834,176
7486,3777477395,3519703355,1672627157,1672627334,177
7850,3778549126,3918584946,1672556875,1672557971,1096
7533,3701984666,3817316561,1672632888,1672634425,1537
7569,3820354437,3605726278,1672539940,1672540095,155
7809,3514987389,3483949762,1672640335,1672643620,3285
7532,3792384220,3516980378,1672581619,1672585015,3396
7610,3505098372,3510711755,1672583115,1672584737,1622
7737,3515394721,3778980116,1672612628,1672613514,886
7827,3792177074,3428674539,1672645271,1672646937,1666
7950,3829319703,3516673015,1672588156,1672591742,3586
7687,3755739653,3827222533,1672689526,1672692687,3161
7746,3881477378,3512837326,1672633972,1672635075,1103
7582,3624761861,3402943525,1672651877,1672655305,3428
7712,3792768129,3404384505,1672594456,1672595622,1166
7848,3772309150,3778980116,1672675877,1672677997,2120
7516,3434642576,3887270940,1672692260,1672693936,1676
7739,3816454165,3500803339,1672553089,1672554153,1064
7652,3378436155,3519556068,1672577812,1672578715,903
7961,3556951786,3811171116,1672577839,1672581241,3402
7533,3777079686,3791942683,1672644306,1672646611,2305
7752,3773950140,3488244966,1672541641,1672542745,1104
7602,3734496778,3387674757,1672561414,1672562414,1000
7573,3882291183,3249791738,1672639815,1672640085,270
7742,3516909237,3533748232,1672606608,1672609752,3144
7483,3711198793,3497901842,1672692438,1672692799,361
7536,3911159965,3772758337,1672548697,1672550494,1797
7687,3809484172,3911245524,1672623031,1672624540,1509
7561,3344364444,3303751772,1672677618,1672678413,795
7884,3496269445,3424922204,1672668776,1672670072,1296
7778,3779036831,3779629905,1672591504,1672594965,3461
7617,3760509236,3510857360,1672657104,1672657313,209
7738,3715998609,3514472925,1672633839,1672635932,2093
7853,3636867411,3664517356,1672645795,1672647479,1684
7834,3701274634,3774501422,1672613976,1672615854,1878
7921,3516258476,3713349754,1672651964,1672654549,2585
7959,3773598056,3513164386,1672586085,1672586572,487
7692,3660493209,3515691540,1672639231,1672639851,620
7755,3428006164,3510969660,1672606777,1672608965,2188
7623,3714962248,3227457126,1672684473,1672684584,111
7896,3757682496,3773755137,1672604930,1672606998,2068
7653,3520931254,3701178711,1672657493,1672660426,2933
7827,3509773875,3510969660,1672576988,1672578979,1991
7755,3783196518,3901877072,1672666877,1672670337,3460
7891,3820354437,3792789881,1672699961,1672701680,1719
7976,3755943611,3815508790,1672691205,1672694803,3598
7630,3899371911,3757812939,1672637147,1672638201,1054
7498,3970117174,3384240055,1672593007,1672596315,3308
7495,3489962019,3399911573,1672659769,1672661070,1301
7931,3351554343,3533270638,1672591810,1672592958,1148
7905,3826759140,3828432634,1672642764,1672645791,3027
7910,3483164654,3509773875,1672651101,1672653648,2547
7765,3511125626,3904775198,1672664815,1672666866,2051
7846,3514128943,3277669002,1672611247,1672612125,878
7901,3773205565,3756601594,1672657906,1672658941,1035
7857,3701274634,3510594211,1672571239,1672574834,3595
7525,3510711755,3244389794,1672641823,1672642002,179
7517,3304625412,3467773920,1672585483,1672587983,2500
7484,3280964728,3714474557,1672587303,1672588284,981
7884,3517077106,3822654369,1672563685,1672566595,2910
7825,3737154119,3485375593,1672653330,1672654107,777
7800,3774127586,3822654369,1672598976,1672599730,754
7942,3780828689,3276993580,1672629648,1672631353,1705
7632,3513080274,3315583351,1672635725,1672639291,3566
7579,3518496488,3777443199,1672543727,1672545305,1578
7727,3426325549,3311415018,1672664619,1672666838,2219
7702,3231056870,3511125626,1672611868,1672613943,2075
7866,3791553060,3378436155,1672599013,1672601473,2460
7516,3342131135,3344364444,1672613779,1672614322,543
7543,3512166013,3710569131,1672583145,1672585315,2170
7593,3911159965,3501198706,1672554725,1672558314,3589
7638,3816853177,3710112546,1672585948,1672588688,2740
7644,3228165483,3713786889,1672593114,1672595128,2014
7957,3972709319,3756528686,1672700395,1672701027,632
7514,3913251733,3902383721,1672576796,1672578829,2033
7944,3978105277,3234541252,1672605360,1672606167,807
7892,3792768129,3509604974,1672670333,1672673610,3277
7622,3883085535,3777929708,1672646726,1672649235,2509
7577,3793389510,3307512479,1672624856,1672625397,541
7740,3793753089,3756021689,1672616441,1672617561,1120
7542,3244436890,3222521619,1672608220,1672609869,1649
7925,3757246925,3224716315,1672566696,1672569753,3057
7782,3828624701,3293695955,1672627384,1672627700,316
7586,3365830990,3909606423,1672631062,1672632475,1413
7873,3247780536,3756027749,1672563995,1672566024,2029
7661,3533927138,3774050956,1672572980,1672575140,2160
7975,3509672210,3882997884,1672552526,1672553025,499
7616,3757562897,3311203656,1672652529,1672652714,185
7889,3809484172,3500729955,1672602193,1672604390,2197
7546,3777776687,3360743849,1672545505,1672545722,217
7973,3477649378,3773950140,1672675372,1672678372,3000
7661,3827377568,3516016437,1672657762,1672658465,703
7527,3793871337,3277939457,1672535662,1672538602,2940
7793,3206593906,3407673904,1672613548,1672616440,2892
7692,3534010629,3606812411,1672559467,1672561800,2333
7921,3715189301,3397418363,1672643919,1672645400,1481
7929,3516016437,3520730271,1672639470,1672640336,866
7664,3855000166,3481502100,1672621485,1672621916,431
7554,3285400528,3813052709,1672660038,1672663362,3324
7860,3851190615,3556951786,1672557295,1672559149,1854
7729,3774005526,3737079798,1672619813,1672620510,697
7924,3390068992,3774045700,1672607623,1672608408,785
7910,3711308224,3311274543,1672552656,1672554219,1563
7973,3774195321,3484995752,1672615800,1672618326,2526
7823,3792177074,3777120536,1672681827,1672682484,657
7752,3481647420,3613683164,1672538783,1672541222,2439
7598,3399004969,3509630174,1672602872,1672606288,3416
7727,3912536808,3826760240,1672615586,1672617374,1788
7615,3520756859,3713969578,1672539503,1672540530,1027
7573,3365830990,3826633236,1672557528,1672559075,1547
7953,3533626375,3520730271,1672688195,1672688614,419
7855,3383922351,3518014404,1672565053,1672565348,295
7672,3634786711,3234362962,1672547420,1672548029,609
7659,3909238838,3352603894,1672558531,1672559969,1438
7517,3912536808,3500578848,1672604843,1672607346,2503
7708,3509907947,3935127663,1672540772,1672542933,2161
7602,3757447189,3228165483,1672566940,1672567940,1000
7548,3756451663,3289061738,1672605788,1672606854,1066
7574,3606186086,3298288268,1672617494,1672617843,349
7545,3516909237,3505362057,1672582225,1672584387,2162
7654,3826415738,3516629436,1672631556,1672632565,1009
7746,3209383861,3920801189,1672628105,1672629315,1210
7645,3206603608,3298288268,1672666470,1672668646,2176
7957,3477649378,3511332835,1672675419,1672676992,1573
7611,3519912874,3520730271,1672641190,1672642910,1720
7814,3513201436,3711973519,1672641415,1672644220,2805
7593,3388372715,3778305740,1672578607,1672580517,1910
7655,3448855696,3760077057,1672532883,1672535757,2874
7555,3701190899,3287105466,1672663875,1672667232,3357
7935,3208844525,3421127249,1672673844,1672675293,1449
7940,3512166013,3509907947,1672564055,1672566818,2763
7825,3739106581,3777717988,1672615967,1672618281,2314
7615,3792883665,3512720680,1672575589,1672575935,346
7813,3778266283,3519152550,1672543688,1672543941,253
7585,3505362057,3688683847,1672664377,1672665855,1478
7830,3931941795,3883861463,1672531928,1672533066,1138
7897,3703718151,3883861463,1672675495,1672678747,3252
7901,3286658957,3917088658,1672538034,1672538680,646
7602,3412980697,3514283243,1672650387,1672651585,1198
7816,3817316561,3516011407,1672688124,1672689975,1851
7555,3478194807,3404384505,1672700957,1672702089,1132
7748,3713349754,3756453423,1672612878,1672616130,3252
7940,3432665384,3359239884,1672624865,1672625745,880
7578,3887270940,3777443199,1672642432,1672644638,2206
7571,3911245524,3802367797,1672631473,1672631957,484
7809,3701498253,3828365570,1672660297,1672662328,2031
7912,3780294829,3520709480,1672673507,1672677082,3575
7661,3791115967,3760992710,1672671995,1672673030,1035
7815,3618873142,3519654779,1672613903,1672615439,1536
7630,3556951786,3514719601,1672702845,1672704888,2043
7733,3500458761,3520709480,1672669883,1672670080,197
7809,3311324983,3791997875,1672623025,1672625198,2173
7746,3760077057,3378686918,1672604799,1672606851,2052
7920,3792668962,3500904641,1672597153,1672600257,3104
7837,3911159965,3773950140,1672664193,1672667610,3417
7956,3710098970,3779629905,1672605419,1672606553,1134
7856,3607748895,3855602893,1672616110,1672618010,1900
7562,3883312122,3555214688,1672556841,1672558974,2133
7849,3510244400,3378686918,1672603041,1672606486,3445
7920,3711973519,3392121505,1672654081,1672656113,2032
7638,3224716315,3975287541,1672657267,1672658539,1272
7629,3485375593,3512683609,1672661485,1672661561,76
7708,3756966035,3757151210,1672703735,1672705946,2211
7706,3793286136,3806545488,1672563702,1672565035,1333
7667,3244436890,3770447408,1672615029,1672618593,3564
7614,3500994774,3284832486,1672683019,1672683435,416
7706,3242408357,3714197325,1672547449,1672550765,3316
7770,3232962003,3509933351,1672570760,1672571371,611
7901,3280964728,3244389794,1672591261,1672593645,2384
7590,3487171044,3770078063,1672630200,1672631156,956
7937,3505859863,3360506772,1672626972,1672628901,1929
7715,3519912874,3465254146,1672659568,1672662743,3175
7966,3881477378,3391915886,1672613310,1672616067,2757
7548,3793753089,3774005526,1672648203,1672651455,3252
7682,3409474775,3534010629,1672553914,1672555327,1413
7880,3520719611,3357483218,1672611075,1672611573,498
7579,3774501422,3773755137,1672569830,1672571280,1450
7756,3512683609,3918584946,1672568595,1672571739,3144
7697,3780593036,3311208440,1672613282,1672615083,1801
7948,3731419510,3901877072,1672537541,1672538096,555
7813,3839849341,3783126683,1672553064,1672553785,721
7636,3426325549,3774050956,1672600936,1672602969,2033
7537,3505201246,3756424865,1672556280,1672559482,3202
7971,3514283243,3407725581,1672660178,1672661491,1313
7948,3500803339,3286658957,1672640301,1672640362,61
7507,3235635976,3605726278,1672665603,1672667664,2061
7540,3902383721,3783196518,1672636465,1672637426,961
7915,3898995675,3783245561,1672607165,1672610562,3397
7840,3855424474,3829764737,1672548338,1672548783,445
7935,3755872268,3516514391,1672618921,1672620291,1370
7973,3774501422,3534191820,1672665694,1672668702,3008
7977,3755042098,3713349754,1672588563,1672589599,1036
7971,3400804807,3454042520,1672694246,1672695127,881
7753,3367902229,3517459919,1672652354,1672654860,2506
7617,3713349754,3500199935,1672677411,1672680399,2988
7656,3613683164,3475795792,1672673891,1672677433,3542
7634,3760893269,3829319703,1672651430,1672654609,3179
7724,3519601612,3911159965,1672632734,1672635034,2300
7489,3534191820,3518360734,1672589856,1672591246,1390
7872,3406784491,3232962003,1672601761,1672604106,2345
7888,3338703270,3792902982,1672616639,1672618414,1775
7938,3792384220,3511350608,1672679166,1672679386,220
7971,3760598102,3812176780,1672601966,1672605413,3447
7709,3911159965,3429856982,1672536347,1672538424,2077
7856,3273500349,3682061100,1672664518,1672666316,1798
7559,3773814927,3505098372,1672573382,1672576158,2776
7780,3756027749,3617734118,1672677309,1672679424,2115
7791,3975287541,3791553060,1672683092,1672686378,3286
7629,3483164654,3972364603,1672590029,1672590133,104
7547,3513599775,3415443558,1672531966,1672532334,368
7667,3312333615,3273500349,1672561804,1672562402,598
7974,3930791338,3288764520,1672628660,1672631744,3084
7676,3227158514,3773429448,1672578193,1672580912,2719
7784,3520751702,3800353779,1672700822,1672704056,3234
7910,3338703270,3501198706,1672645091,1672647394,2303
7769,3757562897,3417061462,1672532373,1672533061,688
7736,3774268456,3483949762,1672670786,1672673073,2287
7530,3976390453,3289061738,1672554207,1672554518,311
7747,3811171116,3496269445,1672565430,1672566695,1265
7974,3770635361,3316222192,1672695618,1672696245,627
7915,3773978034,3774204963,1672643451,1672646394,2943
7912,3516465662,3701691675,1672696280,1672697539,1259
7814,3774050956,3886298125,1672562589,1672565650,3061
7772,3828624701,3514472925,1672682161,1672683704,1543
7639,3501483568,3716165213,1672552625,1672552951,326
7884,3779036831,3505859863,1672579706,1672583125,3419
7910,3244389794,3624761861,1672565740,1672568791,3051
7528,3428006164,3815508790,1672673600,1672674018,418
7652,3519069599,3399004969,1672606963,1672609925,2962
7811,3829319703,3505292701,1672600997,1672601332,335
7923,3280599164,3715339701,1672617082,1672618396,1314
7774,3520756859,3774793839,1672591328,1672593136,1808
7749,3607748895,3509907947,1672672454,1672672828,374
7965,3534191820,3223968713,1672605737,1672608799,3062
7544,3520165601,3703013906,1672554690,1672554947,257
7706,3511359172,3511359172,1672577934,1672578242,308
7814,3396285984,3780914982,1672634048,1672635522,1474
7839,3412980697,3713786889,1672542762,1672544869,2107
7750,3783206719,3616944364,1672582579,1672585990,3411
7676,3235287260,3716197887,1672630558,1672631317,759
7644,3399052055,3277605882,1672658445,1672659845,1400
7826,3514472925,3701274634,1672569552,1672572101,2549
7602,3827626797,3534010629,1672629246,1672631894,2648
7975,3433804879,3774195321,1672562340,1672565221,2881
7978,3773598056,3777806071,1672563871,1672566778,2907
7929,3711504540,3534729133,1672542859,1672543188,329
7693,3904408902,3488244966,1672571516,1672572211,695
7772,3911159965,3711370563,1672561691,1672564106,2415
7523,3518669703,3710112546,1672688695,1672691719,3024
7669,3475251781,3902278226,1672694081,1672696060,1979
7863,3933210486,3338367113,1672552766,1672554735,1969
7776,3889232789,3736790081,1672644877,1672645889,1012
7835,3519428855,3409474775,1672578092,1672581660,3568
7727,3783126683,3703789494,1672652612,1672654621,2009
7500,3511170269,3311324983,1672692611,1672695921,3310
7938,3399535232,3533025282,1672689893,1672690490,597
7613,3855000166,3918584946,1672671097,1672672921,1824
7737,3493507965,3500391167,1672535077,1672537606,2529
7959,3605726278,3520030713,1672546114,1672549509,3395
7503,3713644518,3397418363,1672550929,1672552209,1280
7782,3736229191,3857349323,1672674066,1672676482,2416
7629,3417061462,3333896808,1672549572,1672551994,2422
7559,3420432297,3607748895,1672648232,1672649205,973
7493,3505193212,3770021824,1672588544,1672589509,965
7582,3311845971,3427219654,1672600720,1672601384,664
7587,3976390453,3791115967,1672636923,1672640395,3472
7963,3710112546,3391261292,1672644618,1672646774,2156
7517,3880310724,3701863557,1672553107,1672554432,1325
7709,3489962019,3500060260,1672594822,1672598235,3413
7884,3836573197,3777443199,1672576971,1672577412,441
7750,3902278226,3713969578,1672532764,1672533799,1035
7910,3510711755,3369998498,1672672403,1672676000,3597
7851,3604539807,3242408357,1672536045,1672538912,2867
7701,3500805881,3836573197,1672623484,1672625103,1619
7712,3513080274,3501730685,1672532737,1672535351,2614
7905,3520165601,3513201436,1672651250,1672653875,2625
7756,3367029997,3505973226,1672562009,1672562651,642
7789,3360743849,3780828689,1672651303,1672652005,702
7773,3662180254,3713786889,1672666006,1672667030,1024
7768,3500066230,3808324264,1672652428,1672652569,141
7829,3512166013,3534191820,1672587250,1672588830,1580
7616,3715492942,3519069599,1672556823,1672558754,1931
7878,3418728074,3774127586,1672674052,1672677179,3127
7875,3412980697,3793959750,1672596919,1672599196,2277
7653,3280964728,3760077057,1672544510,1672545908,1398
7659,3520730271,3311208440,1672675642,1672677093,1451
7980,3880285638,3513080274,1672573229,1672574567,1338
7679,3703661585,3533095755,1672666134,1672667944,1810
7897,3760183458,3336751428,1672598718,1672601765,3047
7907,3820354437,3757812939,1672601673,1672602647,974
7967,3776800213,3516606733,1672628506,1672629910,1404
7656,3496549058,3357483218,1672647095,1672650119,3024
7713,3703661585,3855000166,1672539620,1672541462,1842
7738,3388286531,3733189298,1672653580,1672654593,1013
7631,3917278625,3247428249,1672563856,1672564109,253
7953,3311603601,3485823740,1672660558,1672663334,2776
7970,3518014404,3483164654,1672549174,1672551970,2796
7524,3755920131,3404384505,1672698093,1672700440,2347
7834,3318697153,3407954858,1672609748,1672612540,2792
7648,3773814927,3859663348,1672667927,1672670240,2313
7671,3311154569,3396086535,1672669822,1672672108,2286
7931,3805347939,3882997884,1672558591,1672561537,2946
7656,3559110998,3318697153,1672664547,1672666069,1522
7805,3517255726,3778266283,1672575515,1672577263,1748
7831,3384240055,3534729133,1672662330,1672663950,1620
7697,3378092448,3778341199,1672595190,1672598074,2884
7918,3773814927,3783531004,1672550198,1672551398,1200
7932,3407673904,3509672210,1672540028,1672543284,3256
7678,3772884106,3249247700,1672587398,1672590484,3086
7642,3816454165,3360993964,1672542929,1672543589,660
7579,3716843669,3387966152,1672694647,1672695320,673
7615,3805342762,3399052055,1672566244,1672568158,1914
7931,3365278081,3500805881,1672685553,1672686912,1359
7873,3855424474,3248507722,1672635161,1672636129,968
7753,3399911573,3316173088,1672603249,1672603396,147
7586,3688418210,3513201436,1672569500,1672570803,1303
7895,3478194807,3555214688,1672593609,1672594431,822
7520,3755872268,3899266183,1672567289,1672567466,177
7754,3555214688,3429856982,1672658403,1672660628,2225
7604,3501955238,3348261553,1672698849,1672699833,984
7745,3465254146,3627937312,1672546732,1672548045,1313
7571,3304625412,3458539365,1672623275,1672625133,1858
7808,3778780511,3633420270,1672669054,1672670904,1850
7793,3756930948,3701111745,1672567034,1672568659,1625
7592,3804870229,3757562897,1672642067,1672645019,2952
7652,3510771358,3505635228,1672672227,1672673889,1662
7642,3505912939,3520165601,1672655347,1672655825,478
7929,3925620998,3809484172,1672618109,1672619944,1835
7974,3392121505,3247780536,1672547933,1672549316,1383
7961,3428674539,3792384220,1672571885,1672572155,270
7675,3808324264,3774466457,1672607346,1672607892,546
7838,3516223597,3296471982,1672633912,1672634430,518
7609,3774125065,3399535232,1672582462,1672583768,1306
7926,3515691540,3505477652,1672694286,1672697838,3552
7747,3776066388,3534702203,1672688700,1672692145,3445
7689,3466229085,3492478793,1672665724,1672668739,3015
7706,3773950140,3852391257,1672623584,1672624522,938
7840,3756462516,3200691026,1672665223,1672665415,192
7600,3716488385,3639847263,1672703483,1672706063,2580
7611,3714488548,3307097200,1672616612,1672618896,2284
7918,3517721725,3624312512,1672613562,1672614200,638
7665,3773950140,3772884106,1672592376,1672593415,1039
7967,3512510536,3760492950,1672572482,1672575616,3134
7548,3778305740,3208844525,1672672495,1672674541,2046
7734,3604539807,3883551721,1672656967,1672658169,1202
7847,3533280269,3772884106,1672648247,1672649673,1426
7874,3668898102,3249401741,1672591340,1672594244,2904
7577,3852595551,3510857360,1672693899,1672695081,1182
7574,3774125065,3701995648,1672564367,1672566156,1789
7923,3346327502,3636867411,1672577253,1672580474,3221
7722,3533095755,3409474775,1672645437,1672648869,3432
7771,3206593906,3793086311,1672643309,1672645891,2582
7830,3817621391,3756027749,1672612641,1672613712,1071
7903,3380035798,3338367113,1672633733,1672635032,1299
7854,3379589402,3519428855,1672560658,1672561339,681
7791,3883312122,3783126683,1672628396,1672628470,74
7843,3404384505,3783779671,1672686833,1672688965,2132
7978,3394330287,3783245561,1672578731,1672581772,3041
7656,3755798867,3780974443,1672593098,1672594347,1249
7654,3800886801,3710569131,1672668902,1672672281,3379
7910,3505203158,3791901535,1672658399,1672660011,1612
7765,3509773875,3509630174,1672648612,1672650451,1839
7519,3517459919,3304056063,1672547798,1672548157,359
7930,3284832486,3227457126,1672591230,1672592072,842
7673,3209048907,3424922204,1672631082,1672631704,622
7625,3715492942,3342131135,1672628595,1672630809,2214
7944,3277669002,3839849341,1672543799,1672546060,2261
7933,3314245084,3394539273,1672664021,1672664314,293
7522,3808324264,3780639480,1672699077,1672702157,3080
7762,3490191091,3385763781,1672688015,1672689632,1617
7767,3909238838,3667680268,1672665771,1672668605,2834
7485,3534492426,3438645253,1672624366,1672626362,1996
7567,3809059934,3311152102,1672646733,1672647482,749
7532,3227457126,3933210486,1672664467,1672665537,1070
7697,3792288302,3428964059,1672549120,1672550058,938
7924,3509907947,3715189301,1672587096,1672587761,665
7887,3811171116,3242408357,1672664312,1672666528,2216
7741,3505859863,3516039895,1672694715,1672695888,1173
7964,3805292782,3519428855,1672556962,1672559010,2048
7748,3613683164,3501692334,1672674963,1672677225,2262
7820,3519428855,3311718847,1672648236,1672651571,3335
7972,3608868877,3514838220,1672695912,1672696833,921
7929,3511312803,3236102733,1672678913,1672681145,2232
7892,3715189301,3505477652,1672592601,1672593377,776
7672,3249247700,3792384220,1672689574,1672691001,1427
7499,3512969370,3420432297,1672701243,1672702960,1717
7524,3778108318,3903307060,1672669135,1672669555,420
7545,3227158514,3383922351,1672622002,1672623659,1657
7935,3701995648,3500994774,1672568845,1672571915,3070
7531,3505362057,3519601612,1672620210,1672623002,2792
7916,3406784491,3520629279,1672647564,1672649250,1686
7546,3481647420,3777983879,1672619246,1672622333,3087
7682,3932051427,3512567240,1672694237,1672694512,275
7888,3405494240,3516673015,1672607500,1672611078,3578
7706,3701190899,3516039895,1672621877,1672624301,2424
7807,3811694763,3331845324,1672577750,1672578099,349
7575,3716900301,3509352754,1672693432,1672695787,2355
7625,3791901535,3701178711,1672608392,1672608931,539
7704,3206593906,3200198928,1672536243,1672537833,1590
7726,3783705817,3779528381,1672594974,1672598238,3264
7698,3836573197,3352603894,1672621787,1672623217,1430
7698,3501730685,3297463265,1672603634,1672604323,689
7856,3378092448,3737079798,1672572538,1672575134,2596
7742,3770824086,3770824086,1672575501,1672577165,1664
7576,3899371911,3836573197,1672606417,1672609864,3447
7654,3604539807,3683766533,1672675601,1672678240,2639
7727,3970117174,3807987001,1672683945,1672684324,379
7754,3550946908,3510244400,1672616939,1672619292,2353
7865,3485008994,3533371364,1672700976,1672701921,945
7580,3918584946,3791594391,1672629254,1672632310,3056
7956,3534424200,3617055293,1672625269,1672628253,2984
7765,3514838220,3505135325,1672675969,1672676058,89
7505,3783509527,3780503655,1672684579,1672687637,3058
7818,3244436890,3904775198,1672539419,1672541037,1618
7777,3776338577,3209048907,1672666873,1672669671,2798
7809,3511170269,3791115967,1672562829,1672564044,1215
7647,3387674757,3836573197,1672686369,1672686938,569
7715,3517721725,3792768129,1672659744,1672659996,252
7808,3344019610,3286658957,1672673441,1672675847,2406
7562,3520888296,3793286136,1672691662,1672695125,3463
7533,3533137446,3511125626,1672698324,1672699052,728
7932,3899371911,3792844210,1672576441,1672579047,2606
7952,3772053179,3513599775,1672639823,1672641975,2152
7830,3839849341,3909238838,1672580863,1672582394,1531
7654,3208844525,3756027749,1672627647,1672630826,3179
7690,3777936328,3514472925,1672576957,1672577573,616
7722,3514245078,3515125508,1672537271,1672537883,612
7816,3559110998,3972709319,1672555895,1672557445,1550
7585,3773429448,3772758337,1672690199,1672692918,2719
7958,3510380060,3501184421,1672602525,1672602753,228
7876,3826415738,3904408902,1672681274,1672683996,2722
7768,3770101921,3703013906,1672540917,1672541304,387
7812,3249401741,3496549058,1672614477,1672616877,2400
7752,3779528381,3222521619,1672537104,1672538204,1100
7605,3807987001,3939952128,1672670537,1672671441,904
7572,3209551760,3859525941,1672591623,1672592924,1301
7839,3336742544,3520709480,1672693875,1672696481,2606
7697,3715189301,3825229501,1672686479,1672689607,3128
7763,3490191091,3701863557,1672558727,1672561348,2621
7572,3757562897,3808324264,1672636343,1672639247,2904
7883,3311603601,3484995752,1672651172,1672653360,2188
7645,3826415738,3500994774,1672622843,1672623340,497
7823,3714821932,3511170269,1672537776,1672539734,1958
7569,3780503655,3512683609,1672685273,1672688542,3269
7748,3793338102,3365278081,1672681595,1672683056,1461
7570,3615046771,3312664885,1672635303,1672636957,1654
7512,3406784491,3349613093,1672673675,1672674712,1037
7489,3685818092,3519428855,1672686548,1672689601,3053
7582,3760509236,3520730271,1672556344,1672557308,964
7679,3208844525,3289061738,1672621340,1672623576,2236
7964,3511125626,3930791338,1672535330,1672537337,2007
7746,3220716272,3514838220,1672555502,1672557520,2018
7573,3344019610,3520719611,1672619828,1672622557,2729
7719,3701111745,3777623166,1672691626,1672694734,3108
7795,3311090974,3774339795,1672610308,1672612872,2564
7728,3827222533,3394539273,1672555371,1672557738,2367
7580,3334033993,3509773875,1672592328,1672592827,499
7829,3518163778,3809484172,1672573833,1672577343,3510
7707,3855424474,3772746272,1672661361,1672664537,3176
7663,3701984666,3780609808,1672690509,1672691806,1297
7827,3476232529,3291235378,1672696530,1672697943,1413
7956,3505347134,3605726278,1672562593,1672566140,3547
7900,3337544549,3701190899,1672638225,1672638534,309
7980,3822654369,3336751428,1672689327,1672690662,1335
7684,3829232696,3779036831,1672563172,1672564987,1815
7942,3757455053,3607748895,1672687443,1672688321,878
7639,3755625324,3889232789,1672694444,1672696652,2208
7934,3756528686,3937224533,1672601988,1672602980,992
7767,3829319703,3833889105,1672689196,1672690810,1614
7594,3773814927,3554917400,1672696763,1672698307,1544
7869,3715339701,3517509185,1672604958,1672607985,3027
7789,3855937514,3497901842,1672548200,1672548580,380
7780,3511687358,3221536550,1672685770,1672688587,2817
7536,3713630656,3200198928,1672653636,1672654841,1205
7842,3783196518,3360743849,1672589897,1672591718,1821
7589,3605726278,3613995936,1672585571,1672588793,3222
7486,3208844525,3777514571,1672624003,1672625311,1308
7842,3224058172,3853018906,1672637593,1672640889,3296
7971,3286658957,3501927421,1672560757,1672560845,88
7674,3757161914,3774045700,1672585285,1672587956,2671
7828,3904408902,3809059934,1672626242,1672627241,999
7676,3518014404,3519152550,1672574732,1672574915,183
7694,3855424474,3518669703,1672623750,1672625734,1984
7682,3817621391,3737051610,1672626396,1672627229,833
7723,3394539273,3412825109,1672539903,1672542624,2721
7979,3773205565,3813052709,1672642956,1672643993,1037
7499,3780609808,3685818092,1672684416,1672684498,82
7927,3493507965,3519912874,1672681948,1672683735,1787
7818,3303705369,3485823740,1672582812,1672583900,1088
7505,3755436115,3519654779,1672597406,1672599143,1737
7958,3430074045,3512217942,1672538125,1672540742,2617
7535,3713370078,3805292782,1672701006,1672702870,1864
7800,3365278081,3701967560,1672579592,1672583123,3531
7565,3793627961,3779740455,1672635039,1672637410,2371
7725,3664170666,3273500349,1672643747,1672644046,299
7626,3779976989,3701863557,1672619703,1672620635,932
7956,3517864478,3511312803,1672654740,1672656918,2178
7962,3793389510,3534492426,1672578814,1672582151,3337
7692,3979339287,3303751772,1672576540,1672578100,1560
7935,3780974443,3793871337,1672593764,1672595442,1678
7668,3362000049,3518360734,1672564709,1672567289,2580
7864,3614238812,3688683847,1672701810,1672702642,832
7827,3772746272,3780503655,1672663496,1672666703,3207
7881,3475795792,3489728806,1672593764,1672594391,627
7806,3512217942,3509907947,1672620744,1672621729,985
7589,3229058858,3311648200,1672613789,1672616018,2229
7972,3792902982,3276993580,1672648848,1672650645,1797
7973,3855937514,3280964728,1672571489,1672574475,2986
7961,3883085535,3772337814,1672670772,1672673964,3192
7982,3520706195,3826415738,1672640091,1672640669,578
7572,3533369198,3359910781,1672588137,1672588382,245
7689,3505347134,3783083229,1672669203,1672672292,3089
7596,3703013906,3793338102,1672674211,1672677485,3274
7490,3756462516,3206603608,1672687419,1672690074,2655
7783,3812176780,3793086311,1672687506,1672691006,3500
7652,3776948966,3939952128,1672596015,1672598729,2714
7830,3776513891,3505530961,1672584063,1672586697,2634
7660,3315583351,3925620998,1672539295,1672542784,3489
7598,3617734118,3276993580,1672552929,1672555961,3032
7535,3510380060,3509907947,1672683673,1672687071,3398
7532,3395152943,3399004969,1672586887,1672590380,3493
7768,3823600322,3634340855,1672568133,1672569798,1665
7657,3505292701,3248507722,1672638592,1672639400,808
7675,3715339701,3776948966,1672670329,1672673090,2761
7491,3471220483,3903009525,1672589163,1672592378,3215
7781,3756453423,3238712269,1672590501,1672590654,153
7578,3351008918,3505883609,1672629535,1672631462,1927
7527,3248507722,3389115045,1672615456,1672617394,1938
7861,3667680268,3277939457,1672589024,1672590891,1867
7704,3662180254,3817621391,1672533043,1672535770,2727
7844,3514838220,3625274012,1672544080,1672546385,2305
7947,3777079686,3279721246,1672593158,1672593818,660
7737,3780609808,3291883916,1672571031,1672571720,689
7526,3918674986,3224716315,1672611441,1672614319,2878
7837,3774793839,3505904952,1672628775,1672630224,1449
7798,3710569131,3851190615,1672649008,1672651683,2675
7791,3518260334,3505347134,1672534661,1672537623,2962
7717,3889232789,3520756859,1672634648,1672635056,408
7711,3501927421,3834257412,1672698685,1672699183,498
7819,3780593036,3513599775,1672700991,1672703973,2982
7977,3505219850,3711308224,1672536390,1672538218,1828
7722,3505859863,3777514571,1672688291,1672689131,840
7916,3500066230,3903307060,1672697006,1672697705,699
7919,3404058699,3509907947,1672666098,1672669518,3420
7897,3501730685,3772758337,1672535904,1672537120,1216
7726,3770447408,3510711755,1672532202,1672532501,299
7610,3511332835,3516065852,1672596861,1672597345,484
7975,3473562469,3534313900,1672660131,1672663109,2978
7788,3501198706,3311993075,1672637587,1672639718,2131
7750,3311090974,3825229501,1672569379,1672572699,3320
7487,3534729133,3791957752,1672558510,1672561119,2609
7906,3337544549,3760569731,1672533351,1672533705,354
7968,3500729955,3713370078,1672585231,1672588432,3201
7723,3757682496,3711262377,1672701004,1672703415,2411
7508,3518014636,3783509527,1672580060,1672581978,1918
7954,3793286136,3817316561,1672690928,1672692030,1102
7725,3976390453,3510771358,1672625827,1672627622,1795
7692,3244173074,3367029997,1672538098,1672539170,1072
7652,3505201246,3533385867,1672569752,1672572846,3094
7881,3924549929,3278365525,1672640756,1672641828,1072
7795,3520030713,3509634629,1672648356,1672651592,3236
7548,3883861463,3209027249,1672554182,1672557665,3483
7702,3975287541,3886298125,1672543700,1672545300,1600
7502,3505530961,3505203158,1672600228,1672601050,822
7709,3514283243,3402943525,1672545641,1672548695,3054
7652,3711973519,3972709319,1672665849,1672668465,2616
7874,3318166135,3716900301,1672623422,1672625614,2192
7794,3774010081,3418728074,1672650677,1672651817,1140
7943,3915628728,3364543015,1672581740,1672584291,2551
7966,3791553060,3518014636,1672596288,1672597191,903
7631,3244485293,3278365525,1672661336,1672663586,2250
7601,3715339701,3703889596,1672535968,1672536296,328
7838,3374559242,3520751702,1672599518,1672602256,2738
7832,3533385867,3774520233,1672587924,1672588219,295
7810,3302626661,3311871871,1672621967,1672622140,173
7705,3223789409,3918247820,1672634039,1672635383,1344
7892,3512969370,3385763781,1672701103,1672701396,293
7843,3500499542,3235287260,1672655569,1672658367,2798
7865,3853018906,3772337814,1672546051,1672548658,2607
7791,3518496488,3500177712,1672555447,1672555960,513
7693,3715981584,3291235378,1672615681,1672617373,1692
7903,3607178184,3822654369,1672540151,1672541967,1816
7538,3733891182,3516011407,1672569547,1672571357,1810
7923,3776066388,3756453423,1672604754,1672607120,2366
7801,3515125508,3793338102,1672556763,1672559689,2926
7866,3912536808,3472130842,1672545259,1672548082,2823
7821,3404058699,3826633236,1672696006,1672699030,3024
7811,3783531004,3415546117,1672588751,1672592345,3594
7608,3520012395,3793436995,1672672971,1672673417,446
7612,3773755137,3244436890,1672552456,1672554949,2493
7956,3737154119,3804870229,1672700411,1672702014,1603
7757,3755436115,3818255890,1672564850,1672567646,2796
7950,3815508790,3209048907,1672536918,1672539323,2405
7762,3780639480,3206254161,1672587014,1672589015,2001
7950,3739106581,3780813786,1672568223,1672570115,1892
7903,3755042098,3793389510,1672665877,1672669365,3488
7823,3514838220,3791997875,1672602246,1672604141,1895
7812,3433804879,3615046771,1672629646,1672632181,2535
7542,3616944364,3404058699,1672610180,1672613578,3398
7807,3399004969,3312664885,1672602098,1672602326,228
7730,3505477652,3500374658,1672540106,1672543405,3299
7879,3859663348,3429856982,1672564171,1672564889,718
7646,3703661585,3716835696,1672654434,1672657337,2903
7685,3500060260,3713644518,1672625508,1672627150,1642
7863,3234541252,3826760240,1672538321,1672538539,218
7506,3418728074,3774466457,1672669907,1672672105,2198
7777,3791115967,3629547065,1672632390,1672633034,644
7816,3783083229,3399004969,1672612627,1672614990,2363
7849,3533810360,3533025282,1672638823,1672639019,196
7658,3774050956,3510173870,1672550676,1672551910,1234
7848,3885670556,3783779671,1672549544,1672549714,170
7502,3276993580,3716165213,1672672199,1672674766,2567
7832,3812176780,3420432297,1672661682,1672662364,682
7498,3777623166,3200691026,1672675323,1672675824,501
7715,3855602893,3284639858,1672542608,1672543471,863
7828,3518260334,3374559242,1672570127,1672570863,736
7552,3755920131,3979339287,1672646534,1672648986,2452
7935,3760267716,3710408395,1672535972,1672537681,1709
7828,3512142794,3313564074,1672652922,1672654108,1186
7714,3755511676,3711569060,1672681533,1672684293,2760
7630,3756623396,3666506258,1672675829,1672678827,2998
7706,3711504540,3311993075,1672556591,1672558084,1493
7595,3711569060,3805292782,1672541985,1672542857,872
7901,3915628728,3774520233,1672699357,1672700651,1294
7819,3937224533,3374559242,1672666828,1672667382,554
7851,3770851318,3277939457,1672654912,1672657142,2230
7532,3489217083,3280615985,1672574623,1672577235,2612
7654,3367029997,3493507965,1672588491,1672590038,1547
7717,3903009525,3917278625,1672655728,1672657295,1567
7742,3512720680,3394539273,1672669846,1672672985,3139
7654,3827222533,3496549058,1672601954,1672604865,2911
7563,3519703355,3336742544,1672671909,1672672266,357
7620,3483949762,3477375368,1672570981,1672574145,3164
7667,3886298125,3667680268,1672575654,1672577491,1837
7532,3772309166,3636867411,1672580526,1672583428,2902
7878,3404384505,3379589402,1672551631,1672555116,3485
7681,3505193212,3780593036,1672558459,1672558690,231
7855,3918674986,3664517356,1672575124,1672578696,3572
7801,3885670556,3533280269,1672691768,1672694619,2851
7895,3510937904,3772746272,1672567635,1672568112,477
7538,3791602225,3534010629,1672566652,1672567980,1328
7864,3793389510,3236102733,1672638675,1672640857,2182
7697,3780914982,3757455053,1672544392,1672547492,3100
7915,3828365570,3319752091,1672652646,1672653280,634
7754,3534492426,3774204963,1672579318,1672581579,2261
7719,3301107849,3520931254,1672616236,1672618763,2527
7911,3311648200,3488244966,1672640656,1672641801,1145
7678,3361230905,3770101921,1672613889,1672616310,2421
7983,3517721725,3277605882,1672571945,1672575358,3413
7612,3349613093,3493507965,1672587113,1672589846,2733
7855,3972709319,3882242815,1672581470,1672581801,331
7667,3800886801,3505904952,1672564602,1672567229,2627
7649,3454042520,3774338212,1672690752,1672693938,3186
7885,3903307060,3731419510,1672541274,1672544048,2774
7595,3505859863,3513599775,1672698044,1672699127,1083
7789,3791997875,3780788622,1672555034,1672557472,2438
7783,3514245078,3430352815,1672597975,1672599998,2023
7802,3518876135,3404058699,1672634615,1672636059,1444
7899,3760077057,3805292782,1672684658,1672687723,3065
7964,3209048907,3509630174,1672542239,1672542542,303
7637,3510857360,3774127586,1672658543,1672661226,2683
7512,3757246925,3701898991,1672581795,1672584447,2652
7597,3316222192,3284639858,1672595506,1672595740,234
7665,3859663348,3715581279,1672559765,1672563305,3540
7558,3780788622,3377766165,1672583515,1672584158,643
7631,3760267716,3206254161,1672557592,1672558864,1272
7700,3701534009,3770101921,1672604949,1672608459,3510
7854,3701190899,3756453423,1672606328,1672608051,1723
7599,3481502100,3500994774,1672618979,1672622380,3401
7789,3777717988,3711571712,1672602668,1672604181,1513
7553,3200198928,3534729133,1672643514,1672644388,874
7891,3519703355,3520190170,1672689510,1672689975,465
7822,3344364444,3774520233,1672691717,1672692446,729
7809,3501364586,3467773920,1672589052,1672589857,805
7934,3922275416,3480687894,1672604401,1672604607,206
7560,3519703355,3277939457,1672573944,1672574947,1003
7722,3377766165,3520190170,1672544767,1672545798,1031
7779,3760489031,3236102733,1672586922,1672587094,172
7666,3924549929,3918056059,1672623980,1672627239,3259
7945,3298288268,3516039895,1672567315,1672568416,1101
7787,3505219850,3209383861,1672684239,1672684926,687
7694,3757682496,3827626797,1672620249,1672622536,2287
7876,3703871468,3611150562,1672617604,1672620332,2728
7938,3757682496,3519069599,1672651781,1672655228,3447
7908,3407725581,3311154569,1672621714,1672622083,369
7903,3511332835,3312664885,1672569830,1672572899,3069
7804,3736625083,3505973226,1672660054,1672662238,2184
7724,3713370078,3735319397,1672532348,1672535530,3182
7968,3883042241,3518876135,1672597469,1672599640,2171
7687,3367029997,3808324264,1672537923,1672538626,703
7850,3201324715,3500391167,1672604817,1672606059,1242
7932,3415443558,3716258994,1672627876,1672630583,2707
7949,3367902229,3774366875,1672684283,1672687250,2967
7896,3783206719,3618045231,1672536910,1672538423,1513
7565,3817316561,3391915121,1672618511,1672620731,2220
7917,3220716272,3791874383,1672569514,1672572023,2509
7681,3855000166,3505791599,1672678169,1672678958,789
7885,3432665384,3428006164,1672638058,1672640141,2083
7542,3668005723,3501692334,1672633537,1672633766,229
7484,3736786443,3859663348,1672687505,1672688045,540
7826,3318166135,3756451663,1672614289,1672614962,673
7722,3336751428,3511350608,1672669032,1672670119,1087
7942,3517721725,3826759140,1672646337,1672649617,3280
7561,3533810360,3629547065,1672568111,1672569715,1604
7856,3373384732,3509933351,1672606233,1672608018,1785
7550,3772544062,3516629436,1672606411,1672606740,329
7613,3829232696,3774793839,1672548528,1672548796,268
7932,3386707783,3277605882,1672621771,1672624502,2731
7486,3518876135,3249247700,1672558166,1672559665,1499
7880,3625274012,3517509185,1672542784,1672545233,2449
7813,3783083229,3834257412,1672604408,1672607163,2755
7807,3608633356,3427283336,1672619618,1672619890,272
7557,3809484172,3902383721,1672598347,1672599792,1445
7735,3703223015,3756462516,1672534609,1672535104,495
7610,3924549929,3978105277,1672607478,1672609133,1655
7615,3511271692,3909606423,1672686513,1672688789,2276
7547,3235287260,3756623396,1672550499,1672552358,1859
7904,3501955238,3501606184,1672634014,1672635290,1276
7568,3516016437,3756462516,1672547067,1672549850,2783
7633,3755625324,3834257412,1672682241,1672684340,2099
7538,3617055293,3477649378,1672657080,1672658846,1766
7575,3249401741,3311415018,1672701148,1672703485,2337
7973,3489962019,3730517636,1672641437,1672643026,1589
7628,3792768129,3311203656,1672577749,1672578943,1194
7536,3756451663,3760509236,1672682228,1672682393,165
7541,3882242815,3774580701,1672656094,1672659604,3510
7858,3760598102,3713894336,1672623974,1672625680,1706
7953,3284639858,3880310724,1672656892,1672657679,787
7617,3922337974,3791942683,1672590786,1672594118,3332
7940,3778108318,3229058858,1672703667,1672706387,2720
7940,3793627961,3286658957,1672619555,1672621808,2253
7773,3517509185,3249247700,1672691915,1672693102,1187
7810,3201848640,3903307060,1672679538,1672682615,3077
7808,3311208440,3975287541,1672615914,1672617078,1164
7606,3710344260,3511841857,1672534900,1672537657,2757
7688,3232962003,3978115672,1672609118,1672612656,3538
7659,3757682496,3248507722,1672553943,1672555980,2037
7813,3384951177,3509907947,1672545224,1672547610,2386
7848,3331845324,3533653428,1672541095,1672543188,2093
7611,3883042241,3760561634,1672664553,1672667452,2899
7586,3777776687,3783245561,1672611303,1672611990,687
7552,3916289176,3500177712,1672539660,1672541339,1679
7562,3668898102,3489728806,1672695072,1672696907,1835
7739,3703223015,3512720680,1672614774,1672616957,2183
7811,3710112546,3660493209,1672661226,1672662573,1347
7745,3916289176,3458539365,1672641149,1672644042,2893
7617,3505883609,3279721246,1672595971,1672597097,1126
7635,3280599164,3511125626,1672640647,1672641791,1144
7957,3407725581,3899204805,1672572369,1672573285,916
7486,3520165601,3430504438,1672585612,1672586302,690
7888,3505962865,3394330287,1672534586,1672536390,1804
7964,3519912874,3510857360,1672601192,1672601369,177
7972,3716843669,3277939457,1672620433,1672620849,416
7648,3291235378,3500177712,1672569450,1672570091,641
7946,3970117174,3703789494,1672668495,1672670966,2471
7922,3757246925,3634995491,1672535286,1672538779,3493
7631,3970117174,3703223015,1672655153,1672655896,743
7712,3505098372,3713644518,1672604454,1672607916,3462
7634,3386707783,3249401741,1672697767,1672699528,1761
7680,3505638204,3735733948,1672642953,1672645192,2239
7562,3715339701,3399004969,1672595436,1672596928,1492
7532,3607748895,3430074045,1672688027,1672691003,2976
7789,3209048907,3402943525,1672670360,1672673395,3035
7753,3412825109,3429690204,1672641767,1672642746,979
7711,3360993964,3633420270,1672590458,1672592452,1994
7521,3891751546,3520206212,1672688562,1672690806,2244
7921,3518163778,3780593036,1672693838,1672696753,2915
7886,3735733948,3515723720,1672542446,1672546018,3572
7588,3433804879,3710098970,1672587986,1672588964,978
7851,3738274418,3509933351,1672640993,1672642041,1048
7959,3701498253,3711569060,1672657359,1672657831,472
7919,3701146057,3773429448,1672584127,1672587533,3406
7725,3516223597,3430074045,1672663228,1672665397,2169
7672,3772309150,3472130842,1672659754,1672659852,98
7891,3774520233,3660493209,1672679034,1672679522,488
7543,3777983879,3298433163,1672554691,1672556259,1568
7682,3774195321,3925620998,1672614499,1672617598,3099
7550,3404058699,3853018906,1672555084,1672556511,1427
7545,3518014636,3710112546,1672648883,1672650512,1629
7623,3496549058,3757812939,1672665575,1672665714,139
7648,3818255890,3825229501,1672655297,1672655439,142
7648,3311203656,3430074045,1672583567,1672584399,832
7724,3757682496,3501692334,1672550290,1672550656,366
7570,3372883226,3606987130,1672588681,1672590942,2261
7624,3515860749,3774195321,1672670183,1672672641,2458
7967,3206603608,3780974443,1672626426,1672628461,2035
7681,3829319703,3201432789,1672645375,1672648948,3573
7940,3385763781,3360743849,1672657394,1672657506,112
7888,3311845971,3475396323,1672691998,1672693629,1631
7981,3458539365,3780813786,1672606595,1672607624,1029
7658,3889750851,3520751702,1672586345,1672589094,2749
7750,3772714862,3772578994,1672625123,1672627183,2060
7597,3883042241,3346795719,1672619618,1672622754,3136
7694,3917278625,3346795719,1672642210,1672644556,2346
7708,3837094550,3483949762,1672551263,1672551950,687
7637,3852391257,3774501422,1672575923,1672577079,1156
7487,3505635228,3760183458,1672568440,1672570253,1813
7493,3500066230,3910454786,1672674578,1672676913,2335
7616,3206593906,3816853177,1672603928,1672605021,1093
7815,3395152943,3760489031,1672645113,1672647587,2474
7782,3882997884,3550946908,1672552381,1672552671,290
7621,3505000737,3208844525,1672601721,1672603528,1807
7585,3351554343,3512969370,1672670885,1672671235,350
7842,3293695955,3358871377,1672631473,1672631910,437
7647,3909238838,3779740455,1672574719,1672575349,630
7817,3917088658,3715492942,1672531755,1672532540,785
7722,3311415018,3793286136,1672589608,1672590155,547
7972,3883042241,3489545239,1672635682,1672637968,2286
7501,3510771358,3701178711,1672626558,1672629027,2469
7965,3454042520,3387674757,1672631403,1672632733,1330
7804,3465254146,3399911573,1672695838,1672698479,2641
7693,3311274543,3683766533,1672688535,1672688877,342
7952,3383661227,3978105277,1672703101,1672706549,3448
7519,3791997875,3826415738,1672569601,1672569784,183
7851,3512349371,3970117174,1672579316,1672581872,2556
7770,3772309150,3909331423,1672577015,1672579595,2580
7609,3793436995,3315583351,1672611415,1672612980,1565
7786,3703871468,3298433163,1672695530,1672698030,2500
7615,3496549058,3284832486,1672594000,1672594203,203
7888,3972364603,3755042098,1672650202,1672651052,850
7929,3792902982,3430504438,1672598596,1672598842,246
7806,3637008488,3611150562,1672644092,1672646076,1984
7874,3202120784,3634340855,1672690488,1672693939,3451
7914,3755943611,3885897503,1672651042,1672653062,2020
7866,3713644518,3360993964,1672633683,1672634083,400
7917,3774125065,3209048907,1672534974,1672536175,1201
7538,3505000737,3773978034,1672608496,1672608914,418
7623,3912536808,3791942683,1672680947,1672681809,862
7939,3715981584,3791020967,1672539490,1672541721,2231
7777,3882997884,3978115672,1672650166,1672652167,2001
7528,3710569131,3448855696,1672631795,1672634669,2874
7518,3776513891,3792384220,1672665309,1672668387,3078
7766,3500487333,3901877072,1672542665,1672545150,2485
7687,3703789494,3276993580,1672551145,1672554255,3110
7590,3882291183,3807987001,1672636142,1672639380,3238
7874,3755739653,3772746272,1672605255,1672607388,2133
7526,3510594211,3793871337,1672672749,1672676337,3588
7950,3701184889,3519803045,1672614535,1672616428,1893
7760,3600647945,3851190615,1672639788,1672643183,3395
7929,3791874383,3833889105,1672652899,1672654312,1413
7899,3703871468,3734828619,1672667278,1672670158,2880
7556,3505530961,3835382117,1672608949,1672611766,2817
7724,3516039895,3757246925,1672581799,1672584151,2352
7882,3772309166,3511862351,1672587837,1672589679,1842
7798,3889232789,3280599164,1672565225,1672568591,3366
7851,3634786711,3811171116,1672587007,1672589294,2287
7623,3533653428,3367902229,1672626516,1672627336,820
7925,3618873142,3421836608,1672676256,1672676820,564
7814,3518260334,3505904952,1672645777,1672646202,425
7603,3755872268,3716168623,1672631724,1672635030,3306
7608,3367029997,3209383861,1672541705,1672543469,1764
7544,3626156564,3779036831,1672559827,1672560734,907
7921,3416265063,3426325549,1672563391,1672565285,1894
7789,3880285638,3932051427,1672677165,1672678347,1182
7756,3791874383,3618873142,1672696511,1672697979,1468
7664,3500729955,3509604974,1672560549,1672564015,3466
7983,3519700826,3513454145,1672667187,1672667731,544
7926,3333896808,3701984666,1672606239,1672607528,1289
7505,3518360734,3432665384,1672533998,1672534510,512
7778,3505193212,3518876135,1672601384,1672603574,2190
7770,3666553782,3534702203,1672649350,1672650064,714
7686,3501601840,3793753089,1672585937,1672586786,849
7817,3701691675,3666553782,1672571906,1672574178,2272
7852,3614238812,3715974031,1672651300,1672651661,361
7789,3701146057,3777936328,1672595787,1672598168,2381
7690,3914259449,3533025282,1672688131,1672689538,1407
7527,3365830990,3337544549,1672575363,1672577860,2497
7947,3227457126,3472130842,1672555728,1672557319,1591
7868,3370636709,3774127586,1672566427,1672569232,2805
7707,3909606423,3778780511,1672620038,1672623261,3223
7703,3515284591,3482405588,1672551634,1672552665,1031
7490,3533827120,3683959482,1672635401,1672637008,1607
7670,3703889596,3424922204,1672662186,1672664124,1938
7819,3757161914,3883861463,1672647127,1672649762,2635
7690,3793753089,3384240055,1672565869,1672567335,1466
7659,3608868877,3318697153,1672609229,1672611572,2343
7733,3234541252,3804870229,1672593405,1672595516,2111
7957,3701146057,3815508790,1672546118,1672546453,335
7827,3223789409,3711569060,1672556778,1672559442,2664
7863,3773429448,3610695419,1672571867,1672572120,253
7749,3519556068,3388372715,1672594385,1672595563,1178
7767,3731419510,3604539807,1672689216,1672689567,351
7548,3829764737,3520719611,1672685907,1672688823,2916
7715,3298288268,3334033993,1672627224,1672630126,2902
7795,3534702203,3889750851,1672648719,1672652154,3435
7658,3855000166,3817621391,1672648552,1672651123,2571
7599,3519654779,3489962019,1672543455,1672544408,953
7596,3791957752,3446948848,1672679656,1672680392,736
7874,3755042098,3779218771,1672661405,1672663650,2245
7962,3792384220,3783779671,1672568674,1672570221,1547
7918,3533748232,3773120434,1672646120,1672648050,1930
7725,3344364444,3430352815,1672547360,1672550569,3209
7791,3510771358,3296471982,1672654416,1672657030,2614
7793,3517509185,3813052709,1672679572,1672679858,286
7704,3294803686,3286658957,1672606380,1672608436,2056
7787,3760561634,3511332835,1672694584,1672696801,2217
7773,3715998609,3520165601,1672570588,1672570893,305
7521,3793848402,3774127586,1672570091,1672570714,623
7533,3636867411,3713894336,1672592752,1672592998,246
7568,3356860407,3388637594,1672636359,1672637702,1343
7552,3505912939,3400804807,1672627316,1672628189,873
7663,3774466457,3607178184,1672656962,1672660363,3401
7700,3777623166,3776948966,1672657423,1672657894,471
7916,3407673904,3903307060,1672662147,1672662741,594
7754,3311871871,3793871337,1672603294,1672603672,378
7541,3484995752,3711198793,1672562961,1672564822,1861
7551,3601879040,3802367797,1672601771,1672604508,2737
7953,3311152102,3701178711,1672606530,1672608791,2261
7535,3362000049,3511350608,1672701595,1672704084,2489
7702,3757447189,3420700674,1672677015,1672677321,306
7527,3605726278,3776513891,1672589018,1672591876,2858
7576,3311152102,3287105466,1672598711,1672598929,218
7763,3924549929,3714197325,1672550809,1672551707,898
7845,3222521619,3924549929,1672589600,1672591368,1768
7669,3817316561,3421836608,1672615895,1672616394,499
7600,3428006164,3501198706,1672646707,1672647071,364
7864,3922337974,3505203158,1672552701,1672554216,1515
7762,3458539365,3780609808,1672607719,1672608160,441
7777,3516065852,3399004969,1672615568,1672618247,2679
7842,3311603601,3517721725,1672566629,1672569344,2715
7689,3715189301,3773978034,1672641801,1672642389,588
7849,3779629905,3235635976,1672603817,1672606352,2535
7690,3510937904,3352603894,1672673765,1672676459,2694
7910,3497901842,3489217083,1672654980,1672657829,2849
7921,3520183192,3898995675,1672564516,1672565740,1224
7681,3714474557,3916289176,1672688747,1672692068,3321
7486,3783245561,3534424200,1672584033,1672587386,3353
7626,3364543015,3777717988,1672678690,1672678940,250
7733,3772053179,3792384220,1672652594,1672655468,2874
7516,3514128943,3733891182,1672538348,1672541232,2884
7636,3505347134,3701863557,1672643509,1672646364,2855
7955,3776338577,3757161914,1672682972,1672683259,287
7615,3512969370,3514719601,1672667598,1672669934,2336
7966,3714504419,3458539365,1672681625,1672684688,3063
7887,3518408774,3701190899,1672670288,1672673330,3042
7752,3331845324,3755872268,1672549221,1672549515,294
7936,3701863557,3852391257,1672656920,1672657972,1052
7953,3505638204,3477649378,1672626901,1672628698,1797
7620,3888559320,3515394721,1672672461,1672673998,1537
7493,3344364444,3520719611,1672586030,1672587126,1096
7519,3777623166,3792768129,1672692226,1672694830,2604
7692,3756453423,3904408902,1672548689,1672552035,3346
7820,3611150562,3618045231,1672604241,1672607246,3005
7825,3481647420,3822654369,1672641981,1672642272,291
7908,3805519285,3501483568,1672531395,1672534413,3018
7782,3519556068,3478194807,1672659339,1672660568,1229
7957,3710344260,3510380060,1672660297,1672662752,2455
7739,3291227780,3783429780,1672676086,1672678286,2200
7631,3715974031,3200691026,1672583461,1672585248,1787
7578,3770078063,3715339701,1672590051,1672592060,2009
7866,3466911760,3516716179,1672651203,1672652257,1054
7823,3755943611,3510703546,1672548444,1672550774,2330
7707,3792384220,3793389510,1672700998,1672701769,771
7634,3505635228,3760077057,1672683668,1672684381,713
7546,3780365428,3244485293,1672669055,1672670136,1081
7918,3311090974,3853018906,1672594670,1672595249,579
7942,3757455053,3385763781,1672547115,1672548871,1756
7889,3774580701,3778266283,1672562601,1672563880,1279
7622,3511841857,3520730271,1672599066,1672602646,3580
7844,3904775198,3533653428,1672649191,1672650703,1512
7826,3494290908,3519428855,1672674361,1672676557,2196
7915,3500365158,3791901535,1672551741,1672551934,193
7856,3710569131,3972709319,1672674088,1672676078,1990
7624,3316173088,3859663348,1672668945,1672672389,3444
7528,3430352815,3510857360,1672551736,1672553778,2042
7688,3791957752,3232962003,1672549911,1672550455,544
7695,3902383721,3886298125,1672696518,1672696715,197
7745,3716197887,3972709319,1672561954,1672564630,2676
7866,3731419510,3975287541,1672690223,1672691520,1297
7888,3791602225,3534010629,1672621102,1672623877,2775
7737,3710067113,3715581279,1672577761,1672579568,1807
7889,3395152943,3936227020,1672654098,1672656286,2188
7900,3664517356,3501486692,1672597382,1672598980,1598
7755,3370752401,3774793839,1672651244,1672651554,310
7949,3714197325,3888559320,1672562006,1672564459,2453
7869,3379256399,3458539365,1672624101,1672625740,1639
7657,3356860407,3511687358,1672554984,1672555863,879
7614,3714474557,3501730685,1672680305,1672682240,1935
7840,3608633356,3512217942,1672613738,1672615988,2250
7705,3473765852,3417587765,1672664340,1672666995,2655
7513,3550946908,3783531004,1672568426,1672569086,660
7531,3383661227,3206254161,1672652771,1672653264,493
7494,3311603601,3777936328,1672694924,1672695463,539
7661,3793627961,3550946908,1672695100,1672698620,3520
7863,3774066725,3511125626,1672654368,1672657757,3389
7767,3516465662,3817621391,1672547724,1672547824,100
7907,3311065516,3778108318,1672577797,1672580007,2210
7793,3249791738,3916289176,1672701620,1672703403,1783
7559,3937224533,3534729133,1672699554,1672700413,859
7879,3773465237,3518876135,1672593620,1672593771,151
7702,3515151980,3515691540,1672674237,1672677516,3279
7569,3512349371,3826760240,1672555020,1672556890,1870
7784,3755511676,3505000737,1672572733,1672573195,462
7727,3858918246,3666553782,1672598101,1672598275,174
7574,3490191091,3466229085,1672681584,1672684418,2834
7945,3516016437,3715581279,1672628670,1672629907,1237
7712,3505859863,3668898102,1672579739,1672581476,1737
7498,3500177712,3534191820,1672622220,1672622834,614
7781,3772309166,3407673904,1672655538,1672658390,2852
7529,3772578994,3739106581,1672655814,1672658067,2253
7801,3711973519,3912262917,1672686223,1672686466,243
7652,3735733948,3666457294,1672573001,1672575894,2893
7748,3509604974,3385763781,1672700817,1672703086,2269
7749,3399433690,3337544549,1672557042,1672558216,1174
7891,3770851318,3336742544,1672651857,1672653004,1147
7691,3383922351,3388637594,1672604970,1672606498,1528
7618,3909331423,3608633356,1672560942,1672563059,2117
7669,3755511676,3293695955,1672655597,1672658097,2500
7555,3476232529,3222521619,1672557165,1672558686,1521
7806,3819727225,3777455223,1672661618,1672664653,3035
7654,3899266183,3497901842,1672654279,1672656271,1992
7867,3533385867,3828365570,1672703858,1672706528,2670
7723,3372883226,3791594391,1672648163,1672651461,3298
7579,3755587522,3505362057,1672537500,1672540730,3230
7713,3703955926,3388637594,1672536926,1672540163,3237
7631,3922275416,3774466457,1672617214,1672620002,2788
7795,3465254146,3772053179,1672645342,1672646713,1371
7906,3882997884,3685187183,1672579646,1672580379,733
7545,3792844210,3667680268,1672616035,1672618233,2198
7609,3600647945,3496269445,1672608334,1672610360,2026
7568,3201432789,3773465237,1672577109,1672579349,2240
7768,3611150562,3779218771,1672563439,1672563504,65
7901,3271938399,3780609808,1672575749,1672578420,2671
7753,3372883226,3222448362,1672695189,1672695962,773
7555,3501927421,3500894271,1672534086,1672536153,2067
7604,3501606184,3505599848,1672625652,1672628268,2616
7869,3405494240,3471220483,1672645039,1672646066,1027
7537,3515723720,3520756859,1672661954,1672663661,1707
7664,3774127586,3318166135,1672613591,1672615099,1508
7488,3972364603,3500066230,1672691558,1672692558,1000
7728,3301107849,3793436995,1672541896,1672544225,2329
7855,3231056870,3519152550,1672610771,1672614020,3249
7664,3701898991,3809059934,1672702182,1672704884,2702
7584,3826760240,3333896808,1672658091,1672660296,2205
7539,3509352754,3231056870,1672586173,1672588180,2007
7773,3922337974,3783083229,1672588718,1672591708,2990
7597,3714504419,3901990690,1672574251,1672576411,2160
7737,3505203158,3497901842,1672542141,1672544627,2486
7604,3509672210,3357483218,1672673282,1672673717,435
7715,3716537575,3827377568,1672537263,1672539916,2653
7523,3466229085,3904775198,1672569480,1672570656,1176
7853,3481647420,3778980116,1672684908,1672687243,2335
7543,3397418363,3202120784,1672535814,1672536071,257
7799,3249247700,3516629436,1672643535,1672645833,2298
7631,3716488385,3778341199,1672655077,1672656284,1207
7821,3628819436,3311648200,1672662764,1672663150,386
7949,3607748895,3714962248,1672578772,1672582171,3399
7517,3395152943,3509933351,1672614041,1672614900,859
7770,3517721725,3774204963,1672598055,1672600966,2911
7844,3383922351,3701184889,1672636972,1672637553,581
7834,3710067113,3755511676,1672537425,1672540160,2735
7650,3774005526,3438645253,1672653473,1672655253,1780
7902,3925620998,3303751772,1672683318,1672683648,330
7859,3791602225,3501759100,1672604821,1672607764,2943
7773,3206593906,3939952128,1672561683,1672565275,3592
7879,3331845324,3711973519,1672630763,1672632074,1311
7824,3358871377,3606186086,1672547043,1672550193,3150
7885,3533371364,3533748232,1672651737,1672653476,1739
7726,3384951177,3478194807,1672688925,1672692277,3352
7644,3482405588,3247780536,1672595414,1672598170,2756
7930,3311065516,3500894271,1672569980,1672570609,629
7507,3792384220,3399004969,1672679460,1672681907,2447
7953,3559110998,3501606184,1672645159,1672646339,1180
7983,3500199935,3369998498,1672578878,1672582411,3533
7567,3277939457,3314245084,1672557727,1672559426,1699
7651,3516065852,3365830990,1672637435,1672638659,1224
7870,3206603608,3465254146,1672560068,1672561013,945
7694,3517864478,3518932404,1672632549,1672635191,2642
7490,3311648200,3777079686,1672656871,1672657608,737
7556,3380035798,3777455223,1672667184,1672667292,108
7779,3342131135,3757562897,1672615077,1672616028,951
7618,3780788622,3360993964,1672564048,1672566956,2908
7486,3520931254,3554917400,1672544086,1672544621,535
7822,3713268590,3399052055,1672531941,1672532013,72
7896,3851190615,3629547065,1672619427,1672622058,2631
7806,3505635228,3701691675,1672570269,1672571650,1381
7914,3936227020,3336751428,1672547159,1672548556,1397
7921,3738274418,3792844210,1672658149,1672658778,629
7868,3519428855,3246596716,1672602998,1672605470,2472
7498,3222448362,3776800213,1672536743,1672538275,1532
7901,3777983879,3227158514,1672698801,1672699586,785
7657,3715981584,3277939457,1672594046,1672596602,2556
7714,3793286136,3736592744,1672571211,1672573484,2273
7711,3399911573,3351554343,1672568505,1672570843,2338
7805,3760489031,3514283243,1672634744,1672637166,2422
7490,3481502100,3774580701,1672546722,1672548540,1818
7865,3621497531,3534553510,1672613470,1672616537,3067
7922,3386707783,3483164654,1672622845,1672625016,2171
7722,3407673904,3760561634,1672602201,1672605556,3355
7868,3777477395,3715581279,1672550440,1672552312,1872
7804,3760598102,3505193212,1672690816,1672692732,1916
7504,3783509527,3918674986,1672630465,1672631042,577
7547,3351008918,3512683609,1672620481,1672623225,2744
7626,3618873142,3889750851,1672548109,1672550503,2394
7982,3881477378,3773755137,1672620526,1672623541,3015
7668,3533025282,3924549929,1672686683,1672688780,2097
7606,3249247700,3520888296,1672543135,1672546360,3225
7725,3514719601,3533242305,1672582329,1672585242,2913
7520,3500177712,3202120784,1672557571,1672560019,2448
7660,3737079798,3777455223,1672601421,1672601700,279
7938,3312333615,3365830990,1672540606,1672543090,2484
7936,3510126867,3286658957,1672655539,1672658172,2633
7976,3780788622,3715974031,1672656836,1672657485,649
7641,3515691540,3660493209,1672674689,1672675396,707
7814,3318166135,3621810464,1672619457,1672621385,1928
7770,3777717988,3520756859,1672611116,1672614046,2930
7515,3294803686,3475251781,1672664666,1672665840,1174
7599,3518163778,3494290908,1672564272,1672567449,3177
7592,3279721246,3385763781,1672582944,1672586251,3307
7801,3514838220,3898995675,1672674366,1672674959,593
7846,3518014404,3201432789,1672651622,1672654438,2816
7824,3793848402,3518669703,1672564247,1672566783,2536
7905,3511170269,3554917400,1672658191,1672660305,2114
7624,3402943525,3238712269,1672694075,1672696793,2718
7493,3485375593,3311993075,1672647982,1672651201,3219
7679,3701691675,3819727225,1672700371,1672702618,2247
7938,3510857360,3756424865,1672558947,1672560891,1944
7875,3516016437,3377766165,1672601227,1672601800,573
7551,3618045231,3736592744,1672676293,1672679421,3128
7980,3294803686,3909238838,1672542964,1672545284,2320
7486,3345207877,3909331423,1672562147,1672563866,1719
7934,3772359096,3244173074,1672603044,1672606123,3079
7726,3975287541,3903307060,1672655288,1672656237,949
7760,3417061462,3271938399,1672574200,1672574629,429
7975,3615046771,3229665776,1672574402,1672577078,2676
7846,3412825109,3777623166,1672687290,1672689036,1746
7819,3932051427,3701111745,1672679726,1672681644,1918
7624,3770851318,3710408395,1672700420,1672703689,3269
7869,3512142794,3336742544,1672685671,1672688114,2443
7643,3416427576,3520629279,1672559600,1672560872,1272
7886,3716258994,3312829208,1672605994,1672608769,2775
7510,3755739653,3914290246,1672582534,1672585852,3318
7580,3668005723,3360993964,1672656137,1672656919,782
7879,3791602225,3714197325,1672639430,1672641898,2468
7633,3730517636,3777120536,1672669545,1672670713,1168
7511,3617734118,3509907947,1672687031,1672688876,1845
7566,3554917400,3972364603,1672648938,1672649052,114
7944,3220716272,3777120536,1672702730,1672704106,1376
7754,3760267716,3715981584,1672546055,1672546201,146
7977,3774580701,3311845971,1672623750,1672627020,3270
7563,3533748232,3755943611,1672537454,1672539175,1721
7850,3373384732,3501364586,1672555358,1672558323,2965
7587,3933210486,3791942683,1672533545,1672534909,1364
7792,3930797455,3331845324,1672618081,1672621036,2955
7855,3388286531,3519703355,1672571834,1672575339,3505
7881,3513599775,3791942683,1672598838,1672601734,2896
7805,3617055293,3465254146,1672667795,1672670060,2265
7706,3711262377,3637008488,1672582652,1672583749,1097
7951,3516606733,3629935998,1672616216,1672616515,299
7697,3505635228,3755739653,1672563224,1672563729,505
7552,3777806071,3703275621,1672554400,1672557169,2769
7905,3358871377,3500578848,1672688214,1672688996,782
7652,3716537575,3716746253,1672612449,1672615156,2707
7627,3904775198,3520706195,1672660261,1672663150,2889
7527,3518876135,3667680268,1672539238,1672540049,811
7749,3520719611,3234541252,1672557858,1672560275,2417
7548,3519703355,3773814927,1672556275,1672559621,3346
7717,3777623166,3813052709,1672687226,1672688327,1101
7920,3411618230,3401627165,1672575591,1672576011,420
7580,3236102733,3390068992,1672552721,1672552921,200
7931,3500499542,3500487333,1672567982,1672571579,3597
7661,3783705817,3760183458,1672612923,1672615219,2296
7729,3346795719,3238712269,1672550121,1672550787,666
7537,3307512479,3459030804,1672676507,1672678833,2326
7777,3520888296,3284832486,1672579199,1672579341,142
7938,3505201246,3509933351,1672686790,1672690117,3327
7764,3512683609,3235287260,1672581462,1672584635,3173
7488,3604539807,3703955926,1672621272,1672621388,116
7568,3224058172,3703661585,1672649827,1672652216,2389
7952,3289061738,3891751546,1672624990,1672626783,1793
7868,3914290246,3519803045,1672599235,1672602814,3579
7818,3773205565,3734737881,1672534704,1672537351,2647
7887,3400918687,3405494240,1672611525,1672612354,829
7542,3493507965,3510244400,1672607116,1672608822,1706
7939,3736229191,3791874383,1672564749,1672565726,977
7778,3511271692,3420432297,1672533428,1672534621,1193
7943,3936227020,3534729133,1672590065,1672592845,2780
7775,3815508790,3711308224,1672544917,1672545660,743
7779,3500578848,3533369198,1672644028,1672645231,1203
7791,3774127586,3533270638,1672648639,1672652155,3516
7980,3826633236,3914290246,1672638262,1672641343,3081
7863,3736625083,3774005526,1672576361,1672576592,231
7830,3518408774,3776513891,1672616306,1672618028,1722
7700,3432665384,3914259449,1672615878,1672617054,1176
7782,3429856982,3891751546,1672656373,1672659625,3252
7912,3685818092,3710112546,1672660980,1672663342,2362
7760,3739106581,3518932404,1672668902,1672671473,2571
7823,3400804807,3349613093,1672588837,1672589088,251
7826,3378436155,3834257412,1672696353,1672696975,622
7714,3629935998,3823600322,1672697454,1672699214,1760
7741,3438645253,3757682496,1672538007,1672540512,2505
7762,3713268590,3703735129,1672556173,1672556435,262
7812,3221899927,3920801189,1672634904,1672637641,2737
7787,3710408395,3533626375,1672618588,1672621861,3273
7601,3496269445,3399433690,1672562190,1672564167,1977
7831,3367902229,3760561634,1672697494,1672698895,1401
7758,3778549126,3777717988,1672659645,1672659957,312
7802,3500060260,3770824086,1672617046,1672619473,2427
7719,3688683847,3716835696,1672624509,1672626690,2181
7970,3911159965,3518876135,1672663774,1672665035,1261
7772,3318697153,3711380716,1672621392,1672622395,1003
7919,3519654779,3711973519,1672673588,1672674354,766
7843,3365614305,3360506772,1672557312,1672557415,103
7692,3779218771,3904775198,1672673724,1672675211,1487
7892,3311761694,3244173074,1672651651,1672652656,1005
7905,3519428855,3777443199,1672604188,1672604758,570
7762,3835382117,3835382117,1672623251,1672626548,3297
7914,3364543015,3755392666,1672678431,1672679112,681
7493,3791602225,3857349323,1672590474,1672592951,2477
7978,3391915886,3855602893,1672657870,1672660386,2516
7524,3791115967,3777623166,1672549787,1672552157,2370
7790,3345207877,3513956646,1672656410,1672659798,3388
7523,3505873261,3608868877,1672576147,1672577423,1276
7956,3714962248,3311718847,1672576177,1672577872,1695
7816,3311090974,3774127586,1672630414,1672631631,1217
7795,3683766533,3249401741,1672628794,1672629656,862
7754,3519803045,3827377568,1672637358,1672637644,286
7578,3518014404,3778980116,1672586660,1672590222,3562
7693,3312829208,3760492950,1672648038,1672649479,1441
7565,3662180254,3477375368,1672579684,1672581292,1608
7887,3510380060,3701498253,1672554327,1672556045,1718
7526,3713630656,3774045700,1672553514,1672555408,1894
7745,3293695955,3914290246,1672656394,1672657774,1380
7595,3715981584,3339907603,1672653292,1672655262,1970
7557,3711370563,3518669703,1672697405,1672698840,1435
7677,3285400528,3770078063,1672668075,1672671412,3337
7817,3483949762,3399052055,1672656339,1672657445,1106
7890,3519703355,3475251781,1672680855,1672682968,2113
7865,3311648200,3510247121,1672552633,1672555397,2764
7876,3411618230,3826759140,1672682503,1672682692,189
7740,3505145247,3778305740,1672586456,1672589364,2908
7828,3500578848,3301107849,1672657804,1672660988,3184
7969,3209048907,3533280269,1672703219,1672703416,197
7678,3912262917,3505791599,1672681222,1672681653,431
7860,3713208927,3909238838,1672627048,1672629057,2009
7894,3384240055,3774298222,1672589561,1672592587,3026
7849,3618873142,3478194807,1672666239,1672669287,3048
7967,3518360734,3420432297,1672647025,1672648035,1010
7978,3277939457,3918584946,1672571878,1672574340,2462
7541,3703441914,3311439795,1672537427,1672539652,2225
7744,3379589402,3342131135,1672627957,1672629449,1492
7808,3500066230,3514472925,1672673804,1672674571,767
7888,3501198706,3633420270,1672642251,1672643379,1128
7704,3357483218,3515723720,1672635748,1672637965,2217
7792,3783705817,3386707783,1672589098,1672590634,1536
7951,3519803045,3731106822,1672597625,1672600820,3195
7793,3247428249,3534010629,1672630431,1672633622,3191
7925,3735733948,3666507626,1672577536,1672579368,1832
7788,3776948966,3755042098,1672644966,1672646697,1731
7523,3514128943,3512837326,1672559969,1672562220,2251
7851,3713786889,3520709480,1672679677,1672682512,2835
7601,3600647945,3338703270,1672618870,1672620209,1339
7798,3859663348,3886298125,1672547759,1672548608,849
7639,3533748232,3757812939,1672661266,1672661753,487
7702,3976390453,3777443199,1672677170,1672680438,3268
7833,3500994774,3472130842,1672620000,1672623577,3577
7492,3800353779,3792883665,1672591003,1672594381,3378
7958,3520709480,3244436890,1672571552,1672574244,2692
7571,3311993075,3756623396,1672539290,1672541601,2311
7556,3813052709,3853018906,1672636103,1672636470,367
7798,3533270638,3608633356,1672616432,1672619597,3165
7553,3778341199,3756601594,1672543397,1672544388,991
7951,3488244966,3778308417,1672589500,1672589822,322
7606,3510247121,3501927421,1672662891,1672664528,1637
7825,3666553782,3314836094,1672535241,1672538163,2922
7776,3276640712,3303705369,1672533677,1672533778,101
7839,3774556560,3783245561,1672585103,1672587798,2695
7936,3760893269,3519703355,1672695096,1672697149,2053
7513,3509907947,3760183458,1672547019,1672549660,2641
7700,3478194807,3316222192,1672636189,1672638557,2368
7962,3734737881,3973560347,1672658162,1672658730,568
7596,3816454165,3467773920,1672598781,1672598950,169
7715,3937224533,3613995936,1672568347,1672571276,2929
7591,3362000049,3489217083,1672599980,1672602137,2157
7873,3516016437,3859663348,1672674762,1672676117,1355
7862,3811171116,3935627557,1672687954,1672688306,352
7876,3286658957,3779036831,1672560982,1672562593,1611
7546,3667680268,3770021824,1672572835,1672573325,490
7776,3662180254,3515125508,1672699353,1672702688,3335
7675,3809059934,3779976989,1672578992,1672581874,2882
7940,3757447189,3714504419,1672700505,1672703614,3109
7945,3511435497,3360743849,1672660781,1672663890,3109
7960,3246596716,3505219850,1672599916,1672602116,2200
7955,3710344260,3514283243,1672645400,1672646239,839
7758,3939952128,3365830990,1672603999,1672604417,418
7726,3512510536,3715998609,1672671784,1672675276,3492
7520,3311415018,3614238812,1672620929,1672622034,1105
7779,3855937514,3634340855,1672577443,1672577559,116
7496,3307512479,3533137446,1672624396,1672627335,2939
7618,3285400528,3757812939,1672582181,1672583688,1507
7659,3247780536,3881477378,1672539409,1672542098,2689
7796,3774520233,3473765852,1672656334,1672658849,2515
7889,3379256399,3780828689,1672648257,1672648336,79
7932,3701534009,3209027249,1672592559,1672593188,629
7880,3739106581,3972709319,1672660754,1672664164,3410
7569,3519563836,3828624701,1672575097,1672575526,429
7610,3533748232,3512166013,1672649821,1672650511,690
7778,3500729955,3774066725,1672663968,1672667086,3118
7514,3760183458,3757602960,1672556628,1672558897,2269
7580,3379256399,3515125508,1672547651,1672549492,1841
7675,3817621391,3909331423,1672560915,1672563330,2415
7562,3453729665,3276993580,1672568808,1672570422,1614
7772,3883312122,3500729955,1672619110,1672621081,1971
7575,3516258476,3500803339,1672639167,1672642294,3127
7782,3924549929,3513164386,1672697714,1672701163,3449
7936,3454042520,3500391167,1672610880,1672611788,908
7923,3755872268,3778980116,1672548694,1672550614,1920
7912,3399433690,3852595551,1672666673,1672668774,2101
7974,3634786711,3701146057,1672626872,1672627065,193
7820,3478194807,3925402713,1672536643,1672538332,1689
7820,3608633356,3701146057,1672572025,1672572345,320
7531,3636867411,3936227020,1672567885,1672571319,3434
7557,3505173328,3311154569,1672680557,1672682544,1987
7670,3513599775,3534729133,1672689303,1672689493,190
7698,3933210486,3246596716,1672579927,1672580652,725
7663,3703661585,3607748895,1672697228,1672698340,1112
7776,3505292701,3791334389,1672641921,1672645007,3086
7813,3757562897,3805342762,1672539275,1672539615,340
7679,3386707783,3505530961,1672535260,1672536636,1376
7533,3489217083,3783206719,1672685661,1672687724,2063
7572,3772053179,3770763956,1672686362,1672687061,699
7644,3533810360,3756528686,1672693505,1672694464,959
7794,3421127249,3500578848,1672568539,1672571702,3163
7712,3489217083,3815508790,1672591924,1672592247,323
7964,3466911760,3512969370,1672543070,1672545388,2318
7601,3378092448,3737079798,1672592434,1672595460,3026
7501,3421836608,3634995491,1672569292,1672571733,2441
7869,3520183192,3792844210,1672700710,1672701991,1281
7485,3377766165,3829232696,1672684864,1672688014,3150
7933,3855602893,3489545239,1672541450,1672543583,2133
7796,3713370078,3783083229,1672692230,1672695172,2942
7644,3760183458,3711973519,1672565360,1672566363,1003
7704,3389115045,3714962248,1672536541,1672538718,2177
7924,3757455053,3793389510,1672655360,1672657620,2260
7813,3778780511,3756424865,1672548632,1672551997,3365
7811,3773205565,3930791338,1672606394,1672607137,743
7823,3500374658,3200198928,1672605757,1672606767,1010
7931,3917278625,3378436155,1672572112,1672574043,1931
7670,3513164386,3916289176,1672586993,1672587481,488
7745,3774580701,3783429780,1672533708,1672535082,1374
7921,3902383721,3276640712,1672566167,1672568334,2167
7523,3372883226,3446948848,1672691964,1672695564,3600
7904,3501601840,3777455223,1672666590,1672669569,2979
7747,3853018906,3774045700,1672555247,1672555992,745
7647,3500487333,3685187183,1672663911,1672665671,1760
7676,3396086535,3518014404,1672553323,1672556545,3222
7791,3514987389,3714474557,1672594334,1672597888,3554
7748,3533270638,3637008488,1672588491,1672589666,1175
7682,3395152943,3666457294,1672677514,1672677781,267
7702,3519703355,3791942683,1672642349,1672643797,1448
7508,3912262917,3345207877,1672550180,1672552373,2193
7820,3246596716,3229665776,1672547973,1672550302,2329
7951,3634786711,3533371364,1672689900,1672692334,2434
7944,3774501422,3608633356,1672657630,1672658375,745
7583,3337544549,3827377568,1672649570,1672650934,1364
7747,3312333615,3772642849,1672537044,1672537652,608
7619,3770553384,3520706195,1672570264,1672573081,2817
7923,3783126683,3755511676,1672582095,1672585533,3438
7696,3360993964,3713894336,1672599886,1672600171,285
7914,3779740455,3734737881,1672547471,1672548561,1090
7895,3777790718,3804870229,1672614657,1672617050,2393
7842,3533025282,3533927138,1672688753,1672690966,2213
7488,3783779671,3828432634,1672557993,1672560922,2929
7523,3512166013,3224716315,1672638457,1672640928,2471
7577,3224058172,3760492950,1672640106,1672641558,1452
7925,3668898102,3774580701,1672612862,1672615884,3022
7659,3772309150,3683766533,1672565870,1672568035,2165
7519,3835382117,3772544062,1672588342,1672590515,2173
7626,3772544062,3711571712,1672702237,1672704259,2022
7686,3439023335,3209383861,1672687083,1672689670,2587
7612,3666553782,3778549126,1672676696,1672679639,2943
7639,3701691675,3201432789,1672618419,1672619650,1231
7732,3701274634,3505791599,1672580445,1672581962,1517
7929,3667680268,3711571712,1672660613,1672660881,268
7682,3307097200,3505883609,1672696829,1672698867,2038
7950,3475258557,3494290908,1672626184,1672627270,1086
7972,3443698222,3855000166,1672612270,1672615777,3507
7788,3778305740,3391261292,1672623915,1672624733,818
7967,3755872268,3703735129,1672657183,1672660435,3252
7679,3882291183,3505362057,1672549740,1672552995,3255
7515,3770021824,3487171044,1672574976,1672577677,2701
7818,3505098372,3792288302,1672698469,1672701924,3455
7876,3757403279,3793627961,1672687722,1672691179,3457
7567,3627937312,3302626661,1672540305,1672542533,2228
7683,3732481297,3514987389,1672575689,1672576198,509
7976,3396285984,3714488548,1672621698,1672624284,2586
7711,3288764520,3629547065,1672615122,1672616413,1291
7939,3392121505,3500060260,1672623674,1672624003,329
7501,3912536808,3701146057,1672689154,1672690043,889
7722,3756623396,3277605882,1672645312,1672645373,61
7694,3466229085,3715339701,1672594145,1672594851,706
7594,3714197325,3701274634,1672568678,1672571789,3111
7722,3774050956,3703275621,1672534730,1672535813,1083
7610,3293695955,3430074045,1672672293,1672673980,1687
7765,3773814927,3466911760,1672600934,1672601063,129
7833,3925402713,3701178711,1672560408,1672562221,1813
7577,3883085535,3509907947,1672662060,1672665547,3487
7533,3891751546,3501486692,1672700052,1672700785,733
7486,3390068992,3778266283,1672539891,1672541483,1592
7813,3501601840,3882291183,1672567503,1672568307,804
7544,3778308417,3201432789,1672571022,1672571096,74
7934,3757161914,3773664987,1672666721,1672669382,2661
7943,3817621391,3511435497,1672700192,1672700983,791
7710,3209048907,3714474557,1672594109,1672596677,2568
7778,3517864478,3909331423,1672566921,1672567546,625
7678,3777929708,3918584946,1672575555,1672577498,1943
7733,3519563836,3534191820,1672630634,1672634153,3519
7872,3349613093,3378686918,1672620965,1672623300,2335
7523,3494290908,3501483568,1672571667,1672571748,81
7851,3509933351,3685818092,1672578519,1672579541,1022
7879,3703661585,3505098372,1672619103,1672620838,1735
7740,3516016437,3404058699,1672628701,1672631108,2407
7675,3220716272,3701065786,1672684523,1672687945,3422
7544,3314836094,3384240055,1672559132,1672562081,2949
7492,3760492950,3918674986,1672674468,1672676517,2049
7678,3783196518,3298288268,1672584813,1672585671,858
7641,3791020967,3738502357,1672570578,1672571181,603
7914,3533385867,3711265369,1672611539,1672613755,2216
7492,3774204963,3976390453,1672601033,1672603893,2860
7978,3634340855,3244389794,1672552994,1672553286,292
7594,3520706195,3774793839,1672689769,1672692678,2909
7725,3972364603,3774050956,1672612589,1672614534,1945
7657,3625274012,3293695955,1672690010,1672692822,2812
7715,3516465662,3500578848,1672664333,1672666826,2493
7569,3883042241,3822654369,1672676566,1672678215,1649
7942,3713969578,3711265369,1672540547,1672541604,1057
7734,3500066230,3238712269,1672587013,1672589851,2838
7822,3853018906,3793848402,1672647894,1672650579,2685
7499,3311439795,3430352815,1672668768,1672668884,116
7896,3311439795,3770824086,1672547898,1672548422,524
7929,3430504438,3783239924,1672653808,1672654779,971
7695,3889232789,3922275416,1672583240,1672586104,2864
7490,3703661585,3391915121,1672679578,1672681168,1590
7517,3755881905,3739106581,1672629439,1672632143,2704
7799,3439023335,3520190170,1672556742,1672557479,737
7894,3428006164,3360743849,1672689761,1672690655,894
7857,3701984666,3755943611,1672599041,1672602582,3541
7668,3909331423,3378092448,1672614213,1672616856,2643
7936,3517963492,3360993964,1672576972,1672578145,1173
7887,3715974031,3415443558,1672608378,1672609618,1240
7931,3909238838,3910454786,1672616619,1672617922,1303
7850,3770101921,3505201246,1672555738,1672556956,1218
7971,3688418210,3716537575,1672548194,1672551642,3448
7597,3505219850,3757562897,1672593319,1672593872,553
7931,3516065852,3755042098,1672563276,1672563864,588
7935,3534191820,3716197887,1672558221,1672560249,2028
7729,3826415738,3443698222,1672540577,1672541840,1263
7767,3783779671,3405494240,1672676076,1672677842,1766
7718,3792288302,3852391257,1672667729,1672669148,1419
7873,3608868877,3760992710,1672650481,1672652253,1772
7981,3735733948,3358871377,1672596127,1672599676,3549
7947,3820354437,3517255726,1672686819,1672688844,2025
7855,3501364586,3755881905,1672598990,1672599463,473
7627,3760492950,3755511676,1672621275,1672622124,849
7622,3505962865,3772544062,1672701082,1672702217,1135
7841,3772642849,3792844210,1672578372,1672579572,1200
7493,3388286531,3514283243,1672604133,1672604361,228
7622,3533927138,3418534998,1672685282,1672686653,1371
7968,3711569060,3399535232,1672703165,1672705668,2503
7586,3512837326,3734737881,1672626148,1672629213,3065
7689,3505873261,3791594391,1672537753,1672540570,2817
7499,3399052055,3404058699,1672576894,1672580188,3294
7663,3776066388,3516011407,1672572867,1672576403,3536
7772,3428006164,3898995675,1672667776,1672669927,2151
7719,3800353779,3828432634,1672544585,1672545446,861
7566,3978115672,3777623166,1672642793,1672644373,1580
7751,3813052709,3467773920,1672553770,1672554104,334
7818,3760294205,3811694763,1672652830,1672655451,2621
7838,3778341199,3500803339,1672556448,1672558435,1987
7719,3855602893,3512142794,1672699034,1672701014,1980
7685,3400804807,3555214688,1672633523,1672634313,790
7982,3835382117,3777514571,1672631787,1672632766,979
7890,3777983879,3510126867,1672633697,1672635427,1730
7838,3501692334,3231056870,1672690227,1672690520,293
7948,3286658957,3600647945,1672643540,1672645631,2091
7663,3357483218,3809916577,1672617717,1672619121,1404
7837,3774045700,3357483218,1672562454,1672564707,2253
7796,3904775198,3520629279,1672669601,1672670204,603
7941,3518876135,3791594391,1672659080,1672659674,594
7631,3804870229,3220716272,1672599536,1672601359,1823
7513,3362000049,3887270940,1672542586,1672543529,943
7722,3311090974,3666507626,1672664620,1672665296,676
7817,3244389794,3533371364,1672575327,1672575393,66
7828,3774125065,3271938399,1672620359,1672620505,146
7612,3773950140,3483164654,1672582938,1672583304,366
7873,3600647945,3613995936,1672653303,1672654908,1605
7576,3206254161,3516465662,1672579109,1672580012,903
7683,3737154119,3714504419,1672670163,1672671782,1619
7528,3365278081,3783531004,1672592630,1672594819,2189
7882,3756021689,3779740455,1672634966,1672637256,2290
7788,3517077106,3394539273,1672539683,1672542928,3245
7888,3516223597,3500803339,1672660036,1672662186,2150
7890,3510703546,3222448362,1672532033,1672534182,2149
7878,3510247121,3291235378,1672651162,1672652921,1759
7674,3774204963,3912262917,1672616017,1672617761,1744
7843,3715492942,3733189298,1672670313,1672671527,1214
7596,3914290246,3534010629,1672586010,1672587864,1854
7856,3777514571,3778341199,1672577754,1672581181,3427
7821,3370636709,3224058172,1672599267,1672600318,1051
7617,3979339287,3791997875,1672695348,1672697662,2314
7748,3318166135,3424922204,1672668006,1672670217,2211
7763,3311154569,3791115967,1672584175,1672585921,1746
7799,3859663348,3510247121,1672635320,1672636289,969
7624,3399052055,3352603894,1672552514,1672554552,2038
7857,3533927138,3505859863,1672564152,1672565411,1259
7942,3311065516,3792032359,1672653580,1672655950,2370
7845,3516011407,3533827120,1672663822,1672664248,426
7749,3516673015,3701111745,1672632000,1672635036,3036
7588,3757246925,3779218771,1672587394,1672587463,69
7665,3512720680,3500365158,1672693546,1672694639,1093
7698,3760893269,3236102733,1672602585,1672603766,1181
7667,3607178184,3238712269,1672644055,1672645733,1678
7721,3899266183,3500487333,1672576736,1672576880,144
7836,3501184421,3517077106,1672666293,1672669279,2986
7580,3793338102,3513454145,1672593840,1672594047,207
7917,3711504540,3249247700,1672699784,1672702196,2412
7586,3518932404,3827626797,1672579484,1672579669,185
7898,3887270940,3426325549,1672680641,1672680777,136
7891,3780365428,3511198618,1672701635,1672701718,83
7824,3772884106,3228165483,1672563284,1672565264,1980
7948,3516629436,3392121505,1672684159,1672686044,1885
7714,3505859863,3715492942,1672603880,1672607361,3481
7863,3417970574,3379589402,1672553348,1672555732,2384
7822,3520931254,3512720680,1672545587,1672546611,1024
7912,3512567240,3247815299,1672604598,1672604876,278
7579,3783083229,3338367113,1672649837,1672651876,2039
7485,3481502100,3715998609,1672672576,1672674804,2228
7972,3500578848,3514719601,1672618320,1672620671,2351
7847,3512540951,3223968713,1672607489,1672609391,1902
7803,3822654369,3899204805,1672536774,1672537299,525
7867,3313564074,3716488385,1672680484,1672683271,2787
7752,3777623166,3516980378,1672645875,1672646638,763
7729,3780503655,3311603601,1672628986,1672631570,2584
7495,3386707783,3734496778,1672604142,1672604788,646
7650,3760992710,3517963492,1672625896,1672626700,804
7503,3520190170,3703718151,1672592995,1672596287,3292
7842,3338367113,3334033993,1672621772,1672624801,3029
7890,3311761694,3629547065,1672587013,1672589658,2645
7641,3703889596,3500066230,1672681088,1672683133,2045
7714,3629547065,3916289176,1672641324,1672644602,3278
7938,3246596716,3533369198,1672605881,1672606272,391
7826,3899371911,3389115045,1672647914,1672650164,2250
7956,3778266283,3899371911,1672582195,1672582651,456
7890,3533025282,3406784491,1672596551,1672599165,2614
7909,3415546117,3489545239,1672621859,1672623153,1294
7785,3279721246,3826759140,1672653149,1672654659,1510
7831,3918247820,3520730271,1672692663,1672693195,532
7848,3772746272,3613995936,1672597093,1672598366,1273
7535,3416241005,3792473331,1672678547,1672680284,1737
7561,3505362057,3731419510,1672586576,1672587425,849
7912,3826633236,3716258994,1672607474,1672608393,919
7697,3505859863,3247815299,1672599292,1672601453,2161
7546,3773429448,3621810464,1672645706,1672648524,2818
7880,3312829208,3511170269,1672562177,1672563207,1030
7960,3221536550,3701190899,1672544554,1672545894,1340
7933,3396285984,3512142794,1672599643,1672602795,3152
7969,3755511676,3778980116,1672620914,1672620992,78
7890,3505173328,3772053179,1672622723,1672626084,3361
7890,3777455223,3534424200,1672536379,1672538047,1668
7966,3399535232,3534488837,1672541460,1672544173,2713
7551,3280964728,3918584946,1672685247,1672686890,1643
7535,3519428855,3783083229,1672549517,1672550771,1254
7916,3509907947,3246596716,1672628612,1672628825,213
7840,3770851318,3833889105,1672545556,1672547074,1518
7595,3618045231,3777079686,1672694412,1672696749,2337
7522,3518014636,3453729665,1672558712,1672560671,1959
7761,3332072298,3777929708,1672555725,1672558909,3184
7653,3756966035,3352603894,1672652639,1672652753,114
7727,3475251781,3779740455,1672534526,1672537283,2757
7977,3510173870,3331845324,1672631824,1672632294,470
7495,3501927421,3280615985,1672695932,1672697716,1784
7577,3505912939,3362000049,1672652792,1672655890,3098
7658,3685818092,3505201246,1672579678,1672580908,1230
7813,3278365525,3276640712,1672670031,1672672496,2465
7492,3682061100,3883551721,1672565551,1672568611,3060
7948,3637008488,3780813786,1672583460,1672586725,3265
7871,3608633356,3380035798,1672561069,1672563572,2503
7933,3774793839,3734828619,1672531633,1672532433,800
7637,3716843669,3793959750,1672639425,1672642049,2624
7790,3668898102,3287105466,1672595956,1672598774,2818
7659,3931941795,3662180254,1672687562,1672690015,2453
7493,3501730685,3385763781,1672650019,1672650606,587
7627,3208844525,3466229085,1672664967,1672665238,271
7840,3774127586,3311208440,1672660813,1672663057,2244
7559,3510771358,3776800213,1672556318,1672559710,3392
7713,3514128943,3970117174,1672638800,1672639318,518
7631,3855424474,3448855696,1672690416,1672693645,3229
7590,3730517636,3773598056,1672570637,1672571079,442
7884,3515860749,3465254146,1672568840,1672569370,530
7569,3668005723,3291235378,1672691534,1672694133,2599
7717,3890149705,3511170269,1672695486,1672696313,827
7690,3701967560,3777806071,1672533518,1672536912,3394
7860,3395152943,3276640712,1672660202,1672661405,1203
7870,3516980378,3885897503,1672617419,1672620130,2711
7642,3610348516,3517077106,1672582084,1672584452,2368
7509,3805292782,3614238812,1672662173,1672664498,2325
7970,3276640712,3501927421,1672614026,1672614511,485
7799,3465254146,3792288302,1672546086,1672548514,2428
7825,3360743849,3973560347,1672680557,1672681682,1125
7878,3703955926,3244173074,1672535041,1672536233,1192
7829,3715974031,3384240055,1672655924,1672656126,202
7590,3774045700,3520190170,1672547136,1672549575,2439
7968,3802367797,3738502357,1672693204,1672694702,1498
7563,3277605882,3701498253,1672579552,1672580436,884
7917,3800353779,3344364444,1672610277,1672612146,1869
7850,3852391257,3734737881,1672655247,1672658389,3142
7935,3683959482,3793962300,1672639576,1672640557,981
7979,3626156564,3466911760,1672571276,1672573309,2033
7779,3703871468,3534492426,1672609388,1672609540,152
7603,3533270638,3519700826,1672683828,1672686706,2878
7535,3518496488,3793753089,1672549657,1672551035,1378
7743,3417970574,3339907603,1672593478,1672594489,1011
7679,3756601594,3829232696,1672662320,1672664645,2325
7720,3773950140,3776513891,1672569686,1672571326,1640
7657,3711569060,3793753089,1672670948,1672672159,1211
7624,3777790718,3276993580,1672552943,1672556151,3208
7570,3701995648,3703275621,1672639435,1672640649,1214
7584,3774339795,3755798867,1672703662,1672706610,2948
7929,3701995648,3511435497,1672591475,1672593485,2010
7891,3714821932,3244389794,1672623635,1672625060,1425
7853,3910886626,3501692334,1672628057,1672631641,3584
7764,3315583351,3783779671,1672603124,1672603448,324
7572,3505347134,3505638204,1672686956,1672689609,2653
7832,3303705369,3711571712,1672679144,1672681799,2655
7975,3517459919,3713208927,1672616408,1672618802,2394
7916,3505145247,3416265063,1672591643,1672593232,1589
7931,3716488385,3311415018,1672553785,1672556953,3168
7497,3823600322,3505347134,1672652874,1672654530,1656
7968,3478194807,3497901842,1672680322,1672682111,1789
7925,3514245078,3512510536,1672630466,1672631805,1339
7745,3533626375,3515723720,1672661372,1672661694,322
7860,3500066230,3518014636,1672661654,1672665081,3427
7761,3332072298,3399004969,1672682906,1672684798,1892
7634,3280964728,3898995675,1672549711,1672550282,571
7680,3756021689,3710408395,1672584685,1672588052,3367
7670,3500066230,3613995936,1672645543,1672648216,2673
7907,3792883665,3519428855,1672656585,1672657309,724
7891,3791957752,3510969660,1672566019,1672566135,116
7924,3783509527,3514719601,1672670520,1672672702,2182
7971,3516909237,3505135325,1672656338,1672659144,2806
7551,3715981584,3792032359,1672674227,1672677366,3139
7610,3660493209,3293695955,1672617949,1672618961,1012
7616,3277669002,3855000166,1672616372,1672618275,1903
7737,3826759140,3505173328,1672685140,1672686936,1796
7658,3637008488,3887270940,1672629923,1672631845,1922
7508,3760183458,3280964728,1672561520,1672563955,2435
7590,3346795719,3780593036,1672587762,1672588551,789
7781,3472130842,3276640712,1672615146,1672617635,2489
7910,3911245524,3365942576,1672557191,1672560141,2950
7741,3800353779,3809059934,1672560976,1672561716,740
7808,3311871871,3978115672,1672614062,1672616070,2008
7566,3386707783,3736419952,1672616682,1672620014,3332
7542,3757455053,3855000166,1672535281,1672538445,3164
7872,3276993580,3606812411,1672667485,1672669322,1837
7940,3404384505,3911245524,1672546954,1672547567,613
7567,3920801189,3922275416,1672613577,1672615149,1572
7776,3812176780,3271938399,1672602263,1672603066,803
7935,3378092448,3359239884,1672557734,1672559325,1591
7977,3316173088,3880310724,1672571584,1672572408,824
7981,3489728806,3244436890,1672545569,1672546981,1412
7969,3316173088,3311152102,1672677733,1672680620,2887
7890,3713349754,3399911573,1672568264,1672568464,200
7848,3505098372,3427283336,1672625756,1672628861,3105
7593,3280964728,3791020967,1672662491,1672663951,1460
7811,3520012395,3399535232,1672569335,1672572528,3193
7802,3311718847,3711370563,1672667263,1672667527,264
7934,3373384732,3777477395,1672623074,1672624951,1877
7795,3505599848,3756027749,1672555267,1672557667,2400
7763,3757602960,3703013906,1672646037,1672646334,297
7564,3883312122,3770021824,1672578731,1672580906,2175
7638,3338367113,3520719611,1672686880,1672688488,1608
7932,3201432789,3400804807,1672699689,1672700426,737
7648,3339907603,3360993964,1672694609,1672697605,2996
7856,3889232789,3505362057,1672700986,1672703468,2482
7729,3890149705,3915628728,1672636133,1672639338,3205
7810,3805342762,3511687358,1672669737,1672672386,2649
7825,3889750851,3703889596,1672539373,1672540080,707
7722,3520730271,3883861463,1672602256,1672604367,2111
7641,3416427576,3388372715,1672672474,1672673495,1021
7936,3757562897,3912536808,1672605890,1672609028,3138
7703,3520165601,3533193862,1672608795,1672610018,1223
7485,3757812939,3715974031,1672542656,1672545646,2990
7539,3501955238,3480687894,1672679587,1672681101,1514
7939,3475251781,3882997884,1672640936,1672644412,3476
7491,3511312803,3370752401,1672690192,1672692892,2700
7935,3345207877,3500578848,1672589853,1672593033,3180
7958,3346327502,3477375368,1672562222,1672562823,601
7634,3793627961,3918674986,1672625016,1672627037,2021
7774,3533927138,3514472925,1672576137,1672578809,2672
7489,3501486692,3757562897,1672601351,1672602613,1262
7764,3819727225,3774520233,1672612150,1672614423,2273
7621,3777120536,3516016437,1672550989,1672552758,1769
7894,3756453423,3607748895,1672556954,1672559681,2727
7739,3738502357,3516016437,1672701706,1672703580,1874
7556,3855602893,3206254161,1672599685,1672601102,1417
7641,3509672210,3475795792,1672677313,1672678243,930
7919,3713268590,3791657947,1672598726,1672601821,3095
7894,3311845971,3757161914,1672660478,1672661648,1170
7610,3379256399,3809916577,1672588323,1672589877,1554
7570,3760077057,3344019610,1672555014,1672557024,2010
7493,3688683847,3518260334,1672619748,1672619840,92
7859,3625274012,3660493209,1672694161,1672694629,468
7804,3937224533,3518408774,1672672685,1672674051,1366
7743,3855602893,3497901842,1672534947,1672536415,1468
7630,3716488385,3244485293,1672694901,1672697974,3073
7688,3433804879,3791874383,1672703425,1672704105,680
7816,3921211276,3501692334,1672670079,1672671612,1533
7626,3979339287,3909606423,1672551620,1672554895,3275
7895,3703441914,3913251733,1672659410,1672659696,286
7525,3793753089,3820354437,1672559137,1672561873,2736
7643,3736419952,3500658339,1672616287,1672617316,1029
7883,3296471982,3710569131,1672569761,1672572933,3172
7959,3701498253,3515284591,1672554130,1672557401,3271
7932,3276640712,3791020967,1672647668,1672648070,402
7509,3473765852,3284639858,1672556344,1672557600,1256
7620,3916289176,3716900301,1672583153,1672585734,2581
7591,3703735129,3432665384,1672593719,1672595158,1439
7729,3902278226,3206593906,1672620589,1672624166,3577
7756,3793286136,3365942576,1672627362,1672628085,723
7746,3377766165,3800886801,1672608102,1672608178,76
7524,3774580701,3917278625,1672641564,1672642016,452
7509,3232962003,3701274634,1672698811,1672700696,1885
7718,3489545239,3756528686,1672632962,1672633221,259
7508,3401627165,3975287541,1672680731,1672681548,817
7730,3805292782,3394330287,1672700823,1672703649,2826
7683,3855602893,3701898991,1672659013,1672659302,289
7969,3926700506,3519069599,1672698310,1672701028,2718
7780,3703789494,3505193212,1672671741,1672672033,292
7947,3714488548,3774195321,1672682289,1672685630,3341
7708,3772309166,3811171116,1672644684,1672647186,2502
7918,3777455223,3411618230,1672543770,1672544456,686
7540,3361230905,3394330287,1672630721,1672631878,1157
7865,3711265369,3737079798,1672648032,1672650412,2380
7714,3774520233,3298288268,1672650319,1672651580,1261
7918,3377766165,3520165601,1672580829,1672580952,123
7617,3792844210,3399433690,1672577913,1672581350,3437
7766,3427219654,3777717988,1672617744,1672618938,1194
7824,3509604974,3757161914,1672617754,1672618195,441
7869,3512837326,3360993964,1672637247,1672638516,1269
7822,3511271692,3359239884,1672608865,1672609591,726
7677,3634786711,3533827120,1672636921,1672640264,3343
7504,3443698222,3500904641,1672618656,1672619108,452
7953,3829319703,3902278226,1672667536,1672669934,2398
7654,3505362057,3373384732,1672564161,1672565727,1566
7601,3701534009,3517255726,1672578324,1672578407,83
7518,3534010629,3534424200,1672568626,1672569267,641
7585,3533280269,3515151980,1672582951,1672583762,811
7935,3772309166,3397418363,1672550778,1672551005,227
7618,3500578848,3428674539,1672640356,1672642440,2084
7532,3496549058,3932051427,1672631491,1672635065,3574
7825,3932051427,3711370563,1672702168,1672705557,3389
7632,3501483568,3627937312,1672615522,1672618906,3384
7663,3511170269,3399052055,1672620077,1672621728,1651
7589,3791942683,3823600322,1672549505,1672552500,2995
7853,3780788622,3511687358,1672540001,1672542843,2842
7766,3760183458,3516039895,1672645243,1672647420,2177
7544,3610348516,3912536808,1672666831,1672667140,309
7608,3780639480,3291235378,1672539907,1672542098,2191
7547,3510771358,3514838220,1672682079,1672682757,678
7488,3780609808,3533369198,1672663341,1672664399,1058
7719,3505635228,3365942576,1672703666,1672704346,680
7846,3783705817,3714197325,1672583332,1672586079,2747
7554,3311415018,3533385867,1672680710,1672682029,1319
7645,3737051610,3710112546,1672576487,1672577080,593
7807,3770851318,3774204963,1672630645,1672631795,1150
7982,3904408902,3314836094,1672672206,1672673699,1493
7819,3792473331,3284639858,1672596784,1672600084,3300
7538,3780639480,3774501422,1672659771,1672660638,867
7780,3519152550,3284832486,1672555779,1672557697,1918
7631,3342131135,3297463265,1672635512,1672638064,2552
7686,3472130842,3783925755,1672586970,1672589224,2254
7783,3777120536,3515394721,1672600871,1672603932,3061
7782,3774793839,3209383861,1672547892,1672550770,2878
7871,3359239884,3512837326,1672604738,1672605716,978
7634,3346327502,3505193212,1672700459,1672701976,1517
7900,3778308417,3395152943,1672630755,1672633230,2475
7838,3510594211,3777514571,1672622894,1672626206,3312
7956,3533626375,3883042241,1672565606,1672566260,654
7753,3505869747,3493507965,1672569973,1672572199,2226
7924,3314836094,3809059934,1672610218,1672613227,3009
7718,3307097200,3629935998,1672621423,1672622575,1152
7888,3783083229,3736592744,1672591490,1672593422,1932
7930,3380035798,3805292782,1672615108,1672615245,137
7749,3554917400,3780593036,1672638474,1672641288,2814
7830,3805292782,3360743849,1672584486,1672587506,3020
7510,3487171044,3534424200,1672620447,1672621409,962
7517,3618045231,3505173328,1672590022,1672592144,2122
7947,3770851318,3615046771,1672614891,1672616039,1148
7740,3430074045,3492478793,1672592000,1672594639,2639
7906,3780914982,3231056870,1672604565,1672605082,517
7715,3277939457,3370636709,1672554266,1672554386,120
7804,3206603608,3467773920,1672644833,1672645450,617
7785,3805519285,3792473331,1672654002,1672656776,2774
7662,3662180254,3516011407,1672557682,1672560083,2401
7629,3389115045,3915628728,1672623739,1672624106,367
7532,3277605882,3776948966,1672582415,1672585443,3028
7508,3783239924,3899266183,1672620412,1672622578,2166
7753,3770635361,3780828689,1672565502,1672565955,453
7559,3519803045,3792789881,1672578828,1672578937,109
7735,3756424865,3512567240,1672537427,1672540984,3557
7528,3777806071,3916289176,1672586888,1672589933,3045
7821,3500729955,3828365570,1672671641,1672672738,1097
7579,3505135325,3816853177,1672533498,1672533790,292
7647,3313564074,3793436995,1672578171,1672580015,1844
7518,3701534009,3518496488,1672628877,1672629619,742
7979,3512540951,3713630656,1672587493,1672588130,637
7863,3829319703,3806545488,1672625119,1672627662,2543
7493,3793959750,3734737881,1672581632,1672582509,877
7544,3731106822,3714474557,1672619276,1672621683,2407
7963,3757562897,3448855696,1672674925,1672676985,2060
7944,3517721725,3520012395,1672663571,1672666779,3208
7718,3483164654,3336751428,1672633309,1672634879,1570
7855,3394330287,3890149705,1672537268,1672540475,3207
7630,3318697153,3345207877,1672552970,1672553564,594
7802,3711308224,3367029997,1672686853,1672690391,3538
7651,3520719611,3360993964,1672655545,1672657459,1914
7958,3774050956,3511841857,1672612691,1672616045,3354
7961,3487171044,3736419952,1672623717,1672626327,2610
7630,3716168623,3755872268,1672589998,1672591504,1506
7537,3227158514,3614238812,1672692465,1672694473,2008
7737,3336751428,3792768129,1672603078,1672604391,1313
7759,3668005723,3611150562,1672584845,1672585821,976
7602,3890149705,3716537575,1672559313,1672561708,2395
7583,3332072298,3511435497,1672583756,1672585806,2050
7864,3713630656,3776800213,1672697838,1672701155,3317
7662,3898995675,3534313900,1672701046,1672702901,1855
7547,3715127362,3776066388,1672554619,1672554764,145
7563,3500066230,3516960534,1672619675,1672621735,2060
7721,3760561634,3534010629,1672627154,1672629975,2821
7850,3432665384,3911159965,1672594575,1672597575,3000
7638,3500904641,3624312512,1672576790,1672579250,2460
7625,3505912939,3311761694,1672617812,1672619806,1994
7766,3629547065,3396086535,1672699900,1672702108,2208
7671,3756623396,3711504540,1672596011,1672598716,2705
7545,3818255890,3224716315,1672546931,1672550352,3421
7874,3369998498,3711265369,1672578402,1672578580,178
7922,3500894271,3714197325,1672564908,1672565383,475
7727,3627937312,3772359096,1672560514,1672561640,1126
7670,3922275416,3783196518,1672531349,1672534842,3493
7556,3298288268,3411618230,1672655361,1672658864,3503
7856,3513454145,3280964728,1672651049,1672652578,1529
7527,3755798867,3359239884,1672658427,1672660673,2246
7709,3409474775,3780593036,1672689308,1672691329,2021
7812,3511359172,3509907947,1672554244,1672556852,2608
7692,3500803339,3209383861,1672700758,1672701529,771
7899,3501927421,3730517636,1672558963,1672559455,492
7497,3793871337,3227158514,1672555213,1672557622,2409
7875,3514838220,3399535232,1672569799,1672572332,2533
7941,3715189301,3304056063,1672624403,1672627284,2881
7614,3739106581,3883085535,1672636664,1672638400,1736
7901,3505638204,3634786711,1672612128,1672614955,2827
7502,3505098372,3534488837,1672539460,1672541755,2295
7966,3711569060,3918056059,1672588608,1672591584,2976
7858,3715127362,3399911573,1672604392,1672606616,2224
7758,3783239924,3513201436,1672645620,1672645804,184
7794,3482405588,3514283243,1672578425,1672581071,2646
7845,3512349371,3220716272,1672690051,1672693331,3280
7799,3716537575,3792177074,1672568817,1672570368,1551
7695,3518408774,3756021689,1672592849,1672594476,1627
7665,3516065852,3910886626,1672596383,1672597423,1040
7864,3477375368,3916289176,1672641999,1672644814,2815
7789,3625274012,3935127663,1672652067,1672654761,2694
7965,3715492942,3793959750,1672693616,1672694258,642
7798,3244436890,3783779671,1672598154,1672601418,3264
7790,3512510536,3909238838,1672614521,1672615955,1434
7720,3774466457,3809059934,1672635241,1672636095,854
7884,3621810464,3760992710,1672589728,1672591958,2230
7791,3885670556,3806545488,1672698013,1672699448,1435
7745,3427219654,3533280269,1672632725,1672634631,1906
7944,3760509236,3733891182,1672669330,1672670610,1280
7514,3757246925,3711370563,1672604040,1672604854,814
7533,3773950140,3667680268,1672557028,1672558168,1140
7761,3501955238,3816454165,1672617394,1672618383,989
7747,3313541986,3512969370,1672613825,1672616315,2490
7763,3791997875,3510594211,1672585613,1672588251,2638
7614,3430074045,3501955238,1672559032,1672561927,2895
7701,3777806071,3510969660,1672585976,1672587688,1712
7787,3703871468,3715127362,1672649771,1672650895,1124
7542,3811694763,3833889105,1672672275,1672675333,3058
7483,3416427576,3209048907,1672622740,1672625123,2383
7884,3714504419,3776513891,1672695322,1672696118,796
7939,3805292782,3883312122,1672621374,1672624926,3552
7705,3911245524,3228165483,1672559207,1672559861,654
7689,3533270638,3859663348,1672623099,1672624836,1737
7892,3683959482,3806545488,1672593784,1672594955,1171
7561,3621810464,3411618230,1672575612,1672579024,3412
7871,3736419952,3909331423,1672700636,1672701831,1195
7953,3779740455,3791997875,1672655348,1672657745,2397
7740,3713268590,3416265063,1672567791,1672568416,625
7533,3407725581,3701691675,1672600162,1672602839,2677
7906,3716197887,3733891182,1672664220,1672667049,2829
7632,3510594211,3735733948,1672539939,1672542323,2384
7488,3777717988,3235635976,1672596578,1672599654,3076
7508,3773755137,3760492950,1672543566,1672546212,2646
7814,3912262917,3505962865,1672693202,1672693272,70
7712,3833889105,3505193212,1672578460,1672581409,2949
7894,3979339287,3534313900,1672571281,1672573768,2487
7750,3793389510,3517963492,1672695220,1672696205,985
7913,3559110998,3496549058,1672629388,1672630497,1109
7826,3774466457,3517255726,1672700193,1672701533,1340
7662,3396285984,3224058172,1672592110,1672594484,2374
7639,3760598102,3921211276,1672602117,1672605198,3081
7554,3518408774,3516980378,1672556082,1672558387,2305
7541,3903962771,3922275416,1672653320,1672653749,429
7735,3505635228,3490191091,1672574049,1672574276,227
7895,3909331423,3516960534,1672538744,1672538832,88
7954,3291883916,3209383861,1672608693,1672611741,3048
7713,3516514391,3517864478,1672578538,1672578838,300
7691,3793848402,3829764737,1672608705,1672610421,1716
7817,3779740455,3223968713,1672622823,1672625785,2962
7754,3701898991,3533371364,1672650174,1672651266,1092
7865,3627937312,3501364586,1672662774,1672663291,517
7658,3232962003,3516980378,1672642218,1672645080,2862
7951,3316222192,3501955238,1672535563,1672537574,2011
7641,3935627557,3760561634,1672561697,1672564701,3004
7785,3804870229,3915628728,1672665908,1672667147,1239
7642,3390068992,3307512479,1672609178,1672610237,1059
7955,3364543015,3374559242,1672576229,1672579811,3582
7563,3465254146,3202120784,1672543778,1672547147,3369
7483,3701184889,3839849341,1672648238,1672650375,2137
7616,3779976989,3701898991,1672681751,1672682631,880
7818,3772714862,3311065516,1672681676,1672683312,1636
7748,3783196518,3773755137,1672582614,1672584287,1673
7558,3886298125,3505962865,1672687285,1672688734,1449
7846,3533025282,3514472925,1672608176,1672608356,180
7804,3519601612,3903962771,1672555331,1672556825,1494
7805,3774520233,3338703270,1672680931,1672682358,1427
7627,3519601612,3882291183,1672676832,1672677097,265
7790,3826633236,3793871337,1672636967,1672637420,453
7895,3783779671,3624761861,1672544224,1672545938,1714
7508,3505873261,3918674986,1672562399,1672563750,1351
7589,3229058858,3379256399,1672615958,1672616410,452
7932,3505599848,3500374658,1672655310,1672658288,2978
7930,3206254161,3826760240,1672606512,1672606911,399
7520,3229665776,3511163800,1672535107,1672536802,1695
7502,3509453566,3668005723,1672693531,1672696088,2557
7522,3415546117,3515691540,1672698463,1672701033,2570
7880,3430352815,3811171116,1672653674,1672655707,2033
7648,3487171044,3793753089,1672559693,1672561912,2219
7947,3604539807,3760992710,1672671820,1672674731,2911
7504,3533137446,3391915886,1672589682,1672590006,324
7719,3296471982,3777443199,1672550075,1672552175,2100
7900,3777079686,3500066230,1672548485,1672551921,3436
7922,3760077057,3513454145,1672644877,1672646821,1944
7633,3373384732,3370636709,1672672233,1672672698,465
7878,3518791447,3914290246,1672614097,1672616292,2195
7807,3505873261,3516016437,1672552450,1672554183,1733
7735,3276993580,3855602893,1672576035,1672577073,1038
7524,3608868877,3311415018,1672632852,1672636178,3326
7496,3291235378,3891751546,1672687997,1672691391,3394
7747,3293695955,3338703270,1672614546,1672616172,1626
7870,3400918687,3688418210,1672688135,1672691246,3111
7500,3973560347,3432665384,1672661973,1672664939,2966
7805,3731419510,3756966035,1672645081,1672648674,3593
7561,3511267139,3318166135,1672566208,1672566476,268
7523,3701498253,3926700506,1672545590,1672547996,2406
7636,3757812939,3701146057,1672697280,1672699134,1854
7767,3481502100,3780813786,1672586327,1672587825,1498
7813,3492478793,3772746272,1672617524,1672619985,2461
7857,3505145247,3773120434,1672663312,1672666840,3528
7947,3819727225,3384951177,1672546084,1672548166,2082
7557,3516039895,3401627165,1672590189,1672591888,1699
7811,3517864478,3501927421,1672693399,1672693711,312
7939,3501927421,3713808837,1672659648,1672662198,2550
7893,3777120536,3783429780,1672688093,1672690397,2304
7954,3939952128,3223968713,1672641051,1672643118,2067
7634,3316222192,3755392666,1672690781,1672693776,2995
7550,3473562469,3512166013,1672661232,1672664015,2783
7656,3367902229,3511841857,1672631003,1672631590,587
7559,3399433690,3397418363,1672546533,1672549873,3340
7938,3792902982,3774045700,1672626028,1672627646,1618
7725,3286658957,3776338577,1672676416,1672677123,707
7568,3858918246,3500487333,1672698840,1672700658,1818
7893,3271938399,3779036831,1672661297,1672663036,1739
7636,3311065516,3520629279,1672692507,1672695145,2638
7871,3511170269,3713630656,1672639529,1672642381,2852
7759,3791594391,3783429780,1672550975,1672553352,2377
7542,3472130842,3367902229,1672588363,1672589569,1206
7911,3534313900,3505145247,1672611975,1672612442,467
7840,3311203656,3229665776,1672555143,1672556927,1784
7534,3757403279,3520888296,1672653453,1672653818,365
7945,3511163800,3811694763,1672532427,1672535048,2621
7921,3731106822,3485008994,1672547286,1672549818,2532
7627,3475396323,3415546117,1672632826,1672636171,3345
7895,3756021689,3777514571,1672599475,1672600841,1366
7951,3715127362,3359239884,1672576359,1672577235,876
7615,3637008488,3489728806,1672671981,1672673766,1785
7823,3664170666,3417061462,1672641333,1672641863,530
7728,3342131135,3473765852,1672552972,1672553989,1017
7651,3737154119,3710112546,1672542689,1672543037,348
7763,3520751702,3701995648,1672672450,1672673126,676
7600,3819727225,3284832486,1672634292,1672634914,622
7549,3713630656,3733189298,1672554542,1672557272,2730
7807,3809916577,3512166013,1672630920,1672634130,3210
7933,3231056870,3774045700,1672639544,1672640343,799
7874,3715492942,3293695955,1672653452,1672656759,3307
7756,3533270638,3737079798,1672659598,1672660794,1196
7735,3238712269,3520629279,1672537113,1672537615,502
7557,3519703355,3333896808,1672562283,1672562720,437
7782,3772758337,3404058699,1672560687,1672561820,1133
7628,3480687894,3200198928,1672559802,1672562203,2401
7635,3715189301,3711265369,1672539719,1672540180,461
7551,3711198793,3505912939,1672615126,1672616927,1801
7760,3801089989,3396285984,1672614786,1672617947,3161
7835,3247780536,3534553510,1672559408,1672562261,2853
7910,3399433690,3221536550,1672571784,1672572320,536
7626,3430504438,3284832486,1672648110,1672650466,2356
7906,3302626661,3505145247,1672643268,1672646419,3151
7530,3512142794,3484995752,1672675842,1672677288,1446
7526,3756623396,3517721725,1672534133,1672535152,1019
7863,3777936328,3918247820,1672609765,1672612651,2886
7526,3533270638,3756424865,1672703522,1672704666,1144
7933,3791553060,3606812411,1672616833,1672617918,1085
7806,3922275416,3777790718,1672593680,1672596637,2957
7945,3351554343,3770635361,1672654435,1672655738,1303
7607,3303751772,3828365570,1672550580,1672551119,539
7715,3703275621,3883551721,1672596131,1672597212,1081
7574,3517509185,3500499542,1672688295,1672690099,1804
7938,3666553782,3688683847,1672572639,1672575446,2807
7646,3783239924,3316222192,1672692875,1672694285,1410
7822,3882997884,3636867411,1672624224,1672625358,1134
7952,3777079686,3777717988,1672691175,1672692979,1804
7627,3415546117,3703871468,1672639935,1672640575,640
7837,3206254161,3730517636,1672600882,1672603389,2507
7879,3711973519,3710112546,1672638617,1672640417,1800
7888,3791334389,3359239884,1672636453,1672639821,3368
7622,3903962771,3629547065,1672701849,1672702458,609
7825,3773950140,3710408395,1672555545,1672556094,549
7926,3973560347,3882997884,1672648798,1672650101,1303
7749,3533385867,3685187183,1672671643,1672674367,2724
7900,3384240055,3778305740,1672702886,1672703692,806
7832,3280599164,3278365525,1672671910,1672673949,2039
7576,3512540951,3755436115,1672544601,1672546674,2073
7832,3473562469,3206254161,1672567000,1672569855,2855
7844,3500487333,3703889596,1672608295,1672610425,2130
7559,3770824086,3739106581,1672547975,1672551312,3337
7943,3378436155,3519703355,1672562162,1672565126,2964
7522,3791942683,3930797455,1672652267,1672653086,819
7631,3458539365,3244389794,1672675773,1672677105,1332
7759,3500177712,3489962019,1672600666,1672600764,98
7781,3666457294,3683766533,1672607577,1672611000,3423
7836,3533095755,3516039895,1672552378,1672554674,2296
7865,3922275620,3510380060,1672644164,1672644909,745
7526,3827222533,3710344260,1672688467,1672690287,1820
7845,3634786711,3477649378,1672690810,1672692700,1890
7679,3922337974,3626156564,1672642562,1672645651,3089
7527,3760294205,3760294205,1672635998,1672639301,3303
7642,3312664885,3714821932,1672682164,1672684238,2074
7551,3791901535,3415546117,1672660935,1672661196,261
7875,3513454145,3488244966,1672565087,1672567326,2239
7664,3777455223,3791020967,1672641818,1672642752,934
7674,3509634629,3365614305,1672614956,1672615996,1040
7864,3770078063,3209551760,1672671717,1672673813,2096
7592,3903307060,3505635228,1672628279,1672630927,2648
7553,3378092448,3489962019,1672627453,1672628794,1341
7579,3783429780,3483949762,1672631431,1672632105,674
7748,3710067113,3518163778,1672605757,1672608002,2245
7912,3396086535,3512567240,1672659680,1672662431,2751
7688,3813052709,3496269445,1672558864,1672559862,998
7667,3738274418,3500904641,1672649291,1672650795,1504
7863,3533025282,3734496778,1672642425,1672645131,2706
7711,3520888296,3713969578,1672680981,1672683299,2318
7635,3783429780,3484995752,1672623771,1672626542,2771
7705,3396285984,3827377568,1672570468,1672573133,2665
7577,3424922204,3232962003,1672618788,1672618862,74
7811,3336751428,3360506772,1672560727,1672562818,2091
7621,3736786443,3476232529,1672657980,1672660757,2777
7952,3487171044,3859525941,1672559210,1672560216,1006
7935,3500487333,3935127663,1672661600,1672662688,1088
7679,3505292701,3805347939,1672645317,1672647720,2403
7974,3416427576,3387674757,1672604223,1672607335,3112
7587,3621497531,3735319397,1672610117,1672611270,1153
7622,3364543015,3234541252,1672566080,1672569198,3118
7857,3618045231,3688683847,1672661641,1672662353,712
7505,3816454165,3793871337,1672699851,1672702992,3141
7776,3783245561,3202120784,1672628764,1672630006,1242
7631,3615046771,3533371364,1672696525,1672699940,3415
7787,3792253549,3757403279,1672680692,1672683340,2648
7826,3755872268,3825229501,1672651191,1672653562,2371
7965,3793338102,3778980116,1672591022,1672591714,692
7909,3277669002,3481647420,1672681168,1672683785,2617
7974,3685818092,3389115045,1672644494,1672646771,2277
7946,3505477652,3978105277,1672665443,1672668651,3208
7894,3716843669,3685818092,1672602092,1672602366,274
7530,3851190615,3755798867,1672600577,1672601975,1398
7779,3770553384,3776066388,1672651397,1672653500,2103
7735,3209048907,3829764737,1672632251,1672632970,719
7886,3513454145,3383922351,1672553006,1672555706,2700
7527,3760294205,3297463265,1672545591,1672547154,1563
7808,3715492942,3791901535,1672666372,1672667138,766
7754,3772359096,3607178184,1672650857,1672653492,2635
7808,3356860407,3370636709,1672682028,1672682502,474
7700,3666553782,3518408774,1672552032,1672553299,1267
7896,3471220483,3513164386,1672667376,1672667664,288
7975,3774005526,3826633236,1672703318,1672705631,2313
7633,3505962865,3311439795,1672662235,1672662329,94
7713,3336751428,3312333615,1672643759,1672644669,910
7754,3246596716,3714504419,1672617841,1672620011,2170
7627,3774501422,3517509185,1672639121,1672641712,2591
7849,3344019610,3302626661,1672555383,1672557784,2401
7654,3446948848,3511198618,1672543696,1672545218,1522
7670,3711262377,3792789881,1672625275,1672626260,985
7578,3412825109,3713370078,1672679665,1672680207,542
7711,3438645253,3777120536,1672540396,1672543387,2991
7671,3976633198,3520719611,1672624264,1672626845,2581
7703,3482405588,3344364444,1672653983,1672656275,2292
7640,3313564074,3855602893,1672590066,1672591419,1353
7703,3224716315,3791553060,1672680509,1672683450,2941
7789,3688418210,3792473331,1672539894,1672540321,427
7751,3520206212,3514128943,1672656924,1672659925,3001
7517,3513956646,3773465237,1672581005,1672582356,1351
7632,3610695419,3736592744,1672621470,1672623134,1664
7837,3922337974,3505292701,1672644140,1672645434,1294
7586,3760561634,3701274634,1672572300,1672573802,1502
7856,3732481297,3793871337,1672698280,1672699233,953
7542,3891751546,3737079798,1672567141,1672569021,1880
7800,3911159965,3731106822,1672649991,1672652693,2702
7927,3427283336,3791594391,1672538054,1672541367,3313
7542,3715492942,3519912874,1672571133,1672574475,3342
7920,3774338212,3520888296,1672696181,1672697567,1386
7813,3277939457,3303705369,1672588683,1672591531,2848
7599,3303751772,3773755137,1672536977,1672537604,627
7693,3421836608,3234362962,1672538332,1672539593,1261
7851,3660493209,3404058699,1672584940,1672586044,1104
7515,3755625324,3359910781,1672608411,1672611669,3258
7753,3516065852,3513956646,1672630024,1672630787,763
7545,3634995491,3883861463,1672609054,1672611958,2904
7583,3899204805,3481502100,1672684002,1672686410,2408
7661,3904408902,3516673015,1672549705,1672551172,1467
7917,3395152943,3505193212,1672609147,1672612489,3342
7740,3516016437,3501759100,1672694653,1672695380,727
7749,3715127362,3511862351,1672616017,1672617791,1774
7641,3701065786,3851190615,1672690237,1672692761,2524
7852,3511170269,3791997875,1672562938,1672565733,2795
7839,3829319703,3601879040,1672701504,1672703134,1630
7947,3774338212,3519912874,1672615239,1672617258,2019
7603,3883551721,3618045231,1672568928,1672569055,127
7534,3730517636,3510380060,1672662600,1672663850,1250
7710,3792902982,3512349371,1672531968,1672532832,864
7732,3312829208,3519912874,1672587147,1672590478,3331
7625,3289061738,3903009525,1672644344,1672645343,999
7685,3780813786,3755392666,1672610574,1672611409,835
7887,3783239924,3777929708,1672609906,1672610078,172
7614,3430352815,3899204805,1672698014,1672699959,1945
7735,3733891182,3714474557,1672579367,1672580980,1613
7946,3621497531,3634786711,1672644238,1672644696,458
7643,3779976989,3348261553,1672576168,1672576884,716
7752,3760077057,3716835696,1672642296,1672645680,3384
7856,3517459919,3500060260,1672697465,1672698565,1100
7510,3386707783,3793959750,1672582796,1672584960,2164
7763,3858918246,3312333615,1672609067,1672612505,3438
7793,3223968713,3432689543,1672679921,1672681607,1686
7735,3496269445,3378436155,1672560500,1672561851,1351
7610,3909238838,3737051610,1672659061,1672661034,1973
7925,3505904952,3777936328,1672549062,1672549219,157
7767,3755392666,3774050956,1672565912,1672566634,722
7894,3859525941,3618045231,1672651032,1672651893,861
7912,3505203158,3399433690,1672533081,1672534582,1501
7812,3533748232,3773465237,1672630654,1672633143,2489
7636,3291227780,3621497531,1672562343,1672562618,275
7621,3500066230,3505904952,1672658538,1672660370,1832
7976,3711370563,3500578848,1672597687,1672598127,440
7514,3513454145,3902383721,1672686211,1672686539,328
7494,3772309166,3882997884,1672669076,1672670877,1801
7891,3780788622,3779976989,1672691985,1672692671,686
7961,3780639480,3367902229,1672632938,1672634400,1462
7590,3390068992,3209383861,1672628451,1672631611,3160
7715,3901990690,3780294829,1672651786,1672655350,3564
7889,3757151210,3378686918,1672681954,1672683175,1221
7706,3505869747,3660493209,1672601567,1672602857,1290
7754,3533385867,3383922351,1672589508,1672592707,3199
7584,3405494240,3756528686,1672648130,1672651334,3204
7693,3351554343,3500365158,1672571856,1672574368,2512
7865,3473765852,3701178711,1672545327,1672547819,2492
7898,3231056870,3518163778,1672540019,1672542616,2597
7859,3533810360,3703735129,1672536330,1672537532,1202
7959,3236102733,3510771358,1672566243,1672567581,1338
7670,3772053179,3517963492,1672538810,1672542083,3273
7791,3713268590,3780294829,1672547805,1672551318,3513
7680,3703955926,3500894271,1672680439,1672680831,392
7834,3774010081,3780788622,1672660761,1672663268,2507
7811,3828624701,3930791338,1672674535,1672676562,2027
7723,3777806071,3512969370,1672665146,1672668043,2897
7753,3485008994,3399911573,1672575388,1672576170,782
7767,3301107849,3232962003,1672577891,1672580559,2668
7551,3515125508,3813052709,1672632502,1672633440,938
7544,3817316561,3800353779,1672634449,1672635729,1280
7523,3736229191,3791657947,1672556190,1672558945,2755
7959,3772746272,3889232789,1672700474,1672702856,2382
7718,3401627165,3736229191,1672621972,1672622966,994
7719,3332072298,3519069599,1672635975,1672639367,3392
7669,3703275621,3516258476,1672613167,1672616499,3332
7861,3792288302,3533270638,1672579967,1672582320,2353
7714,3533653428,3533095755,1672602315,1672605126,2811
7568,3512540951,3500374658,1672677082,1672680528,3446
7705,3311415018,3757682496,1672622443,1672623131,688
7758,3311845971,3311871871,1672655116,1672656780,1664
7571,3519428855,3512142794,1672692932,1672694003,1071
7918,3760183458,3714488548,1672598525,1672598680,155
7864,3793436995,3933210486,1672687222,1672689514,2292
7559,3735733948,3639847263,1672650061,1672653217,3156
7789,3223789409,3312829208,1672594034,1672595394,1360
7597,3505219850,3826760240,1672624839,1672625965,1126
7511,3416427576,3432689543,1672641863,1672644654,2791
7527,3791334389,3772309150,1672561414,1672563573,2159
7523,3783239924,3346327502,1672650792,1672654383,3591
7751,3979339287,3703871468,1672670404,1672673353,2949
7932,3443698222,3516909237,1672700328,1672703799,3471
7752,3710112546,3511359172,1672639345,1672640054,709
7578,3485375593,3770851318,1672683587,1672684476,889
7815,3714504419,3500199935,1672627992,1672629865,1873
7652,3388286531,3402943525,1672626785,1672627255,470
7652,3701065786,3852391257,1672618416,1672619607,1191
7883,3370752401,3760489031,1672593180,1672596622,3442
7702,3793086311,3802367797,1672670034,1672673271,3237
7899,3829764737,3855602893,1672609446,1672612761,3315
7804,3800353779,3779629905,1672635724,1672636534,810
7978,3505098372,3427283336,1672680223,1672680515,292
7881,3475258557,3223968713,1672649747,1672651509,1762
7963,3416265063,3246596716,1672570599,1672571303,704
7876,3533242305,3828365570,1672590280,1672593382,3102
7955,3517509185,3312333615,1672667623,1672670268,2645
7539,3501927421,3793436995,1672551682,1672552017,335
7647,3519069599,3418534998,1672575216,1672575541,325
7661,3344019610,3755881905,1672675347,1672676985,1638
7838,3311208440,3510247121,1672666195,1672669461,3266
7590,3501601840,3493507965,1672655312,1672658040,2728
7571,3446948848,3822654369,1672539012,1672539978,966
7548,3922275620,3337544549,1672606086,1672608263,2177
7776,3505173328,3833889105,1672600653,1672602494,1841
7953,3613683164,3505962865,1672617482,1672619502,2020
7933,3516039895,3277669002,1672619057,1672620007,950
7746,3660493209,3756424865,1672657401,1672657525,124
7496,3505530961,3701065786,1672553036,1672554351,1315
7637,3512567240,3500805881,1672676974,1672678874,1900
7541,3228165483,3792253549,1672687667,1672690788,3121
7834,3711370563,3716168623,1672690542,1672693126,2584
7804,3311324983,3311993075,1672686522,1672689663,3141
7622,3926700506,3701534009,1672589817,1672591729,1912
7645,3446948848,3911159965,1672556618,1672559552,2934
7616,3406784491,3780974443,1672609191,1672612274,3083
7514,3736790081,3220716272,1672587475,1672589775,2300
7821,3818255890,3778305740,1672575360,1672577013,1653
7646,3432665384,3520629279,1672591455,1672593872,2417
7529,3701184889,3756021689,1672608491,1672608904,413
7754,3608868877,3756027749,1672627772,1672630404,2632
7867,3858918246,3389115045,1672643291,1672644664,1373
7733,3465202715,3770635361,1672561927,1672562823,896
7525,3516011407,3832902928,1672634064,1672637439,3375
7909,3429856982,3510703546,1672645248,1672645429,181
7636,3370752401,3555214688,1672654843,1672656903,2060
7639,3271938399,3501730685,1672594567,1672596827,2260
7978,3277605882,3514283243,1672587105,1672587760,655
7941,3932051427,3510857360,1672619112,1672622565,3453
7867,3774045700,3516016437,1672574337,1672575737,1400
7721,3533280269,3714474557,1672657346,1672658452,1106
7820,3774195321,3311152102,1672538620,1672542172,3552
7939,3793959750,3733891182,1672690958,1672692628,1670
7707,3514128943,3378092448,1672601716,1672601814,98
7532,3777079686,3703718151,1672570388,1672571517,1129
7957,3500805881,3505477652,1672666429,1672668432,2003
7848,3209551760,3348261553,1672665218,1672665792,574
7899,3922337974,3755511676,1672557148,1672559104,1956
7807,3501364586,3606186086,1672551461,1672554131,2670
7606,3926700506,3500391167,1672700072,1672700704,632
7758,3428674539,3701863557,1672649551,1672653031,3480
7841,3206603608,3774195321,1672607853,1672608756,903
7793,3511841857,3760489031,1672641443,1672643307,1864
7807,3757562897,3344364444,1672648170,1672649527,1357
7817,3206593906,3818255890,1672702888,1672706169,3281
7738,3713370078,3716197887,1672661168,1672661536,368
7706,3711265369,3520706195,1672637325,1672637557,232
7966,3500803339,3770553384,1672688075,1672690584,2509
7517,3736790081,3501601840,1672660290,1672660354,64
7773,3247780536,3780365428,1672618790,1672621442,2652
7566,3511841857,3683766533,1672658829,1672659227,398
7888,3505599848,3416265063,1672660087,1672663027,2940
7872,3918584946,3715127362,1672635300,1672637453,2153
7794,3756966035,3476232529,1672533332,1672535279,1947
7754,3777477395,3518669703,1672692565,1672692945,380
7696,3533385867,3755920131,1672641038,1672644608,3570
7977,3465202715,3301107849,1672643211,1672646071,2860
7733,3505477652,3391915886,1672657085,1672657657,572
7764,3412825109,3783196518,1672571842,1672573164,1322
7973,3791594391,3311090974,1672698393,1672700968,2575
7807,3311324983,3518260334,1672694275,1672695098,823
7494,3453729665,3800353779,1672700898,1672701752,854
7678,3772337814,3813052709,1672582015,1672583741,1726
7765,3520888296,3512510536,1672687782,1672688488,706
7981,3755943611,3735733948,1672551411,1672551750,339
7787,3512142794,3809059934,1672641443,1672642486,1043
7904,3232962003,3792883665,1672683990,1672686092,2102
7732,3859663348,3516065852,1672624904,1672626602,1698
7910,3318166135,3812176780,1672595421,1672597657,2236
7714,3783083229,3793338102,1672620927,1672622933,2006
7687,3481647420,3807987001,1672535460,1672535770,310
7542,3792902982,3835382117,1672537634,1672540806,3172
7936,3791602225,3616944364,1672598780,1672601283,2503
7623,3827626797,3318166135,1672671303,1672674776,3473
7883,3820354437,3500805881,1672638445,1672641635,3190
7510,3608633356,3777806071,1672592600,1672594047,1447
7530,3805347939,3511841857,1672574025,1672576825,2800
7690,3912262917,3512720680,1672670685,1672671439,754
7689,3818255890,3783925755,1672607282,1672609964,2682
7860,3805519285,3519069599,1672693366,1672695852,2486
7732,3331845324,3701178711,1672676528,1672677172,644
7917,3774366875,3500894271,1672669033,1672671393,2360
7927,3778780511,3793753089,1672628626,1672630092,1466
7760,3826633236,3483949762,1672686731,1672689506,2775
7720,3774045700,3383661227,1672621602,1672622968,1366
7809,3303705369,3235287260,1672637662,1672639299,1637
7613,3438645253,3424922204,1672573871,1672576851,2980
7975,3501759100,3396285984,1672586598,1672587382,784
7805,3514838220,3792768129,1672581410,1672583812,2402
7897,3936227020,3359239884,1672689168,1672692448,3280
7693,3512217942,3208844525,1672674672,1672675273,601
7572,3773429448,3311274543,1672589607,1672592171,2564
7878,3933210486,3756623396,1672672856,1672674342,1486
7958,3336751428,3703735129,1672615984,1672616978,994
7557,3533137446,3370636709,1672688582,1672689467,885
7685,3783531004,3554917400,1672635853,1672639119,3266
7694,3777443199,3777443199,1672612234,1672615730,3496
7524,3291227780,3412980697,1672641755,1672643392,1637
7868,3364543015,3520709480,1672622946,1672624471,1525
7598,3935127663,3911245524,1672618427,1672619616,1189
7675,3755881905,3816454165,1672657515,1672659816,2301
7497,3883312122,3515151980,1672691714,1672692488,774
7788,3497901842,3201848640,1672696538,1672699783,3245
7717,3809916577,3889232789,1672592450,1672595733,3283
7774,3384951177,3345207877,1672605037,1672608278,3241
7839,3492478793,3511862351,1672583157,1672586340,3183
7493,3835382117,3701984666,1672577378,1672580444,3066
7670,3533025282,3500994774,1672607088,1672608412,1324
7982,3520751702,3344364444,1672560328,1672562518,2190
7931,3760992710,3348261553,1672700137,1672701906,1769
7625,3496269445,3931941795,1672586514,1672588696,2182
7754,3910454786,3666553782,1672541715,1672545144,3429
7629,3760489031,3533137446,1672629157,1672630730,1573
7701,3972364603,3520012395,1672548742,1672551759,3017
7739,3247815299,3342131135,1672572543,1672576037,3494
7594,3515394721,3883042241,1672654554,1672657523,2969
7942,3975287541,3512720680,1672661724,1672663855,2131
7828,3520706195,3510969660,1672626880,1672628518,1638
7618,3858918246,3688683847,1672668232,1672671270,3038
7758,3510380060,3804870229,1672569628,1672570632,1004
7613,3666457294,3760294205,1672571547,1672573540,1993
7558,3912536808,3500994774,1672674631,1672676096,1465
7792,3757562897,3482405588,1672604834,1672605935,1101
7835,3404384505,3534729133,1672597879,1672599226,1347
7640,3533827120,3229058858,1672626466,1672628963,2497
7560,3296471982,3249401741,1672611693,1672613052,1359
7929,3370752401,3826633236,1672597995,1672599280,1285
7523,3601879040,3488244966,1672593355,1672594916,1561
7963,3451432842,3505219850,1672687537,1672689657,2120
7796,3770763956,3755739653,1672572351,1672573357,1006
7665,3505362057,3533137446,1672576461,1672577508,1047
7933,3501692334,3514283243,1672602912,1672603834,922
7578,3667680268,3834257412,1672539975,1672542929,2954
7876,3500578848,3634786711,1672572139,1672572345,206
7584,3351554343,3481647420,1672641309,1672641834,525
7570,3420700674,3489545239,1672649885,1672651301,1416
7817,3505098372,3755625324,1672697698,1672698786,1088
7635,3511332835,3500805881,1672639813,1672642712,2899
7962,3472130842,3418728074,1672594351,1672595359,1008
7815,3791602225,3793848402,1672695182,1672697089,1907
7751,3500060260,3520030713,1672544970,1672548435,3465
7849,3711569060,3776513891,1672570750,1672571954,1204
7770,3533270638,3701691675,1672672436,1672674103,1667
7561,3511271692,3505962865,1672621358,1672622745,1387
7856,3279721246,3416265063,1672592319,1672593417,1098
7864,3976390453,3738502357,1672675544,1672676780,1236
7628,3703441914,3715981584,1672681150,1672683784,2634
7739,3716746253,3616944364,1672618591,1672619323,732
7674,3713630656,3772578994,1672608560,1672611286,2726
7758,3501759100,3777776687,1672693135,1672696111,2976
7557,3826415738,3716165213,1672548495,1672551520,3025
7871,3510380060,3228165483,1672629868,1672631054,1186
7582,3685187183,3407954858,1672585566,1672588923,3357
7765,3924549929,3886298125,1672655559,1672658283,2724
7665,3481647420,3285400528,1672645735,1672646194,459
7693,3311065516,3826633236,1672702002,1672705077,3075
7939,3613995936,3839849341,1672669306,1672672626,3320
7678,3533810360,3774119563,1672584517,1672584869,352
7554,3509672210,3505904952,1672539020,1672540991,1971
7493,3783239924,3501692334,1672654375,1672656153,1778
7831,3534191820,3428006164,1672551300,1672554537,3237
7485,3918674986,3883551721,1672639073,1672642137,3064
7702,3760077057,3756966035,1672661272,1672664066,2794
7610,3973560347,3715127362,1672543616,1672547117,3501
7939,3617734118,3629935998,1672546250,1672549531,3281
7901,3516980378,3399911573,1672621785,1672622208,423
7878,3510173870,3465254146,1672555767,1672556789,1022
7541,3818255890,3392121505,1672654986,1672656372,1386
7972,3636867411,3301107849,1672559171,1672559264,93
7964,3319752091,3792902982,1672608969,1672609906,937
7568,3618873142,3234362962,1672558525,1672559086,561
7695,3829319703,3780828689,1672579537,1672580493,956
7940,3780609808,3311154569,1672686008,1672688191,2183
7929,3511862351,3314245084,1672637791,1672640809,3018
7889,3701184889,3500729955,1672661688,1672663125,1437
7656,3772544062,3770824086,1672656522,1672658947,2425
7653,3473562469,3899371911,1672637874,1672641172,3298
7650,3516065852,3701146057,1672610036,1672612614,2578
7873,3909238838,3613995936,1672628925,1672629427,502
7673,3606987130,3346327502,1672617023,1672618487,1464
7983,3433804879,3755392666,1672692025,1672694105,2080
7816,3520183192,3756623396,1672668224,1672671661,3437
7836,3399911573,3505201246,1672657713,1672659283,1570
7744,3809059934,3837094550,1672595418,1672596574,1156
7544,3331845324,3935627557,1672697514,1672700204,2690
7753,3505098372,3701534009,1672568759,1672569348,589
7596,3811171116,3817621391,1672651273,1672653159,1886
7741,3509933351,3918056059,1672557796,1672560241,2445
7765,3710112546,3883042241,1672582623,1672585204,2581
7579,3356860407,3931941795,1672584283,1672587316,3033
7713,3222448362,3399535232,1672653853,1672656347,2494
7980,3793753089,3628819436,1672577976,1672578525,549
7963,3760267716,3760569731,1672674788,1672677612,2824
7731,3793436995,3772746272,1672610720,1672614260,3540
7804,3770763956,3755798867,1672681703,1672682309,606
7750,3519803045,3518496488,1672676043,1672677028,985
7599,3519700826,3316173088,1672590146,1672592804,2658
7679,3979339287,3774010081,1672569366,1672572160,2794
7765,3711380716,3917088658,1672587417,1672588058,641
7873,3791115967,3776800213,1672613566,1672615663,2097
7706,3520706195,3234541252,1672619703,1672620895,1192
7604,3801089989,3777455223,1672552874,1672552942,68
7739,3505362057,3930797455,1672666937,1672667955,1018
7517,3829232696,3716746253,1672560021,1672560125,104
7681,3533193862,3703223015,1672589873,1672590667,794
7538,3316222192,3247428249,1672563962,1672564306,344
7940,3533626375,3713630656,1672667151,1672668076,925
7700,3773465237,3443698222,1672542073,1672543421,1348
7942,3778266283,3760294205,1672654476,1672655066,590
7870,3232962003,3302626661,1672678273,1672681035,2762
7824,3466911760,3534424200,1672548558,1672549624,1066
7872,3825229501,3490191091,1672624919,1672628326,3407
7490,3550946908,3755042098,1672645413,1672646555,1142
7636,3390068992,3206603608,1672689777,1672692624,2847
7821,3701190899,3793389510,1672637066,1672640378,3312
7869,3510173870,3774195321,1672616106,1672616733,627
7929,3520730271,3515151980,1672640107,1672642227,2120
7887,3520931254,3783196518,1672626030,1672626682,652
7951,3734828619,3379256399,1672570104,1672572767,2663
7503,3404384505,3234362962,1672618558,1672620825,2267
7734,3716746253,3930791338,1672576594,1672578250,1656
7625,3826415738,3395152943,1672671242,1672673158,1916
7706,3312829208,3791020967,1672613075,1672613752,677
7826,3367902229,3515723720,1672577446,1672580833,3387
7983,3780593036,3826760240,1672540775,1672543986,3211
7939,3760598102,3430504438,1672552639,1672553710,1071
7919,3484995752,3939952128,1672602983,1672604837,1854
7522,3930797455,3509634629,1672629572,1672632965,3393
7697,3613995936,3716258994,1672690168,1672691860,1692
7698,3362000049,3883042241,1672661979,1672662515,536
7777,3626156564,3774298222,1672673045,1672675036,1991
7644,3510771358,3388372715,1672540730,1672541016,286
7848,3703735129,3683959482,1672590034,1672592644,2610
7727,3510247121,3778108318,1672568704,1672570885,2181
7685,3716165213,3898995675,1672637349,1672638925,1576
7910,3361230905,3792473331,1672624959,1672626400,1441
7499,3388286531,3666506258,1672578475,1672581459,2984
7622,3509933351,3891751546,1672600637,1672601520,883
7982,3311208440,3433804879,1672681208,1672682261,1053
7803,3805342762,3777983879,1672622928,1672622999,71
7616,3520709480,3774010081,1672654569,1672656635,2066
7734,3903009525,3285400528,1672637217,1672638317,1100
7858,3412980697,3387674757,1672627608,1672629478,1870
7705,3633420270,3774466457,1672562890,1672563940,1050
7826,3660493209,3388286531,1672554214,1672555728,1514
7918,3510126867,3359239884,1672639371,1672639905,534
7699,3407673904,3516223597,1672567602,1672571002,3400
7891,3511125626,3511332835,1672632458,1672632829,371
7848,3370752401,3518669703,1672583058,1672585062,2004
7738,3778980116,3556951786,1672674182,1672675486,1304
7893,3346795719,3533626375,1672651889,1672653900,2011
7487,3277669002,3713786889,1672693873,1672697236,3363
7825,3338367113,3480687894,1672559870,1672561895,2025
7657,3607748895,3791553060,1672534804,1672535312,508
7546,3510711755,3438645253,1672698777,1672700117,1340
7804,3429856982,3716488385,1672698851,1672701548,2697
7855,3510244400,3404058699,1672658602,1672658760,158
7579,3757812939,3202120784,1672550251,1672551367,1116
7809,3509453566,3881477378,1672615451,1672617518,2067
7959,3511350608,3533369198,1672540961,1672544141,3180
7798,3736786443,3777717988,1672602155,1672604823,2668
7881,3511312803,3471220483,1672551963,1672553858,1895
7905,3370752401,3935627557,1672690743,1672691243,500
7789,3511170269,3791874383,1672547841,1672549831,1990
7620,3516514391,3454042520,1672566244,1672566808,564
7726,3755511676,3534488837,1672537605,1672537766,161
7764,3715127362,3778305740,1672616080,1672617860,1780
7635,3518876135,3500374658,1672643633,1672646424,2791
7958,3780609808,3520888296,1672619918,1672623185,3267
7951,3242408357,3756424865,1672613029,1672614098,1069
7729,3428006164,3514283243,1672546886,1672547278,392
7647,3614238812,3500994774,1672537664,1672539931,2267
7834,3773598056,3333896808,1672681880,1672682989,1109
7585,3791942683,3303751772,1672630918,1672634298,3380
7884,3791553060,3505292701,1672584308,1672584769,461
7602,3978105277,3756021689,1672654395,1672654638,243
7497,3386707783,3314836094,1672625222,1672626179,957
7647,3304056063,3827626797,1672551819,1672554962,3143
7974,3365278081,3517509185,1672666485,1672667545,1060
7972,3489728806,3505635228,1672676152,1672678741,2589
7681,3520931254,3286658957,1672608636,1672612077,3441
7882,3780828689,3223968713,1672644289,1672645513,1224
7917,3509352754,3432689543,1672642788,1672644142,1354
7930,3311415018,3792789881,1672631366,1672632568,1202
7493,3756966035,3303705369,1672567688,1672568761,1073
7514,3438645253,3430352815,1672563847,1672566046,2199
7939,3734737881,3783429780,1672544810,1672547366,2556
7515,3882242815,3776338577,1672620014,1672622241,2227
7944,3828365570,3509630174,1672546365,1672549224,2859
7765,3514838220,3777936328,1672536483,1672538344,1861
7865,3505477652,3500994774,1672651464,1672654307,2843
7648,3520165601,3519556068,1672628869,1672629178,309
7519,3617734118,3399911573,1672632104,1672635339,3235
7778,3519803045,3608868877,1672559227,1672562249,3022
7530,3710098970,3500894271,1672658477,1672658796,319
7592,3701065786,3505791599,1672691130,1672692958,1828
7858,3520030713,3780294829,1672696136,1672698156,2020
7890,3777514571,3505873261,1672639795,1672641155,1360
7801,3715492942,3835382117,1672689584,1672692730,3146
7654,3666506258,3809484172,1672587622,1672590237,2615
7784,3791553060,3779740455,1672610375,1672612957,2582
7774,3756027749,3909331423,1672676787,1672677736,949
7686,3426325549,3666457294,1672564198,1672567427,3229
7543,3713808837,3629935998,1672688372,1672689625,1253
7665,3888559320,3286658957,1672659085,1672659874,789
7945,3901877072,3621810464,1672634472,1672637473,3001
7752,3465202715,3391915886,1672605934,1672606497,563
7815,3514838220,3247815299,1672621510,1672622808,1298
7640,3792177074,3311993075,1672702426,1672704645,2219
7941,3477375368,3220716272,1672565699,1672568263,2564
7887,3808324264,3601879040,1672669663,1672671863,2200
7663,3777477395,3930797455,1672640252,1672641174,922
7714,3624761861,3660493209,1672558491,1672560117,1626
7653,3319752091,3760569731,1672614856,1672615729,873
7807,3780639480,3383922351,1672615190,1672615957,767
7747,3304625412,3505791599,1672585356,1672586101,745
7553,3710344260,3505145247,1672645533,1672646237,704
7924,3855602893,3518496488,1672620271,1672620989,718
7654,3770553384,3736790081,1672649485,1672651362,1877
7843,3201432789,3755920131,1672646430,1672647617,1187
7595,3244436890,3512510536,1672551269,1672554458,3189
7716,3703955926,3496549058,1672562789,1672565842,3053
7528,3501483568,3515394721,1672547375,1672547891,516
7617,3344364444,3816454165,1672574568,1672577705,3137
7597,3311090974,3556951786,1672614428,1672616918,2490
7810,3511435497,3315583351,1672699271,1672702200,2929
7539,3710067113,3793871337,1672626719,1672628310,1591
7647,3774793839,3780788622,1672589171,1672591605,2434
7911,3755739653,3513599775,1672671809,1672673099,1290
7894,3755872268,3792844210,1672603328,1672603591,263
7495,3407725581,3780503655,1672674551,1672677650,3099
7485,3979339287,3555214688,1672538947,1672541605,2658
7680,3792253549,3430352815,1672610184,1672612398,2214
7818,3388286531,3826759140,1672688062,1672689268,1206
7810,3510771358,3778980116,1672635820,1672636105,285
7545,3918247820,3772642849,1672652388,1672653601,1213
7586,3601879040,3357483218,1672612557,1672613781,1224
7637,3629547065,3519703355,1672602588,1672603554,966
7843,3772309166,3666457294,1672556441,1672557211,770
7842,3520376528,3500994774,1672660738,1672661334,596
7894,3737051610,3770763956,1672590183,1672591771,1588
7610,3516716179,3778341199,1672603891,1672606681,2790
7562,3505702787,3791657947,1672570851,1672574334,3483
7972,3518408774,3249791738,1672554134,1672554373,239
7619,3244389794,3909606423,1672542934,1672543681,747
7509,3780294829,3733189298,1672542866,1672546463,3597
7853,3391261292,3500894271,1672600475,1672601666,1191
7562,3701184889,3500177712,1672658903,1672659797,894
7745,3534424200,3533270638,1672644629,1672645813,1184
7719,3617055293,3912536808,1672578226,1672579345,1119
7582,3716258994,3395152943,1672660440,1672660574,134
7517,3388286531,3511841857,1672631695,1672631835,140
7702,3903009525,3500365158,1672643883,1672646674,2791
7609,3607178184,3397418363,1672657737,1672658929,1192
7639,3904775198,3611150562,1672577069,1672580264,3195
7700,3480687894,3701111745,1672634458,1672637942,3484
7513,3513164386,3510711755,1672569617,1672571655,2038
7976,3783083229,3777443199,1672551493,1672552981,1488
7672,3756930948,3509352754,1672570284,1672573459,3175
7612,3780294829,3475795792,1672533686,1672535884,2198
7818,3311993075,3639847263,1672558537,1672559297,760
7805,3783705817,3793962300,1672590249,1672591522,1273
7803,3937224533,3774466457,1672572474,1672575493,3019
7493,3248507722,3618873142,1672618908,1672621263,2355
7964,3756451663,3304625412,1672565356,1672565766,410
7910,3277939457,3624761861,1672675184,1672675852,668
7804,3755881905,3780593036,1672662115,1672662827,712
7715,3518408774,3778780511,1672639376,1672639622,246
7672,3783126683,3280599164,1672531401,1672532887,1486
7585,3360743849,3392121505,1672588965,1672589222,257
7780,3406784491,3703889596,1672682650,1672686037,3387
7515,3416265063,3791901535,1672593824,1672595479,1655
7632,3390068992,3516514391,1672613753,1672614648,895
7588,3271938399,3616944364,1672690742,1672693991,3249
7954,3220716272,3757455053,1672588864,1672590662,1798
7659,3424922204,3517459919,1672657868,1672658582,714
7563,3772578994,3477375368,1672572488,1672574824,2336
7947,3711504540,3618045231,1672542818,1672544562,1744
7909,3608633356,3734828619,1672700889,1672703509,2620
7803,3608633356,3361230905,1672629862,1672632081,2219
7525,3421127249,3917088658,1672635441,1672638897,3456
7543,3500066230,3774501422,1672612338,1672614872,2534
7701,3760893269,3773814927,1672677765,1672679737,1972
7837,3770021824,3713786889,1672675275,1672676717,1442
7835,3513956646,3312664885,1672640070,1672643335,3265
7969,3629935998,3509907947,1672576430,1672576718,288
7598,3415546117,3552314511,1672647569,1672648286,717
7741,3392121505,3757151210,1672612183,1672615777,3594
7982,3505873261,3554917400,1672640597,1672641905,1308
7938,3311274543,3307097200,1672588894,1672591507,2613
7827,3735319397,3518876135,1672650433,1672653989,3556
7978,3791020967,3757812939,1672536627,1672538365,1738
7604,3515723720,3757161914,1672634806,1672636140,1334
7588,3715981584,3899266183,1672545550,1672546385,835
7733,3314245084,3811694763,1672607587,1672609186,1599
7977,3716273414,3774125065,1672685104,1672686174,1070
7519,3496269445,3520719611,1672607494,1672608115,621
7565,3976633198,3921211276,1672680354,1672681986,1632
7687,3279721246,3247780536,1672620530,1672622307,1777
7771,3914290246,3920801189,1672604913,1672606550,1637
7583,3710067113,3710098970,1672630835,1672633128,2293
7540,3793286136,3559110998,1672536606,1672537960,1354
7765,3885897503,3365614305,1672654094,1672654875,781
7798,3666457294,3711973519,1672579415,1672581269,1854
7666,3760569731,3509604974,1672655347,1672658727,3380
7854,3773205565,3342131135,1672550517,1672552220,1703
7694,3736625083,3760077057,1672675742,1672677464,1722
7921,3703013906,3415443558,1672546630,1672549959,3329
7876,3346327502,3773205565,1672645401,1672646881,1480
7842,3312333615,3331845324,1672547462,1672550712,3250
7885,3516629436,3755511676,1672646232,1672646925,693
7655,3534313900,3348261553,1672634100,1672636358,2258
7544,3430074045,3428674539,1672576662,1672577760,1098
7781,3793086311,3935627557,1672612650,1672613758,1108
7822,3780639480,3815508790,1672683387,1672685122,1735
7716,3703955926,3714504419,1672673629,1672674410,781
7885,3783925755,3298288268,1672689309,1672690731,1422
7522,3703013906,3505873261,1672623689,1672626379,2690
7552,3793338102,3777623166,1672630513,1672632525,2012
7617,3778980116,3783925755,1672607850,1672611244,3394
7880,3805519285,3776800213,1672554266,1672557232,2966
7699,3505530961,3228165483,1672531718,1672534444,2726
7596,3666506258,3760077057,1672614221,1672617296,3075
7649,3337544549,3683766533,1672544138,1672545312,1174
7687,3400804807,3883042241,1672568308,1672569565,1257
7746,3487171044,3914290246,1672638293,1672640692,2399
7917,3701146057,3433804879,1672695765,1672697081,1316
7955,3688683847,3516065852,1672630524,1672630906,382
7545,3716168623,3344364444,1672660915,1672661958,1043
7716,3885897503,3715998609,1672596094,1672596843,749
7907,3606987130,3249401741,1672577868,1672579399,1531
7520,3365942576,3828624701,1672553515,1672554773,1258
7826,3774268456,3369998498,1672678168,1672680139,1971
7724,3916289176,3917088658,1672666074,1672667068,994
7796,3420432297,3791957752,1672590862,1672593752,2890
7906,3509933351,3639847263,1672535473,1672536105,632
7840,3662180254,3756451663,1672554809,1672555084,275
7785,3780365428,3880285638,1672658051,1672659307,1256
7717,3736790081,3475795792,1672605963,1672608287,2324
7694,3311648200,3774127586,1672660448,1672662749,2301
7890,3755511676,3505135325,1672565044,1672565806,762
7742,3367902229,3760077057,1672600857,1672604166,3309
7588,3901990690,3511271692,1672619340,1672622788,3448
7600,3512567240,3853018906,1672559013,1672562534,3521
7711,3238712269,3713208927,1672649074,1672651200,2126
7756,3510771358,3918247820,1672636623,1672639391,2768
7629,3303751772,3430504438,1672633859,1672634673,814
7925,3432665384,3519152550,1672655847,1672657650,1803
7729,3516629436,3365614305,1672625605,1672627840,2235
7690,3415443558,3291227780,1672629927,1672633264,3337
7607,3882291183,3475251781,1672683492,1672684324,832
7969,3716197887,3516716179,1672656392,1672658955,2563
7708,3715981584,3511332835,1672542395,1672544517,2122
7749,3312664885,3792768129,1672677331,1672679768,2437
7496,3667680268,3610348516,1672678678,1672679593,915
7506,3701534009,3895562476,1672569824,1672573078,3254
7574,3792902982,3777455223,1672692611,1672693228,617
7713,3793338102,3924549929,1672625089,1672626452,1363
7886,3701995648,3777477395,1672562674,1672563569,895
7853,3713969578,3406784491,1672632720,1672633472,752
7847,3733189298,3357483218,1672588721,1672590022,1301
7839,3736419952,3755881905,1672648568,1672652132,3564
7911,3505193212,3756930948,1672550413,1672552952,2539
7865,3608633356,3378436155,1672701263,1672704237,2974
7863,3683959482,3312333615,1672695528,1672698882,3354
7719,3512540951,3505193212,1672621455,1672622532,1077
7657,3244173074,3307512479,1672648835,1672652081,3246
7521,3757602960,3492478793,1672641246,1672643363,2117
7945,3222521619,3774127586,1672588056,1672589704,1648
7629,3774793839,3346795719,1672570228,1672572486,2258
7546,3716197887,3377766165,1672591695,1672595144,3449
7635,3685818092,3935127663,1672590815,1672591463,648
7718,3618045231,3883042241,1672610539,1672614120,3581
7814,3399004969,3273500349,1672545221,1672548429,3208
7487,3424922204,3925402713,1672594827,1672595899,1072
7802,3779218771,3793436995,1672594230,1672595723,1493
7491,3432665384,3516065852,1672563989,1672564506,517
7809,3772714862,3773814927,1672531269,1672534442,3173
7877,3711308224,3433804879,1672682818,1672684030,1212
7556,3297463265,3391915121,1672672943,1672675033,2090
7668,3604539807,3716900301,1672546580,1672548981,2401
7576,3778980116,3200198928,1672540262,1672541875,1613
7589,3735319397,3755587522,1672631342,1672631909,567
7966,3783196518,3501692334,1672615980,1672619194,3214
7500,3383661227,3505203158,1672696472,1672697414,942
7783,3510857360,3614238812,1672644314,1672645620,1306
7842,3774338212,3909606423,1672570986,1672572647,1661
7690,3483164654,3234541252,1672683579,1672685773,2194
7938,3778305740,3701111745,1672673622,1672675047,1425
7583,3600647945,3288764520,1672670845,1672673540,2695
7726,3505962865,3520751702,1672622867,1672625417,2550
7896,3231056870,3733189298,1672610416,1672611830,1414
7956,3913251733,3222448362,1672560492,1672563826,3334
7684,3501486692,3533927138,1672543022,1672546133,3111
7574,3909238838,3448855696,1672666848,1672667769,921
7721,3510244400,3276993580,1672613534,1672613920,386
7621,3313541986,3770101921,1672622845,1672625085,2240
7591,3792844210,3476232529,1672533556,1672536379,2823
7913,3902278226,3915628728,1672577214,1672578775,1561
7502,3512349371,3926700506,1672617696,1672621089,3393
7772,3234362962,3757602960,1672540641,1672542443,1802
7543,3793962300,3793962300,1672681035,1672681185,150
7814,3221899927,3778980116,1672664223,1672665461,1238
7915,3311648200,3925620998,1672670664,1672672542,1878
7694,3515125508,3711265369,1672642131,1672644331,2200
7967,3823600322,3772544062,1672640552,1672642724,2172
7700,3313541986,3889232789,1672686120,1672687073,953
7585,3533626375,3346795719,1672559763,1672561409,1646
7550,3792844210,3783196518,1672605305,1672605732,427
7770,3200198928,3512142794,1672626937,1672629918,2981
7795,3755436115,3505873261,1672655752,1672657166,1414
7506,3367029997,3231056870,1672661874,1672663037,1163
7932,3778780511,3902278226,1672683242,1672683557,315
7585,3829764737,3361230905,1672595956,1672598015,2059
7614,3519556068,3234541252,1672652097,1672655392,3295
7719,3284639858,3916289176,1672682140,1672685382,3242
7802,3703275621,3500803339,1672669501,1672671522,2021
7895,3505203158,3601879040,1672698350,1672698996,646
7581,3772884106,3391261292,1672690096,1672691826,1730
7616,3777717988,3731419510,1672628190,1672630110,1920
7640,3519556068,3533827120,1672605089,1672605535,446
7939,3772642849,3733189298,1672667930,1672669245,1315
7892,3780813786,3757602960,1672677828,1672681064,3236
7698,3417587765,3430504438,1672556105,1672557215,1110
7738,3714821932,3793389510,1672605407,1672605525,118
7537,3710112546,3510126867,1672571110,1672574564,3454
7532,3615046771,3510711755,1672618046,1672619111,1065
7642,3909606423,3855000166,1672592461,1672593805,1344
7703,3774045700,3792032359,1672613991,1672616670,2679
7695,3756451663,3791334389,1672537134,1672538945,1811
7624,3703718151,3889232789,1672594116,1672596380,2264
7501,3520165601,3776800213,1672541963,1672545405,3442
7669,3378686918,3755798867,1672599220,1672602264,3044
7798,3710067113,3733891182,1672562553,1672564709,2156
7860,3793627961,3311761694,1672553429,1672555157,1728
7533,3889232789,3855937514,1672665196,1672666756,1560
7641,3360993964,3918056059,1672566829,1672568984,2155
7827,3629935998,3346327502,1672545490,1672545709,219
7764,3780639480,3772758337,1672695843,1672696563,720
7630,3428964059,3811171116,1672555111,1672557203,2092
7974,3780593036,3912262917,1672636561,1672639170,2609
7920,3387674757,3513599775,1672581079,1672581826,747
7924,3634340855,3227158514,1672670128,1672670428,300
7652,3826633236,3701178711,1672668840,1672671414,2574
7518,3618045231,3397418363,1672665205,1672666619,1414
7531,3774338212,3776338577,1672679148,1672679699,551
7693,3388372715,3550946908,1672618293,1672619069,776
7936,3783925755,3792177074,1672670486,1672673718,3232
7845,3780294829,3793086311,1672641829,1672644172,2343
7501,3793436995,3736419952,1672558115,1672558992,877
7917,3505962865,3780914982,1672599520,1672602179,2659
7543,3518876135,3360993964,1672651834,1672653734,1900
7506,3287105466,3505201246,1672547485,1672548770,1285
7821,3777120536,3909331423,1672629959,1672633068,3109
7777,3500199935,3713349754,1672541202,1672541389,187
7492,3889232789,3774466457,1672666677,1672667310,633
7982,3394539273,3515125508,1672696562,1672698680,2118
7747,3818255890,3303705369,1672613909,1672614332,423
7968,3533371364,3200691026,1672555121,1672557147,2026
7890,3825229501,3519428855,1672687898,1672690577,2679
7795,3760294205,3488244966,1672606187,1672607217,1030
7673,3399052055,3774268456,1672590376,1672593222,2846
7645,3288764520,3512567240,1672554064,1672556622,2558
7946,3500177712,3701274634,1672576253,1672576867,614
7595,3244173074,3793848402,1672679013,1672681321,2308
7738,3773814927,3552314511,1672559642,1672561278,1636
7780,3285400528,3311718847,1672583913,1672586273,2360
7866,3533369198,3793470489,1672684001,1672685229,1228
7643,3311761694,3510703546,1672544673,1672545227,554
7511,3443698222,3515125508,1672604986,1672605512,526
7845,3511841857,3500994774,1672633867,1672636360,2493
7713,3627937312,3512683609,1672679083,1672681316,2233
7516,3804870229,3711569060,1672580009,1672582134,2125
7948,3922275620,3348261553,1672665404,1672666142,738
7966,3783245561,3401627165,1672692528,1672695792,3264
7560,3713268590,3490191091,1672575324,1672575398,74
7503,3485823740,3711571712,1672563529,1672565158,1629
7977,3618873142,3533653428,1672581336,1672581497,161
7908,3839849341,3883312122,1672575775,1672577264,1489
7520,3773978034,3511170269,1672543772,1672544860,1088
7955,3825229501,3783925755,1672578517,1672580601,2084
7759,3515691540,3501955238,1672669544,1672670609,1065
7798,3505201246,3302626661,1672606248,1672609047,2799
7911,3220716272,3738274418,1672681118,1672683903,2785
7491,3791901535,3280615985,1672548190,1672550606,2416
7729,3390068992,3356860407,1672675747,1672677221,1474
7887,3756453423,3519563836,1672697741,1672700323,2582
7948,3534424200,3517077106,1672550181,1672550680,499
7774,3485823740,3880285638,1672615259,1672616666,1407
7823,3509907947,3206603608,1672647465,1672648234,769
7557,3512683609,3389115045,1672608187,1672609798,1611
7748,3606812411,3901990690,1672551494,1672552262,768
7750,3378686918,3516909237,1672679268,1672679537,269
7879,3791997875,3228165483,1672661909,1672662303,394
7595,3703735129,3811171116,1672651596,1672654701,3105
7827,3757562897,3924549929,1672586507,1672587275,768
7647,3516606733,3757447189,1672570770,1672573866,3096
7503,3459030804,3757161914,1672590093,1672592872,2779
7595,3913251733,3345207877,1672555399,1672555639,240
7588,3429856982,3311845971,1672649249,1672649933,684
7853,3935627557,3520706195,1672684070,1672687113,3043
7635,3736625083,3755587522,1672650666,1672651627,961
7847,3760569731,3501483568,1672626128,1672626940,812
7818,3434642576,3374559242,1672639328,1672642088,2760
7559,3516606733,3780828689,1672560451,1672560656,205
7513,3780974443,3533371364,1672563570,1672566538,2968
7486,3509933351,3666553782,1672601714,1672602915,1201
7668,3519069599,3519069599,1672551463,1672553242,1779
7721,3512567240,3516223597,1672592795,1672594009,1214
7702,3418534998,3520012395,1672598592,1672600339,1747
7522,3822654369,3510594211,1672581703,1672583614,1911
7728,3346795719,3883042241,1672686084,1672688168,2084
7518,3510173870,3910454786,1672696202,1672697106,904
7964,3430074045,3517476351,1672563808,1672566237,2429
7721,3973560347,3972364603,1672656423,1672656567,144
7525,3976390453,3370752401,1672670892,1672671605,713
7872,3792288302,3805342762,1672647809,1672650456,2647
7784,3776338577,3703889596,1672683199,1672686492,3293
7960,3811171116,3390068992,1672670614,1672673770,3156
7869,3715581279,3514719601,1672550536,1672552776,2240
7803,3776066388,3388286531,1672632051,1672634174,2123
7605,3510857360,3520183192,1672619154,1672622452,3298
7937,3378092448,3809484172,1672587749,1672589882,2133
7581,3774010081,3481502100,1672599695,1672600498,803
7917,3776513891,3793959750,1672586791,1672587766,975
7823,3773598056,3485823740,1672532484,1672532720,236
7585,3500499542,3426325549,1672650615,1672650698,83
7743,3703889596,3247780536,1672565308,1672566341,1033
7873,3395152943,3792902982,1672670202,1672671864,1662
7724,3515723720,3701984666,1672533647,1672536290,2643
7880,3201848640,3772642849,1672570322,1672573876,3554
7606,3516909237,3534702203,1672558717,1672561453,2736
7676,3362000049,3760992710,1672670380,1672672151,1771
7618,3802367797,3307512479,1672618069,1672619145,1076
7607,3859525941,3828365570,1672630711,1672632014,1303
7549,3533810360,3685818092,1672678449,1672678517,68
7520,3639847263,3757562897,1672642793,1672643811,1018
7843,3313541986,3666457294,1672690687,1672692432,1745
7765,3520931254,3713808837,1672631608,1672634339,2731
7509,3828365570,3972364603,1672559971,1672563125,3154
7935,3809059934,3454042520,1672638200,1672640189,1989
7565,3311065516,3713808837,1672675800,1672676187,387
7748,3757403279,3636867411,1672580775,1672582432,1657
7486,3505362057,3776800213,1672576464,1672579392,2928
7553,3791957752,3760489031,1672673960,1672676932,2972
7874,3805342762,3857349323,1672664141,1672664494,353
7841,3774520233,3626156564,1672533698,1672535374,1676
7629,3516629436,3773429448,1672657475,1672659033,1558
7880,3235287260,3367029997,1672691488,1672693063,1575
7729,3793848402,3901877072,1672637538,1672639315,1777
7800,3505477652,3777790718,1672560425,1672562238,1813
7704,3777936328,3505347134,1672698967,1672701084,2117
7978,3209551760,3815508790,1672534655,1672535959,1304
7720,3975287541,3880285638,1672570960,1672572170,1210
7882,3683766533,3601879040,1672579732,1672580352,620
7860,3351008918,3793959750,1672667879,1672671384,3505
7566,3760492950,3756462516,1672534245,1672536152,1907
7852,3511435497,3774119563,1672550174,1672551442,1268
7624,3760183458,3883312122,1672544878,1672547275,2397
7487,3733189298,3755943611,1672615717,1672616125,408
7885,3483164654,3206603608,1672601111,1672602916,1805
7722,3208844525,3756462516,1672642766,1672643596,830
7786,3359910781,3774195321,1672678565,1672680524,1959
7569,3356860407,3420432297,1672614979,1672617203,2224
7837,3505530961,3883042241,1672543204,1672543974,770
7748,3392121505,3534492426,1672624976,1672625103,127
7934,3815508790,3715492942,1672691244,1672691316,72
7759,3519703355,3280599164,1672601974,1672604357,2383
7612,3516716179,3293695955,1672563175,1672566222,3047
7640,3242408357,3394330287,1672659534,1672662079,2545
7755,3285400528,3298433163,1672557786,1672560040,2254
7983,3200691026,3533626375,1672611377,1672612557,1180
7841,3780974443,3223789409,1672702322,1672704348,2026
7780,3312664885,3774366875,1672610016,1672612947,2931
7664,3770763956,3931941795,1672615301,1672618462,3161
7888,3777776687,3779218771,1672699692,1672702097,2405
7646,3755739653,3509604974,1672621838,1672622351,513
7722,3510247121,3415443558,1672674564,1672675425,861
7731,3917088658,3834257412,1672566953,1672569334,2381
7821,3713644518,3883312122,1672539689,1672539939,250
7501,3489217083,3358871377,1672566167,1672567061,894
7609,3510244400,3662180254,1672612895,1672615152,2257
7781,3360506772,3832902928,1672659498,1672660397,899
7551,3484995752,3505599848,1672672137,1672673655,1518
7755,3930791338,3921211276,1672602032,1672604729,2697
7749,3509907947,3285400528,1672692312,1672695484,3172
7723,3703223015,3496269445,1672670487,1672672558,2071
7534,3505135325,3773429448,1672536427,1672538007,1580
7781,3318697153,3505883609,1672657675,1672658684,1009
7897,3554917400,3777455223,1672659609,1672661682,2073
7617,3351554343,3399052055,1672578040,1672580734,2694
7794,3924549929,3246596716,1672569970,1672572268,2298
7749,3427283336,3510771358,1672572672,1672573681,1009
7963,3477649378,3293695955,1672609380,1672612131,2751
7900,3601879040,3736592744,1672661149,1672664464,3315
7667,3857349323,3920801189,1672671133,1672673111,1978
7589,3500229033,3534191820,1672579569,1672581657,2088
7946,3736229191,3922275620,1672629565,1672633112,3547
7961,3713644518,3711198793,1672612733,1672612805,72
7874,3512567240,3783705817,1672665914,1672668664,2750
7517,3666457294,3621497531,1672673175,1672673710,535
7595,3519601612,3914259449,1672647663,1672651151,3488
7697,3550946908,3713370078,1672557801,1672558591,790
7495,3979339287,3348261553,1672643501,1672643929,428
7900,3774066725,3778780511,1672564051,1672564384,333
7509,3519152550,3248507722,1672684370,1672685774,1404
7865,3853018906,3249247700,1672598017,1672600046,2029
7798,3284639858,3774195321,1672601727,1672603425,1698
7719,3311203656,3755392666,1672565199,1672567273,2074
7502,3774268456,3711370563,1672609666,1672612401,2735
7815,3314836094,3370636709,1672667348,1672667742,394
7941,3735319397,3774501422,1672537732,1672539874,2142
7620,3430504438,3505873261,1672687723,1672689048,1325
7887,3627937312,3910454786,1672648812,1672649820,1008
7548,3404384505,3244485293,1672654182,1672656884,2702
7838,3629547065,3296471982,1672581085,1672583839,2754
7785,3760077057,3703955926,1672681762,1672681920,158
7976,3791657947,3780788622,1672671460,1672674296,2836
7954,3972709319,3823600322,1672597291,1672600130,2839
7712,3791553060,3605726278,1672634627,1672635322,695
7738,3777079686,3516016437,1672561710,1672564909,3199
7775,3713208927,3970117174,1672618805,1672619803,998
7797,3972364603,3273500349,1672679480,1672682967,3487
7617,3533653428,3882242815,1672674850,1672677214,2364
7919,3855424474,3510173870,1672554309,1672555121,812
7768,3500199935,3772884106,1672565151,1672567869,2718
7677,3302626661,3517963492,1672541564,1672543711,2147
7484,3774066725,3404384505,1672675084,1672677672,2588
7635,3517077106,3513080274,1672702065,1672704972,2907
7838,3475396323,3757602960,1672533508,1672536575,3067
7766,3396285984,3792768129,1672608455,1672611132,2677
7718,3715981584,3417970574,1672567555,1672569590,2035
7508,3519654779,3613995936,1672604930,1672607447,2517
7710,3853018906,3315583351,1672537238,1672539352,2114
7873,3316222192,3510380060,1672640698,1672642597,1899
7672,3511332835,3852595551,1672703301,1672704308,1007
7802,3710408395,3505859863,1672644207,1672644286,79
7922,3505649239,3811694763,1672690740,1672692129,1389
7561,3482405588,3918247820,1672567261,1672569936,2675
7929,3666457294,3520206212,1672682692,1672684385,1693
7491,3802367797,3904408902,1672700676,1672701563,887
7826,3688683847,3501364586,1672587587,1672589550,1963
7732,3703889596,3701967560,1672628001,1672631534,3533
7484,3505873261,3311065516,1672543932,1672544648,716
7756,3711504540,3509933351,1672571661,1672574312,2651
7813,3902383721,3774010081,1672658202,1672661181,2979
7486,3520931254,3808324264,1672634511,1672637410,2899
7890,3756966035,3701898991,1672537006,1672537999,993
7596,3703789494,3792032359,1672655684,1672656627,943
7905,3713268590,3634786711,1672652116,1672653274,1158
7487,3808324264,3552314511,1672679048,1672680376,1328
7641,3360993964,3446948848,1672638806,1672640685,1879
7600,3683766533,3399052055,1672575408,1672578478,3070
7559,3667680268,3505873261,1672546706,1672547317,611
7508,3682061100,3756021689,1672584896,1672587379,2483
7788,3701898991,3510173870,1672589458,1672590778,1320
7899,3500578848,3516909237,1672665220,1672667816,2596
7599,3703661585,3701111745,1672582972,1672583827,855
7536,3220716272,3500994774,1672688019,1672691025,3006
7642,3378436155,3778305740,1672663674,1672666668,2994
7938,3889750851,3500894271,1672630965,1672631517,552
7625,3337544549,3520719611,1672559140,1672560733,1593
7647,3774556560,3760992710,1672535606,1672538203,2597
7879,3756930948,3224716315,1672662821,1672666355,3534
7566,3811171116,3777477395,1672559103,1672561544,2441
7878,3500199935,3316222192,1672605560,1672608619,3059
7673,3500229033,3511350608,1672554903,1672557501,2598
7539,3608868877,3411618230,1672566998,1672567977,979
7667,3467773920,3221899927,1672673094,1672676123,3029
7682,3736625083,3607178184,1672571943,1672574890,2947
7828,3976633198,3201848640,1672620562,1672621161,599
7641,3513164386,3421127249,1672686757,1672688698,1941
7891,3634995491,3501759100,1672551159,1672554568,3409
7609,3711370563,3756451663,1672681000,1672683146,2146
7531,3367902229,3206593906,1672593552,1672596664,3112
7813,3774556560,3779218771,1672637706,1672638195,489
7487,3297463265,3774195321,1672695163,1672696398,1235
7644,3500729955,3472130842,1672647418,1672650678,3260
7981,3703718151,3533810360,1672579886,1672582059,2173
7962,3757455053,3883312122,1672643879,1672644474,595
7539,3405494240,3201848640,1672661319,1672661927,608
7565,3489962019,3500060260,1672588657,1672591981,3324
7826,3511170269,3715981584,1672639516,1672641996,2480
7580,3902278226,3386707783,1672590024,1672590888,864
7909,3416241005,3711370563,1672670238,1672672546,2308
7564,3755436115,3827377568,1672558439,1672561418,2979
7862,3512166013,3826415738,1672604868,1672605717,849
7524,3780365428,3385763781,1672567432,1672568162,730
7588,3511687358,3373384732,1672671141,1672672872,1731
7581,3510857360,3466911760,1672574069,1672574777,708
7865,3703718151,3829232696,1672612994,1672615035,2041
7936,3773429448,3505973226,1672595902,1672597796,1894
7599,3291227780,3737079798,1672684626,1672684890,264
7887,3760183458,3713644518,1672612651,1672614172,1521
7756,3518669703,3513080274,1672541583,1672541790,207
7631,3478194807,3505883609,1672568288,1672570294,2006
7655,3770635361,3933210486,1672597211,1672600120,2909
7563,3388372715,3409474775,1672680819,1672682496,1677
7805,3518408774,3311324983,1672692780,1672695781,3001
7883,3533626375,3351008918,1672631261,1672632159,898
7578,3807987001,3716165213,1672688318,1672688560,242
7760,3713349754,3520719611,1672574356,1672577867,3511
7781,3816853177,3736592744,1672673827,1672675346,1519
7824,3459030804,3512567240,1672690859,1672694226,3367
7787,3342131135,3209383861,1672683828,1672686754,2926
7663,3501955238,3234362962,1672591095,1672593712,2617
7685,3793959750,3855937514,1672683694,1672684981,1287
7949,3516258476,3820354437,1672579479,1672580070,591
7508,3736229191,3777455223,1672560645,1672562495,1850
7747,3291227780,3296471982,1672687504,1672687998,494
7697,3757812939,3311648200,1672634134,1672634263,129
7556,3383661227,3972364603,1672664827,1672667009,2182
7762,3817316561,3710112546,1672542359,1672545774,3415
7811,3715998609,3518014404,1672693629,1672697198,3569
7801,3518669703,3383661227,1672646776,1672647678,902
7765,3713208927,3533385867,1672543428,1672546110,2682
7693,3783429780,3383661227,1672607961,1672609803,1842
7608,3625274012,3209027249,1672534040,1672535414,1374
7734,3777514571,3736790081,1672616434,1672619221,2787
7720,3399052055,3534729133,1672616585,1672617555,970
7938,3703661585,3511163800,1672615248,1672617303,2055
7713,3853018906,3417970574,1672657345,1672658490,1145
7952,3534191820,3714488548,1672679355,1672680988,1633
7826,3809484172,3307512479,1672605375,1672607723,2348
7796,3514987389,3774125065,1672545653,1672546354,701
7664,3512142794,3713786889,1672670736,1672672886,2150
7829,3716258994,3898995675,1672653413,1672653856,443
7558,3533193862,3820354437,1672681889,1672684869,2980
7644,3471220483,3501198706,1672597690,1672599067,1377
7608,3772309150,3772544062,1672640077,1672642594,2517
7589,3236102733,3518669703,1672604586,1672605898,1312
7675,3776513891,3378092448,1672567691,1672568475,784
7753,3711569060,3520183192,1672587779,1672588249,470
7494,3711380716,3710067113,1672686143,1672686720,577
7649,3511271692,3780914982,1672569859,1672572063,2204
7962,3515723720,3773950140,1672693763,1672693992,229
7581,3432689543,3703661585,1672565516,1672568769,3253
7597,3228165483,3755392666,1672569429,1672571698,2269
7874,3311274543,3834257412,1672641652,1672643216,1564
7664,3407725581,3334033993,1672586159,1672587683,1524
7696,3515860749,3304056063,1672670268,1672671524,1256
7889,3346795719,3510380060,1672664027,1672665842,1815
7628,3756453423,3510969660,1672674201,1672675180,979
7522,3783429780,3338703270,1672693045,1672693778,733
7672,3855000166,3533242305,1672602540,1672606027,3487
7661,3914290246,3360506772,1672571497,1672574476,2979
7577,3533242305,3715981584,1672597139,1672599634,2495
7687,3701534009,3294803686,1672592464,1672595921,3457
7783,3774010081,3770851318,1672673025,1672673616,591
7668,3903307060,3229058858,1672547667,1672549152,1485
7895,3780813786,3791553060,1672553405,1672554448,1043
7584,3978115672,3618873142,1672593767,1672596385,2618
7585,3716258994,3633420270,1672671462,1672672667,1205
7773,3500904641,3755798867,1672588218,1672590382,2164
7504,3793436995,3387966152,1672547616,1672548844,1228
7825,3279721246,3777477395,1672580836,1672581697,861
7777,3336751428,3683766533,1672692430,1672693542,1112
7515,3701111745,3533137446,1672630965,1672632544,1579
7604,3221899927,3834257412,1672633252,1672634350,1098
7584,3777514571,3793338102,1672571166,1672574592,3426
7661,3909331423,3776338577,1672638725,1672641857,3132
7564,3311439795,3621497531,1672675087,1672675975,888
7822,3520888296,3426325549,1672551983,1672554839,2856
7849,3933210486,3500578848,1672618534,1672621207,2673
7634,3500578848,3818255890,1672562711,1672563971,1260
7883,3516039895,3483949762,1672596752,1672600207,3455
7825,3202120784,3760489031,1672651530,1672653203,1673
7827,3628819436,3501184421,1672673469,1672675013,1544
7933,3757447189,3477649378,1672683630,1672686867,3237
7816,3756528686,3223789409,1672620185,1672622450,2265
7763,3911245524,3406784491,1672672203,1672673132,929
7877,3500499542,3500894271,1672617772,1672621059,3287
7922,3417061462,3713894336,1672675995,1672679472,3477
7849,3780503655,3518876135,1672541611,1672544279,2668
7777,3533137446,3922337974,1672546024,1672548053,2029
7805,3804870229,3478194807,1672695724,1672698222,2498
7964,3500229033,3235635976,1672581841,1672582995,1154
7635,3501486692,3369998498,1672664519,1672664771,252
7575,3664517356,3978115672,1672654591,1672655681,1090
7491,3809059934,3613995936,1672638345,1672641255,2910
7487,3611150562,3485008994,1672571536,1672572399,863
7756,3914259449,3383661227,1672571096,1672573478,2382
7553,3336742544,3683959482,1672586722,1672590180,3458
7965,3501606184,3365830990,1672605749,1672606046,297
7502,3735319397,3500229033,1672571968,1672574082,2114
7548,3889232789,3780788622,1672605102,1672605690,588
7901,3618045231,3291883916,1672545868,1672546786,918
7682,3710344260,3520719611,1672549780,1672550319,539
7649,3421127249,3701274634,1672637313,1672637595,282
7828,3384240055,3622054816,1672590435,1672593792,3357
7687,3622054816,3774119563,1672695937,1672697421,1484
7952,3859525941,3311324983,1672647001,1672649405,2404
7826,3280599164,3716488385,1672546665,1672548236,1571
7760,3701534009,3688418210,1672613650,1672614908,1258
7705,3284832486,3808324264,1672603619,1672606480,2861
7721,3513080274,3365278081,1672638471,1672639777,1306
7919,3512720680,3236102733,1672567694,1672568759,1065
7685,3668005723,3755625324,1672604715,1672605566,851
7695,3713644518,3909606423,1672695472,1672697258,1786
7569,3823600322,3833889105,1672570954,1672573981,3027
7852,3359239884,3779036831,1672578962,1672582241,3279
7971,3396285984,3314836094,1672603435,1672606155,2720
7943,3777477395,3509604974,1672610803,1672612556,1753
7972,3703441914,3714962248,1672614646,1672616156,1510
7832,3277669002,3338703270,1672615755,1672616497,742
7976,3533280269,3800886801,1672563149,1672564712,1563
7874,3201432789,3220716272,1672549548,1672550291,743
7728,3918247820,3417061462,1672687999,1672689260,1261
7501,3505145247,3815508790,1672627092,1672630191,3099
7631,3276993580,3716165213,1672571601,1672573220,1619
7532,3887270940,3715981584,1672689222,1672689905,683
7744,3500904641,3777790718,1672566566,1672569172,2606
7714,3534191820,3618873142,1672629955,1672633382,3427
7777,3780365428,3311203656,1672695017,1672696325,1308
7877,3516673015,3703013906,1672644074,1672647241,3167
7564,3903307060,3533193862,1672580598,1672583303,2705
7794,3617055293,3783779671,1672631897,1672633782,1885
7510,3222521619,3812176780,1672678968,1672681672,2704
7765,3791942683,3454042520,1672566210,1672567647,1437
7502,3716746253,3703275621,1672663355,1672666215,2860
7774,3817621391,3396285984,1672693203,1672694713,1510
7930,3738274418,3826415738,1672648661,1672651733,3072
7776,3918056059,3505912939,1672538106,1672539507,1401
7561,3792288302,3755511676,1672661594,1672662426,832
7552,3555214688,3615046771,1672631080,1672631151,71
7854,3443698222,3909606423,1672680028,1672683613,3585
7947,3232962003,3415443558,1672608960,1672610828,1868
7768,3735733948,3509634629,1672536116,1672538876,2760
7689,3756453423,3311152102,1672613317,1672615649,2332
7968,3978105277,3755042098,1672556303,1672557516,1213
7931,3777776687,3511841857,1672636907,1672639558,2651
7750,3344364444,3606186086,1672624790,1672626576,1786
7680,3298288268,3774520233,1672649709,1672650675,966
7905,3791334389,3757455053,1672600220,1672601522,1302
7650,3792844210,3501955238,1672532059,1672533435,1376
7916,3500578848,3533137446,1672654320,1672654947,627
7975,3471220483,3715998609,1672642953,1672645157,2204
7892,3701534009,3800886801,1672623896,1672624864,968
7924,3550946908,3236102733,1672671314,1672671880,566
7769,3883085535,3397418363,1672677506,1672680288,2782
7598,3890149705,3519428855,1672698446,1672699471,1025
7857,3453729665,3777717988,1672551572,1672553863,2291
7908,3922337974,3311627628,1672702276,1672703108,832
7492,3914259449,3608868877,1672697558,1672699055,1497
7820,3485375593,3756424865,1672537942,1672538804,862
7764,3922275620,3552314511,1672684038,1672684593,555
7574,3783705817,3247428249,1672631822,1672635319,3497
7866,3511862351,3780914982,1672613971,1672614106,135
7774,3770101921,3451432842,1672687268,1672689307,2039
7492,3222521619,3756424865,1672535445,1672535734,289
7656,3736786443,3828624701,1672639232,1672641450,2218
7850,3776948966,3756424865,1672556289,1672558911,2622
7815,3604539807,3800353779,1672674304,1672675124,820
7807,3773429448,3513080274,1672535274,1672537084,1810
7606,3222521619,3883085535,1672687031,1672689601,2570
7614,3533653428,3770851318,1672532355,1672534986,2631
7583,3714962248,3401627165,1672627552,1672629520,1968
7965,3517509185,3533927138,1672685320,1672685420,100
7943,3826759140,3448855696,1672668135,1672669667,1532
7510,3520629279,3222521619,1672636493,1672637201,708
7956,3487171044,3780294829,1672550657,1672553609,2952
7521,3757455053,3915628728,1672687134,1672687838,704
7544,3760598102,3500458761,1672621691,1672622423,732
7858,3688418210,3666506258,1672588698,1672590484,1786
7740,3415443558,3505869747,1672684671,1672686436,1765
7941,3739106581,3713644518,1672615069,1672616213,1144
7915,3505173328,3805342762,1672702106,1672705512,3406
7972,3922275620,3510857360,1672563431,1672566361,2930
7697,3858918246,3817621391,1672652165,1672652983,818
7798,3236102733,3519803045,1672679774,1672680076,302
7825,3809484172,3734496778,1672532993,1672533220,227
7562,3497901842,3273500349,1672574194,1672574559,365
7840,3716746253,3760267716,1672562698,1672564581,1883
7744,3209551760,3221899927,1672640471,1672643417,2946
7885,3533025282,3428006164,1672556512,1672557013,501
7824,3662180254,3792668962,1672588136,1672591353,3217
7861,3394539273,3925620998,1672689962,1672690824,862
7840,3397418363,3772714862,1672613844,1672614285,441
7635,3514719601,3520012395,1672607648,1672608575,927
7878,3505869747,3617734118,1672633387,1672635482,2095
7830,3937224533,3291235378,1672592702,1672593425,723
7916,3701178711,3291883916,1672647126,1672650647,3521
7622,3777079686,3247780536,1672585178,1672586255,1077
7688,3760077057,3773598056,1672654209,1672656689,2480
7814,3774127586,3311648200,1672628152,1672631088,2936
7507,3774556560,3443698222,1672584452,1672585345,893
7929,3792288302,3505873261,1672697676,1672699952,2276
7759,3859663348,3223789409,1672683371,1672684920,1549
7765,3394539273,3711308224,1672543030,1672544328,1298
7778,3757812939,3736625083,1672606654,1672608229,1575
7762,3222521619,3774050956,1672607189,1672608799,1610
7653,3520376528,3899204805,1672628939,1672629661,722
7928,3519069599,3621810464,1672644523,1672648103,3580
7558,3792253549,3738502357,1672572090,1672574374,2284
7522,3925620998,3903009525,1672654655,1672657012,2357
7529,3280599164,3533193862,1672621930,1672622390,460
7857,3500391167,3475396323,1672613256,1672615650,2394
7895,3976390453,3331845324,1672639722,1672641438,1716
7738,3505201246,3783531004,1672665013,1672665240,227
7584,3519700826,3802367797,1672595772,1672598401,2629
7821,3827626797,3494290908,1672695793,1672697573,1780
7603,3520629279,3520756859,1672681949,1672685208,3259
7486,3793962300,3220716272,1672540496,1672541485,989
7751,3510173870,3273500349,1672613125,1672614954,1829
7830,3520706195,3899266183,1672534676,1672534834,158
7496,3904775198,3853018906,1672675176,1672677283,2107
7924,3500374658,3429856982,1672627703,1672630619,2916
7937,3793753089,3271938399,1672559813,1672561299,1486
7794,3739106581,3511163800,1672649783,1672650685,902
7899,3770851318,3550946908,1672534849,1672537312,2463
7651,3756027749,3901990690,1672577240,1672579482,2242
7722,3359910781,3909238838,1672678646,1672679450,804
7522,3234362962,3731419510,1672647070,1672647401,331
7549,3756966035,3312664885,1672661855,1672662306,451
7803,3505702787,3284639858,1672655138,1672658291,3153
7658,3760598102,3855602893,1672608075,1672611474,3399
7793,3935627557,3607748895,1672536677,1672538662,1985
7729,3515151980,3533371364,1672672641,1672672876,235
7847,3227457126,3624312512,1672555842,1672559069,3227
7540,3668005723,3487171044,1672533005,1672533344,339
7917,3711265369,3828432634,1672653126,1672654916,1790
7532,3420700674,3805519285,1672692682,1672693407,725
7905,3817621391,3512969370,1672679195,1672682646,3451
7531,3828624701,3800353779,1672655738,1672658323,2585
7752,3520030713,3776800213,1672594166,1672597480,3314
7507,3201324715,3668005723,1672563452,1672566978,3526
7505,3454042520,3703735129,1672601017,1672604037,3020
7581,3701995648,3500229033,1672690192,1672692027,1835
7944,3271938399,3757246925,1672531588,1672532984,1396
7630,3337544549,3902278226,1672696205,1672697448,1243
7714,3756021689,3206603608,1672532759,1672535945,3186
7536,3774793839,3779036831,1672631208,1672632973,1765
7687,3777079686,3500229033,1672594946,1672597803,2857
7862,3361230905,3373384732,1672604893,1672605491,598
7841,3471220483,3807987001,1672585184,1672587886,2702
7680,3249401741,3501486692,1672552272,1672552484,212
7549,3774204963,3776513891,1672532128,1672535634,3506
7858,3505292701,3510247121,1672537796,1672539959,2163
7922,3312333615,3887270940,1672600416,1672603491,3075
7890,3516223597,3364543015,1672558618,1672559234,616
7563,3505702787,3510380060,1672560301,1672563163,2862
7886,3513080274,3756027749,1672592589,1672593899,1310
7819,3510594211,3715581279,1672678399,1672679599,1200
7797,3756528686,3520206212,1672537601,1672539193,1592
7813,3385763781,3534553510,1672616776,1672619872,3096
7922,3231056870,3772359096,1672546635,1672548288,1653
7805,3730517636,3247815299,1672624404,1672626151,1747
7799,3606987130,3714488548,1672652983,1672655273,2290
7905,3511350608,3338367113,1672548233,1672550513,2280
7730,3818255890,3459030804,1672649928,1672651667,1739
7829,3770078063,3500805881,1672666811,1672667415,604
7613,3853018906,3688683847,1672642677,1672643823,1146
7818,3778305740,3703013906,1672594454,1672596376,1922
7696,3369998498,3505219850,1672605652,1672606423,771
7746,3222448362,3443698222,1672699093,1672701637,2544
7680,3710569131,3889750851,1672566624,1672567913,1289
7830,3420700674,3683959482,1672626131,1672629011,2880
7974,3801089989,3780788622,1672575402,1672576012,610
7921,3312664885,3757246925,1672628032,1672628313,281
7574,3793753089,3776338577,1672610757,1672611702,945
7837,3683766533,3834257412,1672629147,1672632477,3330
7886,3516673015,3514472925,1672617868,1672621194,3326
7548,3733189298,3818255890,1672651700,1672652433,733
7488,3901990690,3421836608,1672630029,1672632174,2145
7887,3417587765,3489962019,1672594397,1672596242,1845
7752,3421836608,3739106581,1672629523,1672632735,3212
7785,3249247700,3639847263,1672583602,1672584464,862
7809,3793436995,3516980378,1672540208,1672542072,1864
7932,3516960534,3356860407,1672539624,1672541501,1877
7913,3760598102,3922337974,1672562349,1672562585,236
7749,3227158514,3511163800,1672678630,1672680907,2277
7484,3383661227,3683766533,1672602705,1672604496,1791
7897,3365278081,3736229191,1672700250,1672703269,3019
7792,3517255726,3716258994,1672689944,1672690248,304
7926,3392121505,3837094550,1672671331,1672672739,1408
7944,3513164386,3755392666,1672532671,1672535744,3073
7845,3387674757,3774268456,1672577831,1672579779,1948
7559,3772053179,3232962003,1672649470,1672650420,950
7685,3206593906,3339907603,1672683066,1672686347,3281
7606,3489217083,3421127249,1672640207,1672641329,1122
7691,3826415738,3509634629,1672563647,1672566643,2996
7968,3703441914,3733891182,1672666692,1672667376,684
7753,3701065786,3666507626,1672580484,1672581638,1154
7891,3493507965,3223789409,1672663485,1672665712,2227
7687,3533927138,3439023335,1672575301,1672576955,1654
7787,3505859863,3851190615,1672589902,1672590226,324
7945,3931941795,3716258994,1672579061,1672579649,588
7624,3757161914,3757562897,1672574856,1672575899,1043
7833,3783509527,3792473331,1672612346,1672615789,3443
7555,3755392666,3510247121,1672702413,1672703343,930
7515,3710344260,3430074045,1672553988,1672554781,793
7931,3338703270,3918056059,1672622685,1672625142,2457
7700,3516223597,3338703270,1672696944,1672699750,2806
7946,3613683164,3387966152,1672605530,1672607693,2163
7842,3222448362,3629547065,1672538918,1672539019,101
7598,3664170666,3415443558,1672594355,1672597721,3366
7646,3770101921,3319752091,1672659170,1672661835,2665
7704,3760893269,3311324983,1672684171,1672684688,517
7846,3358871377,3505869747,1672545888,1672546251,363
7785,3451432842,3825229501,1672580832,1672583842,3010
7980,3288764520,3716197887,1672693317,1672696135,2818
7508,3857349323,3883085535,1672564143,1672567642,3499
7663,3221536550,3792768129,1672688933,1672690378,1445
7719,3319752091,3972364603,1672564201,1672565248,1047
7608,3278365525,3757151210,1672623980,1672626696,2716
7843,3805342762,3701995648,1672537415,1672538666,1251
7920,3975287541,3533810360,1672610388,1672610872,484
7595,3610348516,3346795719,1672590697,1672593777,3080
7940,3777477395,3505635228,1672563356,1672565688,2332
7612,3802367797,3774580701,1672653332,1672656152,2820
7699,3533242305,3418728074,1672581163,1672582429,1266
7499,3783206719,3833889105,1672544209,1672547785,3576
7512,3311845971,3714504419,1672669420,1672670246,826
7633,3512142794,3505638204,1672640412,1672641322,910
7557,3516065852,3668005723,1672676109,1672678617,2508
7513,3734496778,3791901535,1672637485,1672638034,549
7604,3509352754,3773465237,1672560288,1672561735,1447
7697,3760294205,3511350608,1672547636,1672549027,1391
7747,3516065852,3201324715,1672665689,1672667788,2099
7776,3778308417,3520888296,1672647217,1672650080,2863
7764,3976390453,3505904952,1672602280,1672604734,2454
7628,3882291183,3815508790,1672544452,1672546557,2105
7741,3791957752,3734496778,1672635671,1672638776,3105
7778,3772578994,3777806071,1672554330,1672555556,1226
7919,3202120784,3510969660,1672639600,1672642496,2896
7976,3715339701,3518932404,1672537842,1672539095,1253
7758,3666553782,3509630174,1672545468,1672546490,1022
7715,3417061462,3533371364,1672665795,1672669344,3549
7552,3887270940,3921211276,1672641260,1672642765,1505
7924,3399004969,3500374658,1672660034,1672660691,657
7564,3516514391,3417587765,1672621783,1672624149,2366
7616,3903009525,3715189301,1672583171,1672586696,3525
7785,3513080274,3613995936,1672607576,1672610506,2930
7866,3399535232,3234362962,1672593573,1672594437,864
7983,3496051529,3716258994,1672552142,1672555679,3537
7753,3509352754,3716273414,1672590643,1672592165,1522
7679,3276640712,3605726278,1672615946,1672618181,2235
7594,3792177074,3736786443,1672545984,1672549372,3388
7768,3776066388,3246596716,1672553975,1672555795,1820
7500,3533369198,3316222192,1672620800,1672623509,2709
7661,3772544062,3509604974,1672580231,1672580978,747
7538,3209383861,3399535232,1672637748,1672639274,1526
7756,3779218771,3500391167,1672542567,1672545307,2740
7975,3280615985,3914259449,1672567936,1672570723,2787
7789,3713370078,3793848402,1672571349,1672572768,1419
7814,3351554343,3481647420,1672624770,1672628281,3511
7969,3734828619,3778780511,1672594945,1672595898,953
7824,3209551760,3229058858,1672540374,1672543481,3107
7907,3920801189,3209383861,1672692182,1672692958,776
7584,3886298125,3783206719,1672577081,1672578295,1214
7826,3738502357,3489728806,1672571230,1672574812,3582
7867,3807987001,3778341199,1672547140,1672548682,1542
7953,3365614305,3701184889,1672673662,1672676973,3311
7532,3667680268,3446948848,1672585805,1672586901,1096
7881,3344364444,3516223597,1672599968,1672601710,1742
7859,3756027749,3851190615,1672685343,1672685840,497
7658,3776948966,3716258994,1672590024,1672593290,3266
7577,3703871468,3315583351,1672637795,1672640003,2208
7567,3792473331,3735319397,1672577784,1672578134,350
7521,3714474557,3858918246,1672595585,1672596047,462
7692,3755625324,3520030713,1672538765,1672541348,2583
7906,3624761861,3715981584,1672703428,1672704713,1285
7607,3668005723,3500199935,1672678633,1672681467,2834
7513,3853018906,3501198706,1672645522,1672646572,1050
7635,3629935998,3637008488,1672674067,1672674514,447
7664,3386707783,3467773920,1672687985,1672689859,1874
7941,3279721246,3311603601,1672572944,1672574294,1350
7848,3311439795,3780503655,1672563791,1672565510,1719
7829,3500177712,3339907603,1672611010,1672612445,1435
7633,3778980116,3713349754,1672582886,1672583976,1090
7652,3826415738,3772309150,1672539534,1672541861,2327
7964,3511687358,3701190899,1672585234,1672586686,1452
7657,3404384505,3885897503,1672547512,1672548400,888
7724,3501730685,3501184421,1672664600,1672667357,2757
7861,3779976989,3809059934,1672678636,1672679989,1353
7907,3313541986,3777776687,1672685659,1672688539,2880
7788,3737051610,3338367113,1672606352,1672608446,2094
7689,3809059934,3777936328,1672579714,1672582568,2854
7651,3311627628,3793871337,1672555519,1672557570,2051
7854,3510247121,3924549929,1672583856,1672583933,77
7524,3828624701,3333896808,1672607258,1672609432,2174
7647,3501606184,3701065786,1672619191,1672621952,2761
7907,3628819436,3617734118,1672695923,1672699508,3585
7951,3513080274,3715189301,1672584563,1672587034,2471
7854,3516011407,3756027749,1672681771,1672685057,3286
7726,3783245561,3770635361,1672613526,1672614672,1146
7536,3773978034,3852595551,1672586574,1672589891,3317
7811,3773950140,3467773920,1672673194,1672676551,3357
7546,3236102733,3516629436,1672594687,1672596259,1572
7749,3500578848,3770553384,1672557407,1672557538,131
7567,3370752401,3399535232,1672606498,1672606805,307
7779,3629547065,3776800213,1672647928,1672649343,1415
7500,3760509236,3520706195,1672701314,1672704560,3246
7886,3372883226,3379256399,1672629691,1672630083,392
7889,3776513891,3774066725,1672536984,1672540014,3030
7932,3891751546,3710344260,1672611737,1672612847,1110
7907,3774010081,3391915121,1672670806,1672673110,2304
7496,3500658339,3280599164,1672703693,1672704703,1010
7747,3617055293,3533270638,1672580077,1672581134,1057
7494,3511163800,3231056870,1672637672,1672639017,1345
7906,3621810464,3903009525,1672560047,1672561647,1600
7680,3271938399,3316222192,1672599673,1672602370,2697
7740,3401627165,3710569131,1672702806,1672703994,1188
7739,3883042241,3713644518,1672652835,1672654161,1326
7832,3391915121,3703789494,1672590427,1672591534,1107
7569,3714488548,3613995936,1672685803,1672686540,737
7632,3277939457,3924549929,1672607814,1672609667,1853
7761,3432665384,3235635976,1672656499,1672659908,3409
7603,3500578848,3298433163,1672680346,1672682976,2630
7588,3483164654,3783705817,1672651969,1672653369,1400
7914,3772359096,3421836608,1672698756,1672701581,2825
7658,3737079798,3244485293,1672557265,1672557540,275
7551,3773429448,3359239884,1672659051,1672661368,2317
7840,3792032359,3517459919,1672534157,1672535451,1294
7860,3438645253,3607748895,1672683129,1672686548,3419
7678,3774119563,3384951177,1672550827,1672552979,2152
7684,3914259449,3625274012,1672667809,1672669634,1825
7595,3783509527,3209048907,1672547332,1672547611,279
7727,3509630174,3819727225,1672637603,1672640037,2434
7941,3520629279,3201432789,1672650507,1672650660,153
7893,3303751772,3454042520,1672659899,1672660498,599
7698,3485375593,3714474557,1672703177,1672703493,316
7785,3229665776,3739106581,1672544460,1672546735,2275
7880,3666553782,3852595551,1672581181,1672583160,1979
7774,3883861463,3505477652,1672691714,1672691828,114
7823,3277939457,3666506258,1672544250,1672545879,1629
7703,3554917400,3365614305,1672688578,1672688769,191
7683,3238712269,3778549126,1672634986,1672637293,2307
7814,3273500349,3926700506,1672644478,1672647967,3489
7914,3703955926,3688418210,1672569451,1672569952,501
7492,3505362057,3772746272,1672547515,1672549796,2281
7904,3277939457,3235635976,1672670019,1672672112,2093
7900,3710067113,3427219654,1672696104,1672698392,2288
7873,3829764737,3319752091,1672654201,1672655579,1378
7594,3772714862,3238712269,1672576842,1672579773,2931
7883,3778266283,3703889596,1672677673,1672677930,257
7973,3520012395,3534010629,1672604280,1672607352,3072
7785,3311648200,3776338577,1672684853,1672686400,1547
7979,3922275620,3703889596,1672619788,1672621709,1921
7854,3501184421,3713268590,1672591782,1672593262,1480
7614,3899204805,3770553384,1672623412,1672625353,1941
7543,3791901535,3710112546,1672670708,1672672349,1641
7848,3736419952,3434642576,1672693505,1672696409,2904
7527,3399535232,3500805881,1672692307,1672695478,3171
7940,3703275621,3625274012,1672617422,1672620099,2677
7661,3777514571,3500803339,1672659138,1672659644,506
7738,3517509185,3501601840,1672533423,1672534629,1206
7911,3488244966,3477375368,1672544798,1672546448,1650
7705,3223968713,3280615985,1672633887,1672634041,154
7564,3855000166,3312664885,1672656215,1672657227,1012
7549,3817621391,3351008918,1672568144,1672569775,1631
7970,3383922351,3555214688,1672697519,1672700974,3455
7710,3511267139,3221536550,1672551117,1672553672,2555
7723,3485008994,3792032359,1672647034,1672647339,305
7722,3666507626,3634786711,1672536562,1672537309,747
7872,3777079686,3509773875,1672642198,1672643842,1644
7941,3476232529,3510244400,1672664563,1672665403,840
7969,3710098970,3412825109,1672613132,1672615455,2323
7937,3737079798,3777806071,1672697192,1672698452,1260
7483,3466229085,3780974443,1672547804,1672549959,2155
7941,3518669703,3387966152,1672638334,1672640847,2513
7738,3516980378,3666553782,1672585916,1672589142,3226
7519,3760294205,3291235378,1672617914,1672619093,1179
7679,3313541986,3703871468,1672631830,1672635189,3359
7645,3516011407,3399052055,1672623284,1672625597,2313
7490,3278365525,3534729133,1672547472,1672548049,577
7483,3465202715,3791553060,1672553172,1672556080,2908
7949,3910886626,3284832486,1672536557,1672538148,1591
7488,3420432297,3779218771,1672631902,1672634371,2469
7931,3534729133,3917278625,1672695443,1672697041,1598
7902,3772337814,3221536550,1672610075,1672611876,1801
7860,3505193212,3774501422,1672658151,1672660337,2186
7957,3518014636,3773429448,1672576822,1672579296,2474
7903,3800353779,3493507965,1672538188,1672538813,625
7840,3201848640,3533193862,1672668061,1672669194,1133
7982,3311324983,3500729955,1672566343,1672568907,2564
7973,3520165601,3312829208,1672643886,1672645674,1788
7862,3852595551,3459030804,1672557531,1672558390,859
7501,3780974443,3772544062,1672622637,1672622746,109
7934,3391261292,3912536808,1672628505,1672629273,768
7677,3377766165,3512166013,1672545392,1672548936,3544
7774,3427283336,3770447408,1672584854,1672587153,2299
7747,3228165483,3791115967,1672594018,1672596071,2053
7699,3311993075,3220716272,1672537973,1672540228,2255
7741,3516980378,3244389794,1672643029,1672644077,1048
7635,3668898102,3505638204,1672605071,1672606692,1621
7677,3505098372,3710067113,1672591564,1672592910,1346
7610,3715339701,3791115967,1672607981,1672611096,3115
7946,3737154119,3855000166,1672679102,1672680068,966
7763,3451432842,3774793839,1672571225,1672573642,2417
7621,3756453423,3792883665,1672572362,1672574272,1910
7809,3922275620,3776066388,1672640595,1672643432,2837
7536,3312829208,3891751546,1672645768,1672649292,3524
7489,3773950140,3362000049,1672643055,1672646146,3091
7540,3228165483,3780639480,1672692502,1672694032,1530
7896,3774501422,3774339795,1672570763,1672574043,3280
7950,3882291183,3703955926,1672655257,1672656505,1248
7871,3791602225,3813052709,1672691564,1672692752,1188
7653,3312829208,3505883609,1672654509,1672655205,696
7624,3780365428,3778266283,1672621701,1672625285,3584
7510,3415546117,3899371911,1672637880,1672640439,2559
7679,3756930948,3777806071,1672609883,1672612850,2967
7779,3755511676,3418728074,1672676939,1672679666,2727
7548,3311761694,3500805881,1672589179,1672590001,822
7967,3882291183,3519563836,1672541139,1672544724,3585
7537,3405494240,3618873142,1672601554,1672602730,1176
7512,3925402713,3429856982,1672610168,1672613443,3275
7496,3756462516,3277939457,1672562281,1672563724,1443
7522,3472130842,3793962300,1672675762,1672678748,2986
7899,3284639858,3902383721,1672654439,1672655037,598
7578,3713630656,3774005526,1672577120,1672579794,2674
7578,3736786443,3311761694,1672553231,1672554076,845
7685,3703718151,3311152102,1672686798,1672687377,579
7696,3513599775,3610348516,1672570412,1672572362,1950
7488,3774125065,3715981584,1672554677,1672555559,882
7498,3520719611,3701863557,1672702803,1672703737,934
7734,3396285984,3510857360,1672666068,1672667461,1393
7581,3361230905,3518260334,1672567044,1672569073,2029
7857,3666553782,3311152102,1672678176,1672680908,2732
7899,3484995752,3701498253,1672565378,1672568216,2838
7893,3428006164,3344364444,1672624603,1672625618,1015
7810,3206603608,3930797455,1672578781,1672581292,2511
7643,3319752091,3714197325,1672678883,1672679769,886
7501,3936227020,3311993075,1672690317,1672693751,3434
7947,3348261553,3621810464,1672590004,1672592080,2076
7737,3516223597,3613995936,1672547177,1672548625,1448
7735,3391261292,3936227020,1672666457,1672667990,1533
7647,3826415738,3793962300,1672606188,1672606516,328
7919,3222448362,3816853177,1672607305,1672608462,1157
7865,3401627165,3417970574,1672537291,1672540333,3042
7742,3910454786,3318166135,1672649085,1672649340,255
7530,3518360734,3703013906,1672569408,1672572107,2699
7734,3512166013,3346327502,1672659323,1672662256,2933
7945,3400804807,3514719601,1672534214,1672536566,2352
7754,3822654369,3807987001,1672694577,1672697675,3098
7879,3313564074,3711198793,1672638585,1672642084,3499
7746,3666507626,3710098970,1672549387,1672550557,1170
7655,3976633198,3417587765,1672614476,1672615167,691
7961,3235635976,3793848402,1672663041,1672663779,738
7631,3509907947,3390068992,1672655186,1672655298,112
7741,3933210486,3772309150,1672578529,1672579606,1077
7500,3311208440,3772309166,1672555976,1672556196,220
7724,3480687894,3855602893,1672587014,1672588592,1578
7722,3518014404,3512683609,1672700798,1672701950,1152
7704,3511271692,3777806071,1672598204,1672599671,1467
7584,3688683847,3755798867,1672676134,1672676827,693
7818,3505702787,3510937904,1672682962,1672684362,1400
7929,3978115672,3606812411,1672685340,1672687484,2144
7818,3925620998,3791901535,1672550988,1672553934,2946
7882,3793436995,3783705817,1672650723,1672653458,2735
7791,3713349754,3780365428,1672603076,1672605742,2666
7574,3510126867,3805342762,1672585392,1672587350,1958
7980,3755392666,3783239924,1672695270,1672696538,1268
7502,3427219654,3777455223,1672645888,1672648266,2378
7520,3922337974,3400918687,1672608697,1672611866,3169
7884,3438645253,3296471982,1672667567,1672669586,2019
7904,3224058172,3518669703,1672562397,1672565571,3174
7711,3783239924,3509453566,1672613488,1672616985,3497
7954,3359239884,3360993964,1672538460,1672539878,1418
7677,3791553060,3755436115,1672668215,1672670686,2471
7536,3302626661,3430074045,1672539019,1672541018,1999
7592,3731419510,3511359172,1672672061,1672672153,92
7609,3519428855,3514245078,1672556373,1672557122,749
7789,3377766165,3777776687,1672680741,1672681453,712
7808,3778266283,3756021689,1672658895,1672660198,1303
7918,3533626375,3777079686,1672607216,1672607976,760
7627,3500177712,3711370563,1672644092,1672644525,433
7743,3793871337,3517255726,1672602913,1672604413,1500
7680,3701184889,3417061462,1672537828,1672539973,2145
7695,3421836608,3823600322,1672685073,1672687338,2265
7634,3701984666,3737051610,1672592209,1672595561,3352
7740,3882997884,3280615985,1672537726,1672540187,2461
7917,3276993580,3556951786,1672594255,1672595643,1388
7858,3313541986,3832902928,1672702102,1672705359,3257
7736,3291227780,3911245524,1672615566,1672617385,1819
7903,3396285984,3517476351,1672609458,1672610102,644
7895,3805347939,3475396323,1672578248,1672579231,983
7621,3756528686,3501198706,1672650729,1672652662,1933
7907,3634786711,3827222533,1672653576,1672656901,3325
7632,3511350608,3756623396,1672625649,1672629119,3470
7597,3715339701,3804870229,1672656372,1672656555,183
7944,3311208440,3780828689,1672596807,1672599020,2213
7894,3827626797,3885670556,1672685825,1672686979,1154
7898,3496549058,3852391257,1672570034,1672571718,1684
7775,3922275416,3734737881,1672601980,1672602560,580
7625,3533810360,3399433690,1672668639,1672671770,3131
7484,3770553384,3807987001,1672701083,1672704344,3261
7949,3774050956,3976390453,1672582683,1672584050,1367
7756,3805347939,3459030804,1672625762,1672629352,3590
7896,3792768129,3791594391,1672701405,1672703816,2411
7736,3517509185,3881477378,1672579777,1672580431,654
7930,3515151980,3509933351,1672544076,1672545300,1224
7604,3813052709,3485375593,1672590235,1672593648,3413
7607,3505869747,3481647420,1672560488,1672563771,3283
7886,3475251781,3715339701,1672647537,1672650173,2636
7695,3307512479,3307097200,1672642009,1672642306,297
7500,3505530961,3505000737,1672696849,1672699851,3002
7644,3816853177,3683959482,1672654737,1672657586,2849
7672,3520719611,3715127362,1672574765,1672577004,2239
7775,3516016437,3235635976,1672565836,1672569433,3597
7717,3505135325,3511198618,1672572589,1672574159,1570
7523,3792032359,3552314511,1672550860,1672554118,3258
7581,3976390453,3501184421,1672568802,1672569166,364
7845,3534702203,3501486692,1672544174,1672545067,893
7810,3313541986,3346795719,1672702034,1672703002,968
7770,3715339701,3510969660,1672603740,1672606022,2282
7976,3510703546,3520888296,1672536171,1672536459,288
7902,3517077106,3783245561,1672639263,1672641707,2444
7581,3801089989,3516673015,1672623734,1672626753,3019
7765,3791334389,3220716272,1672560678,1672560869,191
7515,3617734118,3434642576,1672638129,1672641490,3361
7867,3356860407,3733891182,1672698080,1672700868,2788
7875,3806545488,3520183192,1672700487,1672703717,3230
7734,3715339701,3715492942,1672539231,1672539407,176
7876,3505203158,3487171044,1672679465,1672680230,765
7887,3505599848,3899204805,1672603733,1672604543,810
7787,3774501422,3248507722,1672649460,1672652854,3394
7721,3701498253,3930791338,1672553514,1672556299,2785
7512,3629935998,3534313900,1672634982,1672637423,2441
7914,3406784491,3606812411,1672656724,1672658267,1543
7579,3313564074,3518876135,1672568545,1672569366,821
7756,3359239884,3511435497,1672651362,1672651813,451
7747,3534702203,3512567240,1672598616,1672599423,807
7744,3360743849,3520376528,1672696146,1672699281,3135
7919,3314245084,3883042241,1672599149,1672602351,3202
7793,3339907603,3313564074,1672608744,1672610537,1793
7815,3392121505,3511332835,1672701031,1672702866,1835
7846,3516011407,3246596716,1672680361,1672683935,3574
7577,3223789409,3777477395,1672657105,1672659844,2739
7875,3500066230,3465202715,1672591635,1672594260,2625
7848,3482405588,3475795792,1672559984,1672563178,3194
7933,3400804807,3611150562,1672655642,1672657637,1995
7823,3339907603,3918584946,1672550117,1672553712,3595
7614,3755625324,3519700826,1672673732,1672674140,408
7742,3518876135,3855602893,1672655079,1672657432,2353
7608,3885670556,3610348516,1672599185,1672601862,2677
7955,3807987001,3277669002,1672566724,1672569769,3045
7781,3334033993,3624761861,1672700048,1672701548,1500
7980,3931941795,3222521619,1672619935,1672620880,945
7686,3791334389,3311603601,1672628854,1672632429,3575
7594,3760492950,3511841857,1672657095,1672657403,308
7498,3714821932,3285400528,1672670184,1672671285,1101
7721,3855602893,3311152102,1672562176,1672564177,2001
7815,3608633356,3793389510,1672643736,1672643915,179
7902,3780788622,3284832486,1672616111,1672618709,2598
7573,3311415018,3388286531,1672610987,1672612570,1583
7483,3882291183,3338703270,1672532791,1672533409,618
7822,3736229191,3301107849,1672617167,1672617838,671
7616,3770635361,3853018906,1672564710,1672567398,2688
7886,3783925755,3416427576,1672558962,1672561247,2285
7865,3780914982,3837094550,1672636325,1672639162,2837
7850,3336751428,3792883665,1672678985,1672681789,2804
7614,3370636709,3639847263,1672581204,1672583195,1991
7678,3783239924,3311203656,1672635592,1672638112,2520
7495,3496549058,3249791738,1672676161,1672677509,1348
7913,3313564074,3517255726,1672565184,1672565910,726
7674,3903307060,3637008488,1672589838,1672592572,2734
7598,3392121505,3931941795,1672637725,1672641300,3575
7707,3497901842,3496549058,1672664962,1672667830,2868
7878,3793470489,3520183192,1672545996,1672547266,1270
7976,3791901535,3792844210,1672599841,1672601573,1732
7812,3473562469,3497901842,1672703192,1672704956,1764
7738,3516258476,3518360734,1672594399,1672594858,459
7561,3229665776,3359910781,1672607079,1672607153,74
7814,3369998498,3244173074,1672668624,1672670840,2216
7686,3231056870,3791115967,1672694075,1672694162,87
7611,3760077057,3760183458,1672692543,1672692962,419
7881,3755798867,3777120536,1672623550,1672626391,2841
7784,3703275621,3713370078,1672703993,1672707223,3230
7494,3772746272,3606987130,1672685180,1672687567,2387
7642,3778308417,3701184889,1672583076,1672585359,2283
7714,3826633236,3345207877,1672553415,1672554168,753
7762,3685187183,3792789881,1672582732,1672584430,1698
7899,3882997884,3249401741,1672640414,1672640568,154
7608,3882291183,3858918246,1672555388,1672555848,460
7650,3384951177,3901877072,1672693137,1672696477,3340
7738,3533193862,3432665384,1672646107,1672646932,825
7637,3510771358,3556951786,1672614321,1672616447,2126
7530,3777079686,3359239884,1672603727,1672606542,2815
7871,3509933351,3701111745,1672596997,1672598684,1687
7852,3344019610,3509933351,1672667965,1672670329,2364
7572,3378092448,3516011407,1672633638,1672636796,3158
7850,3388372715,3311065516,1672697786,1672699252,1466
7938,3773814927,3359910781,1672610192,1672610368,176
7541,3206254161,3201848640,1672627019,1672629425,2406
7552,3510126867,3637008488,1672620791,1672624219,3428
7925,3209027249,3828365570,1672573720,1672574250,530
7751,3701534009,3389115045,1672666473,1672668419,1946
7551,3404384505,3839849341,1672531790,1672532689,899
7516,3777936328,3703275621,1672681677,1672684205,2528
7638,3505869747,3703955926,1672582926,1672583411,485
7919,3701274634,3783779671,1672695440,1672698229,2789
7678,3930791338,3715492942,1672609500,1672612091,2591
7703,3387966152,3770021824,1672652186,1672652251,65
7719,3493507965,3209048907,1672644526,1672646428,1902
7810,3731106822,3826760240,1672536997,1672539073,2076
7664,3520190170,3533927138,1672609703,1672611701,1998
7932,3515284591,3837094550,1672653708,1672654658,950
7515,3664517356,3777776687,1672565046,1672568334,3288
7768,3513599775,3249401741,1672671844,1672672629,785
7843,3512540951,3500487333,1672622605,1672625978,3373
7855,3231056870,3778549126,1672689170,1672691353,2183
7762,3813052709,3505477652,1672686121,1672687165,1044
7901,3209027249,3501927421,1672701623,1672702843,1220
7900,3481647420,3518791447,1672536732,1672538260,1528
7827,3432665384,3801089989,1672676375,1672679110,2735
7614,3774050956,3772758337,1672604727,1672606725,1998
7945,3811694763,3904775198,1672572524,1672575539,3015
7689,3365942576,3358871377,1672584875,1672585337,462
7940,3510937904,3511267139,1672610185,1672612251,2066
7739,3475258557,3756451663,1672541635,1672542456,821
7851,3791942683,3615046771,1672678828,1672680022,1194
7716,3505649239,3904775198,1672590671,1672592213,1542
7484,3819727225,3735733948,1672653162,1672656150,2988
7956,3777120536,3231056870,1672674093,1672676546,2453
7640,3911245524,3713644518,1672694476,1672694924,448
7484,3411618230,3783925755,1672586461,1672589707,3246
7508,3520206212,3412980697,1672597229,1672599592,2363
7872,3713894336,3829232696,1672679725,1672682675,2950
7760,3976633198,3505000737,1672544194,1672545550,1356
7927,3774010081,3734828619,1672584362,1672586061,1699
7653,3770763956,3899371911,1672642708,1672644519,1811
7580,3899371911,3475795792,1672549328,1672551282,1954
7508,3311274543,3418728074,1672551542,1672554819,3277
7803,3475251781,3365278081,1672689925,1672691884,1959
7594,3513956646,3780593036,1672572236,1672572644,408
7684,3713370078,3624761861,1672675794,1672676699,905
7880,3510703546,3710344260,1672602421,1672605705,3284
7575,3774127586,3359910781,1672655619,1672655889,270
7566,3465202715,3515151980,1672559330,1672560349,1019
7505,3978105277,3509453566,1672574307,1672576548,2241
7621,3318697153,3772758337,1672647400,1672650896,3496
7724,3472130842,3387966152,1672686849,1672686999,150
7608,3315583351,3505145247,1672545924,1672548928,3004
7597,3512837326,3485008994,1672702741,1672703369,628
7700,3685187183,3505859863,1672669373,1672670245,872
7913,3555214688,3513080274,1672581928,1672584237,2309
7770,3386707783,3715339701,1672600793,1672603321,2528
7755,3634995491,3756453423,1672592348,1672595439,3091
7492,3716488385,3976633198,1672678392,1672678887,495
7960,3972709319,3304056063,1672620976,1672621248,272
7643,3793086311,3443698222,1672617619,1672618199,580
7874,3792844210,3509634629,1672656498,1672657282,784
7774,3224716315,3792384220,1672576008,1672576439,431
7755,3776338577,3930797455,1672620684,1672621648,964
7672,3774520233,3937224533,1672619248,1672620089,841
7961,3760294205,3774268456,1672611735,1672612108,373
7557,3500803339,3714488548,1672603268,1672603418,150
7936,3512166013,3520756859,1672701204,1672704048,2844
7807,3227158514,3666553782,1672630384,1672631389,1005
7698,3533810360,3757447189,1672594203,1672594354,151
7600,3779976989,3883551721,1672685120,1672686094,974
7617,3291883916,3249401741,1672660283,1672662990,2707
7847,3344019610,3280615985,1672562790,1672564344,1554
7940,3407954858,3311648200,1672681685,1672683585,1900
7562,3715339701,3247815299,1672681556,1672683951,2395
7663,3534702203,3244485293,1672669819,1672671555,1736
7740,3484995752,3756930948,1672569172,1672572056,2884
7707,3881477378,3314245084,1672607310,1672608404,1094
7546,3716537575,3736229191,1672688686,1672689765,1079
7855,3505649239,3280964728,1672569159,1672572569,3410
7677,3882242815,3703718151,1672543405,1672545754,2349
7763,3501483568,3617734118,1672606676,1672608061,1385
7603,3835382117,3370752401,1672558983,1672560913,1930
7620,3756601594,3755042098,1672606377,1672607166,789
7888,3492478793,3516016437,1672534234,1672537277,3043
7940,3756930948,3880285638,1672640142,1672640246,104
7940,3909606423,3559110998,1672573852,1672575001,1149
7915,3517459919,3202120784,1672596378,1672597261,883
7797,3513080274,3835382117,1672573162,1672575515,2353
7751,3505203158,3349613093,1672658852,1672659072,220
7532,3757812939,3710098970,1672642975,1672643451,476
7618,3360993964,3512969370,1672610653,1672613285,2632
7675,3518876135,3370636709,1672669495,1672669882,387
7520,3555214688,3755042098,1672624456,1672627070,2614
7721,3494290908,3520751702,1672618936,1672622089,3153
7537,3783509527,3400918687,1672536957,1672537985,1028
7911,3555214688,3201432789,1672670801,1672671453,652
7551,3737154119,3399911573,1672628086,1672629982,1896
7877,3220716272,3756424865,1672577513,1672579126,1613
7610,3510380060,3778549126,1672612525,1672613520,995
7537,3711262377,3519428855,1672554443,1672556949,2506
7620,3772337814,3391915121,1672632763,1672632827,64
7691,3514987389,3926700506,1672584504,1672588031,3527
7906,3716165213,3512720680,1672559389,1672561965,2576
7888,3793286136,3331845324,1672687132,1672690148,3016
7679,3206254161,3386707783,1672648459,1672648713,254
7488,3388372715,3512969370,1672600558,1672601980,1422
7734,3889232789,3701498253,1672605823,1672606527,704
7982,3715189301,3509907947,1672681427,1672682980,1553
7772,3882997884,3607748895,1672650490,1672654028,3538
7531,3483949762,3235635976,1672693233,1672696026,2793
7595,3903307060,3396086535,1672685016,1672687984,2968
7775,3823600322,3637008488,1672571920,1672573892,1972
7781,3855424474,3406784491,1672695766,1672698900,3134
7679,3533810360,3533810360,1672539522,1672539785,263
7899,3294803686,3809059934,1672659134,1672660807,1673
7636,3505904952,3756930948,1672655197,1672658166,2969
7654,3756451663,3776066388,1672566079,1672569303,3224
7818,3774520233,3520719611,1672698942,1672701757,2815
7493,3511125626,3701863557,1672653673,1672654268,595
7798,3372883226,3514283243,1672578034,1672580455,2421
7771,3370752401,3774010081,1672684447,1672685905,1458
7513,3805347939,3716900301,1672636321,1672638469,2148
7632,3827626797,3629935998,1672662531,1672662920,389
7768,3837094550,3791942683,1672626902,1672630337,3435
7623,3978105277,3756966035,1672663984,1672666997,3013
7931,3773429448,3776066388,1672542513,1672542860,347
7754,3793470489,3407673904,1672543949,1672544663,714
7767,3220716272,3518876135,1672579326,1672580215,889
7946,3779740455,3880285638,1672658092,1672660531,2439
7945,3760598102,3416265063,1672678543,1672679724,1181
7694,3757246925,3446948848,1672543883,1672547401,3518
7630,3903009525,3307097200,1672617009,1672619541,2532
7924,3511125626,3757682496,1672635817,1672638419,2602
7623,3291227780,3432665384,1672608063,1672608784,721
7785,3777983879,3202120784,1672676380,1672679716,3336
7577,3509907947,3483949762,1672625342,1672626456,1114
7544,3512217942,3774050956,1672703769,1672704256,487
7903,3978115672,3710569131,1672689749,1672691922,2173
7647,3778266283,3346795719,1672561791,1672561989,198
7764,3485375593,3311324983,1672586837,1672588737,1900
7924,3384240055,3533280269,1672601596,1672603943,2347
7687,3453729665,3396285984,1672569562,1672572677,3115
7881,3701274634,3715974031,1672601850,1672603595,1745
7774,3246596716,3760569731,1672682645,1672682856,211
7802,3804870229,3505219850,1672554798,1672555593,795
7829,3926700506,3615046771,1672599076,1672600322,1246
7565,3428964059,3511841857,1672630983,1672632725,1742
7643,3760267716,3505000737,1672697128,1672697467,339
7788,3760598102,3520719611,1672589354,1672589710,356
7592,3909331423,3512837326,1672611420,1672611797,377
7535,3505203158,3501198706,1672630163,1672632734,2571
7522,3429856982,3379256399,1672586253,1672587712,1459
7728,3490191091,3485823740,1672664915,1672667433,2518
7736,3505912939,3513599775,1672610915,1672612847,1932
7962,3889750851,3516716179,1672644691,1672647154,2463
7832,3512837326,3770078063,1672551329,1672552810,1481
7787,3496051529,3511267139,1672569493,1672569731,238
7770,3791657947,3774520233,1672648169,1672649391,1222
7919,3512683609,3791602225,1672649011,1672650849,1838
7916,3809484172,3710408395,1672564137,1672566420,2283
7750,3913251733,3783126683,1672616834,1672617999,1165
7929,3809484172,3465202715,1672632998,1672633625,627
7520,3385763781,3792668962,1672577379,1672579454,2075
7891,3519428855,3402943525,1672687294,1672687402,108
7741,3466229085,3517864478,1672694026,1672695944,1918
7931,3738502357,3774339795,1672618627,1672621241,2614
7813,3344019610,3206254161,1672584119,1672584849,730
7969,3714821932,3209551760,1672608041,1672609814,1773
7591,3826415738,3809916577,1672643906,1672644871,965
7634,3466911760,3500066230,1672617809,1672620963,3154
7708,3459030804,3497901842,1672538358,1672541816,3458
7972,3392121505,3201848640,1672594357,1672597398,3041
7676,3777790718,3701984666,1672645082,1672648298,3216
7567,3682061100,3517509185,1672592001,1672594673,2672
7675,3500578848,3399535232,1672696795,1672698964,2169
7554,3505347134,3501198706,1672635785,1672636051,266
7547,3331845324,3805292782,1672688831,1672691562,2731
7649,3311761694,3407725581,1672633015,1672634663,1648
7596,3247428249,3791957752,1672576165,1672577916,1751
7857,3505873261,3209048907,1672586828,1672589593,2765
7755,3809059934,3756930948,1672682793,1672685554,2761
7864,3412980697,3510969660,1672567326,1672570884,3558
7903,3701898991,3922275620,1672624840,1672625321,481
7725,3552314511,3432665384,1672646859,1672648701,1842
7857,3516629436,3465254146,1672652914,1672654858,1944
7508,3715127362,3387966152,1672661884,1672664872,2988
7830,3600647945,3818255890,1672638278,1672639121,843
7582,3755943611,3388372715,1672603373,1672605284,1911
7667,3757812939,3505201246,1672611866,1672612259,393
7601,3351008918,3500499542,1672641801,1672643071,1270
7507,3303751772,3829232696,1672642478,1672644125,1647
7636,3792032359,3713969578,1672536687,1672537466,779
7501,3901877072,3244436890,1672550326,1672553181,2855
7723,3500499542,3338703270,1672591247,1672592070,823
7741,3817316561,3618873142,1672674265,1672676389,2124
7916,3859663348,3792668962,1672660430,1672661099,669
7982,3303705369,3520719611,1672555750,1672557509,1759
7504,3783126683,3772359096,1672661997,1672663106,1109
7741,3792384220,3607748895,1672565794,1672566982,1188
7855,3909331423,3703889596,1672557492,1672559202,1710
7960,3505219850,3515394721,1672609902,1672612178,2276
7495,3311845971,3520376528,1672620289,1672623223,2934
7925,3611150562,3610348516,1672606047,1672609248,3201
7705,3792384220,3613995936,1672666723,1672668235,1512
7949,3223968713,3349613093,1672669276,1672671454,2178
7938,3232962003,3520030713,1672578381,1672580766,2385
7744,3515151980,3783705817,1672657324,1672658153,829
7764,3662180254,3501759100,1672675778,1672675968,190
7514,3736790081,3314836094,1672699633,1672701477,1844
7848,3755436115,3826760240,1672687937,1672690666,2729
7683,3778341199,3439023335,1672559152,1672560878,1726
7832,3909331423,3516909237,1672637477,1672639454,1977
7799,3904775198,3246596716,1672644838,1672647249,2411
7854,3304625412,3224058172,1672575712,1672578973,3261
7918,3891751546,3518014636,1672610432,1672610663,231
7643,3716900301,3883312122,1672639425,1672641980,2555
7872,3222448362,3715339701,1672583120,1672585350,2230
7573,3791657947,3533810360,1672573137,1672575052,1915
7509,3685187183,3904408902,1672587904,1672589618,1714
7649,3760489031,3515125508,1672673656,1672675123,1467
7700,3513599775,3880310724,1672608988,1672611255,2267
7880,3733891182,3416241005,1672590791,1672594390,3599
7688,3443698222,3509933351,1672572184,1672574282,2098
7491,3851190615,3346327502,1672666974,1672667947,973
7681,3606186086,3757812939,1672559870,1672563321,3451
7489,3513080274,3793627961,1672643906,1672646056,2150
7605,3756021689,3778305740,1672576582,1672579922,3340
7743,3201432789,3668898102,1672636090,1672636786,696
7968,3922275620,3624761861,1672576821,1672578416,1595
7764,3232962003,3703275621,1672676756,1672678944,2188
7676,3510771358,3776513891,1672665667,1672665951,284
7766,3777514571,3500578848,1672660218,1672662469,2251
7973,3475396323,3774066725,1672674571,1672676344,1773
7850,3554917400,3757151210,1672600488,1672602307,1819
7888,3293695955,3760077057,1672670633,1672671306,673
7913,3755625324,3311603601,1672570590,1672571749,1159
7677,3922275620,3291227780,1672589257,1672589602,345
7539,3399433690,3517963492,1672564903,1672565899,996
7781,3384951177,3501692334,1672579650,1672581073,1423
7612,3307512479,3617055293,1672667665,1672668155,490
7772,3505098372,3634995491,1672676642,1672678806,2164
7796,3394539273,3471220483,1672534446,1672536253,1807
7527,3666507626,3289061738,1672647071,1672650494,3423
7754,3760267716,3392121505,1672589498,1672591606,2108
7867,3883551721,3465254146,1672602826,1672602966,140
7666,3792473331,3792768129,1672598585,1672600209,1624
7651,3501955238,3236102733,1672614492,1672615125,633
7843,3756021689,3668005723,1672562584,1672565199,2615
7894,3772578994,3500894271,1672534616,1672535366,750
7838,3716900301,3516039895,1672647997,1672650001,2004
7938,3505362057,3556951786,1672609317,1672612317,3000
7600,3515151980,3755943611,1672669684,1672672794,3110
7757,3710408395,3667680268,1672682538,1672685410,2872
7825,3396285984,3298288268,1672592937,1672594194,1257
7502,3882997884,3792384220,1672607729,1672611211,3482
7905,3428674539,3852391257,1672538153,1672538956,803
7659,3793470489,3757403279,1672569702,1672571883,2181
7958,3783779671,3770101921,1672595978,1672597573,1595
7637,3336751428,3972364603,1672661585,1672662617,1032
7613,3301107849,3925402713,1672606760,1672608297,1537
7651,3520709480,3500199935,1672590578,1672591330,752
7654,3777806071,3534191820,1672532841,1672535347,2506
7836,3783705817,3714488548,1672540412,1672541097,685
7488,3481647420,3809059934,1672668427,1672669542,1115
7485,3613683164,3512720680,1672697028,1672697774,746
7602,3711370563,3332072298,1672658118,1672661457,3339
7697,3703789494,3701967560,1672627508,1672629072,1564
7676,3406784491,3801089989,1672540980,1672541604,624
7795,3311761694,3617055293,1672537387,1672539990,2603
7587,3780813786,3734737881,1672576395,1672578495,2100
7977,3520756859,3898995675,1672552601,1672556132,3531
7651,3480687894,3533242305,1672619378,1672620027,649
7903,3383661227,3249247700,1672532717,1672533356,639
7744,3772053179,3760267716,1672566300,1672569302,3002
7939,3277669002,3774050956,1672606009,1672609176,3167
7693,3284832486,3918584946,1672637570,1672640114,2544
7833,3774005526,3311718847,1672658657,1672660923,2266
7577,3489962019,3772544062,1672628681,1672628975,294
7845,3517459919,3370752401,1672654293,1672656924,2631
7489,3772642849,3760183458,1672599194,1672600638,1444
7739,3714504419,3890149705,1672597580,1672600655,3075
7562,3937224533,3556951786,1672612404,1672612855,451
7693,3417970574,3220716272,1672675667,1672676564,897
7731,3490191091,3472130842,1672647366,1672650467,3101
7493,3976390453,3713644518,1672590606,1672591373,767
7696,3800886801,3736625083,1672664067,1672666672,2605
7721,3924549929,3791594391,1672571879,1672573957,2078
7574,3311718847,3505193212,1672666041,1672668129,2088
7767,3383922351,3397418363,1672578740,1672579708,968
7765,3519703355,3512969370,1672568398,1672570280,1882
7659,3364543015,3793848402,1672691837,1672695166,3329
7726,3294803686,3783239924,1672697373,1672699676,2303
7897,3517509185,3489545239,1672580693,1672583827,3134
7648,3229058858,3485823740,1672599797,1672601993,2196
7742,3311761694,3930797455,1672638185,1672640528,2343
7702,3832902928,3792844210,1672658574,1672661291,2717
7757,3517077106,3402943525,1672634776,1672635235,459
7548,3311415018,3518669703,1672684956,1672687612,2656
7715,3487171044,3774268456,1672620880,1672624243,3363
7845,3223968713,3492478793,1672702540,1672705429,2889
7590,3533653428,3383661227,1672700965,1672701738,773
7889,3734737881,3311603601,1672692476,1672692837,361
7537,3277669002,3379589402,1672605027,1672607442,2415
7873,3634786711,3533369198,1672623858,1672626354,2496
7872,3223968713,3519152550,1672566281,1672569451,3170
7798,3417061462,3778780511,1672665357,1672668064,2707
7839,3511350608,3520706195,1672644935,1672645431,496
7750,3314836094,3302626661,1672641050,1672643519,2469
7510,3701190899,3634995491,1672546915,1672549975,3060
7772,3818255890,3774466457,1672673418,1672675558,2140
7896,3779036831,3939952128,1672664117,1672664659,542
7630,3510126867,3738274418,1672688212,1672691235,3023
7762,3312333615,3909606423,1672675171,1672677514,2343
7514,3703889596,3882997884,1672582442,1672584021,1579
7667,3978115672,3755392666,1672555963,1672557178,1215
7585,3800886801,3918056059,1672561115,1672562375,1260
7854,3365614305,3409474775,1672702886,1672705844,2958
7811,3730517636,3607178184,1672571656,1672573606,1950
7728,3889750851,3792883665,1672597194,1672599079,1885
7750,3518260334,3516629436,1672652974,1672656544,3570
7643,3516016437,3818255890,1672584776,1672586224,1448
7950,3302626661,3471220483,1672669761,1672672568,2807
7640,3346327502,3855424474,1672667353,1672668169,816
7644,3736592744,3713630656,1672695898,1672696835,937
7976,3458539365,3715339701,1672611604,1672613003,1399
7672,3424922204,3500487333,1672588934,1672590083,1149
7744,3755920131,3883085535,1672693481,1672696040,2559
7533,3627937312,3606987130,1672598973,1672601780,2807
7660,3827626797,3378092448,1672555988,1672559359,3371
7683,3298433163,3512217942,1672545956,1672547868,1912
7564,3412825109,3332072298,1672589103,1672590680,1577
7592,3880285638,3516011407,1672582650,1672584728,2078
7585,3370636709,3703013906,1672682469,1672683973,1504
7795,3238712269,3390068992,1672580165,1672581947,1782
7966,3492478793,3400918687,1672640952,1672642515,1563
7950,3501184421,3777623166,1672620489,1672620988,499
7856,3760294205,3760569731,1672691683,1672692487,804
7608,3516673015,3780788622,1672677914,1672679046,1132
7882,3480687894,3520730271,1672579181,1672581718,2537
7710,3828432634,3777806071,1672572051,1672575601,3550
7913,3337544549,3703955926,1672636670,1672638043,1373
7847,3311203656,3716900301,1672539349,1672540825,1476
7549,3420700674,3757151210,1672585116,1672586434,1318
7859,3533626375,3236102733,1672597761,1672600175,2414
7960,3222448362,3756424865,1672700482,1672703145,2663
7514,3516258476,3485823740,1672653214,1672653713,499
7530,3627937312,3828432634,1672634202,1672635113,911
7842,3610348516,3234541252,1672647717,1672650687,2970
7948,3497901842,3481647420,1672555297,1672556329,1032
7719,3489962019,3793962300,1672687863,1672691339,3476
7529,3937224533,3476232529,1672646864,1672649537,2673
7836,3514987389,3518014404,1672605135,1672607811,2676
7638,3480687894,3451432842,1672634191,1672636825,2634
7663,3713370078,3296471982,1672574969,1672575183,214
7861,3716258994,3390068992,1672658617,1672659346,729
7840,3813052709,3903009525,1672538287,1672539591,1304
7966,3500578848,3837094550,1672594566,1672598154,3588
7814,3925620998,3757151210,1672583833,1672584251,418
7808,3829232696,3516465662,1672664078,1672664542,464
7591,3713894336,3484995752,1672663435,1672666326,2891
7735,3774195321,3627937312,1672688526,1672690742,2216
7558,3311324983,3777790718,1672569944,1672572032,2088
7660,3496051529,3755872268,1672627481,1672629475,1994
7942,3608633356,3714488548,1672686838,1672688218,1380
7497,3533653428,3476232529,1672581764,1672582632,868
7729,3711569060,3713208927,1672633596,1672635339,1743
7951,3716843669,3533369198,1672687619,1672690859,3240
7708,3520206212,3533025282,1672663216,1672663875,659
7711,3516011407,3388637594,1672653112,1672655861,2749
7867,3823600322,3555214688,1672663046,1672663185,139
7762,3514128943,3930797455,1672571883,1672573657,1774
7548,3818255890,3509630174,1672577906,1672579070,1164
7940,3664517356,3755920131,1672653488,1672653968,480
7940,3515860749,3505135325,1672642009,1672642817,808
7837,3774204963,3288764520,1672606385,1672607280,895
7760,3493507965,3737051610,1672553400,1672556895,3495
7834,3755739653,3510247121,1672541620,1672544075,2455
7610,3701274634,3780974443,1672690351,1672690844,493
7650,3501483568,3489728806,1672641351,1672643323,1972
7922,3388286531,3770078063,1672618823,1672620654,1831
7952,3773205565,3688683847,1672638380,1672638937,557
7579,3244389794,3534488837,1672542696,1672542976,280
7818,3505203158,3885670556,1672581722,1672581782,60
7621,3778108318,3291227780,1672636782,1672638535,1753
7589,3774501422,3227457126,1672644342,1672645069,727
7892,3228165483,3421127249,1672664326,1672665409,1083
7726,3550946908,3601879040,1672672558,1672673869,1311
7675,3519703355,3501198706,1672703789,1672705618,1829
7653,3511125626,3518496488,1672596199,1672599308,3109
7838,3777443199,3391915121,1672545916,1672546243,327
7648,3621810464,3809484172,1672666311,1672669379,3068
7760,3417587765,3914259449,1672608401,1672610628,2227
7488,3888559320,3362000049,1672563942,1672567110,3168
7947,3512567240,3415546117,1672561046,1672562710,1664
7872,3533270638,3711380716,1672675744,1672679090,3346
7792,3351008918,3516223597,1672614818,1672615660,842
7690,3505702787,3800353779,1672625631,1672625968,337
7762,3534424200,3733189298,1672640215,1672643391,3176
7678,3636867411,3501184421,1672565763,1672568079,2316
7927,3829319703,3882242815,1672640712,1672643516,2804
7547,3249247700,3378092448,1672558965,1672561422,2457
7486,3280964728,3777806071,1672654338,1672655092,754
7660,3294803686,3407673904,1672652890,1672656471,3581
7508,3348261553,3624312512,1672610985,1672612667,1682
7745,3555214688,3922275416,1672566228,1672567068,840
7764,3220716272,3505649239,1672586802,1672589039,2237
7916,3501730685,3475258557,1672676195,1672677770,1575
7753,3772309166,3517255726,1672622936,1672625986,3050
7807,3778341199,3334033993,1672626033,1672627556,1523
7971,3517864478,3477649378,1672646221,1672649736,3515
7592,3313564074,3621810464,1672543726,1672546895,3169
7640,3489728806,3359239884,1672605467,1672605703,236
7631,3778266283,3297463265,1672585530,1672587016,1486
7702,3533810360,3418728074,1672653835,1672655495,1660
7890,3883042241,3710344260,1672557629,1672561040,3411
7636,3791334389,3774366875,1672637326,1672640552,3226
7837,3501364586,3505135325,1672625637,1672626705,1068
7729,3667680268,3772544062,1672534353,1672535139,786
7756,3451432842,3311415018,1672579821,1672581129,1308
7659,3519700826,3772642849,1672693304,1672695558,2254
7936,3513454145,3432689543,1672641939,1672645142,3203
7983,3701995648,3236102733,1672673166,1672674200,1034
7938,3234541252,3774119563,1672667677,1672669909,2232
7771,3883042241,3379256399,1672556005,1672559180,3175
7664,3518163778,3389115045,1672651831,1672651951,120
7496,3772309166,3501364586,1672692024,1672692827,803
7671,3777983879,3518669703,1672536943,1672537038,95
7581,3978105277,3822654369,1672629555,1672631890,2335
7588,3370636709,3770635361,1672540675,1672543947,3272
7768,3735733948,3516629436,1672692061,1672694787,2726
7518,3976390453,3416265063,1672701117,1672702803,1686
7909,3429690204,3783509527,1672543671,1672547100,3429
7489,3912262917,3516673015,1672597251,1672599273,2022
7780,3509933351,3246596716,1672653273,1672654623,1350
7574,3277669002,3378686918,1672652309,1672653350,1041
7677,3701184889,3316222192,1672669018,1672669254,236
7847,3783779671,3778305740,1672572289,1672573064,775
7805,3701863557,3668005723,1672580012,1672581953,1941
7816,3206254161,3244389794,1672620622,1672623788,3166
7797,3358871377,3505873261,1672606811,1672607554,743
7675,3520629279,3770021824,1672582396,1672583990,1594
7621,3313564074,3714504419,1672681700,1672685215,3515
7689,3307512479,3209027249,1672582265,1672585469,3204
7598,3200691026,3518360734,1672564407,1672564979,572
7640,3430352815,3360993964,1672583753,1672587250,3497
7611,3386707783,3430352815,1672534633,1672537930,3297
7567,3793338102,3713644518,1672688820,1672690598,1778
7697,3608633356,3271938399,1672567303,1672569833,2530
7788,3909331423,3614238812,1672623549,1672624041,492
7872,3817621391,3777929708,1672626957,1672629749,2792
7584,3505193212,3520629279,1672597286,1672598847,1561
7923,3760489031,3910886626,1672619718,1672621893,2175
7830,3617055293,3505973226,1672623427,1672625361,1934
7570,3715127362,3505599848,1672550565,1672552506,1941
7751,3311203656,3778266283,1672531228,1672532817,1589
7802,3976633198,3703441914,1672596792,1672598297,1505
7846,3519654779,3930791338,1672646575,1672648535,1960
7951,3909331423,3883312122,1672702715,1672704747,2032
7532,3826415738,3922275620,1672644848,1672646210,1362
7555,3533095755,3774580701,1672641710,1672643020,1310
7825,3605726278,3407954858,1672674030,1672677339,3309
7639,3917088658,3777717988,1672571801,1672574302,2501
7528,3713630656,3337544549,1672676636,1672677194,558
7744,3618873142,3516629436,1672649253,1672651359,2106
7522,3779218771,3407673904,1672627732,1672627886,154
7700,3510771358,3780593036,1672607820,1672609450,1630
7531,3516039895,3516011407,1672546472,1672549845,3373
7495,3925402713,3634340855,1672644813,1672647464,2651
7952,3407673904,3415546117,1672651575,1672655168,3593
7947,3937224533,3380035798,1672690644,1672692865,2221
7970,3235635976,3773978034,1672656396,1672656503,107
7962,3394330287,3909331423,1672689114,1672692440,3326
7556,3496549058,3829764737,1672600409,1672601857,1448
7675,3776948966,3510857360,1672604107,1672606919,2812
7589,3664517356,3467773920,1672549887,1672552617,2730
7750,3774127586,3791901535,1672576224,1672577613,1389
7823,3519556068,3792253549,1672623763,1672625092,1329
7924,3311648200,3779740455,1672554640,1672555200,560
7790,3809484172,3220716272,1672658252,1672658601,349
7613,3501759100,3416427576,1672676925,1672678385,1460
7722,3774580701,3713808837,1672572690,1672573971,1281
7667,3517476351,3500904641,1672636498,1672639639,3141
7528,3556951786,3229665776,1672658352,1672661314,2962
7854,3311152102,3509672210,1672667041,1672667201,160
7813,3432665384,3517963492,1672694892,1672697697,2805
7635,3485823740,3420432297,1672577160,1672579361,2201
7761,3533827120,3482405588,1672675820,1672677500,1680
7756,3774466457,3201324715,1672587169,1672587688,519
7919,3244173074,3973560347,1672625862,1672628718,2856
7515,3666553782,3294803686,1672681371,1672684804,3433
7736,3774066725,3606186086,1672698374,1672700647,2273
7670,3713349754,3500658339,1672620373,1672622786,2413
7806,3351554343,3511125626,1672557738,1672558361,623
7892,3777455223,3490191091,1672696766,1672700246,3480
7619,3703661585,3776800213,1672543976,1672546190,2214
7538,3534488837,3518163778,1672557920,1672558790,870
7890,3882242815,3791334389,1672595794,1672597592,1798
7830,3760509236,3737154119,1672564566,1672567628,3062
7560,3925402713,3518791447,1672602754,1672603958,1204
7946,3780503655,3793436995,1672540515,1672541702,1187
7547,3777120536,3791901535,1672551188,1672553241,2053
7628,3901877072,3809916577,1672623030,1672625895,2865
7667,3505791599,3777623166,1672532074,1672532906,832
7841,3778108318,3518360734,1672604498,1672606935,2437
7488,3316222192,3516223597,1672638745,1672641491,2746
7552,3776800213,3534488837,1672695452,1672698390,2938
7853,3465254146,3735319397,1672645699,1672646392,693
7515,3378686918,3736592744,1672691720,1672692588,868
7724,3293695955,3515125508,1672629319,1672629629,310
7569,3518163778,3828624701,1672701062,1672704045,2983
7811,3505193212,3756930948,1672624923,1672628190,3267
7528,3311761694,3520190170,1672594930,1672597402,2472
7651,3915628728,3201324715,1672692855,1672694559,1704
7801,3242408357,3933210486,1672537751,1672540778,3027
7564,3509634629,3512969370,1672543800,1672546012,2212
7723,3777929708,3903307060,1672560792,1672562736,1944
7668,3511163800,3519428855,1672701635,1672703327,1692
7687,3500066230,3904775198,1672653007,1672653821,814
7888,3311152102,3774520233,1672695419,1672698333,2914
7637,3296471982,3222448362,1672598167,1672600636,2469
7503,3244485293,3710112546,1672640612,1672641774,1162
7895,3634786711,3770021824,1672552092,1672552833,741
7823,3331845324,3713644518,1672691008,1672693258,2250
7704,3755625324,3716165213,1672578692,1672578839,147
7581,3716165213,3774501422,1672700014,1672700228,214
7533,3519703355,3514719601,1672569391,1672569529,138
7734,3774580701,3809059934,1672691260,1672692362,1102
7898,3516016437,3473765852,1672679397,1672681085,1688
7488,3915628728,3346327502,1672578920,1672582064,3144
7709,3859663348,3485375593,1672653253,1672653950,697
7921,3701995648,3512969370,1672622474,1672624699,2225
7951,3505135325,3922275416,1672545802,1672549353,3551
7628,3667680268,3755920131,1672659468,1672662097,2629
7796,3736625083,3826759140,1672552813,1672554629,1816
7746,3244485293,3534553510,1672699333,1672700454,1121
7604,3517077106,3922275416,1672608445,1672610893,2448
7826,3315583351,3367029997,1672539946,1672541036,1090
7597,3883861463,3793338102,1672642205,1672643999,1794
7484,3777079686,3505883609,1672586706,1672588412,1706
7520,3483949762,3711370563,1672655600,1672657614,2014
7830,3826760240,3500199935,1672606249,1672609736,3487
7650,3511267139,3458539365,1672553692,1672554610,918
7909,3783196518,3777443199,1672549078,1672552495,3417
7721,3914259449,3613683164,1672642113,1672642799,686
7913,3517864478,3466229085,1672589986,1672591707,1721
7889,3734828619,3914259449,1672699714,1672701195,1481
7641,3777120536,3399433690,1672589787,1672591296,1509
7557,3293695955,3492478793,1672670135,1672672852,2717
7885,3534553510,3733189298,1672689612,1672690164,552
7869,3311439795,3617055293,1672650906,1672653633,2727
7679,3976633198,3221536550,1672673160,1672674582,1422
7531,3278365525,3505649239,1672638105,1672639281,1176
7979,3852595551,3229665776,1672626535,1672629659,3124
7826,3776948966,3372883226,1672546436,1672548840,2404
7802,3500803339,3301107849,1672591502,1672592221,719
7592,3513956646,3362000049,1672634099,1672637202,3103
7733,3313541986,3395152943,1672543420,1672544209,789
7898,3829764737,3494290908,1672647952,1672650672,2720
7670,3807987001,3839849341,1672532472,1672534513,2041
7671,3390068992,3925620998,1672615591,1672617364,1773
7854,3836573197,3703735129,1672568939,1672569394,455
7858,3533748232,3351554343,1672602149,1672604360,2211
7632,3388637594,3453729665,1672586402,1672587137,735
7512,3736625083,3416265063,1672594718,1672596834,2116
7509,3519152550,3660493209,1672583961,1672587472,3511
7848,3520719611,3716835696,1672542549,1672545830,3281
7948,3500805881,3280599164,1672644516,1672647291,2775
7574,3885897503,3605726278,1672602028,1672604546,2518
7878,3515125508,3627937312,1672632179,1672634912,2733
7661,3760509236,3288764520,1672573973,1672576271,2298
7925,3473562469,3808324264,1672547228,1672548066,838
7515,3760992710,3834257412,1672616500,1672618287,1787
7759,3497901842,3472130842,1672702985,1672704803,1818
7525,3291235378,3608868877,1672567060,1672568429,1369
7791,3509907947,3351554343,1672606619,1672609964,3345
7607,3703223015,3550946908,1672630900,1672633243,2343
7668,3501955238,3362000049,1672637078,1672639858,2780
7767,3249247700,3776948966,1672575094,1672576290,1196
7920,3857349323,3311152102,1672629076,1672629875,799
7542,3249791738,3500177712,1672537259,1672539214,1955
7593,3518876135,3791602225,1672560007,1672562064,2057
7610,3772544062,3360743849,1672620453,1672623737,3284
7636,3925402713,3518014636,1672624425,1672627320,2895
7912,3511841857,3774298222,1672565547,1672567146,1599
7739,3489545239,3920801189,1672629520,1672631422,1902
7737,3519601612,3778980116,1672544000,1672545886,1886
7884,3501927421,3780828689,1672703934,1672705090,1156
7787,3925402713,3779036831,1672560174,1672561088,914
7771,3755392666,3489545239,1672547047,1672548964,1917
7679,3519654779,3288764520,1672697314,1672700097,2783
7522,3475251781,3666457294,1672550764,1672553513,2749
7867,3394539273,3618873142,1672608005,1672609765,1760
7831,3316173088,3501364586,1672676588,1672676923,335
7793,3280964728,3515860749,1672680947,1672683439,2492
7948,3774339795,3336751428,1672678370,1672681622,3252
7630,3778549126,3428964059,1672666666,1672667052,386
7644,3776800213,3774005526,1672697746,1672699265,1519
7822,3520709480,3770447408,1672559578,1672560720,1142
7716,3780639480,3629547065,1672674809,1672675689,880
7863,3311648200,3313541986,1672551827,1672555066,3239
7546,3511125626,3755511676,1672665643,1672666648,1005
7672,3424922204,3501184421,1672627448,1672629607,2159
7669,3714474557,3776066388,1672535496,1672535935,439
7665,3703871468,3935627557,1672552688,1672556274,3586
7982,3249791738,3234362962,1672619208,1672620471,1263
7920,3890149705,3978105277,1672581952,1672584100,2148
7693,3774466457,3701534009,1672569016,1672572605,3589
7486,3791997875,3914290246,1672629560,1672630086,526
7737,3716488385,3500803339,1672601923,1672603974,2051
7618,3756021689,3918584946,1672635807,1672639205,3398
7707,3421836608,3505791599,1672662864,1672663462,598
7515,3770635361,3515394721,1672638336,1672641013,2677
7574,3222521619,3505135325,1672611094,1672611817,723
7543,3701995648,3783429780,1672592516,1672596035,3519
7794,3770078063,3629935998,1672615778,1672619244,3466
7980,3615046771,3244173074,1672657800,1672658278,478
7536,3825229501,3515394721,1672562759,1672563255,496
7722,3755943611,3760569731,1672659479,1672659746,267
7489,3805292782,3662180254,1672665468,1672666703,1235
7690,3889232789,3446948848,1672693051,1672696531,3480
7793,3760267716,3511271692,1672684792,1672684987,195
7740,3505702787,3517963492,1672604016,1672605667,1651
7710,3777790718,3466911760,1672572087,1672572802,715
7966,3760992710,3311439795,1672554628,1672557910,3282
7582,3826760240,3311154569,1672621453,1672621964,511
7572,3428964059,3713370078,1672633763,1672636399,2636
7730,3501601840,3710408395,1672636202,1672637438,1236
7640,3801089989,3710344260,1672631170,1672634676,3506
7843,3912262917,3683766533,1672665911,1672669310,3399
7886,3514719601,3509604974,1672569958,1672573454,3496
7778,3500229033,3391915886,1672592872,1672594710,1838
7645,3760992710,3291883916,1672637116,1672637962,846
7732,3852595551,3509672210,1672648308,1672651247,2939
7684,3822654369,3200198928,1672538473,1672539634,1161
7657,3516258476,3820354437,1672628404,1672629454,1050
7613,3533810360,3783239924,1672665326,1672667494,2168
7753,3511163800,3703735129,1672566902,1672567462,560
7964,3817621391,3289061738,1672684417,1672686798,2381
7504,3516980378,3505904952,1672556165,1672557873,1708
7715,3492478793,3311324983,1672613840,1672615706,1866
7909,3774501422,3774580701,1672598420,1672600562,2142
7581,3478194807,3733891182,1672648168,1672651687,3519
7706,3882291183,3222448362,1672625239,1672625839,600
7686,3829319703,3235635976,1672561315,1672563746,2431
7912,3792473331,3839849341,1672701304,1672704191,2887
7803,3500365158,3246596716,1672646223,1672648299,2076
7642,3511271692,3505973226,1672651787,1672652007,220
7603,3774119563,3855937514,1672574634,1672574750,116
7964,3779528381,3890149705,1672587396,1672590821,3425
7962,3701691675,3779218771,1672594042,1672596818,2776
7659,3834257412,3311324983,1672583457,1672584668,1211
7641,3736625083,3509630174,1672584287,1672585942,1655
7696,3757246925,3852595551,1672592991,1672593489,498
7732,3519428855,3314836094,1672605095,1672606305,1210
7495,3703871468,3475251781,1672608915,1672609741,826
7847,3379256399,3280615985,1672545987,1672546359,372
7700,3904775198,3501184421,1672645066,1672648125,3059
7975,3311439795,3970117174,1672644831,1672647615,2784
7836,3533626375,3209027249,1672703468,1672706422,2954
7615,3517255726,3615046771,1672687905,1672690539,2634
7914,3481502100,3477375368,1672656167,1672657873,1706
7556,3772359096,3360993964,1672572627,1672573669,1042
7915,3818255890,3715127362,1672547655,1672548105,450
7836,3711265369,3509604974,1672541767,1672544277,2510
7760,3777790718,3608633356,1672638843,1672639343,500
7831,3736786443,3683766533,1672646269,1672647060,791
7616,3624312512,3916289176,1672652401,1672653802,1401
7548,3314245084,3715974031,1672538160,1672538493,333
7839,3505883609,3365942576,1672693356,1672693823,467
7545,3792768129,3312664885,1672619664,1672620350,686
7923,3318166135,3823600322,1672551408,1672554767,3359
7803,3378436155,3533748232,1672672395,1672674500,2105
7673,3979339287,3279721246,1672630690,1672631080,390
7954,3511332835,3235287260,1672581111,1672581207,96
7601,3773429448,3617055293,1672679979,1672682336,2357
7907,3505145247,3734496778,1672616880,1672617174,294
7723,3399004969,3311627628,1672624581,1672626636,2055
7768,3500229033,3755587522,1672627429,1672630803,3374
7676,3828624701,3820354437,1672612183,1672613165,982
7679,3505912939,3683766533,1672617389,1672618243,854
7949,3338367113,3828432634,1672682693,1672685510,2817
7734,3370636709,3925620998,1672624450,1672627279,2829
7621,3232962003,3209551760,1672536984,1672539494,2510
7554,3510711755,3427283336,1672622915,1672624648,1733
7947,3351554343,3483949762,1672542130,1672542301,171
7859,3701967560,3519803045,1672675327,1672677538,2211
7867,3855602893,3889750851,1672563265,1672564330,1065
7584,3505362057,3615046771,1672554513,1672557579,3066
7776,3605726278,3735319397,1672559463,1672561685,2222
7643,3793286136,3337544549,1672653127,1672654421,1294
7631,3791115967,3604539807,1672636939,1672638827,1888
7960,3711569060,3774501422,1672571161,1672572574,1413
7831,3899266183,3916289176,1672674768,1672675222,454
7602,3298433163,3757455053,1672660608,1672661961,1353
7583,3976633198,3357483218,1672657940,1672658156,216
7619,3792473331,3737079798,1672545935,1672549153,3218
7809,3855424474,3779218771,1672621250,1672623808,2558
7553,3682061100,3889232789,1672627894,1672629254,1360
7832,3757161914,3519556068,1672549581,1672549782,201
7841,3777776687,3939952128,1672682478,1672685546,3068
7889,3627937312,3313541986,1672659823,1672661150,1327
7493,3312664885,3505477652,1672691400,1672692648,1248
7762,3880310724,3888559320,1672645666,1672648400,2734
7842,3760183458,3311203656,1672610006,1672613097,3091
7912,3793753089,3716273414,1672700051,1672701188,1137
7811,3332072298,3519700826,1672618337,1672618920,583
7664,3779036831,3416427576,1672658942,1672661751,2809
7890,3518791447,3365942576,1672682040,1672683913,1873
7643,3338367113,3489545239,1672531505,1672533353,1848
7535,3713268590,3496549058,1672562860,1672564233,1373
7824,3338703270,3774580701,1672535330,1672536182,852
7790,3887270940,3780813786,1672633914,1672635354,1440
7921,3912262917,3735733948,1672672839,1672674575,1736
7592,3703955926,3533242305,1672652176,1672654911,2735
7922,3505883609,3311439795,1672561526,1672563535,2009
7849,3701190899,3518669703,1672649973,1672652043,2070
7771,3829319703,3755625324,1672552632,1672553139,507
7919,3303705369,3783239924,1672556910,1672559237,2327
7828,3515284591,3312829208,1672538003,1672539654,1651
7509,3334033993,3222521619,1672591117,1672593354,2237
7517,3757151210,3443698222,1672673337,1672674324,987
7802,3891751546,3516960534,1672682616,1672686072,3456
7506,3888559320,3510937904,1672592718,1672594916,2198
7651,3383922351,3404384505,1672696617,1672699516,2899
7761,3364543015,3516039895,1672563472,1672564914,1442
7550,3606186086,3466229085,1672665547,1672666060,513
7611,3701863557,3489962019,1672575247,1672576502,1255
7972,3391915886,3511332835,1672559911,1672560090,179
7980,3342131135,3613683164,1672614117,1672615547,1430
7850,3791020967,3703275621,1672625408,1672627912,2504
7978,3822654369,3793753089,1672591080,1672592643,1563
7637,3357483218,3772309166,1672606718,1672608047,1329
7746,3734496778,3501692334,1672555970,1672556684,714
7563,3760077057,3930797455,1672644133,1672644240,107
7790,3279721246,3465254146,1672630226,1672630721,495
7507,3510247121,3791594391,1672605567,1672608053,2486
7815,3516039895,3783126683,1672600292,1672603282,2990
7907,3512567240,3780974443,1672622999,1672623496,497
7543,3634995491,3286658957,1672627865,1672629130,1265
7867,3826415738,3774050956,1672630840,1672633733,2893
7964,3772359096,3333896808,1672546402,1672549884,3482
7556,3515284591,3427219654,1672581274,1672581917,643
7601,3755881905,3386707783,1672654467,1672655068,601
7697,3683959482,3458539365,1672562763,1672564483,1720
7528,3489217083,3517255726,1672646866,1672650093,3227
7642,3855937514,3277939457,1672669076,1672670816,1740
7878,3209383861,3513454145,1672584923,1672586250,1327
7568,3855602893,3783245561,1672619057,1672619307,250
7848,3688683847,3770447408,1672534846,1672537198,2352
7937,3415443558,3280964728,1672582004,1672582280,276
7804,3505362057,3301107849,1672610150,1672612294,2144
7488,3512837326,3533270638,1672604854,1672605268,414
7774,3622054816,3664170666,1672600703,1672603156,2453
7839,3935627557,3509933351,1672601478,1672602874,1396
7847,3889750851,3518260334,1672559760,1672562939,3179
7601,3505638204,3713349754,1672634389,1672637837,3448
7546,3288764520,3755798867,1672581393,1672582830,1437
7830,3420700674,3777929708,1672683130,1672683968,838
7734,3516909237,3430352815,1672646621,1672650072,3451
7967,3511841857,3756528686,1672538878,1672540377,1499
7681,3505912939,3888559320,1672547321,1672548727,1406
7518,3716165213,3711265369,1672576767,1672579690,2923
7516,3776800213,3476232529,1672546125,1672548278,2153
7594,3774466457,3519069599,1672560900,1672562025,1125
7961,3222521619,3903307060,1672691946,1672692159,213
7521,3505000737,3783429780,1672583809,1672585285,1476
7967,3774010081,3901990690,1672540605,1672542841,2236
7694,3520931254,3774338212,1672696527,1672697469,942
7881,3319752091,3774556560,1672619181,1672619703,522
7852,3512567240,3247780536,1672669258,1672672135,2877
7560,3451432842,3514838220,1672655185,1672656635,1450
7869,3605726278,3428674539,1672676529,1672677847,1318
7587,3834257412,3711380716,1672571600,1672572222,622
7547,3234541252,3430074045,1672556153,1672557422,1269
7577,3756528686,3662180254,1672645383,1672648667,3284
7977,3792789881,3793959750,1672543212,1672545444,2232
7746,3418728074,3611150562,1672561703,1672564827,3124
7605,3509352754,3510857360,1672688971,1672691986,3015
7591,3825229501,3780639480,1672623755,1672627011,3256
7779,3509604974,3713894336,1672550194,1672551147,953
7940,3518260334,3280615985,1672626984,1672627203,219
7949,3780365428,3313541986,1672598667,1672601209,2542
7725,3510244400,3534424200,1672563514,1672565292,1778
7704,3778980116,3791942683,1672676660,1672676746,86
7519,3770553384,3200198928,1672658880,1672659478,598
7746,3816853177,3520756859,1672630274,1672632180,1906
7831,3311761694,3826759140,1672633681,1672634433,752
7901,3772758337,3426325549,1672694341,1672695016,675
7979,3701184889,3475396323,1672620561,1672622231,1670
7537,3703889596,3629547065,1672590181,1672592333,2152
7853,3755587522,3777623166,1672625872,1672629068,3196
7922,3515691540,3703275621,1672569743,1672571723,1980
7804,3780914982,3307512479,1672605866,1672608816,2950
7657,3505098372,3518014404,1672683535,1672686169,2634
7577,3472130842,3518876135,1672606704,1672609810,3106
7842,3755881905,3703223015,1672634239,1672637676,3437
7803,3773120434,3757246925,1672534758,1672537258,2500
7716,3505599848,3407673904,1672569036,1672570114,1078
7558,3701178711,3319752091,1672619034,1672621193,2159
7635,3365942576,3791874383,1672633627,1672636122,2495
7581,3978105277,3505912939,1672572655,1672575145,2490
7639,3627937312,3716258994,1672591201,1672591362,161
7738,3520888296,3714197325,1672644407,1672647585,3178
7757,3417587765,3604539807,1672633354,1672634479,1125
7542,3365614305,3516011407,1672632001,1672633901,1900
7806,3201848640,3344019610,1672549018,1672549591,573
7567,3791602225,3891751546,1672620995,1672622801,1806
7941,3899371911,3737051610,1672671756,1672673786,2030
7610,3714962248,3757602960,1672638500,1672640369,1869
7776,3520888296,3622054816,1672623399,1672625845,2446
7665,3774050956,3448855696,1672696827,1672697498,671
7908,3489962019,3501955238,1672618096,1672620430,2334
7557,3664517356,3773465237,1672677909,1672679304,1395
7496,3518014404,3924549929,1672614796,1672617570,2774
7505,3394539273,3311845971,1672573608,1672574939,1331
7636,3757246925,3772746272,1672702783,1672706302,3519
7938,3488244966,3715339701,1672594289,1672594663,374
7777,3519152550,3716488385,1672702250,1672702568,318
7680,3710408395,3496549058,1672603139,1672605155,2016
7960,3512969370,3516465662,1672677958,1672680780,2822
7964,3756451663,3500805881,1672665035,1672667282,2247
7836,3311761694,3899371911,1672661014,1672662132,1118
7870,3515125508,3829319703,1672594109,1672595505,1396
7850,3518360734,3345207877,1672563104,1672565137,2033
7816,3505869747,3515151980,1672620364,1672620833,469
7792,3500365158,3757403279,1672645693,1672646163,470
7571,3716900301,3411618230,1672584820,1672588310,3490
7762,3713644518,3889750851,1672572845,1672573317,472
7605,3511267139,3736625083,1672613036,1672613607,571
7926,3605726278,3792844210,1672607013,1672608287,1274
7587,3505883609,3857349323,1672650082,1672650215,133
7873,3714197325,3311274543,1672628902,1672632340,3438
7561,3703223015,3271938399,1672609649,1672610727,1078
7631,3247428249,3914290246,1672664677,1672664951,274
7882,3774010081,3242408357,1672655825,1672658433,2608
7909,3883861463,3755511676,1672605610,1672608822,3212
7557,3512683609,3800353779,1672532007,1672533472,1465
7969,3248507722,3206254161,1672603750,1672606105,2355
7656,3244436890,3925402713,1672636060,1672638289,2229
7646,3756021689,3770553384,1672696849,1672697051,202
7662,3360743849,3772642849,1672611416,1672612322,906
7532,3415443558,3901990690,1672569331,1672570834,1503
7966,3276640712,3791957752,1672602577,1672605900,3323
7888,3512540951,3400804807,1672563945,1672566237,2292
7609,3221536550,3716835696,1672566981,1672570062,3081
7716,3311274543,3316173088,1672642382,1672644257,1875
7971,3520719611,3439023335,1672672978,1672675718,2740
7909,3714504419,3931941795,1672579797,1672582121,2324
7657,3901990690,3809916577,1672654980,1672658369,3389
7882,3517476351,3500805881,1672687566,1672688253,687
7743,3519556068,3886298125,1672677015,1672680577,3562
7671,3453729665,3238712269,1672697612,1672698910,1298
7707,3783925755,3793871337,1672696460,1672699696,3236
7784,3777514571,3773950140,1672625077,1672625365,288
7980,3228165483,3244485293,1672702627,1672704969,2342
7511,3608633356,3904775198,1672629277,1672632399,3122
7901,3481502100,3829319703,1672619207,1672619397,190
7717,3935127663,3895562476,1672576710,1672579814,3104
7917,3238712269,3773814927,1672670488,1672673925,3437
7739,3791997875,3634340855,1672566924,1672567264,340
7873,3311627628,3232962003,1672542951,1672543926,975
7587,3311603601,3756424865,1672582375,1672584209,1834
7606,3208844525,3533927138,1672533015,1672533476,461
7595,3373384732,3716537575,1672538350,1672540197,1847
7690,3311993075,3505219850,1672636841,1672639802,2961
7696,3501730685,3809059934,1672663699,1672667149,3450
7495,3637008488,3311439795,1672686265,1672688936,2671
7718,3757455053,3777455223,1672637355,1672637528,173
7661,3777806071,3607748895,1672667968,1672669511,1543
7903,3859663348,3715581279,1672636033,1672639377,3344
7632,3533385867,3792253549,1672677090,1672677277,187
7610,3880285638,3311065516,1672697912,1672701008,3096
7569,3756027749,3510937904,1672700391,1672701719,1328
7502,3512969370,3500177712,1672578988,1672579062,74
7912,3783245561,3206603608,1672639347,1672641029,1682
7664,3417970574,3407954858,1672671149,1672671477,328
7902,3914290246,3518360734,1672701475,1672704377,2902
7685,3511350608,3731106822,1672628526,1672629596,1070
7951,3516606733,3779976989,1672680722,1672681214,492
7926,3244485293,3533385867,1672597821,1672598999,1178
7916,3367029997,3777983879,1672564691,1672566776,2085
7923,3756462516,3206603608,1672589994,1672593027,3033
7566,3800886801,3500904641,1672562805,1672566098,3293
7587,3533748232,3514838220,1672584545,1672584738,193
7961,3760294205,3411618230,1672546938,1672550443,3505
7931,3793962300,3716165213,1672691440,1672694664,3224
7856,3520888296,3779528381,1672549627,1672550865,1238
7914,3387674757,3534424200,1672536486,1672539053,2567
7883,3918674986,3383922351,1672533787,1672535712,1925
7931,3357483218,3701111745,1672609983,1672611077,1094
7585,3311274543,3519152550,1672597660,1672598659,999
7654,3777443199,3904775198,1672602567,1672605712,3145
7529,3278365525,3200691026,1672642640,1672644834,2194
7874,3834257412,3515723720,1672642657,1672645456,2799
7557,3510380060,3533371364,1672563036,1672564590,1554
7762,3346327502,3500177712,1672570514,1672572085,1571
7617,3780294829,3920801189,1672673586,1672675981,2395
7691,3701898991,3772746272,1672596842,1672598629,1787
7958,3500374658,3465254146,1672611537,1672612376,839
7558,3500904641,3792668962,1672615496,1672617435,1939
7688,3780593036,3890149705,1672630397,1672632111,1714
7528,3489962019,3383661227,1672666754,1672669906,3152
7874,3533137446,3246596716,1672550156,1672553166,3010
7727,3316173088,3793871337,1672598993,1672601534,2541
7977,3533626375,3808324264,1672591931,1672593979,2048
7750,3346795719,3516011407,1672627226,1672628173,947
7559,3701898991,3774204963,1672595038,1672595801,763
7734,3229665776,3296471982,1672548453,1672549495,1042
7513,3973560347,3338367113,1672624502,1672628094,3592
7616,3387674757,3501730685,1672556460,1672559256,2796
7773,3783429780,3710408395,1672540703,1672543938,3235
7900,3288764520,3978105277,1672625406,1672625743,337
7580,3348261553,3518876135,1672610537,1672611869,1332
7893,3606987130,3276993580,1672601510,1672604685,3175
7494,3701274634,3533369198,1672661692,1672664139,2447
7631,3778980116,3634786711,1672681994,1672685039,3045
7591,3703789494,3497901842,1672538263,1672539194,931
7563,3760569731,3273500349,1672691820,1672692451,631
7546,3511267139,3505173328,1672688238,1672689117,879
7763,3774005526,3715581279,1672667644,1672669448,1804
7856,3881477378,3333896808,1672691550,1672693932,2382
7638,3534191820,3774119563,1672642421,1672642683,262
7567,3229665776,3756424865,1672632029,1672633652,1623
7740,3505873261,3516629436,1672571316,1672571510,194
7743,3235287260,3501184421,1672639707,1672642288,2581
7752,3703223015,3626156564,1672571812,1672572352,540
7761,3505098372,3516465662,1672630782,1672631029,247
7698,3737154119,3738274418,1672593406,1672594921,1515
7900,3701184889,3772053179,1672574256,1672577284,3028
7981,3520030713,3778266283,1672700702,1672701849,1147
7907,3776338577,3713786889,1672598762,1672602338,3576
7906,3505362057,3511687358,1672541821,1672543106,1285
7861,3307512479,3701184889,1672598286,1672598599,313
7972,3800353779,3485375593,1672688652,1672689488,836
7559,3402943525,3511267139,1672585062,1672587069,2007
7871,3534424200,3774045700,1672681336,1672684900,3564
7525,3852391257,3221536550,1672606375,1672608132,1757
7940,3756966035,3736229191,1672670103,1672670287,184
7789,3278365525,3483949762,1672642729,1672643757,1028
7613,3610695419,3611150562,1672535483,1672537397,1914
7913,3734828619,3774119563,1672583939,1672587330,3391
7758,3809916577,3918056059,1672685536,1672686492,956
7813,3757151210,3774268456,1672691274,1672694229,2955
7789,3513454145,3890149705,1672562200,1672564009,1809
7937,3518932404,3294803686,1672535181,1672538525,3344
7643,3201848640,3774298222,1672676583,1672677359,776
7644,3426325549,3710408395,1672531233,1672532174,941
7752,3501483568,3345207877,1672564459,1672564968,509
7557,3501198706,3510173870,1672690914,1672693274,2360
7701,3737154119,3277605882,1672641105,1672642934,1829
7611,3533385867,3223789409,1672610540,1672613600,3060
7585,3516223597,3636867411,1672683333,1672683686,353
7808,3783509527,3778108318,1672621092,1672624058,2966
7758,3715189301,3827222533,1672547901,1672549063,1162
7868,3487171044,3362000049,1672595698,1672596960,1262
7483,3304056063,3885897503,1672701417,1672701809,392
7965,3500487333,3430504438,1672638070,1672638296,226
7694,3485375593,3244436890,1672668887,1672671572,2685
7946,3713894336,3475396323,1672651700,1672651930,230
7569,3739106581,3296471982,1672659278,1672660084,806
7726,3610695419,3793286136,1672550646,1672550745,99
7791,3487171044,3770101921,1672649727,1672653219,3492
7548,3825229501,3520931254,1672545112,1672547066,1954
7690,3220716272,3276993580,1672698704,1672702235,3531
7959,3976390453,3533137446,1672685396,1672688467,3071
7573,3780365428,3331845324,1672702628,1672705657,3029
7767,3513201436,3772309150,1672539303,1672542455,3152
7760,3519654779,3802367797,1672597144,1672597510,366
7498,3510703546,3634340855,1672578179,1672580808,2629
7768,3511198618,3975287541,1672599617,1672599847,230
7891,3760569731,3899371911,1672577709,1672579596,1887
7733,3760492950,3534553510,1672568949,1672569609,660
7669,3756424865,3533371364,1672574590,1672577557,2967
7569,3608633356,3917278625,1672644507,1672647572,3065
7978,3311274543,3534729133,1672690368,1672691154,786
7973,3837094550,3228165483,1672597613,1672598514,901
7847,3404384505,3277939457,1672638203,1672638916,713
7813,3400918687,3703789494,1672646127,1672648803,2676
7857,3421836608,3613995936,1672544206,1672544856,650
7872,3711308224,3817621391,1672545663,1672547811,2148
7516,3823600322,3801089989,1672587307,1672588871,1564
7637,3760509236,3826415738,1672570861,1672571466,605
7867,3800353779,3520190170,1672573691,1672575915,2224
7838,3901990690,3812176780,1672677053,1672679056,2003
7868,3805347939,3534488837,1672547986,1672550798,2812
7569,3792902982,3827377568,1672622217,1672624273,2056
7544,3511271692,3533193862,1672572108,1672573049,941
7737,3514838220,3512166013,1672685910,1672686008,98
7619,3420432297,3293695955,1672623321,1672623455,134
7812,3333896808,3338367113,1672618471,1672620116,1645
7948,3236102733,3505219850,1672604583,1672604864,281
7970,3777079686,3732481297,1672621421,1672624569,3148
7753,3509630174,3516258476,1672600023,1672600942,919
7726,3610348516,3715127362,1672615570,1672619152,3582
7557,3399433690,3220716272,1672656888,1672658281,1393
7810,3972364603,3505477652,1672596613,1672597149,536
7566,3605726278,3222521619,1672570740,1672573315,2575
7869,3294803686,3298288268,1672563811,1672564351,540
7575,3703441914,3791553060,1672640589,1672641349,760
7520,3339907603,3667680268,1672640148,1672641488,1340
7568,3624761861,3703871468,1672649538,1672651530,1992
7833,3388286531,3610348516,1672633587,1672636035,2448
7574,3757403279,3886298125,1672558800,1672559061,261
7791,3505912939,3703013906,1672565546,1672567147,1601
7766,3979339287,3533827120,1672546612,1672547598,986
7815,3505347134,3519601612,1672629004,1672629214,210
7745,3516223597,3755392666,1672575335,1672578752,3417
7493,3475396323,3319752091,1672567421,1672569386,1965
7541,3517509185,3388286531,1672550970,1672554190,3220
7781,3313564074,3793086311,1672647642,1672648419,777
7935,3779036831,3276640712,1672674762,1672675484,722
7665,3420432297,3284832486,1672568131,1672570111,1980
7532,3755042098,3501198706,1672590937,1672593574,2637
7770,3500391167,3770447408,1672662315,1672665487,3172
7574,3760489031,3793470489,1672599363,1672601331,1968
7487,3772884106,3510173870,1672577069,1672579844,2775
7580,3703275621,3710569131,1672602290,1672605303,3013
7599,3519428855,3735733948,1672531992,1672533038,1046
7940,3505201246,3280964728,1672575688,1672576471,783
7540,3883042241,3500729955,1672623459,1672623977,518
7963,3513454145,3515691540,1672687081,1672687993,912
7878,3311208440,3505362057,1672561654,1672564028,2374
7649,3405494240,3297463265,1672566423,1672568854,2431
7834,3505791599,3713349754,1672605626,1672606252,626
7799,3793286136,3901877072,1672663779,1672664887,1108
7948,3777717988,3736592744,1672653865,1672656959,3094
7850,3511687358,3400918687,1672578073,1672579718,1645
7591,3779218771,3902278226,1672685641,1672685772,131
7665,3773598056,3793286136,1672655382,1672656799,1417
7583,3278365525,3417970574,1672548787,1672551806,3019
7700,3792473331,3505883609,1672673393,1672673734,341
7553,3394539273,3311154569,1672565150,1672567935,2785
7881,3779629905,3805342762,1672635759,1672638458,2699
7806,3311993075,3760561634,1672675686,1672678865,3179
7485,3520629279,3533927138,1672565449,1672568665,3216
7591,3301107849,3510244400,1672627314,1672629547,2233
7702,3311603601,3624761861,1672532857,1672533378,521
7557,3280599164,3666553782,1672630589,1672633199,2610
7751,3248507722,3611150562,1672685029,1672685818,789
7640,3770021824,3683959482,1672603199,1672605458,2259
7818,3627937312,3760561634,1672608291,1672608705,414
7678,3618045231,3286658957,1672696107,1672697316,1209
7756,3520719611,3760561634,1672574103,1672574661,558
7487,3811694763,3277669002,1672563770,1672566660,2890
7772,3770763956,3351008918,1672703599,1672704070,471
7656,3520888296,3618045231,1672668571,1672668814,243
7583,3533827120,3774298222,1672531682,1672534742,3060
7918,3713894336,3346327502,1672575108,1672576337,1229
7542,3783531004,3757246925,1672635180,1672635770,590
7752,3334033993,3755436115,1672537737,1672538065,328
7798,3912262917,3533810360,1672677711,1672680895,3184
7547,3909606423,3898995675,1672699769,1672700328,559
7618,3485823740,3417970574,1672598498,1672600269,1771
7815,3349613093,3201432789,1672587442,1672590135,2693
7574,3756528686,3662180254,1672636893,1672639399,2506
7605,3770078063,3777983879,1672598682,1672600624,1942
7654,3559110998,3406784491,1672630600,1672632002,1402
7832,3505973226,3760267716,1672686266,1672687783,1517
7597,3500229033,3777477395,1672618401,1672620506,2105
7899,3501601840,3637008488,1672702973,1672704115,1142
7507,3473562469,3332072298,1672641560,1672643190,1630
7540,3793753089,3772544062,1672676312,1672679513,3201
7484,3859525941,3443698222,1672567018,1672567713,695
7588,3505638204,3473765852,1672572152,1672572270,118
7749,3475251781,3417061462,1672561597,1672565003,3406
7959,3666457294,3777120536,1672568011,1672570425,2414
7497,3716168623,3443698222,1672586128,1672589257,3129
7552,3780365428,3926700506,1672583765,1672585184,1419
7883,3756021689,3520629279,1672610578,1672614000,3422
7962,3510771358,3711370563,1672664723,1672664807,84
7662,3736419952,3501364586,1672615614,1672619052,3438
7927,3621497531,3857349323,1672643236,1672645146,1910
7845,3755436115,3284639858,1672677673,1672679220,1547
7893,3779036831,3760893269,1672680912,1672682499,1587
7921,3494290908,3737154119,1672633193,1672635144,1951
7965,3880285638,3780365428,1672669317,1672669903,586
7486,3426325549,3755872268,1672563317,1672565216,1899
7913,3779218771,3336751428,1672647639,1672649066,1427
7682,3520629279,3703789494,1672592500,1672593992,1492
7508,3791957752,3600647945,1672587866,1672588378,512
7858,3911159965,3715127362,1672638570,1672638844,274
7513,3791957752,3716197887,1672614611,1672615500,889
7683,3517963492,3664170666,1672564412,1672565265,853
7538,3922275416,3613995936,1672659535,1672660925,1390
7752,3774501422,3813052709,1672636887,1672639332,2445
7770,3776338577,3404384505,1672574136,1672576804,2668
7791,3316173088,3492478793,1672606703,1672607141,438
7709,3512510536,3518496488,1672642410,1672642502,92
7516,3618045231,3489962019,1672660959,1672663643,2684
7546,3505193212,3770101921,1672566154,1672568712,2558
7542,3271938399,3505912939,1672657115,1672659751,2636
7935,3201432789,3773755137,1672543176,1672543885,709
7832,3713630656,3399911573,1672691281,1672693694,2413
7802,3365614305,3701146057,1672581443,1672584424,2981
7781,3334033993,3513201436,1672677687,1672679370,1683
7712,3430352815,3518496488,1672634950,1672635500,550
7934,3737079798,3489545239,1672700725,1672702868,2143
7615,3514719601,3500177712,1672653717,1672656925,3208
7753,3882997884,3556951786,1672670003,1672671144,1141
7954,3392121505,3857349323,1672687140,1672688174,1034
7483,3453729665,3223789409,1672566237,1672569507,3270
7723,3484995752,3885670556,1672685238,1672686747,1509
7742,3703955926,3756021689,1672578969,1672580143,1174
7681,3774339795,3772714862,1672658403,1672660211,1808
7779,3533280269,3826633236,1672543153,1672543334,181
7701,3792844210,3703718151,1672535478,1672535611,133
7626,3298433163,3496549058,1672700309,1672702705,2396
7821,3518014636,3756623396,1672657634,1672659450,1816
7746,3616944364,3501692334,1672671976,1672674101,2125
7498,3509933351,3289061738,1672642794,1672646123,3329
7512,3805519285,3792473331,1672556139,1672557102,963
7824,3337544549,3224058172,1672627750,1672628741,991
7892,3223789409,3512683609,1672547399,1672548810,1411
7633,3976633198,3391261292,1672608132,1672611098,2966
7859,3385763781,3360993964,1672590621,1672592886,2265
7798,3755739653,3511350608,1672699017,1672700961,1944
7655,3509907947,3779740455,1672539652,1672540407,755
7888,3379589402,3336751428,1672627544,1672628306,762
7641,3534492426,3238712269,1672643497,1672644265,768
7624,3512969370,3774066725,1672562899,1672564367,1468
7586,3485375593,3779528381,1672534618,1672537470,2852
7884,3756424865,3820354437,1672618095,1672620133,2038
7742,3774045700,3206254161,1672562405,1672564404,1999
7976,3247780536,3774045700,1672606981,1672609579,2598
7648,3832902928,3519563836,1672582610,1672583840,1230
7642,3505904952,3511350608,1672656191,1672657255,1064
7737,3701498253,3780914982,1672633109,1672635824,2715
7815,3427219654,3774339795,1672618034,1672620418,2384
7556,3815508790,3510857360,1672683740,1672683995,255
7497,3500458761,3513080274,1672654959,1672658168,3209
7874,3534488837,3777936328,1672674722,1672677211,2489
7979,3501184421,3357483218,1672576071,1672576435,364
7935,3483164654,3231056870,1672552965,1672554039,1074
7770,3519601612,3756623396,1672600786,1672602324,1538
7701,3911159965,3505962865,1672694514,1672696669,2155
7553,3519428855,3783206719,1672567588,1672569823,2235
7537,3313541986,3509672210,1672544181,1672546830,2649
7567,3520030713,3378436155,1672673419,1672674467,1048
7664,3770824086,3286658957,1672553183,1672553735,552
7611,3760183458,3773465237,1672565932,1672568774,2842
7559,3497901842,3400918687,1672676069,1672678075,2006
7768,3882997884,3467773920,1672558917,1672559226,309
7594,3815508790,3505347134,1672648565,1672649650,1085
7808,3791115967,3883042241,1672562146,1672564795,2649
7956,3500487333,3383922351,1672536704,1672537485,781
7677,3772758337,3757246925,1672546237,1672549752,3515
7755,3488244966,3755798867,1672667035,1672668096,1061
7822,3509634629,3231056870,1672573825,1672577412,3587
7779,3780914982,3760992710,1672590048,1672592118,2070
7839,3397418363,3404058699,1672633010,1672633285,275
7640,3710112546,3338703270,1672587354,1672588258,904
7943,3510857360,3302626661,1672556294,1672556484,190
7878,3793753089,3430074045,1672619139,1672619561,422
7679,3783083229,3770851318,1672621876,1672624309,2433
7711,3903009525,3613683164,1672568662,1672568857,195
7667,3511687358,3791553060,1672684769,1672686157,1388
7651,3622054816,3407673904,1672638033,1672641319,3286
7749,3800353779,3232962003,1672567236,1672569800,2564
7769,3756601594,3925620998,1672699683,1672700054,371
7904,3666506258,3365942576,1672628070,1672630121,2051
7639,3634995491,3855602893,1672632872,1672634672,1800
7982,3451432842,3834257412,1672534085,1672534196,111
7499,3534553510,3773950140,1672617091,1672618299,1208
7488,3760509236,3500904641,1672555155,1672557354,2199
7660,3791115967,3793848402,1672615189,1672617511,2322
7521,3711380716,3618045231,1672663524,1672663691,167
7969,3778266283,3825229501,1672541646,1672545029,3383
7706,3489545239,3362000049,1672610765,1672611031,266
7852,3307512479,3397418363,1672673497,1672676841,3344
7576,3392121505,3791334389,1672650379,1672653629,3250
7507,3224716315,3418728074,1672645855,1672649287,3432
7563,3899371911,3791020967,1672621595,1672622072,477
7619,3713786889,3509933351,1672686585,1672688089,1504
7745,3365942576,3446948848,1672647617,1672649385,1768
7653,3365942576,3232962003,1672605080,1672606772,1692
7525,3793436995,3246596716,1672677731,1672679682,1951
7959,3438645253,3221536550,1672614831,1672618314,3483
7822,3221536550,3731106822,1672656789,1672660191,3402
7920,3505702787,3554917400,1672567297,1672568165,868
7624,3755042098,3772309150,1672612043,1672612113,70
7732,3760294205,3426325549,1672538563,1672541149,2586
7798,3826759140,3774119563,1672608316,1672609227,911
7527,3280599164,3505859863,1672616764,1672617646,882
7931,3772884106,3817621391,1672677262,1672679526,2264
7800,3280599164,3793470489,1672535220,1672536405,1185
7528,3417061462,3345207877,1672546701,1672548541,1840
7965,3807987001,3791657947,1672691947,1672693509,1562
7518,3701498253,3716900301,1672575388,1672575560,172
7683,3520376528,3855000166,1672688520,1672689247,727
7902,3826633236,3637008488,1672629688,1672632153,2465
7926,3738274418,3383922351,1672610599,1672613088,2489
7572,3715492942,3244485293,1672663549,1672664295,746
7763,3224058172,3889750851,1672552083,1672552931,848
7658,3776800213,3773120434,1672652584,1672653274,690
7674,3703789494,3331845324,1672663081,1672666136,3055
7784,3755436115,3505098372,1672550577,1672553316,2739
7925,3887270940,3520706195,1672552144,1672553667,1523
7978,3903962771,3405494240,1672584894,1672585239,345
7928,3770101921,3500904641,1672632482,1672632883,401
7693,3518014636,3634340855,1672531900,1672532801,901
7712,3516258476,3520751702,1672590073,1672593662,3589
7784,3311603601,3713349754,1672548249,1672549823,1574
7497,3291235378,3791901535,1672673401,1672674301,900
7940,3734828619,3520719611,1672610808,1672613242,2434
7917,3501955238,3505702787,1672626640,1672627140,500
7614,3777790718,3898995675,1672651313,1672653259,1946
7890,3505912939,3756966035,1672558202,1672559332,1130
7817,3316173088,3501692334,1672569747,1672570467,720
7554,3554917400,3778341199,1672533373,1672535512,2139
7513,3401627165,3500499542,1672691164,1672694726,3562
7601,3370636709,3852391257,1672572197,1672573021,824
7623,3512969370,3901990690,1672619588,1672620232,644
7870,3711571712,3312333615,1672607553,1672608363,810
7848,3406784491,3513164386,1672531621,1672535083,3462
7618,3421836608,3516223597,1672663468,1672665497,2029
7568,3890149705,3625274012,1672574698,1672577336,2638
7558,3397418363,3975287541,1672579592,1672581524,1932
7877,3757562897,3780503655,1672646468,1672648962,2494
7570,3475795792,3777120536,1672657948,1672659219,1271
7855,3373384732,3777443199,1672554055,1672556726,2671
7817,3791657947,3606987130,1672567555,1672569120,1565
7564,3517963492,3916289176,1672595996,1672597362,1366
7535,3918584946,3713630656,1672566066,1672567640,1574
7501,3511163800,3478194807,1672644136,1672644735,599
7680,3757151210,3703275621,1672546348,1672549832,3484
7866,3516960534,3773950140,1672542984,1672544731,1747
7771,3500391167,3244485293,1672537847,1672540732,2885
7919,3613683164,3882242815,1672603825,1672606071,2246
7490,3519428855,3280615985,1672622204,1672623578,1374
7726,3518163778,3454042520,1672641974,1672644892,2918
7836,3520709480,3520931254,1672557548,1672560851,3303
7908,3701967560,3418728074,1672535253,1672536436,1183
7917,3496051529,3533369198,1672676463,1672677485,1022
7688,3244389794,3791334389,1672537470,1672538046,576
7980,3510594211,3616944364,1672687595,1672689400,1805
7980,3416241005,3823600322,1672700383,1672703935,3552
7646,3756027749,3793753089,1672689879,1672693408,3529
7700,3716168623,3472130842,1672602822,1672604378,1556
7567,3626156564,3826633236,1672676416,1672676880,464
7712,3715492942,3780974443,1672681694,1672685234,3540
7590,3666507626,3516606733,1672551317,1672553037,1720
7551,3384240055,3438645253,1672649497,1672649840,343
7529,3533369198,3715492942,1672554798,1672555079,281
7683,3367029997,3510247121,1672656015,1672656348,333
7782,3822654369,3791020967,1672641545,1672643229,1684
7513,3478194807,3365614305,1672567625,1672568729,1104
7883,3939952128,3385763781,1672682281,1672683523,1242
7723,3276993580,3714821932,1672664505,1672667414,2909
7963,3933210486,3805342762,1672566559,1672569669,3110
7940,3365614305,3909606423,1672533194,1672533892,698
7711,3817621391,3739106581,1672608333,1672611900,3567
7622,3501692334,3500803339,1672622375,1672622448,73
7590,3356860407,3426325549,1672673383,1672676539,3156
7756,3511267139,3517077106,1672596474,1672597078,604
7770,3511862351,3311761694,1672697810,1672701128,3318
7509,3312829208,3792789881,1672582434,1672584264,1830
7869,3914259449,3770078063,1672577210,1672577328,118
7635,3514245078,3276640712,1672676908,1672679640,2732
7563,3405494240,3756451663,1672597198,1672598619,1421
7643,3509453566,3520629279,1672656165,1672657216,1051
7746,3391261292,3517459919,1672696550,1672699976,3426
7927,3778308417,3738502357,1672578731,1672581372,2641
7493,3533385867,3716835696,1672647796,1672649828,2032
7796,3505530961,3434642576,1672608895,1672611730,2835
7597,3515151980,3792253549,1672632359,1672635567,3208
7893,3466911760,3505362057,1672664798,1672664956,158
7508,3890149705,3715981584,1672663733,1672664846,1113
7562,3505649239,3774580701,1672690452,1672693297,2845
7861,3534492426,3311203656,1672661446,1672664734,3288
7979,3636867411,3458539365,1672564894,1672567257,2363
7812,3933210486,3505219850,1672663394,1672666516,3122
7867,3512540951,3975287541,1672585631,1672586347,716
7514,3792844210,3909238838,1672689603,1672691844,2241
7788,3611150562,3780294829,1672593546,1672594198,652
7839,3839849341,3736419952,1672598306,1672600818,2512
7917,3701274634,3344019610,1672693031,1672696033,3002
7545,3828432634,3520888296,1672672853,1672673211,358
7774,3519563836,3770447408,1672602998,1672606548,3550
7656,3273500349,3467773920,1672562012,1672563500,1488
7967,3351008918,3379256399,1672634730,1672636128,1398
7500,3773120434,3901877072,1672695749,1672698011,2262
7576,3519069599,3783245561,1672683923,1672685661,1738
7809,3512166013,3289061738,1672677320,1672679377,2057
7735,3421127249,3783239924,1672571405,1672574196,2791
7974,3853018906,3518360734,1672660162,1672662371,2209
7836,3285400528,3533280269,1672642033,1672644512,2479
7523,3365278081,3360993964,1672695821,1672696658,837
7511,3802367797,3222521619,1672658131,1672661190,3059
7817,3505000737,3505292701,1672616707,1672619482,2775
7817,3501483568,3533137446,1672696236,1672698672,2436
7540,3715998609,3516716179,1672695819,1672698631,2812
7688,3500894271,3433804879,1672629742,1672631291,1549
7776,3760598102,3388637594,1672532959,1672534214,1255
7534,3901877072,3979339287,1672606872,1672609006,2134
7734,3487171044,3500391167,1672586925,1672588794,1869
7597,3757403279,3757447189,1672683771,1672686211,2440
7671,3811171116,3512540951,1672671362,1672671778,416
7628,3501955238,3793338102,1672642755,1672644567,1812
7551,3773814927,3318697153,1672589325,1672590053,728
7822,3611150562,3505173328,1672661851,1672664912,3061
7893,3533827120,3792883665,1672641726,1672641828,102
7955,3276993580,3534191820,1672603765,1672606506,2741
7628,3827377568,3388286531,1672644364,1672644807,443
7540,3760267716,3756424865,1672588013,1672591035,3022
7485,3922275416,3505638204,1672591910,1672592838,928
7529,3473765852,3793871337,1672572485,1672573502,1017
7578,3701967560,3711569060,1672684003,1672687214,3211
7959,3517509185,3278365525,1672680807,1672681558,751
7890,3716900301,3617055293,1672692307,1672692909,602
7707,3511170269,3738274418,1672611882,1672615230,3348
7660,3416427576,3825229501,1672642675,1672644134,1459
7574,3512510536,3510173870,1672554494,1672555824,1330
7901,3716273414,3510126867,1672630638,1672632797,2159
7818,3473765852,3458539365,1672668029,1672670709,2680
7619,3713894336,3715127362,1672552393,1672555710,3317
7500,3533626375,3937224533,1672605260,1672608343,3083
7817,3780974443,3756453423,1672679372,1672681712,2340
7947,3791901535,3367902229,1672567594,1672567769,175
7865,3478194807,3835382117,1672702083,1672704074,1991
7886,3756462516,3280615985,1672671107,1672673290,2183
7866,3779740455,3836573197,1672639681,1672643141,3460
7822,3780593036,3713630656,1672694550,1672697211,2661
7654,3817316561,3685187183,1672566644,1672568487,1843
7735,3780813786,3511198618,1672594645,1672598049,3404
7551,3487171044,3851190615,1672689615,1672689739,124
7885,3505098372,3505859863,1672631728,1672634950,3222
7536,3915628728,3534191820,1672571916,1672573247,1331
7663,3895562476,3883551721,1672698054,1672700621,2567
7664,3855937514,3209048907,1672661722,1672664219,2497
7504,3916289176,3515691540,1672626546,1672626788,242
7974,3828432634,3533927138,1672549209,1672550312,1103
7515,3606812411,3778980116,1672643167,1672646428,3261
7925,3222521619,3774501422,1672577189,1672578230,1041
7659,3472130842,3223968713,1672623876,1672624769,893
7960,3822654369,3511163800,1672633507,1672636087,2580
7672,3812176780,3683959482,1672659858,1672660297,439
7879,3760183458,3792902982,1672534102,1672535768,1666
7491,3501364586,3466229085,1672555716,1672556754,1038
7823,3826415738,3244389794,1672691675,1672695068,3393
7876,3428006164,3505869747,1672645599,1672647247,1648
7601,3516716179,3346327502,1672548015,1672550508,2493
7836,3519654779,3277939457,1672563244,1672563796,552
7585,3296471982,3774580701,1672555486,1672558545,3059
7868,3701984666,3774466457,1672558188,1672560328,2140
7732,3517476351,3296471982,1672557482,1672560828,3346
7621,3716165213,3533653428,1672552663,1672553732,1069
7820,3311648200,3774066725,1672538266,1672538394,128
7576,3518014404,3319752091,1672623999,1672627070,3071
7813,3472130842,3973560347,1672598770,1672599193,423
7975,3770447408,3365942576,1672639524,1672639865,341
7900,3402943525,3933210486,1672611164,1672611321,157
7796,3757562897,3222448362,1672615059,1672616379,1320
7497,3633420270,3909331423,1672691791,1672693879,2088
7492,3446948848,3533810360,1672591764,1672592190,426
7592,3918584946,3703889596,1672612274,1672615283,3009
7936,3518408774,3608633356,1672585036,1672587622,2586
7844,3889232789,3500803339,1672649740,1672650087,347
7893,3780813786,3367902229,1672676767,1672679060,2293
7528,3783206719,3715339701,1672620363,1672622372,2009
7779,3757682496,3429856982,1672548791,1672552253,3462
7765,3244389794,3515284591,1672659334,1672660142,808
7708,3772309166,3493507965,1672536583,1672538768,2185
7952,3738274418,3501955238,1672570034,1672573364,3330
7828,3880285638,3510126867,1672666207,1672666629,422
7916,3221899927,3829319703,1672557630,1672560679,3049
7962,3760509236,3777806071,1672611887,1672614652,2765
7633,3518876135,3399052055,1672585293,1672586181,888
7546,3857349323,3534553510,1672640808,1672641985,1177
7534,3510711755,3779036831,1672607404,1672609042,1638
7980,3428006164,3755625324,1672589743,1672590943,1200
7892,3315583351,3776513891,1672669788,1672672713,2925
7592,3774501422,3701065786,1672633867,1672635098,1231
7743,3713349754,3224716315,1672676792,1672678777,1985
7720,3388372715,3518791447,1672597210,1672598160,950
7490,3427219654,3703735129,1672684749,1672685817,1068
7762,3489728806,3760992710,1672556056,1672557204,1148
7916,3511163800,3793871337,1672546509,1672546843,334
7541,3634786711,3512166013,1672582062,1672583385,1323
7631,3229058858,3710112546,1672624706,1672626751,2045
7967,3783245561,3792473331,1672682058,1672684762,2704
7911,3774127586,3493507965,1672597021,1672597869,848
7973,3500066230,3399911573,1672598171,1672601600,3429
7664,3519700826,3516629436,1672648042,1672651182,3140
7676,3362000049,3895562476,1672606074,1672609397,3323
7821,3518163778,3760183458,1672672920,1672675547,2627
7630,3793959750,3715189301,1672577535,1672579714,2179
7636,3505904952,3352603894,1672680940,1672682040,1100
7647,3836573197,3634340855,1672647855,1672651394,3539
7605,3770447408,3634340855,1672586616,1672587637,1021
7830,3852595551,3777806071,1672697252,1672698796,1544
7690,3430504438,3518791447,1672558248,1672558336,88
7627,3714488548,3206603608,1672700912,1672703207,2295
7838,3223968713,3512510536,1672532498,1672534973,2475
7709,3534424200,3715492942,1672658699,1672659830,1131
7614,3364543015,3791942683,1672637677,1672638170,493
7908,3505638204,3516016437,1672606017,1672606694,677
7639,3791594391,3776338577,1672562701,1672565383,2682
7941,3755625324,3473562469,1672601170,1672602530,1360
7780,3512166013,3738274418,1672583412,1672585254,1842
7896,3520012395,3509773875,1672619716,1672620185,469
7789,3932051427,3311152102,1672656963,1672657899,936
7891,3778780511,3779528381,1672669322,1672670799,1477
7909,3714821932,3937224533,1672667324,1672669969,2645
7839,3701984666,3511350608,1672546738,1672547134,396
7636,3826759140,3428006164,1672553534,1672556462,2928
7795,3244173074,3338703270,1672613844,1672616950,3106
7585,3756453423,3509634629,1672669490,1672671675,2185
7981,3500229033,3713644518,1672576139,1672578334,2195
7644,3757455053,3760569731,1672556941,1672557637,696
7488,3616944364,3501955238,1672534873,1672538032,3159
7495,3909238838,3550946908,1672661820,1672662918,1098
7799,3823600322,3500066230,1672581045,1672584249,3204
7918,3903307060,3859525941,1672552204,1672554658,2454
7496,3555214688,3515125508,1672695276,1672697781,2505
7543,3500994774,3711262377,1672545107,1672547847,2740
7899,3533748232,3223789409,1672551053,1672552140,1087
7655,3200198928,3311324983,1672628778,1672631070,2292
7888,3303751772,3773814927,1672677005,1672678778,1773
7908,3616944364,3416265063,1672699735,1672701359,1624
7633,3774127586,3476232529,1672662207,1672663631,1424
7849,3606812411,3777623166,1672655263,1672658078,2815
7709,3505962865,3778341199,1672665436,1672665794,358
7513,3792789881,3501955238,1672537431,1672540734,3303
7639,3793470489,3829319703,1672626482,1672628080,1598
7964,3703441914,3701065786,1672562989,1672564783,1794
7972,3756021689,3516465662,1672539016,1672539354,338
7579,3220716272,3772309150,1672603715,1672605538,1823
7936,3760489031,3973560347,1672568690,1672570971,2281
7637,3465254146,3774050956,1672658892,1672661351,2459
7821,3489217083,3510969660,1672665253,1672668012,2759
7665,3418728074,3883085535,1672687001,1672690464,3463
7627,3903962771,3666507626,1672547067,1672549320,2253
7747,3533193862,3519152550,1672639495,1672642644,3149
7525,3880285638,3533927138,1672656119,1672659416,3297
7534,3779976989,3514987389,1672617973,1672621500,3527
7908,3736229191,3235287260,1672702011,1672705169,3158
7751,3774580701,3383661227,1672656171,1672656877,706
7970,3715998609,3411618230,1672540269,1672541441,1172
7722,3518163778,3501955238,1672628570,1672630377,1807
7571,3519700826,3711370563,1672631933,1672633286,1353
7860,3511271692,3918584946,1672694425,1672697813,3388
7575,3826633236,3979339287,1672671644,1672672376,732
7646,3512510536,3477649378,1672628842,1672629061,219
7889,3777790718,3485823740,1672608670,1672612072,3402
7813,3201324715,3778341199,1672583976,1672585175,1199
7673,3792288302,3911245524,1672697863,1672698661,798
7905,3793470489,3336751428,1672663941,1672664959,1018
7486,3513164386,3792883665,1672609450,1672611103,1653
7678,3778980116,3520629279,1672626171,1672629327,3156
7773,3734496778,3760561634,1672557657,1672557730,73
7882,3399535232,3516909237,1672695799,1672698268,2469
7819,3249791738,3757682496,1672538469,1672541723,3254
7973,3417587765,3914290246,1672563205,1672563893,688
7783,3505292701,3520931254,1672607212,1672609382,2170
7828,3534729133,3501606184,1672681954,1672683885,1931
7745,3773598056,3249247700,1672622523,1672625032,2509
7870,3432665384,3534010629,1672602650,1672603655,1005
7748,3755739653,3483164654,1672697710,1672699124,1414
7560,3825229501,3713808837,1672534494,1672537893,3399
7904,3501955238,3399433690,1672604036,1672604787,751
7798,3489962019,3516465662,1672633785,1672635726,1941
7669,3738502357,3510126867,1672545042,1672546783,1741
7903,3734828619,3351008918,1672602365,1672604921,2556
7580,3301107849,3304625412,1672630030,1672632330,2300
7804,3200691026,3505173328,1672622211,1672624605,2394
7526,3793753089,3783925755,1672650729,1672652286,1557
7572,3793470489,3242408357,1672609527,1672610482,955
7907,3904775198,3633420270,1672583415,1672586051,2636
7814,3778108318,3311208440,1672663234,1672663696,462
7522,3357483218,3516980378,1672655531,1672658774,3243
7741,3488244966,3881477378,1672565845,1672567922,2077
7678,3297463265,3882242815,1672684949,1672685326,377
7574,3917088658,3792844210,1672690643,1672693327,2684
7705,3910454786,3478194807,1672649274,1672652502,3228
7859,3756623396,3756623396,1672610649,1672611014,365
7503,3338703270,3903307060,1672618761,1672620845,2084
7689,3714504419,3915628728,1672590325,1672593521,3196
7612,3793086311,3238712269,1672654522,1672657302,2780
7920,3389115045,3774339795,1672607841,1672610063,2222
7885,3512720680,3367029997,1672553153,1672554441,1288
7710,3912262917,3412980697,1672680103,1672681724,1621
7578,3516629436,3291883916,1672635215,1672638207,2992
7487,3903962771,3247428249,1672699301,1672700927,1626
7876,3812176780,3294803686,1672581147,1672584726,3579
7857,3851190615,3885897503,1672539524,1672541208,1684
7903,3817621391,3617055293,1672669203,1672671988,2785
7755,3511271692,3935127663,1672671710,1672674942,3232
7709,3516039895,3505000737,1672589163,1672591260,2097
7961,3223789409,3433804879,1672697532,1672699384,1852
7882,3922337974,3910886626,1672542582,1672544345,1763
7943,3384951177,3206603608,1672680291,1672682103,1812
7823,3459030804,3223968713,1672663822,1672665778,1956
7867,3514838220,3817316561,1672557733,1672558640,907
7491,3772053179,3711569060,1672604725,1672608307,3582
7815,3475795792,3662180254,1672568341,1672568626,285
7570,3511271692,3760598102,1672654634,1672654949,315
7911,3505973226,3793389510,1672605654,1672606119,465
7593,3666506258,3514128943,1672565037,1672565768,731
7605,3415546117,3513080274,1672593616,1672593956,340
7827,3778266283,3476232529,1672636171,1672637721,1550
7719,3465202715,3399004969,1672551033,1672554362,3329
7726,3792253549,3713268590,1672664693,1672667099,2406
7701,3918584946,3510703546,1672636088,1672636404,316
7779,3365278081,3624761861,1672624756,1672624951,195
7718,3369998498,3774010081,1672620527,1672621757,1230
7914,3505201246,3472130842,1672568587,1672572180,3593
7671,3533137446,3510969660,1672591564,1672595019,3455
7885,3792384220,3311324983,1672582314,1672583441,1127
7959,3534488837,3792668962,1672626307,1672628645,2338
7495,3349613093,3339907603,1672702523,1672706081,3558
7498,3294803686,3701146057,1672646672,1672649955,3283
7623,3883861463,3885897503,1672586121,1672587274,1153
7537,3624312512,3770101921,1672633987,1672636911,2924
7868,3853018906,3514472925,1672636675,1672639617,2942
7619,3777790718,3415546117,1672671913,1672673318,1405
7962,3517963492,3936227020,1672663538,1672663798,260
7674,3772714862,3701498253,1672629724,1672631386,1662
7720,3302626661,3633420270,1672669902,1672672482,2580
7970,3276640712,3813052709,1672647441,1672650471,3030
7507,3715981584,3731106822,1672621607,1672624303,2696
7918,3509907947,3483164654,1672669216,1672671459,2243
7606,3307097200,3809916577,1672619550,1672622464,2914
7962,3501184421,3311718847,1672559539,1672562066,2527
7841,3774793839,3505135325,1672567032,1672567556,524
7925,3428006164,3807987001,1672545799,1672547262,1463
7725,3629547065,3370636709,1672590496,1672592143,1647
7568,3533927138,3791602225,1672680830,1672683136,2306
7707,3402943525,3426325549,1672622471,1672624835,2364
7520,3935127663,3473765852,1672608542,1672609463,921
7976,3756966035,3384951177,1672621327,1672622452,1125
7932,3778266283,3229058858,1672690473,1672692446,1973
7671,3772884106,3291883916,1672615560,1672615708,148
7805,3220716272,3501730685,1672696994,1672698231,1237
7778,3475396323,3710098970,1672659283,1672661465,2182
7674,3271938399,3520888296,1672577268,1672578494,1226
7523,3316173088,3624761861,1672537094,1672538129,1035
7638,3701995648,3855937514,1672620638,1672622196,1558
7654,3773598056,3512540951,1672698863,1672700402,1539
7751,3760267716,3518360734,1672567545,1672570253,2708
7644,3291235378,3396086535,1672673191,1672673760,569
7532,3626156564,3339907603,1672669153,1672671777,2624
7798,3970117174,3534191820,1672629729,1672630573,844
7839,3520030713,3772884106,1672642080,1672644384,2304
7508,3910886626,3533810360,1672547952,1672551066,3114
7931,3760561634,3780609808,1672684327,1672684512,185
7554,3902383721,3206603608,1672680915,1672684118,3203
7507,3714504419,3338367113,1672690205,1672690945,740
7946,3776513891,3229058858,1672614825,1672616042,1217
7654,3429856982,3770078063,1672642798,1672645941,3143
7815,3774338212,3715998609,1672568056,1672570436,2380
7779,3311718847,3791115967,1672659110,1672660932,1822
7888,3777514571,3770101921,1672617781,1672621228,3447
7528,3520629279,3505649239,1672695195,1672698185,2990
7516,3780639480,3770763956,1672546506,1672549511,3005
7560,3407954858,3428964059,1672622914,1672624344,1430
7542,3715339701,3373384732,1672643688,1672644159,471
7725,3380035798,3399433690,1672620021,1672622568,2547
7610,3303705369,3311761694,1672634068,1672634264,196
7500,3701111745,3793627961,1672666074,1672668884,2810
7483,3713786889,3912536808,1672561707,1672562790,1083
7749,3883042241,3737051610,1672673823,1672676314,2491
7903,3289061738,3755872268,1672684672,1672686423,1751
7657,3791115967,3500894271,1672655481,1672657140,1659
7697,3713268590,3621497531,1672644545,1672645612,1067
7862,3426325549,3520756859,1672594426,1672597793,3367
7694,3772578994,3757246925,1672660581,1672662470,1889
7668,3342131135,3513164386,1672580195,1672581093,898
7611,3777623166,3209048907,1672628689,1672629539,850
7850,3533280269,3332072298,1672673350,1672675725,2375
7781,3311627628,3430504438,1672646408,1672646774,366
7795,3756462516,3345207877,1672671448,1672672772,1324
7669,3533927138,3302626661,1672602094,1672603161,1067
7957,3779976989,3710067113,1672645194,1672646548,1354
7822,3483164654,3817621391,1672569395,1672569472,77
7735,3427219654,3760992710,1672665074,1672667646,2572
7805,3478194807,3311152102,1672584058,1672587571,3513
7754,3510937904,3379256399,1672693480,1672695004,1524
7746,3554917400,3291883916,1672659890,1672662629,2739
7778,3976633198,3791602225,1672628280,1672630399,2119
7828,3682061100,3534191820,1672657442,1672659654,2212
7568,3773755137,3429690204,1672673989,1672676115,2126
7510,3388637594,3774466457,1672651585,1672653836,2251
7770,3978115672,3501184421,1672682181,1672682793,612
7756,3510857360,3516673015,1672627762,1672629258,1496
7710,3312664885,3318166135,1672599415,1672602766,3351
7866,3271938399,3714821932,1672581773,1672585295,3522
7539,3772642849,3312333615,1672593534,1672594004,470
7897,3496269445,3533827120,1672532741,1672534291,1550
7623,3312664885,3711262377,1672701282,1672701936,654
7703,3780828689,3459030804,1672678374,1672680152,1778
7625,3773664987,3417587765,1672667705,1672668948,1243
7927,3736786443,3703275621,1672580442,1672582558,2116
7544,3713370078,3409474775,1672680803,1672680985,182
7564,3360993964,3500904641,1672700319,1672703272,2953
7483,3476232529,3774119563,1672596999,1672597249,250
7744,3703013906,3516606733,1672673969,1672676786,2817
7845,3394539273,3833889105,1672697616,1672699426,1810
7654,3235635976,3284832486,1672666933,1672670002,3069
7505,3209383861,3756623396,1672604423,1672606292,1869
7931,3222521619,3666553782,1672701725,1672702485,760
7927,3384240055,3757455053,1672537111,1672537534,423
7843,3516065852,3386707783,1672570280,1672570966,686
7690,3515691540,3770447408,1672628560,1672631209,2649
7562,3221536550,3736625083,1672575192,1672577262,2070
7650,3515691540,3400918687,1672686188,1672689405,3217
7709,3793871337,3500391167,1672584007,1672584823,816
7498,3244485293,3852595551,1672645522,1672648151,2629
7785,3773664987,3201324715,1672684736,1672687915,3179
7981,3757447189,3428964059,1672670938,1672671349,411
7621,3773664987,3311065516,1672646373,1672647749,1376
7632,3390068992,3427283336,1672594126,1672595729,1603
7560,3492478793,3792902982,1672641304,1672642646,1342
7946,3816454165,3229665776,1672585671,1672586523,852
7647,3311324983,3793436995,1672553824,1672556119,2295
7850,3973560347,3501198706,1672562851,1672564872,2021
7854,3777936328,3284832486,1672681750,1672685032,3282
7632,3836573197,3701274634,1672639630,1672640150,520
7496,3832902928,3511350608,1672549652,1672550002,350
7700,3349613093,3304625412,1672691111,1672692477,1366
7769,3314245084,3475396323,1672578600,1672581669,3069
7902,3701691675,3534553510,1672646802,1672649527,2725
7881,3517963492,3783429780,1672539791,1672540253,462
7558,3808324264,3280964728,1672586758,1672588099,1341
7706,3518260334,3279721246,1672672752,1672674002,1250
7756,3716258994,3772746272,1672647541,1672650877,3336
7890,3430504438,3407954858,1672604769,1672605049,280
7772,3819727225,3520888296,1672674171,1672677572,3401
7885,3909238838,3933210486,1672551430,1672554223,2793
7875,3972709319,3736625083,1672575383,1672578473,3090
7901,3774298222,3517509185,1672535986,1672538002,2016
7767,3520376528,3512142794,1672643105,1672644221,1116
7541,3639847263,3701178711,1672579415,1672582659,3244
7899,3772884106,3792384220,1672555656,1672556419,763
7970,3351008918,3249401741,1672603942,1672604376,434
7653,3493507965,3914259449,1672556741,1672557787,1046
7729,3513080274,3533369198,1672564324,1672567617,3293
7732,3514838220,3357483218,1672689802,1672693086,3284
7672,3773664987,3917278625,1672593065,1672593878,813
7755,3682061100,3783245561,1672555458,1672555649,191
7687,3783531004,3774010081,1672597565,1672600180,2615
7904,3383661227,3772578994,1672600160,1672600768,608
7817,3773598056,3791334389,1672688589,1672692126,3537
7881,3804870229,3882242815,1672531849,1672532327,478
7737,3227158514,3800886801,1672589143,1672592310,3167
7810,3500487333,3235635976,1672539660,1672543177,3517
7804,3399911573,3277605882,1672613919,1672615998,2079
7705,3311648200,3666457294,1672599003,1672600698,1695
7646,3454042520,3518014636,1672617999,1672620934,2935
7609,3816853177,3227158514,1672582219,1672585621,3402
7595,3807987001,3937224533,1672550067,1672552173,2106
7604,3909238838,3473562469,1672601325,1672603664,2339
7539,3757151210,3332072298,1672533323,1672534717,1394
7779,3227457126,3899371911,1672673926,1672677129,3203
7597,3477375368,3518163778,1672537999,1672538213,214
7517,3770635361,3505219850,1672634332,1672635060,728
7810,3399052055,3783429780,1672588005,1672588542,537
7857,3756930948,3711380716,1672555311,1672557829,2518
7893,3774119563,3227158514,1672636385,1672637485,1100
7600,3792032359,3476232529,1672676502,1672677524,1022
7642,3534492426,3924549929,1672552029,1672554276,2247
7548,3415546117,3224058172,1672558684,1672560380,1696
7554,3302626661,3517721725,1672677529,1672679543,2014
7895,3420432297,3716165213,1672688211,1672688455,244
7880,3373384732,3913251733,1672608651,1672609710,1059
7907,3760077057,3791901535,1672578396,1672578696,300
7559,3388372715,3505869747,1672661030,1672663779,2749
7487,3773429448,3338367113,1672583015,1672584354,1339
7507,3533810360,3688418210,1672538276,1672541753,3477
7894,3760509236,3331845324,1672694789,1672696665,1876
7965,3318166135,3703013906,1672651730,1672652167,437
7905,3520183192,3517721725,1672589262,1672591160,1898
7765,3496051529,3912262917,1672542767,1672545599,2832
7672,3664170666,3818255890,1672686489,1672689094,2605
7510,3388372715,3288764520,1672577601,1672580459,2858
7586,3880310724,3511267139,1672555511,1672555690,179
7735,3379589402,3394330287,1672693851,1672693915,64
7793,3505477652,3534729133,1672592981,1672595826,2845
7610,3793389510,3509352754,1672642104,1672644310,2206
7773,3515723720,3513599775,1672557972,1672561572,3600
7976,3533137446,3516629436,1672635466,1672638046,2580
7747,3972709319,3467773920,1672642506,1672644923,2417
7752,3855424474,3438645253,1672610311,1672611010,699
7569,3518496488,3711262377,1672533412,1672534418,1006
7909,3202120784,3858918246,1672608759,1672612153,3394
7912,3511170269,3667680268,1672627679,1672629335,1656
7756,3520751702,3770078063,1672703332,1672705393,2061
7908,3509933351,3701111745,1672597840,1672601294,3454
7787,3465202715,3392121505,1672639975,1672642554,2579
7505,3534729133,3394330287,1672646691,1672646811,120
7720,3760077057,3533748232,1672559051,1672559376,325
7906,3501601840,3247428249,1672535039,1672535689,650
7850,3519703355,3973560347,1672632203,1672633180,977
7686,3711380716,3311324983,1672678048,1672678153,105
7599,3774119563,3703955926,1672556347,1672559023,2676
7643,3703789494,3760561634,1672579977,1672582302,2325
7982,3379589402,3311415018,1672551767,1672552948,1181
7969,3534729133,3379256399,1672660271,1672661096,825
7609,3714474557,3402943525,1672541578,1672544269,2691
7491,3606812411,3489962019,1672662637,1672666086,3449
7873,3554917400,3780813786,1672597448,1672600144,2696
7734,3634786711,3399052055,1672653924,1672657200,3276
7909,3926700506,3637008488,1672569477,1672571555,2078
7704,3734828619,3430352815,1672597196,1672598582,1386
7727,3512540951,3711973519,1672556431,1672559686,3255
7759,3244436890,3311203656,1672571331,1672573014,1683
7543,3792668962,3777717988,1672626553,1672627126,573
7733,3483949762,3291883916,1672557819,1672559720,1901
7725,3505873261,3834257412,1672592740,1672594841,2101
7918,3512720680,3500365158,1672654805,1672655099,294
7795,3734496778,3505347134,1672679146,1672680290,1144
7551,3792288302,3774339795,1672589707,1672591349,1642
7961,3930797455,3516016437,1672629192,1672629765,573
7575,3857349323,3438645253,1672661493,1672663754,2261
7510,3311761694,3791115967,1672661600,1672661802,202
7778,3231056870,3514838220,1672670658,1672671272,614
7718,3311154569,3519152550,1672665851,1672669271,3420
7624,3666507626,3755881905,1672549275,1672550061,786
7760,3930797455,3520756859,1672606033,1672607355,1322
7823,3348261553,3509907947,1672596472,1672596926,454
7871,3311627628,3757602960,1672557971,1672558463,492
7792,3703735129,3394330287,1672618582,1672619483,901
7879,3825229501,3780914982,1672651802,1672651935,133
7891,3517459919,3286658957,1672648808,1672651365,2557
7727,3418534998,3516980378,1672655673,1672658768,3095
7960,3613683164,3510771358,1672534685,1672535446,761
7795,3339907603,3517864478,1672643363,1672643632,269
7807,3500177712,3780593036,1672697566,1672698957,1391
7706,3791594391,3904775198,1672624972,1672627597,2625
7524,3714962248,3377766165,1672680666,1672680797,131
7965,3783245561,3516514391,1672625018,1672627825,2807
7904,3710344260,3613995936,1672617482,1672619368,1886
7692,3311718847,3333896808,1672585256,1672587264,2008
7924,3380035798,3791334389,1672701669,1672702748,1079
7615,3311718847,3701178711,1672624678,1672627139,2461
7646,3774580701,3780828689,1672548007,1672548943,936
7683,3917278625,3383922351,1672685237,1672686276,1039
7612,3512969370,3791957752,1672661582,1672662544,962
7944,3466229085,3714488548,1672611738,1672614836,3098
7867,3770635361,3519069599,1672657653,1672657764,111
7900,3880285638,3778266283,1672605643,1672609100,3457
7679,3518014636,3828432634,1672613124,1672616144,3020
7592,3505649239,3716537575,1672573757,1672575723,1966
7795,3512720680,3755392666,1672572060,1672573148,1088
7948,3760893269,3757682496,1672563626,1672564259,633
7511,3683766533,3505973226,1672693496,1672696408,2912
7901,3667680268,3412980697,1672668556,1672671540,2984
7683,3774520233,3519912874,1672573138,1672576278,3140
7700,3519912874,3773120434,1672654545,1672654938,393
7670,3791334389,3930797455,1672578652,1672581915,3263
7822,3438645253,3228165483,1672532942,1672533230,288
7831,3512837326,3816853177,1672636857,1672639172,2315
7929,3509604974,3516258476,1672590380,1672590874,494
7897,3827626797,3774005526,1672584714,1672586262,1548
7657,3736592744,3505203158,1672597920,1672598975,1055
7666,3826759140,3780788622,1672578708,1672579131,423
7853,3505638204,3475251781,1672565626,1672569044,3418
7933,3516960534,3757682496,1672584260,1672585722,1462
7584,3438645253,3402943525,1672571726,1672572151,425
7539,3777983879,3711571712,1672698500,1672700420,1920
7624,3289061738,3774268456,1672562620,1672563929,1309
7644,3501955238,3519152550,1672702214,1672703033,819
7751,3780365428,3792789881,1672549388,1672551339,1951
7540,3224058172,3716900301,1672577345,1672579197,1852
7934,3430352815,3277669002,1672578329,1672581287,2958
7687,3516960534,3517476351,1672539077,1672539711,634
7823,3493507965,3387674757,1672616796,1672617584,788
7530,3835382117,3200691026,1672629249,1672630696,1447
7949,3624761861,3533369198,1672655584,1672657680,2096
7483,3715981584,3925402713,1672587325,1672590048,2723
7499,3518932404,3311993075,1672589556,1672591091,1535
7928,3378686918,3509907947,1672587638,1672589295,1657
7516,3399911573,3513956646,1672628122,1672630558,2436
7683,3432665384,3496549058,1672636513,1672637639,1126
7494,3903009525,3516980378,1672535370,1672537498,2128
7965,3664170666,3385763781,1672688662,1672689694,1032
7826,3774339795,3792032359,1672560092,1672562040,1948
7616,3519654779,3515151980,1672573622,1672576122,2500
7778,3248507722,3415546117,1672543305,1672545214,1909
7690,3778549126,3913251733,1672629322,1672629902,580
7982,3606987130,3903307060,1672538024,1672539588,1564
7701,3613995936,3518932404,1672602100,1672602165,65
7829,3703223015,3791901535,1672690742,1672694187,3445
7627,3736625083,3311152102,1672639326,1672642701,3375
7748,3234541252,3448855696,1672610770,1672611523,753
7914,3500658339,3817621391,1672609951,1672610440,489
7965,3367029997,3311603601,1672538172,1672541339,3167
7749,3703735129,3716746253,1672566828,1672570388,3560
7833,3832902928,3756424865,1672597472,1672598307,835
7686,3637008488,3247780536,1672557270,1672557913,643
7979,3247815299,3783126683,1672648331,1672649381,1050
7696,3600647945,3510173870,1672648834,1672649655,821
7875,3395152943,3713268590,1672603560,1672604093,533
7591,3883085535,3826760240,1672557898,1672559561,1663
7586,3472130842,3773465237,1672681081,1672684159,3078
7539,3288764520,3858918246,1672574707,1672576237,1530
7552,3501606184,3206254161,1672576898,1672579778,2880
7668,3201432789,3311439795,1672626718,1672630008,3290
7930,3234362962,3914290246,1672559059,1672560889,1830
7488,3760183458,3883861463,1672653102,1672656552,3450
7627,3972364603,3853018906,1672598787,1672599445,658
7910,3519912874,3756930948,1672612450,1672613763,1313
7819,3688418210,3500066230,1672667858,1672671161,3303
7785,3505201246,3520756859,1672564290,1672565339,1049
7659,3520730271,3822654369,1672685086,1672686942,1856
7602,3412825109,3932051427,1672565501,1672567825,2324
7507,3505347134,3606812411,1672585463,1672585726,263
7621,3411618230,3703718151,1672563217,1672565245,2028
7582,3826415738,3517077106,1672633779,1672637360,3581
7808,3289061738,3415443558,1672568367,1672569189,822
7541,3772309166,3770824086,1672695340,1672697640,2300
7550,3415443558,3918584946,1672584458,1672584673,215
7493,3756453423,3715339701,1672643808,1672644451,643
7702,3534488837,3313564074,1672582416,1672585662,3246
7533,3817316561,3888559320,1672663907,1672665002,1095
7790,3280964728,3511267139,1672602344,1672604938,2594
7784,3774127586,3510380060,1672652773,1672655835,3062
7903,3713894336,3793436995,1672643479,1672645986,2507
7567,3369998498,3780914982,1672572322,1672574203,1881
7876,3534424200,3286658957,1672646073,1672647975,1902
7907,3534729133,3296471982,1672610185,1672610335,150
7591,3703223015,3791334389,1672579029,1672581998,2969
7695,3311065516,3311152102,1672564558,1672567389,2831
7538,3736625083,3500805881,1672614955,1672617151,2196
7631,3533095755,3510969660,1672588988,1672590446,1458
7525,3777120536,3778549126,1672607417,1672608736,1319
7711,3369998498,3276993580,1672540919,1672543505,2586
7622,3510771358,3489217083,1672643072,1672646100,3028
7929,3774339795,3400804807,1672580090,1672580887,797
7606,3510594211,3509630174,1672660933,1672663424,2491
7884,3688418210,3800886801,1672539218,1672541616,2398
7656,3359239884,3209383861,1672668810,1672671614,2804
7660,3475251781,3439023335,1672576602,1672577107,505
7530,3731106822,3387966152,1672626385,1672627525,1140
7896,3688683847,3516223597,1672649175,1672650732,1557
7487,3501606184,3505098372,1672559407,1672561966,2559
7526,3772309150,3475795792,1672625998,1672627922,1924
7623,3206593906,3828624701,1672663247,1672664363,1116
7921,3276640712,3500658339,1672587187,1672588386,1199
7530,3515860749,3505362057,1672633673,1672636202,2529
7538,3311871871,3792844210,1672574984,1672576531,1547
7609,3917088658,3776066388,1672664081,1672665247,1166
7811,3475795792,3791115967,1672539426,1672541168,1742
7619,3418534998,3480687894,1672642156,1672645407,3251
7723,3736419952,3510126867,1672638595,1672640513,1918
7608,3791020967,3501601840,1672621929,1672624695,2766
7956,3500177712,3772578994,1672610535,1672613602,3067
7547,3614238812,3517721725,1672598361,1672599595,1234
7636,3351008918,3756528686,1672677905,1672679964,2059
7769,3511198618,3793848402,1672668947,1672670185,1238
7551,3755587522,3792668962,1672622351,1672623959,1608
7542,3511312803,3380035798,1672648692,1672651526,2834
7804,3639847263,3607178184,1672623466,1672624183,717
7608,3613995936,3791602225,1672607276,1672607386,110
7889,3489545239,3902278226,1672691198,1672692212,1014
7568,3416265063,3224058172,1672587220,1672589223,2003
7551,3826415738,3774066725,1672663743,1672666301,2558
7664,3314245084,3512567240,1672612835,1672614253,1418
7619,3783126683,3931941795,1672697957,1672699004,1047
7507,3409474775,3511163800,1672547494,1672550046,2552
7488,3374559242,3501483568,1672606789,1672609453,2664
7681,3378686918,3610695419,1672684333,1672684396,63
7782,3421836608,3552314511,1672534779,1672534893,114
7909,3297463265,3805292782,1672677769,1672678761,992
7743,3472130842,3351554343,1672607858,1672607999,141
7748,3710344260,3533653428,1672645526,1672646374,848
7876,3776800213,3519556068,1672702442,1672705263,2821
7726,3772746272,3415546117,1672698247,1672700327,2080
7760,3500391167,3407673904,1672569958,1672573349,3391
7485,3519703355,3365830990,1672561573,1672562158,585
7670,3714474557,3792288302,1672592554,1672593528,974
7901,3345207877,3494290908,1672573367,1672575108,1741
7535,3516039895,3783779671,1672582894,1672585007,2113
7797,3336742544,3501759100,1672602970,1672604883,1913
7677,3338703270,3505638204,1672662967,1672665321,2354
7537,3286658957,3417587765,1672669555,1672670221,666
7755,3517459919,3512166013,1672531595,1672531750,155
7941,3351554343,3429690204,1672576819,1672579994,3175
7642,3311871871,3475258557,1672593554,1672595842,2288
7494,3755798867,3512683609,1672594786,1672596907,2121
7564,3338703270,3200691026,1672532800,1672535937,3137
7902,3772578994,3738274418,1672627141,1672627241,100
7521,3509907947,3713644518,1672702939,1672703660,721
7741,3772758337,3487171044,1672599272,1672599988,716
7630,3427283336,3365278081,1672666587,1672669558,2971
7619,3859663348,3756027749,1672628580,1672631634,3054
7874,3429856982,3791901535,1672666049,1672666745,696
7504,3778980116,3772578994,1672598182,1672599478,1296
7857,3293695955,3209027249,1672661564,1672664403,2839
7521,3777514571,3777806071,1672616725,1672617543,818
7506,3668898102,3760561634,1672628657,1672629788,1131
7932,3533095755,3791997875,1672564999,1672567858,2859
7509,3736786443,3434642576,1672556089,1672556598,509
7620,3756601594,3407954858,1672671260,1672674161,2901
7613,3416427576,3685818092,1672593114,1672594914,1800
7962,3372883226,3443698222,1672642208,1672644210,2002
7770,3429856982,3345207877,1672607066,1672609044,1978
7604,3432689543,3481502100,1672667486,1672668594,1108
7706,3515394721,3501927421,1672608467,1672609990,1523
7741,3773120434,3735733948,1672684282,1672686227,1945
7878,3855000166,3505599848,1672690261,1672693130,2869
7761,3516223597,3774338212,1672655783,1672655990,207
7615,3384240055,3715981584,1672541728,1672544389,2661
7867,3777806071,3688683847,1672565679,1672567124,1445
7897,3666507626,3533626375,1672575515,1672575619,104
7536,3505193212,3349613093,1672621224,1672623777,2553
7982,3793338102,3519912874,1672703148,1672704663,1515
7851,3501483568,3516673015,1672652884,1672655977,3093
7857,3512349371,3505635228,1672644412,1672645370,958
7930,3711973519,3777443199,1672540512,1672541884,1372
7917,3399004969,3703661585,1672606459,1672606723,264
7942,3312664885,3711198793,1672660049,1672663642,3593
7763,3760509236,3346327502,1672601239,1672604075,2836
7575,3520165601,3975287541,1672537091,1672537599,508
7646,3828624701,3420432297,1672612540,1672616029,3489
7488,3760598102,3933210486,1672703924,1672705542,1618
7891,3296471982,3666507626,1672660049,1672661330,1281
7556,3510937904,3518408774,1672623939,1672626921,2982
7947,3703735129,3634995491,1672612813,1672615068,2255
7797,3285400528,3417970574,1672616579,1672618113,1534
7797,3242408357,3778305740,1672572227,1672572915,688
7735,3513080274,3783239924,1672556123,1672556975,852
7654,3311324983,3505530961,1672655718,1672657315,1597
7763,3510244400,3420700674,1672684275,1672685119,844
7736,3713894336,3517721725,1672654030,1672654769,739
7587,3774466457,3639847263,1672655000,1672658555,3555
7585,3511350608,3889750851,1672561979,1672562779,800
7660,3276993580,3777443199,1672605697,1672608942,3245
7496,3783779671,3511350608,1672553168,1672553843,675
7897,3533653428,3200198928,1672679136,1672680110,974
7761,3937224533,3921211276,1672595561,1672598589,3028
7974,3294803686,3519912874,1672684851,1672686301,1450
7956,3359910781,3703889596,1672557922,1672560857,2935
7880,3311324983,3500374658,1672575140,1672577266,2126
7754,3701863557,3231056870,1672676771,1672680243,3472
7722,3711504540,3302626661,1672538180,1672541432,3252
7835,3829319703,3285400528,1672562232,1672563561,1329
7520,3407954858,3280599164,1672617499,1672618575,1076
7528,3913251733,3389115045,1672541710,1672544725,3015
7865,3429690204,3715581279,1672614879,1672617242,2363
7894,3505649239,3859663348,1672593989,1672597034,3045
7558,3791957752,3834257412,1672691385,1672692468,1083
7691,3407954858,3512510536,1672686750,1672689085,2335
7566,3520190170,3688418210,1672680930,1672682421,1491
7702,3716746253,3516606733,1672676036,1672676160,124
7816,3614238812,3276993580,1672682372,1672683745,1373
7708,3429690204,3509453566,1672622464,1672623512,1048
7804,3756966035,3774501422,1672633192,1672634770,1578
7914,3779528381,3520730271,1672668729,1672669154,425
7627,3606812411,3209551760,1672657672,1672658754,1082
7790,3755798867,3770101921,1672650267,1672652187,1920
7750,3770824086,3829232696,1672678364,1672681449,3085
7870,3395152943,3516606733,1672593228,1672593679,451
7907,3370636709,3360506772,1672598512,1672600334,1822
7624,3891751546,3710408395,1672560203,1672562822,2619
7701,3791020967,3972709319,1672690974,1672692933,1959
7970,3809916577,3388286531,1672668802,1672668874,72
7813,3610695419,3247428249,1672620547,1672621413,866
7498,3618045231,3792253549,1672622084,1672624195,2111
7767,3377766165,3791997875,1672638632,1672640582,1950
7934,3783509527,3925620998,1672534962,1672536226,1264
7840,3917278625,3853018906,1672645614,1672649122,3508
7696,3613683164,3533810360,1672576251,1672576479,228
7921,3613995936,3415546117,1672553416,1672554212,796
7833,3783925755,3481502100,1672583163,1672583539,376
7658,3500066230,3443698222,1672658429,1672659106,677
7865,3501364586,3924549929,1672543919,1672546729,2810
7924,3311152102,3428006164,1672545857,1672547879,2022
7532,3202120784,3918674986,1672696421,1672696665,244
7703,3314245084,3467773920,1672700240,1672701450,1210
7752,3510703546,3780365428,1672683175,1672684752,1577
7754,3889750851,3780609808,1672623965,1672624336,371
7851,3489217083,3778308417,1672596448,1672599224,2776
7547,3517476351,3520931254,1672638909,1672641474,2565
7605,3516016437,3805519285,1672583175,1672584326,1151
7960,3221899927,3517963492,1672610386,1672612732,2346
7547,3779629905,3510857360,1672589905,1672591988,2083
7935,3511271692,3377766165,1672679458,1672681555,2097
7722,3247428249,3937224533,1672572897,1672574464,1567
7785,3209027249,3277605882,1672700135,1672702093,1958
7961,3701498253,3621810464,1672595988,1672596868,880
7778,3668005723,3482405588,1672553542,1672556047,2505
7955,3885670556,3902383721,1672645370,1672647358,1988
7886,3882242815,3780503655,1672659994,1672661187,1193
7817,3351008918,3519152550,1672672208,1672673456,1248
7561,3392121505,3510380060,1672538517,1672539564,1047
7674,3922275620,3287105466,1672655116,1672658046,2930
7837,3365830990,3776948966,1672605099,1672608602,3503
7615,3701967560,3512969370,1672625525,1672626846,1321
7651,3336742544,3356860407,1672663248,1672665983,2735
7539,3783083229,3835382117,1672699176,1672700868,1692
7952,3710569131,3770553384,1672568268,1672570780,2512
7500,3396086535,3939952128,1672664175,1672666047,1872
7488,3713370078,3391261292,1672600438,1672603076,2638
7933,3809484172,3933210486,1672666768,1672668188,1420
7759,3716165213,3701691675,1672626682,1672627067,385
7716,3476232529,3773465237,1672675437,1672676476,1039
7600,3909238838,3711198793,1672554559,1672557409,2850
7930,3837094550,3500060260,1672673840,1672675633,1793
7539,3467773920,3512567240,1672546054,1672549244,3190
7890,3836573197,3791874383,1672541132,1672544721,3589
7537,3505219850,3418534998,1672585138,1672588527,3389
7852,3793753089,3534424200,1672550561,1672553275,2714
7629,3791874383,3516606733,1672544889,1672546373,1484
7878,3304056063,3311274543,1672578057,1672581415,3358
7624,3311274543,3778108318,1672698580,1672698773,193
7746,3512969370,3367902229,1672666525,1672668320,1795
7922,3318697153,3772578994,1672696635,1672698103,1468
7814,3883551721,3713786889,1672568667,1672571542,2875
7749,3401627165,3755739653,1672532095,1672532952,857
7833,3809916577,3533927138,1672691341,1672691791,450
7951,3615046771,3778980116,1672540807,1672542666,1859
7919,3800886801,3533270638,1672699270,1672701658,2388
7772,3200198928,3903307060,1672572496,1672574624,2128
7548,3735733948,3757151210,1672561920,1672564816,2896
7604,3515723720,3228165483,1672622370,1672625549,3179
7622,3792384220,3909606423,1672533026,1672535616,2590
7524,3703955926,3777455223,1672593053,1672596079,3026
7630,3370752401,3783083229,1672602882,1672604482,1600
7969,3710344260,3519428855,1672585894,1672588055,2161
7892,3472130842,3925402713,1672547445,1672550542,3097
7810,3774556560,3805292782,1672542774,1672546051,3277
7770,3428964059,3511271692,1672619097,1672619951,854
7696,3716273414,3206603608,1672639527,1672640946,1419
7811,3411618230,3755625324,1672613387,1672615599,2212
7654,3514128943,3288764520,1672597288,1672600315,3027
7950,3730517636,3820354437,1672617635,1672618858,1223
7758,3209551760,3701898991,1672573111,1672573266,155
7621,3899266183,3774520233,1672539269,1672539666,397
7656,3918674986,3660493209,1672630910,1672632540,1630
7815,3533242305,3501364586,1672577442,1672580809,3367
7540,3823600322,3711380716,1672698052,1672698284,232
7905,3774520233,3271938399,1672687793,1672689440,1647
7714,3416265063,3852391257,1672694902,1672694994,92
7757,3516673015,3533810360,1672555406,1672558131,2725
7653,3662180254,3346327502,1672543554,1672545614,2060
7764,3399535232,3976390453,1672537485,1672540627,3142
7754,3774366875,3515284591,1672568621,1672571360,2739
7732,3510711755,3899371911,1672616419,1672617607,1188
7533,3505219850,3793753089,1672641423,1672644825,3402
7742,3713349754,3227158514,1672605538,1672606332,794
7863,3792288302,3500499542,1672649027,1672650001,974
7696,3289061738,3736419952,1672701754,1672702383,629
7916,3511312803,3777806071,1672686731,1672688175,1444
7487,3930797455,3505219850,1672672942,1672673824,882
7651,3291235378,3342131135,1672569303,1672570749,1446
7488,3791115967,3516514391,1672533880,1672535180,1300
7552,3520012395,3756462516,1672566115,1672568079,1964
7981,3388637594,3477375368,1672571763,1672573826,2063
7917,3757455053,3475251781,1672593605,1672593984,379
7842,3909331423,3348261553,1672614299,1672615775,1476
7654,3388637594,3209551760,1672569540,1672572661,3121
7539,3370752401,3351554343,1672605488,1672607353,1865
7642,3512969370,3313564074,1672684078,1672684633,555
7929,3234541252,3701984666,1672633010,1672633357,347
7832,3518876135,3713786889,1672625754,1672627370,1616
7777,3710067113,3311415018,1672546477,1672547836,1359
7702,3247428249,3554917400,1672576295,1672578006,1711
7790,3760183458,3773120434,1672577644,1672580532,2888
7582,3533193862,3777929708,1672556157,1672558193,2036
7785,3793627961,3286658957,1672698699,1672700300,1601
7687,3660493209,3901990690,1672678018,1672679896,1878
7926,3509630174,3518791447,1672612013,1672613013,1000
7567,3493507965,3511163800,1672620384,1672623133,2749
7786,3392121505,3533270638,1672589698,1672592543,2845
7508,3513164386,3683766533,1672538017,1672539621,1604
7800,3394330287,3509933351,1672565174,1672565915,741
7690,3392121505,3202120784,1672577957,1672579253,1296
7676,3311871871,3500994774,1672654233,1672656023,1790
7586,3921211276,3917088658,1672539425,1672540701,1276
7825,3500803339,3783925755,1672607428,1672608336,908
7767,3777455223,3358871377,1672565075,1672568179,3104
7767,3836573197,3430504438,1672648264,1672650653,2389
7588,3520206212,3806545488,1672673772,1672674314,542
7528,3792668962,3716273414,1672562326,1672564974,2648
7535,3909331423,3344019610,1672696033,1672696749,716
7705,3311718847,3779976989,1672620535,1672623465,2930
7726,3792883665,3500199935,1672578802,1672579735,933
7830,3338367113,3391261292,1672535566,1672537958,2392
7764,3313564074,3534729133,1672696599,1672697335,736
7795,3473765852,3922275620,1672557240,1672558482,1242
7724,3791657947,3533270638,1672642030,1672644591,2561
7737,3372883226,3735733948,1672596067,1672599392,3325
7721,3277669002,3311871871,1672654257,1672657047,2790
7809,3792288302,3505203158,1672604363,1672604620,257
7568,3777936328,3819727225,1672657063,1672657192,129
7575,3534702203,3783196518,1672627635,1672630914,3279
7621,3855937514,3377766165,1672686076,1672686148,72
7486,3370752401,3500578848,1672602890,1672606155,3265
7759,3249401741,3629547065,1672567720,1672570251,2531
7941,3760598102,3249401741,1672557114,1672557773,659
7625,3711262377,3882242815,1672561525,1672561918,393
7504,3801089989,3666457294,1672591446,1672594658,3212
7592,3755943611,3909331423,1672560262,1672561310,1048
7872,3711262377,3411618230,1672699605,1672702227,2622
7686,3514245078,3710569131,1672570390,1672571271,881
7570,3701190899,3514838220,1672547230,1672548179,949
7848,3520719611,3783705817,1672628531,1672631510,2979
7712,3772544062,3711569060,1672610476,1672611713,1237
7942,3701863557,3883312122,1672565289,1672567544,2255
7847,3284639858,3918056059,1672675837,1672677366,1529
7486,3808324264,3820354437,1672586976,1672587122,146
7912,3711198793,3735319397,1672572308,1672572647,339
7949,3511332835,3813052709,1672587887,1672591310,3423
7929,3505635228,3773429448,1672668960,1672669707,747
7937,3552314511,3770851318,1672677053,1672678937,1884
7865,3378686918,3280964728,1672580930,1672584194,3264
7516,3852391257,3314836094,1672701209,1672703158,1949
7566,3811171116,3778266283,1672611243,1672614509,3266
7812,3880285638,3890149705,1672658459,1672658824,365
7612,3793389510,3605726278,1672679864,1672682355,2491
7895,3417587765,3520730271,1672558745,1672562119,3374
7697,3236102733,3519703355,1672617762,1672619761,1999
7964,3533927138,3792288302,1672690274,1672692406,2132
7682,3242408357,3852595551,1672622087,1672624121,2034
7667,3505347134,3733891182,1672645828,1672647317,1489
7727,3316222192,3489962019,1672654841,1672657819,2978
7596,3246596716,3518669703,1672611524,1672612644,1120
7659,3432665384,3517963492,1672582694,1672585461,2767
7827,3755798867,3512142794,1672672873,1672673460,587
7807,3405494240,3501364586,1672675921,1672676537,616
7761,3534729133,3918247820,1672544440,1672546161,1721
7584,3200691026,3711198793,1672695477,1672696153,676
7604,3389115045,3296471982,1672608025,1672609318,1293
7599,3227457126,3917088658,1672692533,1672695057,2524
7919,3519912874,3518014404,1672549205,1672552264,3059
7807,3757447189,3361230905,1672703172,1672706212,3040
7488,3921211276,3411618230,1672551317,1672553629,2312
7692,3914290246,3454042520,1672532547,1672534846,2299
7704,3773814927,3221536550,1672691379,1672693072,1693
7920,3666553782,3229058858,1672609473,1672611769,2296
7847,3839849341,3512683609,1672556559,1672557919,1360
7957,3533369198,3774268456,1672615362,1672616718,1356
7770,3206254161,3349613093,1672618007,1672621037,3030
7817,3311439795,3509352754,1672692486,1672693490,1004
7633,3517077106,3370636709,1672583926,1672587373,3447
7716,3780294829,3513080274,1672596042,1672597386,1344
7743,3835382117,3909238838,1672556175,1672557490,1315
7635,3883312122,3516223597,1672590837,1672591858,1021
7658,3396285984,3399004969,1672533761,1672535694,1933
7972,3731419510,3826633236,1672677853,1672680221,2368
7824,3533025282,3501483568,1672598109,1672598256,147
7882,3459030804,3534729133,1672680049,1672683100,3051
7742,3512510536,3318697153,1672682668,1672683925,1257
7614,3780609808,3734496778,1672546476,1672549992,3516
7531,3701146057,3279721246,1672699540,1672701611,2071
7817,3505173328,3979339287,1672640162,1672641273,1111
7845,3509672210,3344019610,1672544847,1672545258,411
7560,3608633356,3917088658,1672624235,1672625698,1463
7727,3783126683,3772359096,1672562106,1672563774,1668
7642,3249791738,3734737881,1672547218,1672548039,821
7658,3432689543,3614238812,1672685096,1672688313,3217
7865,3505145247,3534553510,1672680483,1672681533,1050
7744,3361230905,3757562897,1672643649,1672645810,2161
7918,3501486692,3497901842,1672613528,1672615764,2236
7607,3932051427,3373384732,1672674896,1672678424,3528
7915,3629547065,3660493209,1672590608,1672592295,1687
7860,3757161914,3924549929,1672580788,1672583447,2659
7843,3511841857,3554917400,1672540448,1672541678,1230
7981,3783429780,3481502100,1672534159,1672535660,1501
7702,3783925755,3209551760,1672558265,1672560228,1963
7777,3318166135,3415546117,1672688902,1672692265,3363
7717,3364543015,3792902982,1672658829,1672662173,3344
7780,3534424200,3515284591,1672553257,1672554809,1552
7623,3922275416,3703661585,1672632371,1672632531,160
7823,3511435497,3823600322,1672641656,1672644102,2446
7778,3517721725,3755798867,1672541969,1672543468,1499
7642,3512683609,3505477652,1672624831,1672626354,1523
7801,3224716315,3772578994,1672615721,1672617187,1466
7792,3475251781,3228165483,1672592385,1672595545,3160
7702,3388372715,3501955238,1672598509,1672599039,530
7952,3711198793,3500060260,1672579044,1672581143,2099
7613,3666553782,3793848402,1672669787,1672672929,3142
7936,3417061462,3433804879,1672610017,1672611976,1959
7833,3772578994,3496269445,1672632885,1672636210,3325
7641,3517459919,3701111745,1672659562,1672662905,3343
7723,3713349754,3930797455,1672582299,1672585883,3584
7594,3427219654,3311090974,1672559983,1672560763,780
7884,3883042241,3901877072,1672634626,1672637997,3371
7610,3288764520,3935127663,1672598233,1672598450,217
7945,3520756859,3202120784,1672661852,1672662341,489
7541,3356860407,3432665384,1672674392,1672675422,1030
7799,3512349371,3509352754,1672587353,1672590414,3061
7734,3209027249,3903962771,1672629199,1672630980,1781
7959,3477649378,3904775198,1672647887,1672648392,505
7824,3280615985,3703955926,1672591258,1672592255,997
7823,3516514391,3809059934,1672696580,1672696748,168
7488,3774204963,3316222192,1672700881,1672702727,1846
7899,3291235378,3778266283,1672568079,1672568912,833
7520,3920801189,3247815299,1672565128,1672566805,1677
7760,3404384505,3629935998,1672689376,1672691092,1716
7643,3206603608,3756966035,1672695261,1672697645,2384
7674,3937224533,3755625324,1672702236,1672702567,331
7677,3360506772,3713894336,1672672348,1672674567,2219
7836,3505135325,3608633356,1672692537,1672694450,1913
7746,3349613093,3791602225,1672681504,1672685049,3545
7820,3404384505,3714504419,1672578496,1672580407,1911
7860,3338367113,3206593906,1672695449,1672698950,3501
7618,3516514391,3792668962,1672565081,1672566376,1295
7804,3515691540,3921211276,1672595787,1672599287,3500
7508,3399052055,3356860407,1672682986,1672684465,1479
7922,3202120784,3608633356,1672690883,1672691918,1035
7948,3899371911,3514128943,1672688800,1672690708,1908
7546,3711262377,3520706195,1672680276,1672683001,2725
7490,3517963492,3454042520,1672673498,1672674483,985
7727,3223968713,3533827120,1672567723,1672570962,3239
7976,3534488837,3534702203,1672546509,1672547006,497
7555,3476232529,3886298125,1672564042,1672564946,904
7555,3760598102,3244389794,1672610151,1672612856,2705
7521,3311871871,3777477395,1672621448,1672621952,504
7684,3500177712,3711308224,1672637992,1672639575,1583
7489,3760992710,3792473331,1672567327,1672567401,74
7890,3520629279,3555214688,1672631115,1672634142,3027
7934,3701967560,3493507965,1672613929,1672614397,468
7694,3516065852,3496549058,1672667817,1672669013,1196
7750,3634786711,3348261553,1672557360,1672558605,1245
7846,3760077057,3417061462,1672682847,1672682996,149
7930,3234541252,3755042098,1672593877,1672596404,2527
7855,3701534009,3932051427,1672644731,1672646053,1322
7850,3715492942,3615046771,1672683475,1672685260,1785
7505,3793338102,3976390453,1672550846,1672553376,2530
7610,3701863557,3500805881,1672571326,1672573018,1692
7522,3925620998,3473765852,1672642916,1672645942,3026
7968,3773205565,3755392666,1672598060,1672600042,1982
7706,3458539365,3315583351,1672562959,1672565432,2473
7496,3978115672,3627937312,1672613201,1672614175,974
7931,3716488385,3500658339,1672670144,1672673228,3084
7800,3454042520,3607748895,1672550899,1672553749,2850
7880,3365942576,3291235378,1672538741,1672541198,2457
7954,3276993580,3880310724,1672676008,1672676525,517
7664,3883312122,3229665776,1672678499,1672679400,901
7618,3711265369,3710067113,1672563339,1672565743,2404
7532,3559110998,3357483218,1672637154,1672639554,2400
7574,3714821932,3855000166,1672668913,1672672289,3376
7729,3770553384,3774050956,1672688471,1672690184,1713
7754,3505219850,3774268456,1672541945,1672545245,3300
7521,3703718151,3774520233,1672559060,1672562270,3210
7817,3903962771,3311203656,1672665412,1672666737,1325
7605,3713786889,3472130842,1672617578,1672618550,972
7907,3715339701,3779528381,1672571041,1672572442,1401
7859,3774204963,3776338577,1672681268,1672682420,1152
7876,3520888296,3516011407,1672605476,1672607170,1694
7930,3710344260,3509672210,1672578042,1672579243,1201
7591,3520012395,3516039895,1672696623,1672699469,2846
7776,3773814927,3701995648,1672577302,1672578982,1680
7929,3714962248,3475795792,1672593945,1672595924,1979
7544,3519700826,3234362962,1672646184,1672647667,1483
7722,3280599164,3715189301,1672555668,1672558348,2680
7833,3713644518,3516465662,1672554939,1672557340,2401
7539,3733189298,3710569131,1672593117,1672593733,616
7740,3280599164,3316222192,1672621385,1672623483,2098
7886,3248507722,3701274634,1672651366,1672653891,2525
7542,3883551721,3518496488,1672655690,1672658357,2667
7619,3618045231,3924549929,1672697045,1672697491,446
7980,3935627557,3918584946,1672670572,1672671711,1139
7575,3711265369,3514719601,1672542203,1672542615,412
7483,3711198793,3514245078,1672626391,1672627905,1514
7965,3902278226,3511198618,1672611268,1672612539,1271
7702,3978105277,3511267139,1672680604,1672680777,173
7835,3311324983,3755943611,1672701303,1672704182,2879
7536,3736592744,3772642849,1672649437,1672649944,507
7890,3433804879,3639847263,1672694137,1672694538,401
7606,3466229085,3484995752,1672604976,1672605434,458
7694,3520709480,3550946908,1672539134,1672542221,3087
7516,3484995752,3514128943,1672642137,1672643481,1344
7960,3710098970,3701190899,1672688931,1672692378,3447
7901,3488244966,3793962300,1672577840,1672580672,2832
7672,3280599164,3378436155,1672617700,1672617936,236
7773,3755625324,3339907603,1672608008,1672611020,3012
7624,3756930948,3793389510,1672559758,1672560627,869
7555,3291227780,3899204805,1672647779,1672649506,1727
7724,3734496778,3701967560,1672625220,1672628357,3137
7826,3605726278,3779629905,1672667501,1672667652,151
7935,3614238812,3703718151,1672698410,1672700375,1965
7675,3500374658,3512217942,1672543155,1672545402,2247
7529,3793627961,3534424200,1672633301,1672634903,1602
7919,3883551721,3911245524,1672617726,1672618356,630
7589,3713208927,3406784491,1672634087,1672634316,229
7830,3774793839,3511687358,1672637824,1672638711,887
7699,3909331423,3344019610,1672535778,1672536304,526
7911,3433804879,3296471982,1672615886,1672616611,725
7808,3914290246,3448855696,1672611787,1672614930,3143
7643,3715981584,3734496778,1672603127,1672605367,2240
7614,3792789881,3921211276,1672534594,1672535683,1089
7759,3505702787,3932051427,1672561665,1672561737,72
7498,3793627961,3739106581,1672603335,1672604399,1064
7681,3774793839,3510771358,1672536882,1672537170,288
7606,3510126867,3600647945,1672570922,1672573023,2101
7539,3811694763,3760489031,1672632428,1672634916,2488
7598,3730517636,3778980116,1672621607,1672622982,1375
7526,3509604974,3510937904,1672611469,1672611992,523
7539,3206603608,3827626797,1672535994,1672538901,2907
7595,3793848402,3802367797,1672540379,1672543247,2868
7661,3222448362,3774556560,1672693015,1672696124,3109
7579,3898995675,3774501422,1672587041,1672589452,2411
7530,3362000049,3925402713,1672537215,1672539857,2642
7803,3201848640,3367902229,1672649833,1672650480,647
7662,3667680268,3793436995,1672619562,1672621595,2033
7512,3701898991,3511271692,1672626193,1672626266,73
7490,3757602960,3617055293,1672644205,1672647458,3253
7617,3303705369,3777776687,1672541502,1672542897,1395
7490,3222521619,3772309150,1672627318,1672630650,3332
7712,3792288302,3626156564,1672685807,1672687352,1545
7782,3510247121,3711198793,1672643861,1672647058,3197
7862,3714474557,3637008488,1672641536,1672644391,2855
7671,3500177712,3791115967,1672635996,1672636815,819
7534,3288764520,3757562897,1672681835,1672683729,1894
7769,3760992710,3852391257,1672700865,1672703208,2343
7792,3516960534,3477375368,1672699368,1672699952,584
7564,3501486692,3505477652,1672615441,1672616849,1408
7786,3760489031,3777929708,1672533473,1672534567,1094
7776,3922275416,3478194807,1672673011,1672675824,2813
7547,3772544062,3475258557,1672669608,1672671445,1837
7720,3365830990,3534488837,1672670086,1672671968,1882
7714,3918247820,3778980116,1672656966,1672660423,3457
7702,3756462516,3783705817,1672698958,1672701255,2297
7971,3518014636,3793436995,1672590179,1672592901,2722
7510,3510247121,3710112546,1672579850,1672581855,2005
7601,3512969370,3779218771,1672660342,1672663609,3267
7970,3939952128,3783206719,1672626983,1672628179,1196
7653,3520030713,3394539273,1672624788,1672626805,2017
7790,3779218771,3904408902,1672600482,1672602576,2094
7767,3924549929,3701111745,1672614266,1672615071,805
7780,3701534009,3688418210,1672558725,1672560134,1409
7959,3738502357,3311603601,1672700314,1672700566,252
7668,3383661227,3975287541,1672586138,1672587479,1341
7545,3505702787,3433804879,1672597160,1672598869,1709
7509,3715339701,3773664987,1672533716,1672536668,2952
7490,3857349323,3703275621,1672643183,1672645322,2139
7876,3736786443,3918247820,1672539680,1672542563,2883
7821,3851190615,3772758337,1672633602,1672634992,1390
7942,3407725581,3388286531,1672581070,1672581990,920
7612,3397418363,3703441914,1672611566,1672613410,1844
7744,3755392666,3793086311,1672681557,1672682302,745
7601,3792384220,3438645253,1672629313,1672630270,957
7932,3388637594,3409474775,1672603137,1672604553,1416
7545,3505292701,3791874383,1672601509,1672603540,2031
7619,3756424865,3710067113,1672671908,1672672489,581
7560,3823600322,3783429780,1672563514,1672566074,2560
7737,3511163800,3238712269,1672627430,1672630599,3169
7635,3617055293,3634340855,1672604248,1672606260,2012
7562,3610348516,3206603608,1672650872,1672651627,755
7798,3791997875,3229665776,1672540385,1672541691,1306
7639,3346327502,3311761694,1672656148,1672659476,3328
7758,3710067113,3287105466,1672600003,1672601317,1314
7712,3701984666,3780593036,1672651869,1672654627,2758
7783,3533927138,3356860407,1672667955,1672670006,2051
7611,3899371911,3315583351,1672688681,1672691116,2435
7816,3500458761,3348261553,1672629224,1672631989,2765
7786,3978105277,3533025282,1672684488,1672684812,324
7771,3626156564,3312664885,1672559677,1672562636,2959
7642,3505635228,3311415018,1672568942,1672572013,3071
7630,3475258557,3313541986,1672673021,1672674930,1909
7982,3778780511,3736229191,1672680128,1672683535,3407
7779,3886298125,3278365525,1672652427,1672653909,1482
7812,3774005526,3780914982,1672615440,1672618160,2720
7934,3512510536,3772884106,1672592795,1672594689,1894
7880,3439023335,3776338577,1672566400,1672567100,700
7610,3792768129,3757455053,1672572586,1672573525,939
7488,3418534998,3882997884,1672640228,1672641922,1694
7679,3298433163,3757602960,1672648526,1672648767,241
7616,3311648200,3701691675,1672696008,1672696366,358
7811,3837094550,3755042098,1672670678,1672672534,1856
7778,3791334389,3774268456,1672698400,1672699939,1539
7738,3314245084,3703889596,1672595430,1672595621,191
7755,3311871871,3920801189,1672598962,1672601951,2989
7522,3387674757,3660493209,1672582359,1672582804,445
7633,3773205565,3533280269,1672553198,1672554664,1466
7910,3391915121,3509907947,1672601108,1672604089,2981
7956,3227158514,3512720680,1672557229,1672558891,1662
7981,3222448362,3517721725,1672699672,1672699770,98
7544,3311065516,3618045231,1672542047,1672542563,516
7757,3311845971,3384240055,1672695119,1672698053,2934
7709,3291227780,3783429780,1672584810,1672586908,2098
7750,3511163800,3514987389,1672692658,1672695590,2932
7812,3311415018,3517077106,1672655061,1672655411,350
7910,3925620998,3668005723,1672576476,1672577840,1364
7974,3783245561,3682061100,1672622560,1672624986,2426
7893,3777983879,3682061100,1672618445,1672620838,2393
7645,3364543015,3604539807,1672603332,1672603725,393
7548,3514987389,3208844525,1672677141,1672677733,592
7972,3772578994,3420432297,1672537639,1672539837,2198
7526,3500229033,3514719601,1672539360,1672541384,2024
7543,3716258994,3791602225,1672663410,1672665592,2182
7686,3882242815,3890149705,1672569075,1672571355,2280
7805,3777806071,3520165601,1672615609,1672616971,1362
7746,3220716272,3424922204,1672631401,1672634345,2944
7705,3559110998,3505145247,1672578837,1672580916,2079
7886,3511332835,3610348516,1672643785,1672643898,113
7753,3827222533,3391261292,1672657689,1672658373,684
7571,3331845324,3505530961,1672612798,1672615919,3121
7770,3249401741,3714474557,1672683894,1672687403,3509
7550,3772309166,3901990690,1672605640,1672608216,2576
7772,3349613093,3614238812,1672552867,1672556083,3216
7733,3978115672,3516909237,1672702294,1672703698,1404
7889,3773120434,3516606733,1672579517,1672582256,2739
7730,3516673015,3518408774,1672593388,1672593880,492
7661,3855000166,3777936328,1672618905,1672619502,597
7857,3774520233,3793338102,1672564379,1672567177,2798
7958,3519700826,3520730271,1672679125,1672681246,2121
7550,3666506258,3415443558,1672666269,1672666345,76
7530,3713808837,3755881905,1672581759,1672584949,3190
7884,3837094550,3533193862,1672679571,1672681994,2423
7755,3822654369,3513201436,1672636339,1672637616,1277
7795,3888559320,3420700674,1672591015,1672594318,3303
7963,3520376528,3307512479,1672703700,1672706658,2958
7570,3793338102,3736625083,1672590753,1672592731,1978
7820,3396086535,3936227020,1672541162,1672542499,1337
7863,3734828619,3703013906,1672701761,1672701834,73
7578,3885897503,3756528686,1672662275,1672665250,2975
7846,3710112546,3616944364,1672701598,1672704472,2874
7650,3307097200,3200691026,1672633160,1672636330,3170
7951,3511359172,3311274543,1672689447,1672692122,2675
7636,3501486692,3294803686,1672686083,1672687667,1584
7625,3716843669,3505962865,1672661006,1672664459,3453
7550,3232962003,3783705817,1672630299,1672631952,1653
7876,3714474557,3311603601,1672543777,1672545404,1627
7720,3519703355,3432665384,1672625838,1672628214,2376
7512,3400918687,3512166013,1672636897,1672638748,1851
7865,3774127586,3783126683,1672702813,1672705391,2578
7913,3475258557,3280964728,1672538741,1672539109,368
7793,3533927138,3667680268,1672674490,1672675797,1307
7806,3793338102,3813052709,1672688812,1672689232,420
7571,3703223015,3208844525,1672582590,1672583373,783
7533,3311324983,3780593036,1672606085,1672608573,2488
7662,3513201436,3518791447,1672560154,1672563599,3445
7726,3430074045,3201432789,1672594755,1672597690,2935
7705,3518014636,3244436890,1672658526,1672661204,2678
7713,3904775198,3222521619,1672612816,1672615000,2184
7811,3901990690,3773950140,1672700024,1672701340,1316
7914,3505362057,3925402713,1672677852,1672679018,1166
7849,3922275620,3391915121,1672695941,1672697471,1530
7812,3518014404,3500729955,1672586804,1672589935,3131
7677,3774520233,3701184889,1672573044,1672574263,1219
7607,3685818092,3859663348,1672672117,1672672651,534
7801,3448855696,3732481297,1672609096,1672612573,3477
7627,3774556560,3792473331,1672693758,1672696004,2246
7940,3519912874,3448855696,1672681346,1672682120,774
7862,3399535232,3714474557,1672633007,1672634062,1055
7624,3811171116,3489545239,1672626463,1672628079,1616
7700,3624761861,3972364603,1672659269,1672660105,836
7774,3417970574,3349613093,1672563970,1672564175,205
7588,3774268456,3244436890,1672658474,1672660713,2239
7517,3505362057,3400804807,1672691943,1672693424,1481
7930,3509453566,3451432842,1672589924,1672592669,2745
7774,3510380060,3774195321,1672699981,1672703157,3176
7601,3505477652,3757246925,1672702236,1672702478,242
7672,3607178184,3916289176,1672568491,1672569346,855
7927,3713370078,3701967560,1672637155,1672637629,474
7654,3311154569,3209551760,1672662318,1672665264,2946
7670,3716488385,3703441914,1672632780,1672634160,1380
7559,3394330287,3399911573,1672654618,1672656469,1851
7834,3500729955,3519428855,1672590758,1672592136,1378
7593,3756528686,3621810464,1672628908,1672629192,284
7739,3855602893,3247815299,1672569759,1672571075,1316
7908,3701146057,3513080274,1672659937,1672663417,3480
7642,3701146057,3760077057,1672578849,1672579998,1149
7606,3512969370,3711504540,1672645471,1672648272,2801
7585,3501364586,3501364586,1672582564,1672584729,2165
7519,3783196518,3515691540,1672584064,1672585804,1740
7559,3756424865,3772714862,1672678965,1672679094,129
7727,3516258476,3828624701,1672610184,1672612866,2682
7880,3791594391,3829319703,1672616972,1672617739,767
7544,3291235378,3500578848,1672696222,1672697670,1448
7756,3489962019,3937224533,1672579711,1672579930,219
7919,3701184889,3715189301,1672565105,1672567412,2307
7576,3715581279,3509773875,1672611786,1672615110,3324
7752,3777717988,3429856982,1672560421,1672562782,2361
7496,3757151210,3511435497,1672588690,1672591654,2964
7522,3924549929,3475396323,1672684575,1672684897,322
7798,3515284591,3739106581,1672616739,1672619683,2944
7942,3291883916,3235287260,1672536287,1672538588,2301
7884,3791594391,3882997884,1672634864,1672636067,1203
7762,3394330287,3903962771,1672597677,1672600301,2624
7616,3735319397,3510857360,1672559417,1672562996,3579
7667,3777443199,3716258994,1672679382,1672679778,396
7738,3511359172,3349613093,1672612005,1672613441,1436
7644,3505193212,3601879040,1672559883,1672560172,289
7775,3780503655,3918247820,1672538596,1672540215,1619
7855,3628819436,3500229033,1672549051,1672550102,1051
7929,3509604974,3760077057,1672590082,1672591312,1230
7755,3931941795,3533242305,1672592441,1672594301,1860
7658,3935627557,3776948966,1672641723,1672644924,3201
7616,3777120536,3793627961,1672557596,1672559436,1840
7857,3756966035,3616944364,1672672059,1672674457,2398
7554,3793627961,3791957752,1672583790,1672585005,1215
7609,3774793839,3714821932,1672613501,1672614995,1494
7698,3757455053,3520030713,1672670505,1672671227,722
7610,3777514571,3280599164,1672553097,1672553568,471
7931,3505098372,3377766165,1672609448,1672610710,1262
7805,3703013906,3234362962,1672583617,1672585292,1675
7594,3780593036,3701178711,1672691078,1672693647,2569
7647,3520730271,3401627165,1672573083,1672576637,3554
7943,3516673015,3500229033,1672666999,1672667499,500
7866,3533137446,3770021824,1672554247,1672556516,2269
7729,3780294829,3380035798,1672617122,1672618501,1379
7559,3711569060,3388372715,1672588644,1672591168,2524
7965,3475251781,3918674986,1672551390,1672551700,310
7755,3899266183,3827377568,1672541759,1672543826,2067
7501,3715998609,3388637594,1672569428,1672572877,3449
7935,3755798867,3757246925,1672698683,1672699812,1129
7693,3880310724,3792384220,1672682740,1672683227,487
7603,3384240055,3488244966,1672669196,1672670057,861
7536,3772309150,3505203158,1672702624,1672705188,2564
7609,3511841857,3221899927,1672631965,1672632528,563
7683,3220716272,3885670556,1672693978,1672696772,2794
7801,3713786889,3917088658,1672632872,1672634857,1985
7837,3438645253,3911245524,1672585472,1672588283,2811
7604,3852391257,3533810360,1672607696,1672611275,3579
7904,3284832486,3360506772,1672633567,1672635455,1888
7878,3505702787,3512166013,1672631162,1672634166,3004
7663,3902383721,3770635361,1672551958,1672552493,535
7678,3399535232,3780609808,1672595874,1672597738,1864
7649,3800353779,3510703546,1672557438,1672560686,3248
7587,3411618230,3518408774,1672643017,1672645965,2948
7780,3511862351,3513454145,1672665517,1672666459,942
7830,3735319397,3360743849,1672587276,1672587972,696
7777,3518791447,3467773920,1672678800,1672681441,2641
7904,3852391257,3515691540,1672623929,1672624213,284
7517,3500805881,3466911760,1672686957,1672688429,1472
7679,3514245078,3829319703,1672649520,1672650083,563
7566,3520719611,3360506772,1672614103,1672615451,1348
7893,3519654779,3716197887,1672631012,1672634545,3533
7576,3497901842,3509933351,1672585016,1672585197,181
7650,3311203656,3500199935,1672675776,1672676954,1178
7875,3629547065,3404058699,1672653718,1672656569,2851
7963,3855424474,3505135325,1672669746,1672672192,2446
7587,3804870229,3701111745,1672551823,1672555238,3415
7845,3360993964,3416427576,1672604103,1672604586,483
7769,3716537575,3601879040,1672564637,1672567923,3286
7787,3899371911,3514283243,1672657357,1672659560,2203
7580,3312333615,3711262377,1672644340,1672647618,3278
7512,3510126867,3391915886,1672689153,1672691107,1954
7840,3480687894,3311208440,1672661497,1672662395,898
7719,3882291183,3683766533,1672540912,1672541000,88
7906,3510937904,3773755137,1672692237,1672695356,3119
7740,3734828619,3780788622,1672653675,1672654285,610
7505,3511125626,3639847263,1672564444,1672566765,2321
7876,3518408774,3206593906,1672538353,1672538771,418
7686,3760598102,3231056870,1672570639,1672573427,2788
7757,3710067113,3776948966,1672601635,1672602602,967
7644,3793871337,3397418363,1672575919,1672579371,3452
7652,3731419510,3280615985,1672588551,1672591266,2715
7523,3760598102,3550946908,1672692031,1672692926,895
7797,3236102733,3772758337,1672700173,1672701308,1135
7859,3390068992,3331845324,1672569162,1672571131,1969
7668,3736625083,3634995491,1672610245,1672613215,2970
7535,3777443199,3714962248,1672562362,1672562755,393
7763,3516606733,3887270940,1672683687,1672685368,1681
7834,3510937904,3791942683,1672683456,1672685953,2497
7712,3246596716,3533270638,1672633250,1672636774,3524
7515,3365942576,3229058858,1672586404,1672587581,1177
7664,3392121505,3601879040,1672693796,1672694687,891
7776,3319752091,3336751428,1672689590,1672692018,2428
7981,3933210486,3399052055,1672625545,1672626917,1372
7770,3550946908,3396086535,1672613961,1672614257,296
7643,3756462516,3293695955,1672659914,1672661166,1252
7728,3242408357,3701111745,1672624553,1672627096,2543
7818,3533369198,3360993964,1672664008,1672666905,2897
7884,3731419510,3559110998,1672609054,1672611795,2741
7955,3533371364,3209383861,1672646772,1672647861,1089
7916,3703871468,3351554343,1672650196,1672652330,2134
7854,3426325549,3772337814,1672629021,1672631986,2965
7629,3914259449,3417587765,1672566954,1672569608,2654
7980,3396086535,3791553060,1672686724,1672689175,2451
7532,3512166013,3500458761,1672583157,1672586338,3181
7982,3913251733,3891751546,1672560205,1672562129,1924
7769,3238712269,3511125626,1672631897,1672633353,1456
7825,3407725581,3516016437,1672612968,1672616310,3342
7572,3793338102,3439023335,1672617585,1672621029,3444
7729,3517721725,3284832486,1672551277,1672553597,2320
7629,3467773920,3500391167,1672554519,1672556360,1841
7607,3534702203,3937224533,1672635943,1672638383,2440
7794,3286658957,3509630174,1672594831,1672595654,823
7798,3755392666,3505219850,1672564626,1672568050,3424
7911,3244173074,3772884106,1672602822,1672603689,867
7638,3774501422,3411618230,1672586365,1672586512,147
7757,3534729133,3505292701,1672634348,1672634672,324
7620,3792253549,3496549058,1672672663,1672673678,1015
7800,3500578848,3825229501,1672683446,1672686622,3176
7691,3520719611,3636867411,1672578686,1672581469,2783
7804,3533025282,3713208927,1672549655,1672550106,451
7814,3242408357,3533385867,1672703024,1672706026,3002
7501,3773429448,3710067113,1672551171,1672553721,2550
7709,3816853177,3793871337,1672666744,1672669310,2566
7593,3244389794,3378092448,1672657572,1672659559,1987
7793,3682061100,3903962771,1672585231,1672586366,1135
7695,3311090974,3311324983,1672548214,1672551307,3093
7651,3344364444,3510173870,1672641978,1672643393,1415
7684,3779629905,3235635976,1672658405,1672659805,1400
7761,3302626661,3783531004,1672690206,1672692180,1974
7687,3534492426,3604539807,1672690384,1672691514,1130
7586,3505145247,3389115045,1672545667,1672549050,3383
7911,3316173088,3519601612,1672658569,1672661860,3291
7673,3510594211,3701065786,1672582630,1672584271,1641
7944,3271938399,3482405588,1672573889,1672575211,1322
7603,3517509185,3454042520,1672678209,1672680712,2503
7832,3924549929,3516673015,1672642212,1672643789,1577
7876,3756027749,3501198706,1672555564,1672557187,1623
7579,3505135325,3475251781,1672582629,1672585475,2846
7732,3710067113,3913251733,1672638910,1672642477,3567
7954,3736229191,3485375593,1672636429,1672637008,579
7763,3779218771,3512142794,1672536365,1672536975,610
7891,3432689543,3349613093,1672606239,1672609669,3430
7787,3331845324,3352603894,1672677545,1672679500,1955
7884,3418534998,3780609808,1672666810,1672667344,534
7922,3520190170,3804870229,1672630496,1672633477,2981
7746,3249791738,3222448362,1672532725,1672534254,1529
7917,3313564074,3925402713,1672661990,1672662749,759
7873,3209027249,3511312803,1672606029,1672606129,100
7818,3756930948,3554917400,1672603625,1672606748,3123
7661,3244485293,3432689543,1672546502,1672547957,1455
7811,3615046771,3793436995,1672631329,1672633585,2256
7886,3756601594,3627937312,1672636010,1672636647,637
7562,3777776687,3783705817,1672678141,1672681446,3305
7565,3755798867,3688418210,1672610337,1672612074,1737
7818,3297463265,3385763781,1672648710,1672651569,2859
7602,3496051529,3912536808,1672680417,1672683776,3359
7930,3760183458,3512510536,1672684416,1672685544,1128
7954,3756528686,3244436890,1672699794,1672700634,840
7576,3714821932,3316173088,1672540116,1672540566,450
7950,3374559242,3839849341,1672602135,1672604576,2441
7818,3505869747,3899266183,1672623556,1672627134,3578
7770,3286658957,3400804807,1672647701,1672648412,711
7590,3509773875,3483164654,1672554376,1672557080,2704
7781,3931941795,3517459919,1672696642,1672698358,1716
7646,3438645253,3533810360,1672689105,1672689688,583
7983,3715127362,3805342762,1672598591,1672599958,1367
7746,3772337814,3513454145,1672650935,1672654531,3596
7798,3716746253,3931941795,1672591857,1672592963,1106
7926,3755872268,3500199935,1672622234,1672623878,1644
7661,3519912874,3852595551,1672703995,1672706832,2837
7545,3885670556,3783083229,1672668510,1672670806,2296
7762,3246596716,3429690204,1672562104,1672563178,1074
7776,3370752401,3774556560,1672586104,1672586888,784
7946,3783779671,3607178184,1672678035,1672679377,1342
7592,3634786711,3500374658,1672616608,1672619023,2415
7904,3501730685,3737051610,1672586437,1672587002,565
7725,3837094550,3242408357,1672612328,1672613126,798
7911,3807987001,3228165483,1672702525,1672704240,1715
7981,3780639480,3372883226,1672648183,1672649176,993
7668,3715492942,3513164386,1672679008,1672680707,1699
7965,3500487333,3711569060,1672653163,1672654032,869
7581,3485823740,3337544549,1672578796,1672579123,327
7926,3533927138,3500578848,1672607868,1672608847,979
7726,3755881905,3883861463,1672645316,1672647713,2397
7726,3509604974,3760294205,1672671212,1672671675,463
7770,3428006164,3668005723,1672686672,1672689981,3309
7672,3783509527,3601879040,1672615163,1672616688,1525
7821,3883861463,3500391167,1672660635,1672660999,364
7691,3489728806,3774125065,1672633708,1672634593,885
7897,3405494240,3755920131,1672657759,1672658391,632
7739,3793848402,3312829208,1672556221,1672558946,2725
7949,3716168623,3505791599,1672581343,1672583220,1877
7726,3482405588,3711308224,1672643071,1672644640,1569
7699,3512683609,3229665776,1672662031,1672664255,2224
7488,3311152102,3500177712,1672691169,1672693600,2431
7906,3809916577,3501692334,1672602345,1672603941,1596
7614,3774010081,3311154569,1672560028,1672561061,1033
7915,3770078063,3534553510,1672612068,1672615463,3395
7675,3757602960,3829764737,1672686942,1672688502,1560
7657,3757602960,3534553510,1672541263,1672544257,2994
7625,3518669703,3772758337,1672692395,1672693199,804
7653,3902383721,3773598056,1672695679,1672696624,945
7499,3512217942,3518014404,1672570566,1672571940,1374
7704,3293695955,3209027249,1672551688,1672554952,3264
7514,3520719611,3624761861,1672606823,1672609754,2931
7687,3311993075,3776948966,1672680733,1672684269,3536
7966,3685187183,3510703546,1672612472,1672615968,3496
7504,3828432634,3477375368,1672652958,1672654953,1995
7666,3614238812,3533385867,1672580562,1672584018,3456
7857,3760077057,3466229085,1672632361,1672633179,818
7798,3501730685,3711973519,1672670813,1672672348,1535
7904,3792844210,3760561634,1672605015,1672607272,2257
7654,3808324264,3505869747,1672618419,1672618766,347
7658,3512142794,3714962248,1672580041,1672583543,3502
7788,3607748895,3899266183,1672659222,1672661665,2443
7876,3550946908,3516011407,1672591653,1672592257,604
7505,3399535232,3512142794,1672534927,1672537169,2242
7943,3484995752,3634340855,1672640846,1672641801,955
7827,3202120784,3378092448,1672538514,1672540049,1535
7528,3710408395,3370752401,1672699940,1672700910,970
7515,3534191820,3701691675,1672694382,1672696996,2614
7755,3701534009,3912262917,1672603273,1672605377,2104
7673,3714504419,3735733948,1672690482,1672693682,3200
7517,3606812411,3792032359,1672653215,1672654398,1183
7673,3710569131,3773429448,1672543386,1672543965,579
7946,3501692334,3777806071,1672580949,1672583626,2677
7670,3716537575,3501730685,1672584386,1672587694,3308
7966,3636867411,3774268456,1672685250,1672687905,2655
7592,3231056870,3839849341,1672599636,1672601091,1455
7695,3780294829,3500499542,1672622117,1672625617,3500
7897,3880285638,3378092448,1672551136,1672554009,2873
7534,3518163778,3384951177,1672659831,1672662197,2366
7563,3418728074,3518163778,1672676688,1672678513,1825
7923,3509907947,3520183192,1672532555,1672534055,1500
7869,3394539273,3492478793,1672603002,1672605351,2349
7493,3667680268,3792384220,1672532864,1672534941,2077
7825,3417970574,3881477378,1672587488,1672590272,2784
7681,3606987130,3715981584,1672679473,1672681185,1712
7809,3618045231,3482405588,1672676602,1672678514,1912
7539,3472130842,3500904641,1672580223,1672582295,2072
7634,3834257412,3629935998,1672621750,1672622512,762
7932,3924549929,3415443558,1672701269,1672703970,2701
7578,3791997875,3505859863,1672601091,1672603970,2879
7741,3304625412,3778108318,1672651178,1672653768,2590
7867,3779629905,3276640712,1672607641,1672609326,1685
7713,3855000166,3516909237,1672620448,1672621276,828
7805,3713969578,3512540951,1672591549,1672591948,399
7945,3774580701,3311152102,1672663488,1672664696,1208
7805,3501483568,3617055293,1672625815,1672628767,2952
7639,3852595551,3634340855,1672577757,1672580614,2857
7598,3516629436,3314245084,1672652513,1672653968,1455
7863,3776066388,3519803045,1672575393,1672577032,1639
7588,3428674539,3701995648,1672695126,1672696568,1442
7521,3703789494,3793286136,1672610087,1672610402,315
7511,3520751702,3446948848,1672618965,1672622318,3353
7828,3713268590,3791957752,1672550183,1672551573,1390
7866,3338367113,3783196518,1672584044,1672586183,2139
7532,3755798867,3360506772,1672533541,1672533962,421
7564,3793848402,3380035798,1672578977,1672581797,2820
7908,3533137446,3976390453,1672595489,1672596175,686
7839,3935127663,3734828619,1672549686,1672552776,3090
7715,3973560347,3249401741,1672641618,1672642227,609
7603,3511163800,3780828689,1672611065,1672612443,1378
7497,3639847263,3475258557,1672670880,1672673271,2391
7545,3780365428,3550946908,1672693767,1672695541,1774
7953,3715581279,3711571712,1672587805,1672589748,1943
7752,3509933351,3805342762,1672552604,1672555629,3025
7829,3234541252,3756451663,1672592244,1672594738,2494
7629,3780294829,3346795719,1672662045,1672662285,240
7546,3518791447,3734737881,1672636222,1672639139,2917
7816,3407673904,3914259449,1672666615,1672668738,2123
7642,3232962003,3201324715,1672605449,1672608303,2854
7585,3332072298,3364543015,1672560761,1672560988,227
7618,3806545488,3500729955,1672623057,1672626055,2998
7546,3280615985,3377766165,1672620490,1672623483,2993
7961,3500578848,3511350608,1672563590,1672564270,680
7660,3774066725,3912536808,1672599631,1672601797,2166
7492,3433804879,3516980378,1672697294,1672697993,699
7589,3777936328,3783531004,1672680243,1672681160,917
7886,3311871871,3307512479,1672609044,1672609233,189
7607,3505292701,3516258476,1672659084,1672661192,2108
7577,3777790718,3501364586,1672672576,1672672654,78
7539,3206593906,3780294829,1672675421,1672678108,2687
7692,3418728074,3714474557,1672605898,1672606406,508
7530,3510703546,3489728806,1672540826,1672542142,1316
7609,3903962771,3851190615,1672545547,1672547918,2371
7890,3817621391,3500499542,1672682709,1672685977,3268
7527,3715981584,3817621391,1672541696,1672542544,848
7611,3378686918,3772053179,1672536478,1672537381,903
7784,3820354437,3510173870,1672549937,1672551833,1896
7522,3315583351,3774195321,1672626069,1672626842,773
7617,3904408902,3760294205,1672638040,1672638903,863
7621,3227457126,3772714862,1672602451,1672602802,351
7642,3501730685,3716165213,1672607588,1672610731,3143
7792,3303751772,3501364586,1672560823,1672561970,1147
7488,3516960534,3731419510,1672649042,1672652181,3139
7580,3716835696,3512540951,1672663768,1672665706,1938
7525,3756424865,3516960534,1672633643,1672635788,2145
7501,3446948848,3713894336,1672576515,1672577046,531
7832,3379256399,3770078063,1672569598,1672570158,560
7711,3509352754,3936227020,1672606485,1672609387,2902
7873,3811171116,3755625324,1672654408,1672654831,423
7727,3420700674,3736229191,1672685053,1672686548,1495
7587,3378092448,3701184889,1672668876,1672671876,3000
7543,3701984666,3779976989,1672682591,1672684509,1918
7883,3388637594,3793436995,1672581783,1672584436,2653
7650,3501601840,3533369198,1672584968,1672586832,1864
7843,3778980116,3917278625,1672549477,1672552134,2657
7935,3979339287,3792473331,1672621546,1672623332,1786
7543,3534492426,3224058172,1672573125,1672576604,3479
7534,3510380060,3244389794,1672622880,1672624914,2034
7770,3791594391,3800886801,1672629844,1672631333,1489
7711,3467773920,3485823740,1672592780,1672595343,2563
7877,3895562476,3829764737,1672603290,1672604998,1708
7715,3534553510,3404384505,1672626026,1672628236,2210
7801,3778980116,3858918246,1672615261,1672617362,2101
7752,3311415018,3634786711,1672558736,1672561655,2919
7610,3755587522,3202120784,1672610695,1672613171,2476
7674,3520719611,3756451663,1672644701,1672645434,733
7943,3713786889,3358871377,1672543655,1672546433,2778
7516,3792177074,3302626661,1672691698,1672694720,3022
7822,3247428249,3822654369,1672647382,1672648803,1421
7728,3617055293,3777455223,1672694541,1672694965,424
7875,3792473331,3930791338,1672696983,1672700058,3075
7695,3757447189,3622054816,1672677296,1672678417,1121
7566,3515723720,3454042520,1672703033,1672703318,285
7800,3617055293,3518876135,1672682349,1672684817,2468
7683,3313564074,3703275621,1672587644,1672589732,2088
7953,3614238812,3477375368,1672615035,1672617802,2767
7760,3793389510,3736786443,1672636660,1672638045,1385
7654,3500066230,3828624701,1672662909,1672666100,3191
7759,3716488385,3249401741,1672679193,1672679262,69
7708,3505649239,3793627961,1672563847,1672567074,3227
7720,3432665384,3234541252,1672665118,1672667928,2810
7716,3407673904,3416427576,1672694738,1672695695,957
7897,3701190899,3909606423,1672556944,1672557477,533
7901,3505973226,3552314511,1672573158,1672575213,2055
7833,3510857360,3277605882,1672623364,1672624585,1221
7811,3920801189,3500487333,1672531935,1672534765,2830
7619,3713808837,3791020967,1672539585,1672540967,1382
7766,3770635361,3500729955,1672640292,1672642120,1828
7936,3911245524,3660493209,1672615200,1672617942,2742
7648,3500229033,3901990690,1672647324,1672649288,1964
7704,3820354437,3533025282,1672570413,1672573808,3395
7567,3465254146,3779740455,1672664686,1672664758,72
7598,3515394721,3516980378,1672588469,1672591508,3039
7801,3772053179,3420432297,1672598863,1672600605,1742
7498,3772309166,3434642576,1672605417,1672606066,649
7780,3314836094,3510857360,1672686542,1672687021,479
7526,3505873261,3601879040,1672699652,1672701284,1632
7794,3234541252,3488244966,1672579431,1672580497,1066
7724,3229058858,3518496488,1672601086,1672601261,175
7925,3387674757,3617055293,1672685609,1672685991,382
7534,3703275621,3730517636,1672661219,1672663797,2578
7929,3716273414,3713786889,1672561122,1672563044,1922
7548,3513164386,3682061100,1672623008,1672625989,2981
7878,3389115045,3513454145,1672682147,1672682333,186
7690,3511170269,3394539273,1672606034,1672607667,1633
7885,3509672210,3518408774,1672544189,1672545896,1707
7518,3501184421,3716746253,1672640405,1672643905,3500
7811,3505791599,3772746272,1672609094,1672609836,742
7929,3976390453,3883861463,1672561869,1672564017,2148
7813,3505912939,3711380716,1672578029,1672579048,1019
7640,3883085535,3791942683,1672577687,1672578635,948
7499,3791594391,3600647945,1672622888,1672624049,1161
7633,3826760240,3685818092,1672695946,1672697729,1783
7808,3664517356,3909606423,1672552025,1672555088,3063
7951,3520888296,3774556560,1672696645,1672699236,2591
7658,3774195321,3827626797,1672689110,1672691816,2706
7824,3374559242,3780828689,1672670736,1672672668,1932
7895,3607748895,3509453566,1672690687,1672693753,3066
7738,3777936328,3492478793,1672531905,1672535342,3437
7536,3735733948,3550946908,1672572486,1672574770,2284
7850,3370752401,3760077057,1672557149,1672559272,2123
7628,3496269445,3829319703,1672610803,1672614218,3415
7569,3377766165,3276993580,1672548283,1672548666,383
7555,3777717988,3773755137,1672699416,1672699609,193
7817,3716843669,3487171044,1672547959,1672549511,1552
7710,3515394721,3389115045,1672594319,1672594672,353
7494,3501692334,3483949762,1672571135,1672574473,3338
7514,3703223015,3415546117,1672673594,1672675500,1906
7601,3826633236,3509630174,1672653628,1672654773,1145
7537,3311415018,3792384220,1672699873,1672701628,1755
7852,3855937514,3701691675,1672632393,1672633964,1571
7970,3922337974,3757246925,1672604767,1672608332,3565
7629,3780365428,3276993580,1672689327,1672691065,1738
7818,3514987389,3388372715,1672586713,1672588743,2030
7621,3500803339,3505219850,1672683523,1672683777,254
7661,3774195321,3883861463,1672680459,1672682940,2481
7890,3520730271,3402943525,1672611097,1672612621,1524
7733,3912262917,3809484172,1672643174,1672645936,2762
7497,3512217942,3703275621,1672533705,1672537121,3416
7730,3773120434,3516011407,1672691327,1672694067,2740
7742,3606812411,3636867411,1672581150,1672582274,1124
7524,3236102733,3701995648,1672573918,1672576807,2889
7837,3443698222,3336742544,1672556694,1672559837,3143
7806,3360743849,3432665384,1672683256,1672683884,628
7508,3388372715,3783531004,1672548275,1672550719,2444
7524,3703223015,3715339701,1672650504,1672652636,2132
7792,3903009525,3344019610,1672703038,1672704514,1476
7634,3513454145,3779976989,1672551345,1672553152,1807
7981,3685818092,3891751546,1672644221,1672645196,975
7726,3822654369,3396285984,1672565597,1672566227,630
7709,3881477378,3760183458,1672607589,1672609359,1770
7950,3516065852,3639847263,1672667811,1672670800,2989
7913,3509634629,3731106822,1672540978,1672543382,2404
7664,3209383861,3737079798,1672587691,1672590368,2677
7933,3859663348,3465254146,1672565682,1672567904,2222
7491,3851190615,3496269445,1672600431,1672603859,3428
7924,3710067113,3428674539,1672551792,1672553641,1849
7578,3755042098,3711262377,1672550705,1672553441,2736
7613,3505530961,3505173328,1672596262,1672599851,3589
7516,3913251733,3505477652,1672682097,1672683030,933
7615,3484995752,3774010081,1672659340,1672662910,3570
7747,3912536808,3344364444,1672678869,1672680155,1286
7558,3826760240,3710408395,1672551211,1672553019,1808
7705,3891751546,3318697153,1672537729,1672540043,2314
7663,3501198706,3914290246,1672677087,1672680414,3327
7600,3731419510,3367902229,1672630065,1672630589,524
7847,3714504419,3976633198,1672578979,1672580864,1885
7539,3683959482,3377766165,1672571939,1672572175,236
7794,3668005723,3298433163,1672539804,1672540535,731
7911,3972709319,3517476351,1672632195,1672632740,545
7638,3882997884,3604539807,1672626620,1672628083,1463
7497,3600647945,3793962300,1672626010,1672629159,3149
7948,3685187183,3902383721,1672695514,1672697212,1698
7573,3465254146,3500365158,1672598071,1672600309,2238
7707,3608868877,3713808837,1672686801,1672690385,3584
7595,3533827120,3716746253,1672636753,1672638879,2126
7799,3711571712,3534492426,1672686460,1672689753,3293
7922,3710344260,3249401741,1672618184,1672618794,610
7653,3791657947,3683766533,1672671885,1672675256,3371
7613,3600647945,3400918687,1672548071,1672551264,3193
7930,3505000737,3618873142,1672620347,1672621761,1414
7639,3710112546,3901990690,1672568346,1672569975,1629
7485,3776338577,3485008994,1672647362,1672648870,1508
7806,3336751428,3716843669,1672594064,1672597169,3105
7786,3973560347,3516606733,1672661299,1672662543,1244
7562,3311208440,3701995648,1672553076,1672553385,309
7919,3496051529,3311993075,1672584387,1672585560,1173
7734,3277605882,3505219850,1672607366,1672608296,930
7543,3500994774,3770021824,1672683551,1672687017,3466
7909,3490191091,3407725581,1672597104,1672598687,1583
7897,3416241005,3416241005,1672685739,1672688286,2547
7920,3770078063,3901990690,1672538229,1672540727,2498
7630,3516716179,3500729955,1672577934,1672579882,1948
7859,3792177074,3482405588,1672662026,1672662672,646
7974,3358871377,3517509185,1672692456,1672692744,288
7521,3921211276,3510594211,1672674749,1672675018,269
7575,3755392666,3912262917,1672665233,1672666430,1197
7928,3756453423,3387966152,1672572807,1672573070,263
7673,3777443199,3808324264,1672584531,1672586864,2333
7932,3912262917,3466229085,1672652958,1672655527,2569
7564,3208844525,3756451663,1672669881,1672672739,2858
7854,3510771358,3516606733,1672692569,1672693639,1070
7667,3770447408,3311718847,1672544481,1672545095,614
7713,3208844525,3518669703,1672548316,1672550544,2228
7509,3517459919,3660493209,1672662339,1672665733,3394
7748,3303705369,3478194807,1672566025,1672569477,3452
7975,3221899927,3885670556,1672583942,1672585559,1617
7911,3777514571,3703789494,1672550844,1672554044,3200
7739,3459030804,3608633356,1672681755,1672684419,2664
7489,3519152550,3407725581,1672656903,1672659352,2449
7835,3497901842,3688418210,1672589362,1672591403,2041
7758,3756966035,3634786711,1672636773,1672639934,3161
7791,3760893269,3779740455,1672552135,1672554171,2036
7633,3624761861,3823600322,1672613204,1672614854,1650
7941,3513956646,3351554343,1672624160,1672625056,896
7723,3918584946,3772337814,1672536243,1672536414,171
7746,3922275620,3783196518,1672560642,1672563300,2658
7527,3312829208,3731106822,1672544335,1672545402,1067
7902,3511350608,3755872268,1672584629,1672587401,2772
7635,3318697153,3394539273,1672545955,1672547278,1323
7721,3739106581,3511163800,1672694612,1672697051,2439
7759,3755392666,3628819436,1672587890,1672589573,1683
7516,3701111745,3772578994,1672701150,1672702760,1610
7812,3505635228,3827222533,1672677168,1672679126,1958
7766,3519912874,3770553384,1672633788,1672634499,711
7538,3881477378,3221536550,1672646455,1672647470,1015
7627,3777443199,3509634629,1672654389,1672654646,257
7678,3774045700,3783083229,1672691925,1672693137,1212
7716,3711265369,3360506772,1672625258,1672626974,1716
7631,3365614305,3311274543,1672673111,1672676548,3437
7912,3509634629,3311324983,1672559143,1672562689,3546
7822,3757447189,3342131135,1672696055,1672698469,2414
7533,3515151980,3774050956,1672541926,1672544172,2246
7521,3388637594,3397418363,1672675723,1672677876,2153
7568,3920801189,3351554343,1672608875,1672609133,258
7786,3516673015,3755625324,1672697865,1672699095,1230
7885,3773120434,3820354437,1672630495,1672631075,580
7486,3384951177,3389115045,1672651073,1672651146,73
7791,3509630174,3811171116,1672670050,1672670888,838
7496,3606186086,3757455053,1672539387,1672540296,909
7881,3703275621,3898995675,1672682221,1672684813,2592
7888,3311603601,3519556068,1672645909,1672647351,1442
7582,3505702787,3774066725,1672664149,1672664884,735
7578,3390068992,3760077057,1672535210,1672538083,2873
7763,3533280269,3418534998,1672670397,1672672262,1865
7810,3287105466,3505530961,1672669252,1672671784,2532
7901,3791874383,3518260334,1672561350,1672563472,2122
7760,3519601612,3774793839,1672650452,1672650812,360
7826,3490191091,3421836608,1672573850,1672576621,2771
7736,3351008918,3346327502,1672650119,1672652778,2659
7910,3430504438,3244436890,1672648094,1672650711,2617
7896,3223789409,3201324715,1672666983,1672669890,2907
7760,3757812939,3756966035,1672655119,1672657109,1990
7764,3401627165,3365830990,1672639161,1672642236,3075
7983,3882242815,3416241005,1672610154,1672613638,3484
7885,3277605882,3311152102,1672675748,1672677729,1981
7775,3311627628,3713208927,1672653791,1672654974,1183
7851,3792844210,3855424474,1672652868,1672655398,2530
7577,3918056059,3500487333,1672683960,1672685632,1672
7550,3301107849,3904408902,1672551793,1672554508,2715
7975,3505883609,3378686918,1672638866,1672641019,2153
7712,3756424865,3516223597,1672612792,1672613278,486
7729,3735733948,3637008488,1672564523,1672565506,983
7693,3244485293,3791942683,1672658621,1672659319,698
7797,3783429780,3777776687,1672628362,1672628848,486
7978,3703718151,3802367797,1672545830,1672547606,1776
7823,3757562897,3701111745,1672592169,1672595439,3270
7506,3909331423,3420432297,1672661401,1672662473,1072
7913,3791020967,3886298125,1672693433,1672693595,162
7578,3783705817,3931941795,1672576874,1672577390,516
7804,3500066230,3903962771,1672581913,1672583768,1855
7589,3314245084,3778780511,1672586365,1672588648,2283
7898,3886298125,3618873142,1672568434,1672568575,141
7537,3701184889,3430504438,1672589426,1672592256,2830
7826,3615046771,3388637594,1672683159,1672684394,1235
7647,3517509185,3356860407,1672645992,1672648971,2979
7837,3713370078,3405494240,1672574073,1672575830,1757
7646,3287105466,3303751772,1672583557,1672586095,2538
7881,3505599848,3356860407,1672644763,1672646137,1374
7971,3772544062,3701274634,1672579814,1672582362,2548
7731,3429690204,3904408902,1672693874,1672694698,824
7492,3344364444,3236102733,1672541487,1672543986,2499
7948,3792844210,3777079686,1672532927,1672534735,1808
7709,3925402713,3430074045,1672612769,1672613417,648
7852,3533827120,3773755137,1672676883,1672679562,2679
7562,3206254161,3311439795,1672645304,1672646307,1003
7786,3378686918,3344019610,1672688016,1672691434,3418
7978,3607178184,3360993964,1672595630,1672598994,3364
7753,3793389510,3505145247,1672605670,1672605883,213
7787,3505702787,3501730685,1672537604,1672539275,1671
7713,3772578994,3904775198,1672602824,1672604504,1680
7940,3415443558,3378436155,1672661298,1672662291,993
7788,3628819436,3430352815,1672614356,1672615623,1267
7976,3888559320,3816853177,1672611026,1672611999,973
7571,3485375593,3475258557,1672650441,1672651611,1170
7736,3311274543,3512540951,1672531818,1672533008,1190
7584,3421127249,3484995752,1672620682,1672623862,3180
7772,3930791338,3634786711,1672693111,1672694757,1646
7739,3534424200,3383922351,1672555399,1672557267,1868
7662,3510594211,3244436890,1672548369,1672548910,541
7970,3701984666,3713644518,1672543840,1672544565,725
7793,3500729955,3756462516,1672567351,1672569114,1763
7954,3716488385,3913251733,1672697188,1672699903,2715
7733,3626156564,3516016437,1672663495,1672663851,356
7974,3200691026,3273500349,1672581121,1672582537,1416
7811,3793470489,3703275621,1672658758,1672660038,1280
7965,3500365158,3289061738,1672695761,1672698413,2652
7497,3713630656,3392121505,1672583817,1672584919,1102
7687,3791334389,3701498253,1672692063,1672692786,723
7539,3209027249,3792177074,1672643391,1672646590,3199
7811,3939952128,3774268456,1672671940,1672675439,3499
7743,3534488837,3935127663,1672661262,1672664001,2739
7719,3222448362,3737051610,1672671035,1672674320,3285
7954,3278365525,3481647420,1672601547,1672603795,2248
7818,3415443558,3404384505,1672586831,1672588945,2114
7795,3756453423,3633420270,1672629300,1672630645,1345
7545,3223968713,3779976989,1672536446,1672537442,996
7881,3920801189,3629935998,1672551400,1672552804,1404
7575,3822654369,3713894336,1672683630,1672686984,3354
7550,3534702203,3914290246,1672640733,1672641428,695
7492,3736419952,3739106581,1672552281,1672552910,629
7590,3512142794,3301107849,1672565573,1672568702,3129
7665,3370636709,3512540951,1672635117,1672638671,3554
7723,3701178711,3405494240,1672562999,1672565095,2096
7796,3791657947,3733189298,1672673100,1672675442,2342
7637,3634995491,3614238812,1672535202,1672535802,600
7871,3777443199,3512349371,1672639702,1672642249,2547
7832,3811171116,3334033993,1672653151,1672654308,1157
7577,3247428249,3774050956,1672557366,1672560078,2712
7926,3606987130,3534729133,1672596808,1672599201,2393
7660,3519803045,3520719611,1672578521,1672579736,1215
7605,3757455053,3792768129,1672586816,1672588692,1876
7733,3429690204,3513454145,1672660166,1672661941,1775
7923,3716746253,3890149705,1672661624,1672664226,2602
7823,3511332835,3915628728,1672692334,1672694009,1675
7549,3979339287,3755739653,1672531879,1672531990,111
7677,3931941795,3229665776,1672645267,1672647950,2683
7515,3501692334,3473765852,1672656741,1672658969,2228
7487,3428964059,3682061100,1672687757,1672689518,1761
7757,3500894271,3757562897,1672664017,1672666779,2762
7664,3826760240,3273500349,1672645512,1672648689,3177
7633,3914259449,3273500349,1672666460,1672668391,1931
7536,3475396323,3513956646,1672699293,1672699599,306
7866,3716900301,3388286531,1672689202,1672690862,1660
7637,3362000049,3779740455,1672608149,1672610327,2178
7767,3813052709,3714488548,1672544907,1672546827,1920
7549,3809916577,3515284591,1672583118,1672583943,825
7866,3387966152,3519601612,1672558975,1672559562,587
7645,3337544549,3760294205,1672600737,1672602495,1758
7653,3855602893,3978105277,1672619566,1672619917,351
7612,3792473331,3770101921,1672643590,1672644948,1358
7915,3809059934,3516980378,1672602481,1672604945,2464
7837,3774127586,3783083229,1672651975,1672654818,2843
7676,3271938399,3234362962,1672604574,1672605932,1358
7887,3316173088,3703275621,1672580911,1672582264,1353
7891,3201432789,3511312803,1672533559,1672533690,131
7866,3617734118,3390068992,1672604111,1672607579,3468
7948,3713349754,3303751772,1672579569,1672580839,1270
7588,3713969578,3515151980,1672606937,1672607118,181
7619,3770021824,3858918246,1672548530,1672550209,1679
7811,3399004969,3880310724,1672660044,1672660715,671
7727,3407725581,3662180254,1672565713,1672568888,3175
7777,3293695955,3303751772,1672653008,1672653182,174
7749,3774366875,3311090974,1672541039,1672541338,299
7508,3888559320,3497901842,1672590251,1672590525,274
7697,3780974443,3387966152,1672550410,1672552914,2504
7867,3833889105,3618045231,1672569140,1672570379,1239
7847,3223789409,3231056870,1672652498,1672652793,295
7704,3511170269,3520751702,1672666788,1672669834,3046
7685,3883551721,3518876135,1672571822,1672573934,2112
7702,3346327502,3514987389,1672600746,1672602264,1518
7722,3311627628,3779528381,1672566461,1672569796,3335
7814,3852391257,3774127586,1672569471,1672572365,2894
7699,3711198793,3911245524,1672582678,1672585414,2736
7849,3701984666,3738274418,1672647927,1672651258,3331
7667,3534488837,3505962865,1672629329,1672630038,709
7581,3757455053,3516606733,1672614428,1672614701,273
7642,3757682496,3519601612,1672533251,1672533583,332
7614,3428964059,3511332835,1672621593,1672621809,216
7867,3454042520,3937224533,1672646500,1672647308,808
7817,3972364603,3512720680,1672678324,1672678696,372
7652,3514283243,3236102733,1672605367,1672606146,779
7940,3336751428,3533137446,1672682711,1672682990,279
7792,3773465237,3778341199,1672638764,1672641940,3176
7892,3783239924,3780593036,1672628420,1672630952,2532
7504,3298433163,3714197325,1672635046,1672638260,3214
7538,3713349754,3427283336,1672598376,1672601378,3002
7598,3238712269,3972364603,1672544927,1672545102,175
7535,3209551760,3772578994,1672699536,1672702723,3187
7542,3637008488,3823600322,1672627925,1672628156,231
7870,3311154569,3229665776,1672585273,1672587339,2066
7496,3737079798,3804870229,1672592930,1672596114,3184
7577,3315583351,3666457294,1672563565,1672565615,2050
7786,3500365158,3514128943,1672656129,1672657885,1756
7652,3715339701,3770553384,1672638791,1672638977,186
7851,3397418363,3476232529,1672536167,1672538872,2705
7970,3362000049,3901990690,1672541756,1672543668,1912
7811,3485823740,3701190899,1672659565,1672662986,3421
7811,3757161914,3757455053,1672598088,1672600154,2066
7674,3757682496,3918247820,1672664445,1672667565,3120
7747,3337544549,3471220483,1672587636,1672587706,70
7886,3756601594,3713894336,1672569632,1672573172,3540
7872,3378436155,3517459919,1672545901,1672548521,2620
7613,3559110998,3610695419,1672558392,1672561557,3165
7541,3701190899,3500499542,1672593965,1672597447,3482
7561,3516606733,3777936328,1672542840,1672544206,1366
7800,3492478793,3516980378,1672604100,1672605477,1377
7638,3311152102,3505530961,1672610572,1672613831,3259
7837,3430074045,3666457294,1672690954,1672692424,1470
7663,3898995675,3773978034,1672580375,1672583573,3198
7748,3466911760,3770553384,1672618410,1672620730,2320
7495,3776338577,3792789881,1672676171,1672677576,1405
7897,3221536550,3201432789,1672595535,1672596591,1056
7890,3206603608,3533270638,1672647353,1672647576,223
7541,3394330287,3533653428,1672678238,1672681333,3095
7625,3485375593,3406784491,1672687326,1672689362,2036
7626,3428964059,3736786443,1672607219,1672609835,2616
7874,3427283336,3730517636,1672572846,1672574060,1214
7593,3774298222,3883861463,1672569392,1672569921,529
7770,3379256399,3273500349,1672615269,1672615603,334
7604,3416241005,3760492950,1672616310,1672617130,820
7855,3713268590,3755436115,1672576426,1672579754,3328
7826,3420432297,3773978034,1672617405,1672620519,3114
7875,3520206212,3511198618,1672558154,1672560216,2062
7551,3388637594,3515394721,1672651463,1672653093,1630
7570,3359910781,3477649378,1672577452,1672580325,2873
7802,3415443558,3399535232,1672693928,1672696210,2282
7903,3713786889,3737079798,1672617343,1672619952,2609
7502,3777514571,3276640712,1672675364,1672676396,1032
7832,3360506772,3511271692,1672557162,1672558346,1184
7792,3405494240,3783245561,1672623420,1672625457,2037
7525,3407725581,3809916577,1672637296,1672637659,363
7562,3898995675,3780365428,1672639196,1672640001,805
7787,3714821932,3520165601,1672668377,1672670715,2338
7584,3345207877,3505904952,1672680835,1672683026,2191
7581,3626156564,3361230905,1672575089,1672575603,514
7782,3772746272,3386707783,1672630480,1672633300,2820
7665,3639847263,3407954858,1672553900,1672557397,3497
7760,3417970574,3234541252,1672614551,1672617279,2728
7565,3505912939,3510247121,1672670477,1672671086,609
7946,3629935998,3494290908,1672667600,1672668107,507
7736,3411618230,3756623396,1672564920,1672568471,3551
7592,3793848402,3304625412,1672619416,1672620678,1262
7668,3714197325,3391915121,1672604034,1672605805,1771
7790,3912536808,3882242815,1672693507,1672693789,282
7535,3303751772,3510857360,1672576947,1672577772,825
7897,3826633236,3755872268,1672610746,1672610967,221
7619,3511359172,3311090974,1672561097,1672562585,1488
7965,3501486692,3365614305,1672652731,1672653841,1110
7728,3238712269,3738274418,1672549453,1672551526,2073
7761,3711380716,3713969578,1672692428,1672694393,1965
7660,3505477652,3901990690,1672677486,1672677751,265
7776,3809484172,3520730271,1672695823,1672698326,2503
7822,3555214688,3471220483,1672644239,1672645046,807
7521,3703275621,3922275416,1672678849,1672679188,339
7791,3520206212,3518932404,1672668913,1672669554,641
7546,3711308224,3387674757,1672653652,1672655148,1496
7914,3277939457,3757447189,1672638553,1672640079,1526
7824,3716165213,3688683847,1672558520,1672560862,2342
7776,3390068992,3792902982,1672549945,1672552727,2782
7625,3780828689,3471220483,1672612604,1672613094,490
7832,3783245561,3387674757,1672671865,1672672937,1072
7536,3626156564,3735733948,1672534906,1672537071,2165
7846,3793753089,3819727225,1672587306,1672589456,2150
7660,3533748232,3885670556,1672659028,1672660884,1856
7920,3356860407,3433804879,1672659026,1672660960,1934
7485,3885897503,3338367113,1672677470,1672679224,1754
7871,3770635361,3519912874,1672607617,1672609844,2227
7532,3760992710,3273500349,1672657292,1672658920,1628
7585,3772578994,3716168623,1672648783,1672651506,2723
7537,3885897503,3780828689,1672660867,1672664411,3544
7682,3780593036,3716746253,1672623473,1672624846,1373
7981,3760893269,3515125508,1672584521,1672584745,224
7757,3817316561,3701984666,1672664039,1672665706,1667
7588,3373384732,3359239884,1672545092,1672545180,88
7766,3517963492,3517721725,1672614324,1672614986,662
7745,3302626661,3500805881,1672626842,1672628965,2123
7773,3778308417,3517509185,1672585286,1672586378,1092
7681,3613683164,3774366875,1672602525,1672603771,1246
7977,3406784491,3513201436,1672691071,1672694288,3217
7720,3201848640,3805519285,1672664835,1672666690,1855
7958,3755436115,3428674539,1672691176,1672692616,1440
7839,3515394721,3755392666,1672548743,1672551968,3225
7522,3518163778,3512837326,1672667677,1672670059,2382
7654,3511312803,3853018906,1672628718,1672630720,2002
7938,3792288302,3710067113,1672656910,1672658549,1639
7776,3208844525,3509672210,1672590429,1672593260,2831
7924,3505973226,3344019610,1672541117,1672541872,755
7632,3356860407,3298433163,1672534319,1672535499,1180
7578,3534702203,3304625412,1672650711,1672651984,1273
7652,3975287541,3312664885,1672671928,1672673900,1972
7727,3774195321,3519654779,1672630381,1672632754,2373
7966,3391915121,3933210486,1672593169,1672595493,2324
7596,3500391167,3776513891,1672656720,1672659302,2582
7771,3505873261,3510969660,1672659147,1672662691,3544
7724,3628819436,3278365525,1672550304,1672553691,3387
7749,3664170666,3777455223,1672570838,1672572973,2135
7694,3500729955,3714821932,1672594696,1672595334,638
7923,3793962300,3394330287,1672624906,1672628047,3141
7621,3311627628,3925402713,1672614626,1672617271,2645
7796,3912536808,3510857360,1672551510,1672553505,1995
7875,3857349323,3520709480,1672638594,1672640010,1416
7782,3817621391,3533827120,1672688988,1672690752,1764
7852,3791997875,3828432634,1672546816,1672548729,1913
7804,3975287541,3883042241,1672566010,1672567929,1919
7750,3611150562,3516465662,1672606010,1672609487,3477
7981,3733891182,3516629436,1672567636,1672569154,1518
7976,3515151980,3399535232,1672542925,1672543908,983
7612,3774338212,3209027249,1672661379,1672663489,2110
7540,3206593906,3777983879,1672646380,1672648071,1691
7823,3402943525,3811171116,1672667158,1672670471,3313
7660,3793753089,3805347939,1672673448,1672676439,2991
7668,3501606184,3510594211,1672576821,1672579768,2947
7748,3311203656,3400804807,1672603155,1672604356,1201
7685,3770021824,3736786443,1672630202,1672632326,2124
7711,3701898991,3365942576,1672626779,1672630146,3367
7955,3918584946,3490191091,1672590920,1672591725,805
7582,3511841857,3932051427,1672582885,1672585564,2679
7662,3777443199,3518360734,1672634140,1672634216,76
7541,3273500349,3774005526,1672617096,1672620597,3501
7866,3791957752,3501198706,1672576020,1672577223,1203
7708,3791602225,3311603601,1672674839,1672676402,1563
7684,3730517636,3501730685,1672595014,1672596659,1645
7932,3533371364,3760077057,1672692362,1672693753,1391
7917,3418728074,3489962019,1672647387,1672647993,606
7977,3713370078,3756601594,1672603107,1672604561,1454
7880,3756451663,3401627165,1672633424,1672635237,1813
7891,3278365525,3606186086,1672569467,1672571796,2329
7837,3791553060,3394539273,1672541635,1672543874,2239
7907,3511125626,3501198706,1672599253,1672602062,2809
7680,3296471982,3284832486,1672543483,1672544675,1192
7733,3791874383,3776513891,1672557161,1672559295,2134
7545,3772309150,3533827120,1672610958,1672613816,2858
7486,3711308224,3627937312,1672564499,1672567310,2811
7827,3911245524,3380035798,1672624331,1672627226,2895
7535,3496051529,3505530961,1672689740,1672692374,2634
7711,3622054816,3534010629,1672585107,1672586995,1888
7525,3439023335,3888559320,1672585431,1672587778,2347
7780,3776066388,3778549126,1672631049,1672633089,2040
7495,3757562897,3882997884,1672679516,1672681831,2315
7890,3883861463,3370636709,1672565337,1672566630,1293
7842,3383661227,3755436115,1672555442,1672556780,1338
7492,3791957752,3511125626,1672633014,1672636241,3227
7676,3774066725,3501692334,1672561306,1672564044,2738
7848,3533927138,3913251733,1672547801,1672548186,385
7783,3512166013,3793338102,1672594305,1672597770,3465
7980,3976390453,3880285638,1672644605,1672646601,1996
7693,3774580701,3311439795,1672675514,1672676409,895
7856,3837094550,3780593036,1672595524,1672598969,3445
7969,3505193212,3925402713,1672691830,1672691980,150
7637,3757403279,3621810464,1672667117,1672670394,3277
7944,3533242305,3516065852,1672640573,1672641065,492
7485,3510857360,3774339795,1672536296,1672538409,2113
7829,3622054816,3898995675,1672606953,1672607183,230
7639,3903307060,3756027749,1672695449,1672697854,2405
7818,3515125508,3510969660,1672615752,1672617562,1810
7545,3792473331,3701863557,1672661380,1672662192,812
7952,3505873261,3311203656,1672595753,1672597418,1665
7840,3249791738,3291235378,1672626157,1672627836,1679
7634,3756528686,3519069599,1672612032,1672612893,861
7865,3520888296,3311993075,1672641647,1672642497,850
7838,3911159965,3783925755,1672547432,1672548435,1003
7499,3777806071,3493507965,1672570640,1672571650,1010
7682,3511267139,3520183192,1672610723,1672613117,2394
7745,3778780511,3755739653,1672602288,1672602678,390
7538,3314245084,3703275621,1672586595,1672589548,2953
7981,3430352815,3760492950,1672659993,1672660150,157
7930,3519563836,3534488837,1672575615,1672578794,3179
7875,3734828619,3688683847,1672542321,1672543471,1150
7977,3634995491,3505477652,1672596635,1672599111,2476
7918,3388372715,3826415738,1672558441,1672558983,542
7632,3512837326,3418728074,1672680615,1672682493,1878
7609,3519700826,3736625083,1672533149,1672533977,828
7866,3802367797,3200691026,1672683582,1672685020,1438
7562,3377766165,3858918246,1672656253,1672657051,798
7924,3337544549,3378686918,1672535180,1672536572,1392
7872,3922275416,3760569731,1672670574,1672670654,80
7779,3774268456,3901877072,1672623489,1672626725,3236
7915,3714504419,3685818092,1672629585,1672632819,3234
7655,3791874383,3792844210,1672555768,1672558861,3093
7531,3774556560,3428006164,1672693088,1672693610,522
7768,3520629279,3358871377,1672678016,1672678568,552
7817,3773664987,3500994774,1672616880,1672619919,3039
7497,3713630656,3365942576,1672631330,1672632554,1224
7968,3774066725,3793627961,1672662266,1672662585,319
7885,3301107849,3471220483,1672575346,1672575909,563
7564,3716537575,3792668962,1672669468,1672669600,132
7900,3760267716,3378686918,1672640493,1672641627,1134
7730,3514128943,3780503655,1672663717,1672665191,1474
7827,3517476351,3520719611,1672632748,1672633570,822
7561,3314836094,3434642576,1672554418,1672556443,2025
7614,3362000049,3208844525,1672698550,1672700134,1584
7933,3297463265,3344364444,1672539015,1672541146,2131
7971,3760598102,3432689543,1672587237,1672590142,2905
7652,3488244966,3500374658,1672639495,1672642421,2926
7739,3512969370,3770635361,1672683195,1672685642,2447
7590,3221899927,3485823740,1672627910,1672628392,482
7580,3247780536,3793959750,1672544915,1672547221,2306
7904,3756623396,3365830990,1672690718,1672690814,96
7534,3511350608,3780294829,1672680227,1672683678,3451
7642,3716258994,3777929708,1672682710,1672686251,3541
7680,3710344260,3278365525,1672651336,1672652545,1209
7813,3505962865,3736625083,1672614719,1672616669,1950
7613,3509352754,3800886801,1672548148,1672549917,1769
7599,3501606184,3518014404,1672546115,1672548517,2402
7513,3510771358,3618873142,1672693548,1672693669,121
7861,3465202715,3336751428,1672547562,1672550997,3435
7506,3770101921,3637008488,1672612539,1672613926,1387
7619,3901990690,3505477652,1672654712,1672655054,342
7593,3716273414,3238712269,1672633578,1672635204,1626
7866,3613995936,3713644518,1672694469,1672697161,2692
7571,3520709480,3823600322,1672628201,1672628311,110
7512,3478194807,3518791447,1672565180,1672567592,2412
7569,3387674757,3760569731,1672564144,1672567719,3575
7665,3480687894,3402943525,1672622451,1672626046,3595
7676,3519700826,3777477395,1672556742,1672559743,3001
7676,3533095755,3703441914,1672654505,1672655884,1379
7886,3439023335,3276640712,1672533709,1672536589,2880
7941,3826760240,3760992710,1672651134,1672652392,1258
7554,3339907603,3505873261,1672641311,1672642366,1055
7849,3505173328,3783245561,1672545105,1672545235,130
7515,3500365158,3367902229,1672699694,1672702346,2652
7722,3777079686,3688418210,1672621099,1672624452,3353
7710,3978105277,3407673904,1672657230,1672659061,1831
7904,3279721246,3421127249,1672588876,1672590647,1771
7885,3791942683,3855602893,1672702168,1672703749,1581
7787,3370752401,3829319703,1672690992,1672691066,74
7551,3533025282,3485008994,1672674223,1672676833,2610
7637,3293695955,3494290908,1672631745,1672632006,261
7704,3311208440,3505873261,1672642889,1672642962,73
7495,3533748232,3793627961,1672628452,1672629249,797
7970,3634995491,3278365525,1672544451,1672546702,2251
7658,3514987389,3978115672,1672662576,1672664006,1430
7735,3777983879,3607748895,1672699188,1672701581,2393
7810,3519803045,3755511676,1672537060,1672538197,1137
7706,3277669002,3778980116,1672551425,1672554857,3432
7594,3780813786,3338703270,1672678170,1672681606,3436
7674,3736419952,3511687358,1672547505,1672549701,2196
7889,3511435497,3711308224,1672616065,1672617685,1620
7865,3311993075,3446948848,1672647979,1672649615,1636
7926,3701967560,3406784491,1672612675,1672613055,380
7976,3778341199,3703735129,1672578366,1672581505,3139
7692,3816853177,3511435497,1672585129,1672587177,2048
7839,3505098372,3899266183,1672662072,1672663238,1166
7675,3737051610,3812176780,1672684265,1672686347,2082
7546,3494290908,3716835696,1672656837,1672659902,3065
7834,3519654779,3791942683,1672635979,1672637346,1367
7806,3373384732,3473562469,1672670856,1672674121,3265
7837,3490191091,3716168623,1672582934,1672585435,2501
7810,3291235378,3361230905,1672683158,1672684394,1236
7521,3280964728,3478194807,1672604495,1672607710,3215
7941,3235635976,3433804879,1672532680,1672535988,3308
7624,3935627557,3514245078,1672634237,1672637632,3395
7767,3489962019,3511312803,1672663535,1672666011,2476
7501,3778108318,3757161914,1672631880,1672632797,917
7964,3224058172,3505873261,1672692339,1672694358,2019
7819,3783083229,3827222533,1672631505,1672633225,1720
7881,3489962019,3515394721,1672602623,1672605073,2450
7834,3918247820,3518360734,1672696683,1672699494,2811
7832,3286658957,3399433690,1672703850,1672706165,2315
7707,3514719601,3935627557,1672691075,1672692797,1722
7846,3730517636,3756601594,1672647803,1672649725,1922
7591,3774127586,3703889596,1672554092,1672555893,1801
7838,3399535232,3227158514,1672597899,1672598061,162
7802,3378686918,3374559242,1672550789,1672552416,1627
7583,3802367797,3808324264,1672603959,1672605341,1382
7616,3360993964,3229058858,1672695985,1672697087,1102
7758,3533242305,3715974031,1672591006,1672591452,446
7786,3293695955,3714488548,1672542279,1672544618,2339
7585,3301107849,3519563836,1672574459,1672577743,3284
7520,3920801189,3501364586,1672596912,1672599468,2556
7937,3829232696,3224716315,1672636168,1672636316,148
7713,3365942576,3501692334,1672619532,1672619935,403
7929,3307097200,3307097200,1672563955,1672565733,1778
7812,3783509527,3284639858,1672602959,1672605796,2837
7858,3736786443,3601879040,1672597898,1672598170,272
7493,3791594391,3688418210,1672597372,1672600416,3044
7734,3976633198,3454042520,1672631067,1672634295,3228
7569,3711262377,3514987389,1672688548,1672689414,866
7679,3701984666,3513956646,1672643779,1672644179,400
7593,3972709319,3703223015,1672636806,1672637646,840
7938,3617734118,3533025282,1672689446,1672690723,1277
7805,3244173074,3454042520,1672639588,1672642689,3101
7929,3629935998,3734496778,1672696646,1672698864,2218
7686,3772359096,3338703270,1672584933,1672588365,3432
7738,3500803339,3519152550,1672574285,1672577580,3295
7931,3336742544,3311152102,1672684484,1672687553,3069
7525,3380035798,3514838220,1672609768,1672611819,2051
7888,3774005526,3701065786,1672685814,1672689407,3593
7962,3534313900,3730517636,1672609465,1672609988,523
7725,3779528381,3770447408,1672644541,1672645404,863
7484,3607748895,3921211276,1672656383,1672656616,233
7895,3513956646,3514987389,1672552741,1672555780,3039
7585,3373384732,3352603894,1672641510,1672645069,3559
7634,3791901535,3311274543,1672701219,1672701548,329
7811,3314836094,3516716179,1672647348,1672648481,1133
7561,3512720680,3533626375,1672622631,1672625280,2649
7583,3421127249,3886298125,1672589336,1672589946,610
7721,3501759100,3783245561,1672653994,1672654710,716
7842,3533748232,3472130842,1672640671,1672641346,675
7526,3316222192,3855424474,1672532892,1672533172,280
7761,3416265063,3783531004,1672606917,1672608316,1399
7527,3780503655,3501927421,1672659097,1672659894,797
7941,3311603601,3777120536,1672547781,1672551356,3575
7573,3533270638,3736229191,1672648071,1672648957,886
7648,3701498253,3885897503,1672631706,1672633615,1909
7538,3345207877,3703223015,1672660584,1672660780,196
7945,3688418210,3711569060,1672571351,1672571802,451
7569,3772642849,3793871337,1672688883,1672690928,2045
7538,3783239924,3234541252,1672589354,1672590542,1188
7691,3770101921,3554917400,1672536727,1672539594,2867
7800,3384240055,3703735129,1672672594,1672673224,630
7958,3685818092,3399535232,1672544379,1672547257,2878
7556,3682061100,3791594391,1672678517,1672681362,2845
7903,3792177074,3373384732,1672652262,1672655462,3200
7809,3777455223,3633420270,1672586599,1672588498,1899
7950,3550946908,3755392666,1672533797,1672537392,3595
7854,3757682496,3388637594,1672577658,1672581045,3387
7713,3808324264,3301107849,1672561408,1672564504,3096
7791,3277605882,3783531004,1672666520,1672669728,3208
7732,3888559320,3501692334,1672620509,1672621811,1302
7672,3736229191,3791594391,1672637076,1672637852,776
7789,3482405588,3855424474,1672583820,1672586751,2931
7846,3738502357,3827626797,1672653010,1672656360,3350
7980,3915628728,3505973226,1672570365,1672573119,2754
7736,3202120784,3756027749,1672660015,1672660712,697
7676,3774501422,3793086311,1672695681,1672698057,2376
7668,3922337974,3760598102,1672631278,1672633509,2231
7663,3701190899,3307097200,1672674684,1672676748,2064
7629,3477375368,3291235378,1672701735,1672703748,2013
7700,3556951786,3636867411,1672675454,1672678997,3543
7751,3430352815,3500994774,1672615693,1672617325,1632
7629,3420432297,3777936328,1672633305,1672635636,2331
7790,3685187183,3370752401,1672593809,1672596310,2501
7533,3466229085,3777983879,1672607354,1672610584,3230
7667,3710569131,3899266183,1672651011,1672653606,2595
7493,3318697153,3334033993,1672650697,1672653203,2506
7916,3776338577,3344364444,1672585373,1672588919,3546
7727,3921211276,3714962248,1672609482,1672610676,1194
7669,3427219654,3777929708,1672647335,1672647736,401
7550,3975287541,3805292782,1672685361,1672687794,2433
7591,3201324715,3805292782,1672564401,1672567382,2981
7938,3770851318,3815508790,1672550357,1672550890,533
7643,3520030713,3505962865,1672554753,1672556885,2132
7720,3703889596,3773205565,1672552812,1672555582,2770
7518,3489545239,3755739653,1672580115,1672581348,1233
7764,3533137446,3533371364,1672642761,1672646257,3496
7583,3685187183,3466229085,1672662422,1672663719,1297
7702,3475251781,3249791738,1672561286,1672563053,1767
7566,3755739653,3772758337,1672567214,1672568675,1461
7704,3975287541,3404384505,1672590757,1672593422,2665
7675,3501927421,3401627165,1672565007,1672568084,3077
7773,3407673904,3222521619,1672648715,1672648863,148
7691,3448855696,3736419952,1672603017,1672606412,3395
7700,3201324715,3629547065,1672589332,1672590642,1310
7588,3416265063,3783126683,1672646423,1672648326,1903
7656,3756601594,3731106822,1672602139,1672604170,2031
7488,3783429780,3793871337,1672568951,1672570698,1747
7861,3903307060,3511271692,1672566945,1672567025,80
7786,3331845324,3760509236,1672655494,1672656346,852
7548,3533280269,3397418363,1672576399,1672579918,3519
7777,3918674986,3757562897,1672621745,1672622217,472
7740,3773120434,3533242305,1672567082,1672570095,3013
7707,3792288302,3392121505,1672648611,1672650602,1991
7829,3427219654,3915628728,1672686463,1672687386,923
7700,3715581279,3778305740,1672614460,1672615488,1028
7873,3520706195,3792768129,1672617016,1672617184,168
7537,3428964059,3970117174,1672596114,1672599286,3172
7742,3361230905,3365830990,1672663679,1672663968,289
7717,3316173088,3510857360,1672678922,1672680567,1645
7513,3277939457,3224716315,1672694846,1672696502,1656
7884,3510703546,3227457126,1672568167,1672569493,1326
7876,3606812411,3779740455,1672610019,1672613438,3419
7691,3533270638,3924549929,1672567380,1672569577,2197
7552,3780788622,3302626661,1672533819,1672536511,2692
7862,3356860407,3610695419,1672548892,1672550566,1674
7920,3509672210,3518496488,1672557639,1672561069,3430
7812,3303751772,3519069599,1672607695,1672608497,802
7599,3793871337,3888559320,1672544708,1672545944,1236
7796,3904408902,3601879040,1672589359,1672592228,2869
7772,3417970574,3880285638,1672576358,1672579899,3541
7759,3978115672,3827377568,1672698939,1672700223,1284
7837,3235635976,3773429448,1672551248,1672553237,1989
7663,3304625412,3756021689,1672575184,1672577259,2075
7565,3407725581,3489217083,1672692017,1672693398,1381
7930,3716273414,3383922351,1672674927,1672678309,3382
7632,3372883226,3889750851,1672620770,1672622655,1885
7926,3519654779,3711569060,1672671372,1672674530,3158
7914,3434642576,3312333615,1672561679,1672562779,1100
7955,3316222192,3904775198,1672647979,1672648865,886
7828,3311845971,3701498253,1672541926,1672544831,2905
7491,3613995936,3793470489,1672531403,1672532126,723
7670,3500060260,3773978034,1672585713,1672587918,2205
7497,3418728074,3899266183,1672563562,1672565699,2137
7958,3518876135,3492478793,1672662287,1672662848,561
7943,3311761694,3779036831,1672686024,1672688990,2966
7738,3391915121,3459030804,1672679170,1672681744,2574
7700,3629547065,3511359172,1672591505,1672594561,3056
7860,3912262917,3780813786,1672563427,1672565804,2377
7674,3364543015,3777455223,1672551760,1672553283,1523
7683,3378686918,3533095755,1672638913,1672641710,2797
7873,3519601612,3489217083,1672657163,1672658897,1734
7720,3386707783,3555214688,1672662316,1672663081,765
7549,3407673904,3510173870,1672703834,1672703969,135
7909,3434642576,3904408902,1672702962,1672705106,2144
7850,3756462516,3249401741,1672572242,1672575346,3104
7917,3533369198,3500391167,1672667451,1672670871,3420
7851,3505702787,3639847263,1672610351,1672613076,2725
7884,3713630656,3664170666,1672621039,1672622254,1215
7709,3316173088,3505201246,1672634412,1672638000,3588
7695,3533193862,3533927138,1672580008,1672581768,1760
7756,3837094550,3432689543,1672688444,1672690895,2451
7608,3518163778,3224058172,1672663958,1672665182,1224
7832,3770635361,3277939457,1672626698,1672627453,755
7924,3339907603,3533748232,1672626121,1672628820,2699
7906,3811694763,3777443199,1672661544,1672664712,3168
7968,3903009525,3439023335,1672655294,1672658590,3296
7953,3481502100,3311761694,1672701647,1672702385,738
7846,3978115672,3242408357,1672558583,1672560283,1700
7564,3978105277,3617734118,1672683583,1672684924,1341
7736,3510703546,3206254161,1672606901,1672607302,401
7888,3500658339,3500229033,1672585448,1672585538,90
7489,3405494240,3711265369,1672540054,1672541696,1642
7486,3791553060,3509773875,1672571332,1672573582,2250
7823,3394539273,3899266183,1672654194,1672655008,814
7491,3701184889,3454042520,1672667325,1672670274,2949
7649,3287105466,3809916577,1672601697,1672602225,528
7651,3668898102,3227457126,1672624012,1672626575,2563
7822,3816454165,3415546117,1672611267,1672611530,263
7964,3662180254,3510126867,1672596956,1672600545,3589
7740,3516465662,3533371364,1672660843,1672662530,1687
7812,3882242815,3772642849,1672649905,1672650537,632
7647,3510173870,3248507722,1672628547,1672629278,731
7904,3202120784,3883312122,1672593517,1672595869,2352
7590,3756930948,3618873142,1672538159,1672540310,2151
7712,3505362057,3935127663,1672546329,1672546467,138
7498,3407725581,3513201436,1672657264,1672659844,2580
7692,3359910781,3909238838,1672629202,1672632365,3163
7518,3509352754,3276640712,1672690378,1672690811,433
7811,3918584946,3932051427,1672540183,1672541612,1429
7786,3481647420,3477649378,1672699583,1672700989,1406
7725,3235287260,3713644518,1672668297,1672670735,2438
7696,3287105466,3610695419,1672535516,1672537042,1526
7493,3779629905,3359239884,1672612673,1672616190,3517
7765,3332072298,3415443558,1672685435,1672688763,3328
7732,3701146057,3446948848,1672564862,1672564986,124
7607,3736790081,3777455223,1672600994,1672603387,2393
7829,3505791599,3505000737,1672617233,1672619084,1851
7703,3880310724,3701111745,1672664154,1672666411,2257
7547,3311090974,3616944364,1672696949,1672699102,2153
7910,3311152102,3501692334,1672675413,1672678981,3568
7907,3433804879,3829319703,1672531377,1672534070,2693
7600,3518360734,3783429780,1672664456,1672667257,2801
7518,3703718151,3793959750,1672651692,1672651920,228
7485,3505869747,3496549058,1672691180,1672693980,2800
7483,3791997875,3774119563,1672699086,1672699456,370
7735,3826760240,3666553782,1672637757,1672638123,366
7917,3683766533,3895562476,1672603905,1672604944,1039
7596,3773755137,3606987130,1672561269,1672562212,943
7605,3791553060,3513164386,1672696850,1672699223,2373
7849,3793959750,3776800213,1672540522,1672543892,3370
7536,3514245078,3885897503,1672672493,1672675840,3347
7762,3520190170,3881477378,1672565985,1672567227,1242
7534,3511170269,3791874383,1672658308,1672661060,2752
7699,3500374658,3334033993,1672664805,1672665576,771
7972,3336742544,3311324983,1672635422,1672636520,1098
7643,3912536808,3812176780,1672700588,1672703056,2468
7837,3200198928,3904775198,1672628084,1672629703,1619
7633,3511267139,3505912939,1672550269,1672551332,1063
7835,3475396323,3756623396,1672663512,1672663884,372
7631,3482405588,3818255890,1672583389,1672583452,63
7693,3514472925,3732481297,1672621707,1672624862,3155
7873,3512540951,3519912874,1672589019,1672590106,1087
7612,3303705369,3514987389,1672607593,1672609655,2062
7601,3206254161,3427283336,1672573988,1672577129,3141
7730,3924549929,3534729133,1672682546,1672685658,3112
7489,3505193212,3778266283,1672539021,1672541318,2297
7566,3514987389,3407954858,1672619615,1672622595,2980
7786,3428674539,3756930948,1672691164,1672692472,1308
7517,3685818092,3688418210,1672677289,1672680416,3127
7917,3770101921,3772544062,1672592096,1672594948,2852
7820,3832902928,3510244400,1672615284,1672618632,3348
7783,3556951786,3373384732,1672594682,1672596217,1535
7514,3792902982,3428964059,1672624590,1672624914,324
7770,3779036831,3755881905,1672610403,1672613215,2812
7514,3780974443,3921211276,1672569296,1672571322,2026
7706,3731419510,3715339701,1672553918,1672555175,1257
7759,3714962248,3735733948,1672702978,1672704429,1451
7501,3777514571,3757812939,1672676596,1672679764,3168
7639,3311993075,3509453566,1672702862,1672705978,3116
7586,3711571712,3493507965,1672633860,1672636271,2411
7545,3613995936,3801089989,1672643437,1672644388,951
7486,3242408357,3520165601,1672697965,1672699081,1116
7744,3379589402,3627937312,1672565513,1672568503,2990
7550,3416241005,3793959750,1672646672,1672648778,2106
7793,3816454165,3513164386,1672549407,1672552537,3130
7615,3715189301,3774127586,1672674428,1672675111,683
7958,3774580701,3480687894,1672679290,1672681773,2483
7577,3932051427,3793338102,1672588662,1672590877,2215
7651,3383922351,3882242815,1672559032,1672562364,3332
7795,3736625083,3756027749,1672690992,1672693422,2430
7623,3489545239,3510771358,1672700110,1672701289,1179
7720,3465202715,3509352754,1672669306,1672671661,2355
7853,3500894271,3505869747,1672700379,1672701211,832
7767,3772884106,3701065786,1672698867,1672699663,796
7774,3777477395,3533193862,1672607208,1672608235,1027
7903,3774195321,3703013906,1672580500,1672581106,606
7677,3716165213,3780914982,1672584224,1672584673,449
7666,3770101921,3770851318,1672612776,1672613632,856
7695,3701534009,3903307060,1672618300,1672621891,3591
7818,3510703546,3772714862,1672538822,1672541574,2752
7643,3496549058,3978115672,1672541661,1672544502,2841
7533,3311871871,3314836094,1672575403,1672578338,2935
7523,3500229033,3311648200,1672672409,1672675773,3364
7778,3604539807,3289061738,1672546651,1672548594,1943
7729,3688683847,3760183458,1672603306,1672604805,1499
7940,3519912874,3515284591,1672656524,1672659521,2997
7803,3778305740,3500578848,1672693757,1672695629,1872
7612,3792473331,3774366875,1672577252,1672577915,663
7607,3882242815,3855937514,1672646895,1672646997,102
7503,3505912939,3399911573,1672619566,1672623026,3460
7823,3715998609,3415546117,1672544753,1672546095,1342
7879,3389115045,3287105466,1672579397,1672580195,798
7846,3406784491,3701691675,1672632624,1672634775,2151
7817,3792668962,3703889596,1672565110,1672565432,322
7965,3515125508,3826415738,1672544494,1672547186,2692
7766,3755042098,3278365525,1672662515,1672665330,2815
7664,3731419510,3509773875,1672557744,1672558274,530
7856,3713349754,3783126683,1672532064,1672534292,2228
7965,3533748232,3755943611,1672621818,1672623305,1487
7512,3737154119,3344019610,1672691221,1672693639,2418
7627,3770101921,3774338212,1672644030,1672646419,2389
7485,3511125626,3734737881,1672558251,1672558735,484
7937,3364543015,3379256399,1672560517,1672563599,3082
7714,3826759140,3510244400,1672572251,1672575831,3580
7857,3791594391,3509672210,1672667738,1672670740,3002
7821,3426325549,3713630656,1672698466,1672699898,1432
7526,3924549929,3713644518,1672628318,1672630426,2108
7503,3802367797,3633420270,1672690095,1672690756,661
7598,3500458761,3467773920,1672580890,1672583596,2706
7763,3715581279,3505702787,1672606042,1672608465,2423
7524,3772359096,3516629436,1672640148,1672643289,3141
7980,3500904641,3510173870,1672613939,1672614724,785
7639,3415443558,3800886801,1672686952,1672690446,3494
7505,3511198618,3779740455,1672561319,1672563624,2305
7925,3880285638,3716835696,1672577721,1672578252,531
7791,3369998498,3736229191,1672681742,1672684017,2275
7818,3387674757,3291235378,1672681877,1672684528,2651
7565,3501483568,3360743849,1672587021,1672589362,2341
7816,3362000049,3776066388,1672540793,1672540869,76
7503,3404058699,3621497531,1672691801,1672694753,2952
7722,3666507626,3277605882,1672667862,1672670460,2598
7902,3773814927,3913251733,1672621585,1672622771,1186
7562,3755881905,3302626661,1672626063,1672628917,2854
7764,3304056063,3388286531,1672555243,1672555591,348
7644,3792883665,3519152550,1672668154,1672669896,1742
7711,3714474557,3793962300,1672561249,1672563357,2108
7937,3628819436,3505000737,1672643931,1672644184,253
7728,3792844210,3501606184,1672622997,1672625626,2629
7776,3519912874,3915628728,1672586874,1672588969,2095
7494,3774010081,3519803045,1672571364,1672573659,2295
7778,3793959750,3428006164,1672596120,1672599625,3505
7587,3416427576,3780639480,1672689804,1672693348,3544
7829,3220716272,3516065852,1672619192,1672622455,3263
7577,3614238812,3424922204,1672665178,1672666002,824
7811,3514472925,3500487333,1672571323,1672573400,2077
7953,3715581279,3311439795,1672680272,1672682113,1841
7667,3773429448,3825229501,1672546749,1672548290,1541
7725,3710569131,3792177074,1672537908,1672539086,1178
7509,3902383721,3607748895,1672565962,1672566242,280
7729,3910886626,3837094550,1672577222,1672578981,1759
7879,3477375368,3807987001,1672562967,1672564700,1733
7937,3931941795,3505201246,1672551955,1672553138,1183
7856,3613995936,3430504438,1672546128,1672547265,1137
7971,3882997884,3773465237,1672532567,1672532827,260
7632,3611150562,3791602225,1672556645,1672557409,764
7772,3777929708,3534729133,1672570268,1672573337,3069
7817,3972709319,3756601594,1672593816,1672595657,1841
7515,3501364586,3501692334,1672664799,1672665394,595
7524,3733189298,3734737881,1672544128,1672546402,2274
7830,3820354437,3471220483,1672642433,1672645722,3289
7624,3903009525,3889232789,1672605050,1672606063,1013
7811,3716835696,3516016437,1672696015,1672696737,722
7861,3228165483,3365278081,1672635726,1672638386,2660
7876,3733891182,3517963492,1672549950,1672552639,2689
7502,3711380716,3911245524,1672544155,1672547390,3235
7573,3639847263,3519703355,1672619580,1672622523,2943
7495,3512217942,3713894336,1672537910,1672540599,2689
7569,3511332835,3703223015,1672594339,1672595277,938
7916,3777983879,3909606423,1672560250,1672562830,2580
7636,3756966035,3639847263,1672624708,1672627346,2638
7519,3935127663,3756601594,1672544721,1672547669,2948
7734,3510703546,3791657947,1672537903,1672538376,473
7846,3855602893,3913251733,1672667739,1672671221,3482
7497,3716537575,3511687358,1672534588,1672534877,289
7916,3416241005,3202120784,1672586933,1672589917,2984
7599,3505347134,3899371911,1672621790,1672622322,532
7924,3501601840,3813052709,1672695855,1672697733,1878
7500,3666506258,3666457294,1672553353,1672555336,1983
7607,3426325549,3517476351,1672554344,1672555528,1184
7973,3417970574,3853018906,1672644543,1672645815,1272
7955,3836573197,3430504438,1672556950,1672557982,1032
7921,3910886626,3511841857,1672657668,1672657984,316
7536,3511198618,3606186086,1672680056,1672683125,3069
7830,3811694763,3918056059,1672626486,1672628956,2470
7916,3715581279,3514245078,1672541068,1672543045,1977
7955,3780294829,3209048907,1672553399,1672555294,1895
7617,3757151210,3505145247,1672554309,1672557247,2938
7769,3760077057,3509773875,1672561788,1672563670,1882
7879,3430504438,3922337974,1672601053,1672603163,2110
7598,3773978034,3346327502,1672617703,1672618998,1295
7754,3773664987,3429856982,1672665195,1672667096,1901
7740,3407954858,3438645253,1672701994,1672702430,436
7940,3318166135,3639847263,1672685035,1672687527,2492
7689,3505638204,3516465662,1672611597,1672612652,1055
7741,3827377568,3516673015,1672626948,1672627200,252
7635,3389115045,3911245524,1672567160,1672570646,3486
7731,3332072298,3783531004,1672668265,1672668735,470
7938,3520751702,3777079686,1672601760,1672602990,1230
7484,3621810464,3783126683,1672597863,1672598226,363
7787,3511271692,3416427576,1672544277,1672546035,1758
7665,3500458761,3349613093,1672577202,1672578180,978
7863,3757602960,3417587765,1672579917,1672581802,1885
7906,3501759100,3494290908,1672580482,1672582732,2250
7835,3301107849,3511198618,1672669988,1672670769,781
7904,3510126867,3417061462,1672535987,1672537523,1536
7646,3475795792,3713644518,1672564953,1672565974,1021
7966,3311274543,3733891182,1672667830,1672668645,815
7864,3390068992,3713894336,1672663213,1672666453,3240
7804,3500458761,3388372715,1672558699,1672560732,2033
7707,3505000737,3505599848,1672607709,1672608852,1143
7837,3493507965,3822654369,1672606679,1672607480,801
7621,3483949762,3889750851,1672579361,1672582005,2644
7676,3484995752,3772337814,1672531734,1672533637,1903
7959,3430504438,3533626375,1672678668,1672679252,584
7486,3889232789,3711380716,1672641952,1672642511,559
7579,3770553384,3244389794,1672588991,1672589473,482
7576,3458539365,3297463265,1672585626,1672587951,2325
7645,3776513891,3792177074,1672600241,1672600306,65
7831,3903009525,3773465237,1672565428,1672565564,136
7682,3777936328,3386707783,1672692079,1672694043,1964
7545,3534488837,3311871871,1672579321,1672582167,2846
7737,3701863557,3936227020,1672691968,1672692115,147
7834,3304056063,3378092448,1672583911,1672585926,2015
7925,3817316561,3246596716,1672553320,1672556625,3305
7567,3755511676,3247815299,1672612647,1672613131,484
7491,3500066230,3221899927,1672657960,1672659381,1421
7595,3200691026,3714488548,1672650142,1672652365,2223
7971,3666506258,3701534009,1672683442,1672685454,2012
7698,3473562469,3271938399,1672690176,1672693052,2876
7761,3757602960,3822654369,1672654145,1672656309,2164
7688,3475396323,3736786443,1672613882,1672616530,2648
7898,3887270940,3778305740,1672540364,1672541804,1440
7727,3488244966,3516465662,1672538892,1672542237,3345
7675,3716273414,3833889105,1672690265,1672692948,2683
7925,3500805881,3501692334,1672546301,1672549695,3394
7611,3514283243,3701184889,1672535804,1672538014,2210
7666,3500365158,3512969370,1672537363,1672539757,2394
7843,3791602225,3534424200,1672588595,1672590084,1489
7774,3828365570,3716843669,1672565109,1672565861,752
7647,3396285984,3922337974,1672674071,1672676955,2884
7559,3734496778,3636867411,1672589826,1672592481,2655
7678,3510594211,3760492950,1672591562,1672591981,419
7618,3783206719,3505173328,1672643513,1672644717,1204
7881,3791602225,3280964728,1672641587,1672643954,2367
7708,3520751702,3311415018,1672600511,1672601177,666
7630,3401627165,3534492426,1672654555,1672657844,3289
7489,3298288268,3490191091,1672635956,1672638990,3034
7759,3912262917,3396086535,1672566440,1672569052,2612
7890,3500499542,3407673904,1672695289,1672696037,748
7791,3770101921,3918247820,1672595635,1672597103,1468
7577,3716168623,3311603601,1672631138,1672631904,766
7843,3518669703,3505649239,1672687514,1672689028,1514
7641,3779036831,3517077106,1672680814,1672682555,1741
7697,3792668962,3512349371,1672558615,1672561105,2490
7943,3297463265,3755587522,1672536167,1672538667,2500
7546,3206593906,3501483568,1672593192,1672593483,291
7708,3519654779,3836573197,1672640791,1672641131,340
7753,3713969578,3885897503,1672559116,1672561451,2335
7853,3500177712,3518932404,1672680200,1672682373,2173
7503,3793086311,3316222192,1672538166,1672538441,275
7934,3501601840,3200198928,1672658479,1672660807,2328
7788,3773598056,3517077106,1672614233,1672615208,975
7496,3715339701,3792288302,1672597347,1672599510,2163
7950,3757455053,3772884106,1672637074,1672639380,2306
7982,3666506258,3485375593,1672651610,1672652088,478
7966,3792473331,3735319397,1672605337,1672606024,687
7912,3773205565,3520709480,1672554967,1672555563,596
7879,3683959482,3716273414,1672554889,1672557763,2874
7729,3400918687,3826415738,1672637409,1672640537,3128
7771,3760992710,3738274418,1672609066,1672609301,235
7848,3853018906,3922275416,1672544422,1672545356,934
7812,3200691026,3792177074,1672626900,1672630351,3451
7670,3315583351,3774520233,1672567641,1672569539,1898
7675,3501927421,3472130842,1672701327,1672704603,3276
7487,3244173074,3606987130,1672552377,1672555597,3220
7922,3517864478,3791553060,1672624232,1672625962,1730
7522,3703661585,3342131135,1672663747,1672667054,3307
7942,3809916577,3312664885,1672699343,1672701058,1715
7508,3760561634,3783239924,1672703852,1672706224,2372
7534,3244389794,3662180254,1672540983,1672541984,1001
7525,3223968713,3520629279,1672700774,1672701062,288
7748,3735319397,3915628728,1672587599,1672589688,2089
7839,3515151980,3733189298,1672703027,1672705047,2020
7501,3311324983,3735733948,1672567525,1672569739,2214
7975,3509907947,3501486692,1672537344,1672538306,962
7573,3511359172,3427283336,1672550303,1672550665,362
7688,3819727225,3606812411,1672623432,1672625425,1993
7960,3809916577,3519703355,1672648650,1672651424,2774
7503,3313564074,3714197325,1672591708,1672594458,2750
7844,3512720680,3716537575,1672618929,1672622423,3494
7650,3466911760,3360993964,1672643453,1672643828,375
7924,3209551760,3391915886,1672537179,1672539617,2438
7487,3793871337,3779218771,1672674296,1672677627,3331
7926,3500994774,3925402713,1672565337,1672566664,1327
7623,3711265369,3716835696,1672630863,1672631470,607
7870,3390068992,3209027249,1672621766,1672622139,373
7740,3331845324,3519912874,1672630200,1672633326,3126
7617,3360506772,3779528381,1672581622,1672583206,1584
7981,3770078063,3247815299,1672653483,1672654558,1075
7920,3334033993,3715339701,1672690898,1672691368,470
7895,3701691675,3394330287,1672584154,1672584601,447
7511,3500060260,3770553384,1672545821,1672547066,1245
7788,3505873261,3605726278,1672539347,1672539474,127
7675,3827377568,3836573197,1672584250,1672586326,2076
7778,3774466457,3703441914,1672693513,1672695727,2214
7930,3755587522,3601879040,1672582282,1672584006,1724
7554,3510937904,3201432789,1672569337,1672570601,1264
7726,3925402713,3736790081,1672585590,1672587853,2263
7914,3496549058,3912262917,1672569665,1672572890,3225
7536,3755625324,3336742544,1672685860,1672686606,746
7731,3244485293,3280599164,1672597105,1672598889,1784
7944,3770824086,3736790081,1672625714,1672626165,451
7553,3738274418,3828624701,1672603035,1672603701,666
7807,3730517636,3666507626,1672659747,1672660697,950
7630,3394539273,3880310724,1672695984,1672696146,162
7849,3519069599,3552314511,1672682994,1672684264,1270
7945,3374559242,3792789881,1672589252,1672592389,3137
7772,3703223015,3311761694,1672620922,1672623307,2385
7604,3792789881,3511435497,1672563193,1672566697,3504
7696,3881477378,3485008994,1672560334,1672563932,3598
7580,3304625412,3774045700,1672581249,1672582680,1431
7802,3777790718,3501759100,1672611248,1672611329,81
7903,3510594211,3311152102,1672612786,1672616229,3443
7845,3791874383,3458539365,1672555945,1672557279,1334
7796,3519563836,3734828619,1672626314,1672626439,125
7513,3386707783,3209551760,1672648099,1672648867,768
7875,3516980378,3315583351,1672637002,1672639377,2375
7569,3509672210,3774127586,1672599594,1672602976,3382
7936,3791942683,3800886801,1672703865,1672706477,2612
7961,3277939457,3716843669,1672570141,1672573401,3260
7511,3377766165,3736790081,1672643056,1672644065,1009
7843,3533280269,3511841857,1672653763,1672654593,830
7641,3520706195,3512349371,1672676565,1672679261,2696
7524,3288764520,3473765852,1672672132,1672672462,330
7798,3731419510,3513080274,1672538532,1672539088,556
7528,3404058699,3509604974,1672576571,1672579952,3381
7496,3516960534,3509933351,1672591508,1672594519,3011
7589,3904408902,3312829208,1672637534,1672638142,608
7665,3780593036,3811171116,1672666265,1672667246,981
7932,3774338212,3756930948,1672550047,1672553270,3223
7793,3311415018,3235287260,1672580459,1672581899,1440
7720,3792668962,3399433690,1672687145,1672689681,2536
7770,3294803686,3791334389,1672619989,1672620684,695
7694,3606987130,3505530961,1672624399,1672626862,2463
7579,3756424865,3774556560,1672691682,1672694000,2318
7541,3369998498,3412825109,1672603198,1672604715,1517
7765,3505883609,3780974443,1672581543,1672584131,2588
7818,3713808837,3418728074,1672539445,1672540145,700
7943,3975287541,3885897503,1672673181,1672676013,2832
7593,3417970574,3291883916,1672635766,1672636172,406
7638,3473765852,3756027749,1672615516,1672619049,3533
7750,3910886626,3760492950,1672573925,1672576465,2540
7824,3517721725,3773205565,1672665543,1672666262,719
7717,3937224533,3432665384,1672610085,1672613552,3467
7557,3827377568,3316173088,1672700919,1672701304,385
7934,3973560347,3613995936,1672687483,1672688922,1439
7692,3520888296,3501184421,1672689810,1672690182,372
7637,3520706195,3514987389,1672613195,1672615906,2711
7719,3489217083,3510126867,1672606202,1672608995,2793
7721,3778108318,3500803339,1672581258,1672583342,2084
7805,3516465662,3311415018,1672543168,1672545150,1982
7586,3778308417,3501486692,1672577688,1672579183,1495
7668,3515394721,3351008918,1672687822,1672688424,602
7955,3802367797,3777806071,1672631207,1672634027,2820
7741,3975287541,3776338577,1672698837,1672699436,599
7901,3481502100,3505135325,1672621144,1672624118,2974
7657,3477375368,3516258476,1672675896,1672679007,3111
7905,3505098372,3223789409,1672695430,1672697594,2164
7600,3755511676,3505362057,1672620613,1672622316,1703
7689,3885897503,3774045700,1672618275,1672618486,211
7808,3701691675,3512683609,1672600087,1672603094,3007
7749,3505873261,3505973226,1672614032,1672614411,379
7710,3773429448,3509630174,1672688387,1672689721,1334
7910,3520376528,3714504419,1672662747,1672664026,1279
7842,3500177712,3509630174,1672625260,1672627672,2412
7533,3921211276,3505599848,1672627345,1672628344,999
7688,3501364586,3518932404,1672622973,1672626082,3109
7891,3395152943,3377766165,1672571905,1672572483,578
7924,3513164386,3244436890,1672570161,1672570473,312
7637,3500904641,3711569060,1672698062,1672700296,2234
7775,3224058172,3777776687,1672551055,1672552513,1458
7625,3500578848,3970117174,1672700994,1672701244,250
7760,3228165483,3485375593,1672534069,1672537002,2933
7877,3515860749,3220716272,1672534592,1672535338,746
7609,3511862351,3777776687,1672580176,1672582392,2216
7792,3399052055,3510594211,1672546194,1672548328,2134
7921,3887270940,3979339287,1672617967,1672620830,2863
7748,3774045700,3626156564,1672586301,1672587196,895
7880,3424922204,3757161914,1672681391,1672682453,1062
7679,3757151210,3791901535,1672559208,1672561511,2303
7918,3516223597,3713630656,1672558876,1672559294,418
7803,3429690204,3778549126,1672657607,1672659544,1937
7550,3234362962,3511841857,1672600577,1672603676,3099
7785,3520888296,3271938399,1672595196,1672597966,2770
7838,3247428249,3279721246,1672605842,1672609223,3381
7842,3776948966,3979339287,1672689231,1672692001,2770
7606,3466229085,3777936328,1672532211,1672534507,2296
7933,3249791738,3793086311,1672699843,1672703261,3418
7982,3756453423,3926700506,1672688450,1672691641,3191
7819,3365278081,3780365428,1672699691,1672700656,965
7731,3774195321,3713894336,1672550143,1672550483,340
7538,3451432842,3367029997,1672569508,1672571033,1525
7924,3779740455,3244389794,1672553524,1672555572,2048
7930,3485823740,3520165601,1672672672,1672674650,1978
7710,3287105466,3519069599,1672667333,1672668739,1406
7801,3917278625,3500229033,1672567639,1672568966,1327
7521,3816853177,3304056063,1672555070,1672556086,1016
7726,3783779671,3485375593,1672629847,1672632610,2763
7671,3817316561,3791115967,1672587707,1672590200,2493
7713,3427219654,3271938399,1672701212,1672704231,3019
7540,3550946908,3828624701,1672552817,1672555411,2594
7497,3318166135,3221536550,1672614584,1672617959,3375
7870,3715492942,3816853177,1672624784,1672627171,2387
7878,3732481297,3711198793,1672535044,1672536454,1410
7983,3760183458,3891751546,1672650546,1672652398,1852
7802,3607178184,3337544549,1672668174,1672668707,533
7757,3760992710,3916289176,1672602488,1672604183,1695
7853,3777443199,3374559242,1672561688,1672562499,811
7957,3774580701,3399535232,1672686708,1672688849,2141
7856,3793338102,3859663348,1672532199,1672535443,3244
7515,3516514391,3402943525,1672701139,1672703972,2833
7765,3518791447,3701065786,1672650168,1672652746,2578
7490,3925620998,3511359172,1672663668,1672663857,189
7891,3701498253,3510711755,1672568561,1672569188,627
7673,3770101921,3774556560,1672654339,1672657560,3221
7963,3791334389,3407725581,1672580027,1672582509,2482
7739,3520709480,3858918246,1672644063,1672646507,2444
7522,3221536550,3755920131,1672563770,1672564758,988
7647,3448855696,3792883665,1672657587,1672661003,3416
7943,3793470489,3206603608,1672603532,1672606377,2845
7827,3703889596,3714474557,1672694965,1672696595,1630
7621,3311603601,3773205565,1672649326,1672652777,3451
7926,3519556068,3637008488,1672565063,1672567378,2315
7565,3505477652,3774195321,1672620052,1672620801,749
7635,3774195321,3493507965,1672587401,1672588252,851
7610,3714504419,3735319397,1672637677,1672639757,2080
7628,3312333615,3505649239,1672607735,1672608311,576
7750,3505635228,3501486692,1672696647,1672698655,2008
7749,3774195321,3500487333,1672560642,1672560981,339
7787,3629935998,3451432842,1672683488,1672686244,2756
7692,3517721725,3516258476,1672562372,1672564458,2086
7901,3903962771,3914259449,1672640862,1672642426,1564
7736,3713268590,3387674757,1672662347,1672664030,1683
7665,3804870229,3533827120,1672589645,1672591615,1970
7533,3512166013,3701184889,1672695192,1672696391,1199
7606,3500374658,3220716272,1672662485,1672664739,2254
7665,3629547065,3489217083,1672601669,1672603189,1520
7688,3533270638,3922337974,1672668903,1672669724,821
7651,3284639858,3792032359,1672543145,1672545016,1871
7523,3284639858,3511198618,1672592336,1672594423,2087
7649,3489728806,3600647945,1672669955,1672670505,550
7966,3556951786,3559110998,1672585717,1672587012,1295
7853,3222521619,3307512479,1672592332,1672593532,1200
7919,3493507965,3311154569,1672538691,1672542139,3448
7824,3737154119,3520030713,1672695344,1672697304,1960
7841,3757447189,3519556068,1672610777,1672614365,3588
7726,3682061100,3776338577,1672539770,1672542025,2255
7622,3453729665,3490191091,1672633316,1672633946,630
7857,3510711755,3505635228,1672702152,1672705675,3523
7585,3778266283,3701984666,1672675060,1672677019,1959
7804,3332072298,3792177074,1672686699,1672689500,2801
7665,3519152550,3975287541,1672607782,1672609283,1501
7499,3301107849,3701984666,1672605270,1672606962,1692
7533,3772884106,3555214688,1672620016,1672622863,2847
7866,3777455223,3505599848,1672670231,1672672697,2466
7731,3490191091,3505635228,1672647493,1672647583,90
7562,3731106822,3517721725,1672672037,1672675596,3559
7566,3512683609,3793436995,1672568266,1672570786,2520
7764,3716835696,3913251733,1672580710,1672583116,2406
7955,3760598102,3514283243,1672552892,1672555656,2764
7754,3730517636,3774520233,1672607751,1672608776,1025
7821,3755943611,3733891182,1672560632,1672561431,799
7530,3776948966,3500894271,1672544845,1672547074,2229
7952,3735733948,3291227780,1672538990,1672540079,1089
7897,3338367113,3736592744,1672676074,1672678461,2387
7965,3515394721,3783705817,1672566468,1672567343,875
7557,3200691026,3501601840,1672647474,1672649629,2155
7654,3362000049,3899266183,1672557773,1672558241,468
7618,3559110998,3606812411,1672682769,1672683938,1169
7800,3909238838,3711370563,1672603547,1672606777,3230
7822,3489217083,3770078063,1672639147,1672640151,1004
7809,3533193862,3520931254,1672583311,1672585403,2092
7488,3533626375,3232962003,1672617433,1672619478,2045
7972,3757812939,3342131135,1672589091,1672592242,3151
7731,3615046771,3236102733,1672606556,1672608925,2369
7891,3855602893,3629547065,1672554771,1672557842,3071
7503,3793848402,3757246925,1672622626,1672623877,1251
7529,3291883916,3516465662,1672554270,1672554570,300
7665,3756528686,3779740455,1672641608,1672643864,2256
7874,3201432789,3378436155,1672594350,1672597925,3575
7917,3760294205,3404384505,1672627435,1672628297,862
7809,3509630174,3805292782,1672661034,1672663012,1978
7792,3276640712,3500487333,1672549520,1672552281,2761
7637,3516465662,3311761694,1672594506,1672597992,3486
7673,3910454786,3420432297,1672577822,1672580259,2437
7501,3688683847,3287105466,1672541162,1672544232,3070
7903,3716165213,3307512479,1672677677,1672679491,1814
7517,3234362962,3756451663,1672561220,1672563073,1853
7749,3976390453,3666506258,1672554551,1672556673,2122
7720,3352603894,3417970574,1672703839,1672706932,3093
7555,3793962300,3227457126,1672675469,1672677221,1752
7532,3914259449,3505530961,1672653202,1672654850,1648
7918,3316173088,3520629279,1672691278,1672694681,3403
7982,3500199935,3881477378,1672546910,1672550255,3345
7561,3511332835,3280615985,1672632101,1672633094,993
7523,3453729665,3755511676,1672671542,1672673375,1833
7531,3475795792,3311065516,1672589287,1672590512,1225
7616,3804870229,3333896808,1672615167,1672615529,362
7660,3379589402,3494290908,1672576693,1672580197,3504
7655,3331845324,3511170269,1672569390,1672571132,1742
7497,3618873142,3501730685,1672561695,1672564757,3062
7674,3511267139,3370636709,1672548747,1672549168,421
7875,3336742544,3496269445,1672533646,1672534212,566
7904,3783779671,3365830990,1672595258,1672596402,1144
7697,3512349371,3209551760,1672641378,1672644794,3416
7701,3365942576,3807987001,1672580368,1672580446,78
7710,3736786443,3737154119,1672535311,1672538297,2986
7485,3774338212,3812176780,1672699442,1672699732,290
7733,3307512479,3739106581,1672634993,1672635425,432
7739,3533369198,3812176780,1672602781,1672604819,2038
7917,3559110998,3384951177,1672550823,1672553829,3006
7837,3777717988,3242408357,1672546887,1672548764,1877
7628,3505098372,3475396323,1672682354,1672682696,342
7812,3511267139,3514128943,1672682363,1672685596,3233
7978,3510247121,3416241005,1672539429,1672540584,1155
7874,3716843669,3297463265,1672535268,1672536032,764
7745,3533385867,3713644518,1672695271,1672697091,1820
7894,3666553782,3793286136,1672700796,1672701396,600
7814,3249791738,3500803339,1672604533,1672606029,1496
7903,3777623166,3783206719,1672666072,1672666349,277
7537,3533827120,3477375368,1672635792,1672637889,2097
7983,3772746272,3249247700,1672566127,1672567081,954
7643,3235635976,3783705817,1672665122,1672666588,1466
7950,3915628728,3779218771,1672536303,1672536714,411
7532,3780813786,3715339701,1672659173,1672659911,738
7791,3918674986,3512720680,1672628659,1672632194,3535
7946,3935127663,3792902982,1672658519,1672658863,344
7832,3757812939,3344019610,1672546586,1672548841,2255
7972,3793962300,3384240055,1672611963,1672614092,2129
7876,3475795792,3770021824,1672606900,1672609098,2198
7601,3223968713,3714962248,1672659047,1672662422,3375
7511,3311065516,3202120784,1672597641,1672598932,1291
7812,3780974443,3756453423,1672551413,1672553281,1868
7645,3715998609,3777790718,1672674141,1672676018,1877
7484,3465254146,3780639480,1672533896,1672536433,2537
7880,3505362057,3480687894,1672699995,1672703499,3504
7903,3344364444,3925620998,1672590319,1672591672,1353
7523,3791957752,3520709480,1672697606,1672701029,3423
7504,3606812411,3756528686,1672647756,1672650401,2645
7550,3533810360,3755739653,1672567636,1672570415,2779
7798,3201432789,3777936328,1672545716,1672548059,2343
7946,3701967560,3475251781,1672558664,1672561044,2380
7584,3701967560,3757455053,1672701503,1672703461,1958
7959,3420700674,3888559320,1672608621,1672612141,3520
7694,3236102733,3420700674,1672539085,1672540579,1494
7755,3206603608,3518014636,1672679001,1672679297,296
7980,3209048907,3757455053,1672590063,1672592172,2109
7495,3319752091,3827626797,1672690783,1672691972,1189
7823,3476232529,3489545239,1672619459,1672622330,2871
7917,3760077057,3890149705,1672534075,1672537124,3049
7655,3811694763,3533385867,1672590180,1672591349,1169
7686,3356860407,3519912874,1672606768,1672610047,3279
7501,3387674757,3501483568,1672662083,1672664435,2352
7735,3378092448,3392121505,1672632356,1672632474,118
7531,3517476351,3917088658,1672599162,1672600064,902
7590,3501364586,3400918687,1672682947,1672685533,2586
7538,3298288268,3783196518,1672572447,1672573163,716
7894,3618045231,3342131135,1672544984,1672545178,194
7966,3793848402,3774127586,1672641597,1672643376,1779
7818,3778780511,3246596716,1672622293,1672622427,134
7795,3756027749,3520376528,1672546512,1672548066,1554
7682,3515284591,3334033993,1672669661,1672671792,2131
7538,3627937312,3227158514,1672661844,1672663585,1741
7744,3533280269,3607178184,1672556081,1672559166,3085
7497,3793470489,3510594211,1672642723,1672646004,3281
7494,3711504540,3248507722,1672587516,1672587878,362
7594,3500374658,3711198793,1672627455,1672629632,2177
7970,3494290908,3828624701,1672631203,1672632719,1516
7660,3805519285,3855937514,1672616381,1672617142,761
7804,3448855696,3511332835,1672585911,1672588135,2224
7584,3505000737,3855424474,1672631746,1672632566,820
7939,3533626375,3505883609,1672658571,1672660140,1569
7963,3513599775,3773978034,1672540292,1672540511,219
7872,3791602225,3815508790,1672608861,1672610775,1914
7829,3807987001,3318166135,1672602862,1672605105,2243
7864,3624312512,3279721246,1672654381,1672654540,159
7859,3793959750,3791997875,1672577131,1672577939,808
7935,3520751702,3505145247,1672611571,1672613948,2377
7520,3412980697,3736790081,1672640317,1672641818,1501
7589,3512510536,3533927138,1672669341,1672671590,2249
7855,3858918246,3780294829,1672662612,1672665216,2604
7789,3887270940,3311648200,1672693282,1672693566,284
7757,3454042520,3311154569,1672554664,1672556303,1639
7784,3883042241,3280615985,1672546284,1672548952,2668
7644,3780914982,3714504419,1672609714,1672611001,1287
7956,3978105277,3515151980,1672637222,1672638041,819
7534,3756601594,3713268590,1672661114,1672663916,2802
7794,3757602960,3624761861,1672696066,1672698562,2496
7582,3778980116,3515125508,1672677313,1672680163,2850
7624,3516606733,3301107849,1672698755,1672701386,2631
7873,3756027749,3399911573,1672615426,1672618860,3434
7508,3311274543,3312829208,1672596456,1672596639,183
7772,3475251781,3554917400,1672687352,1672688381,1029
7755,3703013906,3779629905,1672608923,1672609395,472
7654,3520030713,3736229191,1672612413,1672614385,1972
7851,3221536550,3496269445,1672653234,1672653473,239
7707,3911245524,3819727225,1672585988,1672587849,1861
7537,3443698222,3209551760,1672542170,1672542427,257
7940,3276993580,3701190899,1672677340,1672680772,3432
7555,3774298222,3360993964,1672636865,1672638827,1962
7720,3505912939,3734737881,1672650101,1672652229,2128
7582,3774195321,3701111745,1672628344,1672629466,1122
7953,3301107849,3496549058,1672689718,1672690706,988
7654,3439023335,3713349754,1672645622,1672647912,2290
7850,3311090974,3510703546,1672559279,1672560620,1341
7969,3756601594,3534313900,1672701125,1672702982,1857
7681,3772544062,3505973226,1672579537,1672582286,2749
7695,3313541986,3713894336,1672698171,1672701193,3022
7743,3760183458,3458539365,1672699009,1672701838,2829
7496,3338367113,3510247121,1672673183,1672676267,3084
7891,3755798867,3412825109,1672590824,1672592948,2124
7641,3511862351,3432689543,1672594046,1672594120,74
7869,3370636709,3859663348,1672666310,1672667451,1141
7893,3434642576,3473765852,1672687943,1672689730,1787
7693,3424922204,3835382117,1672543424,1672545312,1888
7831,3386707783,3792032359,1672584998,1672588482,3484
7736,3773205565,3485823740,1672537950,1672541271,3321
7780,3383922351,3883551721,1672591732,1672593683,1951
7826,3514719601,3732481297,1672570874,1672571268,394
7815,3779218771,3516909237,1672617032,1672618144,1112
7722,3701898991,3511271692,1672570564,1672571145,581
7606,3777455223,3737051610,1672611117,1672611190,73
7835,3365614305,3421127249,1672546526,1672547337,811
7491,3666553782,3533369198,1672561507,1672561771,264
7677,3475795792,3922275416,1672575618,1672578361,2743
7969,3736786443,3318697153,1672582424,1672583085,661
7622,3783126683,3713268590,1672545817,1672546775,958
7626,3804870229,3774580701,1672687120,1672690581,3461
7580,3420432297,3885897503,1672661006,1672661355,349
7711,3415443558,3715981584,1672624663,1672625299,636
7585,3888559320,3918247820,1672535965,1672537786,1821
7622,3511332835,3273500349,1672564376,1672567138,2762
7735,3791957752,3475795792,1672665516,1672666653,1137
7855,3605726278,3311208440,1672581776,1672583297,1521
7548,3716197887,3512720680,1672634398,1672634895,497
7846,3249247700,3828432634,1672572299,1672573321,1022
7761,3247428249,3510703546,1672688125,1672688237,112
7603,3505098372,3805347939,1672697406,1672700686,3280
7760,3519803045,3500904641,1672634851,1672637993,3142
7968,3912536808,3472130842,1672568775,1672570723,1948
7713,3826760240,3937224533,1672606063,1672607508,1445
7656,3736419952,3792789881,1672629145,1672631429,2284
7847,3688683847,3515125508,1672595375,1672596432,1057
7629,3432689543,3505702787,1672646730,1672648591,1861
7759,3533193862,3757151210,1672658037,1672659784,1747
7491,3421127249,3773814927,1672600441,1672600738,297
7489,3516011407,3406784491,1672697030,1672700372,3342
7813,3777120536,3466229085,1672625110,1672626176,1066
7620,3501606184,3909238838,1672552554,1672552699,145
7756,3778266283,3338703270,1672545149,1672547487,2338
7632,3500060260,3533927138,1672586926,1672587509,583
7600,3533025282,3412980697,1672631500,1672633402,1902
7682,3501955238,3516223597,1672671838,1672675367,3529
7495,3392121505,3386707783,1672584510,1672586857,2347
7942,3780593036,3890149705,1672573054,1672574972,1918
7563,3365942576,3826760240,1672642543,1672643388,845
7666,3483164654,3314245084,1672684455,1672686419,1964
7842,3365614305,3336751428,1672581127,1672584418,3291
7638,3783239924,3792384220,1672667949,1672668819,870
7787,3780365428,3391915886,1672562571,1672563830,1259
7566,3716168623,3377766165,1672531254,1672532960,1706
7534,3805519285,3738274418,1672680978,1672682834,1856
7971,3311274543,3517077106,1672549627,1672552364,2737
7580,3418728074,3828432634,1672538244,1672539569,1325
7528,3777983879,3533927138,1672608983,1672611392,2409
7610,3617055293,3500805881,1672667321,1672668541,1220
7616,3774005526,3780503655,1672592397,1672593047,650
7677,3760509236,3622054816,1672697375,1672698976,1601
7820,3713268590,3774556560,1672542667,1672544001,1334
7782,3716900301,3284832486,1672571889,1672573745,1856
7680,3881477378,3760569731,1672656696,1672657136,440
7509,3770763956,3517077106,1672604032,1672606571,2539
7808,3715581279,3701146057,1672628399,1672629028,629
7868,3515394721,3604539807,1672605081,1672605188,107
7763,3516909237,3500487333,1672675556,1672676295,739
7914,3621810464,3505477652,1672535059,1672537800,2741
7944,3813052709,3809484172,1672611705,1672614222,2517
7920,3613683164,3516011407,1672676806,1672678888,2082
7602,3514128943,3888559320,1672540272,1672542348,2076
7816,3772642849,3685187183,1672554191,1672556904,2713
7839,3346327502,3505173328,1672553779,1672556887,3108
7825,3827626797,3778980116,1672670674,1672671029,355
7746,3289061738,3711308224,1672606603,1672609778,3175
7485,3629935998,3773664987,1672578176,1672579296,1120
7833,3783705817,3510711755,1672693296,1672695708,2412
7768,3311065516,3404058699,1672603843,1672607160,3317
7833,3793086311,3433804879,1672614907,1672615745,838
7718,3783126683,3505292701,1672679935,1672681238,1303
7948,3757812939,3772544062,1672693702,1672695221,1519
7599,3805342762,3685187183,1672561224,1672563940,2716
7485,3396285984,3513080274,1672587491,1672589659,2168
7797,3701178711,3222448362,1672563380,1672564827,1447
7922,3755436115,3518014404,1672625229,1672626960,1731
7558,3760569731,3512969370,1672681882,1672683384,1502
7632,3760183458,3714488548,1672545184,1672547785,2601
7976,3428006164,3733891182,1672572034,1672574118,2084
7769,3514245078,3825229501,1672620197,1672621211,1014
7805,3734496778,3351008918,1672640814,1672642291,1477
7726,3500904641,3244436890,1672690289,1672691254,965
7555,3313541986,3533137446,1672556878,1672558146,1268
7904,3512540951,3493507965,1672596284,1672597404,1120
7513,3510937904,3791553060,1672598240,1672599796,1556
7976,3227457126,3760509236,1672631717,1672632248,531
7581,3358871377,3426325549,1672537900,1672539982,2082
7684,3793436995,3357483218,1672662099,1672665616,3517
7859,3780828689,3378686918,1672564061,1672564624,563
7599,3756462516,3516039895,1672685116,1672686762,1646
7579,3337544549,3791602225,1672562796,1672566139,3343
7838,3792844210,3339907603,1672571785,1672572939,1154
7634,3734496778,3365278081,1672688054,1672688272,218
7959,3519912874,3774195321,1672697509,1672698919,1410
7769,3791657947,3516465662,1672656155,1672658991,2836
7855,3780294829,3914259449,1672541322,1672544332,3010
7920,3357483218,3430352815,1672696045,1672697373,1328
7794,3608633356,3511359172,1672619711,1672623008,3297
7764,3509933351,3791997875,1672595306,1672596543,1237
7836,3703789494,3311152102,1672624850,1672626061,1211
7503,3286658957,3433804879,1672532083,1672533236,1153
7822,3510771358,3791957752,1672655769,1672657137,1368
7719,3703661585,3826759140,1672664526,1672665394,868
7545,3515284591,3972709319,1672632298,1672632404,106
7486,3235287260,3791602225,1672558186,1672560483,2297
7895,3606186086,3520931254,1672683200,1672685235,2035
7926,3936227020,3319752091,1672537434,1672540876,3442
7676,3936227020,3732481297,1672581203,1672582150,947
7749,3514245078,3760294205,1672583780,1672584661,881
7842,3770763956,3979339287,1672662259,1672664173,1914
7950,3360506772,3515284591,1672632021,1672633371,1350
7527,3777790718,3409474775,1672572318,1672573601,1283
7573,3365614305,3512683609,1672652421,1672654729,2308
7864,3534488837,3779528381,1672635707,1672636869,1162
7777,3607178184,3505477652,1672617357,1672620639,3282
7898,3714821932,3505145247,1672648537,1672651105,2568
7610,3407673904,3516673015,1672702092,1672702509,417
7560,3512720680,3793389510,1672604517,1672607756,3239
7665,3481647420,3703223015,1672661197,1672664441,3244
7820,3515860749,3922337974,1672547788,1672550425,2637
7947,3855000166,3703013906,1672538918,1672539368,450
7665,3505638204,3519703355,1672598396,1672601959,3563
7512,3760561634,3713894336,1672545378,1672548396,3018
7912,3780609808,3428006164,1672566500,1672569568,3068
7909,3909606423,3976390453,1672537930,1672538944,1014
7655,3668005723,3774466457,1672604181,1672604702,521
7650,3378436155,3621497531,1672664566,1672664655,89
7782,3776066388,3518669703,1672533487,1672536885,3398
7691,3232962003,3773664987,1672561243,1672564322,3079
7614,3302626661,3772309150,1672689581,1672693066,3485
7658,3793871337,3918247820,1672633787,1672637269,3482
7685,3466911760,3891751546,1672592411,1672592961,550
7978,3404058699,3811171116,1672548604,1672548997,393
7893,3311208440,3533626375,1672588481,1672588542,61
7685,3512166013,3534702203,1672644189,1672645112,923
7573,3822654369,3505477652,1672672842,1672673718,876
7871,3898995675,3244436890,1672554556,1672555836,1280
7764,3505912939,3701898991,1672629933,1672633474,3541
7922,3783925755,3378436155,1672605372,1672606497,1125
7785,3378436155,3475251781,1672695829,1672696795,966
7595,3925402713,3736419952,1672650406,1672652144,1738
7731,3505347134,3791553060,1672696428,1672698252,1824
7607,3817621391,3293695955,1672580403,1672581111,708
7691,3514472925,3200198928,1672599442,1672599689,247
7980,3820354437,3756930948,1672696529,1672696915,386
7810,3976390453,3500199935,1672606529,1672608370,1841
7732,3777983879,3477375368,1672672547,1672673431,884
7884,3206254161,3284832486,1672640273,1672640954,681
7857,3817316561,3247428249,1672553908,1672557096,3188
7667,3505973226,3770101921,1672537840,1672540269,2429
7769,3334033993,3505362057,1672648235,1672650287,2052
7847,3613995936,3388286531,1672576243,1672577807,1564
7769,3311993075,3756424865,1672592617,1672595924,3307
7942,3500578848,3500487333,1672576791,1672578811,2020
7582,3979339287,3909331423,1672679470,1672682262,2792
7938,3533385867,3772337814,1672534659,1672536064,1405
7818,3383661227,3497901842,1672569534,1672572425,2891
7728,3915628728,3783083229,1672547994,1672549176,1182
7706,3352603894,3777623166,1672576376,1672577426,1050
7723,3817316561,3533280269,1672587884,1672590145,2261
7665,3826760240,3342131135,1672668185,1672669991,1806
7758,3903307060,3792902982,1672597950,1672601204,3254
7791,3430504438,3421836608,1672573705,1672574562,857
7773,3805342762,3520931254,1672655395,1672657576,2181
7795,3715998609,3613995936,1672665578,1672665745,167
7701,3792177074,3736625083,1672560114,1672560669,555
7597,3407673904,3909238838,1672701526,1672702784,1258
7891,3733891182,3703013906,1672548743,1672550011,1268
7795,3703661585,3489962019,1672701920,1672704302,2382
7904,3380035798,3660493209,1672668337,1672668824,487
7875,3438645253,3899204805,1672647044,1672648317,1273
7588,3201848640,3500578848,1672633940,1672635686,1746
7636,3249247700,3200198928,1672691132,1672691736,604
7690,3515151980,3500229033,1672597558,1672599320,1762
7560,3467773920,3624312512,1672554572,1672556860,2288
7599,3516606733,3780294829,1672561972,1672564422,2450
7750,3427283336,3772337814,1672593514,1672595240,1726
7955,3713786889,3827222533,1672552394,1672555703,3309
7975,3244436890,3711265369,1672559033,1672560563,1530
7633,3774556560,3608868877,1672554249,1672555293,1044
7861,3811171116,3399052055,1672536633,1672540022,3389
7810,3783509527,3520165601,1672643305,1672645622,2317
7927,3664170666,3311065516,1672695134,1672698647,3513
7586,3247815299,3244389794,1672627119,1672630271,3152
7629,3618045231,3666506258,1672639472,1672642529,3057
7917,3510380060,3501483568,1672550666,1672554146,3480
7916,3277669002,3510247121,1672549510,1672552074,2564
7866,3513956646,3311274543,1672656782,1672660199,3417
7772,3399911573,3298433163,1672676996,1672678171,1175
7518,3318166135,3634995491,1672629374,1672629599,225
7883,3477649378,3534010629,1672542542,1672543550,1008
7654,3467773920,3738274418,1672583317,1672586191,2874
7916,3711571712,3793086311,1672549613,1672551330,1717
7861,3519803045,3235287260,1672678484,1672681441,2957
7931,3384240055,3715339701,1672629397,1672632557,3160
7509,3607748895,3855424474,1672669219,1672669704,485
7943,3883861463,3333896808,1672694759,1672696048,1289
7855,3805292782,3778549126,1672656508,1672656889,381
7595,3774066725,3899266183,1672653543,1672655195,1652
7707,3772884106,3387674757,1672620531,1672622433,1902
7587,3505869747,3624761861,1672595123,1672598537,3414
7680,3360743849,3487171044,1672605270,1672607558,2288
7792,3346795719,3978105277,1672675990,1672676917,927
7684,3365278081,3224058172,1672675469,1672677025,1556
7950,3231056870,3311845971,1672683483,1672686737,3254
7935,3512217942,3716197887,1672629421,1672632388,2967
7937,3703013906,3404384505,1672561984,1672564560,2576
7683,3489217083,3890149705,1672570318,1672573737,3419
7561,3886298125,3660493209,1672532725,1672535645,2920
7911,3221899927,3533095755,1672604432,1672607717,3285
7956,3515125508,3733891182,1672620616,1672623341,2725
7732,3774045700,3770021824,1672701421,1672703062,1641
7603,3898995675,3714962248,1672645971,1672648032,2061
7944,3280615985,3365278081,1672632130,1672632598,468
7956,3428006164,3780294829,1672627633,1672630346,2713
7898,3514987389,3773429448,1672630162,1672631220,1058
7514,3931941795,3710408395,1672595695,1672597175,1480
7490,3716165213,3511687358,1672536188,1672539633,3445
7874,3791594391,3811171116,1672600715,1672602273,1558
7557,3918056059,3664517356,1672573768,1672576910,3142
7594,3333896808,3793436995,1672687071,1672690142,3071
7844,3231056870,3778549126,1672646122,1672648280,2158
7693,3399004969,3364543015,1672564809,1672567821,3012
7926,3732481297,3378092448,1672535420,1672538629,3209
7882,3387966152,3316173088,1672589143,1672591291,2148
7598,3774520233,3912536808,1672621659,1672622686,1027
7532,3774466457,3510771358,1672631786,1672634924,3138
7742,3248507722,3783083229,1672546186,1672548221,2035
7861,3518408774,3512837326,1672600345,1672602741,2396
7764,3828365570,3756453423,1672538770,1672538963,193
7653,3713268590,3710344260,1672586041,1672587148,1107
7483,3432665384,3365614305,1672604834,1672608054,3220
7770,3776948966,3520888296,1672558762,1672560307,1545
7684,3627937312,3883312122,1672674069,1672675813,1744
7743,3505098372,3760294205,1672656456,1672659029,2573
7847,3372883226,3360743849,1672667855,1672671144,3289
7584,3776338577,3772309150,1672613476,1672616259,2783
7738,3791594391,3755798867,1672649840,1672653227,3387
7505,3621497531,3883551721,1672678311,1672681549,3238
7528,3311648200,3827626797,1672598277,1672598692,415
7917,3519700826,3514987389,1672606013,1672608097,2084
7775,3312333615,3783429780,1672588059,1672589362,1303
7891,3805342762,3519428855,1672663808,1672665065,1257
7614,3817316561,3501198706,1672631850,1672633657,1807
7521,3289061738,3513956646,1672545951,1672549394,3443
7825,3899204805,3377766165,1672531493,1672532373,880
7614,3448855696,3248507722,1672583134,1672586438,3304
7496,3294803686,3513956646,1672577010,1672579809,2799
7956,3792789881,3902383721,1672556653,1672559297,2644
7902,3833889105,3818255890,1672551848,1672552637,789
7940,3973560347,3777514571,1672585623,1672587134,1511
7748,3231056870,3515151980,1672616396,1672616787,391
7533,3520165601,3826759140,1672563479,1672565222,1743
7840,3297463265,3755392666,1672654937,1672657784,2847
7820,3666506258,3359910781,1672670175,1672672361,2186
7972,3515394721,3420432297,1672593147,1672593973,826
7551,3710067113,3730517636,1672601197,1672604499,3302
7655,3200691026,3311627628,1672633044,1672636333,3289
7619,3776948966,3935127663,1672682458,1672683491,1033
7664,3639847263,3559110998,1672648698,1672649363,665
7534,3774204963,3390068992,1672614713,1672616071,1358
7543,3901877072,3792177074,1672625607,1672628348,2741
7894,3556951786,3701995648,1672679857,1672681524,1667
7670,3904408902,3805292782,1672652842,1672654272,1430
7719,3710569131,3772309150,1672678849,1672681977,3128
7707,3302626661,3489545239,1672656092,1672656191,99
7483,3834257412,3792668962,1672536159,1672539507,3348
7803,3813052709,3793627961,1672565780,1672568246,2466
7823,3666506258,3311648200,1672683864,1672684559,695
7655,3716258994,3772309150,1672603424,1672604101,677
7960,3776066388,3390068992,1672541121,1672542455,1334
7881,3227457126,3683959482,1672653557,1672655627,2070
7763,3772578994,3516065852,1672696484,1672697391,907
7486,3732481297,3772746272,1672643150,1672645284,2134
7506,3819727225,3315583351,1672576469,1672576966,497
7483,3917088658,3361230905,1672694500,1672695945,1445
7526,3348261553,3505883609,1672592006,1672594359,2353
7639,3362000049,3416427576,1672594437,1672595586,1149
7841,3336742544,3791942683,1672610057,1672613290,3233
7874,3294803686,3757447189,1672603836,1672605647,1811
7533,3291227780,3337544549,1672591377,1672591714,337
7885,3443698222,3500487333,1672671517,1672672244,727
7710,3783531004,3534488837,1672595011,1672596149,1138
7791,3510703546,3711308224,1672642408,1672644382,1974
7487,3520709480,3773598056,1672572592,1672573152,560
7873,3512166013,3701967560,1672647136,1672647533,397
7496,3636867411,3332072298,1672635664,1672635899,235
7492,3802367797,3234541252,1672605610,1672608231,2621
7702,3519601612,3611150562,1672597474,1672598215,741
7766,3703871468,3432665384,1672604757,1672607160,2403
7612,3248507722,3421127249,1672676096,1672678842,2746
7896,3313541986,3737154119,1672660908,1672662566,1658
7800,3311648200,3351008918,1672622695,1672625352,2657
7576,3365278081,3774298222,1672613317,1672614580,1263
7810,3246596716,3519428855,1672654640,1672655248,608
7801,3932051427,3513956646,1672546467,1672548260,1793
7752,3520629279,3757161914,1672553675,1672556901,3226
7483,3415546117,3823600322,1672662628,1672665404,2776
7686,3511435497,3511862351,1672570968,1672572629,1661
7895,3783509527,3427219654,1672590686,1672593542,2856
7533,3615046771,3607748895,1672616038,1672618528,2490
7648,3316222192,3736229191,1672612473,1672614567,2094
7528,3505873261,3835382117,1672689147,1672689457,310
7584,3505347134,3851190615,1672533023,1672535551,2528
7834,3793848402,3889232789,1672626734,1672627326,592
7782,3774066725,3628819436,1672585254,1672587247,1993
7601,3346327502,3280964728,1672590711,1672593143,2432
7943,3519556068,3792883665,1672693595,1672695919,2324
7484,3533748232,3783925755,1672641604,1672644584,2980
7952,3505973226,3778549126,1672652987,1672654875,1888
7968,3519152550,3736790081,1672583455,1672586520,3065
7587,3500904641,3505962865,1672641024,1672641509,485
7788,3415546117,3910454786,1672549812,1672550867,1055
7495,3812176780,3475258557,1672634487,1672636927,2440
7899,3388286531,3823600322,1672595143,1672595549,406
7905,3703718151,3755436115,1672610179,1672610573,394
7722,3494290908,3914259449,1672672525,1672675256,2731
7505,3783206719,3809059934,1672632612,1672632862,250
7622,3760893269,3223968713,1672553847,1672555422,1575
7577,3312664885,3439023335,1672548328,1672548429,101
7630,3756453423,3401627165,1672650097,1672653450,3353
7818,3738502357,3817316561,1672693417,1672696333,2916
7525,3432689543,3515860749,1672543823,1672546079,2256
7598,3513599775,3396086535,1672676400,1672677657,1257
7637,3224058172,3701146057,1672683429,1672684677,1248
7848,3316222192,3516223597,1672635237,1672638606,3369
7677,3485375593,3770851318,1672561842,1672565183,3341
7853,3760893269,3895562476,1672568711,1672571136,2425
7847,3701065786,3783779671,1672618044,1672618407,363
7488,3614238812,3774556560,1672692561,1672694472,1911
7974,3804870229,3613683164,1672577658,1672579466,1808
7590,3466911760,3713969578,1672646039,1672647131,1092
7697,3511125626,3918584946,1672597417,1672600654,3237
7488,3733189298,3780503655,1672700722,1672703630,2908
7835,3511841857,3512683609,1672608318,1672611628,3310
7602,3224058172,3770447408,1672608101,1672609242,1141
7920,3701691675,3736625083,1672538038,1672540288,2250
7776,3512166013,3489728806,1672667878,1672669523,1645
7538,3713969578,3757403279,1672634842,1672638189,3347
7715,3512567240,3399052055,1672540784,1672542452,1668
7746,3610695419,3858918246,1672684375,1672687264,2889
7788,3774556560,3772053179,1672692595,1672693448,853
7908,3774066725,3770078063,1672632758,1672635152,2394
7874,3777120536,3823600322,1672592723,1672595726,3003
7796,3311324983,3231056870,1672599195,1672600423,1228
7926,3242408357,3513201436,1672620258,1672622650,2392
7602,3755943611,3668005723,1672632958,1672635209,2251
7728,3405494240,3601879040,1672565747,1672569336,3589
7505,3935127663,3791115967,1672673417,1672674586,1169
7819,3302626661,3757455053,1672651116,1672653185,2069
7875,3505635228,3857349323,1672678014,1672681132,3118
7899,3714821932,3701967560,1672559827,1672561302,1475
7722,3904408902,3505173328,1672566773,1672569333,2560
7490,3770021824,3501486692,1672613013,1672615661,2648
7529,3855000166,3731419510,1672678611,1672681503,2892
7686,3458539365,3518014404,1672671499,1672672637,1138
7650,3783083229,3518014636,1672570613,1672574096,3483
7524,3774127586,3280599164,1672574057,1672575397,1340
7883,3311090974,3454042520,1672625420,1672627107,1687
7679,3500365158,3518014636,1672600654,1672603461,2807
7633,3514838220,3345207877,1672563934,1672566189,2255
7789,3316222192,3500805881,1672621608,1672624439,2831
7896,3716168623,3701967560,1672615995,1672617747,1752
7956,3826633236,3926700506,1672687108,1672688876,1768
7650,3683766533,3459030804,1672610296,1672612551,2255
7712,3688418210,3757812939,1672648115,1672651499,3384
7908,3481647420,3500177712,1672631739,1672633013,1274
7889,3399052055,3776338577,1672600673,1672600881,208
7615,3701984666,3624761861,1672559617,1672560240,623
7751,3703223015,3791942683,1672615230,1672618316,3086
7524,3509453566,3359910781,1672661371,1672663055,1684
7845,3815508790,3519152550,1672575323,1672577224,1901
7566,3399911573,3806545488,1672550710,1672553387,2677
7535,3773664987,3352603894,1672534090,1672536666,2576
7757,3378436155,3930797455,1672573521,1672576880,3359
7960,3235287260,3384240055,1672579991,1672580766,775
7864,3200691026,3473765852,1672624589,1672627484,2895
7625,3904408902,3899204805,1672531481,1672534212,2731
7787,3433804879,3404384505,1672649002,1672651309,2307
7682,3505702787,3512720680,1672664858,1672667707,2849
7575,3822654369,3533371364,1672664299,1672666211,1912
7963,3475795792,3757151210,1672536480,1672538633,2153
7893,3666507626,3883312122,1672550639,1672554125,3486
7533,3618045231,3416265063,1672663872,1672664214,342
7497,3917088658,3291235378,1672671815,1672675398,3583
7484,3827377568,3311439795,1672629920,1672633231,3311
7548,3383661227,3909606423,1672649917,1672652206,2289
7625,3516223597,3701967560,1672667058,1672669872,2814
7539,3933210486,3519912874,1672626630,1672629937,3307
7858,3881477378,3401627165,1672634248,1672637117,2869
7681,3776800213,3395152943,1672701307,1672703405,2098
7650,3774050956,3284639858,1672572260,1672574137,1877
7772,3388286531,3911159965,1672586851,1672587435,584
7911,3736625083,3520165601,1672531559,1672532510,951
7652,3701863557,3552314511,1672632859,1672636295,3436
7617,3778308417,3510126867,1672584201,1672587658,3457
7545,3859663348,3703013906,1672557067,1672558933,1866
7775,3895562476,3756601594,1672645594,1672647017,1423
7899,3519700826,3202120784,1672629549,1672631242,1693
7765,3520206212,3336742544,1672622152,1672623081,929
7893,3815508790,3829232696,1672532472,1672535224,2752
7647,3315583351,3772544062,1672580954,1672583605,2651
7981,3510937904,3482405588,1672679517,1672681128,1611
7606,3516223597,3515691540,1672669865,1672672165,2300
7899,3418534998,3518876135,1672570740,1672570914,174
7764,3739106581,3345207877,1672600469,1672601794,1325
7511,3514987389,3481647420,1672674093,1672676580,2487
7774,3780639480,3809059934,1672616536,1672619858,3322
7620,3772309150,3519601612,1672655033,1672656940,1907
7616,3778308417,3497901842,1672585283,1672586072,789
7834,3475795792,3333896808,1672690245,1672690694,449
7925,3428674539,3509634629,1672604136,1672606399,2263
7742,3909238838,3783429780,1672685284,1672688551,3267
7842,3976390453,3714197325,1672555019,1672558202,3183
7530,3365278081,3783531004,1672569496,1672571047,1551
7830,3394539273,3760077057,1672550592,1672553811,3219
7766,3770447408,3903307060,1672581044,1672584582,3538
7835,3780914982,3760077057,1672655269,1672658449,3180
7810,3911245524,3917088658,1672533852,1672534831,979
7687,3365278081,3913251733,1672542829,1672545754,2925
7824,3315583351,3513599775,1672589177,1672589369,192
7530,3755042098,3760077057,1672589438,1672589953,515
7908,3779740455,3505859863,1672644624,1672645799,1175
7797,3604539807,3514283243,1672610428,1672613530,3102
7965,3760992710,3221899927,1672624753,1672626917,2164
7758,3388637594,3912262917,1672549192,1672551888,2696
7601,3772578994,3805342762,1672577855,1672581313,3458
7669,3485375593,3222448362,1672673804,1672674055,251
7550,3809484172,3909238838,1672703870,1672704520,650
7632,3513164386,3533270638,1672585243,1672587588,2345
7794,3703275621,3715998609,1672700542,1672702806,2264
7975,3607748895,3792883665,1672675891,1672679139,3248
7521,3737079798,3505649239,1672558013,1672558848,835
7554,3738502357,3473562469,1672608009,1672611182,3173
7894,3909331423,3608633356,1672664516,1672667887,3371
7969,3791602225,3427219654,1672667581,1672670370,2789
7967,3774127586,3372883226,1672658657,1672661712,3055
7653,3297463265,3510126867,1672578719,1672579209,490
7969,3774298222,3837094550,1672547335,1672547790,455
7857,3688683847,3828624701,1672666180,1672667743,1563
7689,3858918246,3519152550,1672667042,1672670297,3255
7972,3791020967,3373384732,1672655676,1672658445,2769
7896,3201432789,3518669703,1672703951,1672707348,3397
7782,3534702203,3434642576,1672584529,1672585493,964
7492,3715981584,3487171044,1672548332,1672549739,1407
7630,3736419952,3773429448,1672607270,1672608068,798
7573,3534191820,3607178184,1672607021,1672610524,3503
7634,3818255890,3346795719,1672579467,1672581995,2528
7902,3519428855,3518408774,1672688811,1672689576,765
7693,3342131135,3783429780,1672577833,1672578696,863
7739,3520751702,3417587765,1672563752,1672567136,3384
7569,3209048907,3201848640,1672575585,1672578421,2836
7812,3520190170,3505098372,1672664500,1672664660,160
7710,3774466457,3757562897,1672638318,1672638906,588
7672,3924549929,3520751702,1672533454,1672535413,1959
7737,3501730685,3517476351,1672685983,1672689469,3486
7807,3509604974,3293695955,1672609168,1672609970,802
7849,3516673015,3777790718,1672673551,1672676435,2884
7490,3520888296,3701967560,1672696389,1672698403,2014
7670,3777623166,3518014404,1672542835,1672545570,2735
7549,3304056063,3520376528,1672669457,1672669958,501
7569,3885670556,3311993075,1672625880,1672626759,879
7717,3939952128,3777717988,1672550538,1672553689,3151
7763,3349613093,3487171044,1672576642,1672578182,1540
7901,3853018906,3365614305,1672698642,1672700878,2236
7880,3501606184,3235635976,1672692495,1672693461,966
7953,3793338102,3480687894,1672576027,1672577284,1257
7759,3792789881,3913251733,1672645250,1672648669,3419
7570,3772337814,3488244966,1672588667,1672590900,2233
7768,3859525941,3496051529,1672671744,1672674419,2675
7560,3415443558,3662180254,1672663150,1672665672,2522
7652,3757246925,3756451663,1672621584,1672624581,2997
7658,3756462516,3975287541,1672683213,1672684482,1269
7597,3337544549,3770635361,1672563242,1672565624,2382
7711,3222521619,3505219850,1672542684,1672544310,1626
7944,3518496488,3385763781,1672696655,1672698997,2342
7536,3910886626,3492478793,1672579938,1672581178,1240
7519,3779218771,3554917400,1672702273,1672704966,2693
7545,3415443558,3516909237,1672577791,1672580172,2381
7785,3734737881,3360506772,1672683809,1672686581,2772
7969,3855000166,3774466457,1672653061,1672653512,451
7955,3736790081,3510771358,1672584888,1672588145,3257
7836,3501955238,3660493209,1672560900,1672561135,235
7870,3925620998,3778308417,1672647849,1672650692,2843
7878,3496269445,3505635228,1672579411,1672582202,2791
7808,3516039895,3713370078,1672650643,1672651020,377
7723,3517077106,3514245078,1672615550,1672618066,2516
7719,3519601612,3666457294,1672606524,1672609016,2492
7841,3357483218,3979339287,1672596194,1672599686,3492
7935,3392121505,3511198618,1672670511,1672673761,3250
7894,3701863557,3534191820,1672676383,1672678228,1845
7871,3755625324,3774793839,1672632121,1672635541,3420
7726,3514128943,3493507965,1672624321,1672625075,754
7957,3556951786,3791334389,1672625504,1672628800,3296
7849,3921211276,3772714862,1672638864,1672639611,747
7636,3772053179,3510244400,1672655748,1672656252,504
7818,3778308417,3783925755,1672605008,1672607866,2858
7491,3917278625,3734737881,1672690909,1672691630,721
7520,3792032359,3737051610,1672543532,1672546884,3352
7913,3331845324,3711198793,1672699699,1672700845,1146
7553,3513164386,3209383861,1672596705,1672597801,1096
7699,3235635976,3357483218,1672571215,1672571902,687
7535,3509907947,3500066230,1672700511,1672701381,870
7709,3496051529,3777806071,1672556139,1672557352,1213
7707,3291227780,3853018906,1672629910,1672632820,2910
7497,3511359172,3711569060,1672680473,1672682759,2286
7526,3757151210,3978115672,1672563406,1672566056,2650
7723,3501730685,3364543015,1672584262,1672587374,3112
7793,3852391257,3701065786,1672699447,1672701714,2267
7496,3483164654,3520719611,1672662415,1672662507,92
7857,3735319397,3397418363,1672550634,1672552689,2055
7936,3618045231,3379256399,1672541169,1672541694,525
7932,3760992710,3777477395,1672677063,1672678912,1849
7964,3926700506,3922337974,1672548687,1672551907,3220
7829,3925402713,3510126867,1672557866,1672560259,2393
7857,3808324264,3454042520,1672551005,1672552393,1388
7553,3387966152,3514987389,1672700652,1672704118,3466
7969,3235635976,3811171116,1672646116,1672647220,1104
7515,3494290908,3793627961,1672583225,1672584928,1703
7524,3448855696,3774204963,1672657610,1672660442,2832
7620,3778308417,3802367797,1672584922,1672587483,2561
7969,3918247820,3339907603,1672661726,1672662390,664
7812,3284639858,3505702787,1672674351,1672674783,432
7867,3915628728,3517721725,1672628550,1672630771,2221
7669,3404058699,3516011407,1672614330,1672617930,3600
7768,3760183458,3501184421,1672541254,1672542859,1605
7762,3430074045,3664170666,1672595013,1672598579,3566
7495,3701065786,3370636709,1672642499,1672643547,1048
7808,3467773920,3385763781,1672646009,1672649274,3265
7713,3284639858,3512567240,1672638768,1672640205,1437
7954,3628819436,3222448362,1672588457,1672591202,2745
7930,3715581279,3512166013,1672695837,1672696791,954
7908,3772714862,3773429448,1672698622,1672699958,1336
7833,3223968713,3512510536,1672636899,1672637606,707
7547,3909606423,3713644518,1672593191,1672596552,3361
7938,3370752401,3342131135,1672593729,1672594836,1107
7688,3533371364,3500904641,1672539781,1672542103,2322
7580,3791901535,3617734118,1672596474,1672598561,2087
7850,3773429448,3500904641,1672595112,1672596296,1184
7561,3774195321,3384240055,1672689627,1672691489,1862
7670,3820354437,3374559242,1672556162,1672558996,2834
7847,3534729133,3773429448,1672629438,1672631058,1620
7778,3520190170,3833889105,1672637148,1672638105,957
7626,3288764520,3770553384,1672552918,1672553241,323
7750,3238712269,3399052055,1672673027,1672673987,960
7638,3505599848,3711569060,1672674042,1672675372,1330
7908,3500803339,3792384220,1672643105,1672645127,2022
7858,3683959482,3377766165,1672650197,1672653482,3285
7523,3912262917,3773755137,1672606922,1672607257,335
7695,3221536550,3774125065,1672691035,1672692678,1643
7767,3817621391,3833889105,1672656218,1672659362,3144
7556,3701274634,3401627165,1672621479,1672624493,3014
7616,3378092448,3783429780,1672616079,1672617691,1612
7610,3755436115,3852595551,1672624692,1672625799,1107
7857,3823600322,3510594211,1672612565,1672616119,3554
7671,3311603601,3903307060,1672590178,1672592028,1850
7873,3365278081,3793338102,1672676289,1672676536,247
7732,3406784491,3915628728,1672626719,1672629005,2286
7529,3513201436,3296471982,1672591442,1672594962,3520
7843,3780503655,3778266283,1672683605,1672684799,1194
7974,3518360734,3384951177,1672625661,1672628084,2423
7765,3550946908,3774556560,1672607923,1672610115,2192
7822,3855000166,3389115045,1672669844,1672670761,917
7488,3500229033,3975287541,1672691438,1672691653,215
7718,3385763781,3738274418,1672659759,1672662506,2747
7682,3783239924,3473562469,1672620410,1672620978,568
7509,3882291183,3774338212,1672698532,1672700898,2366
7539,3792473331,3909606423,1672616941,1672617953,1012
7766,3858918246,3291227780,1672537779,1672538588,809
7970,3716273414,3406784491,1672641208,1672643995,2787
7513,3793848402,3501955238,1672682667,1672684735,2068
7950,3685187183,3601879040,1672553393,1672556493,3100
7781,3209551760,3285400528,1672648396,1672649387,991
7529,3367029997,3387674757,1672627145,1672630544,3399
7885,3933210486,3783126683,1672667144,1672669215,2071
7712,3756451663,3465254146,1672590113,1672591627,1514
7963,3487171044,3428964059,1672625007,1672625533,526
7680,3772309150,3475251781,1672693816,1672697413,3597
7683,3792473331,3770851318,1672582786,1672585406,2620
7777,3926700506,3883042241,1672697114,1672699989,2875
7781,3755943611,3883085535,1672565836,1672567143,1307
7847,3805347939,3774466457,1672556279,1672559082,2803
7508,3780609808,3930797455,1672570672,1672571118,446
7692,3516465662,3703735129,1672553317,1672556061,2744
7739,3430074045,3836573197,1672607983,1672611008,3025
7925,3792253549,3200691026,1672553761,1672556801,3040
7509,3510126867,3805292782,1672635900,1672636318,418
7660,3760183458,3883551721,1672556832,1672557506,674
7873,3703441914,3606812411,1672548982,1672549153,171
7879,3429856982,3277669002,1672587520,1672588504,984
7691,3827222533,3520030713,1672599770,1672602271,2501
7937,3466229085,3512142794,1672685156,1672687034,1878
7612,3739106581,3519428855,1672567913,1672570367,2454
7843,3550946908,3817316561,1672627021,1672629419,2398
7939,3289061738,3930797455,1672611445,1672611816,371
7802,3351554343,3477375368,1672667098,1672670679,3581
7637,3501198706,3755872268,1672563226,1672565500,2274
7932,3475795792,3713349754,1672581064,1672582613,1549
7923,3883042241,3793436995,1672700224,1672703806,3582
7642,3247815299,3701274634,1672689454,1672689651,197
7570,3293695955,3412980697,1672633255,1672635420,2165
7916,3801089989,3223789409,1672595008,1672595121,113
7657,3773205565,3933210486,1672674056,1672674822,766
7922,3777514571,3416241005,1672637461,1672640816,3355
7768,3421836608,3247428249,1672616277,1672617512,1235
7830,3714474557,3827222533,1672583481,1672586835,3354
7886,3773465237,3911245524,1672681835,1672683399,1564
7805,3776800213,3415443558,1672682560,1672683257,697
7869,3716746253,3511198618,1672595061,1672595245,184
7608,3774204963,3351008918,1672648379,1672649245,866
7700,3316222192,3454042520,1672555158,1672555424,266
7712,3808324264,3936227020,1672580911,1672584449,3538
7875,3779629905,3201432789,1672632116,1672635540,3424
7820,3510244400,3208844525,1672630276,1672632415,2139
7891,3501364586,3802367797,1672562435,1672562865,430
7536,3812176780,3774466457,1672698364,1672700821,2457
7590,3733891182,3534313900,1672592534,1672594949,2415
7943,3516011407,3607178184,1672640711,1672642283,1572
7496,3783196518,3480687894,1672595168,1672596332,1164
7557,3735733948,3792883665,1672574181,1672575390,1209
7862,3432689543,3209551760,1672637164,1672638417,1253
7730,3301107849,3505638204,1672582970,1672585571,2601
7767,3500177712,3714504419,1672642500,1672645384,2884
7649,3760183458,3629547065,1672585462,1672586011,549
7937,3277939457,3772714862,1672546656,1672548964,2308
7728,3465254146,3493507965,1672629556,1672631951,2395
7593,3713644518,3713630656,1672533593,1672535348,1755
7850,3285400528,3912536808,1672535783,1672538629,2846
7657,3298288268,3517476351,1672600788,1672601227,439
7843,3518408774,3933210486,1672672093,1672674200,2107
7754,3386707783,3757562897,1672576632,1672578190,1558
7979,3701498253,3808324264,1672604599,1672607866,3267
7809,3883861463,3778980116,1672683344,1672686917,3573
7814,3365278081,3772746272,1672697878,1672700927,3049
7971,3783206719,3783083229,1672639377,1672641717,2340
7491,3664170666,3606186086,1672689474,1672689612,138
7698,3520165601,3493507965,1672555813,1672558484,2671
7959,3512540951,3634340855,1672588668,1672590195,1527
7613,3359910781,3607748895,1672671200,1672673468,2268
7511,3772714862,3489217083,1672617641,1672619906,2265
7701,3770078063,3303751772,1672672705,1672673416,711
7563,3509933351,3714197325,1672668048,1672669863,1815
7563,3516673015,3357483218,1672610810,1672614178,3368
7900,3242408357,3773598056,1672592803,1672595530,2727
7631,3533385867,3857349323,1672589949,1672592318,2369
7542,3451432842,3515284591,1672678341,1672680535,2194
7500,3399433690,3360743849,1672600490,1672602637,2147
7519,3755943611,3885897503,1672625487,1672627883,2396
7629,3800353779,3500803339,1672653784,1672656012,2228
7696,3533927138,3613995936,1672609864,1672610887,1023
7627,3770763956,3318166135,1672550857,1672551426,569
7770,3839849341,3227457126,1672642220,1672644897,2677
7956,3780294829,3509604974,1672541292,1672541978,686
7487,3500177712,3533137446,1672607095,1672609097,2002
7548,3512837326,3772053179,1672637970,1672641360,3390
7834,3519152550,3517864478,1672608865,1672608977,112
7929,3895562476,3482405588,1672552432,1672552989,557
7826,3365942576,3473562469,1672567852,1672568206,354
7542,3489962019,3472130842,1672625187,1672627950,2763
7794,3780788622,3890149705,1672702255,1672705350,3095
7829,3378436155,3800886801,1672570801,1672572614,1813
7552,3931941795,3780593036,1672608298,1672609684,1386
7771,3433804879,3922275620,1672642062,1672644269,2207
7624,3791901535,3533927138,1672561393,1672562500,1107
7898,3473765852,3364543015,1672562484,1672565284,2800
7663,3776948966,3489545239,1672631442,1672633525,2083
7626,3978115672,3509907947,1672647153,1672648931,1778
7947,3736419952,3756966035,1672672588,1672673425,837
7665,3510969660,3710344260,1672642720,1672645758,3038
7712,3828365570,3388286531,1672588534,1672588929,395
7932,3244389794,3608868877,1672590604,1672593451,2847
7863,3533626375,3780788622,1672682033,1672682095,62
7591,3930791338,3407673904,1672669720,1672671513,1793
7645,3500177712,3760294205,1672658464,1672660466,2002
7961,3430074045,3902383721,1672573932,1672574345,413
7659,3895562476,3516673015,1672540662,1672544139,3477
7648,3835382117,3972364603,1672588313,1672589787,1474
7835,3760992710,3334033993,1672676666,1672678919,2253
7820,3776338577,3277605882,1672633737,1672635228,1491
7495,3714474557,3783245561,1672625357,1672627716,2359
7955,3835382117,3249791738,1672541437,1672544146,2709
7516,3430504438,3407673904,1672580630,1672581857,1227
7826,3621810464,3513454145,1672583740,1672585382,1642
7578,3518360734,3829319703,1672584263,1672584641,378
7624,3783779671,3828624701,1672657396,1672659466,2070
7549,3319752091,3490191091,1672682375,1672684180,1805
7918,3736592744,3791602225,1672589124,1672592558,3434
7806,3817621391,3701984666,1672653171,1672655575,2404
7817,3811694763,3613995936,1672641106,1672643128,2022
7749,3857349323,3716843669,1672539236,1672542431,3195
7736,3249401741,3772578994,1672536483,1672536549,66
7819,3926700506,3916289176,1672638347,1672640987,2640
7505,3509352754,3475795792,1672580726,1672582931,2205
7541,3485823740,3533927138,1672614481,1672614684,203
7819,3902383721,3774066725,1672632084,1672633783,1699
7526,3501759100,3778266283,1672645049,1672648123,3074
7591,3859663348,3459030804,1672614145,1672614324,179
7846,3792902982,3501601840,1672557093,1672557453,360
7843,3607178184,3421127249,1672676621,1672678872,2251
7837,3439023335,3629935998,1672554661,1672558037,3376
7564,3349613093,3313541986,1672586329,1672586581,252
7910,3711265369,3304056063,1672571990,1672575582,3592
7886,3710067113,3231056870,1672570833,1672571531,698
7591,3311648200,3311152102,1672637662,1672638006,344
7552,3885897503,3517864478,1672625081,1672626357,1276
7521,3793962300,3430074045,1672671922,1672673454,1532
7621,3757602960,3713370078,1672637959,1672641502,3543
7519,3372883226,3777514571,1672566162,1672569565,3403
7873,3244389794,3836573197,1672553954,1672555380,1426
7513,3701534009,3316173088,1672671933,1672673456,1523
7536,3412980697,3510126867,1672658121,1672658236,115
7520,3378436155,3600647945,1672602086,1672603224,1138
7552,3512540951,3430352815,1672534776,1672536933,2157
7633,3346327502,3515723720,1672643650,1672646215,2565
7789,3514838220,3433804879,1672609385,1672610345,960
7964,3604539807,3755920131,1672622036,1672623881,1845
7623,3885897503,3420700674,1672681907,1672685470,3563
7787,3917088658,3760569731,1672666408,1672668984,2576
7893,3312333615,3776800213,1672647986,1672649680,1694
7602,3415546117,3493507965,1672669744,1672671314,1570
7848,3466911760,3731419510,1672548942,1672552264,3322
7893,3427283336,3899204805,1672547685,1672550721,3036
7876,3774501422,3791874383,1672682995,1672685596,2601
7569,3500199935,3779218771,1672586562,1672589195,2633
7584,3978115672,3716488385,1672608954,1672609241,287
7605,3497901842,3780609808,1672556585,1672559823,3238
7498,3793286136,3825229501,1672537095,1672537319,224
7719,3284832486,3373384732,1672640800,1672642621,1821
7965,3791901535,3501730685,1672633401,1672633960,559
7826,3885670556,3534313900,1672668006,1672669226,1220
7865,3319752091,3780974443,1672549695,1672551567,1872
7983,3509933351,3505145247,1672681547,1672682219,672
7489,3791594391,3515151980,1672553556,1672557060,3504
7496,3396285984,3492478793,1672541978,1672545483,3505
7785,3501955238,3774556560,1672671535,1672672563,1028
7909,3772642849,3433804879,1672661598,1672664313,2715
7592,3889750851,3390068992,1672571245,1672574049,2804
7774,3777790718,3903307060,1672594278,1672594449,171
7544,3509933351,3448855696,1672575721,1672577116,1395
7920,3738274418,3346795719,1672601652,1672605123,3471
7807,3613995936,3855000166,1672652164,1672652817,653
7666,3224716315,3312664885,1672554196,1672556410,2214
7538,3291227780,3417061462,1672532401,1672533675,1274
7833,3430504438,3793436995,1672595601,1672596671,1070
7741,3284639858,3338367113,1672669317,1672672028,2711
7641,3416427576,3534313900,1672657825,1672658376,551
7893,3513080274,3519703355,1672531887,1672533095,1208
7938,3883861463,3509604974,1672697207,1672699164,1957
7900,3777455223,3778980116,1672661100,1672663121,2021
7569,3338367113,3756453423,1672610463,1672611777,1314
7592,3791602225,3827222533,1672575979,1672578193,2214
7936,3783509527,3271938399,1672611858,1672612851,993
7860,3701274634,3774119563,1672578075,1672578604,529
7973,3851190615,3516465662,1672613152,1672613760,608
7519,3898995675,3509672210,1672643746,1672644694,948
7637,3973560347,3783429780,1672615163,1672616244,1081
7487,3668005723,3519428855,1672621781,1672625002,3221
7924,3202120784,3517864478,1672665325,1672668494,3169
7888,3519703355,3701498253,1672683625,1672685384,1759
7932,3378092448,3809059934,1672581422,1672584509,3087
7965,3667680268,3475258557,1672557947,1672559209,1262
7828,3736592744,3406784491,1672581538,1672584830,3292
7759,3883551721,3714504419,1672550547,1672551893,1346
7592,3534010629,3792384220,1672545565,1672546053,488
7783,3883551721,3475396323,1672538670,1672541532,2862
7854,3501198706,3621497531,1672574314,1672575776,1462
7615,3246596716,3534313900,1672698968,1672701748,2780
7666,3402943525,3777514571,1672693881,1672696049,2168
7739,3792668962,3736229191,1672582033,1672584784,2751
7654,3404384505,3304625412,1672626022,1672626375,353
7541,3755436115,3517077106,1672598411,1672601987,3576
7837,3384951177,3882242815,1672656682,1672658552,1870
7570,3407954858,3711370563,1672688608,1672691401,2793
7784,3494290908,3511271692,1672663529,1672665604,2075
7904,3380035798,3826759140,1672675841,1672678787,2946
7497,3772578994,3714488548,1672664737,1672666255,1518
7719,3401627165,3516716179,1672681382,1672681964,582
7712,3918674986,3424922204,1672601925,1672603731,1806
7701,3360743849,3783779671,1672697841,1672698992,1151
7844,3774045700,3703013906,1672684285,1672684516,231
7737,3776948966,3757161914,1672701407,1672702157,750
7876,3244485293,3703661585,1672536702,1672540276,3574
7866,3911245524,3605726278,1672586036,1672589174,3138
7798,3738502357,3855424474,1672624265,1672626587,2322
7679,3792768129,3505219850,1672699821,1672703147,3326
7640,3791602225,3713808837,1672545924,1672548096,2172
7972,3688683847,3683766533,1672545316,1672545693,377
7967,3505873261,3496549058,1672653525,1672656977,3452
7685,3500458761,3921211276,1672702859,1672705944,3085
7983,3755587522,3914290246,1672552991,1672553210,219
7533,3209027249,3605726278,1672673088,1672673365,277
7819,3238712269,3735319397,1672538007,1672539539,1532
7725,3520376528,3518408774,1672595466,1672598678,3212
7877,3601879040,3608633356,1672645341,1672647560,2219
7843,3311203656,3313564074,1672617655,1672620784,3129
7904,3812176780,3405494240,1672575164,1672577303,2139
7645,3223968713,3774556560,1672657044,1672660468,3424
7928,3757682496,3505859863,1672621356,1672623017,1661
7683,3774580701,3416241005,1672669744,1672670346,602
7951,3231056870,3883085535,1672541604,1672544547,2943
7547,3512349371,3505791599,1672665310,1672667403,2093
7610,3512837326,3520751702,1672603965,1672604463,498
7751,3222448362,3756623396,1672537112,1672538245,1133
7897,3738274418,3667680268,1672664825,1672667338,2513
7683,3242408357,3391915121,1672669400,1672671653,2253
7711,3516016437,3836573197,1672702063,1672702323,260
7960,3716835696,3805292782,1672570876,1672573391,2515
7613,3429856982,3271938399,1672627074,1672630426,3352
7508,3701498253,3511198618,1672618381,1672621242,2861
7634,3512837326,3475795792,1672558667,1672558852,185
7533,3910886626,3716843669,1672572860,1672574860,2000
7841,3379256399,3772884106,1672703406,1672706923,3517
7864,3336742544,3910886626,1672632580,1672635343,2763
7874,3400804807,3805292782,1672659845,1672660898,1053
7919,3772309166,3446948848,1672627735,1672629645,1910
7659,3716488385,3519069599,1672672504,1672674039,1535
7944,3421836608,3773978034,1672674622,1672675250,628
7933,3701967560,3202120784,1672634225,1672636836,2611
7516,3311648200,3397418363,1672696937,1672697953,1016
7980,3904775198,3935627557,1672580004,1672580795,791
7967,3512166013,3880285638,1672700160,1672700578,418
7483,3793871337,3822654369,1672548442,1672550889,2447
7558,3760492950,3629935998,1672669068,1672672136,3068
7767,3737051610,3703718151,1672628494,1672631185,2691
7751,3418728074,3899371911,1672650052,1672650328,276
7507,3489217083,3505203158,1672627194,1672627276,82
7738,3889750851,3314836094,1672580380,1672582416,2036
7592,3365942576,3478194807,1672565825,1672566186,361
7853,3200691026,3236102733,1672637586,1672637748,162
7523,3817316561,3284832486,1672601110,1672604686,3576
7487,3777790718,3668898102,1672533850,1672537195,3345
7611,3858918246,3701274634,1672665245,1672665906,661
7705,3779629905,3223968713,1672616229,1672619341,3112
7911,3774556560,3932051427,1672584252,1672585857,1605
7685,3914290246,3373384732,1672533509,1672536695,3186
7839,3391261292,3792768129,1672609859,1672613452,3593
7698,3774050956,3920801189,1672684168,1672686443,2275
7938,3975287541,3505000737,1672617418,1672619221,1803
7736,3311993075,3224058172,1672558512,1672558702,190
7959,3496269445,3778308417,1672702160,1672705333,3173
7931,3780914982,3351008918,1672631968,1672635056,3088
7673,3297463265,3902383721,1672603790,1672607355,3565
7832,3485375593,3772578994,1672532524,1672535339,2815
7908,3433804879,3792253549,1672686821,1672689096,2275
7488,3774556560,3715974031,1672680223,1672683771,3548
7901,3783126683,3853018906,1672668093,1672669852,1759
7488,3276993580,3505201246,1672551849,1672553323,1474
7918,3774366875,3224716315,1672592988,1672593890,902
7522,3715981584,3683959482,1672532727,1672534639,1912
7908,3515691540,3497901842,1672658561,1672661874,3313
7633,3519556068,3298433163,1672619521,1672620611,1090
7544,3703441914,3365278081,1672555072,1672558617,3545
7526,3361230905,3777120536,1672633208,1672636640,3432
7688,3774195321,3733891182,1672647080,1672648119,1039
7975,3621497531,3505904952,1672589056,1672590093,1037
7772,3357483218,3811694763,1672693870,1672696156,2286
7864,3779976989,3756021689,1672639726,1672642531,2805
7932,3533626375,3451432842,1672680543,1672681098,555
7641,3288764520,3311274543,1672552082,1672554456,2374
7975,3520206212,3807987001,1672622449,1672624513,2064
7520,3793627961,3911159965,1672680739,1672682459,1720
7870,3512510536,3774066725,1672678518,1672681662,3144
7803,3883861463,3859663348,1672601193,1672604188,2995
7967,3736790081,3780828689,1672654395,1672657911,3516
7949,3505145247,3401627165,1672621685,1672623330,1645
7778,3505702787,3238712269,1672647271,1672648008,737
7494,3713969578,3505203158,1672551673,1672554318,2645
7749,3473562469,3600647945,1672603976,1672604133,157
7748,3701146057,3497901842,1672654673,1672654859,186
7667,3772758337,3851190615,1672664869,1672668317,3448
7729,3601879040,3757682496,1672575434,1672576050,616
7719,3500729955,3512969370,1672636255,1672636792,537
7656,3901990690,3777983879,1672702752,1672703794,1042
7538,3533270638,3385763781,1672572736,1672574665,1929
7860,3384240055,3238712269,1672671451,1672674752,3301
7775,3352603894,3362000049,1672601314,1672603005,1691
7848,3392121505,3513956646,1672683186,1672686295,3109
7939,3511198618,3518932404,1672563657,1672566671,3014
7497,3520629279,3505135325,1672676924,1672678158,1234
7922,3780294829,3714504419,1672676678,1672678213,1535
7652,3791874383,3443698222,1672589936,1672592869,2933
7766,3757812939,3520629279,1672619865,1672621107,1242
7858,3509453566,3311439795,1672642667,1672646019,3352
7799,3885670556,3774119563,1672593415,1672594381,966
7928,3770553384,3792902982,1672637421,1672640097,2676
7610,3384240055,3773755137,1672646554,1672649955,3401
7736,3737154119,3303705369,1672593860,1672593963,103
7570,3793848402,3783245561,1672696180,1672697043,863
7502,3505219850,3517864478,1672620991,1672623254,2263
7642,3882291183,3760569731,1672555238,1672556495,1257
7623,3501364586,3777983879,1672597110,1672599443,2333
7730,3249791738,3534313900,1672636004,1672637033,1029
7678,3404384505,3688683847,1672686903,1672689626,2723
7783,3773978034,3772714862,1672539875,1672541447,1572
7794,3400804807,3434642576,1672551881,1672553842,1961
7685,3311154569,3348261553,1672677293,1672679858,2565
7748,3858918246,3737051610,1672683388,1672685356,1968
7532,3737051610,3925620998,1672559791,1672562935,3144
7600,3511125626,3802367797,1672579836,1672581355,1519
7835,3501955238,3488244966,1672631056,1672631641,585
7629,3716488385,3276993580,1672587382,1672590432,3050
7943,3853018906,3303705369,1672536018,1672538623,2605
7779,3356860407,3774005526,1672580912,1672582361,1449
7823,3518260334,3829764737,1672650273,1672651072,799
7661,3922275620,3458539365,1672546657,1672546781,124
7963,3404058699,3716168623,1672532138,1672534301,2163
7562,3703955926,3276640712,1672598771,1672601606,2835
7926,3516716179,3701190899,1672682829,1672686022,3193
7809,3512217942,3391261292,1672592387,1672593277,890
7892,3629935998,3770824086,1672689448,1672692204,2756
7812,3399052055,3406784491,1672623142,1672623952,810
7657,3823600322,3518791447,1672567760,1672570050,2290
7633,3433804879,3534553510,1672702558,1672702766,208
7523,3311718847,3711569060,1672646426,1672646870,444
7774,3666506258,3926700506,1672644394,1672645252,858
7504,3501606184,3779218771,1672605096,1672607038,1942
7833,3976633198,3618045231,1672622676,1672625058,2382
7910,3713370078,3886298125,1672542916,1672544778,1862
7855,3465202715,3715998609,1672560662,1672564077,3415
7745,3338367113,3664170666,1672579940,1672580586,646
7607,3701984666,3509634629,1672690052,1672692716,2664
7597,3311274543,3505638204,1672595074,1672596201,1127
7968,3738502357,3485008994,1672646664,1672646786,122
7535,3711370563,3433804879,1672670986,1672673829,2843
7868,3249247700,3336742544,1672561899,1672564166,2267
7548,3664170666,3510711755,1672565731,1672567682,1951
7700,3378092448,3316222192,1672628831,1672630555,1724
7764,3510857360,3492478793,1672684690,1672685681,991
7702,3779740455,3809059934,1672633306,1672636024,2718
7786,3772337814,3516673015,1672667287,1672668777,1490
7686,3922275416,3489545239,1672620398,1672623004,2606
7776,3774195321,3313541986,1672637801,1672638299,498
7616,3713268590,3701967560,1672605279,1672607835,2556
7674,3770447408,3511841857,1672555444,1672556006,562
7928,3209027249,3533280269,1672686438,1672687978,1540
7761,3890149705,3924549929,1672565352,1672567282,1930
7686,3910454786,3510711755,1672581379,1672581744,365
7898,3805519285,3774793839,1672665495,1672666582,1087
7846,3512720680,3780974443,1672564528,1672567049,2521
7904,3812176780,3501486692,1672544173,1672547708,3535
7880,3399911573,3222521619,1672664115,1672667659,3544
7498,3518876135,3512720680,1672580836,1672582860,2024
7638,3364543015,3608633356,1672689858,1672690906,1048
7580,3855424474,3793962300,1672603430,1672606079,2649
7661,3859663348,3512510536,1672639711,1672641909,2198
7876,3511687358,3774366875,1672608365,1672609524,1159
7577,3304056063,3344364444,1672590015,1672591816,1801
7802,3520012395,3516065852,1672602667,1672604206,1539
7684,3385763781,3379256399,1672651032,1672651943,911
7618,3399433690,3311090974,1672552757,1672554592,1835
7725,3757455053,3206254161,1672598848,1672601146,2298
7528,3664517356,3793962300,1672589045,1672591304,2259
7823,3475396323,3302626661,1672678436,1672681473,3037
7524,3610695419,3701184889,1672551522,1672552758,1236
7910,3231056870,3533810360,1672667348,1672670524,3176
7867,3778305740,3791942683,1672641116,1672644356,3240
7607,3828432634,3823600322,1672670790,1672672115,1325
7532,3520190170,3791657947,1672613374,1672613436,62
7800,3519563836,3734737881,1672534941,1672538189,3248
7867,3338367113,3505173328,1672547151,1672549221,2070
7667,3779740455,3412825109,1672657906,1672660680,2774
7926,3777079686,3206254161,1672601176,1672603768,2592
7845,3501606184,3716165213,1672583722,1672584870,1148
7774,3770824086,3533369198,1672537592,1672537798,206
7756,3466911760,3247428249,1672627191,1672630785,3594
7949,3516673015,3628819436,1672579059,1672581996,2937
7563,3783245561,3614238812,1672672655,1672675598,2943
7563,3760598102,3779218771,1672563300,1672563693,393
7823,3770635361,3636867411,1672684093,1672686176,2083
7874,3517476351,3809484172,1672693087,1672694323,1236
7494,3715581279,3859525941,1672602171,1672602927,756
7889,3618045231,3426325549,1672656749,1672657285,536
7500,3621810464,3337544549,1672696544,1672699803,3259
7761,3206593906,3780639480,1672565749,1672568035,2286
7698,3286658957,3337544549,1672610691,1672610915,224
7561,3518163778,3774520233,1672698887,1672700697,1810
7746,3518876135,3509453566,1672681102,1672682696,1594
7645,3760569731,3510247121,1672533014,1672535234,2220
7774,3973560347,3505702787,1672593442,1672594028,586
7604,3776948966,3291227780,1672671477,1672675006,3529
7734,3825229501,3432665384,1672533543,1672535707,2164
7630,3516673015,3510247121,1672595330,1672596291,961
7517,3757682496,3520206212,1672606366,1672607909,1543
7676,3772642849,3715981584,1672693919,1672696657,2738
7635,3757682496,3809059934,1672607624,1672610308,2684
7864,3772309166,3510594211,1672595509,1672598636,3127
7976,3800886801,3400918687,1672677200,1672680325,3125
7920,3505219850,3516065852,1672679300,1672680444,1144
7744,3976390453,3518014404,1672583627,1672586900,3273
7842,3380035798,3833889105,1672542177,1672544844,2667
7971,3899266183,3472130842,1672690175,1672692992,2817
7770,3427283336,3832902928,1672547985,1672550697,2712
7598,3713786889,3701534009,1672586579,1672587192,613
7676,3826759140,3338367113,1672570935,1672571078,143
7931,3779976989,3501759100,1672622710,1672623816,1106
7957,3703955926,3911159965,1672673094,1672676116,3022
7619,3370752401,3311627628,1672687468,1672690330,2862
7958,3489962019,3513080274,1672597619,1672598575,956
7500,3291883916,3774793839,1672695812,1672696466,654
7867,3757246925,3428006164,1672667921,1672668329,408
7584,3511862351,3509352754,1672545589,1672547636,2047
7871,3791020967,3518669703,1672677546,1672681026,3480
7650,3311324983,3370636709,1672657819,1672659058,1239
7592,3792032359,3793848402,1672678107,1672678590,483
7713,3791115967,3505173328,1672567322,1672568565,1243
7868,3772053179,3792288302,1672560633,1672562470,1837
7506,3505477652,3513201436,1672693109,1672696385,3276
7653,3384240055,3443698222,1672646793,1672649743,2950
7501,3510247121,3757161914,1672662016,1672664678,2662
7823,3668005723,3774556560,1672654167,1672656013,1846
7810,3500199935,3534191820,1672621411,1672624014,2603
7514,3247780536,3772884106,1672575298,1672576598,1300
7682,3832902928,3770078063,1672698293,1672700544,2251
7821,3716273414,3511163800,1672664673,1672665808,1135
7844,3773978034,3898995675,1672691281,1672694621,3340
7706,3520756859,3421836608,1672618607,1672621318,2711
7803,3534010629,3855000166,1672617733,1672618405,672
7520,3713208927,3716835696,1672579076,1672581014,1938
7560,3772578994,3489217083,1672701691,1672702248,557
7824,3611150562,3903962771,1672539128,1672541316,2188
7680,3778341199,3505649239,1672533192,1672536170,2978
7691,3756930948,3533095755,1672563814,1672565426,1612
7714,3500365158,3611150562,1672545382,1672546180,798
7667,3427219654,3231056870,1672582892,1672583755,863
7759,3501184421,3500374658,1672543543,1672546184,2641
7706,3505912939,3914259449,1672639135,1672639509,374
7758,3713208927,3918584946,1672658762,1672662215,3453
7794,3913251733,3365830990,1672589673,1672591651,1978
7723,3433804879,3792789881,1672601138,1672602750,1612
7535,3311993075,3514283243,1672630302,1672631187,885
7516,3793470489,3774466457,1672573507,1672573998,491
7550,3820354437,3318697153,1672666557,1672669462,2905
7562,3400918687,3369998498,1672635474,1672638733,3259
7978,3278365525,3516980378,1672566714,1672567146,432
7979,3772544062,3909331423,1672619946,1672620350,404
7960,3792789881,3201324715,1672619960,1672620743,783
7773,3459030804,3500060260,1672552088,1672552415,327
7602,3303705369,3855424474,1672691433,1672691593,160
7740,3624761861,3200691026,1672561222,1672563878,2656
7718,3374559242,3517255726,1672691186,1672692235,1049
7570,3783196518,3827377568,1672622719,1672625452,2733
7515,3899371911,3357483218,1672545966,1672548761,2795
7514,3509933351,3489728806,1672619601,1672620585,984
7690,3505193212,3883861463,1672689255,1672692814,3559
7506,3475258557,3716197887,1672654575,1672656122,1547
7766,3501486692,3483164654,1672636822,1672640337,3515
7850,3701863557,3682061100,1672587607,1672589977,2370
7596,3912536808,3776338577,1672630528,1672631810,1282
7665,3716168623,3883085535,1672695750,1672698325,2575
7560,3559110998,3392121505,1672664387,1672666044,1657
7561,3370636709,3533242305,1672578494,1672581871,3377
7546,3701184889,3886298125,1672701242,1672702051,809
7549,3851190615,3415546117,1672571548,1672571793,245
7673,3360743849,3338703270,1672670532,1672671273,741
7680,3711308224,3617055293,1672573445,1672576590,3145
7911,3772758337,3238712269,1672562794,1672565932,3138
7852,3791657947,3416265063,1672543255,1672544246,991
7590,3519563836,3711380716,1672619464,1672621397,1933
7971,3780828689,3713969578,1672670473,1672673777,3304
7879,3972709319,3683766533,1672604820,1672607186,2366
7813,3734828619,3755798867,1672680052,1672681017,965
7521,3513599775,3613995936,1672540897,1672544256,3359
7836,3520709480,3510711755,1672625921,1672626928,1007
7869,3333896808,3792473331,1672653896,1672655544,1648
7636,3773120434,3365830990,1672702592,1672705970,3378
7509,3244485293,3427219654,1672537120,1672538578,1458
7584,3777455223,3736790081,1672696885,1672696945,60
7881,3475396323,3476232529,1672602355,1672603033,678
7540,3500391167,3505859863,1672652863,1672656364,3501
7509,3384240055,3417587765,1672606721,1672609838,3117
7928,3533280269,3356860407,1672601430,1672602816,1386
7921,3883042241,3833889105,1672663810,1672665412,1602
7584,3881477378,3614238812,1672628164,1672629262,1098
7503,3713644518,3825229501,1672614339,1672615741,1402
7686,3918674986,3930797455,1672574321,1672577201,2880
7908,3360993964,3407954858,1672668185,1672668356,171
7862,3827377568,3909238838,1672548436,1672550814,2378
7651,3836573197,3668898102,1672592897,1672595642,2745
7690,3511841857,3780788622,1672622715,1672624774,2059
7773,3518876135,3200198928,1672647616,1672648624,1008
7711,3668005723,3505201246,1672699150,1672702225,3075
7530,3760489031,3777929708,1672702456,1672705082,2626
7554,3458539365,3757161914,1672687370,1672690044,2674
7917,3512540951,3618873142,1672632634,1672633375,741
7877,3517721725,3246596716,1672585586,1672587947,2361
7515,3513164386,3501198706,1672562624,1672565330,2706
7839,3500199935,3711370563,1672643464,1672644521,1057
7882,3286658957,3513080274,1672689072,1672690837,1765
7915,3430504438,3505962865,1672540580,1672543752,3172
7922,3770824086,3234362962,1672638659,1672642119,3460
7899,3298433163,3755436115,1672607105,1672607546,441
7665,3716273414,3518496488,1672640324,1672641951,1627
7686,3660493209,3710344260,1672593910,1672595518,1608
7925,3417061462,3505000737,1672563950,1672565506,1556
7520,3291227780,3703441914,1672612356,1672614972,2616
7489,3710112546,3774339795,1672624417,1672625087,670
7934,3559110998,3756601594,1672691752,1672694070,2318
7814,3516258476,3518163778,1672593539,1672594993,1454
7773,3970117174,3783925755,1672688746,1672689193,447
7831,3904408902,3777983879,1672621079,1672622368,1289
7595,3446948848,3249791738,1672672590,1672674113,1523
7739,3883042241,3380035798,1672573165,1672574219,1054
7564,3716165213,3792177074,1672644273,1672645521,1248
7658,3232962003,3500658339,1672575766,1672579084,3318
7801,3716258994,3770635361,1672653700,1672655022,1322
7905,3793286136,3701065786,1672673872,1672675385,1513
7603,3772544062,3783925755,1672695798,1672697789,1991
7791,3715189301,3513454145,1672671040,1672672666,1626
7847,3918584946,3713644518,1672661375,1672664657,3282
7978,3629547065,3701967560,1672629692,1672630912,1220
7629,3505904952,3773814927,1672700529,1672700648,119
7839,3783196518,3735733948,1672687337,1672687432,95
7865,3365942576,3427219654,1672669820,1672671688,1868
7484,3399433690,3391915121,1672688184,1672690351,2167
7783,3418728074,3360506772,1672640872,1672642131,1259
7779,3910454786,3773978034,1672558523,1672561180,2657
7914,3334033993,3629547065,1672574354,1672576535,2181
7917,3918674986,3783206719,1672679769,1672683064,3295
7895,3515723720,3776066388,1672572865,1672575614,2749
7659,3520931254,3493507965,1672621801,1672622190,389
7666,3534488837,3703223015,1672601778,1672604830,3052
7578,3882997884,3509933351,1672582754,1672585376,2622
7536,3311648200,3826760240,1672620844,1672621099,255
7792,3773120434,3533270638,1672625186,1672628235,3049
7539,3800353779,3514472925,1672615950,1672617195,1245
7817,3519700826,3280964728,1672679172,1672680164,992
7900,3494290908,3815508790,1672581430,1672582569,1139
7643,3760267716,3316222192,1672668809,1672672161,3352
7950,3858918246,3424922204,1672588477,1672588812,335
7955,3792883665,3296471982,1672577520,1672577660,140
7787,3760294205,3515860749,1672588662,1672588945,283
7745,3516514391,3757812939,1672550166,1672552907,2741
7749,3485375593,3760077057,1672570292,1672570507,215
7805,3777477395,3509352754,1672682592,1672684407,1815
7876,3227457126,3201432789,1672539153,1672540272,1119
7983,3388637594,3516960534,1672564924,1672567705,2781
7714,3855937514,3930797455,1672645816,1672648473,2657
7537,3973560347,3633420270,1672661850,1672663488,1638
7755,3826759140,3388372715,1672577420,1672580316,2896
7555,3304625412,3610695419,1672604561,1672607291,2730
7855,3396086535,3297463265,1672604977,1672607126,2149
7671,3512837326,3600647945,1672590783,1672592537,1754
7708,3249401741,3365278081,1672642059,1672643735,1676
7618,3359910781,3378092448,1672593169,1672594125,956
7761,3534313900,3500803339,1672566173,1672568298,2125
7507,3520183192,3342131135,1672535338,1672537818,2480
7852,3391915886,3703275621,1672580576,1672582013,1437
7983,3805519285,3400918687,1672634555,1672637228,2673
7582,3496051529,3978115672,1672568676,1672569282,606
7902,3416427576,3772714862,1672590986,1672592477,1491
7574,3857349323,3793086311,1672697049,1672697633,584
7675,3500658339,3367029997,1672626603,1672627214,611
7699,3533385867,3760893269,1672549898,1672552190,2292
7724,3917088658,3518014404,1672534715,1672536470,1755
7524,3636867411,3385763781,1672689898,1672691732,1834
7655,3533095755,3430352815,1672655446,1672656118,672
7670,3229058858,3809059934,1672568236,1672569667,1431
7516,3773465237,3388372715,1672629797,1672632098,2301
7564,3783245561,3610348516,1672558688,1672558944,256
7796,3387966152,3791334389,1672700349,1672700566,217
7890,3466911760,3852391257,1672576029,1672579063,3034
7642,3407673904,3516514391,1672578173,1672579531,1358
7484,3859663348,3899266183,1672560383,1672562327,1944
7584,3918247820,3475258557,1672594739,1672597769,3030
7800,3666506258,3713630656,1672644661,1672645879,1218
7734,3853018906,3505135325,1672627329,1672630927,3598
7944,3713969578,3509634629,1672665500,1672666239,739
7562,3411618230,3770447408,1672701271,1672702994,1723
7862,3428006164,3757602960,1672541647,1672544571,2924
7588,3497901842,3774125065,1672692339,1672693331,992
7910,3773120434,3777983879,1672677935,1672679272,1337
7607,3703223015,3500458761,1672700913,1672701890,977
7738,3793753089,3792288302,1672596647,1672598379,1732
7713,3519700826,3826760240,1672681175,1672682350,1175
7710,3902278226,3774298222,1672598581,1672599669,1088
7761,3344019610,3917278625,1672593928,1672595518,1590
7684,3388286531,3311761694,1672533823,1672535477,1654
7808,3811694763,3516909237,1672622468,1672623323,855
7802,3505362057,3518360734,1672646004,1672646617,613
7750,3885670556,3780974443,1672661343,1672662901,1558
7869,3755798867,3206254161,1672667466,1672670446,2980
7817,3701498253,3701274634,1672634065,1672636524,2459
7863,3478194807,3621810464,1672587100,1672587518,418
7964,3520730271,3415443558,1672604233,1672606918,2685
7702,3809484172,3916289176,1672546727,1672549635,2908
7938,3234362962,3339907603,1672553717,1672554119,402
7584,3772359096,3496549058,1672644967,1672645337,370
7714,3533810360,3500199935,1672621349,1672623625,2276
7809,3829319703,3396285984,1672601237,1672604777,3540
7796,3791020967,3387674757,1672560657,1672562998,2341
7575,3792768129,3555214688,1672617728,1672618895,1167
7791,3346327502,3518360734,1672612734,1672614113,1379
7550,3805342762,3519601612,1672578934,1672580875,1941
7531,3500499542,3755587522,1672678883,1672679784,901
7782,3891751546,3783196518,1672677500,1672679607,2107
7937,3209027249,3510173870,1672662406,1672664614,2208
7932,3489545239,3554917400,1672563277,1672566249,2972
7930,3913251733,3357483218,1672575704,1672578963,3259
7834,3713786889,3936227020,1672602677,1672605501,2824
7904,3311065516,3733891182,1672558458,1672561022,2564
7498,3756528686,3302626661,1672667537,1672668923,1386
7882,3774793839,3505477652,1672588849,1672588909,60
7569,3625274012,3772642849,1672697315,1672697721,406
7811,3511359172,3520709480,1672593628,1672596926,3298
7553,3489962019,3625274012,1672555564,1672559142,3578
7790,3510594211,3783779671,1672700576,1672701056,480
7850,3791553060,3883861463,1672693358,1672696630,3272
7933,3505362057,3778341199,1672679717,1672682820,3103
7642,3792473331,3937224533,1672685621,1672688676,3055
7678,3770635361,3613683164,1672624189,1672625790,1601
7566,3518408774,3289061738,1672655467,1672658030,2563
7895,3520756859,3613995936,1672627433,1672630944,3511
7630,3311718847,3297463265,1672643689,1672644230,541
7580,3811694763,3734828619,1672649495,1672650173,678
7695,3774195321,3682061100,1672688548,1672688826,278
7806,3774580701,3716168623,1672549905,1672553422,3517
7904,3714821932,3614238812,1672565891,1672568490,2599
7510,3774466457,3778780511,1672652341,1672652798,457
7862,3312664885,3512166013,1672591529,1672592441,912
7638,3248507722,3760509236,1672537183,1672537393,210
7524,3755587522,3792473331,1672622527,1672624100,1573
7788,3505173328,3713208927,1672697148,1672698632,1484
7796,3360993964,3399052055,1672669357,1672671788,2431
7594,3297463265,3428964059,1672594947,1672596334,1387
7950,3519700826,3519601612,1672583914,1672586987,3073
7564,3976390453,3716537575,1672675162,1672676653,1491
7648,3222448362,3683766533,1672609852,1672611524,1672
7485,3433804879,3339907603,1672538717,1672540928,2211
7489,3774125065,3312333615,1672621421,1672621988,567
7788,3713630656,3533927138,1672668011,1672671121,3110
7617,3715981584,3235287260,1672678121,1672679967,1846
7853,3664517356,3505869747,1672626864,1672629140,2276
7554,3516065852,3613683164,1672619997,1672623132,3135
7867,3734828619,3404058699,1672616352,1672619738,3386
7976,3505599848,3779528381,1672675429,1672677090,1661
7863,3736592744,3473765852,1672674160,1672676043,1883
7484,3715127362,3416241005,1672564230,1672565240,1010
7854,3401627165,3715974031,1672657523,1672658661,1138
7940,3520931254,3774366875,1672556056,1672558151,2095
7747,3232962003,3701898991,1672620493,1672622716,2223
7565,3918674986,3713630656,1672590813,1672592920,2107
7623,3902278226,3533653428,1672612361,1672614672,2311
7542,3467773920,3509352754,1672536985,1672540512,3527
7907,3792902982,3755511676,1672542311,1672543580,1269
7760,3833889105,3500060260,1672580628,1672582106,1478
7583,3736592744,3780593036,1672607940,1672611110,3170
7758,3500487333,3760267716,1672564454,1672566423,1969
7963,3737154119,3505098372,1672677679,1672680684,3005
7752,3311415018,3554917400,1672638720,1672640215,1495
7681,3402943525,3777477395,1672609281,1672609428,147
7877,3417970574,3780974443,1672692644,1672692928,284
7669,3533371364,3888559320,1672700611,1672701624,1013
7860,3520183192,3397418363,1672604025,1672604625,600
7649,3519912874,3606987130,1672598475,1672602019,3544
7675,3405494240,3534729133,1672637557,1672638198,641
7576,3806545488,3606186086,1672610872,1672613431,2559
7647,3333896808,3899266183,1672593740,1672595554,1814
7488,3733189298,3624761861,1672580801,1672583656,2855
7811,3378686918,3505362057,1672590846,1672594321,3475
7661,3933210486,3716537575,1672618759,1672619934,1175
7801,3319752091,3757812939,1672687187,1672688166,979
7484,3244485293,3811171116,1672696900,1672697697,797
7888,3805347939,3223789409,1672539221,1672542593,3372
7610,3736790081,3793389510,1672698385,1672700887,2502
7716,3731419510,3477649378,1672698710,1672700867,2157
7688,3760992710,3773950140,1672547640,1672551102,3462
7774,3533810360,3737154119,1672642218,1672643982,1764
7921,3519912874,3735733948,1672594971,1672595478,507
7860,3625274012,3713969578,1672605408,1672607811,2403
7609,3465202715,3755587522,1672580255,1672583325,3070
7753,3358871377,3232962003,1672637782,1672641288,3506
7774,3556951786,3518932404,1672555530,1672557514,1984
7854,3311274543,3291883916,1672543456,1672546759,3303
7732,3511350608,3912262917,1672691125,1672691684,559
7612,3701691675,3611150562,1672656373,1672656635,262
7941,3711265369,3780294829,1672576498,1672578209,1711
7543,3512837326,3774125065,1672597153,1672598574,1421
7812,3607748895,3439023335,1672675092,1672675948,856
7756,3510857360,3774298222,1672540086,1672540896,810
7867,3757455053,3783083229,1672575694,1672576797,1103
7637,3516039895,3533095755,1672561597,1672562234,637
7504,3314836094,3889232789,1672664327,1672667392,3065
7538,3365278081,3488244966,1672683349,1672685523,2174
7620,3360743849,3783705817,1672611658,1672614533,2875
7499,3710344260,3409474775,1672689030,1672690897,1867
7676,3510969660,3925402713,1672564244,1672565757,1513
7701,3509672210,3935627557,1672597768,1672599788,2020
7602,3313564074,3500578848,1672623082,1672624583,1501
7822,3755042098,3770078063,1672541046,1672542565,1519
7497,3519563836,3501606184,1672577882,1672578496,614
7772,3399004969,3421127249,1672576184,1672576541,357
7891,3510703546,3287105466,1672696806,1672697159,353
7576,3516011407,3533369198,1672663769,1672664688,919
7687,3880285638,3780593036,1672560578,1672563830,3252
7975,3811171116,3714504419,1672588389,1672589288,899
7776,3770851318,3918247820,1672675147,1672676225,1078
7614,3420700674,3473562469,1672576377,1672576610,233
7908,3858918246,3505145247,1672557872,1672558729,857
7679,3407725581,3510711755,1672624771,1672626750,1979
7881,3755881905,3883042241,1672638535,1672641133,2598
7714,3701898991,3731419510,1672685736,1672687161,1425
7706,3369998498,3685818092,1672615399,1672617367,1968
7872,3791874383,3629547065,1672617161,1672617277,116
7616,3500066230,3756601594,1672695853,1672698914,3061
7738,3222448362,3855000166,1672684554,1672687852,3298
7651,3247428249,3820354437,1672662974,1672664234,1260
7702,3394330287,3519428855,1672627609,1672628945,1336
7888,3618873142,3855424474,1672692661,1672693385,724
7623,3246596716,3886298125,1672629962,1672631063,1101
7642,3501692334,3976633198,1672607074,1672607446,372
7600,3756601594,3817621391,1672647325,1672647600,275
7852,3791553060,3757403279,1672702224,1672705688,3464
7501,3514719601,3736625083,1672634234,1672636216,1982
7512,3772309166,3904408902,1672681882,1672682729,847
7494,3509634629,3400804807,1672699161,1672701175,2014
7498,3475251781,3417061462,1672550041,1672550995,954
7948,3293695955,3311718847,1672650290,1672651320,1030
7913,3793389510,3731106822,1672652386,1672653095,709
7611,3882997884,3904775198,1672644822,1672646144,1322
7574,3512683609,3925620998,1672531289,1672533453,2164
7820,3533626375,3772884106,1672663366,1672666173,2807
7708,3500578848,3660493209,1672606491,1672609816,3325
7847,3209551760,3772544062,1672646800,1672646885,85
7501,3517077106,3780639480,1672608280,1672611761,3481
7663,3512969370,3777455223,1672685017,1672686980,1963
7722,3793086311,3554917400,1672570093,1672571391,1298
7678,3806545488,3509933351,1672627174,1672629581,2407
7829,3776066388,3505098372,1672700570,1672703705,3135
7775,3439023335,3916289176,1672620365,1672621634,1269
7938,3202120784,3777477395,1672626341,1672628069,1728
7654,3701146057,3512540951,1672687528,1672690874,3346
7896,3701984666,3534191820,1672559592,1672560669,1077
7795,3738502357,3407954858,1672624492,1672626332,1840
7484,3209027249,3510857360,1672569898,1672570461,563
7736,3760183458,3713808837,1672554652,1672555564,912
7875,3783925755,3473562469,1672560446,1672563219,2773
7530,3518014404,3828432634,1672681396,1672683364,1968
7952,3517077106,3519152550,1672610155,1672613541,3386
7824,3505201246,3516258476,1672672883,1672676058,3175
7642,3533242305,3916289176,1672575605,1672576784,1179
7875,3383661227,3516065852,1672575072,1672577310,2238
7822,3837094550,3285400528,1672635457,1672638366,2909
7836,3515125508,3520190170,1672702139,1672702736,597
7977,3703871468,3760509236,1672540004,1672542609,2605
7668,3481502100,3298433163,1672555679,1672557271,1592
7647,3500658339,3318697153,1672564527,1672566000,1473
7575,3773664987,3277939457,1672599244,1672602841,3597
7640,3735319397,3517077106,1672546361,1672547945,1584
7641,3760492950,3505883609,1672559903,1672563490,3587
7886,3505638204,3666553782,1672692135,1672692759,624
7843,3773465237,3703441914,1672548594,1672548798,204
7826,3909606423,3783531004,1672627040,1672629616,2576
7949,3516673015,3307512479,1672590379,1672591885,1506
7536,3289061738,3247815299,1672561845,1672562930,1085
7642,3416241005,3519556068,1672625039,1672627140,2101
7646,3711262377,3500229033,1672690732,1672691514,782
7730,3314836094,3972364603,1672540650,1672542426,1776
7980,3899371911,3520756859,1672699940,1672702103,2163
7797,3513080274,3903307060,1672701277,1672702043,766
7887,3829232696,3505219850,1672702530,1672705464,2934
7691,3206593906,3510173870,1672650093,1672651592,1499
7680,3792789881,3773814927,1672577984,1672581187,3203
7672,3828432634,3757403279,1672555201,1672555705,504
7564,3314245084,3911159965,1672615365,1672617884,2519
7777,3774466457,3298433163,1672630373,1672632605,2232
7725,3833889105,3483949762,1672687943,1672690755,2812
7483,3513080274,3826760240,1672602391,1672604114,1723
7698,3510771358,3610348516,1672595683,1672596303,620
7842,3710408395,3710408395,1672621906,1672624260,2354
7587,3517459919,3774268456,1672544170,1672545440,1270
7929,3485375593,3736625083,1672650907,1672654136,3229
7967,3826633236,3783509527,1672663281,1672663997,716
7806,3613683164,3520165601,1672586090,1672589362,3272
7567,3832902928,3516039895,1672619413,1672619620,207
7760,3432665384,3509630174,1672616588,1672619956,3368
7531,3883861463,3819727225,1672569876,1672570500,624
7661,3715974031,3500803339,1672579651,1672581943,2292
7532,3760077057,3911245524,1672616994,1672617079,85
7843,3770851318,3779976989,1672566274,1672568856,2582
7822,3311208440,3774366875,1672596610,1672598853,2243
7551,3834257412,3487171044,1672698373,1672699922,1549
7921,3701984666,3229665776,1672627110,1672629346,2236
7916,3360743849,3601879040,1672613961,1672616804,2843
7680,3512720680,3736229191,1672656426,1672659882,3456
7699,3493507965,3520730271,1672582337,1672584438,2101
7948,3311415018,3713894336,1672601088,1672604462,3374
7710,3338703270,3891751546,1672622728,1672623992,1264
7674,3634340855,3206254161,1672695707,1672697993,2286
7961,3912262917,3336751428,1672670366,1672670823,457
7842,3791901535,3318697153,1672621999,1672624134,2135
7849,3429856982,3737079798,1672665258,1672668353,3095
7839,3439023335,3534553510,1672624799,1672627323,2524
7672,3459030804,3912536808,1672695024,1672697697,2673
7581,3220716272,3939952128,1672600379,1672603601,3222
7959,3772642849,3777790718,1672566240,1672566585,345
7745,3883861463,3736786443,1672644314,1672647115,2801
7975,3777455223,3780593036,1672684756,1672688235,3479
7856,3791957752,3701184889,1672641072,1672644067,2995
7542,3805519285,3221899927,1672622367,1672624640,2273
7905,3930797455,3513201436,1672553336,1672554604,1268
7751,3511170269,3617055293,1672662681,1672664397,1716
7550,3331845324,3701863557,1672646244,1672646731,487
7674,3280599164,3361230905,1672557382,1672557488,106
7621,3615046771,3736625083,1672701422,1672704723,3301
7627,3533626375,3510126867,1672623516,1672625805,2289
7524,3883861463,3516980378,1672568097,1672570191,2094
7812,3404384505,3915628728,1672656965,1672658141,1176
7821,3778108318,3780294829,1672621365,1672622493,1128
7928,3420700674,3505873261,1672691994,1672694626,2632
7591,3512142794,3755587522,1672661398,1672664056,2658
7733,3773205565,3811694763,1672660219,1672662903,2684
7859,3903307060,3534702203,1672578251,1672578586,335
7687,3518163778,3613995936,1672641237,1672641814,577
7929,3512837326,3833889105,1672642879,1672645561,2682
7589,3244485293,3513201436,1672631806,1672634826,3020
7772,3510711755,3918056059,1672568420,1672571806,3386
7645,3924549929,3533927138,1672567367,1672569342,1975
7877,3510969660,3534313900,1672544557,1672545224,667
7729,3533193862,3311415018,1672585980,1672586381,401
7596,3770021824,3304625412,1672542169,1672544543,2374
7734,3731106822,3713969578,1672544573,1672547102,2529
7952,3344364444,3316222192,1672673810,1672675056,1246
7629,3903307060,3774366875,1672548088,1672548872,784
7665,3733891182,3533927138,1672563764,1672564635,871
7981,3731419510,3291235378,1672648835,1672649809,974
7859,3229665776,3284639858,1672662885,1672665910,3025
7914,3855602893,3519563836,1672593973,1672595029,1056
7544,3505347134,3416265063,1672639898,1672640750,852
7751,3208844525,3777443199,1672667900,1672669906,2006
7913,3296471982,3518260334,1672698249,1672700417,2168
7640,3979339287,3855000166,1672681933,1672682603,670
7629,3772746272,3384951177,1672666755,1672667386,631
7718,3385763781,3606812411,1672660358,1672660567,209
7931,3374559242,3904775198,1672700565,1672701236,671
7818,3755436115,3739106581,1672690222,1672690374,152
7693,3756930948,3703789494,1672551909,1672553816,1907
7790,3244436890,3202120784,1672611990,1672613817,1827
7772,3311871871,3701498253,1672586865,1672588609,1744
7785,3511332835,3313541986,1672652526,1672655938,3412
7521,3516606733,3801089989,1672666957,1672668908,1951
7544,3510594211,3701178711,1672601287,1672602410,1123
7876,3736790081,3424922204,1672681580,1672682925,1345
7980,3770078063,3505883609,1672630697,1672634227,3530
7846,3882997884,3772337814,1672562069,1672563745,1676
7906,3776800213,3701967560,1672682456,1672682938,482
7654,3505649239,3617055293,1672691427,1672693714,2287
7792,3515284591,3757562897,1672596547,1672597524,977
7614,3783206719,3519601612,1672622678,1672625426,2748
7615,3517864478,3779976989,1672619893,1672621085,1192
7680,3826760240,3780294829,1672645659,1672646191,532
7821,3922337974,3629935998,1672628227,1672629596,1369
7598,3731419510,3772309166,1672640075,1672641985,1910
7973,3505530961,3550946908,1672698696,1672701853,3157
7625,3383661227,3533025282,1672583051,1672585015,1964
7844,3777477395,3666506258,1672568022,1672571185,3163
7963,3889232789,3411618230,1672668195,1672671107,2912
7771,3280615985,3307097200,1672573164,1672575633,2469
7498,3770635361,3756021689,1672600642,1672603310,2668
7676,3801089989,3600647945,1672694102,1672694843,741
7604,3809059934,3512567240,1672685638,1672687378,1740
7484,3899371911,3518260334,1672612993,1672613272,279
7741,3772309166,3534553510,1672604442,1672605816,1374
7970,3756453423,3710569131,1672677030,1672678684,1654
7931,3639847263,3501692334,1672653043,1672655882,2839
7975,3365830990,3783509527,1672702626,1672704478,1852
7755,3510857360,3773598056,1672700442,1672700505,63
7498,3736625083,3685187183,1672610288,1672613020,2732
7734,3223968713,3606186086,1672544008,1672545815,1807
7802,3550946908,3518360734,1672689566,1672693148,3582
7582,3815508790,3510594211,1672542797,1672546033,3236
7688,3520888296,3318697153,1672539086,1672539447,361
7828,3516514391,3511163800,1672691086,1672691468,382
7656,3774556560,3514719601,1672589909,1672593184,3275
7747,3432665384,3505193212,1672591033,1672591586,553
7707,3337544549,3500894271,1672660324,1672663429,3105
7748,3311627628,3757812939,1672683271,1672685905,2634
7610,3519069599,3935127663,1672675723,1672675823,100
7904,3505962865,3701498253,1672694619,1672698068,3449
7814,3348261553,3895562476,1672695053,1672696749,1696
7793,3773120434,3633420270,1672622526,1672625733,3207
7806,3716197887,3792253549,1672686583,1672688472,1889
7650,3701065786,3236102733,1672693904,1672694098,194
7614,3883042241,3755511676,1672676967,1672680458,3491
7487,3421836608,3505791599,1672532382,1672533250,868
7901,3757151210,3500060260,1672542319,1672545676,3357
7778,3773814927,3792844210,1672640836,1672642218,1382
7707,3711973519,3511312803,1672594886,1672597370,2484
7611,3703735129,3500391167,1672571577,1672573774,2197
7885,3505599848,3808324264,1672552356,1672553313,957
7911,3809484172,3610348516,1672536401,1672537013,612
7634,3633420270,3477375368,1672581105,1672584698,3593
7809,3384951177,3500177712,1672577737,1672580104,2367
7708,3277669002,3975287541,1672645124,1672645993,869
7761,3500803339,3808324264,1672651794,1672652963,1169
7804,3777443199,3778341199,1672576969,1672577839,870
7549,3716168623,3813052709,1672654206,1672654595,389
7777,3711973519,3519703355,1672641611,1672644697,3086
7701,3701146057,3780365428,1672568315,1672570288,1973
7567,3388286531,3249791738,1672613696,1672615494,1798
7553,3484995752,3378092448,1672580971,1672582778,1807
7684,3286658957,3716835696,1672549758,1672552116,2358
7696,3774501422,3505859863,1672665786,1672667625,1839
7773,3783126683,3792789881,1672675109,1672675409,300
7918,3731106822,3783779671,1672558412,1672560266,1854
7877,3625274012,3859525941,1672533077,1672534364,1287
7540,3703889596,3716273414,1672591875,1672592413,538
7677,3918056059,3200691026,1672641902,1672645330,3428
7770,3755392666,3483949762,1672684534,1672685444,910
7866,3518360734,3505219850,1672671560,1672673743,2183
7571,3516065852,3518496488,1672551834,1672555314,3480
7487,3772758337,3511163800,1672585463,1672587493,2030
7608,3774119563,3904408902,1672547905,1672548572,667
7585,3772884106,3475396323,1672680114,1672681733,1619
7901,3206603608,3711571712,1672573600,1672573712,112
7907,3851190615,3407725581,1672576990,1672580173,3183
7586,3505635228,3756462516,1672563194,1672565118,1924
7681,3605726278,3880310724,1672662724,1672663627,903
7488,3505347134,3289061738,1672658595,1672661720,3125
7830,3370752401,3208844525,1672688313,1672689862,1549
7855,3291227780,3939952128,1672672965,1672676444,3479
7701,3792668962,3793470489,1672562720,1672563238,518
7530,3601879040,3886298125,1672679523,1672680566,1043
7666,3505883609,3446948848,1672679370,1672681037,1667
7584,3713786889,3716165213,1672607838,1672611372,3534
7821,3515394721,3454042520,1672661924,1672665093,3169
7529,3209383861,3416241005,1672670905,1672671783,878
7611,3509453566,3235287260,1672583482,1672584674,1192
7596,3518496488,3511332835,1672658341,1672660994,2653
7807,3701111745,3780503655,1672595297,1672597357,2060
7524,3511125626,3973560347,1672645440,1672645805,365
7574,3517255726,3827222533,1672694970,1672698464,3494
7647,3505869747,3407954858,1672578747,1672580713,1966
7490,3505201246,3809916577,1672558218,1672559103,885
7936,3304056063,3616944364,1672583877,1672585046,1169
7813,3898995675,3519703355,1672535364,1672535942,578
7587,3365830990,3774268456,1672556012,1672558168,2156
7961,3792253549,3311415018,1672604306,1672607572,3266
7982,3904775198,3223968713,1672611732,1672612404,672
7657,3701898991,3248507722,1672575382,1672578469,3087
7817,3910454786,3808324264,1672663530,1672664097,567
7692,3901877072,3780974443,1672595341,1672597566,2225
7651,3637008488,3516716179,1672547226,1672549199,1973
7945,3713370078,3828432634,1672582738,1672585332,2594
7831,3520751702,3703223015,1672625949,1672627696,1747
7648,3777717988,3776948966,1672640513,1672642164,1651
7966,3520709480,3835382117,1672548403,1672549941,1538
7808,3713894336,3757682496,1672539649,1672540010,361
7910,3917278625,3770101921,1672599442,1672602085,2643
7722,3487171044,3626156564,1672640464,1672643360,2896
7694,3791657947,3427219654,1672600636,1672602110,1474
7737,3703223015,3477649378,1672579124,1672579850,726
7522,3433804879,3475795792,1672576417,1672576554,137
7851,3520719611,3793086311,1672692692,1672693700,1008
7767,3917088658,3512166013,1672604301,1672606518,2217
7877,3223968713,3500499542,1672621183,1672622048,865
7843,3886298125,3816454165,1672581604,1672582072,468
7620,3372883226,3373384732,1672581502,1672581863,361
7654,3855000166,3664170666,1672536029,1672537766,1737
7664,3613995936,3534492426,1672587695,1672590833,3138
7947,3685818092,3516629436,1672669559,1672671000,1441
7524,3804870229,3500805881,1672679333,1672681535,2202
7952,3757812939,3517963492,1672699896,1672701801,1905
7707,3284832486,3401627165,1672547568,1672547975,407
7616,3478194807,3556951786,1672659384,1672662101,2717
7812,3713644518,3519703355,1672600396,1672603343,2947
7675,3478194807,3780788622,1672537955,1672539369,1414
7518,3246596716,3277605882,1672586437,1672589262,2825
7745,3311208440,3379256399,1672595280,1672597024,1744
7583,3773120434,3760492950,1672664674,1672667090,2416
7501,3288764520,3791115967,1672532903,1672533047,144
7929,3815508790,3931941795,1672558071,1672559795,1724
7896,3755042098,3714962248,1672671753,1672672105,352
7794,3510771358,3516011407,1672534155,1672534535,380
7807,3701863557,3301107849,1672684391,1672685441,1050
7714,3852391257,3895562476,1672653352,1672653883,531
7629,3760077057,3515723720,1672543474,1672544453,979
7620,3534010629,3311439795,1672534987,1672537999,3012
7961,3291235378,3777776687,1672645687,1672649182,3495
7550,3930797455,3924549929,1672557828,1672557890,62
7495,3533626375,3800886801,1672544746,1672545533,787
7966,3510703546,3505098372,1672618076,1672618347,271
7636,3311845971,3703013906,1672594703,1672595871,1168
7838,3500904641,3807987001,1672569248,1672571118,1870
7982,3755042098,3224058172,1672703914,1672706833,2919
7561,3701995648,3201324715,1672546390,1672548341,1951
7545,3401627165,3520756859,1672682386,1672685539,3153
7854,3857349323,3918247820,1672655987,1672658764,2777
7579,3311415018,3909606423,1672599691,1672600394,703
7913,3792902982,3710098970,1672541699,1672545085,3386
7871,3483949762,3421127249,1672584309,1672587605,3296
7491,3806545488,3772714862,1672638052,1672641066,3014
7487,3432665384,3500229033,1672643805,1672645210,1405
7821,3734737881,3791594391,1672699626,1672700363,737
7833,3516960534,3903962771,1672615725,1672617288,1563
7947,3228165483,3313541986,1672540568,1672541787,1219
7629,3500994774,3711262377,1672621599,1672624504,2905
7571,3777936328,3713808837,1672541034,1672542494,1460
7690,3783779671,3731106822,1672628916,1672631214,2298
7637,3780365428,3380035798,1672648031,1672650813,2782
7637,3885670556,3511163800,1672658095,1672659596,1501
7797,3733189298,3701995648,1672639691,1672642093,2402
7962,3664170666,3805342762,1672619856,1672623107,3251
7605,3664517356,3774556560,1672597808,1672597972,164
7555,3430074045,3420700674,1672694524,1672696834,2310
7597,3338367113,3520629279,1672647036,1672648540,1504
7689,3284832486,3380035798,1672540321,1672541796,1475
7875,3520030713,3780503655,1672593075,1672596458,3383
7938,3500994774,3520376528,1672671733,1672672612,879
7610,3428964059,3779629905,1672550432,1672551067,635
7951,3855602893,3202120784,1672645130,1672646818,1688
7860,3512142794,3505362057,1672638460,1672639584,1124
7800,3415546117,3818255890,1672676770,1672678434,1664
7541,3361230905,3716900301,1672662679,1672664974,2295
7609,3909606423,3770851318,1672578822,1672579983,1161
7654,3683959482,3713208927,1672597771,1672600539,2768
7587,3770553384,3624761861,1672543636,1672546920,3284
7524,3277669002,3533626375,1672668666,1672671630,2964
7960,3519703355,3904408902,1672666068,1672666616,548
7689,3780503655,3229058858,1672630849,1672631723,874
7484,3280615985,3772309166,1672650084,1672651132,1048
7553,3520730271,3209383861,1672672040,1672675631,3591
7821,3755625324,3534191820,1672659735,1672661159,1424
7955,3791594391,3664517356,1672675498,1672678487,2989
7731,3736419952,3783429780,1672685780,1672688623,2843
7837,3304056063,3916289176,1672647442,1672647861,419
7613,3533193862,3624312512,1672553655,1672557199,3544
7952,3277669002,3420700674,1672653919,1672655746,1827
7785,3383922351,3829232696,1672609692,1672611435,1743
7761,3510771358,3887270940,1672637419,1672639163,1744
7554,3511359172,3512683609,1672536822,1672538979,2157
7772,3516606733,3509604974,1672592975,1672595495,2520
7488,3664170666,3852595551,1672628365,1672631614,3249
7740,3505904952,3224058172,1672620281,1672622453,2172
7759,3811171116,3600647945,1672602334,1672605221,2887
7803,3703013906,3391915121,1672590208,1672593603,3395
7820,3338703270,3703871468,1672676581,1672676764,183
7924,3837094550,3505638204,1672674822,1672676808,1986
7787,3793086311,3778308417,1672533079,1672534052,973
7755,3667680268,3792902982,1672554561,1672555722,1161
7600,3805347939,3399052055,1672701039,1672704218,3179
7722,3886298125,3534702203,1672685031,1672686686,1655
7523,3628819436,3714821932,1672645751,1672648823,3072
7513,3605726278,3802367797,1672611672,1672613978,2306
7713,3606812411,3399433690,1672620339,1672622367,2028
7726,3407954858,3303751772,1672617080,1672619283,2203
7910,3303751772,3512349371,1672552557,1672554499,1942
7653,3774338212,3520730271,1672663033,1672663282,249
7508,3509907947,3516909237,1672671066,1672673398,2332
7743,3514987389,3500177712,1672570680,1672571897,1217
7642,3311203656,3624761861,1672564385,1672564828,443
7929,3770021824,3200198928,1672690859,1672691522,663
7526,3793848402,3505347134,1672628865,1672632252,3387
7673,3711198793,3777623166,1672552938,1672555671,2733
7511,3711198793,3209048907,1672647080,1672649701,2621
7540,3760077057,3792789881,1672565477,1672567505,2028
7806,3465202715,3666507626,1672627101,1672629666,2565
7571,3859525941,3772359096,1672681252,1672681723,471
7648,3501955238,3209048907,1672667151,1672668642,1491
7612,3770078063,3774520233,1672575873,1672577010,1137
7551,3515691540,3370752401,1672618110,1672620356,2246
7910,3356860407,3517255726,1672683070,1672683892,822
7799,3533927138,3311274543,1672666005,1672668408,2403
7943,3307512479,3510857360,1672560242,1672562620,2378
7810,3834257412,3399433690,1672675776,1672679280,3504
7518,3613995936,3533280269,1672600333,1672602467,2134
7799,3458539365,3288764520,1672601264,1672603133,1869
7865,3776513891,3518876135,1672693890,1672697479,3589
7874,3836573197,3512166013,1672550989,1672553234,2245
7605,3533626375,3287105466,1672538903,1672539577,674
7872,3777806071,3922337974,1672686201,1672688449,2248
7872,3505292701,3880310724,1672685915,1672688359,2444
7661,3756930948,3415443558,1672597271,1672597493,222
7798,3600647945,3448855696,1672681933,1672685255,3322
7804,3774127586,3701691675,1672703472,1672705669,2197
7880,3834257412,3496549058,1672700676,1672703880,3204
7616,3481647420,3922275416,1672681306,1672683563,2257
7861,3755798867,3778980116,1672663728,1672666290,2562
7643,3774580701,3235287260,1672625155,1672626056,901
7537,3394330287,3509630174,1672538920,1672539106,186
7742,3505883609,3666553782,1672701973,1672705545,3572
7715,3234362962,3735319397,1672703148,1672704604,1456
7484,3714197325,3811171116,1672631069,1672632748,1679
7565,3711370563,3770078063,1672661507,1672664628,3121
7937,3407954858,3227158514,1672600269,1672600464,195
7726,3520190170,3505873261,1672638880,1672639581,701
7826,3370636709,3716835696,1672576195,1672579063,2868
7941,3511170269,3813052709,1672534688,1672537698,3010
7572,3737079798,3480687894,1672548961,1672550646,1685
7495,3701111745,3711262377,1672692122,1672694893,2771
7638,3601879040,3234362962,1672652458,1672652995,537
7957,3710067113,3370752401,1672542813,1672545888,3075
7586,3496269445,3516011407,1672683369,1672684225,856
7523,3514838220,3519700826,1672670908,1672671185,277
7562,3926700506,3510380060,1672673532,1672675111,1579
7823,3533626375,3774010081,1672693499,1672695604,2105
7569,3390068992,3374559242,1672672980,1672673901,921
7965,3476232529,3511841857,1672690608,1672693810,3202
7672,3772359096,3817621391,1672658520,1672661059,2539
7808,3779976989,3703013906,1672681761,1672682768,1007
7572,3336751428,3703441914,1672687126,1672688486,1360
7821,3512142794,3378092448,1672596581,1672598746,2165
7499,3637008488,3533371364,1672693295,1672694828,1533
7530,3399535232,3739106581,1672668760,1672668838,78
7945,3466911760,3710067113,1672656992,1672659420,2428
7900,3500658339,3505873261,1672622998,1672625004,2006
7500,3201848640,3770021824,1672630414,1672630665,251
7827,3757161914,3805519285,1672577361,1672578845,1484
7939,3511312803,3780813786,1672639712,1672641333,1621
7709,3777936328,3517077106,1672621982,1672624730,2748
7797,3774204963,3793962300,1672682817,1672686274,3457
7621,3206593906,3500803339,1672567429,1672569660,2231
7705,3511841857,3773950140,1672633990,1672634734,744
7505,3287105466,3772758337,1672587235,1672588088,853
7610,3430504438,3889232789,1672547841,1672550423,2582
7914,3731106822,3880285638,1672678340,1672680261,1921
7803,3280599164,3770635361,1672538837,1672542195,3358
7924,3360743849,3791942683,1672574725,1672575834,1109
7640,3477375368,3772359096,1672546892,1672547370,478
7610,3509453566,3221899927,1672534761,1672535168,407
7758,3316222192,3477375368,1672550955,1672553878,2923
7862,3416241005,3276993580,1672612523,1672615355,2832
7771,3391261292,3811694763,1672598895,1672602345,3450
7895,3608633356,3715339701,1672580540,1672582597,2057
7869,3500578848,3421836608,1672564451,1672567493,3042
7635,3755392666,3201324715,1672646398,1672646659,261
7624,3808324264,3513454145,1672536507,1672537125,618
7552,3823600322,3756021689,1672667166,1672670169,3003
7693,3774066725,3714962248,1672538123,1672541328,3205
7907,3636867411,3772544062,1672570533,1672572375,1842
7861,3625274012,3229665776,1672605833,1672609304,3471
7727,3836573197,3520376528,1672692135,1672695204,3069
7865,3500487333,3914290246,1672625238,1672627738,2500
7804,3889750851,3429690204,1672538922,1672542140,3218
7659,3774119563,3899371911,1672690816,1672691282,466
7553,3910454786,3792789881,1672678949,1672682529,3580
7859,3505530961,3772714862,1672618032,1672620069,2037
7657,3378436155,3222521619,1672618120,1672618595,475
7785,3776338577,3880285638,1672582047,1672582223,176
7577,3500803339,3757682496,1672669038,1672671481,2443
7579,3701691675,3857349323,1672645932,1672648338,2406
7597,3534191820,3533927138,1672608040,1672608222,182
7502,3930791338,3760267716,1672687193,1672689704,2511
7873,3779528381,3446948848,1672669181,1672671677,2496
7919,3208844525,3286658957,1672586844,1672588690,1846
7487,3780788622,3770635361,1672596549,1672599338,2789
7555,3473562469,3516716179,1672653586,1672653720,134
7671,3231056870,3935627557,1672579043,1672581399,2356
7742,3399911573,3533371364,1672670893,1672674359,3466
7686,3901990690,3772337814,1672566866,1672567121,255
7847,3826415738,3311154569,1672666030,1672668513,2483
7569,3800353779,3365278081,1672627915,1672629750,1835
7488,3793871337,3516011407,1672691166,1672694606,3440
7914,3311761694,3395152943,1672567132,1672569954,2822
7633,3921211276,3736592744,1672553549,1672554170,621
7891,3713786889,3356860407,1672597889,1672600543,2654
7660,3428674539,3703735129,1672643633,1672644867,1234
7736,3774556560,3813052709,1672591768,1672592688,920
7891,3685818092,3519601612,1672534161,1672536234,2073
7868,3636867411,3773978034,1672577734,1672578951,1217
7936,3777623166,3772309150,1672638625,1672638866,241
7972,3774125065,3828432634,1672648612,1672649425,813
7944,3917278625,3756601594,1672644985,1672648512,3527
7813,3713969578,3399004969,1672533653,1672537242,3589
7907,3778108318,3406784491,1672695835,1672697647,1812
7753,3909331423,3388286531,1672633443,1672636566,3123
7650,3359239884,3734828619,1672588740,1672591076,2336
7879,3516065852,3303751772,1672622791,1672623115,324
7773,3701984666,3711198793,1672637355,1672640645,3290
7922,3487171044,3303751772,1672622904,1672623206,302
7772,3780788622,3312829208,1672552230,1672555420,3190
7713,3448855696,3777455223,1672581504,1672585077,3573
7883,3365614305,3735733948,1672649557,1672652372,2815
7815,3446948848,3773814927,1672668940,1672669978,1038
7900,3384951177,3627937312,1672686443,1672687460,1017
7850,3817316561,3534488837,1672679594,1672680866,1272
7512,3284639858,3936227020,1672652513,1672654487,1974
7973,3760509236,3273500349,1672634170,1672636205,2035
7781,3778266283,3774125065,1672604667,1672606959,2292
7728,3505869747,3715492942,1672613180,1672614335,1155
7797,3793871337,3277939457,1672663671,1672664635,964
7528,3505347134,3496269445,1672591442,1672594746,3304
7506,3760598102,3405494240,1672617268,1672620171,2903
7661,3701178711,3703955926,1672633045,1672635931,2886
7810,3757151210,3433804879,1672663682,1672666715,3033
7643,3512349371,3510771358,1672558822,1672561583,2761
7898,3773950140,3443698222,1672676957,1672677401,444
7687,3776948966,3483949762,1672611101,1672612586,1485
7627,3404384505,3515284591,1672601325,1672604200,2875
7866,3760294205,3685187183,1672544666,1672546007,1341
7592,3533270638,3901990690,1672668557,1672669394,837
7945,3770851318,3209027249,1672539731,1672540484,753
7733,3606812411,3397418363,1672615943,1672616887,944
7935,3637008488,3972364603,1672612306,1672615105,2799
7890,3667680268,3792032359,1672688117,1672689190,1073
7796,3298433163,3714821932,1672640269,1672641231,962
7711,3715974031,3279721246,1672538372,1672540225,1853
7863,3401627165,3701995648,1672699431,1672701213,1782
7923,3791874383,3520030713,1672629682,1672631868,2186
7634,3711308224,3855000166,1672612733,1672614197,1464
7700,3779740455,3711569060,1672531253,1672534069,2816
7727,3901877072,3511125626,1672634331,1672636174,1843
7810,3836573197,3311648200,1672570458,1672573831,3373
7576,3682061100,3345207877,1672579678,1672580365,687
7598,3816454165,3293695955,1672535565,1672537940,2375
7494,3534313900,3443698222,1672668976,1672671689,2713
7969,3339907603,3915628728,1672629118,1672632028,2910
7754,3760992710,3500487333,1672680713,1672681521,808
7895,3776800213,3519700826,1672654199,1672656300,2101
7811,3505173328,3483164654,1672606139,1672609391,3252
7547,3400804807,3416241005,1672660260,1672662238,1978
7947,3513599775,3770824086,1672585001,1672588590,3589
7866,3396285984,3975287541,1672667132,1672669365,2233
7586,3222521619,3909606423,1672667366,1672668118,752
7506,3201848640,3505869747,1672683331,1672685831,2500
7574,3511841857,3834257412,1672672113,1672673966,1853
7761,3885670556,3770553384,1672561333,1672563749,2416
7537,3855424474,3209551760,1672695421,1672695787,366
7617,3206593906,3209027249,1672553605,1672554182,577
7794,3505635228,3458539365,1672692081,1672695561,3480
7597,3607748895,3209551760,1672644787,1672647548,2761
7944,3770078063,3772359096,1672609549,1672610345,796
7631,3883312122,3505193212,1672698836,1672699801,965
7919,3777079686,3534191820,1672619953,1672621439,1486
7598,3311415018,3500658339,1672614304,1672615809,1505
7570,3773978034,3880310724,1672639929,1672643041,3112
7817,3792032359,3303705369,1672554636,1672557370,2734
7822,3791997875,3477375368,1672538025,1672539406,1381
7772,3701146057,3715492942,1672611596,1672613000,1404
7965,3607748895,3714474557,1672574244,1672574830,586
7510,3234541252,3200198928,1672629870,1672630893,1023
7864,3518932404,3209048907,1672651433,1672654497,3064
7594,3713630656,3505791599,1672609189,1672609942,753
7685,3387674757,3311845971,1672671269,1672672237,968
7562,3757682496,3793627961,1672588380,1672589212,832
7829,3755042098,3516223597,1672648675,1672649490,815
7753,3399535232,3228165483,1672554228,1672557756,3528
7537,3518669703,3400804807,1672613172,1672613346,174
7698,3520751702,3701984666,1672700899,1672702226,1327
7490,3801089989,3209551760,1672637860,1672639932,2072
7501,3770447408,3365942576,1672585317,1672587005,1688
7872,3755042098,3465254146,1672659417,1672662037,2620
7654,3886298125,3510380060,1672560616,1672561231,615
7678,3701898991,3711265369,1672592434,1672593602,1168
7676,3626156564,3716197887,1672581145,1672584613,3468
7898,3505904952,3715998609,1672649976,1672653410,3434
7856,3710344260,3365278081,1672546836,1672549417,2581
7912,3736625083,3399911573,1672535790,1672536493,703
7598,3501759100,3760267716,1672655943,1672659148,3205
7489,3688683847,3776513891,1672626955,1672628164,1209
7599,3359239884,3420700674,1672604608,1672605534,926
7894,3755881905,3519654779,1672599128,1672601168,2040
7537,3417970574,3773205565,1672646842,1672647109,267
7593,3395152943,3247815299,1672634940,1672635394,454
7829,3513956646,3554917400,1672566102,1672569614,3512
7952,3756453423,3501759100,1672552819,1672555138,2319
7860,3826760240,3716835696,1672610009,1672610829,820
7616,3883085535,3783429780,1672583464,1672586890,3426
7698,3779218771,3514838220,1672630481,1672631137,656
7952,3836573197,3666553782,1672647967,1672649467,1500
7801,3637008488,3334033993,1672590351,1672592051,1700
7512,3505193212,3770824086,1672680797,1672681761,964
7854,3904775198,3911159965,1672560074,1672562478,2404
7510,3443698222,3294803686,1672613673,1672614979,1306
7667,3731106822,3533385867,1672585455,1672588225,2770
7677,3399052055,3515860749,1672555825,1672557372,1547
7617,3500374658,3202120784,1672562508,1672565085,2577
7612,3903009525,3520190170,1672674710,1672676359,1649
7826,3783206719,3475258557,1672624586,1672627555,2969
7527,3882291183,3773755137,1672627906,1672629342,1436
7607,3883042241,3713644518,1672580984,1672583651,2667
7911,3773950140,3518669703,1672557783,1672558063,280
7847,3774125065,3917088658,1672602651,1672605932,3281
7925,3770824086,3666553782,1672631876,1672635191,3315
7945,3904775198,3534492426,1672563752,1672565111,1359
7663,3472130842,3520706195,1672626575,1672629737,3162
7835,3221536550,3774125065,1672556951,1672558401,1450
7622,3755920131,3667680268,1672642975,1672644646,1671
7523,3520931254,3500578848,1672620090,1672623643,3553
7750,3737051610,3783705817,1672568607,1672569837,1230
7755,3736229191,3515125508,1672602440,1672602542,102
7609,3683766533,3227457126,1672589619,1672591795,2176
7708,3511841857,3399433690,1672588576,1672592090,3514
7824,3510173870,3370752401,1672544902,1672547951,3049
7776,3755042098,3533810360,1672693860,1672696633,2773
7585,3280615985,3822654369,1672679078,1672679388,310
7539,3855602893,3378436155,1672544097,1672544900,803
7651,3633420270,3311152102,1672688739,1672691730,2991
7539,3501955238,3516258476,1672670625,1672673598,2973
7977,3772359096,3791942683,1672617958,1672619713,1755
7694,3511271692,3736625083,1672593991,1672595451,1460
7744,3701898991,3703013906,1672534673,1672538256,3583
7955,3511435497,3351554343,1672624933,1672628116,3183
7822,3902383721,3730517636,1672538978,1672539057,79
7583,3776513891,3516673015,1672701889,1672703329,1440
7781,3783779671,3890149705,1672667641,1672671099,3458
7736,3737154119,3792789881,1672565342,1672568272,2930
7694,3516716179,3852391257,1672679377,1672681501,2124
7541,3332072298,3901990690,1672620521,1672623727,3206
7836,3777929708,3772309150,1672646004,1672648416,2412
7509,3773465237,3792844210,1672606742,1672606932,190
7855,3889750851,3836573197,1672689748,1672690914,1166
7972,3516223597,3716273414,1672609654,1672613189,3535
7669,3247815299,3628819436,1672690290,1672691563,1273
7491,3229665776,3206254161,1672638548,1672641203,2655
7896,3701995648,3500803339,1672615051,1672617072,2021
7876,3361230905,3883312122,1672540297,1672543731,3434
7886,3510126867,3277939457,1672645251,1672647900,2649
7678,3716843669,3713349754,1672600582,1672603974,3392
7572,3859525941,3481647420,1672548271,1672550831,2560
7886,3802367797,3500904641,1672585789,1672589025,3236
7585,3804870229,3416427576,1672597834,1672599627,1793
7889,3206593906,3757161914,1672625663,1672627108,1445
7807,3534313900,3792668962,1672636449,1672638233,1784
7895,3501955238,3476232529,1672645313,1672646050,737
7596,3520730271,3433804879,1672580571,1672583852,3281
7708,3374559242,3756462516,1672633844,1672635542,1698
7551,3505477652,3780503655,1672597160,1672599743,2583
7845,3975287541,3710569131,1672539043,1672541836,2793
7498,3835382117,3550946908,1672604121,1672607418,3297
7654,3501364586,3514128943,1672604340,1672606161,1821
7978,3513201436,3664170666,1672661268,1672664594,3326
7600,3533270638,3519428855,1672556954,1672557921,967
7732,3738502357,3713808837,1672554826,1672555571,745
7875,3701898991,3400918687,1672703485,1672706650,3165
7937,3881477378,3885897503,1672608842,1672612256,3414
7651,3505869747,3828365570,1672624920,1672628236,3316
7720,3220716272,3780294829,1672607758,1672609863,2105
7671,3711370563,3773465237,1672572702,1672574517,1815
7715,3476232529,3415443558,1672693329,1672695603,2274
7713,3513080274,3391915121,1672557099,1672558864,1765
7575,3736229191,3627937312,1672599515,1672601308,1793
7903,3416241005,3606186086,1672651959,1672653706,1747
7621,3520376528,3755042098,1672617326,1672617892,566
7708,3774050956,3516258476,1672650303,1672650739,436
7634,3777477395,3660493209,1672556930,1672560505,3575
7708,3738502357,3533927138,1672583009,1672583652,643
7716,3918584946,3500805881,1672667414,1672669214,1800
7590,3505649239,3454042520,1672616999,1672620568,3569
7860,3244173074,3780365428,1672575992,1672576902,910
7640,3235635976,3201432789,1672582430,1672585136,2706
7499,3533371364,3715974031,1672617453,1672618121,668
7499,3501364586,3826759140,1672694551,1672696730,2179
7794,3701995648,3373384732,1672623518,1672624108,590
7908,3510380060,3713370078,1672636282,1672636686,404
7648,3757602960,3755042098,1672660631,1672663853,3222
7730,3533626375,3736625083,1672590915,1672592287,1372
7878,3823600322,3244173074,1672657783,1672658504,721
7776,3466229085,3774010081,1672588285,1672589391,1106
7857,3837094550,3511359172,1672540207,1672540604,397
7675,3703275621,3249401741,1672696959,1672700509,3550
7717,3365278081,3511359172,1672652584,1672654785,2201
7768,3520165601,3209048907,1672644373,1672646137,1764
7895,3513599775,3755511676,1672677518,1672678126,608
7599,3979339287,3972364603,1672563543,1672564999,1456
7697,3792384220,3716273414,1672639922,1672642579,2657
7940,3783206719,3500177712,1672670953,1672673507,2554
7891,3972709319,3711198793,1672572970,1672575659,2689
7860,3777717988,3311761694,1672534778,1672536019,1241
7944,3231056870,3515723720,1672644863,1672644934,71
7489,3513599775,3760077057,1672639752,1672641052,1300
7586,3399052055,3362000049,1672611975,1672613940,1965
7610,3533371364,3912536808,1672628255,1672631087,2832
7846,3520931254,3774066725,1672687686,1672688480,794
7546,3755511676,3500994774,1672685759,1672687563,1804
7958,3439023335,3730517636,1672616080,1672618270,2190
7686,3756451663,3970117174,1672654656,1672658129,3473
7744,3513080274,3812176780,1672548799,1672551594,2795
7704,3793086311,3510937904,1672644247,1672647566,3319
7942,3516065852,3518014404,1672685695,1672685762,67
7717,3713268590,3222521619,1672694330,1672697439,3109
7762,3783196518,3505859863,1672694591,1672695646,1055
7690,3773814927,3475258557,1672568675,1672570321,1646
7913,3834257412,3776800213,1672609846,1672612473,2627
7705,3716168623,3779629905,1672536075,1672537702,1627
7793,3509634629,3903962771,1672549670,1672552049,2379
7506,3515691540,3773664987,1672669730,1672672776,3046
7889,3800353779,3685818092,1672700642,1672702749,2107
7867,3634786711,3311761694,1672619805,1672622200,2395
7769,3209383861,3432689543,1672631365,1672632628,1263
7918,3416427576,3517721725,1672590366,1672593040,2674
7715,3533270638,3235635976,1672619096,1672621351,2255
7884,3518791447,3430074045,1672601980,1672602511,531
7840,3533193862,3344019610,1672623412,1672626991,3579
7487,3783083229,3399433690,1672580806,1672582330,1524
7585,3534488837,3516011407,1672578871,1672581711,2840
7681,3736229191,3420700674,1672554227,1672556392,2165
7964,3756021689,3783509527,1672676266,1672679287,3021
7881,3660493209,3713969578,1672538478,1672539380,902
7586,3311439795,3520376528,1672607691,1672610843,3152
7889,3364543015,3399911573,1672593547,1672596145,2598
7817,3662180254,3516258476,1672595472,1672597606,2134
7785,3505000737,3501364586,1672702485,1672704948,2463
7968,3889750851,3415443558,1672658194,1672660390,2196
7745,3783531004,3779528381,1672625136,1672627108,1972
7489,3518669703,3501364586,1672627555,1672629425,1870
7500,3783206719,3519912874,1672543672,1672545647,1975
7830,3505883609,3792288302,1672682814,1672684872,2058
7777,3222521619,3716488385,1672576641,1672577350,709
7501,3778980116,3511687358,1672662541,1672663153,612
7686,3505649239,3755881905,1672568786,1672570308,1522
7764,3312664885,3760077057,1672591395,1672593237,1842
7539,3439023335,3713808837,1672642389,1672643471,1082
7978,3780593036,3483164654,1672608111,1672611503,3392
7853,3610348516,3606812411,1672646971,1672647653,682
7898,3311845971,3780974443,1672677201,1672677708,507
7882,3606812411,3773465237,1672669326,1672669570,244
7905,3711370563,3516223597,1672703862,1672705086,1224
7844,3909606423,3909238838,1672545223,1672546008,785
7516,3517255726,3519563836,1672622908,1672626294,3386
7532,3716488385,3837094550,1672586119,1672587109,990
7675,3629935998,3235635976,1672549702,1672553195,3493
7537,3554917400,3201432789,1672666592,1672669892,3300
7976,3433804879,3227457126,1672564779,1672565611,832
7739,3826415738,3714197325,1672532369,1672535764,3395
7689,3756623396,3311761694,1672686637,1672687815,1178
7945,3756601594,3909331423,1672557895,1672558650,755
7508,3756601594,3448855696,1672568523,1672570783,2260
7692,3514283243,3519152550,1672668611,1672671271,2660
7866,3713808837,3232962003,1672540527,1672541046,519
7696,3505145247,3688418210,1672685401,1672686812,1411
7515,3303705369,3716258994,1672561608,1672564585,2977
7647,3420432297,3383922351,1672619800,1672622691,2891
7770,3209551760,3483164654,1672695784,1672695902,118
7608,3664517356,3774066725,1672634041,1672635155,1114
7911,3244485293,3209048907,1672652477,1672653748,1271
7824,3505193212,3515860749,1672556931,1672557319,388
7658,3505477652,3471220483,1672659007,1672662031,3024
7930,3533280269,3234362962,1672640539,1672642489,1950
7620,3757246925,3534191820,1672696133,1672699422,3289
7676,3519700826,3224716315,1672628212,1672630217,2005
7697,3792902982,3500391167,1672668657,1672669621,964
7774,3249401741,3289061738,1672623113,1672626409,3296
7602,3276993580,3477375368,1672625640,1672626502,862
7550,3517459919,3247428249,1672539149,1672542083,2934
7977,3512349371,3606812411,1672562151,1672564872,2721
7645,3515723720,3881477378,1672673338,1672673539,201
7654,3519152550,3364543015,1672561112,1672562234,1122
7846,3550946908,3626156564,1672691053,1672691314,261
7643,3516629436,3826415738,1672579683,1672582547,2864
7884,3511862351,3520165601,1672606576,1672607813,1237
7819,3404384505,3774520233,1672699417,1672699593,176
7911,3607178184,3360743849,1672676295,1672676612,317
7837,3515151980,3783206719,1672673632,1672674656,1024
7825,3505869747,3979339287,1672546641,1672546834,193
7773,3618045231,3716258994,1672545943,1672547745,1802
7793,3618873142,3714504419,1672602369,1672603965,1596
7818,3776800213,3370636709,1672660617,1672663562,2945
7713,3359910781,3404384505,1672628898,1672630342,1444
7660,3417587765,3209027249,1672669777,1672671354,1577
7509,3935127663,3234362962,1672564769,1672567478,2709
7897,3793962300,3756462516,1672699039,1672700270,1231
7673,3780294829,3772746272,1672660334,1672663316,2982
7495,3280599164,3476232529,1672561366,1672561994,628
7849,3731419510,3936227020,1672633125,1672634470,1345
7794,3736419952,3494290908,1672666219,1672668384,2165
7648,3736625083,3774466457,1672677933,1672681040,3107
7661,3778308417,3792288302,1672576179,1672577836,1657
7719,3776948966,3392121505,1672628285,1672631201,2916
7898,3438645253,3500894271,1672599658,1672603045,3387
7723,3783925755,3509630174,1672605604,1672606095,491
7709,3228165483,3412825109,1672670695,1672673398,2703
7495,3701274634,3232962003,1672557805,1672559502,1697
7610,3770553384,3610348516,1672670788,1672673154,2366
7724,3817621391,3511170269,1672568276,1672569787,1511
7658,3819727225,3913251733,1672595378,1672596189,811
7674,3774125065,3515151980,1672615815,1672616599,784
7952,3802367797,3512217942,1672593479,1672595674,2195
7859,3882997884,3780609808,1672603950,1672605063,1113
7564,3829764737,3757403279,1672565132,1672567486,2354
7701,3703889596,3926700506,1672562595,1672563244,649
7565,3618045231,3517963492,1672542499,1672544546,2047
7731,3791334389,3453729665,1672667190,1672668329,1139
7766,3910886626,3852595551,1672697297,1672700739,3442
7570,3511841857,3501606184,1672628367,1672631384,3017
7825,3478194807,3478194807,1672607052,1672610197,3145
7826,3624761861,3710112546,1672639664,1672639829,165
7737,3518014636,3793959750,1672575507,1672577949,2442
7576,3458539365,3373384732,1672694348,1672696324,1976
7945,3778305740,3404384505,1672559346,1672562170,2824
7783,3228165483,3432689543,1672692789,1672695930,3141
7870,3505201246,3556951786,1672631804,1672633265,1461
7809,3828624701,3972709319,1672574845,1672577259,2414
7926,3430074045,3488244966,1672547067,1672550211,3144
7663,3231056870,3377766165,1672647159,1672648309,1150
7519,3395152943,3428964059,1672541409,1672541959,550
7837,3793962300,3400918687,1672597337,1672599932,2595
7917,3511163800,3625274012,1672554554,1672557797,3243
7822,3519556068,3501606184,1672627234,1672627736,502
7944,3716258994,3780788622,1672600722,1672602351,1629
7532,3484995752,3518408774,1672553963,1672557065,3102
7497,3509604974,3478194807,1672625439,1672628118,2679
7802,3227457126,3501927421,1672593404,1672594286,882
7911,3534553510,3296471982,1672689526,1672692022,2496
7860,3633420270,3606812411,1672703152,1672703653,501
7836,3837094550,3420700674,1672593600,1672596312,2712
7655,3520888296,3459030804,1672575220,1672575637,417
7655,3389115045,3711504540,1672676128,1672679268,3140
7603,3485823740,3902278226,1672690729,1672692141,1412
7716,3858918246,3359910781,1672548768,1672552356,3588
7601,3776066388,3516629436,1672569983,1672572978,2995
7881,3617734118,3777983879,1672702981,1672704811,1830
7877,3713894336,3510937904,1672673981,1672676461,2480
7726,3979339287,3976390453,1672571558,1672573973,2415
7860,3837094550,3914290246,1672563987,1672564049,62
7545,3770078063,3608868877,1672533682,1672534687,1005
7616,3777079686,3792902982,1672626361,1672627716,1355
7600,3973560347,3520376528,1672573957,1672576961,3004
7969,3755798867,3901877072,1672630808,1672632082,1274
7503,3533653428,3497901842,1672645586,1672646233,647
7959,3777477395,3439023335,1672545527,1672547904,2377
7531,3783705817,3701065786,1672607156,1672610536,3380
7552,3380035798,3481502100,1672551394,1672554794,3400
7796,3618873142,3519428855,1672554869,1672558430,3561
7584,3415443558,3505599848,1672680329,1672681841,1512
7702,3520751702,3500729955,1672651202,1672653354,2152
7824,3772884106,3415546117,1672565063,1672566897,1834
7770,3829232696,3791901535,1672643512,1672643645,133
7716,3518876135,3910454786,1672690722,1672692250,1528
7954,3772544062,3533369198,1672635682,1672636781,1099
7692,3201848640,3500729955,1672562296,1672562519,223
7529,3710344260,3481647420,1672606722,1672609952,3230
7785,3520183192,3510594211,1672694851,1672695698,847
7889,3224058172,3634786711,1672632572,1672634336,1764
7552,3714197325,3925620998,1672630012,1672630746,734
7694,3711380716,3859663348,1672659535,1672660186,651
7808,3519803045,3352603894,1672692810,1672694874,2064
7588,3367029997,3404058699,1672701989,1672704125,2136
7652,3755798867,3516606733,1672564415,1672565549,1134
7941,3227158514,3518932404,1672584742,1672585145,403
7554,3346795719,3510247121,1672597456,1672598777,1321
7845,3478194807,3201848640,1672697166,1672697938,772
7501,3387674757,3510969660,1672564187,1672566041,1854
7956,3756451663,3711569060,1672701781,1672702730,949
7795,3731106822,3520756859,1672532200,1672533309,1109
7911,3302626661,3511332835,1672652280,1672655589,3309
7702,3666506258,3513599775,1672559614,1672562909,3295
7576,3755042098,3711569060,1672536814,1672539486,2672
7752,3513454145,3701984666,1672564376,1672566348,1972
7831,3610348516,3777717988,1672702657,1672704723,2066
7612,3780639480,3385763781,1672644457,1672644915,458
7710,3200198928,3513956646,1672586093,1672586255,162
7700,3515691540,3716168623,1672580750,1672581977,1227
7957,3533810360,3770851318,1672576271,1672577276,1005
7895,3791553060,3780294829,1672556456,1672558763,2307
7876,3757161914,3734737881,1672536434,1672538033,1599
7811,3424922204,3774556560,1672535246,1672536646,1400
7847,3839849341,3200691026,1672586377,1672586806,429
7826,3229665776,3519556068,1672569393,1672570402,1009
7501,3773814927,3500803339,1672612068,1672614983,2915
7975,3793627961,3778305740,1672678823,1672679080,257
7545,3518791447,3316222192,1672696410,1672698640,2230
7751,3518260334,3514245078,1672546544,1672546736,192
7865,3888559320,3318166135,1672568667,1672571550,2883
7512,3234541252,3776338577,1672694876,1672695195,319
7521,3701184889,3500805881,1672632954,1672633838,884
7969,3613995936,3509773875,1672593447,1672594677,1230
7523,3716258994,3520206212,1672678070,1672679797,1727
7585,3915628728,3714821932,1672695232,1672698741,3509
7821,3608868877,3509630174,1672617764,1672619384,1620
7579,3235635976,3618045231,1672574421,1672577933,3512
7768,3520183192,3421836608,1672624955,1672625035,80
7623,3976390453,3411618230,1672678833,1672680082,1249
7675,3228165483,3604539807,1672643799,1672645582,1783
7663,3755881905,3510244400,1672568200,1672571710,3510
7791,3490191091,3615046771,1672693252,1672694623,1371
7679,3899371911,3316222192,1672654845,1672656112,1267
7854,3500066230,3512683609,1672658028,1672659511,1483
7861,3777983879,3533827120,1672555242,1672557524,2282
7946,3713644518,3276640712,1672571369,1672574685,3316
7976,3629935998,3760598102,1672531758,1672532840,1082
7853,3518260334,3610695419,1672662296,1672662591,295
7553,3533369198,3516716179,1672557346,1672559598,2252
7781,3834257412,3510244400,1672638387,1672640995,2608
7951,3288764520,3396285984,1672604840,1672606051,1211
7979,3780828689,3770021824,1672686030,1672687129,1099
7880,3279721246,3857349323,1672658286,1672658728,442
7550,3202120784,3777717988,1672595729,1672598254,2525
7719,3835382117,3701898991,1672680650,1672683937,3287
7713,3901877072,3421127249,1672546144,1672546481,337
7623,3505904952,3534492426,1672542502,1672545904,3402
7902,3221536550,3629935998,1672656230,1672658590,2360
7701,3271938399,3311154569,1672608840,1672611232,2392
7970,3774204963,3510711755,1672638367,1672641713,3346
7581,3792668962,3792789881,1672589562,1672591455,1893
7906,3555214688,3481647420,1672702301,1672704756,2455
7735,3519556068,3925402713,1672644818,1672647830,3012
7738,3711308224,3358871377,1672696301,1672698537,2236
7812,3202120784,3777079686,1672577722,1672578567,845
7774,3770824086,3533369198,1672607462,1672608766,1304
7880,3489962019,3505859863,1672653067,1672655234,2167
7930,3516980378,3313541986,1672685562,1672688751,3189
7593,3380035798,3925402713,1672605158,1672607243,2085
7603,3520719611,3505173328,1672596330,1672597325,995
7670,3346327502,3391915121,1672675346,1672676792,1446
7964,3855602893,3915628728,1672611215,1672613378,2163
7810,3394539273,3710408395,1672655286,1672658656,3370
7718,3417587765,3534488837,1672652572,1672655939,3367
7771,3483949762,3501601840,1672702662,1672705115,2453
7748,3921211276,3634340855,1672584558,1672586963,2405
7736,3483164654,3505702787,1672587296,1672588151,855
7532,3734737881,3346795719,1672565716,1672567184,1468
7741,3519152550,3606186086,1672536832,1672537651,819
7701,3715492942,3379589402,1672573516,1672575021,1505
7597,3550946908,3500904641,1672650020,1672651720,1700
7949,3855937514,3496269445,1672638798,1672642388,3590
7863,3511359172,3716900301,1672588929,1672589498,569
7841,3510703546,3778980116,1672636881,1672638703,1822
7794,3773978034,3774066725,1672548814,1672551189,2375
7956,3466911760,3533385867,1672582009,1672582077,68
7842,3534553510,3349613093,1672579116,1672580295,1179
7614,3773205565,3760561634,1672683548,1672684547,999
7622,3505219850,3489217083,1672561471,1672563885,2414
7850,3279721246,3294803686,1672636374,1672637446,1072
7711,3903962771,3477375368,1672686305,1672687662,1357
7527,3500803339,3731106822,1672681635,1672682955,1320
7537,3809059934,3512837326,1672673653,1672675527,1874
7922,3401627165,3360993964,1672578227,1672581321,3094
7578,3778308417,3822654369,1672631414,1672632793,1379
7864,3514719601,3520730271,1672613266,1672616556,3290
7758,3703735129,3828624701,1672615675,1672616340,665
7798,3779976989,3313541986,1672680261,1672681823,1562
7531,3519703355,3791602225,1672655901,1672659419,3518
7874,3511435497,3773978034,1672669923,1672671114,1191
7654,3344364444,3793286136,1672619761,1672622132,2371
7647,3500894271,3813052709,1672666057,1672666749,692
7952,3668005723,3336742544,1672643560,1672646396,2836
7710,3774125065,3828624701,1672598150,1672599526,1376
7530,3920801189,3736229191,1672620924,1672621948,1024
7512,3412980697,3291227780,1672581815,1672583412,1597
7709,3489728806,3916289176,1672684720,1672685230,510
7744,3793470489,3346795719,1672629860,1672631382,1522
7832,3832902928,3629547065,1672703997,1672707130,3133
7683,3496269445,3510247121,1672676051,1672677919,1868
7937,3235287260,3407673904,1672681915,1672684672,2757
7805,3501730685,3816454165,1672570913,1672571996,1083
7916,3901990690,3511170269,1672629471,1672632196,2725
7518,3852595551,3918247820,1672600145,1672602635,2490
7789,3500994774,3613683164,1672549051,1672551048,1997
7621,3517459919,3909606423,1672671303,1672673914,2611
7932,3517864478,3365278081,1672690008,1672691785,1777
7741,3534492426,3311439795,1672661725,1672661977,252
7975,3201324715,3773755137,1672573665,1672573785,120
7784,3780974443,3505292701,1672595254,1672597922,2668
7523,3713630656,3805342762,1672637247,1672639396,2149
7614,3826760240,3362000049,1672593141,1672596450,3309
7848,3467773920,3296471982,1672593332,1672593875,543
7690,3903307060,3378092448,1672623404,1672626060,2656
7816,3701111745,3505702787,1672619471,1672620936,1465
7556,3859663348,3311439795,1672562536,1672563322,786
7827,3716197887,3390068992,1672615872,1672618281,2409
7590,3688418210,3417587765,1672535166,1672535708,542
7569,3318697153,3511312803,1672703703,1672705887,2184
7925,3715981584,3520888296,1672533739,1672536568,2829
7522,3519152550,3397418363,1672575722,1672575976,254
7855,3812176780,3367902229,1672680208,1672682033,1825
7621,3501759100,3976633198,1672583726,1672584981,1255
7496,3206254161,3777443199,1672694838,1672697804,2966
7799,3512720680,3512837326,1672538309,1672539708,1399
7689,3405494240,3294803686,1672592439,1672593920,1481
7619,3411618230,3509672210,1672653188,1672654127,939
7828,3555214688,3914290246,1672669004,1672669073,69
7943,3773205565,3476232529,1672679469,1672680931,1462
7976,3409474775,3505135325,1672641088,1672644425,3337
7618,3701863557,3791020967,1672620978,1672622363,1385
7799,3791657947,3737079798,1672553673,1672556268,2595
7651,3915628728,3714962248,1672655774,1672657400,1626
7960,3805519285,3298433163,1672682797,1672684438,1641
7717,3770763956,3459030804,1672576688,1672578816,2128
7835,3388637594,3783429780,1672700981,1672702263,1282
7526,3505962865,3517077106,1672660330,1672663591,3261
7924,3930797455,3937224533,1672650361,1672650752,391
7536,3293695955,3935127663,1672543993,1672544670,677
7519,3737154119,3385763781,1672652624,1672654917,2293
7515,3487171044,3735733948,1672612347,1672615835,3488
7875,3399911573,3760598102,1672652797,1672655597,2800
7620,3235635976,3512683609,1672694607,1672695045,438
7626,3533653428,3314836094,1672580847,1672582149,1302
7880,3316173088,3360506772,1672649546,1672652825,3279
7906,3774204963,3780609808,1672629954,1672631155,1201
7520,3823600322,3778308417,1672590798,1672592068,1270
7649,3505859863,3738274418,1672532180,1672535697,3517
7969,3895562476,3777790718,1672621944,1672624790,2846
7917,3511862351,3715581279,1672587743,1672590437,2694
7723,3399911573,3514283243,1672549951,1672551261,1310
7817,3496269445,3392121505,1672604086,1672607047,2961
7898,3446948848,3614238812,1672700050,1672700987,937
7788,3505173328,3833889105,1672646983,1672649826,2843
7965,3362000049,3777936328,1672563150,1672564654,1504
7543,3509630174,3732481297,1672654204,1672656754,2550
7828,3459030804,3792768129,1672538113,1672539110,997
7857,3711504540,3533653428,1672672025,1672673244,1219
7615,3792844210,3386707783,1672656817,1672658848,2031
7795,3617734118,3534010629,1672534741,1672535995,1254
7617,3383661227,3882997884,1672599656,1672602118,2462
7569,3519556068,3505638204,1672587849,1672588635,786
7586,3289061738,3518408774,1672599837,1672602038,2201
7856,3209027249,3505347134,1672578603,1672581104,2501
7830,3520719611,3703955926,1672607752,1672607986,234
7865,3711262377,3505201246,1672679584,1672680735,1151
7597,3736786443,3514838220,1672558564,1672560735,2171
7757,3701863557,3311274543,1672675894,1672676708,814
7756,3533193862,3783083229,1672676578,1672679006,2428
7651,3512567240,3500177712,1672535086,1672536684,1598
7782,3713786889,3313541986,1672635175,1672638254,3079
7673,3716900301,3922275620,1672587485,1672590587,3102
7590,3505635228,3515691540,1672539030,1672542133,3103
7898,3519703355,3520629279,1672657926,1672659257,1331
7820,3889750851,3505145247,1672654598,1672655291,693
7559,3902278226,3484995752,1672573833,1672577339,3506
7552,3778341199,3852595551,1672612137,1672615646,3509
7640,3774339795,3930791338,1672548094,1672549661,1567
7601,3701274634,3412825109,1672596841,1672599178,2337
7853,3533827120,3774204963,1672543787,1672544575,788
7643,3244389794,3278365525,1672581431,1672584667,3236
7561,3703871468,3805519285,1672544707,1672545848,1141
7923,3829764737,3336751428,1672682120,1672682731,611
7705,3800886801,3827377568,1672628499,1672630173,1674
7673,3903307060,3559110998,1672689880,1672693020,3140
7485,3509352754,3783429780,1672698834,1672700981,2147
7867,3370752401,3512217942,1672665479,1672668152,2673
7569,3836573197,3682061100,1672614520,1672617966,3446
7655,3733891182,3714821932,1672578725,1672581805,3080
7564,3485375593,3314836094,1672534258,1672534329,71
7814,3715998609,3396285984,1672640082,1672643290,3208
7749,3715189301,3501927421,1672584690,1672584814,124
7510,3388637594,3770078063,1672582488,1672585570,3082
7709,3244389794,3384951177,1672542156,1672544873,2717
7786,3637008488,3333896808,1672553124,1672555492,2368
7695,3291227780,3516016437,1672576901,1672577002,101
7509,3779976989,3510247121,1672644444,1672645056,612
7913,3793436995,3711569060,1672703475,1672704503,1028
7944,3829764737,3855602893,1672544433,1672546364,1931
7592,3827377568,3500391167,1672574960,1672578279,3319
7621,3311439795,3505869747,1672657638,1672660916,3278
7837,3370752401,3882242815,1672577289,1672578171,882
7528,3710344260,3711262377,1672553385,1672554116,731
7836,3791020967,3910454786,1672680161,1672682844,2683
7543,3512217942,3617055293,1672636947,1672639640,2693
7807,3804870229,3889232789,1672674202,1672676717,2515
7969,3399535232,3791957752,1672537467,1672540519,3052
7961,3800886801,3913251733,1672638065,1672639865,1800
7534,3710344260,3716746253,1672540328,1672540852,524
7668,3501730685,3312829208,1672679102,1672681646,2544
7533,3314245084,3930797455,1672658782,1672661818,3036
7976,3800353779,3899204805,1672669454,1672672197,2743
7742,3925620998,3685187183,1672647616,1672649631,2015
7488,3511359172,3533927138,1672537731,1672539260,1529
7572,3760509236,3815508790,1672670816,1672672173,1357
7532,3774066725,3311439795,1672547246,1672549997,2751
7954,3939952128,3520183192,1672569549,1672571711,2162
7957,3926700506,3738274418,1672643393,1672646484,3091
7781,3493507965,3779036831,1672676193,1672679664,3471
7765,3777477395,3711198793,1672678540,1672681233,2693
7652,3735733948,3519563836,1672589165,1672592674,3509
7824,3792668962,3397418363,1672687482,1672689971,2489
7725,3773950140,3757602960,1672631465,1672632693,1228
7565,3774045700,3509634629,1672676519,1672677660,1141
7641,3493507965,3778305740,1672642437,1672642976,539
7882,3399004969,3228165483,1672550027,1672551334,1307
7582,3517476351,3496051529,1672671509,1672674356,2847
7803,3899204805,3556951786,1672646751,1672647109,358
7781,3291227780,3922337974,1672536801,1672537816,1015
7836,3235287260,3448855696,1672619282,1672622115,2833
7514,3276640712,3791115967,1672697242,1672697849,607
7591,3792668962,3291883916,1672622606,1672626017,3411
7853,3467773920,3200691026,1672642683,1672646119,3436
7790,3783779671,3613683164,1672566047,1672568137,2090
7709,3374559242,3882242815,1672624419,1672627249,2830
7602,3514245078,3792668962,1672671709,1672671987,278
7628,3618045231,3337544549,1672666404,1672669273,2869
7757,3793848402,3518669703,1672656258,1672658296,2038
7516,3311152102,3518014404,1672634534,1672635743,1209
7804,3918674986,3485823740,1672672710,1672675319,2609
7527,3715998609,3826633236,1672536998,1672540116,3118
7665,3518669703,3312333615,1672662060,1672664776,2716
7814,3780914982,3318166135,1672550467,1672552242,1775
7840,3805342762,3660493209,1672638450,1672640908,2458
7952,3514987389,3703955926,1672606566,1672608339,1773
7811,3247428249,3304056063,1672606247,1672607407,1160
7871,3777717988,3756453423,1672607373,1672607990,617
7508,3227158514,3500374658,1672545489,1672547245,1756
7976,3737051610,3837094550,1672632614,1672633511,897
7823,3533653428,3248507722,1672565407,1672568562,3155
7919,3622054816,3519912874,1672643584,1672645205,1621
7584,3505173328,3793959750,1672649578,1672650628,1050
7909,3510244400,3895562476,1672545284,1672545856,572
7483,3519703355,3822654369,1672540949,1672543486,2537
7732,3307512479,3713894336,1672560917,1672562686,1769
7729,3516223597,3780294829,1672621028,1672623983,2955
7681,3311415018,3703441914,1672580334,1672583410,3076
7945,3520709480,3428006164,1672634855,1672637563,2708
7705,3791997875,3333896808,1672683734,1672686317,2583
7897,3912262917,3505859863,1672623247,1672623969,722
7829,3494290908,3451432842,1672587213,1672588745,1532
7739,3611150562,3516960534,1672696157,1672697039,882
7955,3738502357,3793627961,1672541511,1672544610,3099
7961,3412980697,3277605882,1672650373,1672653542,3169
7608,3443698222,3755392666,1672684519,1672687200,2681
7723,3200691026,3301107849,1672548639,1672549186,547
7696,3735319397,3500374658,1672608823,1672609662,839
7680,3913251733,3391261292,1672591773,1672594143,2370
7627,3501730685,3737154119,1672648970,1672651968,2998
7908,3509773875,3516465662,1672569933,1672572350,2417
7829,3285400528,3505869747,1672682764,1672684884,2120
7844,3832902928,3439023335,1672596526,1672596605,79
7497,3516673015,3713268590,1672681349,1672682522,1173
7704,3534010629,3716488385,1672701671,1672703748,2077
7566,3418728074,3755042098,1672640370,1672643817,3447
7791,3516980378,3682061100,1672647774,1672649435,1661
7888,3792768129,3432689543,1672642278,1672644782,2504
7572,3881477378,3280964728,1672544234,1672547122,2888
7598,3791942683,3311090974,1672536153,1672538693,2540
7947,3783126683,3229058858,1672670603,1672673427,2824
7840,3629935998,3791657947,1672542381,1672545352,2971
7828,3881477378,3280615985,1672547492,1672549578,2086
7856,3280599164,3501184421,1672623509,1672625991,2482
7887,3813052709,3701863557,1672532717,1672535902,3185
7671,3774366875,3505649239,1672702007,1672704787,2780
7628,3209383861,3338703270,1672652429,1672653744,1315
7538,3500177712,3520709480,1672588316,1672591694,3378
7633,3276993580,3533095755,1672548047,1672549265,1218
7594,3791942683,3755798867,1672702732,1672705961,3229
7755,3921211276,3737051610,1672545689,1672546523,834
7727,3773950140,3757447189,1672617755,1672618447,692
7938,3777929708,3774580701,1672616199,1672619316,3117
7571,3394330287,3477649378,1672553794,1672555426,1632
7869,3911159965,3534492426,1672642549,1672644579,2030
7787,3520706195,3511841857,1672699576,1672701907,2331
7864,3703955926,3501364586,1672601334,1672604360,3026
7693,3511332835,3793848402,1672567849,1672569155,1306
7911,3760492950,3737079798,1672631071,1672632443,1372
7510,3520629279,3713268590,1672573109,1672573378,269
7895,3534010629,3482405588,1672670809,1672674367,3558
7636,3228165483,3756930948,1672676290,1672679689,3399
7688,3773205565,3500365158,1672539607,1672542809,3202
7975,3757602960,3389115045,1672544476,1672546118,1642
7811,3311648200,3760492950,1672575234,1672576447,1213
7546,3911245524,3284639858,1672606252,1672607293,1041
7767,3970117174,3497901842,1672602434,1672605348,2914
7562,3505201246,3287105466,1672686978,1672688814,1836
7536,3517509185,3384240055,1672674533,1672675032,499
7758,3792844210,3774045700,1672552799,1672553086,287
7592,3395152943,3736419952,1672641559,1672642530,971
7696,3515394721,3921211276,1672584141,1672586819,2678
7707,3710112546,3793959750,1672666304,1672668884,2580
7627,3427283336,3367902229,1672687747,1672688029,282
7924,3774520233,3792253549,1672685330,1672685626,296
7547,3715998609,3662180254,1672536779,1672540043,3264
7660,3494290908,3666507626,1672674973,1672676157,1184
7736,3223968713,3517459919,1672586013,1672588415,2402
7681,3859663348,3634786711,1672625824,1672628539,2715
7693,3666507626,3738502357,1672670129,1672672936,2807
7499,3683766533,3666506258,1672582681,1672586242,3561
7776,3443698222,3391261292,1672665125,1672666063,938
7585,3791942683,3430074045,1672620918,1672623655,2737
7941,3505193212,3757455053,1672536396,1672539707,3311
7836,3501692334,3519700826,1672644516,1672647691,3175
7625,3613995936,3703735129,1672557054,1672557494,440
7969,3516960534,3716843669,1672545012,1672548259,3247
7564,3668898102,3664517356,1672625185,1672628769,3584
7573,3731419510,3519563836,1672586908,1672589370,2462
7636,3297463265,3500060260,1672637382,1672640614,3232
7690,3736229191,3404384505,1672691434,1672692115,681
7730,3772544062,3518360734,1672699095,1672702380,3285
7556,3235287260,3826633236,1672649676,1672651361,1685
7903,3629935998,3483164654,1672642357,1672645285,2928
7648,3666506258,3755392666,1672650700,1672652527,1827
7762,3287105466,3307097200,1672606664,1672607984,1320
7675,3756966035,3770553384,1672694595,1672696390,1795
7950,3314245084,3235635976,1672613347,1672615841,2494
7801,3711504540,3489962019,1672676208,1672677162,954
7874,3390068992,3898995675,1672568465,1672570040,1575
7954,3385763781,3918247820,1672541546,1672544900,3354
7743,3501483568,3714474557,1672572862,1672574575,1713
7808,3829232696,3826760240,1672655537,1672657101,1564
7949,3634786711,3792789881,1672659383,1672661764,2381
7744,3509630174,3822654369,1672672272,1672672504,232
7565,3778341199,3918674986,1672672802,1672674519,1717
7756,3783705817,3417970574,1672644629,1672646364,1735
7510,3505000737,3515860749,1672682361,1672684283,1922
7767,3519428855,3500729955,1672562394,1672563656,1262
7558,3777443199,3667680268,1672558569,1672560948,2379
7699,3773120434,3312829208,1672572038,1672572926,888
7933,3976390453,3480687894,1672670325,1672672095,1770
7967,3500805881,3903009525,1672661745,1672662741,996
7981,3733189298,3714488548,1672591033,1672592521,1488
7974,3513080274,3826760240,1672570456,1672572493,2037
7768,3273500349,3629935998,1672646115,1672646885,770
7653,3792177074,3206603608,1672549951,1672550412,461
7802,3770635361,3774045700,1672630021,1672632024,2003
7628,3351008918,3202120784,1672695053,1672697426,2373
7544,3505702787,3829319703,1672580815,1672582758,1943
7576,3473562469,3512166013,1672595484,1672597792,2308
7843,3512969370,3859525941,1672683520,1672685994,2474
7647,3417061462,3374559242,1672695214,1672695464,250
7668,3222521619,3882997884,1672599326,1672601434,2108
7631,3501184421,3443698222,1672588559,1672589942,1383
7723,3772758337,3711308224,1672686327,1672688588,2261
7666,3512837326,3201432789,1672591301,1672591952,651
7666,3757812939,3791594391,1672532212,1672533452,1240
7948,3399433690,3407725581,1672539403,1672542607,3204
7624,3621810464,3757812939,1672597777,1672599717,1940
7534,3359910781,3711198793,1672579400,1672580190,790
7720,3534553510,3633420270,1672677573,1672680432,2859
7653,3774005526,3931941795,1672607011,1672609705,2694
7530,3276640712,3835382117,1672615117,1672615593,476
7957,3500578848,3433804879,1672615768,1672616635,867
7982,3756966035,3622054816,1672574639,1672577445,2806
7711,3731106822,3534553510,1672626596,1672628107,1511
7944,3428674539,3399535232,1672608514,1672609787,1273
7781,3608868877,3608633356,1672584826,1672585924,1098
7488,3475258557,3467773920,1672688747,1672691434,2687
7889,3316173088,3774580701,1672672757,1672675114,2357
7936,3826759140,3904775198,1672680194,1672681556,1362
7939,3500374658,3352603894,1672560095,1672561286,1191
7753,3496549058,3891751546,1672695345,1672696786,1441
7896,3391261292,3774580701,1672621567,1672624544,2977
7756,3367902229,3559110998,1672607821,1672608717,896
7727,3914259449,3621810464,1672537058,1672540471,3413
7896,3505702787,3777120536,1672571874,1672575014,3140
7659,3249401741,3604539807,1672532267,1672532350,83
7887,3811171116,3501198706,1672680406,1672681630,1224
7858,3889750851,3476232529,1672694345,1672696204,1859
7676,3345207877,3774366875,1672614854,1672616285,1431
7551,3885670556,3793436995,1672594786,1672595212,426
7621,3976390453,3774466457,1672642546,1672642808,262
7533,3909606423,3201432789,1672594995,1672596797,1802
7804,3757682496,3519152550,1672637116,1672639693,2577
7982,3229058858,3401627165,1672599339,1672599983,644
7691,3399004969,3755436115,1672686966,1672687812,846
7768,3337544549,3978105277,1672541382,1672543569,2187
7879,3377766165,3780914982,1672610619,1672612311,1692
7805,3774520233,3505477652,1672623286,1672624277,991
7946,3235287260,3315583351,1672602782,1672603593,811
7977,3809916577,3756424865,1672645948,1672647890,1942
7884,3812176780,3224716315,1672668575,1672669138,563
7955,3839849341,3607748895,1672582305,1672582657,352
7506,3517459919,3516465662,1672656517,1672659041,2524
7789,3556951786,3556951786,1672688140,1672689383,1243
7653,3711973519,3770824086,1672544049,1672545790,1741
7486,3701065786,3360506772,1672589685,1672591202,1517
7596,3757682496,3614238812,1672629767,1672632265,2498
7657,3500729955,3770851318,1672594138,1672595534,1396
7942,3516465662,3338703270,1672698906,1672700891,1985
7734,3356860407,3682061100,1672537553,1672540932,3379
7829,3510969660,3501601840,1672651877,1672654277,2400
7583,3815508790,3316222192,1672584789,1672587437,2648
7938,3405494240,3909331423,1672637919,1672639531,1612
7757,3772714862,3472130842,1672675472,1672675904,432
7889,3311718847,3390068992,1672688344,1672691829,3485
7890,3510126867,3505962865,1672671506,1672673831,2325
7639,3515125508,3421836608,1672583079,1672583186,107
7976,3809916577,3360506772,1672696384,1672697506,1122
7633,3231056870,3755625324,1672695997,1672698144,2147
7918,3511687358,3247815299,1672548027,1672548884,857
7732,3221536550,3811694763,1672552172,1672553888,1716
7752,3391915121,3388372715,1672552435,1672554047,1612
7817,3889750851,3918056059,1672638556,1672640402,1846
7587,3315583351,3510711755,1672652893,1672653018,125
7836,3500177712,3755436115,1672645191,1672647532,2341
7708,3516039895,3855602893,1672629306,1672631489,2183
7929,3922337974,3505530961,1672687757,1672690736,2979
7743,3711262377,3626156564,1672588040,1672588430,390
7831,3713894336,3780974443,1672652196,1672655685,3489
7892,3915628728,3738274418,1672617588,1672620341,2753
7894,3316222192,3332072298,1672675885,1672678362,2477
7957,3926700506,3246596716,1672682531,1672682653,122
7489,3628819436,3756027749,1672680292,1672682859,2567
7892,3791594391,3500658339,1672569864,1672572632,2768
7918,3701995648,3628819436,1672660548,1672661481,933
7498,3352603894,3360993964,1672671184,1672673987,2803
7502,3755739653,3501692334,1672590554,1672593089,2535
7732,3889750851,3703661585,1672578141,1672579470,1329
7899,3914290246,3533927138,1672600223,1672603569,3346
7524,3601879040,3515151980,1672626236,1672626524,288
7580,3776513891,3430074045,1672578458,1672581343,2885
7842,3519703355,3756966035,1672576983,1672579402,2419
7933,3634995491,3505000737,1672600735,1672602643,1908
7741,3372883226,3312333615,1672639380,1672641349,1969
7894,3466911760,3825229501,1672614225,1672614801,576
7622,3513164386,3770851318,1672567545,1672570536,2991
7980,3511163800,3516016437,1672548864,1672549629,765
7544,3511332835,3386707783,1672564543,1672564739,196
7639,3533270638,3778780511,1672689419,1672692417,2998
7975,3370636709,3880285638,1672601043,1672603166,2123
7982,3881477378,3516011407,1672595446,1672596817,1371
7623,3818255890,3519563836,1672594310,1672597739,3429
7741,3772758337,3883042241,1672603388,1672603507,119
7548,3512567240,3627937312,1672567458,1672570329,2871
7603,3519700826,3608868877,1672561597,1672564709,3112
7852,3792902982,3399052055,1672540423,1672542308,1885
7549,3881477378,3399052055,1672690043,1672692787,2744
7562,3793338102,3627937312,1672561270,1672562818,1548
7782,3319752091,3492478793,1672681161,1672683973,2812
7808,3979339287,3829319703,1672694583,1672698060,3477
7936,3362000049,3910454786,1672588458,1672591582,3124
7569,3365278081,3432665384,1672552926,1672553891,965
7710,3756930948,3500066230,1672607869,1672610467,2598
7943,3533369198,3550946908,1672652608,1672653948,1340
7544,3701184889,3511312803,1672604114,1672606740,2626
7896,3511170269,3755392666,1672602279,1672602522,243
7510,3518014636,3517864478,1672628485,1672630576,2091
7684,3793086311,3500060260,1672624582,1672628102,3520
7904,3852595551,3520190170,1672591890,1672594624,2734
7845,3492478793,3417587765,1672539562,1672542582,3020
7624,3920801189,3610348516,1672599494,1672600366,872
7504,3533653428,3489545239,1672640673,1672642058,1385
7812,3311274543,3701190899,1672683852,1672686112,2260
7960,3624312512,3760183458,1672576520,1672578570,2050
7926,3882291183,3500060260,1672701748,1672702944,1196
7793,3510594211,3701190899,1672555927,1672559433,3506
7887,3367029997,3613995936,1672627408,1672629953,2545
7588,3517963492,3512540951,1672626849,1672629319,2470
7659,3319752091,3416427576,1672625456,1672626567,1111
7924,3660493209,3791942683,1672599392,1672601934,2542
7900,3311871871,3500803339,1672564309,1672565914,1605
7511,3922337974,3627937312,1672702469,1672704114,1645
7780,3779528381,3737051610,1672702628,1672703414,786
7747,3757161914,3465254146,1672630637,1672632861,2224
7854,3772544062,3509453566,1672560479,1672563279,2800
7817,3774195321,3882291183,1672587902,1672588032,130
7905,3918056059,3816454165,1672627764,1672630780,3016
7498,3899371911,3716746253,1672533049,1672533863,814
7543,3783925755,3710112546,1672593092,1672595335,2243
7641,3221899927,3232962003,1672687918,1672689715,1797
7771,3859525941,3639847263,1672592157,1672595159,3002
7635,3910886626,3600647945,1672671292,1672673945,2653
7681,3475795792,3298433163,1672659712,1672661467,1755
7890,3772714862,3201324715,1672676103,1672678232,2129
7925,3736592744,3509352754,1672549808,1672550654,846
7847,3534010629,3715127362,1672562519,1672563382,863
7775,3500729955,3286658957,1672701398,1672702855,1457
7672,3703718151,3777079686,1672580616,1672581249,633
7960,3417061462,3756930948,1672677771,1672680949,3178
7791,3701984666,3939952128,1672560907,1672564198,3291
7500,3510594211,3792177074,1672577116,1672579847,2731
7671,3337544549,3760598102,1672627135,1672630084,2949
7859,3710112546,3772337814,1672690965,1672691033,68
7975,3606186086,3429856982,1672589218,1672589497,279
7826,3755881905,3770851318,1672549235,1672552159,2924
7887,3777079686,3800353779,1672695296,1672695689,393
7824,3505649239,3711571712,1672567392,1672570060,2668
7594,3509773875,3407673904,1672693298,1672695243,1945
7824,3247780536,3734828619,1672593653,1672595425,1772
7623,3500177712,3516514391,1672606393,1672607785,1392
7837,3774501422,3756966035,1672584590,1672586085,1495
7515,3478194807,3755872268,1672687242,1672687995,753
7483,3467773920,3365614305,1672548171,1672548836,665
7814,3296471982,3519069599,1672626080,1672627735,1655
7902,3791334389,3232962003,1672673019,1672674416,1397
7884,3516909237,3372883226,1672547276,1672550228,2952
7623,3852595551,3755881905,1672593107,1672596506,3399
7956,3386707783,3303705369,1672648785,1672650235,1450
7859,3883312122,3829232696,1672550593,1672553404,2811
7645,3703889596,3417061462,1672603756,1672603911,155
7935,3512217942,3859663348,1672601578,1672604504,2926
7873,3633420270,3774338212,1672559001,1672560647,1646
7681,3533927138,3716258994,1672610982,1672611230,248
7524,3533137446,3338367113,1672689061,1672692084,3023
7644,3601879040,3774125065,1672541125,1672544218,3093
7952,3556951786,3520165601,1672647276,1672649607,2331
7811,3978115672,3733891182,1672615149,1672615954,805
7814,3501692334,3760267716,1672554357,1672557765,3408
7737,3904408902,3383922351,1672610388,1672613330,2942
7601,3889750851,3792902982,1672648694,1672649603,909
7767,3714197325,3793436995,1672641255,1672644640,3385
7529,3783239924,3515125508,1672685352,1672685724,372
7494,3379256399,3611150562,1672583851,1672585576,1725
7981,3505347134,3559110998,1672624441,1672625958,1517
7548,3770635361,3793338102,1672611545,1672612731,1186
7712,3778549126,3430074045,1672611585,1672612565,980
7687,3500066230,3777983879,1672660301,1672662234,1933
7585,3520719611,3935627557,1672681661,1672684385,2724
7855,3512683609,3385763781,1672580394,1672583957,3563
7643,3774127586,3201324715,1672601048,1672604483,3435
7951,3819727225,3822654369,1672696680,1672698831,2151
7860,3510380060,3823600322,1672642140,1672644824,2684
7509,3465254146,3311152102,1672592271,1672594023,1752
7684,3399535232,3683766533,1672566918,1672568853,1935
7913,3388637594,3711504540,1672672681,1672675792,3111
7905,3822654369,3514128943,1672569197,1672570925,1728
7924,3912536808,3342131135,1672547289,1672547772,483
7556,3916289176,3715998609,1672642826,1672645011,2185
7619,3899204805,3835382117,1672584058,1672584497,439
7665,3471220483,3716835696,1672618419,1672620374,1955
7546,3715974031,3533653428,1672536263,1672539703,3440
7645,3855000166,3359910781,1672666362,1672669867,3505
7894,3477375368,3756451663,1672574159,1672575656,1497
7611,3473562469,3615046771,1672698368,1672700920,2552
7734,3731419510,3402943525,1672580388,1672582755,2367
7873,3792789881,3808324264,1672685614,1672685868,254
7763,3520706195,3395152943,1672553647,1672554336,689
7489,3412825109,3378686918,1672627553,1672630407,2854
7512,3518163778,3774005526,1672690254,1672690764,510
7549,3890149705,3510380060,1672619517,1672619967,450
7496,3480687894,3432665384,1672651413,1672653001,1588
7514,3711198793,3513454145,1672552875,1672555394,2519
7926,3801089989,3637008488,1672555762,1672557915,2153
7716,3780974443,3793436995,1672584784,1672588139,3355
7762,3733891182,3667680268,1672534762,1672536868,2106
7831,3208844525,3485008994,1672640260,1672643458,3198
7514,3666553782,3792883665,1672569984,1672570297,313
7699,3514987389,3395152943,1672620629,1672621377,748
7647,3302626661,3852595551,1672654238,1672654348,110
7596,3271938399,3713349754,1672582859,1672586123,3264
7801,3793436995,3338367113,1672635128,1672637629,2501
7488,3899204805,3792902982,1672633982,1672636219,2237
7774,3701111745,3284639858,1672561148,1672563419,2271
7785,3509604974,3806545488,1672617581,1672621160,3579
7508,3533827120,3703013906,1672691587,1672691864,277
7983,3780914982,3520030713,1672678002,1672678501,499
7609,3510126867,3791594391,1672669467,1672671833,2366
7858,3711265369,3792883665,1672628033,1672629467,1434
7949,3509672210,3505145247,1672645968,1672648826,2858
7687,3514719601,3898995675,1672581338,1672581812,474
7837,3731106822,3505791599,1672532145,1672533880,1735
7750,3711262377,3779976989,1672667120,1672668311,1191
7789,3433804879,3774366875,1672691791,1672694333,2542
7966,3517721725,3331845324,1672633258,1672633527,269
7671,3208844525,3271938399,1672619603,1672622526,2923
7974,3293695955,3516258476,1672576621,1672577758,1137
7787,3621497531,3715339701,1672675964,1672676064,100
7852,3533371364,3783196518,1672626637,1672629886,3249
7740,3973560347,3342131135,1672544774,1672547789,3015
7672,3777936328,3922275620,1672581026,1672583374,2348
7880,3370752401,3475396323,1672606489,1672607702,1213
7843,3396285984,3716843669,1672538510,1672539782,1272
7707,3683766533,3607748895,1672615586,1672617803,2217
7599,3701190899,3399052055,1672633571,1672636114,2543
7695,3835382117,3811171116,1672616609,1672619143,2534
7519,3793470489,3512567240,1672577286,1672577664,378
7777,3533927138,3515723720,1672574917,1672576729,1812
7978,3384240055,3510173870,1672669955,1672672184,2229
7648,3416241005,3808324264,1672596272,1672598888,2616
7904,3793389510,3711262377,1672662142,1672664848,2706
7973,3359239884,3895562476,1672637370,1672639773,2403
7818,3520165601,3515125508,1672534270,1672534602,332
7605,3739106581,3511312803,1672542026,1672542812,786
7560,3774580701,3516716179,1672596856,1672599681,2825
7500,3519601612,3800353779,1672689648,1672689870,222
7892,3736786443,3511332835,1672556078,1672556770,692
7840,3533748232,3714962248,1672660074,1672661062,988
7764,3757151210,3715127362,1672664060,1672664773,713
7560,3427283336,3891751546,1672566288,1672566788,500
7584,3534702203,3710344260,1672698553,1672701280,2727
7676,3430504438,3806545488,1672702142,1672705154,3012
7685,3791957752,3511271692,1672540220,1672542343,2123
7899,3386707783,3812176780,1672639384,1672642415,3031
7712,3489962019,3770763956,1672657378,1672658293,915
7657,3500199935,3201848640,1672560377,1672560758,381
7532,3756453423,3501198706,1672664922,1672667140,2218
7906,3611150562,3421836608,1672579864,1672581177,1313
7707,3249247700,3855424474,1672547105,1672550156,3051
7951,3359239884,3737154119,1672550633,1672552039,1406
7718,3714474557,3898995675,1672550410,1672553799,3389
7719,3516258476,3426325549,1672538249,1672540771,2522
7837,3776338577,3311718847,1672635628,1672638516,2888
7961,3883312122,3738502357,1672687129,1672690054,2925
7904,3249791738,3421836608,1672596736,1672598810,2074
7589,3519700826,3791115967,1672693698,1672695566,1868
7608,3359239884,3391915886,1672696514,1672697666,1152
7661,3512349371,3819727225,1672691257,1672694014,2757
7528,3832902928,3902278226,1672628810,1672630125,1315
7775,3777455223,3291883916,1672639763,1672642624,2861
7749,3713349754,3783531004,1672675773,1672677794,2021
7649,3516011407,3420700674,1672567759,1672570276,2517
7597,3352603894,3716900301,1672673863,1672677104,3241
7579,3716197887,3930797455,1672617398,1672617517,119
7774,3760077057,3391915121,1672700308,1672702010,1702
7927,3772337814,3713808837,1672584028,1672586610,2582
7797,3770021824,3780503655,1672546523,1672549570,3047
7923,3533280269,3885670556,1672568526,1672571217,2691
7761,3793627961,3209027249,1672669932,1672670430,498
7528,3772578994,3701190899,1672544738,1672546148,1410
7697,3703013906,3500904641,1672582793,1672585404,2611
7663,3601879040,3514719601,1672560936,1672562661,1725
7792,3505599848,3757151210,1672692227,1672693007,780
7951,3634786711,3755872268,1672546850,1672548316,1466
7794,3793753089,3783925755,1672584078,1672585229,1151
7776,3778108318,3534702203,1672686469,1672687597,1128
7859,3500805881,3443698222,1672632437,1672632683,246
7610,3380035798,3918247820,1672566160,1672567994,1834
7738,3715339701,3770101921,1672680023,1672680546,523
7983,3778341199,3307097200,1672676685,1672677404,719
7530,3334033993,3511271692,1672665908,1672667017,1109
7535,3427283336,3496269445,1672559253,1672560776,1523
7876,3901990690,3510771358,1672648276,1672651750,3474
7975,3399535232,3713208927,1672673933,1672676578,2645
7545,3311274543,3513201436,1672627686,1672628730,1044
7494,3501483568,3755872268,1672630838,1672632141,1303
7515,3736786443,3881477378,1672692589,1672692870,281
7746,3234541252,3792288302,1672570844,1672572844,2000
7551,3736229191,3895562476,1672540589,1672540893,304
7565,3234541252,3807987001,1672642603,1672645796,3193
7583,3617734118,3534313900,1672599694,1672599806,112
7893,3701995648,3773598056,1672649610,1672650792,1182
7980,3505000737,3303705369,1672535671,1672538251,2580
7774,3332072298,3774298222,1672673809,1672674371,562
7686,3244389794,3509604974,1672672200,1672675080,2880
7554,3853018906,3505649239,1672623006,1672623368,362
7623,3391261292,3519912874,1672579823,1672581528,1705
7715,3859525941,3475396323,1672551699,1672553656,1957
7895,3249247700,3223968713,1672653811,1672655857,2046
7749,3311203656,3922337974,1672642744,1672643270,526
7538,3336742544,3505201246,1672540948,1672541870,922
7664,3817316561,3427219654,1672652638,1672655125,2487
7729,3757403279,3314836094,1672649126,1672649360,234
7656,3316173088,3973560347,1672649953,1672653445,3492
7897,3501606184,3342131135,1672591202,1672594155,2953
7862,3208844525,3883042241,1672580850,1672582634,1784
7936,3291235378,3271938399,1672594546,1672595848,1302
7571,3710569131,3918584946,1672610675,1672613979,3304
7644,3315583351,3311993075,1672618154,1672618475,321
7725,3520706195,3511267139,1672573867,1672576449,2582
7596,3783245561,3512142794,1672658450,1672661419,2969
7830,3404058699,3459030804,1672689317,1672690661,1344
7754,3451432842,3224716315,1672663379,1672665026,1647
7705,3515125508,3311324983,1672684149,1672684905,756
7690,3780639480,3511198618,1672560876,1672563495,2619
7916,3361230905,3505649239,1672685504,1672686610,1106
7938,3828432634,3857349323,1672547861,1672550013,2152
7684,3808324264,3899204805,1672609333,1672612815,3482
7876,3244485293,3518260334,1672675897,1672678673,2776
7786,3424922204,3416427576,1672692714,1672695222,2508
7658,3801089989,3402943525,1672568066,1672570983,2917
7790,3634995491,3633420270,1672619305,1672619716,411
7868,3518932404,3776513891,1672534535,1672536110,1575
7968,3773465237,3666553782,1672556056,1672558072,2016
7668,3501730685,3247780536,1672627711,1672629379,1668
7629,3404384505,3895562476,1672576987,1672579269,2282
7913,3510937904,3514245078,1672613506,1672614065,559
7577,3453729665,3501601840,1672606504,1672607476,972
7644,3485008994,3515860749,1672640154,1672643753,3599
7876,3238712269,3415443558,1672568974,1672571443,2469
7522,3978105277,3478194807,1672686551,1672686673,122
7864,3415443558,3793627961,1672625437,1672627524,2087
7877,3311871871,3760077057,1672632226,1672633168,942
7850,3533927138,3755436115,1672646603,1672649284,2681
7563,3757812939,3772578994,1672548598,1672550541,1943
7501,3793470489,3770447408,1672613128,1672615773,2645
7938,3311208440,3783779671,1672603627,1672605581,1954
7902,3379256399,3608633356,1672549786,1672553334,3548
7767,3792253549,3533280269,1672566964,1672567818,854
7852,3770101921,3284639858,1672614954,1672617399,2445
7938,3552314511,3458539365,1672558035,1672560681,2646
7572,3342131135,3604539807,1672686071,1672687617,1546
7489,3618873142,3289061738,1672648088,1672648859,771
7621,3223789409,3378092448,1672618419,1672618724,305
7716,3359239884,3509907947,1672621728,1672624010,2282
7654,3307512479,3855602893,1672697460,1672698470,1010
7896,3760183458,3701984666,1672602863,1672603801,938
7934,3731419510,3774338212,1672675271,1672677338,2067
7733,3780828689,3399433690,1672555690,1672557852,2162
7919,3346795719,3520730271,1672559323,1672560992,1669
7640,3858918246,3772884106,1672609728,1672612716,2988
7787,3311324983,3716537575,1672608211,1672608473,262
7486,3514987389,3972364603,1672553968,1672555694,1726
7495,3703735129,3777806071,1672564599,1672565856,1257
7831,3711504540,3505145247,1672680520,1672682341,1821
7619,3475251781,3391261292,1672571245,1672572922,1677
7544,3446948848,3467773920,1672570266,1672572462,2196
7778,3606812411,3514472925,1672550302,1672551677,1375
7626,3552314511,3367902229,1672532857,1672534434,1577
7787,3851190615,3882242815,1672617517,1672618437,920
7931,3417587765,3777623166,1672541655,1672544881,3226
7954,3518876135,3793753089,1672621789,1672621878,89
7646,3438645253,3427219654,1672672757,1672672831,74
7602,3432689543,3293695955,1672659346,1672662533,3187
7541,3931941795,3511841857,1672623215,1672624887,1672
7854,3755798867,3829764737,1672610823,1672610928,105
7606,3246596716,3898995675,1672661010,1672661690,680
7829,3711308224,3505904952,1672589669,1672591998,2329
7507,3713894336,3716843669,1672589738,1672591040,1302
7784,3369998498,3459030804,1672615349,1672616090,741
7733,3731419510,3731419510,1672702162,1672704512,2350
7718,3714474557,3604539807,1672587416,1672590018,2602
7523,3701274634,3466911760,1672610803,1672611126,323
7793,3517476351,3792473331,1672645225,1672647662,2437
7979,3475396323,3792384220,1672688809,1672691409,2600
7850,3780593036,3773598056,1672552493,1672554260,1767
7768,3755920131,3489545239,1672683798,1672686974,3176
7794,3791874383,3490191091,1672616421,1672618669,2248
7754,3805342762,3899371911,1672532798,1672534928,2130
7798,3519556068,3229665776,1672545650,1672547330,1680
7845,3224058172,3388637594,1672703483,1672703844,361
7548,3774339795,3783196518,1672612343,1672613950,1607
7748,3509672210,3235635976,1672605827,1672607603,1776
7617,3930791338,3512166013,1672663870,1672665463,1593
7976,3202120784,3280964728,1672646198,1672648205,2007
7900,3760561634,3315583351,1672666196,1672667714,1518
7496,3618045231,3505859863,1672665115,1672665630,515
7961,3291235378,3755739653,1672606428,1672608187,1759
7978,3387674757,3206603608,1672572430,1672573580,1150
7514,3279721246,3236102733,1672608241,1672610154,1913
7835,3770553384,3311152102,1672636840,1672638339,1499
7576,3939952128,3236102733,1672661238,1672661900,662
7571,3715127362,3755920131,1672652462,1672656026,3564
7568,3899204805,3613683164,1672534897,1672536278,1381
7490,3793627961,3500994774,1672637859,1672638740,881
7500,3519912874,3770553384,1672575349,1672575471,122
7758,3757246925,3793959750,1672639927,1672640138,211
7790,3500803339,3311090974,1672542992,1672546398,3406
7530,3774268456,3793848402,1672670190,1672671200,1010
7621,3279721246,3395152943,1672674708,1672676981,2273
7699,3247815299,3778266283,1672622524,1672625420,2896
7965,3780593036,3505791599,1672669114,1672671813,2699
7821,3800886801,3534313900,1672665633,1672667202,1569
7573,3760992710,3774580701,1672642300,1672643712,1412
7923,3757602960,3792473331,1672676067,1672676603,536
7664,3777776687,3616944364,1672577458,1672579574,2116
7496,3430504438,3716258994,1672610638,1672610957,319
7498,3755587522,3516039895,1672550760,1672551133,373
7915,3319752091,3505702787,1672642103,1672643136,1033
7808,3331845324,3229665776,1672687721,1672689299,1578
7808,3412825109,3284639858,1672567128,1672569680,2552
7962,3500578848,3534010629,1672658723,1672659053,330
7571,3501601840,3509634629,1672573218,1672576382,3164
7594,3273500349,3513454145,1672572177,1672574282,2105
7600,3520888296,3881477378,1672700952,1672704169,3217
7904,3683959482,3209048907,1672587333,1672590451,3118
7680,3509453566,3318166135,1672581708,1672582772,1064
7493,3783429780,3510173870,1672562729,1672565591,2862
7520,3778341199,3519152550,1672574527,1672576368,1841
7898,3883551721,3780639480,1672701563,1672703442,1879
7601,3817621391,3345207877,1672605039,1672607498,2459
7583,3836573197,3857349323,1672535511,1672537331,1820
7559,3510771358,3438645253,1672692161,1672692700,539
7713,3534010629,3404058699,1672678030,1672679750,1720
7779,3773814927,3734828619,1672556432,1672558762,2330
7688,3701065786,3792668962,1672535249,1672536559,1310
7485,3703789494,3533927138,1672595790,1672597747,1957
7741,3489217083,3606186086,1672531572,1672532279,707
7743,3757562897,3730517636,1672594651,1672597533,2882
7877,3976633198,3501692334,1672658955,1672661641,2686
7947,3683766533,3925620998,1672569787,1672570826,1039
7625,3418534998,3348261553,1672641201,1672643411,2210
7950,3556951786,3779976989,1672691419,1672694796,3377
7785,3505145247,3554917400,1672614300,1672616875,2575
7530,3777623166,3312829208,1672608897,1672610618,1721
7489,3604539807,3826633236,1672563062,1672564192,1130
7723,3519601612,3509634629,1672678728,1672680251,1523
7641,3500894271,3783239924,1672695597,1672698622,3025
7927,3303751772,3774268456,1672589457,1672591758,2301
7758,3276640712,3395152943,1672535029,1672535473,444
7803,3500499542,3360743849,1672567195,1672569940,2745
7561,3365614305,3512720680,1672568681,1672569852,1171
7613,3209048907,3516465662,1672652236,1672655634,3398
7899,3777717988,3836573197,1672582577,1672584226,1649
7766,3533280269,3533270638,1672658973,1672659466,493
7639,3511359172,3520030713,1672598279,1672601474,3195
7954,3756966035,3415546117,1672633419,1672633722,303
7856,3289061738,3736229191,1672631821,1672633575,1754
7499,3500199935,3812176780,1672621631,1672622729,1098
7710,3362000049,3516065852,1672585852,1672586587,735
7699,3443698222,3364543015,1672561916,1672564773,2857
7946,3516629436,3618045231,1672608779,1672610934,2155
7824,3880310724,3760267716,1672549575,1672549639,64
7771,3703735129,3935127663,1672608039,1672609049,1010
7629,3510937904,3826415738,1672634369,1672637282,2913
7799,3505883609,3513164386,1672582578,1672585853,3275
7786,3711569060,3780974443,1672541876,1672542988,1112
7856,3501759100,3783239924,1672649033,1672652042,3009
7716,3224058172,3311761694,1672599210,1672602154,2944
7716,3736229191,3367902229,1672628336,1672630075,1739
7980,3791334389,3685818092,1672662821,1672664724,1903
7582,3512217942,3373384732,1672683130,1672685680,2550
7573,3533748232,3823600322,1672611298,1672612123,825
7885,3314245084,3505859863,1672573295,1672575924,2629
7549,3488244966,3229058858,1672573492,1672575563,2071
7929,3465254146,3703441914,1672537363,1672538611,1248
7689,3779528381,3783509527,1672563930,1672566584,2654
7527,3772544062,3760893269,1672607629,1672610811,3182
7961,3715127362,3224716315,1672626416,1672629706,3290
7666,3511125626,3826760240,1672634340,1672635741,1401
7717,3792473331,3783239924,1672578567,1672581978,3411
7730,3883551721,3668898102,1672555317,1672557549,2232
7657,3780639480,3793470489,1672568905,1672572046,3141
7497,3533827120,3783126683,1672587052,1672588170,1118
7975,3783705817,3703735129,1672585894,1672588195,2301
7931,3926700506,3505292701,1672686483,1672687132,649
7910,3426325549,3500805881,1672556081,1672558562,2481
7820,3400918687,3394330287,1672605281,1672607442,2161
7630,3277669002,3500060260,1672620158,1672620984,826
7599,3501198706,3668005723,1672553020,1672555987,2967
7489,3478194807,3930791338,1672602306,1672604298,1992
7537,3514987389,3605726278,1672582400,1672582603,203
7584,3756601594,3910886626,1672616278,1672618193,1915
7640,3703223015,3505869747,1672581696,1672583139,1443
7886,3783925755,3711308224,1672603460,1672603636,176
7840,3515723720,3400804807,1672663209,1672663498,289
7639,3736790081,3932051427,1672583547,1672587119,3572
7781,3360743849,3792902982,1672685546,1672688753,3207
7883,3833889105,3501483568,1672645036,1672645239,203
7726,3430352815,3713894336,1672594360,1672595958,1598
7822,3516065852,3715998609,1672688780,1672689453,673
7821,3505135325,3520190170,1672588404,1672589167,763
7935,3430504438,3421836608,1672604397,1672605867,1470
7792,3701967560,3534553510,1672553453,1672556337,2884
7636,3713208927,3311845971,1672666769,1672669730,2961
7568,3533827120,3915628728,1672575561,1672576831,1270
7791,3829232696,3973560347,1672584852,1672585392,540
7502,3783509527,3518014636,1672690339,1672692964,2625
7640,3791020967,3701863557,1672613046,1672616349,3303
7758,3520931254,3446948848,1672639630,1672639779,149
7755,3429690204,3714962248,1672682384,1672684268,1884
7825,3793959750,3515394721,1672567249,1672569661,2412
7918,3505638204,3899204805,1672696504,1672699283,2779
7672,3880310724,3509604974,1672654397,1672654714,317
7867,3772642849,3505649239,1672634031,1672636489,2458
7940,3713268590,3703441914,1672595712,1672596282,570
7710,3505000737,3466229085,1672547846,1672548288,442
7697,3489728806,3303751772,1672531204,1672532244,1040
7770,3360743849,3666506258,1672584051,1672587033,2982
7695,3220716272,3388372715,1672693136,1672695986,2850
7589,3715581279,3511198618,1672696713,1672698620,1907
7637,3389115045,3792789881,1672606547,1672607518,971
7632,3312664885,3533385867,1672578590,1672580410,1820
7789,3617055293,3760992710,1672653301,1672656379,3078
7806,3760492950,3556951786,1672625316,1672628914,3598
7830,3978105277,3978115672,1672539652,1672542063,2411
7977,3501759100,3924549929,1672535546,1672537945,2399
7863,3519563836,3533280269,1672631936,1672634510,2574
7919,3716197887,3791874383,1672578701,1672580893,2192
7758,3301107849,3516716179,1672589569,1672592042,2473
7926,3760569731,3303751772,1672694606,1672697015,2409
7499,3774010081,3500904641,1672645591,1672648526,2935
7957,3711308224,3774520233,1672603140,1672605126,1986
7971,3806545488,3505347134,1672602071,1672603081,1010
7740,3716835696,3247815299,1672666105,1672667301,1196
7873,3345207877,3755511676,1672536695,1672538054,1359
7543,3426325549,3809059934,1672634465,1672637937,3472
7724,3804870229,3500066230,1672577835,1672580172,2337
7902,3280964728,3760077057,1672676027,1672677341,1314
7691,3904408902,3534010629,1672622758,1672625928,3170
7599,3334033993,3972709319,1672635033,1672636657,1624
7517,3780593036,3246596716,1672646798,1672648223,1425
7597,3500060260,3629935998,1672534903,1672537316,2413
7536,3755625324,3972364603,1672684104,1672686457,2353
7889,3209048907,3703735129,1672608160,1672611042,2882
7558,3828365570,3701178711,1672582615,1672584969,2354
7896,3430352815,3776948966,1672570377,1672573905,3528
7763,3756021689,3783196518,1672591960,1672592839,879
7486,3515860749,3516514391,1672660453,1672662649,2196
7847,3244173074,3711973519,1672630493,1672633532,3039
7606,3703955926,3826759140,1672568571,1672569160,589
7728,3501759100,3918056059,1672635432,1672637307,1875
7974,3516606733,3229058858,1672648622,1672648951,329
7968,3883042241,3730517636,1672634927,1672635919,992
7804,3509672210,3633420270,1672549687,1672552251,2564
7715,3518791447,3311627628,1672621884,1672622304,420
7781,3511435497,3859525941,1672617505,1672619576,2071
7530,3519563836,3760893269,1672628673,1672629480,807
7762,3379256399,3736790081,1672543798,1672546641,2843
7731,3701184889,3685187183,1672672304,1672675709,3405
7952,3898995675,3778266283,1672630466,1672632947,2481
7486,3734737881,3520206212,1672541719,1672543791,2072
7940,3833889105,3432689543,1672563253,1672564467,1214
7525,3800353779,3514719601,1672570846,1672571019,173
7816,3517255726,3757455053,1672559336,1672560245,909
7947,3236102733,3533270638,1672604098,1672606668,2570
7836,3209551760,3360506772,1672658514,1672658869,355
7539,3701184889,3516258476,1672630205,1672633042,2837
7575,3757161914,3509634629,1672574953,1672575802,849
7736,3516065852,3779528381,1672558818,1672559031,213
7780,3201848640,3703013906,1672549110,1672551897,2787
7828,3757562897,3434642576,1672532903,1672535185,2282
7793,3439023335,3519700826,1672594356,1672597513,3157
7717,3770101921,3774005526,1672564831,1672568184,3353
7781,3500803339,3311439795,1672702278,1672705015,2737
7863,3505477652,3793389510,1672701335,1672704199,2864
7511,3772053179,3505201246,1672617227,1672620113,2886
7825,3518876135,3533137446,1672582214,1672583335,1121
7688,3755920131,3231056870,1672596250,1672597400,1150
7883,3731106822,3206603608,1672684737,1672686136,1399
7794,3451432842,3783196518,1672652146,1672653636,1490
7626,3783429780,3736229191,1672605458,1672605788,330
7861,3851190615,3903962771,1672575146,1672577775,2629
7699,3249401741,3713268590,1672596159,1672597817,1658
7620,3534488837,3779218771,1672590033,1672593632,3599
7677,3518932404,3926700506,1672546516,1672549266,2750
7612,3517509185,3734828619,1672601980,1672603169,1189
7677,3448855696,3209027249,1672665045,1672665211,166
7662,3828432634,3826760240,1672539786,1672541665,1879
7881,3426325549,3520719611,1672663131,1672663642,511
7706,3516909237,3736790081,1672636604,1672639716,3112
7578,3688683847,3517255726,1672602277,1672603523,1246
7872,3931941795,3484995752,1672641028,1672641310,282
7486,3247780536,3772578994,1672654447,1672655149,702
7693,3500894271,3783509527,1672592378,1672594997,2619
7873,3770824086,3367902229,1672618346,1672618425,79
7620,3519556068,3515125508,1672611776,1672613348,1572
7517,3377766165,3516716179,1672559355,1672562861,3506
7526,3713808837,3500066230,1672533063,1672535952,2889
7899,3418728074,3284832486,1672551107,1672552574,1467
7830,3880285638,3780593036,1672674068,1672676199,2131
7713,3510937904,3624312512,1672691689,1672694940,3251
7854,3370752401,3514245078,1672660152,1672661206,1054
7921,3509933351,3314245084,1672575979,1672576192,213
7909,3793286136,3779629905,1672612545,1672614875,2330
7571,3505859863,3505000737,1672681615,1672684392,2777
7885,3385763781,3711198793,1672555698,1672558136,2438
7924,3500658339,3817316561,1672569787,1672571994,2207
7668,3518932404,3303705369,1672653406,1672656172,2766
7873,3235635976,3466229085,1672594538,1672594936,398
7801,3756462516,3629547065,1672696376,1672696992,616
7816,3610348516,3624312512,1672617776,1672619868,2092
7824,3755872268,3606812411,1672649513,1672651289,1776
7662,3481502100,3734828619,1672655316,1672657550,2234
7583,3826633236,3772053179,1672590980,1672591885,905
7982,3510703546,3756930948,1672669044,1672669154,110
7598,3925402713,3505912939,1672565741,1672565978,237
7659,3792768129,3777776687,1672675266,1672676676,1410
7802,3829232696,3773598056,1672549786,1672552823,3037
7838,3365278081,3757246925,1672596476,1672596821,345
7791,3756027749,3634786711,1672675296,1672677668,2372
7824,3519703355,3500803339,1672618951,1672620263,1312
7521,3280964728,3501927421,1672667963,1672670381,2418
7623,3737154119,3418534998,1672569540,1672570544,1004
7612,3714474557,3533369198,1672640971,1672642066,1095
7910,3701498253,3432665384,1672621051,1672622036,985
7830,3489545239,3407673904,1672698588,1672699969,1381
7572,3235287260,3365830990,1672546405,1672547126,721
7621,3791334389,3510247121,1672599146,1672600177,1031
7847,3606987130,3662180254,1672610507,1672611505,998
7560,3234362962,3512683609,1672599395,1672602636,3241
7546,3519556068,3772714862,1672587387,1672590208,2821
7655,3772337814,3514245078,1672534443,1672537603,3160
7636,3713644518,3500391167,1672549424,1672550499,1075
7709,3224058172,3202120784,1672613007,1672615593,2586
7770,3882291183,3735733948,1672663317,1672666743,3426
7962,3517963492,3229665776,1672609863,1672612847,2984
7508,3358871377,3345207877,1672558276,1672560747,2471
7650,3509672210,3739106581,1672548872,1672551833,2961
7754,3534492426,3774298222,1672565623,1672566192,569
7503,3911159965,3518876135,1672593339,1672595323,1984
7772,3614238812,3352603894,1672573588,1672576143,2555
7516,3249247700,3334033993,1672608286,1672608874,588
7771,3313541986,3387674757,1672646662,1672648042,1380
7546,3777477395,3511170269,1672632511,1672635953,3442
7671,3510711755,3476232529,1672580013,1672581406,1393
7701,3510594211,3518932404,1672596131,1672598724,2593
7691,3773120434,3316222192,1672599174,1672602710,3536
7719,3534010629,3500229033,1672694964,1672697975,3011
7889,3229058858,3534424200,1672597457,1672597965,508
7626,3476232529,3273500349,1672626783,1672628361,1578
7903,3701967560,3924549929,1672610199,1672610906,707
7799,3513454145,3883312122,1672602594,1672605881,3287
7505,3774580701,3485823740,1672599415,1672600570,1155
7789,3772758337,3800353779,1672615197,1672617435,2238
7682,3510380060,3512142794,1672605775,1672606786,1011
7912,3772359096,3505702787,1672540240,1672542521,2281
7921,3605726278,3772714862,1672699867,1672702041,2174
7842,3756930948,3420700674,1672645497,1672648888,3391
7783,3466229085,3828432634,1672633761,1672636283,2522
7711,3379256399,3903009525,1672635359,1672638923,3564
7497,3516629436,3378436155,1672676672,1672679910,3238
7891,3703661585,3505098372,1672675381,1672677317,1936
7718,3515125508,3385763781,1672539575,1672541620,2045
7906,3513599775,3362000049,1672687584,1672689380,1796
7693,3534488837,3227158514,1672595361,1672597770,2409
7961,3515151980,3520183192,1672680721,1672681909,1188
7809,3783509527,3760077057,1672681819,1672684974,3155
7609,3835382117,3511125626,1672597762,1672598387,625
7533,3711973519,3701967560,1672636053,1672639497,3444
7746,3511267139,3773205565,1672557889,1672559751,1862
7911,3822654369,3385763781,1672632605,1672632677,72
7850,3505203158,3388637594,1672567408,1672570558,3150
7818,3415546117,3514128943,1672677467,1672679688,2221
7832,3389115045,3235635976,1672610153,1672611281,1128
7592,3634340855,3772359096,1672695178,1672696445,1267
7747,3713630656,3778108318,1672620226,1672621844,1618
7502,3206593906,3520751702,1672668859,1672671395,2536
7899,3756451663,3715492942,1672554156,1672556463,2307
7957,3777120536,3459030804,1672619796,1672622190,2394
7679,3801089989,3601879040,1672638020,1672639516,1496
7782,3200691026,3711380716,1672616755,1672618414,1659
7484,3478194807,3489545239,1672560193,1672562707,2514
7843,3816454165,3772544062,1672639901,1672640222,321
7817,3402943525,3293695955,1672555635,1672558696,3061
7619,3889232789,3500729955,1672681417,1672683836,2419
7623,3224716315,3739106581,1672578340,1672578627,287
7763,3701111745,3221536550,1672610233,1672610329,96
7839,3780639480,3732481297,1672571728,1672573548,1820
7946,3793086311,3915628728,1672649102,1672650254,1152
7526,3485375593,3828624701,1672647365,1672649031,1666
7790,3703223015,3756930948,1672693548,1672696832,3284
7500,3777120536,3755042098,1672566391,1672568723,2332
7961,3533371364,3886298125,1672692269,1672693082,813
7977,3757812939,3519069599,1672698270,1672699794,1524
7553,3428006164,3755739653,1672608022,1672609118,1096
7515,3342131135,3277939457,1672660367,1672662983,2616
7965,3360743849,3800886801,1672579858,1672583406,3548
7613,3857349323,3399004969,1672609052,1672610664,1612
7651,3519556068,3779740455,1672635233,1672635571,338
7577,3429856982,3925620998,1672544673,1672548018,3345
7644,3770635361,3852595551,1672613621,1672614130,509
7765,3520629279,3430504438,1672643476,1672645553,2077
7975,3715998609,3519912874,1672641880,1672641943,63
7848,3510857360,3820354437,1672647828,1672649402,1574
7872,3777477395,3417587765,1672622470,1672622673,203
7564,3756453423,3776513891,1672652593,1672653228,635
7556,3713349754,3208844525,1672609375,1672611539,2164
7507,3314836094,3793871337,1672628315,1672629334,1019
7774,3760077057,3737154119,1672623420,1672626127,2707
7706,3415443558,3312333615,1672573134,1672574430,1296
7576,3311845971,3552314511,1672540619,1672543937,3318
7930,3516980378,3716273414,1672630127,1672633565,3438
7958,3792902982,3783509527,1672648034,1672649610,1576
7751,3519912874,3823600322,1672656328,1672657266,938
7710,3311324983,3223968713,1672665572,1672668947,3375
7654,3883551721,3779740455,1672554881,1672557505,2624
7690,3685187183,3857349323,1672682409,1672683660,1251
7577,3778549126,3607748895,1672600628,1672601202,574
7921,3453729665,3346795719,1672698106,1672698849,743
7772,3777079686,3500060260,1672596952,1672597096,144
7732,3516606733,3505347134,1672534516,1672535502,986
7966,3519700826,3770078063,1672630282,1672631586,1304
7751,3783925755,3475251781,1672681470,1672681990,520
7912,3714474557,3621810464,1672593081,1672595459,2378
7528,3533748232,3501486692,1672540779,1672543886,3107
7727,3338703270,3200691026,1672575754,1672578040,2286
7810,3500904641,3518791447,1672590352,1672591128,776
7592,3713268590,3394330287,1672558633,1672560612,1979
7559,3377766165,3511267139,1672535778,1672538796,3018
7714,3364543015,3617734118,1672576040,1672576111,71
7658,3513080274,3223789409,1672611918,1672613776,1858
7585,3714821932,3518932404,1672560014,1672560430,416
7843,3852595551,3280615985,1672601238,1672602185,947
7749,3493507965,3333896808,1672546726,1672549231,2505
7662,3515125508,3711370563,1672567780,1672569195,1415
7925,3760893269,3917088658,1672538296,1672540871,2575
7865,3773950140,3312333615,1672645308,1672647770,2462
7594,3485823740,3774501422,1672660911,1672661874,963
7794,3517721725,3791957752,1672679290,1672681152,1862
7895,3510969660,3453729665,1672584270,1672584562,292
7705,3772359096,3511435497,1672565325,1672568430,3105
7612,3404058699,3633420270,1672536970,1672537463,493
7663,3774580701,3701691675,1672576503,1672578038,1535
7619,3533025282,3377766165,1672559619,1672562769,3150
7621,3626156564,3288764520,1672580905,1672581820,915
7886,3716746253,3519428855,1672559255,1672560934,1679
7724,3383922351,3825229501,1672548347,1672548495,148
7853,3832902928,3701984666,1672546146,1672548889,2743
7723,3520165601,3407954858,1672647429,1672649161,1732
7890,3391915121,3407673904,1672554974,1672558391,3417
7541,3466229085,3360506772,1672645446,1672646218,772
7947,3512166013,3902383721,1672702211,1672705008,2797
7830,3370752401,3701863557,1672596903,1672597848,945
7583,3792768129,3918056059,1672667964,1672669835,1871
7937,3760569731,3772642849,1672537594,1672538111,517
7707,3925402713,3418728074,1672590696,1672593659,2963
7492,3701178711,3778341199,1672576441,1672577453,1012
7619,3411618230,3756528686,1672702836,1672703646,810
7745,3883861463,3518014636,1672619373,1672621241,1868
7506,3791594391,3516514391,1672597805,1672600403,2598
7691,3209551760,3248507722,1672567960,1672570459,2499
7961,3500805881,3817316561,1672569916,1672571011,1095
7807,3206603608,3756966035,1672678927,1672679613,686
7782,3605726278,3780365428,1672671422,1672674148,2726
7697,3533927138,3772714862,1672624720,1672628202,3482
7877,3804870229,3501955238,1672685534,1672687757,2223
7505,3511163800,3755920131,1672554041,1672554471,430
7906,3783925755,3388286531,1672556271,1672558716,2445
7728,3777455223,3780639480,1672553346,1672556100,2754
7585,3858918246,3500894271,1672596222,1672598523,2301
7621,3206593906,3510937904,1672556702,1672558092,1390
7707,3481647420,3505791599,1672536514,1672538989,2475
7579,3755798867,3756462516,1672550527,1672552602,2075
7631,3384951177,3780639480,1672634018,1672636523,2505
7802,3312664885,3859663348,1672662892,1672663801,909
7558,3391915121,3755798867,1672536172,1672536913,741
7918,3509634629,3396086535,1672683026,1672684573,1547
7515,3816454165,3487171044,1672552822,1672555204,2382
7681,3714962248,3467773920,1672634737,1672635591,854
7735,3497901842,3757403279,1672579107,1672581980,2873
7850,3757602960,3416265063,1672545166,1672546675,1509
7979,3235287260,3770824086,1672649908,1672653144,3236
7617,3736419952,3780294829,1672650553,1672653657,3104
7571,3774005526,3917278625,1672572321,1672575276,2955
7589,3331845324,3420700674,1672570564,1672571755,1191
7700,3520706195,3773598056,1672556088,1672556282,194
7727,3533095755,3518932404,1672566095,1672566346,251
7582,3853018906,3783196518,1672550449,1672552637,2188
7782,3776948966,3780828689,1672643706,1672645055,1349
7514,3755511676,3229058858,1672673975,1672676923,2948
7556,3276993580,3509453566,1672561852,1672563507,1655
7794,3755042098,3313541986,1672642362,1672644095,1733
7811,3883861463,3777120536,1672534210,1672535698,1488
7979,3855424474,3360506772,1672580238,1672581070,832
7582,3235287260,3365614305,1672629606,1672631075,1469
7790,3345207877,3716835696,1672692879,1672695718,2839
7567,3516223597,3400918687,1672673617,1672674303,686
7806,3617734118,3800353779,1672581898,1672582163,265
7565,3772544062,3227457126,1672671627,1672672765,1138
7815,3509933351,3701065786,1672669293,1672669594,301
7639,3772746272,3826633236,1672591312,1672594718,3406
7626,3501184421,3972709319,1672589109,1672592658,3549
7496,3520030713,3285400528,1672545201,1672547835,2634
7878,3509352754,3776513891,1672657462,1672658649,1187
7513,3755625324,3209027249,1672650378,1672653360,2982
7934,3512837326,3533270638,1672661050,1672661306,256
7739,3757161914,3247780536,1672693102,1672695126,2024
7825,3451432842,3383922351,1672611615,1672614653,3038
7783,3277939457,3772758337,1672664121,1672666099,1978
7925,3666457294,3792253549,1672646224,1672647740,1516
7827,3828624701,3505477652,1672608290,1672610782,2492
7882,3881477378,3385763781,1672627240,1672627561,321
7708,3660493209,3487171044,1672667266,1672670490,3224
7839,3791901535,3511350608,1672700213,1672702865,2652
7599,3666457294,3249247700,1672675423,1672676127,704
7719,3714474557,3420700674,1672587540,1672588010,470
7981,3389115045,3772758337,1672570631,1672570723,92
7890,3552314511,3819727225,1672649219,1672652076,2857
7602,3465254146,3773598056,1672688288,1672688600,312
7670,3760598102,3209027249,1672641417,1672642630,1213
7976,3776066388,3779036831,1672574996,1672576739,1743
7868,3412980697,3793086311,1672572639,1672574326,1687
7684,3760893269,3772578994,1672665011,1672665412,401
7864,3791594391,3356860407,1672669688,1672671873,2185
7605,3773814927,3757682496,1672693789,1672694828,1039
7762,3534424200,3304625412,1672621906,1672622927,1021
7575,3311761694,3791115967,1672678840,1672680634,1794
7828,3793436995,3493507965,1672670739,1672671860,1121
7865,3819727225,3400918687,1672603493,1672606082,2589
7489,3494290908,3512510536,1672604616,1672608193,3577
7700,3518360734,3774268456,1672700605,1672702156,1551
7560,3783429780,3664517356,1672640128,1672642441,2313
7615,3888559320,3496549058,1672565029,1672566282,1253
7706,3512142794,3227158514,1672674438,1672675543,1105
7610,3485375593,3817621391,1672563828,1672563916,88
7961,3756462516,3829232696,1672612248,1672612722,474
7891,3779218771,3500487333,1672579691,1672582816,3125
7771,3851190615,3817316561,1672617396,1672620407,3011
7676,3793436995,3514987389,1672631314,1672633941,2627
7808,3417061462,3774125065,1672661212,1672664695,3483
7922,3333896808,3339907603,1672574758,1672575555,797
7731,3365614305,3505098372,1672673203,1672673487,284
7695,3248507722,3304056063,1672589365,1672591326,1961
7773,3311761694,3434642576,1672686347,1672688321,1974
7888,3783196518,3280599164,1672656475,1672658007,1532
7854,3904408902,3829319703,1672702853,1672703391,538
7491,3311439795,3778305740,1672665752,1672668182,2430
7664,3514472925,3703223015,1672581397,1672584471,3074
7755,3400804807,3883551721,1672669703,1672670212,509
7556,3779218771,3755436115,1672561101,1672563428,2327
7578,3517864478,3808324264,1672619643,1672623148,3505
7916,3238712269,3511267139,1672587552,1672588297,745
7667,3520165601,3232962003,1672577769,1672578683,914
7709,3439023335,3899204805,1672659088,1672660957,1869
7510,3465202715,3618045231,1672665652,1672668322,2670
7748,3701146057,3760492950,1672616767,1672617756,989
7971,3666506258,3387674757,1672615347,1672617834,2487
7503,3556951786,3476232529,1672698928,1672700654,1726
7681,3783779671,3352603894,1672616914,1672618641,1727
7863,3512837326,3828624701,1672551664,1672552621,957
7838,3520756859,3777514571,1672556246,1672558562,2316
7892,3772359096,3514838220,1672567163,1672567638,475
7855,3501955238,3482405588,1672661600,1672664604,3004
7669,3715339701,3224716315,1672537008,1672540034,3026
7790,3624761861,3779740455,1672628066,1672631292,3226
7821,3206254161,3315583351,1672576229,1672578061,1832
7614,3716273414,3757161914,1672567215,1672569156,1941
7661,3411618230,3519069599,1672559838,1672562121,2283
7554,3755881905,3395152943,1672595896,1672596943,1047
7877,3903307060,3510857360,1672628395,1672629663,1268
7571,3520751702,3710112546,1672652891,1672655619,2728
7762,3459030804,3346795719,1672543229,1672546015,2786
7599,3772578994,3774119563,1672616736,1672618242,1506
7566,3516673015,3520629279,1672623406,1672624363,957
7819,3811694763,3774127586,1672557650,1672558962,1312
7754,3316173088,3711370563,1672537869,1672538323,454
7811,3511359172,3501692334,1672665333,1672667555,2222
7677,3555214688,3505869747,1672595951,1672598675,2724
7975,3715581279,3515394721,1672695211,1672696492,1281
7784,3701995648,3247428249,1672536606,1672537431,825
7811,3772544062,3399004969,1672604952,1672605989,1037
7831,3755798867,3909238838,1672558316,1672559320,1004
7598,3247780536,3443698222,1672597403,1672597919,516
7970,3417970574,3770078063,1672651001,1672652155,1154
7955,3433804879,3933210486,1672610608,1672611729,1121
7647,3634340855,3342131135,1672573745,1672575902,2157
7653,3338367113,3780788622,1672607485,1672610425,2940
7711,3774338212,3600647945,1672632304,1672634076,1772
7532,3500658339,3311845971,1672619078,1672621567,2489
7925,3247815299,3311065516,1672609760,1672611395,1635
7742,3481502100,3534553510,1672594991,1672596527,1536
7615,3736419952,3316173088,1672634421,1672634736,315
7747,3883085535,3365942576,1672625386,1672626779,1393
7629,3505962865,3779976989,1672553433,1672555715,2282
7891,3710569131,3467773920,1672582955,1672583748,793
7514,3778305740,3518791447,1672688412,1672689198,786
7771,3909606423,3922337974,1672543283,1672544767,1484
7852,3247815299,3770021824,1672634755,1672636123,1368
7668,3229058858,3713370078,1672698997,1672701672,2675
7955,3757447189,3396086535,1672673265,1672675141,1876
7884,3739106581,3400918687,1672534064,1672536105,2041
7485,3773120434,3500803339,1672650538,1672651851,1313
7637,3755392666,3756930948,1672575108,1672577777,2669
7637,3880285638,3512142794,1672539444,1672541164,1720
7922,3770763956,3311090974,1672585454,1672585638,184
7939,3713268590,3514283243,1672589618,1672592593,2975
7592,3448855696,3617055293,1672687368,1672690904,3536
7511,3791874383,3772309166,1672649613,1672653178,3565
7807,3859663348,3505362057,1672698414,1672700609,2195
7939,3715981584,3311415018,1672672604,1672676067,3463
7856,3392121505,3774520233,1672605843,1672606348,505
7512,3881477378,3774339795,1672533820,1672535784,1964
7852,3791997875,3899266183,1672560491,1672561374,883
7726,3791594391,3518496488,1672574296,1672574465,169
7534,3511332835,3710112546,1672626360,1672628776,2416
7963,3755881905,3246596716,1672593477,1672595378,1901
7983,3365942576,3639847263,1672566975,1672570110,3135
7511,3773120434,3400918687,1672663412,1672665175,1763
7680,3430352815,3511687358,1672658968,1672661737,2769
7920,3711973519,3783925755,1672654491,1672657103,2612
7885,3516465662,3520165601,1672645091,1672645849,758
7981,3826760240,3783429780,1672645872,1672645951,79
7490,3512540951,3485008994,1672628048,1672628318,270
7711,3777623166,3891751546,1672668751,1672670009,1258
7511,3359239884,3242408357,1672537995,1672540736,2741
7522,3311603601,3520376528,1672619620,1672620703,1083
7739,3979339287,3518163778,1672682634,1672685453,2819
7567,3924549929,3926700506,1672547829,1672549951,2122
7641,3770447408,3780788622,1672554061,1672554951,890
7724,3815508790,3827626797,1672682772,1672685695,2923
7899,3383922351,3304056063,1672547015,1672549321,2306
7826,3756623396,3715189301,1672664247,1672664513,266
7634,3407954858,3500458761,1672691239,1672694413,3174
7511,3714504419,3733189298,1672571314,1672571653,339
7553,3401627165,3304056063,1672608716,1672611718,3002
7678,3777623166,3826633236,1672690698,1672692520,1822
7597,3615046771,3511435497,1672613467,1672614579,1112
7817,3777079686,3316222192,1672571422,1672573820,2398
7944,3465254146,3494290908,1672674065,1672677189,3124
7508,3666457294,3778549126,1672693218,1672695554,2336
7816,3314836094,3501759100,1672672615,1672674820,2205
7955,3201848640,3514838220,1672584301,1672586434,2133
7568,3505347134,3827626797,1672560427,1672562779,2352
7490,3978115672,3773755137,1672562559,1672565833,3274
7536,3518014636,3774298222,1672548790,1672549755,965
7643,3336742544,3772309150,1672648138,1672651623,3485
7505,3755587522,3342131135,1672545092,1672547738,2646
7634,3756528686,3716746253,1672603405,1672606421,3016
7581,3370636709,3517459919,1672669781,1672672006,2225
7860,3714474557,3757246925,1672641309,1672643583,2274
7657,3793470489,3881477378,1672575685,1672576608,923
7534,3367029997,3793962300,1672677981,1672679352,1371
7679,3774005526,3734737881,1672688807,1672689426,619
7854,3249791738,3922337974,1672546270,1672547318,1048
7658,3780593036,3755872268,1672702033,1672704004,1971
7535,3773950140,3852391257,1672700710,1672700817,107
7956,3760183458,3734828619,1672684662,1672686615,1953
7785,3505904952,3500805881,1672561602,1672561665,63
7632,3683766533,3779528381,1672651405,1672651864,459
7945,3901877072,3221536550,1672537895,1672538113,218
7507,3757602960,3533927138,1672700863,1672702889,2026
7747,3388286531,3518360734,1672572733,1672573680,947
7759,3493507965,3920801189,1672702098,1672703895,1797
7931,3783245561,3734737881,1672566019,1672567426,1407
7916,3779218771,3756528686,1672690521,1672690981,460
7505,3312333615,3505173328,1672702043,1672702238,195
7602,3467773920,3517077106,1672548963,1672551139,2176
7674,3716258994,3736790081,1672550762,1672551233,471
7699,3812176780,3939952128,1672587939,1672590592,2653
7729,3404058699,3374559242,1672574216,1672575921,1705
7760,3792883665,3520165601,1672623859,1672624522,663
7612,3512720680,3505869747,1672543424,1672544027,603
7975,3500060260,3715189301,1672573315,1672575235,1920
7746,3302626661,3346795719,1672533771,1672534179,408
7524,3519563836,3533653428,1672653331,1672656788,3457
7930,3249791738,3730517636,1672581621,1672584484,2863
7767,3772337814,3501606184,1672544453,1672546751,2298
7806,3291235378,3533385867,1672635060,1672636577,1517
7533,3636867411,3516673015,1672637283,1672638175,892
7597,3500904641,3701863557,1672638211,1672639418,1207
7838,3800886801,3351554343,1672605269,1672606736,1467
7901,3349613093,3500177712,1672599120,1672600598,1478
7497,3701184889,3501692334,1672692978,1672696138,3160
7611,3731106822,3247815299,1672625200,1672626001,801
7939,3427219654,3515723720,1672592072,1672593821,1749
7591,3533137446,3227457126,1672640047,1672642632,2585
7849,3793627961,3500487333,1672638850,1672640347,1497
7782,3476232529,3889750851,1672576722,1672577248,526
7751,3703275621,3481502100,1672624111,1672624875,764
7530,3713208927,3247428249,1672697183,1672699091,1908
7564,3780365428,3634786711,1672651581,1672652047,466
7784,3770824086,3770763956,1672552763,1672553897,1134
7771,3501759100,3277669002,1672701014,1672704234,3220
7801,3909606423,3384240055,1672687907,1672688844,937
7808,3772642849,3688418210,1672701171,1672703324,2153
7747,3534313900,3703661585,1672671260,1672673257,1997
7864,3793848402,3627937312,1672620502,1672621842,1340
7827,3883085535,3716273414,1672600489,1672602028,1539
7665,3370636709,3773664987,1672644046,1672646899,2853
7576,3510244400,3793848402,1672677505,1672680596,3091
7792,3514719601,3606186086,1672566698,1672568557,1859
7745,3755392666,3370752401,1672531413,1672531647,234
7856,3972709319,3777514571,1672678977,1672680569,1592
7703,3783083229,3621810464,1672682345,1672685135,2790
7603,3285400528,3777790718,1672605157,1672607551,2394
7791,3701898991,3500177712,1672615475,1672617669,2194
7533,3774338212,3608868877,1672551307,1672553409,2102
7566,3757447189,3737154119,1672546415,1672548104,1689
7897,3760561634,3475795792,1672531240,1672532819,1579
7726,3336751428,3792032359,1672598294,1672599139,845
7868,3817316561,3277605882,1672696411,1672697856,1445
7748,3496269445,3342131135,1672621720,1672624954,3234
7848,3701498253,3731419510,1672613015,1672614566,1551
7916,3359239884,3774298222,1672696823,1672698654,1831
7610,3312829208,3800353779,1672565154,1672567147,1993
7593,3298433163,3511687358,1672661853,1672663365,1512
7929,3902278226,3736625083,1672682868,1672683360,492
7746,3428674539,3792473331,1672550284,1672551476,1192
7900,3735733948,3688683847,1672602856,1672603945,1089
7486,3247780536,3895562476,1672565210,1672567238,2028
7667,3209027249,3516909237,1672556261,1672557537,1276
7831,3515284591,3404058699,1672702258,1672705095,2837
7798,3791602225,3839849341,1672614473,1672615941,1468
7755,3516039895,3773429448,1672571053,1672572193,1140
7888,3478194807,3482405588,1672574016,1672577324,3308
7747,3777120536,3703275621,1672684718,1672685909,1191
7698,3716197887,3738502357,1672623194,1672626356,3162
7714,3716197887,3792902982,1672555101,1672556680,1579
7649,3511271692,3711370563,1672550417,1672550744,327
7973,3517963492,3772758337,1672553374,1672555536,2162
7583,3755798867,3793436995,1672602553,1672603709,1156
7737,3903009525,3778266283,1672618140,1672621472,3332
7613,3780609808,3511163800,1672588092,1672591087,2995
7684,3367029997,3497901842,1672682351,1672684549,2198
7686,3509352754,3703223015,1672635709,1672639222,3513
7713,3701534009,3515151980,1672651562,1672651874,312
7824,3710112546,3552314511,1672612204,1672615763,3559
7531,3516606733,3613683164,1672569531,1672571094,1563
7766,3556951786,3400918687,1672546198,1672548153,1955
7509,3517077106,3662180254,1672543908,1672547152,3244
7966,3715974031,3772359096,1672614867,1672616617,1750
7904,3511163800,3514245078,1672568439,1672569256,817
7534,3777477395,3496269445,1672643801,1672646508,2707
7929,3772053179,3668898102,1672590573,1672593135,2562
7952,3716197887,3407725581,1672573991,1672574655,664
7737,3730517636,3793871337,1672569553,1672572077,2524
7633,3515284591,3533095755,1672600843,1672601012,169
7561,3516673015,3780294829,1672558570,1672559393,823
7496,3883312122,3520719611,1672652456,1672653261,805
7904,3311208440,3791997875,1672629856,1672630728,872
7543,3703441914,3777717988,1672543388,1672545417,2029
7806,3280599164,3805347939,1672614713,1672616985,2272
7699,3903009525,3776066388,1672645363,1672647159,1796
7520,3774366875,3311993075,1672676599,1672677452,853
7720,3311439795,3774556560,1672585500,1672587522,2022
7745,3664517356,3514987389,1672543540,1672546059,2519
7644,3500374658,3793436995,1672583070,1672584204,1134
7717,3311154569,3313564074,1672637723,1672639142,1419
7630,3511359172,3434642576,1672580648,1672581790,1142
7486,3296471982,3701534009,1672604359,1672604908,549
7819,3249791738,3666457294,1672595712,1672596905,1193
7981,3716900301,3911159965,1672590754,1672594294,3540
7811,3513956646,3815508790,1672629282,1672631324,2042
7883,3345207877,3430504438,1672551341,1672554516,3175
7536,3716537575,3711571712,1672553892,1672556665,2773
7540,3633420270,3533653428,1672678201,1672680528,2327
7517,3519152550,3284832486,1672597344,1672599794,2450
7835,3501483568,3773465237,1672660031,1672661079,1048
7979,3518408774,3391915121,1672608348,1672608987,639
7650,3783925755,3411618230,1672672587,1672673117,530
7744,3391261292,3510857360,1672653049,1672655221,2172
7838,3605726278,3399911573,1672604461,1672606267,1806
7898,3206593906,3517721725,1672694604,1672697313,2709
7534,3755920131,3428674539,1672596429,1672598940,2511
7673,3783779671,3453729665,1672583593,1672584957,1364
7828,3517864478,3755920131,1672655564,1672658573,3009
7833,3505883609,3920801189,1672645303,1672646332,1029
7893,3716746253,3429856982,1672532221,1672535541,3320
7769,3832902928,3755511676,1672605426,1672605494,68
7507,3936227020,3514283243,1672581476,1672584933,3457
7850,3500229033,3756424865,1672702204,1672704398,2194
7696,3792288302,3291235378,1672649504,1672650910,1406
7617,3755798867,3510969660,1672684263,1672685674,1411
7650,3407673904,3505219850,1672674123,1672675114,991
7831,3369998498,3428006164,1672650052,1672653079,3027
7983,3510126867,3533025282,1672603471,1672604775,1304
7655,3291227780,3816454165,1672702913,1672706018,3105
7795,3629547065,3209383861,1672608028,1672610101,2073
7672,3773664987,3514245078,1672675990,1672677162,1172
7574,3319752091,3811694763,1672629532,1672632032,2500
7553,3505098372,3396285984,1672624263,1672625426,1163
7572,3394330287,3634786711,1672634267,1672635390,1123
7868,3520012395,3370636709,1672628010,1672628256,246
7664,3493507965,3756462516,1672637033,1672640352,3319
7774,3291883916,3792902982,1672702787,1672706324,3537
7554,3626156564,3791657947,1672612243,1672614023,1780
7583,3515284591,3515860749,1672679894,1672681350,1456
7548,3496051529,3487171044,1672557396,1672559835,2439
7655,3715339701,3975287541,1672703888,1672707218,3330
7487,3401627165,3500391167,1672556576,1672559445,2869
7848,3883312122,3514245078,1672647092,1672648020,928
7856,3311845971,3519700826,1672654422,1672656166,1744
7723,3757161914,3516716179,1672701756,1672702595,839
7918,3520756859,3475251781,1672597279,1672600698,3419
7819,3713644518,3315583351,1672543048,1672543255,207
7664,3505702787,3735733948,1672544341,1672545834,1493
7732,3783925755,3517721725,1672536066,1672538123,2057
7610,3829764737,3514987389,1672588073,1672590280,2207
7716,3500391167,3427283336,1672531548,1672531679,131
7504,3756601594,3783779671,1672678474,1672681577,3103
7942,3915628728,3778980116,1672534693,1672537177,2484
7815,3895562476,3737154119,1672611957,1672613005,1048
7816,3858918246,3200198928,1672571633,1672572842,1209
7613,3404384505,3622054816,1672621161,1672621794,633
7799,3760077057,3516016437,1672598608,1672599032,424
7594,3367902229,3757602960,1672562410,1672564811,2401
7500,3701065786,3738274418,1672619593,1672621790,2197
7696,3500994774,3903009525,1672670127,1672673415,3288
7664,3836573197,3509634629,1672557439,1672559388,1949
7777,3714962248,3922337974,1672585702,1672587626,1924
7976,3621497531,3334033993,1672563029,1672563717,688
7762,3518163778,3505791599,1672555254,1672556230,976
7928,3512969370,3429690204,1672619325,1672622165,2840
7679,3500391167,3662180254,1672686898,1672689511,2613
7506,3287105466,3760992710,1672667353,1672667547,194
7822,3828432634,3760992710,1672624432,1672625093,661
7900,3473765852,3247815299,1672631355,1672632048,693
7891,3800353779,3710112546,1672702298,1672704194,1896
7842,3534729133,3394539273,1672626849,1672627273,424
7594,3489962019,3772359096,1672663366,1672665134,1768
7686,3416241005,3236102733,1672538093,1672541593,3500
7734,3512720680,3379589402,1672697695,1672700021,2326
7840,3501927421,3475795792,1672693777,1672697005,3228
7878,3500177712,3500177712,1672628379,1672628905,526
7676,3331845324,3514283243,1672620933,1672623031,2098
7654,3288764520,3451432842,1672544919,1672546158,1239
7763,3778549126,3459030804,1672584291,1672585214,923
7932,3817316561,3716746253,1672656456,1672659313,2857
7750,3710098970,3512837326,1672647081,1672649353,2272
7512,3624312512,3915628728,1672700986,1672702219,1233
7872,3514283243,3826760240,1672592447,1672594271,1824
7615,3774366875,3511435497,1672551066,1672553064,1998
7863,3918056059,3639847263,1672630811,1672633157,2346
7602,3513956646,3979339287,1672593101,1672593837,736
7753,3511267139,3792288302,1672591455,1672594631,3176
7562,3783531004,3703013906,1672622443,1672624087,1644
7629,3916289176,3387966152,1672683884,1672687132,3248
7893,3716835696,3514838220,1672694365,1672694993,628
7581,3901877072,3703735129,1672645293,1672646093,800
7798,3778549126,3500177712,1672616968,1672617819,851
7762,3519803045,3453729665,1672675512,1672676831,1319
7794,3209027249,3774338212,1672645535,1672647186,1651
7902,3733891182,3518496488,1672567767,1672569184,1417
7968,3533371364,3369998498,1672573833,1672575873,2040
7736,3703718151,3716537575,1672600558,1672601490,932
7637,3825229501,3826759140,1672561093,1672563883,2790
7792,3776948966,3505973226,1672694060,1672696897,2837
7894,3520730271,3388637594,1672644276,1672647025,2749
7808,3912536808,3311203656,1672591633,1672593356,1723
7981,3776513891,3427283336,1672661824,1672664058,2234
7740,3316173088,3858918246,1672566449,1672567821,1372
7648,3409474775,3520730271,1672542596,1672542728,132
7674,3421127249,3520190170,1672672808,1672676030,3222
7942,3701995648,3637008488,1672674018,1672674522,504
7892,3284832486,3247428249,1672605335,1672608674,3339
7968,3774127586,3510244400,1672623242,1672626270,3028
7786,3772578994,3792032359,1672612547,1672613565,1018
7926,3311274543,3517963492,1672647549,1672650769,3220
7843,3774580701,3903009525,1672658411,1672661621,3210
7775,3386707783,3855937514,1672653979,1672655841,1862
7851,3716258994,3701863557,1672586227,1672587525,1298
7689,3772309166,3234541252,1672545789,1672546374,585
7791,3246596716,3711262377,1672667165,1672669523,2358
7903,3394330287,3755436115,1672667486,1672667971,485
7750,3412980697,3477649378,1672657191,1672660449,3258
7572,3378436155,3279721246,1672542183,1672544726,2543
7794,3409474775,3716165213,1672548920,1672552506,3586
7975,3617055293,3511687358,1672693146,1672695373,2227
7553,3510594211,3778108318,1672681690,1672682266,576
7754,3384951177,3783705817,1672546488,1672548603,2115
7803,3307512479,3516039895,1672666339,1672667952,1613
7577,3780593036,3703889596,1672572874,1672574214,1340
7820,3200691026,3369998498,1672541337,1672544723,3386
7767,3828365570,3664170666,1672609780,1672613278,3498
7657,3713644518,3298288268,1672549091,1672549260,169
7898,3406784491,3277605882,1672560052,1672561527,1475
7637,3402943525,3518669703,1672545111,1672546209,1098
7952,3828365570,3534313900,1672669526,1672671200,1674
7737,3481647420,3520183192,1672691256,1672693111,1855
7740,3778308417,3833889105,1672668597,1672668795,198
7974,3639847263,3815508790,1672602645,1672604442,1797
7773,3505098372,3284639858,1672573945,1672574405,460
7584,3703955926,3783239924,1672665559,1672667899,2340
7894,3701184889,3889750851,1672616046,1672616322,276
7693,3701534009,3667680268,1672648956,1672650159,1203
7705,3533242305,3386707783,1672700022,1672703067,3045
7576,3773950140,3756930948,1672680806,1672684084,3278
7560,3904408902,3774339795,1672629778,1672632128,2350
7680,3774339795,3714504419,1672605393,1672608736,3343
7922,3516016437,3793086311,1672542735,1672543541,806
7857,3512540951,3451432842,1672667892,1672670378,2486
7694,3774580701,3792177074,1672545086,1672546002,916
7662,3614238812,3285400528,1672702876,1672705843,2967
7565,3756601594,3501759100,1672620672,1672622559,1887
7495,3613995936,3221899927,1672628286,1672628393,107
7960,3519556068,3297463265,1672593532,1672596228,2696
7775,3416427576,3777717988,1672678305,1672680652,2347
7520,3737079798,3757161914,1672649328,1672652678,3350
7706,3755625324,3311439795,1672548806,1672550788,1982
7741,3517255726,3516980378,1672653905,1672654429,524
7613,3978105277,3880285638,1672668504,1672669534,1030
7766,3777790718,3930791338,1672632951,1672634925,1974
7623,3481647420,3383922351,1672677790,1672679123,1333
7485,3311203656,3613683164,1672676764,1672679612,2848
7509,3715974031,3827222533,1672703338,1672704978,1640
7885,3793627961,3515284591,1672533638,1672535833,2195
7766,3513956646,3760992710,1672677134,1672677969,835
7514,3780365428,3976390453,1672552537,1672555192,2655
7549,3883551721,3917278625,1672569616,1672570164,548
7906,3311761694,3221899927,1672564254,1672566667,2413
7937,3852391257,3236102733,1672580172,1672580882,710
7491,3287105466,3713894336,1672617844,1672620997,3153
7728,3703013906,3773814927,1672597111,1672598000,889
7839,3922275620,3701498253,1672650197,1672652577,2380
7487,3244485293,3793338102,1672611315,1672612943,1628
7871,3737079798,3311439795,1672610712,1672614212,3500
7637,3509933351,3937224533,1672639710,1672641960,2250
7654,3802367797,3902383721,1672535961,1672537392,1431
7658,3701274634,3774339795,1672689738,1672690363,625
7847,3917278625,3473562469,1672647722,1672650729,3007
7931,3975287541,3421836608,1672622037,1672622146,109
7849,3774338212,3711571712,1672680980,1672681160,180
7751,3793338102,3711262377,1672683191,1672684492,1301
7949,3314245084,3772884106,1672700325,1672702016,1691
7844,3859663348,3793286136,1672564421,1672566053,1632
7521,3505973226,3774125065,1672566049,1672566246,197
7516,3510711755,3918056059,1672691878,1672693250,1372
7604,3520931254,3783779671,1672697862,1672699474,1612
7617,3817316561,3780503655,1672672074,1672674172,2098
7643,3898995675,3397418363,1672668881,1672672258,3377
7489,3345207877,3304625412,1672577013,1672580467,3454
7768,3772578994,3222521619,1672638730,1672639965,1235
7842,3920801189,3534729133,1672614247,1672614334,87
7505,3760992710,3487171044,1672654372,1672656713,2341
7955,3509933351,3430352815,1672607823,1672611314,3491
7834,3485375593,3910886626,1672555295,1672557635,2340
7514,3757151210,3516514391,1672608858,1672610976,2118
7931,3512349371,3533193862,1672700151,1672700949,798
7887,3779218771,3520730271,1672596968,1672600148,3180
7744,3487171044,3772714862,1672560500,1672562602,2102
7549,3466911760,3780294829,1672617959,1672619250,1291
7498,3774204963,3344364444,1672595543,1672597335,1792
7803,3513164386,3809484172,1672638202,1672640454,2252
7626,3236102733,3206603608,1672596157,1672597412,1255
7563,3613995936,3512540951,1672610641,1672613934,3293
7721,3505203158,3972364603,1672599145,1672600249,1104
7940,3348261553,3791553060,1672532731,1672533041,310
7655,3734496778,3624312512,1672656435,1672659736,3301
7590,3516011407,3458539365,1672636584,1672638124,1540
7493,3613683164,3933210486,1672685436,1672687935,2499
7609,3379256399,3711308224,1672662725,1672662871,146
7875,3791997875,3772359096,1672657400,1672659509,2109
7551,3895562476,3500487333,1672650485,1672651824,1339
7949,3713808837,3755881905,1672547597,1672549292,1695
7748,3760893269,3930797455,1672699405,1672701460,2055
7931,3511198618,3703735129,1672534371,1672535178,807
7640,3222448362,3793753089,1672554567,1672556210,1643
7796,3505173328,3518496488,1672630378,1672631796,1418
7544,3710112546,3222521619,1672593990,1672597206,3216
7906,3713268590,3365278081,1672531719,1672532586,867
7849,3489728806,3688683847,1672628911,1672632420,3509
7553,3802367797,3223968713,1672595337,1672598373,3036
7529,3886298125,3760489031,1672586278,1672587848,1570
7813,3244436890,3313541986,1672696481,1672696644,163
7731,3407725581,3792844210,1672641628,1672643322,1694
7772,3772359096,3757447189,1672640945,1672642695,1750
7712,3311439795,3279721246,1672592997,1672593192,195
7682,3628819436,3304056063,1672657464,1672659548,2084
7570,3756966035,3667680268,1672552487,1672552713,226
7848,3500177712,3511350608,1672615431,1672617180,1749
7806,3501483568,3513956646,1672681408,1672683048,1640
7860,3668005723,3909606423,1672662727,1672663269,542
7930,3501198706,3361230905,1672534896,1672536271,1375
7518,3505869747,3792789881,1672547351,1672548943,1592
7790,3715981584,3637008488,1672564071,1672566927,2856
7803,3793962300,3783779671,1672605128,1672605510,382
7703,3515151980,3808324264,1672690447,1672692822,2375
7906,3475396323,3391261292,1672535843,1672537133,1290
7768,3828624701,3918584946,1672701916,1672704042,2126
7522,3780503655,3770447408,1672533463,1672535057,1594
7620,3715981584,3407673904,1672643054,1672644172,1118
7485,3534492426,3883861463,1672631549,1672631992,443
7670,3666506258,3489728806,1672532229,1672535524,3295
7831,3247428249,3297463265,1672536766,1672539514,2748
7633,3886298125,3606186086,1672584849,1672585967,1118
7946,3882997884,3510703546,1672665332,1672667174,1842
7771,3606186086,3511435497,1672579168,1672580703,1535
7504,3394539273,3534313900,1672610474,1672612291,1817
7685,3634340855,3519563836,1672575784,1672579111,3327
7783,3970117174,3913251733,1672651259,1672653780,2521
7834,3516514391,3388372715,1672642179,1672645203,3024
7874,3516673015,3666457294,1672688539,1672691878,3339
7565,3610695419,3778266283,1672671664,1672674221,2557
7810,3792844210,3770078063,1672638692,1672640203,1511
7919,3774520233,3505000737,1672551619,1672554872,3253
7780,3625274012,3505904952,1672560958,1672563349,2391
7919,3505859863,3405494240,1672647006,1672648768,1762
7851,3516223597,3773598056,1672543531,1672547055,3524
7681,3384951177,3280964728,1672554402,1672556716,2314
7578,3428006164,3716165213,1672581639,1672582127,488
7753,3279721246,3756453423,1672542626,1672543584,958
7856,3772642849,3783429780,1672635116,1672638012,2896
7945,3312333615,3454042520,1672578579,1672579985,1406
7496,3636867411,3935627557,1672624662,1672625015,353
7947,3298433163,3379589402,1672672570,1672673612,1042
7691,3500729955,3505362057,1672602981,1672606443,3462
7758,3500658339,3701190899,1672604476,1672604654,178
7849,3933210486,3288764520,1672555133,1672556643,1510
7863,3209551760,3516629436,1672605471,1672606885,1414
7538,3298433163,3834257412,1672663877,1672664059,182
7757,3616944364,3276993580,1672646677,1672646934,257
7681,3617734118,3391915121,1672699794,1672700966,1172
7555,3792902982,3339907603,1672582216,1672583655,1439
7556,3516223597,3516606733,1672601597,1672604672,3075
7510,3227158514,3826633236,1672688123,1672688866,743
7566,3922275416,3829764737,1672592106,1672595535,3429
7724,3231056870,3311152102,1672636705,1672637384,679
7979,3303705369,3859663348,1672627186,1672627416,230
7678,3534553510,3516258476,1672673306,1672674186,880
7521,3910454786,3224058172,1672690388,1672692271,1883
7721,3505649239,3416427576,1672586471,1672588699,2228
7815,3780503655,3247428249,1672535700,1672539003,3303
7775,3209048907,3715581279,1672575812,1672578862,3050
7809,3756021689,3378092448,1672656664,1672659305,2641
7784,3883312122,3223968713,1672662660,1672662928,268
7911,3716537575,3616944364,1672686519,1672688661,2142
7887,3610348516,3922275416,1672701058,1672702476,1418
7498,3496051529,3277605882,1672629141,1672630583,1442
7609,3774127586,3477649378,1672621142,1672623503,2361
7617,3836573197,3513599775,1672589797,1672592831,3034
7920,3222448362,3770851318,1672652975,1672655759,2784
7671,3332072298,3515125508,1672601855,1672602855,1000
7897,3514283243,3610348516,1672669673,1672671271,1598
7709,3304056063,3501601840,1672532877,1672535473,2596
7930,3296471982,3298433163,1672577994,1672578551,557
7828,3828365570,3533626375,1672566473,1672569922,3449
7513,3517963492,3701967560,1672689135,1672689971,836
7675,3736786443,3201324715,1672637646,1672639964,2318
7525,3500578848,3505649239,1672640649,1672641497,848
7812,3889232789,3481647420,1672612272,1672614095,1823
7923,3407725581,3975287541,1672577930,1672579846,1916
7828,3377766165,3760569731,1672693996,1672694802,806
7568,3780365428,3713644518,1672670494,1672671571,1077
7664,3518791447,3516673015,1672697850,1672698201,351
7854,3757562897,3303705369,1672613439,1672613852,413
7744,3909238838,3756528686,1672560189,1672562127,1938
7510,3517963492,3922275620,1672619127,1672622367,3240
7845,3416427576,3736790081,1672624709,1672625127,418
7795,3511267139,3389115045,1672691565,1672692319,754
7594,3505599848,3280964728,1672585726,1672586231,505
7670,3886298125,3777477395,1672592126,1672592303,177
7891,3777514571,3509634629,1672649673,1672651857,2184
7485,3770763956,3895562476,1672654745,1672655324,579
7873,3273500349,3935127663,1672615110,1672616256,1146
7777,3244485293,3517509185,1672618846,1672620461,1615
7812,3399433690,3465202715,1672621619,1672622235,616
7794,3311065516,3828624701,1672620123,1672621164,1041
7881,3880310724,3351008918,1672596538,1672599633,3095
7586,3736592744,3666507626,1672593961,1672594278,317
7658,3715189301,3416241005,1672677577,1672678430,853
7940,3484995752,3519803045,1672667414,1672669792,2378
7795,3515125508,3234362962,1672549129,1672551372,2243
7738,3516065852,3778308417,1672576287,1672578772,2485
7876,3510703546,3319752091,1672600939,1672602129,1190
7584,3511862351,3384951177,1672551923,1672553797,1874
7948,3756623396,3400918687,1672613593,1672615986,2393
7842,3247780536,3500578848,1672608516,1672609982,1466
7923,3516223597,3606987130,1672541379,1672544855,3476
7931,3311065516,3247428249,1672593694,1672593954,260
7742,3388372715,3388286531,1672561722,1672563685,1963
7513,3249401741,3711569060,1672552477,1672554694,2217
7751,3660493209,3533242305,1672681637,1672681879,242
7861,3713786889,3606987130,1672697225,1672700762,3537
7533,3887270940,3772714862,1672542337,1672545353,3016
7969,3514283243,3345207877,1672587715,1672588898,1183
7817,3792253549,3666457294,1672651900,1672655471,3571
7960,3512837326,3979339287,1672608316,1672609073,757
7705,3475795792,3834257412,1672579008,1672579323,315
7491,3473562469,3429690204,1672637964,1672639825,1861
7600,3902278226,3772578994,1672566321,1672566529,208
7520,3388637594,3500365158,1672665965,1672666705,740
7596,3416241005,3604539807,1672666245,1672668845,2600
7869,3714197325,3936227020,1672595807,1672598433,2626
7551,3886298125,3311439795,1672609635,1672609970,335
7814,3406784491,3701995648,1672545017,1672545962,945
7544,3552314511,3755625324,1672535290,1672537014,1724
7686,3774520233,3517255726,1672672712,1672672841,129
7791,3715492942,3817316561,1672695439,1672695970,531
7514,3394539273,3777776687,1672578560,1672579648,1088
7803,3509634629,3500066230,1672681583,1672683908,2325
7579,3360993964,3827626797,1672559855,1672562327,2472
7757,3278365525,3827626797,1672631060,1672631286,226
7673,3434642576,3777806071,1672636294,1672637606,1312
7814,3420432297,3904408902,1672543622,1672546380,2758
7672,3318166135,3770021824,1672676774,1672677380,606
7915,3780974443,3511435497,1672533133,1672536437,3304
7516,3515691540,3773598056,1672663009,1672664883,1874
7936,3286658957,3485008994,1672572284,1672572372,88
7830,3780788622,3756966035,1672662376,1672663737,1361
7828,3412825109,3774580701,1672703073,1672704504,1431
7793,3473765852,3510937904,1672569293,1672569661,368
7518,3975287541,3773598056,1672644017,1672645021,1004
7638,3859525941,3433804879,1672649351,1672651537,2186
7948,3516011407,3736419952,1672594109,1672594885,776
7564,3511332835,3511435497,1672621072,1672624609,3537
7938,3534702203,3780788622,1672575021,1672578541,3520
7650,3301107849,3520012395,1672600401,1672601110,709
7751,3505962865,3378092448,1672584998,1672588320,3322
7955,3783925755,3289061738,1672578207,1672578368,161
7604,3757682496,3757161914,1672680652,1672684057,3405
7558,3760569731,3520931254,1672589963,1672592109,2146
7617,3520012395,3802367797,1672672071,1672674193,2122
7520,3512683609,3793470489,1672581245,1672581689,444
7911,3731106822,3416427576,1672638992,1672642269,3277
7584,3667680268,3713630656,1672622446,1672626038,3592
7565,3972709319,3287105466,1672693853,1672696330,2477
7557,3713644518,3222521619,1672593896,1672594145,249
7810,3280615985,3703789494,1672655227,1672655529,302
7901,3791594391,3800353779,1672541392,1672543989,2597
7951,3811171116,3736419952,1672655672,1672655927,255
7521,3534702203,3780813786,1672624814,1672628035,3221
7762,3668898102,3815508790,1672662239,1672664047,1808
7594,3932051427,3780294829,1672657086,1672658384,1298
7809,3534010629,3400804807,1672615990,1672616179,189
7593,3760569731,3701498253,1672552369,1672555235,2866
7872,3836573197,3772337814,1672542653,1672543757,1104
7956,3514987389,3770851318,1672535902,1672536063,161
7650,3779740455,3331845324,1672634556,1672637316,2760
7803,3433804879,3755881905,1672664678,1672667983,3305
7946,3633420270,3826415738,1672699917,1672702593,2676
7515,3516065852,3932051427,1672619781,1672623010,3229
7485,3316222192,3311090974,1672531347,1672531695,348
7700,3817621391,3201848640,1672550762,1672551310,548
7892,3493507965,3780974443,1672675057,1672677363,2306
7971,3277605882,3792768129,1672695035,1672697049,2014
7658,3514987389,3228165483,1672558491,1672558643,152
7675,3352603894,3229058858,1672586719,1672589598,2879
7653,3311415018,3248507722,1672697418,1672700208,2790
7900,3367902229,3510771358,1672629701,1672630000,299
7491,3518669703,3519601612,1672572798,1672573729,931
7681,3617734118,3756623396,1672623928,1672625371,1443
7533,3616944364,3792902982,1672545418,1672548226,2808
7535,3736786443,3703275621,1672688224,1672691074,2850
7950,3755042098,3505869747,1672631449,1672632702,1253
7585,3534488837,3360743849,1672665040,1672668095,3055
7952,3902278226,3417587765,1672536325,1672537871,1546
7688,3311439795,3608633356,1672689703,1672690791,1088
7698,3500066230,3220716272,1672672157,1672672410,253
7523,3770824086,3791020967,1672686120,1672686736,616
7935,3520888296,3516980378,1672631674,1672633954,2280
7861,3467773920,3509672210,1672594525,1672596321,1796
7761,3899204805,3770021824,1672590129,1672591568,1439
7907,3505702787,3311324983,1672561388,1672562070,682
7541,3247815299,3715492942,1672685348,1672686118,770
7981,3392121505,3400804807,1672615614,1672617978,2364
7917,3505599848,3227457126,1672644112,1672646027,1915
7682,3505292701,3297463265,1672588604,1672589617,1013
7591,3829232696,3411618230,1672542060,1672544442,2382
7571,3770763956,3711380716,1672663272,1672665887,2615
7762,3297463265,3770635361,1672575962,1672578024,2062
7741,3451432842,3777455223,1672694030,1672696574,2544
7851,3903009525,3505135325,1672665403,1672667213,1810
7930,3338703270,3505635228,1672617128,1672617483,355
7708,3417061462,3826760240,1672696672,1672699506,2834
7957,3520719611,3772884106,1672700772,1672702656,1884
7917,3533371364,3805342762,1672700338,1672700631,293
7867,3505530961,3733189298,1672588632,1672591387,2755
7723,3427219654,3518360734,1672678923,1672680065,1142
7683,3370636709,3793389510,1672533735,1672536664,2929
7696,3232962003,3909606423,1672610398,1672612651,2253
7953,3473562469,3346327502,1672537019,1672538251,1232
7494,3336742544,3774050956,1672595784,1672596999,1215
7963,3714504419,3399004969,1672602453,1672603121,668
7579,3520190170,3924549929,1672560884,1672563700,2816
7952,3701967560,3446948848,1672604291,1672604653,362
7834,3909331423,3801089989,1672650633,1672654184,3551
7872,3505347134,3520719611,1672637626,1672640481,2855
7651,3383661227,3773755137,1672574857,1672575551,694
7599,3510126867,3311203656,1672639683,1672640579,896
7982,3733189298,3770824086,1672703729,1672704097,368
7767,3505869747,3358871377,1672601507,1672602316,809
7854,3756021689,3757562897,1672562211,1672564137,1926
7725,3829232696,3510594211,1672549375,1672552442,3067
7896,3780639480,3621810464,1672699120,1672701456,2336
7690,3511271692,3229665776,1672600180,1672602664,2484
7685,3833889105,3533927138,1672563917,1672564984,1067
7893,3780639480,3664517356,1672576499,1672579000,2501
7645,3711569060,3607748895,1672609322,1672609554,232
7600,3489728806,3515151980,1672568872,1672571201,2329
7749,3703871468,3826759140,1672615476,1672618706,3230
7608,3777776687,3516065852,1672545985,1672548118,2133
7944,3365830990,3395152943,1672551910,1672553234,1324
7579,3344364444,3534191820,1672573063,1672574459,1396
7782,3509453566,3520183192,1672591323,1672594388,3065
7831,3244389794,3519703355,1672638941,1672641506,2565
7656,3384240055,3703013906,1672631596,1672632620,1024
7533,3899371911,3715127362,1672538609,1672539676,1067
7487,3773598056,3932051427,1672601615,1672602341,726
7937,3418534998,3783083229,1672703432,1672705241,1809
7822,3610695419,3774501422,1672560774,1672562865,2091
7897,3519700826,3916289176,1672689849,1672690302,453
7939,3311871871,3859663348,1672677373,1672679494,2121
7875,3885670556,3755511676,1672531379,1672533236,1857
7567,3664170666,3304625412,1672656135,1672657942,1807
7513,3249791738,3716488385,1672553371,1672554709,1338
7897,3554917400,3885670556,1672537710,1672540729,3019
7689,3505219850,3793962300,1672566536,1672567533,997
7770,3901990690,3626156564,1672684633,1672685078,445
7902,3779740455,3519912874,1672620116,1672621115,999
7571,3611150562,3627937312,1672614238,1672616343,2105
7903,3710098970,3291227780,1672661745,1672665023,3278
7969,3428006164,3331845324,1672533833,1672534891,1058
7493,3228165483,3633420270,1672594174,1672594417,243
7586,3920801189,3517255726,1672695584,1672698483,2899
7693,3774339795,3780503655,1672618501,1672619622,1121
7874,3829764737,3399052055,1672666068,1672668189,2121
7972,3915628728,3420432297,1672674386,1672674992,606
7702,3405494240,3777717988,1672601645,1672604032,2387
7829,3773120434,3500904641,1672702055,1672704223,2168
7768,3613995936,3494290908,1672680540,1672683117,2577
7638,3478194807,3516980378,1672654619,1672655333,714
7904,3774339795,3509453566,1672585295,1672585664,369
7938,3407954858,3733891182,1672633837,1672635349,1512
7548,3311648200,3760893269,1672536816,1672538015,1199
7735,3780914982,3774339795,1672686095,1672686180,85
7958,3534729133,3206593906,1672667793,1672669756,1963
7887,3202120784,3316222192,1672592393,1672595683,3290
7523,3817621391,3517077106,1672620787,1672621111,324
7602,3311203656,3511312803,1672657408,1672658156,748
7494,3921211276,3756027749,1672648321,1672650231,1910
7915,3496269445,3634995491,1672625657,1672625862,205
7900,3634995491,3883042241,1672682105,1672683356,1251
7752,3501483568,3883085535,1672577451,1672580312,2861
7838,3311993075,3513956646,1672575644,1672577903,2259
7626,3428674539,3756424865,1672683212,1672683326,114
7483,3755042098,3391915121,1672553310,1672555574,2264
7651,3776066388,3639847263,1672613788,1672614251,463
7936,3511332835,3826760240,1672642123,1672643575,1452
7594,3791115967,3777790718,1672648110,1672649336,1226
7804,3276640712,3703275621,1672643642,1672643705,63
7906,3773598056,3778980116,1672554383,1672556483,2100
7640,3446948848,3500894271,1672665889,1672666476,587
7884,3715998609,3235287260,1672662409,1672663368,959
7625,3201432789,3384951177,1672640687,1672644148,3461
7797,3515125508,3701178711,1672681608,1672682135,527
7684,3297463265,3922275620,1672672997,1672675866,2869
7954,3715974031,3829764737,1672610233,1672613212,2979
7665,3511862351,3777455223,1672634633,1672637956,3323
7620,3625274012,3534488837,1672549565,1672550895,1330
7575,3770078063,3485008994,1672595271,1672596511,1240
7522,3336742544,3372883226,1672593870,1672594205,335
7930,3855602893,3857349323,1672670851,1672673620,2769
7686,3519803045,3736625083,1672634303,1672636701,2398
7891,3273500349,3316173088,1672607286,1672608397,1111
7677,3512142794,3392121505,1672659592,1672663134,3542
7901,3520706195,3883042241,1672659866,1672663175,3309
7848,3311993075,3439023335,1672567070,1672569382,2312
7487,3832902928,3359910781,1672639057,1672642091,3034
7502,3777717988,3365614305,1672559564,1672560927,1363
7721,3773429448,3534702203,1672703266,1672706182,2916
7741,3509630174,3234541252,1672701165,1672701248,83
7557,3358871377,3284832486,1672619594,1672620179,585
7786,3760569731,3777983879,1672698216,1672701527,3311
7700,3554917400,3688683847,1672551473,1672553393,1920
7803,3739106581,3533827120,1672628075,1672631441,3366
7803,3515125508,3898995675,1672619569,1672619893,324
7975,3970117174,3520730271,1672630526,1672630661,135
7785,3713644518,3757602960,1672622712,1672625838,3126
7569,3433804879,3430504438,1672662151,1672664022,1871
7910,3760489031,3200691026,1672702836,1672703137,301
7903,3710344260,3500229033,1672601730,1672604400,2670
7532,3811171116,3756027749,1672558462,1672560061,1599
7719,3402943525,3289061738,1672702141,1672705016,2875
7516,3793871337,3662180254,1672561636,1672564468,2832
7573,3711265369,3500487333,1672576100,1672578783,2683
7661,3533827120,3500199935,1672654602,1672657265,2663
7788,3820354437,3772309150,1672596346,1672597293,947
7595,3505203158,3791874383,1672621403,1672624411,3008
7806,3770763956,3783779671,1672628588,1672632056,3468
7904,3883312122,3520888296,1672532312,1672532916,604
7653,3778308417,3515125508,1672588925,1672591856,2931
7574,3390068992,3734828619,1672555941,1672558672,2731
7977,3438645253,3883042241,1672645222,1672646122,900
7960,3401627165,3774195321,1672595584,1672598084,2500
7522,3505904952,3513599775,1672608494,1672612068,3574
7772,3518791447,3777929708,1672531504,1672534018,2514
7634,3805292782,3513080274,1672684393,1672687223,2830
7645,3516465662,3755511676,1672557445,1672560671,3226
7687,3407725581,3792768129,1672618104,1672619874,1770
7619,3234541252,3500904641,1672699257,1672699506,249
7945,3791115967,3610695419,1672634709,1672635672,963
7733,3505791599,3829764737,1672614802,1672615862,1060
7587,3513454145,3972709319,1672578409,1672581222,2813
7634,3853018906,3855000166,1672573156,1672576580,3424
7767,3426325549,3311761694,1672682093,1672685110,3017
7640,3783206719,3478194807,1672558038,1672561409,3371
7810,3777443199,3756930948,1672559210,1672562652,3442
7755,3780365428,3780788622,1672594389,1672597869,3480
7630,3336751428,3505912939,1672647952,1672650825,2873
7940,3760183458,3249791738,1672627162,1672627875,713
7691,3232962003,3517459919,1672560611,1672561705,1094
7684,3424922204,3246596716,1672666649,1672667721,1072
7895,3516606733,3778549126,1672575025,1672578114,3089
7723,3291883916,3356860407,1672687143,1672690539,3396
7951,3279721246,3634995491,1672631713,1672632792,1079
7567,3808324264,3533369198,1672644531,1672644951,420
7893,3634340855,3485823740,1672553780,1672556450,2670
7817,3533137446,3428006164,1672626846,1672626998,152
7576,3477649378,3936227020,1672563441,1672566294,2853
7569,3819727225,3500177712,1672588945,1672591454,2509
7533,3485823740,3714197325,1672557748,1672558624,876
7685,3772359096,3780365428,1672666231,1672668299,2068
7842,3312333615,3505962865,1672595388,1672598724,3336
7876,3365278081,3917278625,1672596905,1672600117,3212
7908,3244485293,3500177712,1672624233,1672624454,221
7884,3880285638,3793338102,1672693636,1672695249,1613
7565,3516016437,3793338102,1672604395,1672605709,1314
7972,3244436890,3505530961,1672675987,1672676171,184
7952,3485823740,3500199935,1672621625,1672624632,3007
7798,3793871337,3791020967,1672644937,1672646247,1310
7918,3415443558,3792473331,1672561838,1672564236,2398
7891,3478194807,3378686918,1672594599,1672597046,2447
7529,3703661585,3711571712,1672629283,1672632625,3342
7902,3533626375,3711571712,1672568290,1672569388,1098
7825,3510380060,3826760240,1672553443,1672554395,952
7645,3412825109,3420700674,1672693792,1672693992,200
7745,3827377568,3783239924,1672576505,1672579054,2549
7728,3510247121,3774204963,1672609831,1672613274,3443
7640,3277669002,3715339701,1672662255,1672665604,3349
7973,3773978034,3200198928,1672683885,1672686381,2496
7873,3276993580,3755625324,1672556508,1672556835,327
7509,3666553782,3736592744,1672544738,1672546283,1545
7515,3201848640,3774268456,1672612694,1672613876,1182
7636,3827222533,3715981584,1672612292,1672615471,3179
7658,3827377568,3917088658,1672683935,1672686196,2261
7601,3432665384,3407725581,1672587710,1672590039,2329
7818,3755943611,3390068992,1672534596,1672536771,2175
7548,3703955926,3826759140,1672593327,1672595112,1785
7657,3365278081,3516016437,1672677778,1672678161,383
7904,3805292782,3805347939,1672645374,1672647195,1821
7695,3510857360,3511687358,1672552244,1672555642,3398
7949,3417970574,3505477652,1672668511,1672670450,1939
7903,3829764737,3519703355,1672665737,1672667309,1572
7621,3975287541,3780593036,1672542246,1672542647,401
7833,3617055293,3853018906,1672686565,1672686916,351
7871,3688418210,3828432634,1672538613,1672541771,3158
7904,3703661585,3816454165,1672676061,1672679159,3098
7512,3513599775,3316222192,1672665470,1672667421,1951
7884,3776800213,3473562469,1672632763,1672633365,602
7863,3858918246,3733189298,1672686668,1672687673,1005
7684,3409474775,3380035798,1672601722,1672602279,557
7820,3777983879,3783206719,1672588445,1672590750,2305
7911,3714488548,3885670556,1672657534,1672658504,970
7624,3760183458,3296471982,1672616734,1672616901,167
7923,3918674986,3937224533,1672644066,1672645297,1231
7854,3511170269,3783925755,1672595396,1672598624,3228
7796,3760489031,3510703546,1672613614,1672615563,1949
7770,3311648200,3885897503,1672618216,1672619847,1631
7963,3783429780,3277605882,1672576710,1672578860,2150
7570,3533371364,3289061738,1672545106,1672547751,2645
7837,3249401741,3890149705,1672626330,1672627600,1270
7927,3311090974,3701967560,1672699449,1672700047,598
7528,3930791338,3756451663,1672583160,1672586453,3293
7500,3777623166,3222448362,1672634465,1672636741,2276
7526,3773814927,3467773920,1672541887,1672542603,716
7689,3409474775,3791997875,1672659486,1672662519,3033
7518,3533371364,3370636709,1672559456,1672559652,196
7888,3304625412,3505193212,1672664658,1672665198,540
7718,3432665384,3200198928,1672645044,1672646785,1741
7837,3716273414,3209048907,1672663759,1672665759,2000
7831,3515723720,3472130842,1672604095,1672607527,3432
7964,3774520233,3606186086,1672621491,1672622456,965
7760,3367029997,3614238812,1672671033,1672672575,1542
7593,3500904641,3534553510,1672583947,1672585899,1952
7661,3715981584,3760294205,1672563164,1672565579,2415
7767,3224716315,3792844210,1672563464,1672566066,2602
7628,3501927421,3711380716,1672621031,1672623013,1982
7710,3421836608,3783779671,1672701538,1672704680,3142
7953,3473765852,3836573197,1672663270,1672666490,3220
7825,3780593036,3331845324,1672698595,1672699672,1077
7600,3360506772,3356860407,1672568720,1672570769,2049
7514,3339907603,3760509236,1672684359,1672686295,1936
7702,3512217942,3809484172,1672646836,1672650036,3200
7755,3713894336,3533025282,1672664816,1672667315,2499
7879,3273500349,3921211276,1672636855,1672639465,2610
7627,3345207877,3783531004,1672595060,1672595295,235
7562,3296471982,3918584946,1672661215,1672663222,2007
7870,3415546117,3552314511,1672620194,1672620862,668
7653,3780294829,3772884106,1672569923,1672570427,504
7627,3716165213,3439023335,1672641170,1672642783,1613
7629,3939952128,3931941795,1672700086,1672701038,952
7491,3778305740,3311274543,1672675422,1672677933,2511
7886,3829319703,3307512479,1672650450,1672651960,1510
7553,3511163800,3779036831,1672598595,1672600519,1924
7785,3887270940,3513080274,1672658202,1672658307,105
7919,3312333615,3734496778,1672654220,1672656879,2659
7490,3517255726,3770635361,1672569457,1672570955,1498
7574,3206603608,3516673015,1672636660,1672640192,3532
7552,3772884106,3516629436,1672611543,1672613210,1667
7502,3770078063,3716273414,1672548576,1672551542,2966
7964,3783509527,3533385867,1672617113,1672619129,2016
7833,3516223597,3757455053,1672611476,1672612055,579
7842,3383922351,3515860749,1672554936,1672557007,2071
7513,3829232696,3772053179,1672560930,1672563689,2759
7924,3634786711,3806545488,1672694351,1672696931,2580
7929,3346795719,3613995936,1672638100,1672640013,1913
7890,3711569060,3933210486,1672632277,1672634707,2430
7680,3391915886,3412825109,1672571298,1672573966,2668
7563,3629547065,3407725581,1672616098,1672617449,1351
7615,3517864478,3466229085,1672701632,1672703160,1528
7570,3314836094,3806545488,1672637551,1672639710,2159
7538,3792768129,3852595551,1672648404,1672649071,667
7898,3501483568,3793959750,1672649769,1672652873,3104
7942,3394539273,3351008918,1672546901,1672549677,2776
7878,3624312512,3636867411,1672589987,1672591401,1414
7580,3379589402,3918584946,1672670142,1672673513,3371
7644,3756021689,3755392666,1672539487,1672542365,2878
7490,3316173088,3404058699,1672567334,1672570237,2903
7957,3519912874,3401627165,1672559884,1672561969,2085
7750,3359239884,3613683164,1672633538,1672636324,2786
7704,3206603608,3510711755,1672630778,1672632292,1514
7654,3713370078,3703013906,1672621608,1672624605,2997
7781,3713370078,3505649239,1672680664,1672682934,2270
7968,3855937514,3773978034,1672662783,1672662930,147
7960,3913251733,3392121505,1672700523,1672701946,1423
7841,3519700826,3443698222,1672581795,1672584598,2803
7789,3701498253,3783429780,1672654542,1672655518,976
7750,3387966152,3365614305,1672558596,1672561904,3308
7882,3201324715,3780914982,1672675698,1672676864,1166
7627,3377766165,3823600322,1672679880,1672680543,663
7720,3829764737,3513164386,1672694997,1672697321,2324
7866,3791942683,3509634629,1672561410,1672564201,2791
7566,3933210486,3774793839,1672651338,1672652465,1127
7565,3559110998,3701984666,1672537201,1672539515,2314
7626,3755436115,3505347134,1672602150,1672605364,3214
7628,3311152102,3280615985,1672655712,1672658686,2974
7509,3885670556,3779740455,1672608095,1672610106,2011
7646,3496549058,3777776687,1672537067,1672540495,3428
7818,3909606423,3683766533,1672620377,1672622918,2541
7778,3485823740,3777623166,1672636812,1672637532,720
7781,3710408395,3852595551,1672539324,1672542395,3071
7585,3793753089,3400918687,1672685359,1672687312,1953
7604,3791594391,3236102733,1672532333,1672532602,269
7896,3773205565,3501692334,1672593008,1672594555,1547
7945,3242408357,3809059934,1672560602,1672561710,1108
7888,3774793839,3234362962,1672594171,1672595451,1280
7667,3776948966,3466911760,1672575177,1672576906,1729
7486,3519703355,3500904641,1672627488,1672630082,2594
7568,3793338102,3617055293,1672683213,1672685669,2456
7603,3518360734,3711198793,1672600009,1672601307,1298
7725,3774520233,3345207877,1672667712,1672670076,2364
7675,3360993964,3783196518,1672697609,1672699060,1451
7753,3792883665,3777455223,1672571680,1672571913,233
7848,3930791338,3416265063,1672617814,1672618951,1137
7728,3911159965,3801089989,1672680632,1672683869,3237
7786,3911159965,3776513891,1672637618,1672639679,2061
7898,3925402713,3772642849,1672628040,1672630242,2202
7967,3344364444,3837094550,1672578855,1672581455,2600
7952,3818255890,3511332835,1672689142,1672690926,1784
7924,3701984666,3756027749,1672608952,1672609780,828
7969,3489728806,3777455223,1672554055,1672556498,2443
7778,3400918687,3533827120,1672615314,1672618312,2998
7559,3404384505,3793436995,1672582890,1672585080,2190
7636,3388372715,3701691675,1672668620,1672671612,2992
7846,3773120434,3228165483,1672599163,1672600226,1063
7883,3511198618,3333896808,1672680735,1672680932,197
7822,3505962865,3918674986,1672614182,1672616110,1928
7671,3822654369,3774338212,1672570062,1672571998,1936
7559,3501601840,3819727225,1672639569,1672642336,2767
7646,3509634629,3715998609,1672567595,1672568751,1156
7698,3520190170,3772714862,1672694962,1672697221,2259
7810,3348261553,3399052055,1672556055,1672557583,1528
7508,3779740455,3885670556,1672554297,1672555607,1310
7802,3813052709,3220716272,1672701171,1672701710,539
7511,3703789494,3339907603,1672567912,1672570893,2981
7841,3534729133,3883085535,1672607464,1672610582,3118
7935,3859525941,3475795792,1672676474,1672677031,557
7885,3395152943,3415443558,1672533359,1672536276,2917
7667,3454042520,3778341199,1672559522,1672562925,3403
7978,3365942576,3904775198,1672633668,1672636344,2676
7574,3533280269,3834257412,1672637810,1672637934,124
7855,3888559320,3427219654,1672540036,1672543177,3141
7510,3516960534,3232962003,1672667749,1672669678,1929
7841,3511312803,3389115045,1672670910,1672672021,1111
7717,3770101921,3760267716,1672532062,1672534111,2049
7678,3777717988,3453729665,1672578677,1672579867,1190
7522,3736229191,3711569060,1672580526,1672581637,1111
7626,3399535232,3518669703,1672703089,1672703425,336
7526,3666457294,3433804879,1672619134,1672622339,3205
7906,3913251733,3407673904,1672603187,1672606134,2947
7903,3800353779,3885897503,1672697750,1672699773,2023
7698,3520012395,3404384505,1672665705,1672666822,1117
7704,3756451663,3715492942,1672588652,1672591467,2815
7707,3711571712,3918247820,1672646646,1672649492,2846
7654,3509453566,3755511676,1672576426,1672578510,2084
7565,3500229033,3613683164,1672591843,1672592627,784
7841,3209048907,3383661227,1672594316,1672596475,2159
7850,3757455053,3772642849,1672609231,1672610270,1039
7749,3505193212,3361230905,1672587448,1672590789,3341
7581,3505203158,3397418363,1672637724,1672639936,2212
7823,3516016437,3731106822,1672622859,1672626430,3571
7827,3713808837,3882997884,1672629019,1672632048,3029
7906,3770447408,3520629279,1672537189,1672538936,1747
7611,3311871871,3793086311,1672699605,1672700110,505
7579,3489217083,3500229033,1672623307,1672623456,149
7951,3336751428,3793848402,1672669203,1672670209,1006
7688,3222521619,3512969370,1672594826,1672596449,1623
7554,3976633198,3501692334,1672676193,1672679390,3197
7924,3223789409,3760183458,1672562194,1672565686,3492
7949,3443698222,3510173870,1672590886,1672592317,1431
7487,3318697153,3417970574,1672553348,1672556296,2948
7819,3777120536,3792473331,1672675994,1672678687,2693
7940,3509672210,3774127586,1672640688,1672641982,1294
7907,3473562469,3500458761,1672687425,1672688256,831
7766,3489728806,3345207877,1672642393,1672642883,490
7580,3914290246,3418728074,1672631512,1672633907,2395
7522,3378092448,3783705817,1672683147,1672686124,2977
7768,3777443199,3779976989,1672594004,1672594374,370
7898,3731419510,3668005723,1672649609,1672652517,2908
7520,3451432842,3852595551,1672617770,1672620259,2489
7947,3399052055,3780503655,1672670468,1672671420,952
7751,3471220483,3776338577,1672606045,1672606763,718
7650,3855602893,3666457294,1672668747,1672668881,134
7545,3500487333,3200198928,1672598679,1672602021,3342
7851,3512837326,3533369198,1672583822,1672585369,1547
7630,3738502357,3407954858,1672622105,1672625629,3524
7967,3714474557,3806545488,1672625669,1672627147,1478
7618,3500391167,3505292701,1672699413,1672700247,834
7613,3738274418,3701184889,1672574044,1672576307,2263
7533,3509630174,3367902229,1672696771,1672698818,2047
7714,3201848640,3912536808,1672640389,1672643205,2816
7648,3516629436,3244436890,1672661488,1672664864,3376
7917,3770101921,3520629279,1672531573,1672533990,2417
7848,3428674539,3703889596,1672585891,1672588702,2811
7845,3883551721,3757161914,1672631420,1672632001,581
7879,3488244966,3616944364,1672605642,1672606093,451
7649,3434642576,3760893269,1672538054,1672539902,1848
7957,3534488837,3886298125,1672612932,1672614886,1954
7508,3518791447,3400918687,1672682004,1672683477,1473
7597,3520719611,3770851318,1672667658,1672671235,3577
7538,3291235378,3760489031,1672553328,1672555804,2476
7744,3505962865,3774127586,1672671333,1672672940,1607
7727,3399535232,3384240055,1672578380,1672578918,538
7933,3902278226,3556951786,1672574730,1672578131,3401
7746,3773814927,3517864478,1672551046,1672554010,2964
7955,3518014404,3625274012,1672636278,1672637958,1680
7617,3776338577,3792768129,1672600936,1672601440,504
7744,3512837326,3500904641,1672692951,1672695912,2961
7692,3373384732,3307097200,1672611242,1672611375,133
7509,3280599164,3516465662,1672580033,1672582402,2369
7685,3373384732,3505873261,1672607059,1672607388,329
7704,3512969370,3922275416,1672623179,1672623900,721
7921,3505973226,3639847263,1672699266,1672700164,898
7574,3446948848,3711308224,1672563265,1672565858,2593
7769,3701190899,3208844525,1672644975,1672648192,3217
7653,3883042241,3277669002,1672543933,1672547087,3154
7540,3714474557,3500458761,1672695574,1672696011,437
7930,3756966035,3920801189,1672555830,1672556921,1091
7806,3517509185,3304625412,1672603152,1672605994,2842
7965,3774338212,3890149705,1672623543,1672625586,2043
7800,3778780511,3770851318,1672684914,1672685731,817
7785,3774195321,3510126867,1672655594,1672658741,3147
7687,3757602960,3978115672,1672600810,1672604002,3192
7902,3783206719,3516716179,1672613312,1672616194,2882
7532,3505649239,3533827120,1672551609,1672553083,1474
7613,3416265063,3899204805,1672649140,1672651203,2063
7683,3793871337,3783196518,1672589356,1672590146,790
7817,3349613093,3818255890,1672699016,1672699720,704
7698,3511312803,3510771358,1672639637,1672642053,2416
7869,3881477378,3774580701,1672536855,1672538653,1798
7570,3895562476,3883861463,1672684731,1672686285,1554
7578,3736625083,3515691540,1672696741,1672697795,1054
7846,3430504438,3512510536,1672569319,1672572726,3407
7973,3505193212,3701967560,1672655806,1672659339,3533
7600,3511687358,3356860407,1672554329,1672555348,1019
7768,3738274418,3792288302,1672697375,1672698615,1240
7709,3511435497,3359910781,1672600389,1672601586,1197
7810,3304056063,3731106822,1672655557,1672658528,2971
7661,3509933351,3458539365,1672635923,1672636397,474
7561,3793436995,3373384732,1672650827,1672652890,2063
7694,3384951177,3311439795,1672619054,1672621488,2434
7662,3783509527,3220716272,1672653827,1672655004,1177
7621,3922275416,3882242815,1672579068,1672582517,3449
7928,3485823740,3297463265,1672651399,1672653574,2175
7713,3517476351,3311415018,1672596621,1672598326,1705
7670,3806545488,3773205565,1672644924,1672648161,3237
7740,3519428855,3774005526,1672664792,1672666283,1491
7639,3613995936,3304056063,1672561976,1672564310,2334
7604,3400918687,3480687894,1672615088,1672618321,3233
7926,3772337814,3434642576,1672687136,1672690381,3245
7979,3533748232,3412825109,1672676235,1672679521,3286
7981,3511359172,3311324983,1672619147,1672619303,156
7939,3416241005,3777929708,1672534690,1672537519,2829
7701,3820354437,3509604974,1672690932,1672693408,2476
7838,3791594391,3394330287,1672612082,1672614910,2828
7526,3783196518,3509453566,1672686890,1672688345,1455
7613,3384240055,3477375368,1672600949,1672601442,493
7778,3511163800,3805292782,1672620590,1672622225,1635
7843,3360506772,3615046771,1672535226,1672538564,3338
7848,3533385867,3336751428,1672690256,1672692166,1910
7692,3806545488,3853018906,1672683501,1672684305,804
7585,3384951177,3311152102,1672532666,1672534005,1339
7872,3933210486,3736625083,1672670119,1672671234,1115
7706,3703735129,3880285638,1672630823,1672633576,2753
7933,3760569731,3918056059,1672652484,1672653763,1279
7716,3517459919,3716165213,1672589718,1672592988,3270
7759,3757246925,3384240055,1672539028,1672541466,2438
7713,3627937312,3520030713,1672549525,1672552964,3439
7908,3407954858,3756021689,1672593109,1672594330,1221
7764,3792902982,3666553782,1672626994,1672628372,1378
7752,3716258994,3793962300,1672591209,1672591600,391
7849,3666507626,3505201246,1672553696,1672555165,1469
7694,3760598102,3533137446,1672699956,1672702865,2909
7928,3783429780,3249247700,1672690474,1672691020,546
7750,3666506258,3429856982,1672586244,1672587502,1258
7783,3777120536,3235287260,1672608279,1672610203,1924
7609,3972709319,3770101921,1672538962,1672542472,3510
7622,3772642849,3520756859,1672596243,1672598983,2740
7815,3776800213,3774268456,1672602101,1672602741,640
7679,3756453423,3715581279,1672614148,1672614657,509
7717,3668005723,3774045700,1672695448,1672698398,2950
7671,3793848402,3316173088,1672552409,1672552814,405
7810,3829764737,3757812939,1672587704,1672590511,2807
7903,3351554343,3666507626,1672599311,1672599511,200
7982,3518408774,3367902229,1672663849,1672665973,2124
7855,3496051529,3511435497,1672627587,1672629475,1888
7610,3855602893,3512166013,1672532693,1672533066,373
7507,3611150562,3909606423,1672677831,1672679679,1848
7650,3772714862,3780503655,1672545141,1672546038,897
7773,3737051610,3852391257,1672581065,1672581650,585
7755,3509773875,3755920131,1672629131,1672630985,1854
7682,3667680268,3773465237,1672673784,1672674967,1183
7602,3418534998,3505912939,1672571317,1672573814,2497
7830,3534729133,3520719611,1672569223,1672570260,1037
7627,3807987001,3852595551,1672682390,1672684169,1779
7495,3811171116,3487171044,1672593868,1672595853,1985
7976,3287105466,3485008994,1672563162,1672564791,1629
7696,3227158514,3895562476,1672633426,1672635122,1696
7652,3829319703,3234362962,1672591937,1672593849,1912
7701,3772309166,3278365525,1672554255,1672555931,1676
7708,3291227780,3760893269,1672535351,1672538403,3052
7932,3517963492,3302626661,1672647033,1672648838,1805
7774,3388637594,3770101921,1672557196,1672559857,2661
7548,3351554343,3520719611,1672603243,1672605961,2718
7706,3311152102,3714488548,1672681141,1672683150,2009
7919,3703955926,3472130842,1672574714,1672576786,2072
7585,3388637594,3715127362,1672703768,1672705326,1558
7929,3311648200,3970117174,1672538659,1672539041,382
7630,3664170666,3899371911,1672545784,1672549084,3300
7780,3505219850,3296471982,1672570112,1672573134,3022
7700,3276993580,3412980697,1672657462,1672659572,2110
7889,3716258994,3374559242,1672585148,1672586427,1279
7840,3739106581,3606987130,1672549530,1672551811,2281
7955,3760569731,3501927421,1672577026,1672577784,758
7722,3610695419,3510711755,1672673306,1672674534,1228
7624,3901990690,3777790718,1672698328,1672701876,3548
7698,3604539807,3716488385,1672581927,1672582327,400
7702,3756451663,3287105466,1672578363,1672580260,1897
7840,3756601594,3517509185,1672557208,1672558000,792
7910,3505201246,3417970574,1672649334,1672650636,1302
7799,3365614305,3297463265,1672597114,1672600254,3140
7812,3505859863,3935627557,1672657324,1672658430,1106
7618,3249247700,3493507965,1672677144,1672677942,798
7908,3731106822,3783245561,1672650957,1672651421,464
7972,3249791738,3793871337,1672614915,1672617786,2871
7718,3517476351,3483164654,1672552627,1672553153,526
7888,3509907947,3832902928,1672679004,1672682064,3060
7973,3505173328,3500066230,1672681542,1672684431,2889
7512,3760492950,3716165213,1672689025,1672690046,1021
7766,3428006164,3757455053,1672680295,1672681312,1017
7951,3280964728,3808324264,1672550158,1672552003,1845
7829,3519912874,3298288268,1672590270,1672593720,3450
7947,3617055293,3903009525,1672621053,1672621867,814
7541,3291227780,3349613093,1672651225,1672654578,3353
7842,3421836608,3813052709,1672540707,1672544105,3398
7525,3279721246,3430504438,1672654506,1672657212,2706
7796,3773664987,3880285638,1672602364,1672603024,660
7634,3500658339,3826759140,1672679971,1672680225,254
7740,3511163800,3472130842,1672544237,1672545929,1692
7554,3500229033,3318697153,1672577541,1672577927,386
7803,3496269445,3513164386,1672663705,1672664853,1148
7969,3713268590,3800353779,1672545940,1672548400,2460
7562,3472130842,3792288302,1672592835,1672594789,1954
7726,3701498253,3304625412,1672648383,1672648854,471
7665,3311603601,3388637594,1672617125,1672618049,924
7514,3512510536,3421127249,1672666486,1672667214,728
7662,3313564074,3362000049,1672698105,1672701531,3426
7854,3346327502,3501486692,1672620735,1672622694,1959
7514,3760893269,3496269445,1672602310,1672603368,1058
7757,3757403279,3828365570,1672689674,1672690955,1281
7702,3816454165,3365942576,1672539784,1672541623,1839
7952,3774125065,3229058858,1672586922,1672588807,1885
7882,3852391257,3773978034,1672640247,1672643634,3387
7809,3911159965,3634340855,1672644811,1672646782,1971
7605,3249401741,3628819436,1672557163,1672558904,1741
7796,3777806071,3467773920,1672672201,1672673746,1545
7681,3505973226,3703871468,1672702792,1672704935,2143
7850,3613683164,3918674986,1672677023,1672677810,787
7539,3428964059,3311208440,1672623717,1672627086,3369
7612,3433804879,3392121505,1672620423,1672621278,855
7581,3880285638,3383661227,1672614026,1672617368,3342
7635,3881477378,3318697153,1672654101,1672655209,1108
7824,3887270940,3383661227,1672698074,1672699932,1858
7780,3628819436,3505869747,1672683906,1672684383,477
7898,3520756859,3475258557,1672605178,1672608763,3585
7709,3827222533,3209551760,1672678560,1672680257,1697
7514,3701691675,3734828619,1672622652,1672622784,132
7649,3886298125,3711380716,1672672226,1672673455,1229
7501,3510857360,3510173870,1672617549,1672620533,2984
7552,3510711755,3318166135,1672651800,1672654222,2422
7695,3244173074,3227158514,1672618473,1672618712,239
7959,3793871337,3505599848,1672608054,1672611512,3458
7961,3793086311,3510711755,1672608736,1672608861,125
7821,3783196518,3511312803,1672615464,1672615612,148
7553,3979339287,3801089989,1672697091,1672699443,2352
7654,3793753089,3770447408,1672652733,1672655598,2865
7560,3511687358,3610695419,1672628391,1672631091,2700
7608,3711262377,3791334389,1672603327,1672605816,2489
7618,3756453423,3232962003,1672571436,1672573324,1888
7532,3816853177,3826415738,1672619749,1672620861,1112
7531,3755739653,3909331423,1672535974,1672538274,2300
7656,3757562897,3780609808,1672534465,1672536325,1860
7647,3534010629,3519152550,1672659444,1672660586,1142
7822,3930797455,3773978034,1672547744,1672550791,3047
7861,3853018906,3493507965,1672641716,1672644421,2705
7859,3834257412,3505859863,1672570140,1672570998,858
7601,3710344260,3505859863,1672654926,1672657239,2313
7816,3556951786,3209551760,1672673277,1672676299,3022
7584,3852391257,3757812939,1672615876,1672616851,975
7573,3780914982,3793286136,1672555147,1672555600,453
7609,3792768129,3550946908,1672628514,1672629079,565
7835,3774556560,3792883665,1672596456,1672599896,3440
7964,3701274634,3277605882,1672637235,1672639769,2534
7686,3519428855,3772053179,1672629115,1672630937,1822
7709,3793959750,3513164386,1672547214,1672549329,2115
7979,3701065786,3711571712,1672606458,1672608508,2050
7492,3432665384,3777443199,1672536121,1672537042,921
7936,3510969660,3880285638,1672552662,1672555444,2782
7961,3770447408,3481647420,1672573915,1672576655,2740
7654,3221536550,3412825109,1672663054,1672664378,1324
7953,3534729133,3304056063,1672613598,1672614109,511
7926,3291235378,3777929708,1672623307,1672623908,601
7573,3534492426,3511687358,1672668363,1672668796,433
7860,3518408774,3776948966,1672608058,1672610876,2818
7556,3617055293,3377766165,1672625212,1672627554,2342
7654,3534313900,3779629905,1672546767,1672548007,1240
7627,3639847263,3556951786,1672642096,1672643587,1491
7830,3909238838,3757602960,1672628192,1672628708,516
7862,3829764737,3519152550,1672589195,1672591210,2015
7666,3666457294,3885897503,1672668057,1672671397,3340
7708,3533827120,3519563836,1672603826,1672606532,2706
7551,3783779671,3772309150,1672690707,1672693415,2708
7704,3921211276,3497901842,1672629589,1672631734,2145
7691,3220716272,3346795719,1672614826,1672617676,2850
7976,3505599848,3513201436,1672590408,1672591119,711
7967,3370752401,3550946908,1672636808,1672639775,2967
7858,3475251781,3682061100,1672606525,1672607408,883
7975,3621497531,3883042241,1672548843,1672549424,581
7790,3881477378,3819727225,1672618262,1672620648,2386
7720,3903307060,3501184421,1672596566,1672598724,2158
7630,3703275621,3316222192,1672566121,1672568641,2520
7566,3533927138,3633420270,1672686283,1672687832,1549
7567,3277605882,3772309166,1672701599,1672703894,2295
7606,3515394721,3360993964,1672601467,1672604959,3492
7624,3500060260,3475795792,1672679392,1672680192,800
7814,3379589402,3783531004,1672569422,1672569638,216
7624,3520751702,3774793839,1672674940,1672677582,2642
7852,3660493209,3311208440,1672550567,1672551775,1208
7550,3448855696,3703789494,1672540702,1672544132,3430
7695,3501759100,3346327502,1672633573,1672634269,696
7875,3629547065,3378092448,1672588673,1672589218,545
7533,3520165601,3833889105,1672638169,1672640428,2259
7572,3485823740,3370636709,1672606577,1672607753,1176
7610,3805347939,3626156564,1672615195,1672615518,323
7762,3387966152,3903962771,1672584877,1672587684,2807
7745,3407725581,3229665776,1672577385,1672577688,303
7496,3662180254,3716165213,1672612153,1672613984,1831
7780,3713969578,3777443199,1672570495,1672573815,3320
7769,3430352815,3357483218,1672645880,1672647568,1688
7962,3244173074,3909331423,1672672307,1672674619,2312
7786,3311090974,3777477395,1672546796,1672550161,3365
7746,3793753089,3534424200,1672698320,1672699505,1185
7638,3412980697,3500487333,1672701415,1672704504,3089
7565,3777929708,3915628728,1672587451,1672588212,761
7821,3806545488,3417587765,1672664746,1672666214,1468
7508,3248507722,3332072298,1672574723,1672577569,2846
7566,3783779671,3701184889,1672588808,1672590394,1586
7740,3701184889,3733891182,1672552852,1672556018,3166
7774,3311993075,3396285984,1672605084,1672608442,3358
7637,3626156564,3465202715,1672533799,1672535100,1301
7698,3293695955,3509604974,1672684111,1672687677,3566
7970,3519601612,3517509185,1672671461,1672675043,3582
7600,3388637594,3801089989,1672636643,1672637620,977
7598,3418728074,3518014404,1672558451,1672561454,3003
7885,3415443558,3739106581,1672557336,1672559465,2129
7523,3505635228,3633420270,1672642716,1672645758,3042
7823,3774298222,3427283336,1672569753,1672572034,2281
7974,3776338577,3312333615,1672605837,1672606632,795
7862,3409474775,3511163800,1672630342,1672631986,1644
7910,3311718847,3613995936,1672647426,1672649351,1925
7961,3772578994,3416427576,1672626461,1672629328,2867
7719,3235635976,3518014636,1672607345,1672608613,1268
7686,3249401741,3664170666,1672631865,1672634415,2550
7831,3756601594,3513080274,1672583766,1672585768,2002
7550,3509630174,3332072298,1672689021,1672690708,1687
7545,3222521619,3770078063,1672593372,1672593642,270
7647,3426325549,3716537575,1672604161,1672606054,1893
7689,3298288268,3512567240,1672666530,1672668449,1919
7617,3501486692,3903009525,1672700109,1672703167,3058
7790,3912262917,3780639480,1672596550,1672599053,2503
7648,3772309150,3332072298,1672661677,1672662755,1078
7772,3501364586,3773429448,1672569475,1672570674,1199
7932,3514719601,3732481297,1672568126,1672570734,2608
7865,3244389794,3516716179,1672650504,1672652636,2132
7876,3511312803,3756966035,1672567243,1672567545,302
7793,3399911573,3780294829,1672674629,1672677096,2467
7684,3392121505,3639847263,1672673233,1672673873,640
7556,3793338102,3505791599,1672625315,1672625870,555
7887,3518260334,3760561634,1672622913,1672623683,770
7554,3513599775,3518260334,1672591380,1672591704,324
7527,3515284591,3757161914,1672623502,1672623932,430
7538,3777120536,3910454786,1672688823,1672690814,1991
7749,3770635361,3715339701,1672643727,1672647270,3543
7760,3713644518,3832902928,1672675862,1672679447,3585
7909,3701178711,3827377568,1672586472,1672588897,2425
7717,3516629436,3273500349,1672635820,1672637188,1368
7584,3937224533,3791901535,1672604176,1672605096,920
7623,3703955926,3505973226,1672689097,1672689801,704
7915,3618045231,3516016437,1672682624,1672683460,836
7797,3770447408,3791115967,1672548532,1672549179,647
7884,3201432789,3399433690,1672598742,1672600516,1774
7516,3311761694,3791594391,1672570988,1672572136,1148
7974,3516606733,3774556560,1672604712,1672605704,992
7691,3685818092,3774010081,1672612191,1672613152,961
7839,3336751428,3387966152,1672536288,1672536999,711
7707,3277939457,3629547065,1672628637,1672631545,2908
7560,3360993964,3397418363,1672549204,1672552274,3070
7500,3316222192,3713786889,1672596627,1672599375,2748
7657,3519152550,3792032359,1672665306,1672666427,1121
7749,3711973519,3774045700,1672574392,1672577060,2668
7763,3534702203,3779976989,1672629246,1672629360,114
7692,3514128943,3777120536,1672599451,1672600974,1523
7544,3857349323,3511271692,1672666007,1672667201,1194
7659,3773465237,3510937904,1672538079,1672540658,2579
7565,3229665776,3291883916,1672699864,1672699982,118
7503,3512837326,3505201246,1672639576,1672642454,2878
7484,3396086535,3417587765,1672580571,1672582915,2344
7879,3710344260,3379589402,1672630978,1672632362,1384
7760,3516223597,3835382117,1672531633,1672534676,3043
7587,3913251733,3703013906,1672567024,1672567571,547
7656,3311718847,3715189301,1672618564,1672620693,2129
7506,3703275621,3904775198,1672596500,1672596982,482
7746,3808324264,3201432789,1672598019,1672598980,961
7585,3917278625,3401627165,1672643077,1672644926,1849
7785,3505599848,3701534009,1672543688,1672546158,2470
7630,3792789881,3852391257,1672633488,1672636784,3296
7932,3505912939,3770101921,1672629668,1672632952,3284
7842,3793286136,3778780511,1672692265,1672694144,1879
7820,3886298125,3629935998,1672601180,1672602639,1459
7666,3533025282,3760489031,1672617681,1672619492,1811
7857,3373384732,3911159965,1672666499,1672667373,874
7899,3701146057,3773598056,1672621861,1672622692,831
7634,3518669703,3627937312,1672650081,1672651231,1150
7862,3466229085,3701691675,1672626425,1672626977,552
7740,3910886626,3392121505,1672666517,1672667842,1325
7914,3477649378,3459030804,1672619938,1672622048,2110
7830,3770635361,3898995675,1672629140,1672631441,2301
7608,3514128943,3312664885,1672564355,1672565160,805
7752,3388286531,3852595551,1672669682,1672673057,3375
7680,3710067113,3733189298,1672688433,1672691595,3162
7864,3816454165,3286658957,1672656431,1672659272,2841
7764,3601879040,3518876135,1672686650,1672688607,1957
7768,3518408774,3774501422,1672661058,1672663179,2121
7850,3512540951,3710112546,1672582758,1672583323,565
7786,3280599164,3713630656,1672610878,1672614370,3492
7744,3703789494,3517963492,1672588207,1672591499,3292
7952,3737154119,3791594391,1672655100,1672655188,88
7612,3555214688,3774580701,1672597959,1672600330,2371
7971,3289061738,3501198706,1672616098,1672617850,1752
7540,3779528381,3772714862,1672688917,1672689587,670
7883,3710408395,3291235378,1672568686,1672570790,2104
7503,3791997875,3513201436,1672611819,1672613067,1248
7734,3734828619,3613683164,1672593570,1672594192,622
7921,3407725581,3439023335,1672690998,1672694260,3262
7978,3519563836,3500658339,1672566689,1672568577,1888
7794,3407673904,3801089989,1672612304,1672614308,2004
7743,3303705369,3625274012,1672660858,1672661650,792
7483,3465254146,3284639858,1672685595,1672685904,309
7581,3915628728,3828624701,1672624958,1672626921,1963
7737,3828624701,3249791738,1672687046,1672689656,2610
7636,3793436995,3533193862,1672542375,1672543153,778
7770,3401627165,3755798867,1672587209,1672588146,937
7714,3716488385,3901990690,1672588972,1672589063,91
7547,3668005723,3466911760,1672649280,1672650872,1592
7486,3791657947,3773664987,1672641687,1672642716,1029
7785,3817621391,3505292701,1672695140,1672696243,1103
7741,3774366875,3512166013,1672676836,1672678520,1684
7625,3770078063,3885897503,1672644317,1672647469,3152
7571,3791997875,3716746253,1672643885,1672645522,1637
7490,3760294205,3404384505,1672643319,1672646818,3499
7540,3904775198,3509630174,1672575867,1672578400,2533
7726,3402943525,3739106581,1672601628,1672602351,723
7813,3760569731,3756451663,1672677612,1672681086,3474
7588,3779629905,3209383861,1672682655,1672684247,1592
7921,3776338577,3778780511,1672583319,1672583877,558
7869,3711198793,3857349323,1672637506,1672640375,2869
7716,3348261553,3756451663,1672638952,1672642550,3598
7864,3911159965,3852391257,1672644454,1672646145,1691
7976,3715127362,3511312803,1672540607,1672542630,2023
7673,3235635976,3466911760,1672637145,1672638062,917
7618,3373384732,3710067113,1672586059,1672588777,2718
7690,3792768129,3716537575,1672574744,1672576102,1358
7679,3735319397,3345207877,1672690389,1672693743,3354
7829,3298433163,3477375368,1672636776,1672637673,897
7779,3513080274,3770447408,1672687826,1672688456,630
7971,3514245078,3429690204,1672564083,1672567343,3260
7929,3407725581,3760492950,1672625686,1672627555,1869
7795,3683766533,3427283336,1672647913,1672649006,1093
7485,3511359172,3370752401,1672641695,1672642168,473
7765,3770447408,3391915886,1672551332,1672553695,2363
7797,3412980697,3883085535,1672549402,1672550027,625
7676,3311871871,3792288302,1672674729,1672677283,2554
7581,3276640712,3760489031,1672675225,1672677013,1788
7889,3926700506,3628819436,1672675566,1672679161,3595
7645,3607178184,3397418363,1672684153,1672685576,1423
7982,3930797455,3701995648,1672574976,1672578274,3298
7838,3882997884,3792177074,1672577892,1672579117,1225
7617,3883861463,3475258557,1672652766,1672656317,3551
7835,3783239924,3516716179,1672691118,1672692124,1006
7946,3511332835,3855424474,1672546403,1672548360,1957
7917,3519912874,3505973226,1672546424,1672549516,3092
7706,3287105466,3773664987,1672696401,1672697916,1515
7666,3501759100,3883312122,1672614528,1672617684,3156
7660,3511267139,3370752401,1672684808,1672685978,1170
7506,3755798867,3805342762,1672614993,1672618287,3294
7488,3601879040,3770851318,1672555672,1672557423,1751
7934,3836573197,3713786889,1672543837,1672544559,722
7926,3713969578,3816454165,1672645890,1672649358,3468
7886,3534492426,3901990690,1672554474,1672557613,3139
7807,3433804879,3512837326,1672679771,1672682345,2574
7854,3313564074,3837094550,1672696422,1672699000,2578
7735,3533385867,3411618230,1672581173,1672584605,3432
7519,3428964059,3505973226,1672662632,1672662872,240
7809,3533270638,3297463265,1672532215,1672533831,1616
7970,3772642849,3404384505,1672598564,1672598775,211
7582,3505292701,3286658957,1672690269,1672693468,3199
7555,3406784491,3770763956,1672546731,1672548084,1353
7597,3209383861,3512142794,1672618973,1672619092,119
7679,3736790081,3757151210,1672571639,1672572973,1334
7969,3500729955,3430074045,1672572812,1672574105,1293
7660,3976633198,3484995752,1672621251,1672623025,1774
7577,3701274634,3713808837,1672544712,1672544956,244
7820,3629547065,3515860749,1672698033,1672698465,432
7705,3488244966,3903962771,1672645103,1672647308,2205
7647,3228165483,3757447189,1672569640,1672572384,2744
7849,3734828619,3970117174,1672683998,1672687486,3488
7688,3774793839,3801089989,1672699216,1672700377,1161
7837,3793286136,3510594211,1672576065,1672577443,1378
7941,3857349323,3518669703,1672559039,1672560177,1138
7804,3519703355,3634340855,1672684564,1672687371,2807
7498,3294803686,3473765852,1672687795,1672689752,1957
7739,3505883609,3888559320,1672628559,1672630006,1447
7535,3482405588,3296471982,1672639140,1672641943,2803
7598,3737154119,3666457294,1672596101,1672596629,528
7832,3978105277,3201432789,1672691654,1672693031,1377
7816,3511271692,3475258557,1672668147,1672669995,1848
7571,3514838220,3778308417,1672669434,1672670066,632
7499,3373384732,3713208927,1672579513,1672581674,2161
7898,3227457126,3477375368,1672577541,1672579125,1584
7972,3459030804,3774793839,1672700779,1672703629,2850
7944,3738274418,3859663348,1672586731,1672589721,2990
7501,3489962019,3458539365,1672611696,1672613737,2041
7842,3755872268,3208844525,1672669348,1672669811,463
7763,3755587522,3802367797,1672592835,1672595169,2334
7829,3772578994,3715974031,1672577622,1672577894,272
7499,3334033993,3510771358,1672577509,1672579419,1910
7814,3384951177,3505530961,1672566058,1672567061,1003
7744,3318166135,3510247121,1672620206,1672620826,620
7981,3311415018,3736592744,1672631047,1672632051,1004
7619,3244436890,3701691675,1672673235,1672674381,1146
7711,3823600322,3287105466,1672701538,1672701787,249
7744,3427283336,3412980697,1672680265,1672683558,3293
7805,3882997884,3793753089,1672684979,1672685207,228
7729,3760077057,3882997884,1672699581,1672702744,3163
7758,3246596716,3815508790,1672531231,1672533314,2083
7707,3514472925,3778980116,1672576996,1672580148,3152
7513,3516016437,3512142794,1672557419,1672559291,1872
7598,3605726278,3510380060,1672618813,1672621677,2864
7745,3736592744,3517963492,1672698441,1672700993,2552
7683,3516223597,3520206212,1672536322,1672536685,363
7640,3636867411,3277669002,1672549229,1672549387,158
7817,3519563836,3629547065,1672544675,1672545543,868
7949,3388372715,3885897503,1672630507,1672631419,912
7787,3760598102,3855000166,1672594977,1672597579,2602
7613,3736625083,3701146057,1672595611,1672597867,2256
7645,3505869747,3533137446,1672561143,1672563732,2589
7707,3473562469,3518360734,1672594913,1672596456,1543
7705,3519556068,3513599775,1672682165,1672684340,2175
7487,3755587522,3512683609,1672608946,1672611020,2074
7587,3496549058,3515394721,1672696007,1672696915,908
7618,3776513891,3886298125,1672624458,1672625784,1326
7552,3901990690,3813052709,1672673336,1672676674,3338
7662,3484995752,3792789881,1672682142,1672683720,1578
7723,3520888296,3756528686,1672552567,1672555079,2512
7500,3421127249,3500729955,1672668104,1672669601,1497
7653,3711973519,3828624701,1672610024,1672610781,757
7862,3909331423,3716900301,1672542217,1672542300,83
7730,3760492950,3734496778,1672673553,1672676322,2769
7673,3710112546,3344364444,1672571518,1672574698,3180
7528,3703441914,3618045231,1672541717,1672545076,3359
7819,3451432842,3511359172,1672659344,1672660768,1424
7563,3711569060,3319752091,1672695203,1672696066,863
7547,3514128943,3976390453,1672596906,1672600378,3472
7727,3711571712,3882242815,1672585010,1672587750,2740
7819,3783705817,3713268590,1672545100,1672545161,61
7521,3391915121,3430352815,1672596187,1672597309,1122
7778,3301107849,3608868877,1672664046,1672665302,1256
7762,3439023335,3780639480,1672570447,1672572208,1761
7718,3621497531,3311065516,1672643409,1672644232,823
7765,3818255890,3277669002,1672589493,1672592301,2808
7683,3505904952,3420700674,1672661837,1672664142,2305
7746,3904408902,3505219850,1672612373,1672612672,299
7513,3772359096,3773978034,1672612882,1672614059,1177
7916,3780788622,3734737881,1672692471,1672693218,747
7980,3520376528,3793436995,1672593751,1672596308,2557
7946,3428964059,3418534998,1672619721,1672622379,2658
7884,3800353779,3312333615,1672549113,1672549792,679
7721,3513164386,3236102733,1672612971,1672615483,2512
7493,3973560347,3791874383,1672665200,1672668095,2895
7525,3828624701,3500060260,1672576833,1672578562,1729
7483,3509773875,3791957752,1672637530,1672638582,1052
7679,3791020967,3685818092,1672623092,1672625967,2875
7896,3778266283,3688683847,1672578729,1672580524,1795
7915,3711504540,3931941795,1672576123,1672579194,3071
7932,3760267716,3770635361,1672700772,1672703918,3146
7712,3777717988,3903962771,1672663713,1672664552,839
7508,3478194807,3605726278,1672626165,1672627003,838
7970,3505883609,3774127586,1672578156,1672580043,1887
7507,3756966035,3714504419,1672577733,1672580682,2949
7870,3912536808,3509672210,1672702597,1672703361,764
7636,3209048907,3209027249,1672557806,1672560426,2620
7710,3615046771,3972364603,1672622551,1672626071,3520
7745,3277669002,3903307060,1672567654,1672569771,2117
7610,3760992710,3420700674,1672591264,1672591756,492
7807,3511271692,3516039895,1672560801,1672562761,1960
7538,3370752401,3227158514,1672615838,1672617426,1588
7641,3755436115,3418728074,1672657708,1672657863,155
7597,3805519285,3791602225,1672619088,1672622273,3185
7890,3518163778,3513956646,1672659223,1672660887,1664
7709,3628819436,3809059934,1672543362,1672545726,2364
7615,3716168623,3519152550,1672645970,1672647940,1970
7948,3475396323,3520165601,1672614888,1672615222,334
7803,3224058172,3683959482,1672630343,1672632034,1691
7607,3852391257,3519428855,1672598723,1672601840,3117
7667,3273500349,3356860407,1672637114,1672639652,2538
7571,3534553510,3364543015,1672642625,1672644325,1700
7964,3316173088,3501927421,1672630848,1672632074,1226
7773,3930797455,3516716179,1672702729,1672703099,370
7711,3505173328,3826415738,1672608017,1672610038,2021
7547,3777790718,3314245084,1672645281,1672648782,3501
7826,3533827120,3701146057,1672699289,1672702475,3186
7922,3912262917,3701178711,1672559328,1672560162,834
7805,3391915886,3477649378,1672548405,1672548703,298
7567,3701111745,3511359172,1672625653,1672629214,3561
7899,3857349323,3235635976,1672558685,1672561447,2762
7815,3701111745,3378092448,1672562562,1672564183,1621
7958,3853018906,3800886801,1672539597,1672542947,3350
7859,3777455223,3859663348,1672691306,1672693105,1799
7655,3432689543,3912536808,1672585360,1672585679,319
7662,3467773920,3703223015,1672697861,1672700943,3082
7616,3823600322,3516011407,1672562847,1672565452,2605
7767,3497901842,3424922204,1672595569,1672598665,3096
7763,3921211276,3513201436,1672664968,1672665834,866
7938,3703223015,3378686918,1672564169,1672566517,2348
7610,3406784491,3629935998,1672552180,1672555338,3158
7600,3792473331,3311845971,1672669868,1672670811,943
7564,3399004969,3837094550,1672561146,1672562992,1846
7879,3406784491,3519654779,1672651979,1672654956,2977
7979,3703789494,3807987001,1672696240,1672696353,113
7584,3662180254,3473562469,1672666837,1672668393,1556
7700,3715981584,3732481297,1672545747,1672548922,3175
7979,3773814927,3812176780,1672614171,1672616871,2700
7603,3760489031,3534702203,1672562704,1672564697,1993
7704,3206603608,3773598056,1672596838,1672597792,954
7725,3509933351,3505702787,1672694127,1672695770,1643
7741,3520751702,3312829208,1672565302,1672567048,1746
7982,3780828689,3703889596,1672688061,1672688963,902
7911,3825229501,3224058172,1672617499,1672620431,2932
7495,3973560347,3438645253,1672595694,1672598265,2571
7747,3519912874,3273500349,1672677996,1672678614,618
7981,3903307060,3734828619,1672652539,1672654432,1893
7626,3501486692,3855424474,1672683328,1672684234,906
7683,3774010081,3792844210,1672701838,1672702892,1054
7955,3664170666,3500894271,1672539985,1672541890,1905
7673,3918056059,3917088658,1672608085,1672608586,501
7865,3505530961,3289061738,1672610747,1672611953,1206
7868,3512720680,3338703270,1672646903,1672647088,185
7700,3391915886,3511687358,1672655885,1672658747,2862
7888,3804870229,3489217083,1672600860,1672601639,779
7849,3716746253,3921211276,1672650187,1672653123,2936
7631,3885670556,3378436155,1672630319,1672632221,1902
7935,3517721725,3791657947,1672675861,1672677111,1250
7672,3311065516,3827377568,1672650581,1672652241,1660
7916,3534010629,3701534009,1672641507,1672644870,3363
7510,3519700826,3519654779,1672609108,1672609293,185
7609,3202120784,3621497531,1672574439,1672574542,103
7915,3801089989,3880310724,1672595399,1672595972,573
7506,3618873142,3439023335,1672571956,1672572590,634
7944,3391915886,3701498253,1672613412,1672615341,1929
7978,3887270940,3885670556,1672676030,1672677197,1167
7807,3855937514,3772758337,1672539563,1672542910,3347
7492,3223968713,3311603601,1672563407,1672565573,2166
7510,3634340855,3206603608,1672668395,1672671417,3022
7500,3770824086,3783429780,1672539847,1672541884,2037
7793,3516716179,3793627961,1672594086,1672597357,3271
7599,3791657947,3517476351,1672688643,1672689522,879
7798,3518791447,3627937312,1672652687,1672655022,2335
7808,3500374658,3780788622,1672557118,1672558284,1166
7719,3716843669,3615046771,1672559186,1672562191,3005
7853,3418534998,3356860407,1672600406,1672602800,2394
7643,3859525941,3918247820,1672539913,1672542042,2129
7803,3365278081,3895562476,1672621230,1672621579,349
7978,3770824086,3500487333,1672637621,1672639822,2201
7789,3760992710,3881477378,1672594659,1672598094,3435
7563,3277939457,3344364444,1672660389,1672663338,2949
7795,3714488548,3517077106,1672569045,1672570454,1409
7826,3904408902,3509352754,1672567572,1672567907,335
7843,3533137446,3760267716,1672609397,1672612967,3570
7814,3426325549,3339907603,1672555708,1672558194,2486
7755,3911159965,3915628728,1672647170,1672650642,3472
7867,3311208440,3756453423,1672605745,1672608256,2511
7601,3792844210,3505145247,1672674243,1672675469,1226
7739,3500199935,3935627557,1672673273,1672674165,892
7485,3209551760,3732481297,1672578733,1672580519,1786
7556,3242408357,3773814927,1672595056,1672597539,2483
7584,3378092448,3688683847,1672596759,1672598980,2221
7829,3391261292,3922275620,1672690738,1672694211,3473
7630,3337544549,3417587765,1672679871,1672680749,878
7703,3208844525,3617055293,1672531671,1672531982,311
7609,3520183192,3730517636,1672678631,1672679572,941
7982,3774066725,3517459919,1672619351,1672622035,2684
7672,3505702787,3202120784,1672670513,1672672904,2391
7957,3517963492,3772746272,1672674106,1672674672,566
7577,3427283336,3247428249,1672594770,1672595934,1164
7941,3639847263,3792902982,1672675816,1672676320,504
7602,3510771358,3756027749,1672619445,1672619978,533
7755,3922275416,3662180254,1672557230,1672557956,726
7664,3311845971,3809916577,1672665174,1672665562,388
7913,3604539807,3887270940,1672665866,1672668595,2729
7684,3736229191,3493507965,1672620446,1672623681,3235
7670,3783245561,3200691026,1672536697,1672536922,225
7911,3509672210,3710067113,1672684559,1672685242,683
7709,3505193212,3510173870,1672571267,1672573834,2567
7772,3396086535,3915628728,1672693515,1672695812,2297
7823,3793753089,3903307060,1672620607,1672622994,2387
7806,3365942576,3901877072,1672539888,1672541121,1233
7856,3701274634,3783239924,1672541957,1672545258,3301
7581,3227158514,3496269445,1672599413,1672602737,3324
7723,3284639858,3459030804,1672588008,1672588189,181
7812,3311627628,3235635976,1672579902,1672583037,3135
7655,3516465662,3534488837,1672694951,1672697890,2939
7807,3367902229,3835382117,1672657928,1672658004,76
7838,3688683847,3385763781,1672698212,1672699192,980
7495,3307512479,3613995936,1672658603,1672660057,1454
7707,3711571712,3792883665,1672672572,1672674159,1587
7862,3792177074,3533371364,1672645698,1672647134,1436
7938,3208844525,3505201246,1672637845,1672639261,1416
7693,3783779671,3516011407,1672700485,1672703908,3423
7493,3514245078,3518408774,1672641852,1672643133,1281
7651,3505973226,3629935998,1672695894,1672698640,2746
7911,3776513891,3809484172,1672562298,1672563297,999
7845,3715339701,3519654779,1672660603,1672661792,1189
7626,3509453566,3388286531,1672630612,1672630892,280
7512,3509634629,3287105466,1672533241,1672534120,879
7761,3446948848,3757246925,1672688067,1672688612,545
7509,3513599775,3756021689,1672642437,1672644256,1819
7625,3489728806,3519601612,1672637084,1672639757,2673
7682,3500578848,3311439795,1672636994,1672640204,3210
7785,3780294829,3496051529,1672697198,1672699028,1830
7971,3510173870,3772359096,1672695867,1672697094,1227
7913,3613995936,3637008488,1672665703,1672666398,695
7566,3273500349,3774268456,1672657841,1672659705,1864
7587,3626156564,3778980116,1672644930,1672645769,839
7602,3827377568,3859663348,1672638369,1672640702,2333
7819,3668898102,3505904952,1672627076,1672630309,3233
7565,3792288302,3227457126,1672673687,1672674265,578
7809,3433804879,3482405588,1672549033,1672550849,1816
7672,3511163800,3394539273,1672626216,1672626813,597
7878,3304056063,3739106581,1672608678,1672609173,495
7761,3760893269,3828432634,1672560524,1672560832,308
7497,3793286136,3793959750,1672564317,1672565405,1088
7927,3918584946,3231056870,1672549574,1672551351,1777
7954,3903307060,3737079798,1672693977,1672695097,1120
7975,3501730685,3883861463,1672657838,1672661338,3500
7637,3778980116,3777443199,1672640213,1672640606,393
7699,3286658957,3755943611,1672673613,1672674834,1221
7502,3626156564,3780593036,1672672343,1672675828,3485
7630,3428674539,3792253549,1672591366,1672594560,3194
7614,3511312803,3770635361,1672630955,1672633601,2646
7791,3777717988,3453729665,1672634164,1672637691,3527
7744,3501955238,3346795719,1672546393,1672547956,1563
7788,3914290246,3778780511,1672656211,1672657453,1242
7888,3976390453,3394330287,1672687744,1672689384,1640
7687,3235287260,3365830990,1672699214,1672700559,1345
7572,3497901842,3629547065,1672572266,1672574869,2603
7868,3515394721,3760492950,1672681882,1672682862,980
7887,3792883665,3701065786,1672629067,1672629216,149
7656,3703955926,3660493209,1672578885,1672579929,1044
7532,3516909237,3501184421,1672533116,1672535579,2463
7647,3312664885,3501198706,1672610824,1672612056,1232
7602,3716900301,3774127586,1672666900,1672669768,2868
7966,3715339701,3837094550,1672595936,1672596762,826
7579,3519803045,3880310724,1672630765,1672631254,489
7772,3313541986,3703889596,1672695760,1672698136,2376
7796,3513454145,3443698222,1672688103,1672689243,1140
7515,3485008994,3311324983,1672669802,1672672324,2522
7945,3607748895,3501730685,1672548385,1672550811,2426
7737,3405494240,3520888296,1672534923,1672536533,1610
7520,3882997884,3736790081,1672588395,1672589297,902
7836,3519703355,3910886626,1672587910,1672588870,960
7511,3514987389,3780639480,1672538067,1672540035,1968
7833,3820354437,3201324715,1672683876,1672684479,603
7585,3231056870,3311761694,1672680256,1672681028,772
7634,3760598102,3664170666,1672608800,1672610669,1869
7619,3777443199,3701498253,1672561561,1672564043,2482
7574,3534553510,3716197887,1672586643,1672589164,2521
7940,3774366875,3311154569,1672579214,1672580106,892
7514,3465202715,3760183458,1672629936,1672632880,2944
7897,3701863557,3367902229,1672624232,1672624568,336
7827,3890149705,3509773875,1672649915,1672652712,2797
7842,3822654369,3427219654,1672634623,1672634972,349
7589,3415443558,3772309150,1672636573,1672638312,1739
7517,3826415738,3710098970,1672540539,1672542704,2165
7641,3515691540,3776338577,1672628820,1672630128,1308
7802,3828624701,3359910781,1672641960,1672645151,3191
7762,3792473331,3533025282,1672688159,1672690329,2170
7556,3792844210,3757151210,1672699605,1672699865,260
7756,3793753089,3777477395,1672591256,1672594845,3589
7609,3391915121,3820354437,1672653245,1672654425,1180
7516,3312664885,3882242815,1672594721,1672597555,2834
7584,3910454786,3922275416,1672537862,1672539898,2036
7733,3303751772,3792668962,1672591965,1672593738,1773
7818,3303751772,3774338212,1672679888,1672680193,305
7492,3505530961,3285400528,1672633028,1672634787,1759
7802,3774005526,3701498253,1672643503,1672646963,3460
7624,3303705369,3550946908,1672539764,1672539847,83
7837,3668005723,3505791599,1672622173,1672623365,1192
7488,3514987389,3779036831,1672634803,1672637980,3177
7769,3606186086,3387674757,1672572881,1672573765,884
7772,3791602225,3779528381,1672552850,1672556370,3520
7541,3855424474,3791115967,1672702580,1672703770,1190
7520,3311648200,3298288268,1672664388,1672667131,2743
7546,3405494240,3757161914,1672678824,1672681872,3048
7768,3755436115,3668898102,1672611694,1672612215,521
7518,3550946908,3475396323,1672641200,1672643165,1965
7819,3932051427,3505962865,1672580344,1672582552,2208
7605,3756451663,3510771358,1672691084,1672694433,3349
7538,3238712269,3701691675,1672686890,1672689621,2731
7870,3428674539,3314245084,1672656349,1672657387,1038
7958,3453729665,3903009525,1672690202,1672692606,2404
7861,3710344260,3713208927,1672671646,1672672280,634
7577,3518791447,3370752401,1672667674,1672667823,149
7855,3412980697,3534313900,1672701824,1672702533,709
7645,3755587522,3520376528,1672631595,1672633179,1584
7683,3276640712,3374559242,1672605642,1672606309,667
7850,3319752091,3666457294,1672557203,1672559295,2092
7913,3829764737,3890149705,1672614447,1672615939,1492
7526,3420700674,3534729133,1672623376,1672626480,3104
7913,3453729665,3880285638,1672601240,1672603242,2002
7852,3711569060,3391915121,1672644660,1672647599,2939
7941,3783705817,3772053179,1672615464,1672618493,3029
7675,3517509185,3899371911,1672625181,1672626498,1317
7734,3853018906,3500199935,1672567174,1672567463,289
7718,3773205565,3344019610,1672616718,1672617685,967
7778,3238712269,3891751546,1672606461,1672608312,1851
7717,3482405588,3407954858,1672581228,1672583602,2374
7801,3492478793,3520629279,1672681876,1672682880,1004
7857,3828624701,3534424200,1672634927,1672637302,2375
7853,3855937514,3496549058,1672634395,1672636850,2455
7662,3682061100,3716273414,1672688462,1672689494,1032
7707,3511271692,3898995675,1672587036,1672587926,890
7606,3316222192,3777514571,1672653303,1672653685,382
7931,3520012395,3760267716,1672604540,1672606841,2301
7528,3783239924,3792473331,1672551402,1672554902,3500
7976,3520706195,3668898102,1672644213,1672647620,3407
7910,3534492426,3903307060,1672668122,1672668895,773
7856,3756966035,3517721725,1672663215,1672664555,1340
7590,3311203656,3404384505,1672557293,1672560401,3108
7883,3851190615,3607748895,1672700121,1672702139,2018
7620,3757455053,3501730685,1672645854,1672649421,3567
7636,3851190615,3611150562,1672567152,1672569276,2124
7844,3291883916,3755511676,1672662655,1672663374,719
7603,3500066230,3304056063,1672671243,1672671867,624
7667,3365614305,3755920131,1672699089,1672699568,479
7531,3238712269,3883085535,1672613143,1672613913,770
7603,3770078063,3427283336,1672571304,1672574624,3320
7602,3248507722,3711198793,1672662447,1672665955,3508
7766,3357483218,3783245561,1672553999,1672556705,2706
7528,3485375593,3783509527,1672593391,1672596974,3583
7974,3370636709,3365942576,1672609252,1672610985,1733
7928,3701146057,3791602225,1672630816,1672633498,2682
7504,3770078063,3278365525,1672677440,1672680111,2671
7485,3511841857,3774119563,1672683645,1672685181,1536
7560,3778308417,3500177712,1672552067,1672554733,2666
7612,3312333615,3793962300,1672667292,1672668083,791
7831,3511170269,3220716272,1672562228,1672565792,3564
7503,3483164654,3683766533,1672592374,1672593931,1557
7879,3755872268,3505638204,1672679874,1672683271,3397
7785,3501759100,3365830990,1672610588,1672612172,1584
7789,3756623396,3793470489,1672630288,1672632975,2687
7653,3783779671,3703223015,1672647357,1672650506,3149
7841,3512217942,3783531004,1672591016,1672592906,1890
7568,3688418210,3519556068,1672567808,1672570503,2695
7706,3511350608,3736625083,1672620950,1672622925,1975
7538,3399535232,3360506772,1672583743,1672584799,1056
7633,3314836094,3925402713,1672666233,1672666467,234
7903,3348261553,3500658339,1672546048,1672549288,3240
7907,3711380716,3666506258,1672607805,1672608420,615
7630,3513956646,3471220483,1672629128,1672632299,3171
7808,3851190615,3780294829,1672673994,1672674581,587
7609,3345207877,3783083229,1672599723,1672600513,790
7891,3391915121,3518791447,1672639587,1672642021,2434
7589,3473562469,3520706195,1672625787,1672627291,1504
7565,3626156564,3221536550,1672569378,1672570207,829
7726,3770447408,3249791738,1672585395,1672588090,2695
7708,3608868877,3533095755,1672619574,1672621139,1565
7961,3811171116,3605726278,1672663338,1672664133,795
7773,3734828619,3637008488,1672634191,1672635581,1390
7497,3416427576,3351554343,1672581423,1672581984,561
7491,3533827120,3898995675,1672588443,1672591694,3251
7584,3367902229,3510969660,1672567281,1672569081,1800
7497,3510380060,3390068992,1672703615,1672704762,1147
7665,3939952128,3313564074,1672537014,1672539281,2267
7525,3407954858,3859525941,1672532812,1672533589,777
7781,3760569731,3512540951,1672675904,1672677475,1571
7955,3517864478,3902383721,1672619767,1672622333,2566
7827,3703441914,3517077106,1672555665,1672556624,959
7676,3249791738,3315583351,1672646347,1672648588,2241
7701,3909606423,3516039895,1672658515,1672661752,3237
7704,3520012395,3736790081,1672541053,1672543960,2907
7579,3404384505,3516716179,1672619651,1672622182,2531
7513,3624312512,3247815299,1672653601,1672657196,3595
7825,3412825109,3392121505,1672636394,1672637944,1550
7716,3512166013,3710067113,1672584109,1672584290,181
7837,3518408774,3820354437,1672584514,1672586708,2194
7795,3520012395,3604539807,1672600228,1672602509,2281
7966,3710067113,3755392666,1672545521,1672548340,2819
7936,3774066725,3391915121,1672645109,1672645831,722
7692,3914259449,3512217942,1672603824,1672606134,2310
7775,3473765852,3773120434,1672558681,1672560609,1928
7620,3777717988,3918674986,1672664388,1672666113,1725
7977,3514719601,3760569731,1672563167,1672564540,1373
7500,3791020967,3736419952,1672653406,1672654587,1181
7774,3756453423,3636867411,1672689947,1672690487,540
7914,3356860407,3411618230,1672534462,1672535550,1088
7956,3899371911,3755798867,1672677813,1672680171,2358
7657,3500229033,3711380716,1672609055,1672610990,1935
7781,3364543015,3534553510,1672561553,1672565022,3469
7962,3760893269,3859663348,1672664063,1672666437,2374
7562,3777717988,3373384732,1672701424,1672701694,270
7680,3475795792,3826759140,1672628866,1672630588,1722
7552,3783206719,3776948966,1672544532,1672546661,2129
7648,3489962019,3481502100,1672554996,1672557388,2392
7516,3365614305,3701967560,1672657528,1672659004,1476
7869,3666507626,3852595551,1672560301,1672560992,691
7800,3395152943,3773755137,1672640032,1672643227,3195
7718,3420700674,3772359096,1672541783,1672544147,2364
7721,3909606423,3505638204,1672578376,1672580876,2500
7498,3500487333,3811171116,1672684393,1672685001,608
7711,3882242815,3637008488,1672591196,1672593663,2467
7593,3828432634,3478194807,1672586857,1672586963,106
7877,3899371911,3713630656,1672689071,1672691779,2708
7898,3428674539,3534488837,1672634127,1672636543,2416
7928,3438645253,3777477395,1672575072,1672577956,2884
7832,3520756859,3666457294,1672683939,1672686411,2472
7729,3383922351,3234362962,1672649093,1672649196,103
7490,3247815299,3247428249,1672670480,1672672681,2201
7726,3465254146,3716900301,1672659200,1672660729,1529
7881,3703223015,3756027749,1672660912,1672664201,3289
7694,3715581279,3779528381,1672578741,1672579743,1002
7983,3772746272,3793959750,1672590729,1672593583,2854
7523,3773950140,3922275416,1672693355,1672694610,1255
7948,3501606184,3792883665,1672635610,1672638319,2709
7721,3208844525,3315583351,1672639794,1672640222,428
7907,3249791738,3624761861,1672598188,1672601703,3515
7867,3360506772,3777514571,1672546851,1672550072,3221
7705,3223968713,3500365158,1672554357,1672556491,2134
7845,3857349323,3534191820,1672550044,1672550907,863
7772,3791874383,3783531004,1672679121,1672681951,2830
7876,3903009525,3501486692,1672656837,1672657724,887
7837,3805519285,3886298125,1672633421,1672634328,907
7937,3416427576,3682061100,1672659517,1672660369,852
7588,3793753089,3972709319,1672540659,1672542171,1512
7909,3510126867,3492478793,1672564364,1672565262,898
7777,3629935998,3248507722,1672558731,1672560733,2002
7696,3222521619,3703718151,1672573056,1672575445,2389
7736,3554917400,3334033993,1672539103,1672539254,151
7817,3505193212,3235287260,1672611358,1672611583,225
7706,3365278081,3809916577,1672573778,1672575564,1786
7564,3505135325,3505201246,1672591475,1672591977,502
7726,3714488548,3736419952,1672601519,1672602156,637
7850,3819727225,3774195321,1672547414,1672548441,1027
7714,3601879040,3809916577,1672571088,1672571895,807
7517,3221536550,3514719601,1672703392,1672703515,123
7575,3475251781,3755798867,1672664149,1672665523,1374
7935,3500994774,3703223015,1672535155,1672537653,2498
7495,3518260334,3770553384,1672581106,1672583637,2531
7630,3520030713,3834257412,1672614142,1672616986,2844
7922,3760569731,3501184421,1672605226,1672606362,1136
7589,3917278625,3518932404,1672701381,1672704793,3412
7764,3501759100,3512837326,1672680101,1672681051,950
7746,3501927421,3791602225,1672634460,1672635832,1372
7925,3394539273,3517459919,1672557625,1672560129,2504
7558,3774339795,3711262377,1672557898,1672558270,372
7577,3774298222,3902383721,1672548362,1672551725,3363
7483,3930791338,3513201436,1672563393,1672566076,2683
7657,3711973519,3731419510,1672580773,1672583215,2442
7854,3777623166,3518163778,1672541076,1672541871,795
7717,3516960534,3778308417,1672634705,1672637619,2914
7674,3533369198,3733891182,1672649451,1672650429,978
7533,3370636709,3511163800,1672657983,1672660143,2160
7552,3777717988,3276640712,1672660259,1672660637,378
7906,3783531004,3793753089,1672657158,1672659097,1939
7764,3701995648,3399004969,1672634348,1672636706,2358
7878,3235287260,3780593036,1672541311,1672543768,2457
7832,3834257412,3227457126,1672590239,1672592698,2459
7859,3222448362,3779036831,1672649394,1672649970,576
7546,3247815299,3208844525,1672656060,1672659275,3215
7542,3760489031,3533927138,1672591225,1672593430,2205
7757,3770553384,3412980697,1672635819,1672639128,3309
7830,3485375593,3793753089,1672701787,1672704040,2253
7539,3913251733,3467773920,1672703907,1672706294,2387
7923,3407673904,3736786443,1672676700,1672678964,2264
7770,3774119563,3605726278,1672627259,1672629809,2550
7840,3883312122,3247780536,1672636091,1672637598,1507
7871,3716197887,3777623166,1672691077,1672691823,746
7557,3248507722,3715189301,1672546264,1672548753,2489
7567,3734496778,3319752091,1672688037,1672690104,2067
7565,3361230905,3779036831,1672620911,1672621105,194
7970,3518014636,3902278226,1672562169,1672562567,398
7711,3334033993,3783779671,1672587074,1672589635,2561
7683,3756462516,3975287541,1672564602,1672564704,102
7686,3360506772,3500803339,1672556915,1672557808,893
7912,3887270940,3481647420,1672579409,1672581637,2228
7836,3608633356,3514719601,1672561734,1672563952,2218
7581,3801089989,3811171116,1672546759,1672550158,3399
7597,3773429448,3516065852,1672683295,1672686219,2924
7918,3519912874,3772758337,1672613595,1672613805,210
7650,3625274012,3826759140,1672618447,1672619879,1432
7559,3629547065,3703889596,1672654620,1672656219,1599
7557,3713349754,3466229085,1672693300,1672695388,2088
7778,3428964059,3770447408,1672570997,1672573745,2748
7609,3783126683,3516258476,1672660436,1672661914,1478
7698,3770021824,3793848402,1672622092,1672623630,1538
7803,3369998498,3314245084,1672697173,1672697334,161
7582,3349613093,3909331423,1672696757,1672700259,3502
7546,3512349371,3416427576,1672542621,1672544917,2296
7639,3517459919,3387966152,1672551645,1672553664,2019
7483,3505347134,3601879040,1672601276,1672603394,2118
7516,3731419510,3346327502,1672674636,1672676766,2130
7581,3286658957,3493507965,1672640415,1672642339,1924
7967,3715492942,3235635976,1672587456,1672590783,3327
7648,3284639858,3511163800,1672690178,1672691059,881
7570,3783196518,3925402713,1672616558,1672618400,1842
7961,3611150562,3512217942,1672702816,1672704936,2120
7582,3475258557,3710569131,1672596056,1672598819,2763
7540,3779629905,3710112546,1672536576,1672538964,2388
7745,3294803686,3505477652,1672693508,1672695702,2194
7815,3666506258,3291227780,1672699821,1672701768,1947
7957,3533810360,3836573197,1672681973,1672683506,1533
7528,3772309166,3427283336,1672593450,1672596627,3177
7737,3509672210,3378092448,1672568431,1672569984,1553
7683,3915628728,3505145247,1672628167,1672628755,588
7585,3827626797,3351008918,1672667107,1672670645,3538
7958,3791901535,3222521619,1672539717,1672543064,3347
7718,3918584946,3898995675,1672573836,1672577221,3385
7920,3511350608,3336742544,1672654224,1672654698,474
7980,3228165483,3516039895,1672601708,1672604670,2962
7839,3249247700,3801089989,1672571955,1672572976,1021
7577,3472130842,3220716272,1672634173,1672636712,2539
7880,3902278226,3882242815,1672694089,1672695842,1753
7653,3793286136,3772758337,1672567680,1672569599,1919
7957,3756601594,3513599775,1672585663,1672586847,1184
7943,3533371364,3496269445,1672589907,1672593200,3293
7678,3505201246,3284832486,1672572861,1672574624,1763
7818,3298433163,3509453566,1672561912,1672564520,2608
7561,3715581279,3917278625,1672674183,1672674800,617
7803,3703441914,3780609808,1672661491,1672663160,1669
7526,3780828689,3206593906,1672555359,1672555506,147
7868,3356860407,3312664885,1672650297,1672651364,1067
7874,3736419952,3514128943,1672578379,1672581913,3534
7682,3510937904,3505635228,1672659490,1672660969,1479
7746,3713208927,3883312122,1672632841,1672636408,3567
7563,3505530961,3313541986,1672647541,1672649464,1923
7743,3489545239,3859525941,1672677981,1672679202,1221
7529,3756930948,3505219850,1672564072,1672565341,1269
7889,3304056063,3793848402,1672615947,1672618207,2260
7815,3802367797,3511359172,1672691473,1672693767,2294
7626,3517864478,3509933351,1672539091,1672542443,3352
7509,3520751702,3206254161,1672579804,1672581973,2169
7689,3315583351,3224716315,1672702125,1672702496,371
7554,3780813786,3828365570,1672679183,1672680261,1078
7705,3311324983,3224058172,1672607405,1672609273,1868
7756,3881477378,3899371911,1672675275,1672677754,2479
7531,3634340855,3755881905,1672600204,1672602655,2451
7529,3391915121,3711308224,1672566674,1672569615,2941
7603,3772642849,3760077057,1672626218,1672627598,1380
7603,3244436890,3701967560,1672552476,1672555944,3468
7675,3520030713,3513454145,1672577474,1672580439,2965
7663,3312333615,3711569060,1672691274,1672693923,2649
7912,3201432789,3710408395,1672610973,1672614199,3226
7873,3912262917,3280964728,1672633231,1672633738,507
7490,3284639858,3351008918,1672576677,1672578297,1620
7749,3332072298,3511841857,1672664945,1672667443,2498
7857,3793086311,3362000049,1672636518,1672639595,3077
7514,3209027249,3779740455,1672625168,1672627778,2610
7589,3636867411,3829764737,1672597894,1672600694,2800
7915,3909606423,3880285638,1672644875,1672645522,647
7568,3516960534,3511267139,1672661728,1672662031,303
7677,3505962865,3520709480,1672647632,1672649158,1526
7599,3730517636,3489728806,1672605104,1672605259,155
7808,3755511676,3238712269,1672673118,1672675063,1945
7566,3311415018,3227158514,1672590683,1672591302,619
7663,3415546117,3904775198,1672625883,1672628587,2704
7674,3314836094,3710098970,1672615436,1672618167,2731
7512,3388372715,3518669703,1672639161,1672640044,883
7636,3882997884,3736419952,1672629327,1672629401,74
7760,3367029997,3501483568,1672564293,1672565911,1618
7934,3701190899,3505702787,1672691201,1672693484,2283
7517,3933210486,3513201436,1672698201,1672699462,1261
7607,3399004969,3512142794,1672604081,1672605497,1416
7566,3286658957,3466911760,1672614039,1672616227,2188
7642,3312829208,3424922204,1672630116,1672631171,1055
7966,3829764737,3701967560,1672584471,1672588022,3551
7967,3714197325,3715981584,1672548491,1672548765,274
7581,3202120784,3533025282,1672556831,1672557102,271
7913,3336742544,3852391257,1672631262,1672632304,1042
7672,3701498253,3288764520,1672590079,1672590861,782
7651,3774580701,3519654779,1672626606,1672627381,775
7510,3757562897,3773429448,1672698283,1672699278,995
7745,3520756859,3930791338,1672544527,1672546556,2029
7923,3791594391,3662180254,1672581995,1672584914,2919
7754,3360506772,3359910781,1672631041,1672631784,743
7595,3316222192,3793286136,1672563269,1672566800,3531
7804,3505477652,3774366875,1672624808,1672626030,1222
7887,3209383861,3519803045,1672659557,1672661499,1942
7773,3617055293,3636867411,1672699433,1672701068,1635
7523,3459030804,3500365158,1672567312,1672568495,1183
7918,3438645253,3311154569,1672674885,1672677662,2777
7959,3930797455,3772309150,1672640956,1672643884,2928
7685,3852595551,3500578848,1672700506,1672703683,3177
7684,3279721246,3534191820,1672531897,1672534867,2970
7598,3909606423,3772714862,1672603378,1672604294,916
7693,3394330287,3858918246,1672585353,1672587930,2577
7873,3716835696,3668898102,1672614560,1672616246,1686
7938,3351554343,3533270638,1672587544,1672589602,2058
7724,3755511676,3489962019,1672620294,1672622032,1738
7661,3639847263,3500060260,1672639571,1672642272,2701
7971,3515125508,3505193212,1672637925,1672640631,2706
7849,3249247700,3618045231,1672574537,1672574922,385
7908,3344019610,3280964728,1672630447,1672632075,1628
7982,3904775198,3899204805,1672680994,1672684061,3067
7643,3389115045,3922337974,1672701366,1672701610,244
7871,3777790718,3701111745,1672696738,1672699996,3258
7632,3209551760,3294803686,1672534856,1672536464,1608
7570,3664517356,3396285984,1672632688,1672633149,461
7960,3793286136,3770021824,1672600815,1672603100,2285
7728,3500803339,3713349754,1672564522,1672565487,965
7862,3510703546,3731419510,1672617434,1672618456,1022
7828,3516223597,3639847263,1672594451,1672596225,1774
7724,3780503655,3505912939,1672657227,1672659801,2574
7771,3780813786,3736419952,1672607639,1672608278,639
7655,3235287260,3730517636,1672571415,1672573372,1957
7747,3515394721,3801089989,1672591008,1672592306,1298
7790,3511862351,3793959750,1672651278,1672653298,2020
7554,3611150562,3805342762,1672676399,1672679036,2637
7518,3883551721,3755739653,1672586951,1672590197,3246
7750,3703223015,3533927138,1672616311,1672617093,782
7650,3772714862,3374559242,1672557710,1672558378,668
7770,3307512479,3500658339,1672668699,1672669865,1166
7661,3510247121,3227158514,1672560498,1672563177,2679
7556,3757455053,3888559320,1672609017,1672610055,1038
7664,3889232789,3509773875,1672622522,1672624226,1704
7637,3534702203,3520629279,1672582804,1672584412,1608
7869,3311871871,3249247700,1672596612,1672599632,3020
7665,3501483568,3311993075,1672683665,1672684994,1329
7809,3399911573,3385763781,1672703761,1672705070,1309
7533,3416241005,3511170269,1672611065,1672611796,731
7956,3248507722,3733189298,1672573174,1672573535,361
7545,3505347134,3828432634,1672646408,1672647264,856
7647,3713644518,3773814927,1672653095,1672655701,2606
7662,3392121505,3505477652,1672532688,1672535666,2978
7836,3459030804,3852391257,1672640259,1672643595,3336
7587,3406784491,3714197325,1672577811,1672577932,121
7968,3500487333,3246596716,1672589278,1672590242,964
7966,3780828689,3972709319,1672550101,1672551326,1225
7767,3484995752,3407954858,1672566525,1672568227,1702
7970,3533280269,3505638204,1672539197,1672540548,1351
7927,3922275620,3622054816,1672670520,1672671310,790
7873,3973560347,3242408357,1672665010,1672665568,558
7593,3755872268,3703735129,1672647861,1672650017,2156
7889,3420432297,3714962248,1672535311,1672536457,1146
7712,3496051529,3660493209,1672606542,1672606883,341
7551,3889232789,3774045700,1672590626,1672590712,86
7903,3516980378,3607178184,1672677300,1672679129,1829
7694,3792768129,3770824086,1672636410,1672637319,909
7649,3756453423,3855937514,1672667530,1672669371,1841
7670,3555214688,3772746272,1672605856,1672607373,1517
7642,3809059934,3278365525,1672560224,1672561949,1725
7648,3344019610,3812176780,1672570626,1672572355,1729
7879,3511198618,3701995648,1672658935,1672662359,3424
7808,3791997875,3513080274,1672558922,1672561133,2211
7704,3289061738,3783206719,1672574477,1672577395,2918
7762,3513454145,3352603894,1672645170,1672646420,1250
7923,3517459919,3713630656,1672552590,1672555971,3381
7836,3778780511,3500066230,1672665593,1672665728,135
7547,3358871377,3783925755,1672700291,1672701978,1687
7673,3339907603,3760893269,1672537262,1672540547,3285
7913,3711504540,3427219654,1672600140,1672601795,1655
7727,3809484172,3774125065,1672623195,1672624929,1734
7580,3312664885,3534191820,1672657501,1672659505,2004
7546,3229058858,3458539365,1672665117,1672667320,2203
7703,3201432789,3346795719,1672598941,1672599840,899
7790,3773664987,3883085535,1672683566,1672684252,686
7518,3772053179,3606987130,1672567683,1672571016,3333
7792,3505635228,3520931254,1672600485,1672601394,909
7609,3774338212,3519700826,1672682437,1672683418,981
7590,3774339795,3303705369,1672618181,1672620815,2634
7909,3380035798,3777717988,1672647695,1672649325,1630
7502,3316222192,3513201436,1672644172,1672645535,1363
7911,3534488837,3303751772,1672551829,1672554034,2205
7872,3500994774,3791997875,1672541864,1672543234,1370
7881,3384951177,3667680268,1672531818,1672533334,1516
7791,3713268590,3920801189,1672534198,1672537645,3447
7820,3202120784,3331845324,1672607851,1672610761,2910
7536,3513599775,3715981584,1672581095,1672581631,536
7518,3756453423,3716746253,1672676891,1672678108,1217
7627,3505869747,3811694763,1672552952,1672555019,2067
7663,3351008918,3627937312,1672536405,1672536607,202
7712,3465202715,3760598102,1672640116,1672642041,1925
7498,3625274012,3516909237,1672703733,1672704672,939
7956,3485008994,3550946908,1672592836,1672594306,1470
7612,3770101921,3249791738,1672603755,1672605457,1702
7768,3772578994,3284639858,1672547296,1672547363,67
7704,3534492426,3791874383,1672674803,1672676362,1559
7909,3979339287,3734828619,1672626841,1672627451,610
7685,3778308417,3513201436,1672606443,1672606658,215
7866,3773814927,3711504540,1672660948,1672662798,1850
7617,3805347939,3791997875,1672664154,1672666586,2432
7736,3200198928,3514987389,1672621895,1672624506,2611
7858,3236102733,3792668962,1672610011,1672611751,1740
7956,3518408774,3793753089,1672579681,1672583124,3443
7826,3606812411,3760992710,1672570348,1672570437,89
7668,3760509236,3496549058,1672611456,1672612535,1079
7893,3710344260,3807987001,1672562750,1672565360,2610
7817,3829764737,3780813786,1672543651,1672544363,712
7943,3628819436,3492478793,1672621602,1672622272,670
7594,3851190615,3666506258,1672588159,1672588584,425
7813,3454042520,3533137446,1672659998,1672662541,2543
7506,3755920131,3518791447,1672620105,1672620715,610
7877,3917278625,3829319703,1672595721,1672598060,2339
7917,3331845324,3516465662,1672616086,1672619356,3270
7773,3304056063,3516960534,1672608455,1672609980,1525
7888,3377766165,3559110998,1672679446,1672680251,805
7602,3534553510,3505098372,1672621338,1672624180,2842
7918,3823600322,3475396323,1672604161,1672607058,2897
7938,3755881905,3359239884,1672605047,1672608045,2998
7757,3778980116,3361230905,1672607874,1672609973,2099
7730,3783126683,3494290908,1672587763,1672590782,3019
7517,3710569131,3828432634,1672564752,1672565927,1175
7891,3899266183,3407673904,1672541664,1672544642,2978
7718,3430352815,3391915886,1672578689,1672579877,1188
7593,3816853177,3793086311,1672649452,1672652826,3374
7512,3711262377,3533369198,1672573124,1672574293,1169
7537,3311415018,3819727225,1672681996,1672683575,1579
7627,3899371911,3624312512,1672638758,1672639176,418
7610,3501486692,3772053179,1672664318,1672667225,2907
7884,3392121505,3313564074,1672578958,1672580199,1241
7906,3512540951,3627937312,1672561705,1672563760,2055
7629,3772544062,3359239884,1672601496,1672604811,3315
7507,3716488385,3311845971,1672569060,1672569360,300
7496,3424922204,3828432634,1672660398,1672660763,365
7506,3774005526,3710112546,1672576389,1672579955,3566
7793,3311718847,3533927138,1672599094,1672601985,2891
7590,3395152943,3772714862,1672690042,1672690392,350
7961,3518932404,3601879040,1672537783,1672539088,1305
7655,3756623396,3351008918,1672660169,1672661234,1065
7915,3780828689,3312829208,1672588986,1672590045,1059
7946,3514472925,3339907603,1672621599,1672623585,1986
7751,3509933351,3736592744,1672583321,1672583769,448
7837,3518932404,3511350608,1672552030,1672554067,2037
7921,3634995491,3421836608,1672703982,1672706286,2304
7891,3792384220,3234362962,1672637597,1672638743,1146
7928,3716537575,3494290908,1672656827,1672657094,267
7638,3783083229,3713268590,1672699869,1672700726,857
7737,3285400528,3901877072,1672692570,1672694848,2278
7528,3829319703,3514987389,1672633357,1672636450,3093
7621,3713808837,3976390453,1672701712,1672702529,817
7564,3391261292,3883042241,1672567003,1672567093,90
7920,3792384220,3477649378,1672683407,1672685892,2485
7504,3714488548,3772309150,1672556964,1672559596,2632
7571,3336751428,3972709319,1672677317,1672679762,2445
7679,3808324264,3783245561,1672556471,1672559203,2732
7675,3783531004,3701898991,1672694108,1672694194,86
7650,3792668962,3703955926,1672695613,1672698803,3190
7586,3783239924,3518932404,1672570902,1672573258,2356
7488,3483164654,3359910781,1672618223,1672621337,3114
7953,3853018906,3533371364,1672649699,1672651010,1311
7588,3517476351,3318697153,1672644815,1672647515,2700
7913,3509352754,3407954858,1672701553,1672704226,2673
7906,3776948966,3901990690,1672533218,1672533599,381
7856,3246596716,3533827120,1672616836,1672620353,3517
7646,3285400528,3731419510,1672555648,1672557870,2222
7527,3517459919,3388372715,1672662791,1672666229,3438
7886,3701146057,3732481297,1672574091,1672574683,592
7926,3606186086,3552314511,1672654049,1672657421,3372
7971,3244173074,3467773920,1672551403,1672552786,1383
7956,3760893269,3757403279,1672591539,1672592299,760
7938,3777983879,3773205565,1672652153,1672654458,2305
7691,3774338212,3791901535,1672694299,1672696298,1999
7621,3405494240,3489728806,1672578013,1672578192,179
7703,3914290246,3312664885,1672649809,1672651584,1775
7483,3516606733,3774195321,1672635555,1672638683,3128
7547,3774268456,3778305740,1672549716,1672550696,980
7589,3388286531,3777120536,1672678786,1672680260,1474
7702,3779528381,3533810360,1672598881,1672601238,2357
7641,3359910781,3715974031,1672643566,1672645638,2072
7728,3374559242,3404384505,1672599940,1672602754,2814
7867,3311274543,3284639858,1672599041,1672599690,649
7734,3517963492,3629547065,1672603042,1672604025,983
7632,3770851318,3755392666,1672636454,1672636652,198
7951,3314836094,3505635228,1672658940,1672662363,3423
7920,3200198928,3888559320,1672533031,1672535792,2761
7758,3311208440,3429690204,1672560070,1672560383,313
7680,3776800213,3516039895,1672574446,1672575115,669
7786,3714821932,3792902982,1672695097,1672697962,2865
7933,3773120434,3500658339,1672594044,1672596388,2344
7532,3488244966,3903962771,1672688369,1672691708,3339
7811,3338703270,3780639480,1672650233,1672650520,287
7571,3811694763,3291227780,1672699900,1672703165,3265
7524,3917278625,3559110998,1672539629,1672542453,2824
7975,3520931254,3550946908,1672702323,1672705126,2803
7502,3760492950,3701178711,1672587687,1672588937,1250
7544,3500499542,3716168623,1672678354,1672680891,2537
7521,3493507965,3338367113,1672555122,1672557477,2355
7728,3409474775,3816853177,1672577350,1672578026,676
7967,3778108318,3307097200,1672562454,1672562708,254
7834,3247428249,3779528381,1672653427,1672654757,1330
7797,3755587522,3711569060,1672617641,1672618527,886
7545,3228165483,3500177712,1672592266,1672593488,1222
7822,3511198618,3417970574,1672569885,1672570942,1057
7656,3973560347,3500805881,1672630682,1672632957,2275
7719,3222521619,3883042241,1672540562,1672540650,88
7798,3284832486,3451432842,1672551736,1672553587,1851
7562,3755392666,3610348516,1672538203,1672540256,2053
7754,3510969660,3271938399,1672662059,1672665046,2987
7627,3533653428,3515284591,1672696506,1672699108,2602
7982,3515860749,3360743849,1672570319,1672572048,1729
7537,3420432297,3311065516,1672617300,1672618498,1198
7924,3773598056,3493507965,1672546072,1672547002,930
7842,3901990690,3472130842,1672629487,1672632806,3319
7522,3490191091,3298433163,1672675473,1672676961,1488
7757,3311154569,3534553510,1672682075,1672685456,3381
7520,3520730271,3915628728,1672536932,1672539839,2907
7625,3826633236,3430074045,1672690703,1672693511,2808
7513,3485823740,3511359172,1672661169,1672663352,2183
7535,3772309166,3221536550,1672622344,1672624876,2532
7733,3200198928,3520730271,1672602784,1672604409,1625
7848,3399004969,3935127663,1672611691,1672613579,1888
7885,3779629905,3501730685,1672588400,1672589170,770
7547,3489728806,3755920131,1672663101,1672664698,1597
7497,3683766533,3757447189,1672658269,1672661068,2799
7568,3780503655,3778305740,1672636870,1672636985,115
7833,3510703546,3685818092,1672621742,1672624765,3023
7678,3774204963,3223789409,1672632619,1672633676,1057
7547,3780609808,3232962003,1672654910,1672657970,3060
7884,3909331423,3703013906,1672602159,1672604238,2079
7952,3829232696,3369998498,1672586078,1672588167,2089
7568,3496269445,3516960534,1672606872,1672610236,3364
7622,3533371364,3662180254,1672651413,1672654854,3441
7504,3533137446,3770635361,1672543198,1672544893,1695
7644,3755625324,3792883665,1672650185,1672651696,1511
7676,3975287541,3518669703,1672683221,1672684149,928
7659,3349613093,3903307060,1672672634,1672674488,1854
7484,3918674986,3701274634,1672587683,1672588802,1119
7834,3285400528,3505145247,1672682997,1672685309,2312
7607,3711265369,3520376528,1672673485,1672677074,3589
7502,3713268590,3757151210,1672659001,1672660879,1878
7506,3791901535,3716168623,1672585865,1672587720,1855
7811,3888559320,3276993580,1672576167,1672579399,3232
7854,3505599848,3858918246,1672536655,1672536911,256
7865,3313564074,3509907947,1672640191,1672641424,1233
7821,3411618230,3533371364,1672702592,1672703123,531
7761,3509352754,3925402713,1672610361,1672611301,940
7729,3713786889,3346327502,1672637728,1672640612,2884
7837,3438645253,3316222192,1672618638,1672618789,151
7573,3703789494,3415443558,1672653366,1672656067,2701
7847,3926700506,3628819436,1672539931,1672540789,858
7902,3608633356,3516980378,1672694170,1672694800,630
7827,3828624701,3780813786,1672580669,1672583805,3136
7867,3518014404,3778549126,1672556026,1672558116,2090
7735,3776513891,3517963492,1672674719,1672678090,3371
7975,3883312122,3517864478,1672584911,1672586434,1523
7797,3811694763,3427283336,1672663516,1672665066,1550
7921,3976633198,3294803686,1672547284,1672549363,2079
7958,3515723720,3510380060,1672536783,1672537537,754
7549,3772359096,3701691675,1672629266,1672629489,223
7547,3629935998,3378686918,1672700024,1672702081,2057
7755,3859525941,3518163778,1672659644,1672661003,1359
7756,3318697153,3518876135,1672555594,1672557517,1923
7785,3534191820,3510969660,1672626484,1672627233,749
7808,3517509185,3516465662,1672538872,1672542416,3544
7884,3610348516,3774466457,1672544116,1672544363,247
7731,3346327502,3755042098,1672645067,1672647062,1995
7668,3737051610,3388637594,1672671020,1672671865,845
7517,3713370078,3710067113,1672623419,1672624989,1570
7595,3833889105,3289061738,1672641377,1672642611,1234
7798,3512837326,3304625412,1672694998,1672695542,544
7962,3298288268,3935627557,1672637392,1672638525,1133
7570,3392121505,3714821932,1672651731,1672653549,1818
7551,3711308224,3664170666,1672675672,1672678178,2506
7727,3634340855,3773205565,1672611473,1672613115,1642
7654,3518360734,3777806071,1672558714,1672560084,1370
7540,3811171116,3370636709,1672536160,1672536576,416
7983,3783196518,3802367797,1672677786,1672678150,364
7670,3387674757,3500658339,1672545976,1672547351,1375
7552,3614238812,3367902229,1672595861,1672598979,3118
7899,3483164654,3360743849,1672552148,1672555737,3589
7552,3820354437,3793286136,1672605049,1672607323,2274
7813,3667680268,3792789881,1672565757,1672567063,1306
7733,3510703546,3311648200,1672601895,1672602785,890
7780,3608868877,3520709480,1672534721,1672537077,2356
7497,3206593906,3466911760,1672684778,1672686731,1953
7560,3511125626,3604539807,1672606866,1672610212,3346
7687,3533242305,3760489031,1672690694,1672691517,823
7846,3505791599,3360743849,1672681038,1672684584,3546
7588,3779976989,3291235378,1672681839,1672682188,349
7870,3311993075,3713630656,1672587023,1672589186,2163
7484,3772746272,3533280269,1672617178,1672620072,2894
7679,3778980116,3601879040,1672653652,1672655072,1420
7658,3505347134,3760267716,1672632076,1672632364,288
7873,3302626661,3512217942,1672538441,1672541915,3474
7693,3774793839,3829232696,1672635963,1672636952,989
7570,3394539273,3911245524,1672680633,1672682981,2348
7498,3792177074,3244389794,1672562057,1672563147,1090
7845,3304056063,3451432842,1672564861,1672566822,1961
7978,3415443558,3611150562,1672572376,1672573163,787
7633,3279721246,3429690204,1672554799,1672556230,1431
7765,3465254146,3713969578,1672672218,1672672625,407
7933,3809059934,3349613093,1672535059,1672537454,2395
7589,3311154569,3314245084,1672619717,1672621769,2052
7498,3777120536,3827222533,1672583054,1672583424,370
7691,3774010081,3774466457,1672608430,1672611170,2740
7828,3515860749,3883085535,1672531359,1672531687,328
7808,3446948848,3792668962,1672627396,1672627564,168
7794,3416241005,3918584946,1672589222,1672591993,2771
7707,3500499542,3391261292,1672613453,1672616730,3277
7620,3337544549,3772337814,1672569393,1672570942,1549
7981,3439023335,3533748232,1672571003,1672573221,2218
7781,3909606423,3483949762,1672597761,1672599500,1739
7752,3520629279,3311993075,1672638206,1672641021,2815
7546,3370636709,3509604974,1672665383,1672667465,2082
7621,3815508790,3837094550,1672658625,1672662182,3557
7657,3501955238,3883085535,1672548723,1672550236,1513
7969,3891751546,3809059934,1672597474,1672598672,1198
7828,3625274012,3899371911,1672658580,1672661872,3292
7920,3716835696,3925620998,1672621079,1672622177,1098
7487,3505145247,3318166135,1672558745,1672560192,1447
7619,3621810464,3773814927,1672543653,1672546271,2618
7668,3918584946,3777443199,1672653736,1672655908,2172
7483,3516514391,3399433690,1672679133,1672679715,582
7748,3509630174,3227158514,1672681969,1672682373,404
7741,3858918246,3517077106,1672532520,1672534195,1675
7861,3520165601,3857349323,1672676621,1672679412,2791
7619,3342131135,3833889105,1672616479,1672616832,353
7569,3515151980,3517509185,1672694694,1672694867,173
7850,3424922204,3688418210,1672690227,1672691550,1323
7650,3291883916,3500374658,1672680531,1672683100,2569
7781,3617734118,3737051610,1672548005,1672548699,694
7832,3701534009,3291235378,1672627695,1672629462,1767
7727,3772642849,3780788622,1672621080,1672623467,2387
7523,3615046771,3501483568,1672683099,1672686647,3548
7883,3516223597,3783126683,1672571510,1672572489,979
7857,3511435497,3501483568,1672659779,1672660775,996
7508,3500229033,3760992710,1672635713,1672638042,2329
7783,3201324715,3231056870,1672680193,1672681030,837
7898,3443698222,3914290246,1672635712,1672636144,432
7793,3703735129,3512567240,1672702162,1672704340,2178
7663,3345207877,3756528686,1672596624,1672597979,1355
7767,3793959750,3780503655,1672586972,1672588677,1705
7581,3518791447,3978105277,1672585714,1672586505,791
7491,3520012395,3367029997,1672616984,1672619456,2472
7747,3772746272,3701863557,1672667516,1672668998,1482
7602,3774580701,3428964059,1672603886,1672604407,521
7894,3791594391,3757682496,1672662764,1672665665,2901
7981,3516514391,3334033993,1672629878,1672630264,386
7593,3773598056,3760294205,1672604519,1672605902,1383
7701,3518014636,3973560347,1672681467,1672684023,2556
7502,3777717988,3496051529,1672690080,1672690816,736
7899,3828365570,3389115045,1672628780,1672629869,1089
7978,3711370563,3713630656,1672632980,1672635243,2263
7486,3737079798,3757812939,1672540087,1672543028,2941
7702,3520629279,3608868877,1672604141,1672605170,1029
7573,3903307060,3224716315,1672577813,1672578799,986
7504,3505638204,3801089989,1672689142,1672692295,3153
7790,3412980697,3899266183,1672550468,1672552596,2128
7925,3756623396,3770078063,1672655098,1672656624,1526
7581,3480687894,3400804807,1672622060,1672623562,1502
7793,3515151980,3791602225,1672703034,1672704245,1211
7591,3701863557,3716746253,1672692658,1672694400,1742
7777,3339907603,3505962865,1672669180,1672670647,1467
7736,3438645253,3774793839,1672648879,1672652274,3395
7754,3792789881,3519700826,1672536444,1672538747,2303
7715,3515691540,3311274543,1672694699,1672697857,3158
7810,3779740455,3755392666,1672559803,1672562677,2874
7934,3853018906,3520751702,1672561598,1672561994,396
7806,3882242815,3979339287,1672661084,1672663228,2144
7671,3757151210,3772746272,1672582468,1672585002,2534
7595,3412980697,3439023335,1672650300,1672650551,251
7634,3901990690,3883042241,1672589115,1672592667,3552
7533,3773950140,3737051610,1672602147,1672605740,3593
7873,3505912939,3429690204,1672665674,1672666410,736
7922,3362000049,3505000737,1672544914,1672547585,2671
7754,3404384505,3516980378,1672624241,1672624341,100
7774,3793753089,3367029997,1672566292,1672567740,1448
7860,3399433690,3228165483,1672617078,1672619297,2219
7780,3510173870,3311065516,1672670340,1672670587,247
7491,3505201246,3201324715,1672604298,1672604392,94
7560,3249791738,3249791738,1672600367,1672602913,2546
7806,3793959750,3489728806,1672637362,1672638688,1326
7625,3817621391,3634786711,1672612054,1672615353,3299
7693,3284639858,3312333615,1672536345,1672536725,380
7847,3391261292,3228165483,1672550945,1672553134,2189
7770,3533927138,3778341199,1672559197,1672562006,2809
7775,3365614305,3520706195,1672553333,1672555996,2663
7875,3899204805,3550946908,1672635063,1672637498,2435
7751,3774501422,3855424474,1672621827,1672624712,2885
7754,3774366875,3520376528,1672638598,1672641965,3367
7693,3209027249,3637008488,1672599381,1672600010,629
7627,3511163800,3792032359,1672660326,1672661015,689
7517,3819727225,3888559320,1672647662,1672647732,70
7907,3512142794,3500391167,1672618485,1672619838,1353
7961,3770021824,3634995491,1672662979,1672665131,2152
7950,3314836094,3517509185,1672693424,1672695633,2209
7577,3606812411,3882997884,1672672301,1672675119,2818
7824,3311415018,3249247700,1672664290,1672667729,3439
7904,3311627628,3418728074,1672685353,1672686121,768
7555,3688418210,3922275620,1672697953,1672700306,2353
7826,3774045700,3617055293,1672613361,1672614173,812
7780,3513164386,3757682496,1672669071,1672671589,2518
7924,3493507965,3405494240,1672676409,1672676750,341
7684,3809916577,3430352815,1672559544,1672562648,3104
7938,3757455053,3411618230,1672661392,1672664446,3054
7815,3701863557,3206254161,1672658937,1672662270,3333
7867,3978115672,3829319703,1672659411,1672660041,630
7946,3791657947,3520376528,1672558369,1672559691,1322
7548,3772884106,3432665384,1672679087,1672680424,1337
7898,3760077057,3391915886,1672636148,1672636877,729
7889,3228165483,3487171044,1672585816,1672587236,1420
7655,3473765852,3510771358,1672552385,1672555917,3532
7496,3505904952,3500458761,1672557109,1672558451,1342
7846,3411618230,3760598102,1672578312,1672578522,210
7649,3825229501,3777514571,1672563091,1672565421,2330
7897,3755392666,3534191820,1672694545,1672695964,1419
7544,3800353779,3711571712,1672676915,1672678904,1989
7680,3533385867,3520376528,1672605705,1672607410,1705
7582,3809916577,3885670556,1672584083,1672584372,289
7879,3756966035,3792668962,1672703688,1672705700,2012
7592,3533927138,3853018906,1672570717,1672571044,327
7692,3511125626,3716835696,1672585363,1672587382,2019
7716,3221536550,3234541252,1672651161,1672653688,2527
7557,3777079686,3886298125,1672686795,1672689282,2487
7674,3383661227,3776800213,1672631988,1672633319,1331
7484,3500658339,3379256399,1672606570,1672607646,1076
7871,3234541252,3501730685,1672578173,1672581687,3514
7890,3520376528,3839849341,1672541548,1672542383,835
7661,3465254146,3783083229,1672674273,1672675686,1413
7827,3780503655,3415546117,1672587152,1672589213,2061
7841,3703871468,3520629279,1672697938,1672698250,312
7565,3760598102,3227158514,1672594259,1672595489,1230
7570,3613995936,3774066725,1672588818,1672590580,1762
7882,3701190899,3518932404,1672672266,1672672388,122
7926,3286658957,3738274418,1672622178,1672624369,2191
7802,3223789409,3793753089,1672702456,1672704588,2132
7669,3500374658,3505173328,1672534044,1672536917,2873
7956,3500199935,3633420270,1672578161,1672580175,2014
7731,3533193862,3515691540,1672578373,1672579600,1227
7943,3384951177,3552314511,1672572605,1672575909,3304
7859,3777717988,3509933351,1672534556,1672536108,1552
7649,3311871871,3735733948,1672701424,1672704209,2785
7598,3516606733,3511841857,1672686675,1672689235,2560
7883,3858918246,3837094550,1672606350,1672609537,3187
7849,3703718151,3311203656,1672537736,1672539455,1719
7898,3774005526,3883085535,1672647398,1672649899,2501
7752,3855602893,3222448362,1672532533,1672532775,242
7561,3627937312,3777120536,1672575325,1672576520,1195
7759,3500391167,3778305740,1672633691,1672633831,140
7483,3701146057,3739106581,1672567751,1672570742,2991
7597,3858918246,3451432842,1672571550,1672573673,2123
7643,3512349371,3339907603,1672538995,1672541032,2037
7581,3774119563,3519912874,1672633422,1672634572,1150
7557,3738274418,3701498253,1672684097,1672687022,2925
7650,3774339795,3628819436,1672699461,1672701522,2061
7523,3517963492,3734496778,1672702707,1672704167,1460
7945,3400918687,3510969660,1672636284,1672638137,1853
7816,3517077106,3505638204,1672703210,1672706182,2972
7968,3836573197,3772746272,1672666757,1672667995,1238
7787,3855602893,3505219850,1672676780,1672680316,3536
7686,3757682496,3518014404,1672651188,1672654353,3165
7895,3505599848,3473765852,1672627323,1672629192,1869
7812,3505869747,3372883226,1672565618,1672568728,3110
7772,3627937312,3773664987,1672654102,1672657029,2927
7862,3516223597,3518876135,1672631425,1672632638,1213
7604,3346327502,3505599848,1672576341,1672579555,3214
7747,3600647945,3806545488,1672682846,1672685235,2389
7648,3703955926,3433804879,1672702976,1672703713,737
7856,3770101921,3636867411,1672634794,1672636102,1308
7851,3516039895,3519069599,1672677696,1672678089,393
7677,3703718151,3800886801,1672644112,1672645378,1266
7918,3429856982,3755739653,1672635056,1672635843,787
7536,3778780511,3489545239,1672607303,1672609205,1902
7945,3735733948,3201324715,1672546721,1672546784,63
7856,3891751546,3232962003,1672575767,1672577716,1949
7810,3372883226,3426325549,1672573105,1672575037,1932
7532,3937224533,3534492426,1672627232,1672630113,2881
7642,3451432842,3774005526,1672599549,1672601619,2070
7558,3734496778,3972364603,1672543226,1672545725,2499
7737,3388372715,3533025282,1672577399,1672577460,61
7613,3823600322,3389115045,1672656357,1672656977,620
7928,3774793839,3288764520,1672650895,1672651532,637
7855,3231056870,3223789409,1672673947,1672677205,3258
7801,3792473331,3509604974,1672646285,1672647002,717
7744,3438645253,3515394721,1672654412,1672657851,3439
7570,3660493209,3885897503,1672640579,1672641723,1144
7873,3688683847,3792902982,1672574647,1672577138,2491
7866,3200198928,3229665776,1672535695,1672537348,1653
7858,3911159965,3467773920,1672651966,1672654090,2124
7675,3313564074,3365942576,1672585821,1672585980,159
7544,3519152550,3925620998,1672692617,1672693815,1198
7689,3472130842,3828624701,1672690717,1672691095,378
7840,3909606423,3822654369,1672702806,1672703358,552
7546,3855602893,3777514571,1672655882,1672656003,121
7675,3833889105,3302626661,1672679452,1672680559,1107
7764,3489217083,3416241005,1672602854,1672605645,2791
7744,3514128943,3501184421,1672581011,1672582781,1770
7573,3332072298,3515691540,1672587064,1672590132,3068
7512,3783705817,3792473331,1672535716,1672536092,376
7692,3500066230,3716537575,1672670185,1672671578,1393
7859,3234541252,3337544549,1672651445,1672651932,487
7487,3703871468,3409474775,1672663743,1672666687,2944
7841,3809916577,3379589402,1672699232,1672700139,907
7853,3713894336,3517077106,1672698999,1672700862,1863
7694,3478194807,3420432297,1672564177,1672564417,240
7859,3915628728,3451432842,1672574865,1672575432,567
7869,3683766533,3516716179,1672580191,1672582771,2580
7878,3223789409,3399433690,1672668316,1672670345,2029
7567,3388372715,3533748232,1672596204,1672598775,2571
7575,3336742544,3493507965,1672597167,1672598707,1540
7539,3429690204,3668005723,1672635809,1672636161,352
7640,3428006164,3715974031,1672602686,1672605818,3132
7815,3703735129,3683959482,1672645525,1672646089,564
7717,3898995675,3755392666,1672673217,1672673516,299
7560,3885670556,3510380060,1672537458,1672538628,1170
7825,3224058172,3284639858,1672698704,1672700021,1317
7559,3311208440,3791020967,1672579351,1672581382,2031
7543,3852595551,3829232696,1672551927,1672554046,2119
7673,3312664885,3505883609,1672621105,1672624104,2999
7880,3760489031,3396285984,1672629297,1672629753,456
7646,3918056059,3711569060,1672691901,1672694955,3054
7873,3311718847,3713349754,1672587979,1672590776,2797
7587,3756027749,3428674539,1672661439,1672662985,1546
7882,3755798867,3515723720,1672669145,1672671728,2583
7770,3780593036,3688418210,1672622088,1672625182,3094
7661,3667680268,3683766533,1672578535,1672580097,1562
7613,3518876135,3517963492,1672623558,1672625950,2392
7858,3918674986,3511359172,1672596840,1672599584,2744
7813,3520206212,3713786889,1672688176,1672691697,3521
7653,3430504438,3427219654,1672544154,1672547740,3586
7930,3757161914,3770078063,1672649112,1672652185,3073
7639,3774580701,3911159965,1672622161,1672623332,1171
7864,3828624701,3817316561,1672531384,1672534378,2994
7541,3234541252,3303705369,1672586800,1672589636,2836
7793,3316222192,3783779671,1672591127,1672591616,489
7955,3881477378,3772642849,1672597660,1672600071,2411
7621,3209027249,3660493209,1672659604,1672661255,1651
7920,3412980697,3417970574,1672699679,1672700825,1146
7593,3285400528,3231056870,1672655848,1672658064,2216
7710,3490191091,3364543015,1672680527,1672681056,529
7717,3500391167,3757455053,1672595723,1672596967,1244
7655,3909331423,3472130842,1672578448,1672578842,394
7896,3505477652,3509630174,1672669416,1672672404,2988
7515,3516673015,3501692334,1672670658,1672672956,2298
7617,3713630656,3505702787,1672695885,1672699276,3391
7743,3235635976,3778549126,1672683693,1672686589,2896
7961,3626156564,3231056870,1672557166,1672560244,3078
7594,3667680268,3348261553,1672540270,1672541680,1410
7982,3783196518,3774010081,1672659226,1672660689,1463
7618,3285400528,3365942576,1672532998,1672533706,708
7644,3703223015,3813052709,1672568170,1672570207,2037
7871,3505347134,3511841857,1672692756,1672695100,2344
7967,3627937312,3774298222,1672537017,1672539781,2764
7853,3312829208,3783239924,1672538249,1672538359,110
7710,3421836608,3351554343,1672647263,1672650270,3007
7703,3358871377,3510247121,1672576871,1672579089,2218
7710,3520931254,3800886801,1672694448,1672695304,856
7652,3489728806,3772359096,1672600570,1672602754,2184
7498,3639847263,3344019610,1672621856,1672625340,3484
7906,3475251781,3297463265,1672697476,1672697851,375
7875,3284832486,3420700674,1672605762,1672607747,1985
7494,3688683847,3711504540,1672684483,1672685345,862
7891,3889750851,3319752091,1672600527,1672603973,3446
7656,3827626797,3917088658,1672579356,1672579466,110
7582,3387966152,3412980697,1672536248,1672536428,180
7636,3792177074,3313564074,1672699053,1672701797,2744
7863,3277939457,3760561634,1672640102,1672640486,384
7659,3793962300,3514283243,1672670686,1672673559,2873
7872,3514283243,3755943611,1672594786,1672595060,274
7957,3395152943,3930797455,1672628229,1672629040,811
7580,3755872268,3912536808,1672699603,1672700308,705
7544,3397418363,3500803339,1672625855,1672629193,3338
7578,3858918246,3780914982,1672566170,1672569366,3196
7633,3911159965,3534424200,1672547481,1672549869,2388
7496,3806545488,3234362962,1672679777,1672680541,764
7614,3512142794,3685818092,1672599995,1672602433,2438
7668,3813052709,3438645253,1672582661,1672585111,2450
7870,3520730271,3394330287,1672552659,1672553731,1072
7602,3399052055,3895562476,1672680010,1672680122,112
7704,3319752091,3911159965,1672618273,1672619720,1447
7815,3332072298,3311603601,1672596287,1672598974,2687
7730,3710112546,3779036831,1672623335,1672624965,1630
7854,3430504438,3315583351,1672635658,1672638350,2692
7805,3509634629,3915628728,1672537770,1672540970,3200
7566,3834257412,3511359172,1672693313,1672696364,3051
7869,3855000166,3715339701,1672691359,1672692032,673
7973,3505201246,3475795792,1672625019,1672627744,2725
7575,3783429780,3478194807,1672550551,1672552610,2059
7898,3791602225,3387674757,1672544738,1672548132,3394
7560,3500374658,3783239924,1672693315,1672696788,3473
7867,3773978034,3358871377,1672540915,1672542956,2041
7785,3629547065,3424922204,1672552206,1672553270,1064
7583,3777776687,3280615985,1672635200,1672636906,1706
7635,3730517636,3774010081,1672660021,1672662810,2789
7981,3420432297,3791942683,1672546557,1672546642,85
7730,3608633356,3314245084,1672614738,1672616997,2259
7885,3918247820,3494290908,1672651880,1672654543,2663
7899,3774050956,3883861463,1672550205,1672553449,3244
7568,3427219654,3388637594,1672589604,1672593005,3401
7693,3818255890,3774338212,1672578831,1672579507,676
7982,3361230905,3512142794,1672563682,1672563987,305
7529,3505477652,3779036831,1672634854,1672637285,2431
7952,3505702787,3399004969,1672654848,1672657247,2399
7933,3714197325,3916289176,1672541487,1672543679,2192
7747,3483949762,3487171044,1672620308,1672623311,3003
7863,3979339287,3777079686,1672644675,1672645023,348
7952,3399911573,3514838220,1672540949,1672541343,394
7883,3783206719,3533242305,1672676597,1672679495,2898
7629,3311415018,3415443558,1672624487,1672625119,632
7882,3534492426,3772578994,1672671087,1672672881,1794
7619,3511271692,3501184421,1672549206,1672551687,2481
7498,3221899927,3500994774,1672585830,1672586912,1082
7584,3701065786,3276993580,1672557739,1672558334,595
7731,3556951786,3760183458,1672691193,1672693292,2099
7634,3331845324,3912536808,1672620283,1672622808,2525
7973,3979339287,3713349754,1672582562,1672585902,3340
7967,3223968713,3800886801,1672697286,1672698912,1626
7953,3497901842,3501606184,1672639299,1672642747,3448
7494,3480687894,3617734118,1672599120,1672599625,505
7727,3777929708,3662180254,1672582777,1672584904,2127
7978,3520751702,3505962865,1672572855,1672573121,266
7647,3895562476,3244173074,1672582429,1672584220,1791
7905,3626156564,3618045231,1672621439,1672624292,2853
7792,3760561634,3416265063,1672594797,1672595554,757
7679,3380035798,3777717988,1672628694,1672632154,3460
7693,3517963492,3703275621,1672683632,1672685445,1813
7589,3701863557,3505203158,1672669364,1672670474,1110
7797,3510247121,3772544062,1672593932,1672595026,1094
7501,3365942576,3487171044,1672556894,1672557874,980
7977,3520706195,3976390453,1672658783,1672659473,690
7725,3932051427,3757161914,1672572688,1672573418,730
7934,3777929708,3518260334,1672623152,1672625698,2546
7980,3451432842,3756453423,1672577756,1672580031,2275
7650,3904408902,3516909237,1672680492,1672681563,1071
7701,3420432297,3774793839,1672572924,1672574385,1461
7980,3518876135,3471220483,1672688938,1672692502,3564
7767,3629935998,3899371911,1672572103,1672574995,2892
7791,3311718847,3312664885,1672666745,1672667689,944
7610,3776066388,3777806071,1672578523,1672580258,1735
7768,3809059934,3792844210,1672578127,1672578652,525
7747,3808324264,3406784491,1672640974,1672643525,2551
7717,3881477378,3516258476,1672613448,1672615235,1787
7553,3855602893,3918584946,1672590908,1672594339,3431
7881,3505973226,3505635228,1672594191,1672594527,336
7723,3224716315,3516465662,1672608702,1672611595,2893
7626,3736786443,3415546117,1672666225,1672667740,1515
7614,3500374658,3815508790,1672585751,1672586810,1059
7558,3822654369,3773120434,1672688672,1672689118,446
7778,3519654779,3811171116,1672550629,1672551322,693
7589,3533369198,3429856982,1672604346,1672606477,2131
7553,3625274012,3883861463,1672633371,1672634737,1366
7566,3777717988,3533748232,1672552401,1672552811,410
7924,3736229191,3701178711,1672650279,1672651037,758
7816,3500229033,3312829208,1672691528,1672692757,1229
7914,3500894271,3387966152,1672545188,1672546691,1503
7845,3885670556,3909238838,1672693726,1672695840,2114
7918,3284832486,3760077057,1672668706,1672669782,1076
7493,3703013906,3311439795,1672549761,1672553147,3386
7676,3703955926,3902278226,1672687440,1672688106,666
7810,3509907947,3757161914,1672577710,1672580478,2768
7706,3791997875,3711198793,1672595320,1672595585,265
7978,3715974031,3774010081,1672595555,1672596745,1190
7870,3791657947,3407954858,1672535035,1672536726,1691
7498,3801089989,3779218771,1672699107,1672701834,2727
7735,3397418363,3772746272,1672614065,1672616190,2125
7813,3711380716,3778341199,1672659502,1672661144,1642
7824,3505962865,3514719601,1672597511,1672598221,710
7616,3428674539,3451432842,1672631762,1672632239,477
7499,3293695955,3760077057,1672540734,1672543797,3063
7504,3739106581,3505362057,1672649153,1672649972,819
7539,3777776687,3736786443,1672668833,1672671368,2535
7824,3231056870,3420432297,1672671559,1672671733,174
7738,3424922204,3772642849,1672599916,1672603432,3516
7649,3882291183,3505347134,1672597262,1672598889,1627
7499,3828365570,3510380060,1672681035,1672683416,2381
7736,3459030804,3713808837,1672645212,1672646855,1643
7883,3513454145,3629935998,1672579865,1672581222,1357
7734,3511125626,3756453423,1672597373,1672599338,1965
7728,3510126867,3855000166,1672696067,1672698597,2530
7819,3792902982,3505904952,1672636472,1672637106,634
7653,3622054816,3516909237,1672614416,1672615799,1383
7881,3783779671,3809484172,1672625074,1672627522,2448
7727,3792844210,3776948966,1672621217,1672623116,1899
7827,3774793839,3634995491,1672548924,1672549939,1015
7924,3533095755,3284639858,1672641595,1672641701,106
7614,3466229085,3369998498,1672611989,1672612885,896
7560,3800886801,3601879040,1672634390,1672634570,180
7554,3899204805,3733189298,1672594840,1672596381,1541
7795,3534010629,3344019610,1672542943,1672545112,2169
7587,3793086311,3666506258,1672663591,1672665520,1929
7553,3430504438,3512510536,1672548668,1672548843,175
7563,3711380716,3519563836,1672632247,1672633219,972
7800,3332072298,3716900301,1672659365,1672660606,1241
7640,3780639480,3714821932,1672613139,1672616277,3138
7515,3909606423,3365942576,1672546052,1672548495,2443
7795,3510937904,3244436890,1672676553,1672679242,2689
7740,3780813786,3519703355,1672582995,1672584282,1287
7563,3793962300,3783196518,1672661817,1672662208,391
7913,3533810360,3779976989,1672585144,1672586317,1173
7627,3701691675,3792253549,1672548674,1672549965,1291
7741,3416265063,3791874383,1672634399,1672637596,3197
7733,3827377568,3783206719,1672630852,1672633331,2479
7485,3421836608,3520751702,1672684881,1672685048,167
7540,3755392666,3249247700,1672547984,1672550109,2125
7777,3314836094,3621497531,1672601896,1672604616,2720
7536,3513454145,3970117174,1672620858,1672621333,475
7941,3774066725,3399911573,1672531604,1672532140,536
7955,3904775198,3901990690,1672648924,1672652467,3543
7884,3480687894,3316173088,1672643048,1672645513,2465
7619,3881477378,3520190170,1672637082,1672639965,2883
7688,3497901842,3701995648,1672580133,1672582572,2439
7977,3407725581,3610348516,1672587037,1672588847,1810
7921,3835382117,3201324715,1672634224,1672637417,3193
7569,3512720680,3336742544,1672686982,1672688445,1463
7551,3511862351,3374559242,1672573377,1672573545,168
7958,3715974031,3774010081,1672566479,1672568411,1932
7639,3516514391,3475251781,1672539435,1672540426,991
7653,3852391257,3510244400,1672701140,1672704504,3364
7688,3918056059,3614238812,1672550823,1672552499,1676
7910,3621497531,3778266283,1672621461,1672624320,2859
7808,3346795719,3914290246,1672684493,1672685493,1000
7624,3770021824,3792668962,1672564377,1672566451,2074
7859,3773120434,3783196518,1672542643,1672543728,1085
7936,3227457126,3221536550,1672638345,1672638733,388
7709,3688418210,3505193212,1672639553,1672642276,2723
7758,3231056870,3296471982,1672644416,1672645347,931
7501,3716165213,3534191820,1672643035,1672643096,61
7526,3939952128,3534488837,1672700538,1672702523,1985
7843,3926700506,3284832486,1672579664,1672581970,2306
7795,3634786711,3520931254,1672556356,1672558811,2455
7756,3801089989,3817621391,1672660675,1672661859,1184
7547,3777623166,3411618230,1672623788,1672626777,2989
7713,3779528381,3774339795,1672601967,1672603336,1369
7851,3311627628,3779218771,1672653016,1672655602,2586
7717,3774466457,3439023335,1672680884,1672681702,818
7800,3770021824,3311203656,1672668880,1672669709,829
7795,3898995675,3716746253,1672531776,1672534276,2500
7681,3817316561,3420432297,1672616529,1672618625,2096
7914,3338367113,3703661585,1672618206,1672620977,2771
7809,3855937514,3701984666,1672679047,1672680976,1929
7873,3311871871,3883042241,1672596050,1672597147,1097
7937,3701190899,3533369198,1672629595,1672631561,1966
7532,3509907947,3822654369,1672569800,1672572530,2730
7880,3311415018,3713894336,1672703840,1672704392,552
7500,3890149705,3505201246,1672535768,1672536766,998
7690,3477649378,3505135325,1672614233,1672614577,344
7499,3514838220,3901990690,1672570147,1672570505,358
7872,3505599848,3716273414,1672658816,1672659624,808
7587,3774125065,3930791338,1672655338,1672658537,3199
7692,3501606184,3496549058,1672551967,1672554173,2206
7540,3315583351,3360743849,1672582080,1672585348,3268
7972,3417970574,3384951177,1672544705,1672545180,475
7550,3301107849,3509604974,1672663007,1672665084,2077
7552,3361230905,3901990690,1672640157,1672642612,2455
7545,3284832486,3550946908,1672652260,1672653209,949
7918,3501198706,3505219850,1672593951,1672596707,2756
7762,3812176780,3518876135,1672534321,1672535963,1642
7761,3484995752,3364543015,1672560076,1672562123,2047
7650,3397418363,3756424865,1672668769,1672669079,310
7509,3487171044,3402943525,1672562314,1672564553,2239
7634,3513201436,3826759140,1672681791,1672683623,1832
7628,3519428855,3664517356,1672644882,1672647367,2485
7506,3936227020,3318166135,1672585661,1672588403,2742
7892,3829232696,3809484172,1672664932,1672668006,3074
7934,3733189298,3668898102,1672574204,1672577775,3571
7531,3520719611,3556951786,1672559917,1672562222,2305
7791,3770851318,3634995491,1672690589,1672690782,193
7738,3899204805,3755436115,1672679881,1672681990,2109
7772,3349613093,3533748232,1672636938,1672638539,1601
7848,3475795792,3760569731,1672606554,1672607963,1409
7798,3975287541,3605726278,1672667793,1672670959,3166
7945,3701184889,3925620998,1672592764,1672594075,1311
7526,3791334389,3713894336,1672582950,1672584855,1905
7807,3889232789,3909606423,1672581988,1672585447,3459
7543,3902383721,3206254161,1672649534,1672651892,2358
7973,3520719611,3682061100,1672595407,1672596505,1098
7793,3202120784,3780914982,1672585412,1672586367,955
7705,3496549058,3367029997,1672626477,1672628113,1636
7875,3760077057,3637008488,1672618091,1672618619,528
7922,3485375593,3284639858,1672635355,1672635817,462
7521,3772359096,3829319703,1672652352,1672652802,450
7636,3682061100,3505292701,1672638793,1672640673,1880
7678,3829764737,3515860749,1672589013,1672591441,2428
7660,3500199935,3391261292,1672622775,1672625961,3186
7626,3533270638,3520376528,1672659006,1672659609,603
7501,3466911760,3626156564,1672692165,1672694223,2058
7885,3519069599,3701146057,1672552956,1672553150,194
7513,3384951177,3361230905,1672673180,1672674508,1328
7527,3792789881,3511687358,1672666369,1672669941,3572
7483,3429690204,3298433163,1672688175,1672691297,3122
7670,3517721725,3291227780,1672624909,1672625162,253
7817,3509773875,3714504419,1672685476,1672687705,2229
7802,3701995648,3555214688,1672586567,1672589881,3314
7730,3312664885,3716488385,1672619694,1672623077,3383
7577,3931941795,3716835696,1672653553,1672654077,524
7712,3979339287,3446948848,1672640646,1672644191,3545
7532,3411618230,3273500349,1672570605,1672570712,107
7861,3389115045,3346327502,1672630117,1672630970,853
7716,3774127586,3736229191,1672589935,1672593377,3442
7694,3792789881,3501483568,1672575744,1672575831,87
7842,3805292782,3487171044,1672552834,1672554589,1755
7773,3701498253,3972364603,1672598391,1672601850,3459
7956,3520730271,3921211276,1672532169,1672534022,1853
7527,3360506772,3760569731,1672535120,1672537299,2179
7674,3776338577,3319752091,1672651927,1672652193,266
7968,3778305740,3760992710,1672647993,1672650242,2249
7938,3533810360,3703889596,1672548509,1672551850,3341
7532,3318166135,3465202715,1672569801,1672571508,1707
7801,3855937514,3777623166,1672611614,1672613007,1393
7680,3713786889,3500894271,1672561999,1672562739,740
7725,3756021689,3517963492,1672650859,1672654281,3422
7538,3242408357,3501955238,1672580376,1672580914,538
7754,3972709319,3519703355,1672620964,1672621807,843
7584,3505649239,3509672210,1672694531,1672695951,1420
7737,3429856982,3756027749,1672614025,1672615266,1241
7966,3791594391,3683766533,1672595952,1672597749,1797
7971,3774010081,3610348516,1672555838,1672558831,2993
7768,3475396323,3510244400,1672539237,1672542826,3589
7790,3792789881,3715339701,1672693270,1672694883,1613
7765,3249247700,3394539273,1672615089,1672618401,3312
7727,3476232529,3510380060,1672695150,1672697683,2533
7924,3774125065,3313541986,1672640512,1672641940,1428
7858,3229058858,3755872268,1672622285,1672624183,1898
7642,3883312122,3688683847,1672668026,1672668315,289
7935,3235287260,3520888296,1672553081,1672554649,1568
7750,3792288302,3505599848,1672622301,1672625597,3296
7504,3606987130,3222521619,1672683849,1672685027,1178
7788,3734828619,3314836094,1672639430,1672642765,3335
7927,3828432634,3666553782,1672644345,1672644961,616
7968,3899266183,3231056870,1672604931,1672607165,2234
7579,3755392666,3288764520,1672581268,1672584522,3254
7647,3314836094,3481647420,1672575786,1672578865,3079
7752,3812176780,3289061738,1672696547,1672699140,2593
7808,3505649239,3713808837,1672633052,1672633454,402
7637,3520756859,3791020967,1672578125,1672580131,2006
7982,3738502357,3667680268,1672548534,1672552054,3520
7672,3668898102,3683766533,1672678508,1672680041,1533
7540,3520030713,3683959482,1672588067,1672588501,434
7524,3501692334,3399004969,1672623370,1672624222,852
7969,3500365158,3352603894,1672670675,1672673557,2882
7801,3793436995,3229665776,1672683983,1672687368,3385
7801,3836573197,3520719611,1672617359,1672620408,3049
7892,3773755137,3349613093,1672672760,1672672862,102
7577,3606186086,3920801189,1672532423,1672533327,904
7598,3511267139,3485823740,1672620057,1672621809,1752
7646,3666553782,3512142794,1672540301,1672543553,3252
7972,3550946908,3755511676,1672534578,1672535924,1346
7692,3509773875,3406784491,1672586958,1672590066,3108
7650,3244389794,3777936328,1672582868,1672582980,112
7852,3511862351,3777443199,1672657659,1672659815,2156
7845,3820354437,3975287541,1672643316,1672646417,3101
7706,3399535232,3793436995,1672554310,1672556547,2237
7675,3426325549,3757151210,1672646399,1672648477,2078
7941,3430504438,3510594211,1672566647,1672569864,3217
7540,3404058699,3921211276,1672664374,1672667482,3108
7723,3500578848,3380035798,1672591678,1672593098,1420
7624,3512540951,3520709480,1672694767,1672695202,435
7973,3409474775,3311761694,1672576839,1672577071,232
7559,3793871337,3228165483,1672556652,1672557050,398
7624,3828432634,3533025282,1672677366,1672678801,1435
7619,3534702203,3731419510,1672696099,1672696911,812
7872,3688418210,3518014636,1672613512,1672614808,1296
7563,3716273414,3910886626,1672575725,1672577444,1719
7488,3791115967,3772884106,1672563971,1672565185,1214
7939,3360506772,3429690204,1672603845,1672604685,840
7807,3711308224,3483164654,1672635991,1672638616,2625
7901,3937224533,3737051610,1672625760,1672627498,1738
7832,3500458761,3791115967,1672654466,1672655004,538
7760,3432665384,3978105277,1672606396,1672608892,2496
7782,3412980697,3701184889,1672652822,1672653152,330
7732,3434642576,3777455223,1672685226,1672685607,381
7525,3465202715,3249247700,1672543427,1672544781,1354
7824,3617734118,3500391167,1672643193,1672645090,1897
7678,3517864478,3666507626,1672587872,1672590697,2825
7827,3501364586,3770078063,1672672306,1672675186,2880
7731,3511267139,3608633356,1672621560,1672623876,2316
7665,3736592744,3387966152,1672561513,1672562517,1004
7885,3809916577,3711370563,1672625215,1672628307,3092
7974,3489962019,3833889105,1672673664,1672676505,2841
7969,3889750851,3885897503,1672605734,1672607995,2261
7549,3773465237,3711262377,1672638429,1672638532,103
7507,3715189301,3510380060,1672554076,1672555847,1771
7634,3505973226,3370752401,1672559922,1672563306,3384
7720,3516016437,3882997884,1672607400,1672610085,2685
7771,3735319397,3925402713,1672584213,1672586719,2506
7906,3755920131,3733891182,1672567387,1672570272,2885
7513,3231056870,3512510536,1672596917,1672597023,106
7667,3636867411,3534488837,1672551700,1672555018,3318
7900,3973560347,3475396323,1672585806,1672587558,1752
7974,3552314511,3666553782,1672650387,1672653050,2663
7562,3807987001,3384951177,1672660154,1672660771,617
7882,3500374658,3496269445,1672673181,1672675479,2298
7876,3933210486,3634340855,1672535956,1672536772,816
7638,3500803339,3792844210,1672619442,1672621623,2181
7917,3331845324,3757403279,1672597425,1672599302,1877
7776,3533927138,3756601594,1672697260,1672698839,1579
7936,3711380716,3513956646,1672585751,1672588013,2262
7639,3716537575,3478194807,1672674992,1672675721,729
7568,3755511676,3736786443,1672654457,1672657891,3434
7547,3757161914,3512567240,1672658223,1672661276,3053
7489,3510380060,3238712269,1672620082,1672621253,1171
7522,3760267716,3201848640,1672532235,1672534160,1925
7836,3505203158,3714962248,1672635641,1672637674,2033
7716,3501692334,3518360734,1672581985,1672584648,2663
7625,3533927138,3426325549,1672628131,1672629903,1772
7974,3519601612,3222521619,1672536510,1672540077,3567
7608,3935127663,3703735129,1672646258,1672648988,2730
7732,3715189301,3716843669,1672655230,1672658277,3047
7790,3777120536,3807987001,1672562239,1672565779,3540
7810,3685187183,3777776687,1672593478,1672596475,2997
7973,3780813786,3738274418,1672594572,1672597815,3243
7868,3827626797,3792177074,1672597358,1672599668,2310
7733,3773205565,3760294205,1672532799,1672535508,2709
7544,3604539807,3247815299,1672532612,1672536052,3440
7791,3713630656,3973560347,1672580318,1672582860,2542
7639,3304056063,3805347939,1672642446,1672642693,247
7652,3511312803,3755511676,1672574151,1672576760,2609
7640,3206593906,3778341199,1672637819,1672641131,3312
7883,3734496778,3400804807,1672582837,1672584550,1713
7910,3855937514,3617055293,1672657806,1672658576,770
7724,3517459919,3760077057,1672548736,1672552292,3556
7969,3791602225,3793627961,1672613944,1672617195,3251
7523,3711308224,3774338212,1672585533,1672586312,779
7587,3516465662,3500803339,1672586884,1672589895,3011
7787,3388286531,3344364444,1672662784,1672665219,2435
7681,3914259449,3511170269,1672702975,1672706042,3067
7636,3519152550,3902278226,1672675879,1672678004,2125
7969,3816853177,3885897503,1672534367,1672535565,1198
7843,3688683847,3736790081,1672674099,1672676838,2739
7846,3757682496,3277605882,1672661950,1672665006,3056
7879,3356860407,3853018906,1672611440,1672613051,1611
7890,3512540951,3931941795,1672564181,1672567709,3528
7808,3935627557,3734737881,1672596001,1672598789,2788
7816,3202120784,3791553060,1672548243,1672550414,2171
7621,3373384732,3224716315,1672657123,1672660133,3010
7770,3533827120,3735319397,1672677926,1672680245,2319
7958,3378436155,3399535232,1672614832,1672618254,3422
7746,3501486692,3407954858,1672573054,1672574761,1707
7706,3339907603,3351554343,1672618462,1672621825,3363
7591,3296471982,3783779671,1672580825,1672581032,207
7919,3817316561,3358871377,1672697873,1672700032,2159
7877,3349613093,3685818092,1672669473,1672671411,1938
7967,3774005526,3770635361,1672632624,1672636140,3516
7857,3485008994,3601879040,1672560034,1672560248,214
7541,3390068992,3505904952,1672532943,1672533585,642
7550,3533371364,3760267716,1672660562,1672663494,2932
7879,3432665384,3519703355,1672583187,1672583296,109
7645,3715339701,3378092448,1672570616,1672573950,3334
7599,3534702203,3756462516,1672660388,1672662218,1830
7861,3475258557,3365942576,1672541818,1672543129,1311
7776,3505859863,3505477652,1672539566,1672542330,2764
7694,3791657947,3520706195,1672560982,1672562968,1986
7690,3756966035,3289061738,1672692111,1672694004,1893
7801,3805292782,3430352815,1672545468,1672546645,1177
7818,3933210486,3388286531,1672665779,1672666244,465
7633,3520376528,3773814927,1672703755,1672703875,120
7751,3730517636,3792768129,1672594508,1672596816,2308
7707,3316222192,3773465237,1672550201,1672550380,179
7640,3617734118,3430352815,1672544052,1672545413,1361
7980,3772359096,3475396323,1672571836,1672573074,1238
7895,3438645253,3510937904,1672592898,1672594812,1914
7541,3424922204,3783531004,1672642859,1672645696,2837
7735,3291235378,3509453566,1672640564,1672643548,2984
7604,3801089989,3816853177,1672697684,1672699364,1680
7743,3500803339,3517476351,1672611971,1672615185,3214
7768,3490191091,3505791599,1672675485,1672676053,568
7563,3318697153,3388637594,1672672360,1672675257,2897
7825,3534010629,3713268590,1672611227,1672611882,655
7797,3465202715,3276993580,1672662064,1672662772,708
7504,3778266283,3757246925,1672678130,1672681661,3531
7783,3224716315,3220716272,1672543356,1672544724,1368
7489,3636867411,3628819436,1672649824,1672651132,1308
7511,3385763781,3881477378,1672582964,1672583458,494
7828,3713644518,3517864478,1672563251,1672566287,3036
7584,3517255726,3396086535,1672639178,1672642143,2965
7814,3889750851,3777477395,1672569230,1672571326,2096
7497,3271938399,3378686918,1672614811,1672615270,459
7878,3668898102,3713894336,1672663560,1672663637,77
7826,3533385867,3855000166,1672699194,1672699347,153
7545,3509672210,3247428249,1672542602,1672544321,1719
7668,3311274543,3816853177,1672569307,1672571177,1870
7529,3755511676,3818255890,1672556432,1672557222,790
7568,3516629436,3511862351,1672631539,1672633395,1856
7857,3505203158,3496269445,1672611472,1672614641,3169
7709,3520190170,3793286136,1672557543,1672560225,2682
7689,3209048907,3533827120,1672662395,1672663691,1296
7656,3667680268,3777623166,1672575871,1672577386,1515
7758,3249401741,3512683609,1672559773,1672562689,2916
7890,3505530961,3890149705,1672703585,1672705516,1931
7673,3783245561,3365942576,1672685167,1672687860,2693
7624,3512683609,3512540951,1672682983,1672686112,3129
7808,3916289176,3793436995,1672678693,1672681410,2717
7788,3512969370,3244173074,1672684986,1672686126,1140
7685,3792253549,3515691540,1672549495,1672550540,1045
7548,3774520233,3716843669,1672677678,1672678705,1027
7579,3424922204,3520190170,1672682879,1672685727,2848
7558,3772714862,3828624701,1672675056,1672676047,991
7724,3898995675,3439023335,1672631996,1672633037,1041
7613,3776948966,3783509527,1672637812,1672638992,1180
7667,3509933351,3711308224,1672701941,1672704871,2930
7619,3666457294,3772544062,1672673325,1672675811,2486
7689,3344019610,3827626797,1672630701,1672632329,1628
7867,3820354437,3385763781,1672579569,1672580821,1252
7518,3618873142,3206603608,1672544791,1672545521,730
7645,3714821932,3246596716,1672590906,1672592357,1451
7715,3362000049,3519069599,1672676064,1672679497,3433
7724,3826633236,3777717988,1672554146,1672556761,2615
7568,3608633356,3780609808,1672559117,1672562257,3140
7498,3520706195,3411618230,1672647539,1672649538,1999
7924,3755625324,3883312122,1672556853,1672557524,671
7508,3970117174,3344019610,1672643351,1672643883,532
7783,3399535232,3430504438,1672607848,1672610727,2879
7850,3516629436,3915628728,1672564746,1672564974,228
7983,3783779671,3778341199,1672651539,1672653861,2322
7503,3774793839,3407725581,1672541457,1672544134,2677
7827,3512540951,3772746272,1672655251,1672655445,194
7542,3922275620,3533385867,1672680060,1672683609,3549
7887,3500499542,3777983879,1672667428,1672668129,701
7872,3513201436,3313541986,1672551080,1672551420,340
7611,3492478793,3776948966,1672591933,1672593151,1218
7793,3514719601,3496269445,1672576330,1672578125,1795
7584,3683959482,3496549058,1672650914,1672654348,3434
7551,3512567240,3517255726,1672675198,1672675749,551
7516,3715189301,3356860407,1672651422,1672653381,1959
7501,3714821932,3783083229,1672624896,1672627422,2526
7933,3918674986,3517963492,1672639618,1672642776,3158
7801,3399004969,3760183458,1672700099,1672700762,663
7814,3757812939,3500391167,1672660599,1672660694,95
7827,3223968713,3668898102,1672627990,1672629368,1378
7958,3512166013,3777120536,1672569342,1672572521,3179
7552,3279721246,3778549126,1672684775,1672685379,604
7737,3777623166,3716488385,1672564819,1672568392,3573
7791,3514838220,3783239924,1672640302,1672643668,3366
7757,3475795792,3791594391,1672703243,1672703970,727
7586,3855937514,3772337814,1672644240,1672647365,3125
7684,3514283243,3453729665,1672648591,1672650603,2012
7789,3360506772,3500060260,1672700144,1672703234,3090
7743,3511841857,3738502357,1672672621,1672672716,95
7541,3837094550,3391261292,1672634206,1672637280,3074
7929,3701498253,3618045231,1672696025,1672696164,139
7523,3917278625,3804870229,1672638553,1672641580,3027
7789,3427283336,3611150562,1672658755,1672659547,792
7980,3244485293,3880285638,1672548337,1672549534,1197
7819,3533095755,3777983879,1672678319,1672679600,1281
7640,3505347134,3234362962,1672657812,1672660904,3092
7647,3925620998,3518163778,1672688866,1672690883,2017
7704,3221899927,3924549929,1672595590,1672598954,3364
7880,3505791599,3314836094,1672547392,1672550028,2636
7888,3520206212,3416427576,1672598649,1672601497,2848
7766,3772714862,3806545488,1672587166,1672590694,3528
7870,3492478793,3280964728,1672569481,1672571770,2289
7907,3378686918,3505649239,1672603086,1672606006,2920
7715,3247815299,3511435497,1672605819,1672605950,131
7511,3882291183,3446948848,1672629117,1672630976,1859
7637,3793338102,3898995675,1672562611,1672566136,3525
7648,3356860407,3510969660,1672701932,1672702757,825
7906,3773598056,3882242815,1672592817,1672596030,3213
7720,3899371911,3510173870,1672574801,1672577814,3013
7570,3351008918,3701146057,1672619396,1672620243,847
7965,3806545488,3235287260,1672699797,1672700042,245
7531,3855000166,3512969370,1672545365,1672548185,2820
7681,3520730271,3829319703,1672601439,1672603625,2186
7964,3509634629,3510380060,1672659057,1672661940,2883
7507,3338703270,3280615985,1672584067,1672587645,3578
7762,3805292782,3809059934,1672681100,1672682901,1801
7871,3401627165,3493507965,1672653010,1672655220,2210
7647,3613995936,3235635976,1672595990,1672597064,1074
7732,3338367113,3511271692,1672587673,1672589764,2091
7932,3500177712,3899204805,1672587071,1672588373,1302
7510,3505477652,3209551760,1672700583,1672701244,661
7553,3242408357,3519654779,1672562707,1672564608,1901
7918,3735733948,3517077106,1672636305,1672637592,1287
7849,3280615985,3534702203,1672612389,1672612590,201
7781,3755739653,3800886801,1672542741,1672545674,2933
7552,3738274418,3793871337,1672632287,1672635697,3410
7802,3365614305,3554917400,1672581015,1672584065,3050
7798,3518014636,3500177712,1672673790,1672675082,1292
7857,3427283336,3454042520,1672535679,1672537399,1720
7598,3833889105,3399052055,1672624561,1672627370,2809
7805,3533369198,3429856982,1672669837,1672672439,2602
7722,3714197325,3734737881,1672690190,1672691449,1259
7869,3793470489,3827626797,1672659903,1672660192,289
7918,3342131135,3430352815,1672550277,1672550741,464
7552,3518360734,3342131135,1672625080,1672626693,1613
7978,3618045231,3383661227,1672558678,1672561972,3294
7545,3855602893,3793470489,1672555819,1672557011,1192
7779,3466911760,3979339287,1672679479,1672680994,1515
7702,3777443199,3774268456,1672694505,1672698088,3583
7887,3755872268,3296471982,1672638895,1672639667,772
7595,3805347939,3458539365,1672659853,1672661406,1553
7960,3903962771,3636867411,1672679123,1672679441,318
7926,3342131135,3716273414,1672617465,1672617770,305
7953,3338703270,3505201246,1672692010,1672692409,399
7595,3711370563,3501955238,1672641673,1672642266,593
7925,3779629905,3755042098,1672685643,1672687538,1895
7692,3293695955,3500994774,1672679864,1672680795,931
7818,3352603894,3311603601,1672545421,1672546909,1488
7922,3972709319,3209383861,1672684150,1672686311,2161
7777,3367029997,3458539365,1672584101,1672584666,565
7737,3519556068,3280964728,1672572832,1672572931,99
7831,3500578848,3512837326,1672621899,1672623609,1710
7589,3885670556,3855424474,1672649848,1672653116,3268
7835,3701111745,3297463265,1672533132,1672533704,572
7672,3633420270,3711569060,1672587515,1672589807,2292
7725,3778108318,3757455053,1672700983,1672701606,623
7862,3922275620,3756528686,1672640757,1672642626,1869
7705,3342131135,3533280269,1672702692,1672705493,2801
7524,3852595551,3509773875,1672650305,1672651092,787
7939,3819727225,3458539365,1672617165,1672620138,2973
7765,3519654779,3812176780,1672586146,1672588441,2295
7503,3512720680,3500994774,1672590112,1672591404,1292
7818,3780974443,3774339795,1672636449,1672639152,2703
7889,3384951177,3500805881,1672695752,1672696790,1038
7700,3512567240,3362000049,1672599439,1672601320,1881
7939,3387674757,3859525941,1672616846,1672619064,2218
7581,3930797455,3518260334,1672689996,1672692330,2334
7636,3770851318,3396285984,1672613707,1672614124,417
7948,3554917400,3917278625,1672626737,1672630230,3493
7707,3770763956,3770635361,1672688941,1672691489,2548
7616,3505904952,3791957752,1672685270,1672686982,1712
7485,3825229501,3624312512,1672542176,1672544323,2147
7920,3533137446,3481502100,1672691346,1672693301,1955
7569,3514283243,3500578848,1672623942,1672625106,1164
7540,3921211276,3713969578,1672550422,1672552132,1710
7665,3505873261,3792253549,1672668012,1672669434,1422
7740,3517963492,3776513891,1672659973,1672663265,3292
7817,3500391167,3489217083,1672563062,1672566443,3381
7954,3501601840,3280615985,1672550783,1672554326,3543
7706,3793389510,3772053179,1672684601,1672687652,3051
7874,3909606423,3783206719,1672625259,1672625644,385
7697,3931941795,3234362962,1672625269,1672628168,2899
7553,3716488385,3427283336,1672615518,1672618785,3267
7781,3760893269,3936227020,1672535152,1672536928,1776
7543,3505912939,3559110998,1672634636,1672635166,530
7908,3883085535,3793470489,1672555243,1672556994,1751
7960,3518791447,3783925755,1672669380,1672670969,1589
7891,3760294205,3411618230,1672655797,1672657376,1579
7763,3710067113,3359910781,1672633143,1672634921,1778
7688,3688418210,3415443558,1672636661,1672638236,1575
7702,3899371911,3511687358,1672639979,1672643444,3465
7675,3378436155,3774501422,1672540956,1672541469,513
7809,3489545239,3313541986,1672696872,1672698725,1853
7664,3972709319,3600647945,1672659364,1672659555,191
7584,3973560347,3793389510,1672540059,1672540808,749
7762,3416265063,3377766165,1672677939,1672678415,476
7492,3883861463,3294803686,1672585579,1672586444,865
7849,3396086535,3755798867,1672654628,1672656979,2351
7758,3757246925,3202120784,1672636163,1672638227,2064
7612,3520706195,3402943525,1672543945,1672545103,1158
7761,3904408902,3916289176,1672616337,1672618792,2455
7699,3770078063,3737079798,1672556527,1672558914,2387
7749,3401627165,3805292782,1672602413,1672603126,713
7528,3713786889,3828432634,1672618474,1672619361,887
7612,3774339795,3817621391,1672641963,1672644031,2068
7703,3378092448,3903307060,1672651273,1672653151,1878
7787,3348261553,3827222533,1672672256,1672673314,1058
7765,3978115672,3909238838,1672700807,1672701964,1157
7500,3711308224,3242408357,1672628125,1672630619,2494
7907,3701534009,3279721246,1672569186,1672572777,3591
7745,3485008994,3520931254,1672631496,1672634462,2966
7760,3515394721,3756451663,1672627109,1672627177,68
7841,3882997884,3388286531,1672699058,1672701406,2348
7759,3397418363,3427283336,1672671513,1672674181,2668
7663,3611150562,3515151980,1672702977,1672703843,866
7731,3701534009,3791997875,1672609420,1672612839,3419
7681,3912262917,3772309150,1672533154,1672536261,3107
7633,3685187183,3421127249,1672695923,1672698402,2479
7966,3703789494,3379256399,1672620942,1672623146,2204
7541,3793338102,3519703355,1672574198,1672576664,2466
7735,3516039895,3701111745,1672608198,1672611494,3296
7824,3505201246,3509672210,1672641588,1672643667,2079
7497,3903009525,3715492942,1672587817,1672590655,2838
7650,3509634629,3730517636,1672608293,1672608838,545
7583,3836573197,3494290908,1672640337,1672641882,1545
7517,3774045700,3489728806,1672600107,1672601721,1614
7833,3438645253,3666506258,1672652675,1672655255,2580
7886,3485008994,3311415018,1672671599,1672672452,853
7754,3822654369,3703441914,1672576033,1672579478,3445
7939,3760598102,3774125065,1672675891,1672677342,1451
7966,3500904641,3505873261,1672576165,1672576356,191
7771,3778980116,3733189298,1672538718,1672539530,812
7747,3511312803,3378436155,1672642575,1672646098,3523
7795,3409474775,3311090974,1672598544,1672601521,2977
7901,3611150562,3792883665,1672535194,1672536202,1008
7761,3516673015,3511125626,1672700882,1672701105,223
7844,3902383721,3760077057,1672702224,1672703661,1437
7627,3817316561,3716168623,1672535617,1672538104,2487
7714,3808324264,3559110998,1672662045,1672662700,655
7492,3615046771,3701274634,1672692714,1672695817,3103
7535,3755392666,3716835696,1672684804,1672684887,83
7591,3716835696,3883312122,1672552987,1672555750,2763
7588,3313564074,3487171044,1672673910,1672675746,1836
7705,3312333615,3777790718,1672537781,1672539478,1697
7805,3634340855,3902278226,1672694707,1672697490,2783
7530,3774298222,3800353779,1672666088,1672666413,325
7691,3783196518,3475251781,1672655308,1672658145,2837
7649,3780365428,3509773875,1672663477,1672665571,2094
7764,3621810464,3777514571,1672686714,1672687249,535
7862,3715974031,3515125508,1672569554,1672570160,606
7982,3501692334,3773664987,1672546644,1672549799,3155
7707,3711262377,3291883916,1672697405,1672697644,239
7669,3703871468,3518496488,1672578936,1672579406,470
7804,3777717988,3792768129,1672587384,1672588943,1559
7720,3345207877,3429856982,1672546173,1672548004,1831
7931,3791553060,3314836094,1672667426,1672670068,2642
7753,3760569731,3890149705,1672682774,1672686280,3506
7644,3518669703,3201432789,1672545296,1672547012,1716
7635,3777790718,3483164654,1672643741,1672647144,3403
7965,3420432297,3792768129,1672684234,1672687633,3399
7592,3890149705,3737079798,1672673136,1672676544,3408
7483,3377766165,3732481297,1672601856,1672602820,964
7594,3520012395,3806545488,1672531872,1672533288,1416
7695,3939952128,3311718847,1672671635,1672674149,2514
7497,3828432634,3909606423,1672663136,1672664223,1087
7701,3756528686,3827626797,1672633258,1672635853,2595
7613,3755872268,3501198706,1672566193,1672566640,447
7932,3755920131,3885897503,1672661162,1672662393,1231
7674,3293695955,3346327502,1672670351,1672673561,3210
7875,3891751546,3501601840,1672676600,1672677662,1062
7854,3514987389,3515723720,1672676121,1672678314,2193
7526,3307097200,3791657947,1672645252,1672646541,1289
7567,3485008994,3932051427,1672694520,1672696485,1965
7967,3501601840,3668005723,1672559830,1672562539,2709
7496,3780813786,3512720680,1672539509,1672540521,1012
7701,3478194807,3777806071,1672656090,1672658537,2447
7716,3716488385,3613995936,1672574105,1672575612,1507
7531,3770763956,3918584946,1672684772,1672686863,2091
7946,3249791738,3496549058,1672551141,1672551635,494
7856,3809059934,3819727225,1672631552,1672634413,2861
7496,3736790081,3792177074,1672567895,1672570620,2725
7676,3774127586,3757812939,1672599026,1672599707,681
7603,3391915886,3701984666,1672669717,1672670585,868
7732,3387674757,3756424865,1672643331,1672643936,605
7869,3517077106,3515151980,1672535942,1672538407,2465
7746,3634995491,3485823740,1672599706,1672602950,3244
7499,3756966035,3904775198,1672618651,1672619061,410
7800,3711569060,3509933351,1672640537,1672642518,1981
7948,3902383721,3607178184,1672576583,1672577552,969
7730,3610348516,3755943611,1672668804,1672671988,3184
7747,3520183192,3837094550,1672654496,1672658073,3577
7483,3774195321,3312664885,1672622844,1672625463,2619
7750,3249401741,3779528381,1672646096,1672646737,641
7581,3935627557,3364543015,1672571563,1672573335,1772
7512,3805292782,3478194807,1672547828,1672551357,3529
7596,3737154119,3428964059,1672623810,1672627044,3234
7666,3513201436,3770101921,1672606076,1672609655,3579
7860,3489962019,3501730685,1672549690,1672551650,1960
7895,3802367797,3533095755,1672645409,1672648646,3237
7762,3518360734,3229665776,1672602735,1672602845,110
7831,3774125065,3467773920,1672549047,1672549985,938
7741,3511350608,3716835696,1672570759,1672572305,1546
7910,3316222192,3853018906,1672599459,1672600642,1183
7596,3511435497,3822654369,1672642810,1672644769,1959
7494,3827626797,3373384732,1672607473,1672610665,3192
7527,3783429780,3247815299,1672598667,1672601508,2841
7951,3825229501,3774466457,1672694958,1672698466,3508
7711,3714474557,3510126867,1672580060,1672580703,643
7770,3755798867,3826760240,1672673277,1672674386,1109
7831,3515151980,3770635361,1672542917,1672545779,2862
7648,3756021689,3534488837,1672691848,1672695290,3442
7721,3666507626,3610695419,1672662778,1672663664,886
7501,3613683164,3730517636,1672609539,1672612244,2705
7566,3505638204,3426325549,1672677539,1672679126,1587
7533,3703013906,3710067113,1672690096,1672693610,3514
7860,3770021824,3510771358,1672600465,1672601841,1376
7857,3496051529,3303751772,1672661897,1672663640,1743
7496,3778341199,3510594211,1672572859,1672575414,2555
7966,3780593036,3311845971,1672582997,1672585692,2695
7694,3774366875,3518014636,1672618952,1672620644,1692
7657,3501606184,3829319703,1672687526,1672688448,922
7485,3716273414,3518496488,1672592440,1672592714,274
7771,3738274418,3395152943,1672682570,1672683108,538
7560,3756601594,3518408774,1672585434,1672585912,478
7788,3296471982,3307097200,1672590926,1672592752,1826
7806,3770851318,3278365525,1672697774,1672700756,2982
7920,3776338577,3334033993,1672671651,1672672675,1024
7595,3405494240,3446948848,1672540701,1672541113,412
7532,3511163800,3500805881,1672565793,1672568370,2577
7769,3517509185,3416241005,1672652511,1672653938,1427
7628,3448855696,3783429780,1672677816,1672679432,1616
7799,3666553782,3780593036,1672638352,1672639359,1007
7832,3520709480,3311154569,1672663033,1672664510,1477
7705,3236102733,3559110998,1672577489,1672580093,2604
7862,3488244966,3314245084,1672697780,1672700142,2362
7603,3793286136,3514838220,1672644305,1672647685,3380
7577,3882997884,3519152550,1672559763,1672560089,326
7649,3227457126,3520629279,1672554255,1672556919,2664
7569,3716537575,3792384220,1672626217,1672628095,1878
7614,3760492950,3836573197,1672549173,1672551080,1907
7497,3774466457,3756451663,1672687725,1672688803,1078
7979,3312829208,3793470489,1672626903,1672627153,250
7596,3809484172,3466911760,1672547102,1672550521,3419
7657,3501606184,3756027749,1672637480,1672638276,796
7597,3533626375,3505873261,1672577825,1672577915,90
7676,3391261292,3477649378,1672672692,1672674453,1761
7641,3682061100,3756966035,1672703179,1672704182,1003
7682,3516629436,3805292782,1672680414,1672680535,121
7697,3388637594,3820354437,1672668487,1672669787,1300
7900,3780813786,3380035798,1672628598,1672630902,2304
7824,3774119563,3890149705,1672598193,1672599193,1000
7817,3858918246,3360993964,1672605575,1672608611,3036
7702,3793470489,3617734118,1672531292,1672533556,2264
7534,3916289176,3517459919,1672645704,1672648410,2706
7614,3285400528,3925402713,1672568238,1672571083,2845
7502,3770447408,3510594211,1672621531,1672624445,2914
7768,3755920131,3280615985,1672647627,1672649344,1717
7857,3505883609,3346795719,1672623034,1672624003,969
7625,3249401741,3805292782,1672602535,1672606105,3570
7568,3828432634,3520206212,1672604057,1672606671,2614
7868,3519912874,3509604974,1672548386,1672548762,376
7513,3276640712,3755436115,1672547815,1672551291,3476
7698,3517864478,3200691026,1672632676,1672634334,1658
7641,3774127586,3359910781,1672644325,1672647802,3477
7916,3510857360,3772642849,1672586142,1672588168,2026
7785,3475396323,3505904952,1672634172,1672634824,652
7656,3716197887,3385763781,1672552763,1672554798,2035
7566,3505599848,3500229033,1672662195,1672664175,1980
7552,3512540951,3910886626,1672561973,1672564085,2112
7931,3734737881,3780503655,1672605675,1672606191,516
7556,3621810464,3737051610,1672645074,1672646983,1909
7934,3477375368,3918056059,1672542678,1672545992,3314
7927,3505912939,3711973519,1672628080,1672628336,256
7647,3629935998,3364543015,1672594610,1672597492,2882
7578,3825229501,3429856982,1672604734,1672607146,2412
7497,3465202715,3793470489,1672547854,1672548674,820
7749,3779528381,3505912939,1672629594,1672631022,1428
7814,3772053179,3399433690,1672643495,1672645666,2171
7650,3244389794,3791957752,1672597369,1672598195,826
7808,3701065786,3935627557,1672585440,1672587866,2426
7641,3484995752,3774793839,1672604596,1672606226,1630
7560,3811694763,3369998498,1672594717,1672597849,3132
7720,3618045231,3520376528,1672648982,1672652117,3135
7535,3369998498,3534553510,1672601983,1672604956,2973
7790,3505638204,3703661585,1672668642,1672670024,1382
7705,3924549929,3926700506,1672644116,1672645310,1194
7830,3518669703,3793389510,1672587341,1672588553,1212
7664,3209048907,3613683164,1672604862,1672605691,829
7508,3276993580,3284832486,1672608776,1672609546,770
7904,3792473331,3778308417,1672670944,1672673662,2718
7685,3416265063,3713370078,1672577809,1672580014,2205
7915,3380035798,3516065852,1672700808,1672702696,1888
7609,3307512479,3791874383,1672623405,1672626033,2628
7556,3610695419,3805519285,1672691844,1672694419,2575
7792,3783705817,3417970574,1672534591,1672536297,1706
7585,3505193212,3534313900,1672606046,1672608063,2017
7492,3293695955,3520030713,1672577038,1672578384,1346
7903,3910454786,3291235378,1672690441,1672690709,268
7490,3242408357,3836573197,1672537277,1672539536,2259
7483,3792177074,3757812939,1672676383,1672678478,2095
7696,3701967560,3772714862,1672665115,1672666957,1842
7491,3516514391,3234362962,1672553298,1672555480,2182
7734,3813052709,3221536550,1672668848,1672671579,2731
7664,3777717988,3297463265,1672604743,1672607659,2916
7979,3760294205,3209383861,1672638195,1672641059,2864
7832,3731106822,3533270638,1672559528,1672561805,2277
7963,3774556560,3755042098,1672641925,1672645348,3423
7613,3209383861,3505135325,1672601694,1672603186,1492
7609,3817621391,3388637594,1672664880,1672667817,2937
7517,3710408395,3280615985,1672546860,1672548019,1159
7702,3792473331,3777514571,1672667157,1672669299,2142
7821,3229058858,3756424865,1672703790,1672706431,2641
7983,3910886626,3511332835,1672631998,1672632447,449
7742,3501606184,3389115045,1672682628,1672683180,552
7663,3511332835,3505791599,1672552965,1672556445,3480
7891,3533369198,3209027249,1672639147,1672642026,2879
7655,3501730685,3715581279,1672652251,1672653611,1360
7494,3780974443,3614238812,1672629555,1672630662,1107
7564,3378686918,3505292701,1672575507,1672576270,763
7798,3314245084,3777477395,1672701144,1672704603,3459
7897,3827222533,3899371911,1672669617,1672669965,348
7676,3701995648,3517721725,1672670709,1672671515,806
7688,3402943525,3383661227,1672626868,1672627254,386
7795,3778341199,3426325549,1672599248,1672601730,2482
7527,3319752091,3287105466,1672679515,1672682136,2621
7947,3827626797,3301107849,1672620954,1672622443,1489
7827,3732481297,3770851318,1672688273,1672689725,1452
7912,3417061462,3518014636,1672537987,1672539673,1686
7924,3826759140,3711370563,1672602335,1672602744,409
7882,3618045231,3783705817,1672564898,1672566292,1394
7572,3757682496,3512720680,1672606452,1672608462,2010
7592,3311439795,3760561634,1672669513,1672670726,1213
7806,3703871468,3621810464,1672610221,1672610337,116
7535,3510380060,3231056870,1672564909,1672567140,2231
7891,3533385867,3501606184,1672561854,1672564665,2811
7678,3688683847,3935627557,1672614323,1672615436,1113
7854,3791594391,3780828689,1672618905,1672621771,2866
7890,3772544062,3311090974,1672636659,1672640073,3414
7754,3976633198,3805292782,1672538676,1672539984,1308
7862,3552314511,3973560347,1672564605,1672565448,843
7724,3783245561,3500229033,1672663299,1672666044,2745
7796,3760267716,3412825109,1672618897,1672621538,2641
7598,3520709480,3365942576,1672691052,1672691300,248
7486,3792177074,3294803686,1672671893,1672673862,1969
7621,3703955926,3776948966,1672582756,1672584701,1945
7512,3500060260,3432689543,1672683296,1672685669,2373
7844,3533827120,3477649378,1672637101,1672637481,380
7683,3688418210,3737051610,1672609034,1672609693,659
7847,3365278081,3777623166,1672646364,1672649785,3421
7797,3972364603,3770078063,1672624565,1672626657,2092
7563,3518260334,3713969578,1672691938,1672695401,3463
7660,3552314511,3817316561,1672679145,1672682588,3443
7849,3701967560,3636867411,1672595225,1672597041,1816
7576,3430352815,3505702787,1672692877,1672693768,891
7506,3500578848,3711370563,1672664818,1672666172,1354
7542,3793627961,3224058172,1672627180,1672627561,381
7909,3510126867,3416241005,1672604567,1672605655,1088
7881,3505219850,3711265369,1672642674,1672645452,2778
7912,3605726278,3533280269,1672676855,1672677653,798
7667,3200198928,3756462516,1672691737,1672693387,1650
7514,3390068992,3755943611,1672689921,1672690347,426
7836,3339907603,3424922204,1672531429,1672531950,521
7745,3515723720,3774195321,1672657621,1672657874,253
7592,3512217942,3778780511,1672630971,1672633765,2794
7760,3518408774,3667680268,1672644444,1672647863,3419
7767,3711380716,3904775198,1672674817,1672676173,1356
7928,3736419952,3772544062,1672662767,1672663702,935
7752,3516039895,3500805881,1672603033,1672604517,1484
7902,3505873261,3533827120,1672687233,1672689497,2264
7494,3475251781,3485375593,1672549655,1672552075,2420
7793,3271938399,3509453566,1672643773,1672644630,857
7517,3793848402,3298433163,1672663740,1672664842,1102
7530,3851190615,3404058699,1672583555,1672583839,284
7854,3622054816,3793962300,1672654366,1672657858,3492
7893,3404384505,3501601840,1672565415,1672567816,2401
7600,3533810360,3489728806,1672548554,1672548825,271
7862,3701178711,3505883609,1672684589,1672685287,698
7719,3791553060,3235635976,1672536867,1672539117,2250
7535,3483949762,3505135325,1672670308,1672672278,1970
7628,3487171044,3307097200,1672681289,1672682767,1478
7606,3515394721,3606987130,1672532460,1672532725,265
7697,3519556068,3891751546,1672624716,1672625640,924
7762,3818255890,3485375593,1672565267,1672568386,3119
7919,3510126867,3770553384,1672700333,1672700916,583
7902,3515860749,3792902982,1672699395,1672702903,3508
7492,3778780511,3857349323,1672700666,1672702400,1734
7919,3510703546,3755042098,1672541961,1672543777,1816
7635,3828365570,3534010629,1672675706,1672676460,754
7915,3533137446,3515860749,1672612587,1672614197,1610
7733,3880285638,3801089989,1672622314,1672625251,2937
7620,3757562897,3288764520,1672618309,1672619985,1676
7749,3516039895,3610348516,1672589682,1672590715,1033
7713,3711380716,3415443558,1672633626,1672633803,177
7703,3935127663,3756462516,1672627743,1672627961,218
7545,3805519285,3316173088,1672579128,1672579906,778
7856,3917088658,3516606733,1672697519,1672699336,1817
7732,3608633356,3520931254,1672684231,1672687562,3331
7565,3533626375,3780503655,1672617199,1672618677,1478
7690,3512837326,3806545488,1672601679,1672603526,1847
7643,3394330287,3713370078,1672693923,1672697150,3227
7906,3244173074,3389115045,1672699226,1672700572,1346
7905,3247428249,3534313900,1672546591,1672548131,1540
7742,3520730271,3793286136,1672626591,1672628473,1882
7775,3902278226,3277605882,1672626737,1672628159,1422
7904,3454042520,3931941795,1672680125,1672683387,3262
7849,3365278081,3913251733,1672588123,1672589728,1605
7644,3311324983,3917278625,1672590244,1672593598,3354
7493,3234541252,3606987130,1672540428,1672540922,494
7623,3208844525,3533280269,1672610749,1672613358,2609
7513,3311154569,3912262917,1672632367,1672635200,2833
7701,3427219654,3857349323,1672577138,1672578211,1073
7615,3244389794,3773950140,1672557315,1672558795,1480
7886,3519803045,3500487333,1672544818,1672547130,2312
7737,3903307060,3312333615,1672633633,1672635745,2112
7805,3520706195,3514128943,1672557504,1672560572,3068
7752,3710569131,3793436995,1672580341,1672582214,1873
7963,3311203656,3315583351,1672679554,1672680969,1415
7515,3613683164,3485823740,1672609349,1672609681,332
7773,3701146057,3777936328,1672629425,1672631298,1873
7633,3909331423,3501927421,1672557998,1672560965,2967
7787,3715581279,3817316561,1672690575,1672691550,975
7870,3608633356,3510711755,1672532183,1672534031,1848
7579,3760569731,3736592744,1672677837,1672679937,2100
7754,3624761861,3737154119,1672687914,1672688520,606
7500,3510969660,3554917400,1672608136,1672608761,625
7522,3772544062,3510244400,1672702738,1672703024,286
7670,3516980378,3921211276,1672564370,1672564882,512
7539,3388637594,3828624701,1672647938,1672650642,2704
7926,3883861463,3802367797,1672676870,1672678373,1503
7841,3904775198,3800886801,1672690156,1672692233,2077
7611,3801089989,3755739653,1672581038,1672582740,1702
7571,3922275620,3773978034,1672608529,1672610009,1480
7919,3915628728,3511198618,1672585528,1672588261,2733
7512,3238712269,3716258994,1672697162,1672700425,3263
7707,3972364603,3701863557,1672625633,1672628922,3289
7894,3515860749,3932051427,1672672583,1672673868,1285
7788,3399535232,3378686918,1672592693,1672593622,929
7776,3883551721,3778305740,1672552904,1672553983,1079
7735,3914259449,3757562897,1672672691,1672674509,1818
7822,3976390453,3931941795,1672616110,1672618302,2192
7745,3937224533,3318697153,1672693683,1672694482,799
7781,3311415018,3611150562,1672638682,1672639516,834
7620,3483949762,3533748232,1672643448,1672645628,2180
7525,3336751428,3903307060,1672639220,1672642236,3016
7747,3683766533,3826415738,1672651355,1672653034,1679
7604,3828365570,3397418363,1672546976,1672550253,3277
7911,3780609808,3755920131,1672570202,1672572003,1801
7894,3515860749,3701146057,1672568411,1672569905,1494
7961,3898995675,3793286136,1672647716,1672648924,1208
7635,3773664987,3209027249,1672548818,1672548919,101
7572,3716488385,3235287260,1672562390,1672564748,2358
7961,3222521619,3307097200,1672538160,1672540485,2325
7776,3711504540,3277939457,1672575342,1672576572,1230
7503,3783239924,3736229191,1672639382,1672642879,3497
7701,3512720680,3338367113,1672541256,1672543900,2644
7890,3829764737,3412980697,1672557124,1672559557,2433
7863,3294803686,3887270940,1672685585,1672688038,2453
7884,3777776687,3518932404,1672640748,1672642733,1985
7490,3816853177,3793959750,1672634127,1672635961,1834
7931,3783083229,3289061738,1672539032,1672541524,2492
7812,3510244400,3780365428,1672701634,1672705120,3486
7528,3779036831,3234362962,1672597098,1672599717,2619
7854,3777514571,3520165601,1672668833,1672669424,591
7483,3473765852,3501364586,1672604248,1672605564,1316
7947,3407954858,3780914982,1672610700,1672611549,849
7853,3515125508,3351008918,1672696880,1672698109,1229
7594,3311761694,3925620998,1672625267,1672626408,1141
7519,3833889105,3778308417,1672696081,1672696516,435
7531,3701274634,3791997875,1672578419,1672581656,3237
7598,3615046771,3399004969,1672672511,1672674678,2167
7903,3514128943,3352603894,1672570096,1672571499,1403
7946,3516065852,3930797455,1672538167,1672538502,335
7942,3500374658,3629547065,1672574589,1672574761,172
7494,3852391257,3519654779,1672620457,1672622413,1956
7512,3227457126,3770101921,1672562914,1672565486,2572
7903,3621497531,3360506772,1672544405,1672547368,2963
7781,3473765852,3833889105,1672646708,1672646840,132
7583,3711262377,3605726278,1672587464,1672589577,2113
7613,3883085535,3550946908,1672671594,1672675083,3489
7853,3611150562,3509604974,1672581196,1672584737,3541
7799,3510703546,3514838220,1672681465,1672684561,3096
7634,3288764520,3311648200,1672671333,1672674805,3472
7659,3501486692,3439023335,1672652144,1672652953,809
7728,3518260334,3387966152,1672562820,1672563869,1049
7582,3511163800,3772578994,1672702009,1672704344,2335
7920,3791901535,3792177074,1672620202,1672623692,3490
7930,3760077057,3432689543,1672650522,1672651837,1315
7597,3778980116,3779740455,1672582615,1672583284,669
7855,3516980378,3757562897,1672625727,1672627715,1988
7737,3701274634,3757447189,1672586083,1672589240,3157
7652,3514987389,3605726278,1672623866,1672626736,2870
7520,3772309150,3970117174,1672701021,1672703140,2119
7735,3505859863,3365278081,1672572235,1672573364,1129
7818,3770851318,3379589402,1672557982,1672559163,1181
7933,3220716272,3710098970,1672672664,1672674221,1557
7970,3777443199,3616944364,1672549510,1672552635,3125
7817,3247428249,3774119563,1672606055,1672607141,1086
7508,3621810464,3793086311,1672663296,1672663450,154
7864,3500374658,3778308417,1672559726,1672560130,404
7721,3828432634,3509630174,1672534136,1672537213,3077
7483,3713786889,3501601840,1672656585,1672658015,1430
7955,3396086535,3713268590,1672565873,1672567487,1614
7641,3301107849,3772714862,1672548201,1672550168,1967
7962,3338367113,3534729133,1672590552,1672593907,3355
7594,3421127249,3828365570,1672540081,1672541178,1097
7786,3378436155,3518260334,1672573781,1672575604,1823
7634,3885670556,3416241005,1672655196,1672657339,2143
7545,3303751772,3397418363,1672682933,1672683138,205
7606,3774195321,3510937904,1672658615,1672658805,190
7530,3716197887,3516909237,1672647693,1672650785,3092
7515,3777929708,3509773875,1672685023,1672685308,285
7780,3882291183,3512142794,1672558115,1672561681,3566
7591,3859525941,3883312122,1672577215,1672580554,3339
7894,3512720680,3297463265,1672582732,1672586171,3439
7505,3713208927,3510247121,1672603772,1672607196,3424
7728,3901877072,3793753089,1672624080,1672626807,2727
7965,3783429780,3520012395,1672640220,1672642915,2695
7841,3302626661,3520709480,1672625531,1672627031,1500
7532,3777623166,3713808837,1672671684,1672672179,495
7566,3614238812,3736786443,1672600454,1672602986,2532
7958,3303705369,3885670556,1672601490,1672605004,3514
7887,3970117174,3235287260,1672596483,1672599875,3392
7752,3493507965,3715981584,1672547356,1672549651,2295
7838,3777477395,3826760240,1672703751,1672704673,922
7594,3291235378,3515394721,1672575400,1672576410,1010
7828,3520376528,3359239884,1672631580,1672634784,3204
7558,3829232696,3715998609,1672575897,1672578860,2963
7840,3501955238,3701691675,1672694256,1672695937,1681
7673,3466229085,3922337974,1672621862,1672624223,2361
7777,3516223597,3738502357,1672541184,1672544255,3071
7691,3826633236,3930797455,1672666840,1672668265,1425
7557,3714821932,3448855696,1672534804,1672536869,2065
7544,3757151210,3505219850,1672569410,1672569946,536
7584,3287105466,3922275620,1672536311,1672538348,2037
7829,3773465237,3716273414,1672700786,1672701308,522
7974,3757455053,3778780511,1672690729,1672692982,2253
7511,3510244400,3429856982,1672636787,1672638307,1520
7695,3453729665,3285400528,1672667481,1672669378,1897
7574,3716746253,3500904641,1672668757,1672671552,2795
7591,3510703546,3287105466,1672661903,1672665411,3508
7958,3828432634,3467773920,1672618257,1672618798,541
7605,3783206719,3430352815,1672640315,1672643571,3256
7569,3477375368,3792883665,1672689298,1672690787,1489
7928,3701146057,3895562476,1672672822,1672672951,129
7536,3736229191,3515284591,1672651236,1672654098,2862
7548,3756462516,3713630656,1672630207,1672630337,130
7894,3851190615,3733891182,1672655582,1672659071,3489
7671,3703735129,3922275620,1672543977,1672545235,1258
7572,3605726278,3773120434,1672591557,1672593674,2117
7937,3348261553,3610348516,1672647226,1672648669,1443
7834,3792288302,3608868877,1672661265,1672664125,2860
7976,3770851318,3813052709,1672574442,1672577317,2875
7973,3514283243,3501955238,1672673958,1672675953,1995
7555,3533626375,3380035798,1672579408,1672581880,2472
7563,3417587765,3473765852,1672658051,1672658823,772
7563,3533193862,3516223597,1672552502,1672555297,2795
7682,3511267139,3500658339,1672612358,1672613858,1500
7666,3453729665,3621497531,1672540012,1672543233,3221
7894,3828624701,3822654369,1672648517,1672651853,3336
7827,3517476351,3780914982,1672632373,1672634623,2250
7584,3825229501,3318166135,1672697535,1672699476,1941
7763,3516909237,3820354437,1672549723,1672553148,3425
7598,3516716179,3500060260,1672641706,1672641859,153
7876,3454042520,3756930948,1672650501,1672653696,3195
7680,3378092448,3501364586,1672560062,1672560952,890
7645,3852595551,3731419510,1672627740,1672629357,1617
7939,3760267716,3500729955,1672600425,1672601567,1142
7871,3683766533,3793871337,1672561324,1672564147,2823
7818,3465202715,3711504540,1672604574,1672605413,839
7538,3713370078,3970117174,1672542331,1672545531,3200
7844,3400804807,3229058858,1672659739,1672660533,794
7783,3792473331,3774466457,1672563838,1672566690,2852
7652,3634340855,3777717988,1672590446,1672593850,3404
7695,3511267139,3373384732,1672563168,1672563760,592
7632,3883551721,3510771358,1672563690,1672565960,2270
7715,3428964059,3711380716,1672596344,1672596522,178
7792,3520190170,3481647420,1672682981,1672686110,3129
7514,3703955926,3379256399,1672697061,1672698335,1274
7643,3311324983,3475396323,1672533378,1672534776,1398
7573,3418728074,3248507722,1672597923,1672600761,2838
7598,3710067113,3835382117,1672609241,1672610214,973
7582,3701898991,3778780511,1672689822,1672691645,1823
7682,3518163778,3232962003,1672583499,1672586262,2763
7919,3716746253,3417587765,1672602051,1672605060,3009
7684,3209027249,3716258994,1672602342,1672604332,1990
7658,3793436995,3756930948,1672697559,1672698653,1094
7776,3714962248,3512166013,1672610940,1672611459,519
7772,3554917400,3520730271,1672678950,1672680086,1136
7611,3516629436,3304056063,1672636888,1672636968,80
7962,3889750851,3979339287,1672660895,1672661445,550
7725,3736625083,3774366875,1672552537,1672553901,1364
7586,3496269445,3731106822,1672642109,1672642844,735
7768,3792883665,3473765852,1672683100,1672686691,3591
7722,3520719611,3666553782,1672625038,1672625100,62
7865,3626156564,3291235378,1672587820,1672588096,276
7669,3500391167,3520730271,1672677980,1672680121,2141
7485,3804870229,3277605882,1672611440,1672613118,1678
7883,3280964728,3510771358,1672697291,1672698271,980
7975,3716168623,3397418363,1672694362,1672694733,371
7683,3510771358,3774366875,1672537291,1672539762,2471
7912,3512720680,3520030713,1672657051,1672659855,2804
7720,3804870229,3978115672,1672655807,1672657149,1342
7848,3392121505,3701274634,1672549710,1672552156,2446
7629,3757447189,3365942576,1672684068,1672686398,2330
7783,3231056870,3804870229,1672534876,1672537764,2888
7905,3500365158,3378092448,1672668537,1672669699,1162
7509,3399052055,3518876135,1672693347,1672694434,1087
7574,3701498253,3515394721,1672694265,1672695549,1284
7536,3714821932,3772544062,1672703584,1672703795,211
7520,3338703270,3338367113,1672658517,1672661346,2829
7605,3394330287,3880285638,1672679550,1672680098,548
7711,3485823740,3509630174,1672584421,1672587068,2647
7768,3733891182,3397418363,1672681503,1672683362,1859
7764,3716168623,3505477652,1672694866,1672695269,403
7848,3518496488,3780593036,1672614829,1672615127,298
7486,3344364444,3284639858,1672659061,1672660516,1455
7556,3234541252,3978105277,1672591344,1672593504,2160
7655,3779976989,3714821932,1672594953,1672597234,2281
7688,3807987001,3601879040,1672605192,1672605721,529
7620,3302626661,3666553782,1672539661,1672540784,1123
7639,3776513891,3757562897,1672644523,1672647051,2528
7538,3701498253,3760077057,1672648988,1672649669,681
7797,3791874383,3931941795,1672684026,1672686511,2485
7630,3206603608,3970117174,1672544907,1672546271,1364
7508,3715581279,3365830990,1672544907,1672545519,612
7655,3278365525,3931941795,1672609458,1672609762,304
7762,3760509236,3931941795,1672683971,1672687107,3136
7910,3411618230,3509634629,1672594296,1672596633,2337
7568,3520931254,3235635976,1672684916,1672684997,81
7599,3610695419,3607748895,1672605733,1672609030,3297
7973,3909606423,3516673015,1672618414,1672620345,1931
7897,3783126683,3501364586,1672639358,1672642823,3465
7960,3792177074,3512349371,1672576066,1672579240,3174
7723,3496051529,3510380060,1672554050,1672555097,1047
7790,3774119563,3714197325,1672621864,1672623570,1706
7635,3418728074,3757455053,1672553430,1672555903,2473
7547,3515284591,3825229501,1672539006,1672541465,2459
7824,3490191091,3334033993,1672676442,1672677551,1109
7901,3936227020,3777514571,1672539988,1672540896,908
7716,3246596716,3510173870,1672632131,1672635277,3146
7966,3510703546,3510969660,1672543835,1672546268,2433
7699,3774268456,3298433163,1672697321,1672700290,2969
7593,3500499542,3756021689,1672645200,1672648105,2905
7689,3610695419,3307097200,1672596960,1672600493,3533
7791,3701984666,3772642849,1672554468,1672555338,870
7671,3533137446,3882242815,1672541961,1672543989,2028
7587,3791602225,3534492426,1672660007,1672662219,2212
7683,3733189298,3533626375,1672687829,1672687959,130
7856,3713894336,3360506772,1672596657,1672600112,3455
7770,3517459919,3378686918,1672648926,1672649614,688
7634,3301107849,3792288302,1672555527,1672557364,1837
7878,3756966035,3855424474,1672650381,1672652701,2320
7843,3779629905,3713644518,1672667188,1672668576,1388
7512,3418534998,3510247121,1672561177,1672564680,3503
7791,3534424200,3713894336,1672642347,1672645417,3070
7852,3336742544,3517963492,1672548744,1672548970,226
7943,3313541986,3276993580,1672685995,1672686674,679
7847,3505292701,3505873261,1672590427,1672593915,3488
7949,3976633198,3779036831,1672577401,1672578045,644
7847,3711308224,3703789494,1672554823,1672556344,1521
7966,3882242815,3772758337,1672603195,1672604672,1477
7653,3517721725,3361230905,1672545336,1672546036,700
7758,3829319703,3617734118,1672613666,1672614207,541
7976,3511687358,3409474775,1672661336,1672664160,2824
7921,3701967560,3533369198,1672579239,1672582316,3077
7549,3505193212,3505791599,1672541987,1672542752,765
7948,3833889105,3779740455,1672627127,1672628877,1750
7893,3774010081,3800886801,1672596267,1672597777,1510
7848,3935627557,3500994774,1672567485,1672569287,1802
7666,3730517636,3287105466,1672597961,1672598778,817
7661,3388637594,3360993964,1672605270,1672605808,538
7682,3935127663,3792789881,1672537091,1672539533,2442
7563,3883085535,3505912939,1672608988,1672609050,62
7627,3711504540,3978105277,1672550521,1672554102,3581
7879,3421836608,3780828689,1672591328,1672593408,2080
7817,3601879040,3418728074,1672600239,1672602637,2398
7687,3364543015,3829764737,1672629644,1672631353,1709
7646,3793962300,3780914982,1672673618,1672677096,3478
7780,3804870229,3783196518,1672601488,1672603789,2301
7827,3710112546,3388372715,1672626137,1672627422,1285
7757,3311324983,3610348516,1672568862,1672571699,2837
7766,3509453566,3664517356,1672649987,1672653113,3126
7745,3534424200,3715974031,1672572481,1672574030,1549
7825,3358871377,3359239884,1672546835,1672549921,3086
7825,3515860749,3291227780,1672616733,1672620191,3458
7983,3365830990,3774127586,1672692261,1672694903,2642
7517,3360506772,3777929708,1672639444,1672641096,1652
7560,3756453423,3713894336,1672619210,1672621419,2209
7697,3434642576,3777929708,1672604249,1672604832,583
7888,3668005723,3755881905,1672676981,1672678319,1338
7656,3520888296,3755511676,1672561082,1672562091,1009
7508,3311274543,3792473331,1672593347,1672596517,3170
7969,3519703355,3500994774,1672566454,1672569363,2909
7842,3710408395,3362000049,1672567019,1672568893,1874
7627,3235635976,3811171116,1672689914,1672693435,3521
7657,3516980378,3433804879,1672635268,1672638816,3548
7833,3512142794,3518408774,1672646951,1672650243,3292
7556,3736419952,3533748232,1672693779,1672696357,2578
7618,3311627628,3500658339,1672533259,1672536681,3422
7686,3244389794,3760893269,1672538546,1672541304,2758
7687,3792902982,3534010629,1672573197,1672576399,3202
7964,3774045700,3783779671,1672690593,1672692460,1867
7561,3915628728,3509604974,1672558251,1672559256,1005
7666,3311154569,3976390453,1672613143,1672615851,2708
7565,3701146057,3662180254,1672543056,1672545488,2432
7602,3792253549,3607748895,1672609397,1672611084,1687
7672,3514472925,3737079798,1672629260,1672630820,1560
7877,3755872268,3365278081,1672561310,1672562552,1242
7828,3200691026,3911159965,1672673835,1672676211,2376
7681,3755739653,3800353779,1672666020,1672668987,2967
7956,3488244966,3917088658,1672562593,1672564596,2003
7765,3206254161,3817316561,1672578409,1672580876,2467
7578,3791334389,3533927138,1672585544,1672587642,2098
7982,3500365158,3206254161,1672541453,1672541809,356
7943,3389115045,3716488385,1672569538,1672571696,2158
7661,3454042520,3511163800,1672639222,1672639809,587
7839,3703871468,3791942683,1672677573,1672681058,3485
7647,3517077106,3500578848,1672635520,1672636315,795
7569,3889750851,3925620998,1672698161,1672698732,571
7496,3505791599,3757602960,1672599784,1672601578,1794
7895,3793086311,3777623166,1672645909,1672647444,1535
7881,3333896808,3505649239,1672662023,1672663804,1781
7756,3774366875,3520888296,1672535039,1672538535,3496
7504,3500658339,3513164386,1672683377,1672683676,299
7818,3713644518,3710067113,1672685958,1672686983,1025
7948,3505859863,3346327502,1672671872,1672673247,1375
7585,3500060260,3772053179,1672687890,1672688492,602
7593,3793959750,3473765852,1672651255,1672653854,2599
7551,3454042520,3711380716,1672588025,1672589044,1019
7601,3518876135,3518932404,1672650921,1672653864,2943
7950,3710112546,3246596716,1672567959,1672569316,1357
7774,3930797455,3829232696,1672611197,1672613113,1916
7610,3515125508,3391261292,1672599797,1672599942,145
7772,3737079798,3475251781,1672690041,1672691347,1306
7547,3222521619,3533371364,1672570502,1672570714,212
7747,3511198618,3793871337,1672636154,1672638241,2087
7603,3815508790,3711198793,1672605689,1672606943,1254
7601,3402943525,3242408357,1672610315,1672612782,2467
7680,3344019610,3244485293,1672558673,1672562273,3600
7898,3416427576,3716746253,1672588750,1672590428,1678
7905,3664517356,3311152102,1672588904,1672589957,1053
7935,3774366875,3511350608,1672535225,1672536702,1477
7727,3777443199,3932051427,1672624358,1672626204,1846
7942,3388637594,3511350608,1672603038,1672605041,2003
7801,3911245524,3555214688,1672560493,1672560657,164
7546,3518014636,3312829208,1672551292,1672554588,3296
7598,3772758337,3514987389,1672567735,1672570809,3074
7606,3778341199,3533369198,1672697394,1672699518,2124
7793,3387966152,3458539365,1672562752,1672565069,2317
7775,3360506772,3601879040,1672695832,1672697060,1228
7681,3714197325,3825229501,1672569829,1672571132,1303
7530,3793389510,3201324715,1672692518,1672693000,482
7754,3518163778,3533827120,1672678546,1672681161,2615
7947,3534424200,3910454786,1672634762,1672635618,856
7939,3516011407,3505193212,1672701445,1672703703,2258
7848,3760598102,3200198928,1672695694,1672696656,962
7641,3777079686,3418728074,1672608283,1672610780,2497
7674,3737079798,3757246925,1672588128,1672589734,1606
7598,3776513891,3621810464,1672640760,1672643872,3112
7899,3505635228,3378686918,1672698149,1672701566,3417
7971,3634340855,3511312803,1672631351,1672632469,1118
7644,3294803686,3783779671,1672654569,1672656972,2403
7927,3429690204,3518014636,1672650409,1672652120,1711
7952,3883551721,3604539807,1672670357,1672673199,2842
7813,3910886626,3206593906,1672562446,1672563592,1146
7668,3415443558,3793753089,1672585323,1672586352,1029
7804,3925402713,3284639858,1672584063,1672584649,586
7929,3685818092,3817621391,1672580146,1672580294,148
7619,3851190615,3820354437,1672552228,1672554437,2209
7762,3510173870,3617055293,1672654473,1672655686,1213
7762,3972364603,3512349371,1672580938,1672583655,2717
7870,3772359096,3760561634,1672636079,1672637905,1826
7616,3685187183,3516258476,1672563631,1672566720,3089
7775,3365278081,3756453423,1672577970,1672580968,2998
7813,3783206719,3505201246,1672697616,1672697882,266
7783,3607178184,3501955238,1672652735,1672652922,187
7889,3430352815,3501601840,1672668521,1672671291,2770
7521,3311208440,3412825109,1672659036,1672659810,774
7512,3511163800,3793753089,1672539696,1672540658,962
7536,3500994774,3505638204,1672612283,1672613503,1220
7574,3369998498,3512142794,1672683753,1672684331,578
7523,3833889105,3370752401,1672615830,1672617725,1895
7739,3756930948,3778549126,1672602827,1672603447,620
7800,3852595551,3800353779,1672552947,1672554112,1165
7579,3889232789,3774268456,1672688744,1672690004,1260
7758,3249247700,3792844210,1672657410,1672658983,1573
7935,3520165601,3227457126,1672566005,1672566794,789
7823,3533927138,3520165601,1672578363,1672581359,2996
7484,3901877072,3734828619,1672580145,1672581945,1800
7932,3209027249,3533626375,1672632980,1672635581,2601
7921,3926700506,3390068992,1672638825,1672640172,1347
7596,3311871871,3516909237,1672531303,1672533667,2364
7558,3607748895,3492478793,1672537071,1672538332,1261
7701,3770021824,3778308417,1672643560,1672646583,3023
7972,3518932404,3515284591,1672566050,1672567353,1303
7894,3519803045,3533626375,1672668684,1672669478,794
7779,3223968713,3791020967,1672586417,1672588776,2359
7521,3311439795,3433804879,1672662501,1672666072,3571
7507,3421127249,3773950140,1672602045,1672603702,1657
7609,3627937312,3446948848,1672654433,1672656398,1965
7741,3792668962,3513956646,1672612540,1672615022,2482
7679,3823600322,3311203656,1672591164,1672592892,1728
7742,3446948848,3756601594,1672548220,1672551680,3460
7741,3533242305,3500499542,1672559477,1672561770,2293
7801,3426325549,3500229033,1672601477,1672603463,1986
7625,3779629905,3296471982,1672699147,1672701960,2813
7879,3512142794,3793848402,1672677856,1672681296,3440
7533,3505201246,3780914982,1672644584,1672646503,1919
7703,3818255890,3666507626,1672631206,1672634795,3589
7679,3932051427,3890149705,1672572779,1672573136,357
7566,3520888296,3232962003,1672624488,1672625636,1148
7522,3604539807,3859525941,1672531813,1672534857,3044
7861,3483949762,3778266283,1672668886,1672671659,2773
7561,3520706195,3369998498,1672562263,1672564903,2640
7614,3783429780,3617055293,1672669524,1672672851,3327
7685,3757562897,3500894271,1672596065,1672598120,2055
7645,3518163778,3228165483,1672701898,1672705165,3267
7622,3783206719,3629547065,1672534093,1672535419,1326
7664,3629547065,3978115672,1672561188,1672562146,958
7531,3912536808,3372883226,1672640978,1672644070,3092
7612,3617734118,3277939457,1672549946,1672550164,218
7928,3826759140,3246596716,1672582715,1672584462,1747
7602,3715581279,3791553060,1672635909,1672636225,316
7662,3511125626,3883085535,1672617554,1672618898,1344
7592,3800353779,3388372715,1672676207,1672677586,1379
7701,3760893269,3311065516,1672640787,1672643654,2867
7909,3311208440,3828432634,1672663991,1672667569,3578
7656,3242408357,3855000166,1672601526,1672602037,511
7895,3512969370,3520756859,1672651038,1672651422,384
7715,3231056870,3613995936,1672620622,1672623162,2540
7555,3238712269,3916289176,1672548659,1672548931,272
7943,3902278226,3783779671,1672659691,1672662241,2550
7816,3209027249,3311065516,1672620411,1672622415,2004
7629,3685818092,3757447189,1672558901,1672560314,1413
7953,3701190899,3534492426,1672689966,1672693291,3325
7708,3511332835,3346327502,1672671814,1672673460,1646
7547,3807987001,3773978034,1672545057,1672546299,1242
7676,3510969660,3829764737,1672627888,1672630313,2425
7827,3891751546,3500066230,1672642987,1672644243,1256
7611,3800886801,3294803686,1672678587,1672679523,936
7874,3604539807,3389115045,1672676891,1672676997,106
7631,3286658957,3735733948,1672646002,1672647716,1714
7850,3701995648,3501692334,1672553581,1672555135,1554
7748,3805519285,3701146057,1672646448,1672646718,270
7700,3618045231,3390068992,1672532698,1672535156,2458
7674,3755872268,3711571712,1672545787,1672546826,1039
7813,3337544549,3791594391,1672584073,1672586057,1984
7704,3667680268,3385763781,1672662569,1672663782,1213
7757,3757447189,3556951786,1672549853,1672553073,3220
7942,3910454786,3711265369,1672618429,1672619554,1125
7589,3332072298,3510703546,1672571980,1672574555,2575
7845,3519563836,3716488385,1672595466,1672598374,2908
7596,3312829208,3533827120,1672687805,1672690346,2541
7820,3550946908,3277939457,1672618505,1672621938,3433
7775,3534010629,3703223015,1672556030,1672556325,295
7627,3485375593,3516716179,1672681827,1672682283,456
7654,3703871468,3467773920,1672566364,1672568734,2370
7860,3400804807,3715127362,1672542303,1672545222,2919
7882,3701691675,3735733948,1672579944,1672582723,2779
7490,3760489031,3432665384,1672535114,1672538422,3308
7547,3701498253,3511163800,1672652957,1672653870,913
7871,3756453423,3607748895,1672676290,1672679238,2948
7626,3618873142,3780593036,1672616186,1672619245,3059
7714,3242408357,3424922204,1672638942,1672641232,2290
7598,3298288268,3501601840,1672547436,1672550978,3542
7644,3384240055,3617055293,1672563860,1672564561,701
7855,3756424865,3805342762,1672664624,1672665928,1304
7567,3512349371,3520190170,1672613854,1672615808,1954
7800,3703889596,3386707783,1672538685,1672539012,327
7814,3932051427,3773205565,1672563477,1672564463,986
7585,3505702787,3505219850,1672702023,1672702453,430
7808,3666457294,3617055293,1672651681,1672653087,1406
7674,3713349754,3222521619,1672542991,1672544462,1471
7893,3716843669,3512510536,1672687902,1672690466,2564
7782,3520751702,3780365428,1672700931,1672702648,1717
7667,3904775198,3710344260,1672540525,1672541300,775
7839,3772359096,3516673015,1672570119,1672572938,2819
7699,3755872268,3475396323,1672678919,1672679154,235
7672,3484995752,3401627165,1672606832,1672608494,1662
7852,3710408395,3666506258,1672691888,1672694919,3031
7705,3774793839,3664517356,1672668588,1672670139,1551
7944,3701967560,3338367113,1672600622,1672601462,840
7545,3416241005,3379256399,1672636497,1672637601,1104
7724,3779629905,3914259449,1672539035,1672540344,1309
7614,3518163778,3401627165,1672591687,1672592320,633
7885,3477649378,3793959750,1672577013,1672579842,2829
7899,3756462516,3514987389,1672580922,1672582695,1773
7851,3774298222,3501927421,1672624751,1672626051,1300
7761,3826760240,3716197887,1672664516,1672667385,2869
7594,3913251733,3505219850,1672584048,1672584657,609
7733,3732481297,3338367113,1672612035,1672614428,2393
7833,3518932404,3475251781,1672651149,1672653039,1890
7696,3510703546,3475795792,1672534543,1672536607,2064
7531,3516016437,3285400528,1672615936,1672618520,2584
7956,3424922204,3336751428,1672671346,1672673531,2185
7617,3475396323,3701274634,1672689749,1672691019,1270
7924,3505000737,3246596716,1672612793,1672614519,1726
7803,3517255726,3975287541,1672653502,1672656993,3491
7744,3311845971,3793959750,1672659284,1672659948,664
7504,3711973519,3925402713,1672656272,1672656624,352
7683,3880310724,3800353779,1672696163,1672697756,1593
7775,3701995648,3703661585,1672541488,1672543888,2400
7698,3518932404,3683766533,1672702218,1672704842,2624
7967,3760294205,3777079686,1672644802,1672647968,3166
7849,3418728074,3515284591,1672694448,1672694515,67
7647,3701111745,3476232529,1672613642,1672617236,3594
7627,3770101921,3487171044,1672636996,1672640367,3371
7605,3777120536,3509630174,1672624742,1672627687,2945
7558,3813052709,3492478793,1672550509,1672551478,969
7787,3518669703,3606812411,1672536321,1672538035,1714
7960,3285400528,3833889105,1672668070,1672670976,2906
7956,3807987001,3829764737,1672583369,1672583531,162
7750,3887270940,3783245561,1672660721,1672661559,838
7929,3356860407,3485375593,1672583062,1672583394,332
7556,3783239924,3209383861,1672576789,1672577329,540
7789,3420432297,3465254146,1672650355,1672650585,230
7976,3909238838,3701534009,1672575370,1672576598,1228
7769,3610348516,3780365428,1672644263,1672645180,917
7559,3505638204,3736790081,1672655354,1672656947,1593
7576,3826759140,3475258557,1672631898,1672634079,2181
7605,3478194807,3365942576,1672587753,1672590180,2427
7680,3227457126,3607748895,1672695646,1672697231,1585
7743,3621810464,3716900301,1672597673,1672597818,145
7518,3515860749,3339907603,1672616724,1672617111,387
7828,3756021689,3556951786,1672640959,1672643686,2727
7808,3378092448,3791602225,1672607819,1672610534,2715
7512,3311871871,3780813786,1672600081,1672601773,1692
7966,3222521619,3515394721,1672702376,1672704419,2043
7974,3791553060,3783925755,1672600207,1672602372,2165
7763,3356860407,3713808837,1672615060,1672616977,1917
7609,3520888296,3475251781,1672628917,1672630386,1469
7763,3715339701,3367902229,1672560190,1672561200,1010
7514,3621497531,3777079686,1672695107,1672695965,858
7800,3918247820,3926700506,1672632154,1672632292,138
7856,3937224533,3428006164,1672632063,1672635344,3281
7695,3710408395,3777443199,1672562709,1672565047,2338
7977,3394539273,3365942576,1672582420,1672583529,1109
7781,3316173088,3402943525,1672593733,1672595921,2188
7781,3755587522,3407725581,1672565749,1672566622,873
7873,3701274634,3387966152,1672600744,1672602259,1515
7754,3774005526,3388637594,1672640963,1672644103,3140
7788,3276993580,3760992710,1672557370,1672560551,3181
7832,3392121505,3668005723,1672686646,1672687164,518
7868,3311090974,3361230905,1672682567,1672685889,3322
7632,3412980697,3904408902,1672557239,1672557301,62
7849,3379256399,3489962019,1672589705,1672591347,1642
7766,3613995936,3311208440,1672661433,1672662638,1205
7967,3384951177,3734496778,1672698093,1672698649,556
7593,3515723720,3505145247,1672686232,1672688307,2075
7615,3500803339,3613995936,1672701506,1672703871,2365
7694,3303705369,3910886626,1672631159,1672632006,847
7981,3510969660,3432689543,1672631317,1672632877,1560
7965,3333896808,3209383861,1672538801,1672539197,396
7840,3622054816,3793959750,1672537186,1672539581,2395
7593,3505973226,3711308224,1672534428,1672536443,2015
7736,3399004969,3733891182,1672583950,1672584944,994
7877,3715981584,3517509185,1672628832,1672632411,3579
7493,3389115045,3711380716,1672589177,1672589950,773
7734,3793848402,3402943525,1672673640,1672676338,2698
7557,3975287541,3399004969,1672681508,1672684313,2805
7491,3291235378,3757403279,1672642081,1672643318,1237
7751,3516016437,3315583351,1672531608,1672532537,929
7629,3378686918,3756623396,1672685544,1672686335,791
7739,3793871337,3734496778,1672612968,1672616111,3143
7586,3280599164,3388372715,1672647272,1672650183,2911
7565,3715974031,3891751546,1672613289,1672613432,143
7777,3804870229,3534702203,1672549826,1672550397,571
7838,3779740455,3421127249,1672587211,1672587901,690
7878,3760294205,3515151980,1672664084,1672664635,551
7835,3773814927,3519601612,1672640475,1672643456,2981
7532,3517864478,3344019610,1672598762,1672600500,1738
7558,3520206212,3883861463,1672699760,1672702708,2948
7696,3512540951,3629935998,1672612307,1672613494,1187
7960,3346795719,3776066388,1672534207,1672537170,2963
7800,3760509236,3851190615,1672654530,1672656873,2343
7829,3518932404,3601879040,1672580124,1672581143,1019
7814,3510244400,3772758337,1672596705,1672597226,521
7759,3505883609,3711198793,1672549090,1672550407,1317
7617,3770824086,3333896808,1672561045,1672561184,139
7517,3365830990,3770635361,1672622362,1672625023,2661
7864,3505635228,3500066230,1672641647,1672641768,121
7804,3930797455,3791594391,1672644937,1672645334,397
7621,3520190170,3501483568,1672643136,1672645074,1938
7900,3716197887,3822654369,1672585975,1672587340,1365
7562,3520706195,3834257412,1672618365,1672621259,2894
7895,3505203158,3515723720,1672598541,1672601343,2802
7715,3519601612,3475258557,1672554600,1672555649,1049
7559,3891751546,3448855696,1672611808,1672614346,2538
7860,3428006164,3235287260,1672666012,1672668311,2299
7966,3783239924,3512969370,1672538934,1672539628,694
7971,3500365158,3516909237,1672603875,1672605524,1649
7635,3383922351,3439023335,1672682899,1672684474,1575
7719,3913251733,3496051529,1672665874,1672669011,3137
7903,3505135325,3277669002,1672676442,1672678714,2272
7881,3515151980,3883551721,1672674602,1672677268,2666
7591,3715974031,3760294205,1672682496,1672684913,2417
7834,3791874383,3701146057,1672615318,1672616349,1031
7912,3501955238,3628819436,1672670019,1672672406,2387
7956,3426325549,3345207877,1672579709,1672580351,642
7738,3600647945,3793436995,1672599648,1672602860,3212
7485,3244436890,3206254161,1672566086,1672569112,3026
7607,3773664987,3319752091,1672679079,1672682638,3559
7617,3500658339,3780593036,1672570706,1672570874,168
7932,3379589402,3779218771,1672655980,1672656821,841
7828,3773814927,3501606184,1672647571,1672647715,144
7931,3774045700,3407673904,1672622655,1672623475,820
7569,3621810464,3206254161,1672558378,1672561426,3048
7661,3516673015,3428006164,1672694142,1672695605,1463
7857,3778108318,3774466457,1672632956,1672636193,3237
7980,3791997875,3476232529,1672551875,1672554648,2773
7640,3511332835,3417970574,1672598435,1672598744,309
7581,3291227780,3514128943,1672591619,1672594027,2408
7760,3772309166,3904775198,1672547261,1672548752,1491
7674,3509907947,3493507965,1672591310,1672592131,821
7875,3668005723,3378436155,1672640752,1672641509,757
7565,3362000049,3904775198,1672609829,1672613056,3227
7780,3505173328,3314245084,1672540109,1672540665,556
7597,3277939457,3909238838,1672679241,1672680933,1692
7751,3703789494,3770101921,1672687405,1672690566,3161
7553,3633420270,3391261292,1672563443,1672564294,851
7511,3517077106,3484995752,1672621480,1672624989,3509
7835,3331845324,3396285984,1672672561,1672674608,2047
7511,3483164654,3629547065,1672660744,1672662974,2230
7581,3505098372,3779528381,1672609956,1672611799,1843
7843,3611150562,3534492426,1672621046,1672621366,320
7716,3760489031,3755042098,1672680831,1672682242,1411
7979,3483164654,3473765852,1672567100,1672569294,2194
7767,3736625083,3713969578,1672603026,1672605691,2665
7799,3793962300,3793389510,1672620503,1672621093,590
7822,3914290246,3793286136,1672640737,1672644018,3281
7872,3713644518,3701190899,1672691486,1672691665,179
7743,3453729665,3342131135,1672559012,1672560682,1670
7735,3415443558,3501927421,1672634953,1672636499,1546
7718,3682061100,3902383721,1672636023,1672637270,1247
7951,3200198928,3298288268,1672575482,1672576060,578
7653,3519700826,3533810360,1672652650,1672655274,2624
7928,3825229501,3777455223,1672531358,1672532390,1032
7864,3776338577,3386707783,1672650700,1672651695,995
7956,3510247121,3716488385,1672701612,1672702366,754
7665,3836573197,3311090974,1672570394,1672571087,693
7537,3777120536,3714504419,1672664696,1672667524,2828
7812,3510594211,3739106581,1672643935,1672646657,2722
7750,3314836094,3666553782,1672583891,1672584415,524
7641,3774339795,3311274543,1672591068,1672594037,2969
7871,3624761861,3755920131,1672676678,1672679981,3303
7761,3200198928,3772714862,1672542905,1672545718,2813
7596,3512540951,3774556560,1672569137,1672572676,3539
7489,3391915121,3235635976,1672574843,1672575333,490
7655,3443698222,3516980378,1672543828,1672543955,127
7677,3505904952,3760992710,1672680859,1672683720,2861
7746,3519912874,3513956646,1672575094,1672578466,3372
7920,3505477652,3772359096,1672607453,1672608386,933
7801,3912536808,3399004969,1672702579,1672704777,2198
7966,3316173088,3209383861,1672616857,1672619271,2414
7851,3666553782,3510594211,1672608445,1672610261,1816
7645,3380035798,3895562476,1672659838,1672660874,1036
7499,3772359096,3826633236,1672600765,1672601980,1215
7741,3780828689,3703871468,1672593859,1672597330,3471
7958,3772714862,3778980116,1672679446,1672680759,1313
7735,3519563836,3500458761,1672595252,1672598372,3120
7555,3516016437,3515125508,1672535722,1672535876,154
7675,3911159965,3776513891,1672604742,1672606200,1458
7906,3200691026,3202120784,1672537698,1672540997,3299
7944,3755739653,3333896808,1672612891,1672615091,2200
7484,3922275416,3889750851,1672592912,1672593206,294
7747,3505362057,3516065852,1672678420,1672680090,1670
7700,3839849341,3490191091,1672550049,1672552742,2693
7760,3904408902,3783925755,1672592994,1672594055,1061
7661,3668005723,3555214688,1672646063,1672649152,3089
7607,3514719601,3622054816,1672668178,1672668333,155
7510,3311152102,3703955926,1672589610,1672593032,3422
7708,3606987130,3639847263,1672539516,1672542502,2986
7554,3757562897,3736786443,1672593581,1672596283,2702
7607,3516039895,3533385867,1672667186,1672670483,3297
7741,3772578994,3880285638,1672602941,1672603924,983
7864,3510703546,3731106822,1672597789,1672598411,622
7951,3396086535,3311439795,1672662535,1672664748,2213
7776,3637008488,3365278081,1672559093,1672562445,3352
7912,3311648200,3380035798,1672620364,1672620430,66
7509,3898995675,3703955926,1672643937,1672646169,2232
7813,3793848402,3778341199,1672662358,1672663024,666
7840,3714474557,3791602225,1672565399,1672567337,1938
7534,3622054816,3713349754,1672570326,1672571071,745
7959,3617734118,3481502100,1672614249,1672615635,1386
7744,3280599164,3756601594,1672585662,1672586062,400
7897,3293695955,3280964728,1672603177,1672606567,3390
7538,3770447408,3380035798,1672549026,1672550124,1098
7751,3533137446,3511687358,1672608798,1672611665,2867
7596,3714197325,3901877072,1672701487,1672702509,1022
7549,3333896808,3683959482,1672644362,1672646058,1696
7707,3224716315,3756021689,1672598719,1672601915,3196
7733,3315583351,3792032359,1672544933,1672547784,2851
7563,3890149705,3733891182,1672649673,1672652942,3269
7687,3757403279,3229665776,1672638419,1672638960,541
7497,3713786889,3232962003,1672535248,1672538589,3341
7697,3701178711,3710569131,1672637078,1672639478,2400
7870,3715127362,3481502100,1672648730,1672651688,2958
7624,3772884106,3777790718,1672675826,1672677878,2052
7933,3930791338,3607748895,1672624345,1672626455,2110
7607,3473562469,3280964728,1672567380,1672568763,1383
7656,3770824086,3713349754,1672604595,1672607104,2509
7725,3935127663,3500199935,1672674458,1672675834,1376
7544,3882291183,3481647420,1672554938,1672557051,2113
7802,3774338212,3518360734,1672570138,1672573539,3401
7487,3386707783,3618045231,1672668438,1672670598,2160
7782,3394330287,3772309150,1672587873,1672591259,3386
7840,3517476351,3501692334,1672567330,1672568094,764
7856,3509773875,3246596716,1672631366,1672632506,1140
7501,3416241005,3852595551,1672617201,1672620551,3350
7707,3404384505,3505098372,1672660546,1672662462,1916
7600,3514128943,3778305740,1672559792,1672563390,3598
7937,3713268590,3279721246,1672584394,1672586232,1838
7844,3280599164,3397418363,1672694680,1672695647,967
7722,3276993580,3855937514,1672623275,1672625610,2335
7792,3517864478,3711571712,1672643836,1672645913,2077
7749,3505702787,3505873261,1672602254,1672604095,1841
7720,3616944364,3688683847,1672594002,1672595518,1516
7581,3311718847,3736786443,1672585835,1672588909,3074
7972,3477375368,3935627557,1672585979,1672587773,1794
7854,3293695955,3880310724,1672653060,1672656357,3297
7624,3716900301,3774066725,1672642432,1672645323,2891
7983,3791594391,3418534998,1672613313,1672615736,2423
7660,3377766165,3206603608,1672646107,1672647989,1882
7867,3312333615,3397418363,1672644091,1672646711,2620
7938,3533137446,3202120784,1672621948,1672625488,3540
7505,3224716315,3734737881,1672656473,1672658225,1752
7981,3388286531,3666553782,1672624913,1672625370,457
7745,3773978034,3777806071,1672591265,1672594415,3150
7884,3701691675,3714474557,1672688839,1672690172,1333
7655,3520888296,3713370078,1672654235,1672657745,3510
7905,3666507626,3820354437,1672581472,1672583347,1875
7951,3432689543,3234362962,1672596059,1672597998,1939
7671,3714197325,3533626375,1672533996,1672534771,775
7508,3701863557,3348261553,1672673522,1672674066,544
7980,3501606184,3427283336,1672575792,1672576544,752
7967,3416265063,3516223597,1672665133,1672667945,2812
7884,3711308224,3829319703,1672691234,1672692260,1026
7516,3756601594,3607178184,1672686078,1672687672,1594
7572,3505859863,3666507626,1672674766,1672677993,3227
7533,3383661227,3792288302,1672605092,1672605515,423
7922,3979339287,3374559242,1672669623,1672670798,1175
7725,3701274634,3515151980,1672664373,1672666249,1876
7977,3206593906,3772544062,1672699629,1672699990,361
7517,3519152550,3471220483,1672693204,1672694177,973
7960,3242408357,3773598056,1672650905,1672653671,2766
7737,3774127586,3475396323,1672648290,1672650909,2619
7853,3505962865,3667680268,1672664479,1672666507,2028
7930,3891751546,3512217942,1672680223,1672680872,649
7760,3811694763,3883312122,1672569551,1672572667,3116
7488,3420700674,3446948848,1672688851,1672690505,1654
7834,3487171044,3501483568,1672701869,1672704448,2579
7539,3384951177,3820354437,1672676222,1672676425,203
7502,3757151210,3501486692,1672640090,1672642137,2047
7773,3515151980,3209027249,1672684833,1672685829,996
7842,3520756859,3494290908,1672598039,1672599801,1762
7522,3407725581,3459030804,1672545592,1672548251,2659
7693,3424922204,3791997875,1672649576,1672652818,3242
7973,3855602893,3715998609,1672699581,1672700179,598
7560,3780788622,3710067113,1672564101,1672564435,334
7978,3792789881,3731419510,1672575132,1672578487,3355
7896,3412825109,3516065852,1672584131,1672586320,2189
7922,3533095755,3311718847,1672576113,1672577491,1378
7748,3773120434,3360993964,1672662593,1672665463,2870
7638,3622054816,3510969660,1672621614,1672623212,1598
7948,3519601612,3899266183,1672698945,1672699855,910
7665,3883085535,3206254161,1672686287,1672687152,865
7839,3756966035,3777079686,1672669682,1672672373,2691
7530,3793962300,3505883609,1672540980,1672541832,852
7878,3666506258,3411618230,1672615664,1672618539,2875
7717,3427283336,3374559242,1672532798,1672533051,253
7516,3773429448,3777623166,1672572692,1672573381,689
7683,3360506772,3511435497,1672698664,1672701198,2534
7491,3613683164,3777443199,1672588546,1672589972,1426
7845,3201848640,3466911760,1672574172,1672576045,1873
7585,3500060260,3439023335,1672628638,1672629770,1132
7882,3757161914,3337544549,1672652403,1672652466,63
7886,3770101921,3627937312,1672682102,1672682863,761
7895,3509630174,3628819436,1672652331,1672653757,1426
7873,3899371911,3202120784,1672541677,1672545070,3393
7510,3519803045,3278365525,1672641579,1672643323,1744
7717,3703889596,3483949762,1672565001,1672566738,1737
7674,3415546117,3484995752,1672552121,1672553976,1855
7893,3889232789,3774520233,1672574117,1672574311,194
7971,3405494240,3774338212,1672696645,1672698188,1543
7762,3736229191,3289061738,1672555058,1672558170,3112
7524,3730517636,3915628728,1672656029,1672657098,1069
7572,3293695955,3505145247,1672678872,1672679782,910
7952,3494290908,3351008918,1672604324,1672607448,3124
7541,3500578848,3902278226,1672683576,1672685846,2270
7834,3311203656,3511687358,1672656393,1672659422,3029
7681,3494290908,3852391257,1672551711,1672554475,2764
7756,3478194807,3465254146,1672552302,1672553940,1638
7517,3783206719,3668005723,1672665354,1672666091,737
7815,3518669703,3533371364,1672659432,1672662359,2927
7976,3276640712,3772714862,1672578059,1672579308,1249
7824,3713349754,3511271692,1672643732,1672645184,1452
7706,3358871377,3793338102,1672643668,1672645429,1761
7619,3791602225,3738274418,1672565680,1672566003,323
7576,3757682496,3288764520,1672661386,1672664707,3321
7969,3394539273,3858918246,1672567186,1672567794,608
7811,3505973226,3774501422,1672637698,1672640642,2944
7794,3736786443,3757403279,1672571325,1672571765,440
7560,3482405588,3520376528,1672678068,1672678615,547
7904,3483949762,3780914982,1672635135,1672636998,1863
7775,3783705817,3716537575,1672679355,1672680949,1594
7587,3346795719,3777120536,1672634397,1672635622,1225
7929,3512567240,3772746272,1672627148,1672630393,3245
7559,3793389510,3688683847,1672680887,1672682100,1213
7522,3975287541,3774195321,1672626969,1672630490,3521
7899,3600647945,3922337974,1672648940,1672651907,2967
7775,3346327502,3475258557,1672681730,1672683839,2109
7582,3485008994,3904408902,1672587504,1672588395,891
7896,3770851318,3936227020,1672541913,1672543177,1264
7806,3976390453,3518014404,1672579344,1672580987,1643
7714,3516011407,3755511676,1672540943,1672541394,451
7776,3360743849,3883551721,1672552686,1672554019,1333
7550,3293695955,3776948966,1672667286,1672669701,2415
7853,3200198928,3500904641,1672604136,1672607338,3202
7522,3882242815,3332072298,1672693421,1672694644,1223
7493,3815508790,3520730271,1672665257,1672666720,1463
7896,3972709319,3334033993,1672635003,1672635925,922
7595,3346795719,3774066725,1672567003,1672568573,1570
7660,3939952128,3607178184,1672583583,1672585769,2186
7712,3500994774,3776338577,1672549641,1672552423,2782
7522,3396285984,3505203158,1672606789,1672607387,598
7858,3511198618,3834257412,1672604123,1672605979,1856
7783,3701190899,3780294829,1672563505,1672566383,2878
7900,3389115045,3314245084,1672561843,1672564623,2780
7799,3433804879,3518876135,1672555222,1672556979,1757
7849,3417061462,3757403279,1672703370,1672704272,902
7779,3773205565,3515860749,1672558585,1672560411,1826
7785,3516909237,3418534998,1672538797,1672541003,2206
7740,3236102733,3478194807,1672687532,1672690127,2595
7888,3511350608,3828365570,1672623282,1672625749,2467
7657,3774793839,3972364603,1672622316,1672624188,1872
7740,3818255890,3236102733,1672676815,1672677844,1029
7943,3471220483,3510969660,1672643887,1672643982,95
7797,3760183458,3683766533,1672685779,1672685892,113
7624,3247780536,3288764520,1672656512,1672656664,152
7762,3515860749,3826633236,1672587708,1672589181,1473
7630,3311993075,3336742544,1672692473,1672694565,2092
7835,3533810360,3713349754,1672702502,1672705360,2858
7874,3365830990,3774010081,1672701806,1672704128,2322
7602,3833889105,3777936328,1672681787,1672682406,619
7492,3755042098,3512683609,1672532400,1672534004,1604
7597,3624761861,3534553510,1672537501,1672540961,3460
7858,3887270940,3208844525,1672692883,1672693307,424
7859,3807987001,3458539365,1672667894,1672668611,717
7606,3634786711,3804870229,1672548277,1672549601,1324
7521,3298433163,3792473331,1672546637,1672548584,1947
7549,3518014636,3800886801,1672532698,1672535633,2935
7702,3711262377,3318697153,1672684332,1672687570,3238
7745,3710408395,3772309166,1672584809,1672587642,2833
7909,3485375593,3791553060,1672684165,1672685915,1750
7889,3903962771,3313541986,1672691012,1672692936,1924
7925,3930797455,3378092448,1672615656,1672616485,829
7809,3851190615,3715492942,1672662199,1672664752,2553
7877,3511267139,3514987389,1672597570,1672598164,594
7825,3777455223,3519428855,1672648169,1672650696,2527
7499,3517476351,3755920131,1672659490,1672661838,2348
7969,3805292782,3885897503,1672583844,1672584597,753
7844,3715581279,3859525941,1672594784,1672596780,1996
7838,3370752401,3685818092,1672655715,1672658442,2727
7575,3533280269,3345207877,1672696661,1672699775,3114
7970,3533369198,3713786889,1672537024,1672539337,2313
7791,3228165483,3791957752,1672582009,1672582968,959
7932,3500391167,3231056870,1672599745,1672600865,1120
7904,3738274418,3772714862,1672630030,1672633154,3124
7680,3517963492,3533626375,1672652495,1672652698,203
7620,3855424474,3774204963,1672693899,1672697313,3414
7766,3430504438,3774501422,1672602516,1672602890,374
7658,3828624701,3481647420,1672637100,1672638277,1177
7654,3492478793,3978115672,1672594988,1672598236,3248
7872,3351554343,3247428249,1672566533,1672569960,3427
7938,3777455223,3976390453,1672659473,1672661094,1621
7959,3515151980,3776948966,1672645751,1672649098,3347
7599,3835382117,3770763956,1672558210,1672560273,2063
7802,3783206719,3818255890,1672637728,1672637975,247
7967,3505530961,3701995648,1672675042,1672676285,1243
7937,3778266283,3249791738,1672628841,1672631272,2431
7712,3777929708,3519556068,1672631689,1672633271,1582
7568,3827377568,3772544062,1672566829,1672567975,1146
7863,3774119563,3791997875,1672560812,1672561646,834
7560,3402943525,3972709319,1672686993,1672688065,1072
7892,3429856982,3772309150,1672598970,1672601309,2339
7597,3714197325,3389115045,1672534907,1672536505,1598
7870,3715339701,3311152102,1672594316,1672597105,2789
7776,3829319703,3348261553,1672592131,1672595161,3030
7870,3336751428,3756453423,1672694882,1672698035,3153
7807,3715981584,3505530961,1672590318,1672591047,729
7833,3779740455,3500374658,1672699075,1672702147,3072
7714,3278365525,3430074045,1672635128,1672638445,3317
7621,3777079686,3780294829,1672646021,1672646999,978
7627,3496051529,3713630656,1672546319,1672549059,2740
7899,3514987389,3701065786,1672701575,1672703933,2358
7857,3533626375,3247780536,1672602286,1672604997,2711
7796,3701691675,3383922351,1672564278,1672564977,699
7749,3511862351,3534191820,1672560209,1672561662,1453
7759,3622054816,3291883916,1672680845,1672681012,167
7507,3510711755,3513454145,1672664258,1672665184,926
7863,3812176780,3793086311,1672660145,1672661836,1691
7714,3409474775,3714474557,1672689549,1672691826,2277
7975,3333896808,3606812411,1672656603,1672658921,2318
7639,3777776687,3666506258,1672690269,1672693592,3323
7532,3970117174,3701111745,1672540636,1672541379,743
7651,3374559242,3756027749,1672586457,1672587494,1037
7578,3713644518,3770635361,1672655243,1672658669,3426
7522,3429690204,3518669703,1672549698,1672552600,2902
7870,3760183458,3533371364,1672666249,1672668244,1995
7629,3238712269,3236102733,1672600236,1672602597,2361
7873,3516909237,3880285638,1672540964,1672541451,487
7646,3319752091,3416241005,1672641873,1672642898,1025
7576,3760294205,3760561634,1672584703,1672587547,2844
7910,3448855696,3500578848,1672642761,1672643773,1012
7766,3778549126,3816853177,1672599534,1672602090,2556
7918,3819727225,3505702787,1672675192,1672678406,3214
7772,3200691026,3519601612,1672544978,1672546719,1741
7724,3626156564,3415546117,1672557307,1672557859,552
7941,3757602960,3931941795,1672624307,1672624947,640
7652,3505791599,3607748895,1672581843,1672584406,2563
7945,3514719601,3311274543,1672602428,1672602734,306
7708,3311152102,3501486692,1672686983,1672688471,1488
7798,3760492950,3776513891,1672570443,1672572143,1700
7663,3807987001,3774366875,1672591841,1672594932,3091
7753,3501955238,3791957752,1672546450,1672546935,485
7827,3359239884,3760267716,1672617431,1672618057,626
7839,3755920131,3277939457,1672690166,1672691158,992
7586,3858918246,3505362057,1672622995,1672625190,2195
7884,3816454165,3517963492,1672660698,1672662745,2047
7604,3610348516,3285400528,1672563713,1672563945,232
7807,3277939457,3701984666,1672678769,1672680212,1443
7721,3855424474,3234541252,1672609403,1672612658,3255
7661,3391261292,3770824086,1672668278,1672669397,1119
7595,3622054816,3780788622,1672666953,1672669536,2583
7686,3885670556,3311090974,1672586673,1672588714,2041
7663,3777806071,3615046771,1672691955,1672695238,3283
7622,3716900301,3346795719,1672695586,1672696454,868
7648,3731106822,3505883609,1672584862,1672586569,1707
7690,3774204963,3606987130,1672619699,1672621032,1333
7622,3660493209,3501692334,1672554763,1672555109,346
7693,3500391167,3791115967,1672567003,1672567884,881
7756,3209383861,3421127249,1672697804,1672699567,1763
7492,3501730685,3311152102,1672584456,1672585278,822
7781,3760569731,3791115967,1672540307,1672543275,2968
7777,3280615985,3397418363,1672532269,1672534889,2620
7505,3511435497,3774125065,1672694963,1672698374,3411
7777,3608868877,3973560347,1672601923,1672603399,1476
7930,3438645253,3246596716,1672539232,1672541611,2379
7837,3311324983,3533095755,1672554758,1672558211,3453
7648,3248507722,3231056870,1672562616,1672563106,490
7696,3286658957,3501486692,1672649945,1672650945,1000
7876,3512510536,3222448362,1672600632,1672600994,362
7593,3611150562,3331845324,1672692528,1672692798,270
7563,3772337814,3500487333,1672677022,1672677614,592
7604,3815508790,3804870229,1672643398,1672646192,2794
7546,3416265063,3311439795,1672680466,1672683179,2713
7836,3614238812,3505873261,1672579862,1672581418,1556
7861,3660493209,3978115672,1672684644,1672685645,1001
7681,3520751702,3715998609,1672610961,1672612362,1401
7897,3483949762,3505292701,1672668321,1672671659,3338
7689,3777120536,3505599848,1672580484,1672583319,2835
7743,3500904641,3770763956,1672552465,1672552579,114
7908,3511271692,3777120536,1672693401,1672696845,3444
7958,3505912939,3793848402,1672610427,1672613940,3513
7951,3221899927,3500578848,1672591954,1672595110,3156
7854,3622054816,3404384505,1672660384,1672663905,3521
7957,3516980378,3432665384,1672657759,1672659212,1453
7576,3855000166,3235287260,1672589087,1672591770,2683
7628,3520629279,3466911760,1672562131,1672563658,1527
7631,3685818092,3533369198,1672635999,1672636511,512
7954,3346327502,3400918687,1672699185,1672700726,1541
7511,3399004969,3500060260,1672566271,1672569859,3588
7968,3518163778,3756528686,1672544317,1672545304,987
7954,3819727225,3715998609,1672632418,1672635223,2805
7852,3505347134,3458539365,1672666775,1672667563,788
7738,3291235378,3701190899,1672592527,1672594009,1482
7520,3792844210,3783925755,1672666258,1672667275,1017
7570,3365830990,3517255726,1672598117,1672598751,634
7706,3778308417,3779629905,1672558183,1672561179,2996
7969,3811694763,3972364603,1672650284,1672653061,2777
7938,3617734118,3710067113,1672543617,1672546178,2561
7583,3858918246,3774010081,1672668379,1672669673,1294
7948,3511271692,3637008488,1672646588,1672646722,134
7797,3629935998,3516980378,1672559137,1672560061,924
7830,3783206719,3804870229,1672545832,1672548850,3018
7741,3714488548,3209048907,1672701028,1672703720,2692
7734,3206593906,3731106822,1672624352,1672625634,1282
7916,3733891182,3520030713,1672655874,1672656235,361
7764,3882291183,3627937312,1672608381,1672610108,1727
7530,3500994774,3715339701,1672544232,1672546032,1800
7658,3777079686,3533193862,1672594199,1672596192,1993
7983,3401627165,3235287260,1672638543,1672639141,598
7688,3388637594,3416265063,1672580077,1672582855,2778
7698,3206603608,3273500349,1672568425,1672568576,151
7548,3209383861,3516039895,1672647730,1672648028,298
7976,3512683609,3855602893,1672624957,1672625100,143
7810,3756451663,3978105277,1672550225,1672552318,2093
7943,3516011407,3685187183,1672578094,1672581186,3092
7649,3701691675,3883861463,1672671193,1672671318,125
7885,3776338577,3234541252,1672662844,1672665344,2500
7847,3533653428,3533810360,1672540490,1672542940,2450
7659,3516011407,3899371911,1672659752,1672661999,2247
7696,3853018906,3511125626,1672651837,1672654388,2551
7839,3716900301,3407725581,1672538309,1672541035,2726
7601,3302626661,3418534998,1672572971,1672573397,426
7771,3510857360,3634786711,1672538683,1672540457,1774
7606,3500177712,3615046771,1672690603,1672693727,3124
7840,3703955926,3811694763,1672605829,1672608746,2917
7610,3624761861,3311439795,1672697751,1672698381,630
7684,3783509527,3344019610,1672698301,1672700717,2416
7877,3734828619,3512166013,1672605288,1672607292,2004
7602,3505873261,3516980378,1672595590,1672595728,138
7783,3827626797,3701184889,1672545401,1672548639,3238
7724,3755625324,3837094550,1672698244,1672698900,656
7753,3755392666,3367902229,1672623188,1672624355,1167
7703,3780609808,3774066725,1672584722,1672587050,2328
7927,3791115967,3378092448,1672628369,1672631245,2876
7900,3511359172,3505962865,1672697224,1672699678,2454
7536,3777079686,3736786443,1672588908,1672590639,1731
7552,3518496488,3534729133,1672636639,1672640041,3402
7758,3515125508,3533369198,1672636596,1672638332,1736
7550,3916289176,3755943611,1672670133,1672672069,1936
7807,3471220483,3711308224,1672667586,1672667971,385
7798,3519654779,3770021824,1672600017,1672600619,602
7538,3407954858,3465254146,1672624224,1672624382,158
7629,3857349323,3518496488,1672631590,1672633842,2252
7626,3356860407,3779976989,1672625704,1672626724,1020
7682,3500177712,3774066725,1672578433,1672581189,2756
7524,3358871377,3360743849,1672581314,1672581799,485
7884,3710067113,3779629905,1672674096,1672675856,1760
7941,3316173088,3792668962,1672597282,1672600028,2746
7758,3780828689,3385763781,1672549009,1672551503,2494
7519,3666553782,3516629436,1672650219,1672652210,1991
7633,3780974443,3774366875,1672549214,1672549571,357
7657,3774066725,3412980697,1672618944,1672619142,198
7567,3668898102,3936227020,1672644152,1672647041,2889
7863,3701534009,3783779671,1672579343,1672579914,571
7918,3715492942,3516223597,1672534427,1672536089,1662
7513,3489545239,3475795792,1672560205,1672562026,1821
7968,3286658957,3715339701,1672657808,1672658598,790
7687,3348261553,3201848640,1672680403,1672681009,606
7550,3837094550,3714504419,1672632061,1672633934,1873
7714,3429856982,3715998609,1672618447,1672618731,284
7526,3511125626,3483949762,1672541693,1672541771,78
7653,3430074045,3776066388,1672619477,1672619861,384
7981,3206603608,3793962300,1672602179,1672605323,3144
7784,3484995752,3510173870,1672537944,1672541260,3316
7663,3288764520,3472130842,1672635746,1672636079,333
7676,3780609808,3760492950,1672551011,1672551890,879
7958,3418728074,3629547065,1672653033,1672654475,1442
7789,3778549126,3779528381,1672637710,1672641289,3579
7616,3713268590,3377766165,1672573737,1672573830,93
7585,3855602893,3349613093,1672588805,1672589921,1116
7627,3714504419,3512540951,1672679489,1672682381,2892
7567,3206603608,3520730271,1672703972,1672705394,1422
7683,3514128943,3779528381,1672560590,1672561747,1157
7627,3918584946,3792844210,1672703837,1672704721,884
7786,3505145247,3733189298,1672653315,1672656621,3306
7863,3715998609,3383661227,1672614471,1672617606,3135
7670,3430074045,3201432789,1672616268,1672619180,2912
7762,3791553060,3774793839,1672597233,1672600103,2870
7761,3513599775,3920801189,1672577776,1672578839,1063
7697,3688683847,3388372715,1672608489,1672611329,2840
7538,3837094550,3773205565,1672633079,1672634999,1920
7938,3516039895,3756027749,1672676878,1672677484,606
7595,3374559242,3489728806,1672676678,1672679047,2369
7826,3249401741,3236102733,1672607673,1672609866,2193
7794,3514472925,3738274418,1672545205,1672545854,649
7490,3774366875,3533748232,1672586646,1672589645,2999
7887,3515394721,3490191091,1672637164,1672638443,1279
7715,3616944364,3735319397,1672614121,1672614564,443
7872,3883312122,3904408902,1672687556,1672689195,1639
7845,3734737881,3383922351,1672578706,1672579652,946
7576,3714197325,3688418210,1672654707,1672657535,2828
7609,3773120434,3774045700,1672619063,1672619196,133
7615,3783126683,3792883665,1672605216,1672605501,285
7977,3793753089,3633420270,1672696479,1672699069,2590
7637,3395152943,3780788622,1672601855,1672603893,2038
7774,3834257412,3760294205,1672608693,1672611859,3166
7927,3396285984,3783206719,1672620816,1672623540,2724
7787,3805519285,3387674757,1672669192,1672672322,3130
7818,3385763781,3520206212,1672683273,1672686507,3234
7629,3777717988,3311718847,1672637704,1672638067,363
7620,3880285638,3922337974,1672664464,1672667594,3130
7922,3770101921,3792789881,1672585298,1672588472,3174
7747,3808324264,3911245524,1672695510,1672698518,3008
7642,3701863557,3978105277,1672666456,1672667265,809
7898,3244173074,3832902928,1672665626,1672665854,228
7835,3756528686,3918584946,1672585314,1672586038,724
7619,3418534998,3519563836,1672661298,1672664016,2718
7857,3338703270,3365278081,1672612878,1672614415,1537
7833,3534313900,3515394721,1672609822,1672609913,91
7844,3774119563,3556951786,1672647172,1672648797,1625
7506,3912262917,3409474775,1672578320,1672580488,2168
7486,3514838220,3505791599,1672580301,1672582342,2041
7929,3779036831,3512969370,1672601145,1672604655,3510
7492,3358871377,3613995936,1672679115,1672679770,655
7741,3385763781,3757151210,1672682847,1672683278,431
7779,3418728074,3735733948,1672608614,1672610180,1566
7882,3793753089,3314245084,1672698895,1672701032,2137
7502,3703223015,3711262377,1672669067,1672672583,3516
7841,3772746272,3520190170,1672629694,1672630446,752
7676,3394539273,3287105466,1672598143,1672600479,2336
7652,3778780511,3232962003,1672663183,1672665396,2213
7867,3505477652,3505962865,1672614551,1672615232,681
7751,3430504438,3774268456,1672631385,1672631654,269
7487,3519703355,3304625412,1672575109,1672576555,1446
7827,3481502100,3600647945,1672577940,1672579906,1966
7983,3500066230,3307097200,1672573884,1672575985,2101
7974,3489728806,3280964728,1672540985,1672541450,465
7564,3736229191,3715492942,1672690075,1672690489,414
7975,3904775198,3713644518,1672649837,1672653177,3340
7981,3501606184,3511862351,1672553945,1672556876,2931
7523,3606186086,3429690204,1672677290,1672678703,1413
7864,3514245078,3779036831,1672674734,1672674852,118
7862,3791942683,3826633236,1672542729,1672543035,306
7684,3851190615,3935627557,1672586949,1672589702,2753
7648,3301107849,3303705369,1672532414,1672535091,2677
7898,3688683847,3711571712,1672645501,1672646023,522
7925,3911245524,3534313900,1672657211,1672660007,2796
7681,3701065786,3515284591,1672641240,1672644785,3545
7533,3606812411,3511435497,1672622250,1672625471,3221
7937,3881477378,3369998498,1672692891,1672695113,2222
7674,3311648200,3516960534,1672589983,1672592453,2470
7572,3629547065,3889750851,1672635382,1672636903,1521
7836,3618045231,3517509185,1672622539,1672623101,562
7599,3713786889,3534553510,1672615654,1672618427,2773
7836,3618873142,3710344260,1672703303,1672705039,1736
7751,3737051610,3416265063,1672599013,1672600781,1768
7850,3388372715,3514245078,1672542015,1672543443,1428
7766,3778341199,3800886801,1672646627,1672647348,721
7704,3736625083,3777929708,1672639646,1672639811,165
7525,3739106581,3534010629,1672663328,1672664416,1088
7955,3356860407,3200198928,1672610684,1672610950,266
7733,3916289176,3772309166,1672552799,1672554606,1807
7915,3386707783,3313564074,1672591965,1672594243,2278
7953,3780365428,3666506258,1672571868,1672572969,1101
7862,3912262917,3883085535,1672604083,1672607330,3247
7501,3512683609,3827377568,1672555863,1672556590,727
7615,3512142794,3533810360,1672558222,1672560673,2451
7891,3783126683,3711380716,1672625433,1672625851,418
7516,3505791599,3427219654,1672598511,1672601875,3364
7897,3760492950,3734828619,1672547601,1672548074,473
7812,3757455053,3882242815,1672683065,1672686592,3527
7520,3925402713,3485375593,1672651986,1672655372,3386
7555,3774195321,3773205565,1672550242,1672553771,3529
7830,3703223015,3714488548,1672672203,1672674989,2786
7701,3834257412,3716273414,1672692439,1672694965,2526
7506,3926700506,3792032359,1672614898,1672615409,511
7596,3715974031,3770101921,1672552038,1672552638,600
7951,3518014404,3756451663,1672633857,1672636485,2628
7600,3247428249,3484995752,1672676345,1672677886,1541
7824,3888559320,3701178711,1672616732,1672619794,3062
7799,3518408774,3757602960,1672572339,1672574285,1946
7933,3804870229,3711198793,1672543721,1672546134,2413
7494,3859663348,3432689543,1672627321,1672629752,2431
7660,3511125626,3244389794,1672687638,1672689372,1734
7617,3501483568,3774339795,1672541922,1672543098,1176
7530,3880285638,3755511676,1672630572,1672633908,3336
7906,3312829208,3511841857,1672536294,1672536933,639
7903,3815508790,3703735129,1672584680,1672587084,2404
7979,3416427576,3911245524,1672596888,1672600054,3166
7955,3417587765,3277669002,1672581077,1672581582,505
7572,3770078063,3501692334,1672643208,1672645954,2746
7971,3378686918,3783779671,1672661848,1672662417,569
7501,3388372715,3374559242,1672585130,1672586559,1429
7975,3481647420,3505702787,1672631953,1672632766,813
7945,3496269445,3826633236,1672633784,1672634910,1126
7765,3359910781,3228165483,1672594121,1672595110,989
7733,3774050956,3902278226,1672612858,1672613921,1063
7741,3515125508,3509630174,1672697583,1672700037,2454
7524,3405494240,3533385867,1672633380,1672635680,2300
7904,3505904952,3910886626,1672611821,1672614173,2352
7839,3296471982,3510126867,1672622167,1672622460,293
7924,3303705369,3770101921,1672679792,1672681761,1969
7558,3710408395,3716168623,1672557097,1672558643,1546
7621,3238712269,3505347134,1672667274,1672667997,723
7971,3757151210,3505638204,1672546202,1672547866,1664
7501,3777776687,3714962248,1672573809,1672574848,1039
7879,3685187183,3477649378,1672674828,1672676451,1623
7839,3793338102,3232962003,1672551772,1672552561,789
7912,3485008994,3500487333,1672639286,1672641633,2347
7626,3361230905,3399052055,1672586953,1672588936,1983
7626,3882291183,3793436995,1672594808,1672596692,1884
7713,3519700826,3421127249,1672627899,1672628406,507
7911,3701178711,3383922351,1672701108,1672703660,2552
7517,3400804807,3516980378,1672562222,1672564369,2147
7591,3509907947,3910454786,1672630106,1672633288,3182
7569,3520376528,3513201436,1672566379,1672567827,1448
7855,3373384732,3731419510,1672605897,1672607262,1365
7815,3756966035,3608633356,1672650527,1672652310,1783
7782,3315583351,3605726278,1672694576,1672695027,451
7677,3755587522,3311324983,1672545112,1672547906,2794
7578,3513080274,3770078063,1672559840,1672560930,1090
7518,3733189298,3613995936,1672673562,1672673783,221
7675,3802367797,3505649239,1672576322,1672576883,561
7888,3511125626,3480687894,1672638362,1672638547,185
7959,3931941795,3618873142,1672594154,1672595128,974
7626,3209383861,3344364444,1672623213,1672626281,3068
7524,3734828619,3501759100,1672659624,1672662321,2697
7907,3701534009,3312333615,1672579130,1672580687,1557
7831,3379589402,3500391167,1672646065,1672649655,3590
7706,3791657947,3387966152,1672589208,1672590386,1178
7713,3826759140,3298433163,1672558423,1672560157,1734
7584,3972709319,3791874383,1672600969,1672602937,1968
7816,3500458761,3859663348,1672535302,1672538459,3157
7621,3773755137,3509630174,1672614137,1672614468,331
7634,3792473331,3791942683,1672534197,1672534308,111
7835,3806545488,3701691675,1672646410,1672647260,850
7608,3685818092,3370752401,1672639946,1672640317,371
7742,3518669703,3772309166,1672604452,1672607727,3275
7910,3792902982,3533927138,1672587226,1672588495,1269
7642,3904408902,3815508790,1672651357,1672652082,725
7983,3501483568,3490191091,1672580829,1672582825,1996
7973,3780503655,3515860749,1672608115,1672608657,542
7672,3711973519,3668898102,1672699210,1672701867,2657
7667,3514472925,3885670556,1672631912,1672634873,2961
7558,3770763956,3399433690,1672538301,1672541540,3239
7824,3701863557,3618045231,1672674963,1672677001,2038
7969,3760489031,3770553384,1672560491,1672562499,2008
7913,3776948966,3773120434,1672634708,1672637838,3130
7586,3783705817,3774338212,1672631662,1672633991,2329
7745,3510380060,3388286531,1672682441,1672683224,783
7640,3909238838,3791942683,1672593645,1672595009,1364
7834,3334033993,3428674539,1672689363,1672692354,2991
7970,3516960534,3365830990,1672644415,1672646326,1911
7620,3664170666,3520376528,1672646591,1672648767,2176
7778,3515284591,3777443199,1672608162,1672609508,1346
7651,3417061462,3273500349,1672603338,1672603659,321
7743,3387674757,3760492950,1672544840,1672545847,1007
7929,3311993075,3224058172,1672596116,1672599179,3063
7860,3513956646,3903307060,1672615422,1672616611,1189
7913,3510711755,3512217942,1672624986,1672625090,104
7800,3703223015,3770851318,1672646316,1672648637,2321
7730,3616944364,3244389794,1672663820,1672665644,1824
7508,3783245561,3396285984,1672582005,1672584413,2408
7952,3311152102,3815508790,1672549830,1672552099,2269
7623,3511198618,3342131135,1672681957,1672684551,2594
7494,3533371364,3829232696,1672598064,1672599397,1333
7640,3500487333,3465254146,1672698305,1672698950,645
7981,3711262377,3201848640,1672676696,1672680117,3421
7741,3889750851,3349613093,1672678441,1672680538,2097
7961,3552314511,3701111745,1672599425,1672599546,121
7540,3817621391,3899204805,1672575516,1672575757,241
7867,3816454165,3533242305,1672679088,1672682209,3121
7692,3834257412,3365278081,1672609864,1672613328,3464
7561,3737079798,3918247820,1672606154,1672606273,119
7958,3829232696,3395152943,1672598737,1672600260,1523
7557,3791901535,3774010081,1672539923,1672542469,2546
7776,3801089989,3311208440,1672638441,1672641875,3434
7915,3760509236,3405494240,1672682007,1672682509,502
7871,3773598056,3209048907,1672665028,1672665765,737
7670,3512217942,3374559242,1672565128,1672568108,2980
7576,3234541252,3917278625,1672699807,1672702118,2311
7511,3972364603,3388637594,1672539389,1672542583,3194
7759,3279721246,3277669002,1672618383,1672618571,188
7797,3293695955,3518014636,1672567220,1672569678,2458
7706,3277605882,3505912939,1672571783,1672572093,310
7756,3430074045,3505635228,1672607678,1672607818,140
7944,3710112546,3505098372,1672606102,1672608824,2722
7703,3285400528,3791594391,1672574333,1672577458,3125
7978,3244173074,3301107849,1672578559,1672580338,1779
7722,3313564074,3770078063,1672636464,1672639960,3496
7642,3701111745,3227158514,1672676075,1672678877,2802
7781,3314245084,3358871377,1672692216,1672694767,2551
7682,3883312122,3278365525,1672612368,1672615794,3426
7718,3510244400,3493507965,1672613054,1672614485,1431
7799,3791874383,3736592744,1672639624,1672641421,1797
7644,3319752091,3411618230,1672640755,1672643972,3217
7918,3361230905,3311627628,1672658976,1672661681,2705
7939,3352603894,3512510536,1672630468,1672630735,267
7609,3359239884,3617734118,1672640300,1672640830,530
7910,3550946908,3731106822,1672610905,1672613559,2654
7753,3772746272,3791115967,1672636268,1672638045,1777
7624,3791997875,3703661585,1672555701,1672558143,2442
7519,3493507965,3773120434,1672607324,1672609344,2020
7535,3667680268,3770553384,1672663360,1672664696,1336
7974,3622054816,3701274634,1672605776,1672607395,1619
7830,3505649239,3716197887,1672595082,1672595889,807
7773,3772053179,3510173870,1672568061,1672570842,2781
7831,3760077057,3922337974,1672633761,1672636677,2916
7956,3315583351,3518669703,1672636644,1672638065,1421
7645,3713630656,3772758337,1672679788,1672680819,1031
7920,3303751772,3664517356,1672540770,1672541074,304
7655,3773429448,3780503655,1672558822,1672561796,2974
7523,3713894336,3505477652,1672595299,1672598567,3268
7903,3774127586,3345207877,1672538070,1672538644,574
7902,3711262377,3378436155,1672571508,1672572932,1424
7590,3791874383,3348261553,1672562217,1672563591,1374
7664,3500199935,3517077106,1672674788,1672676747,1959
7823,3501955238,3533280269,1672583031,1672583366,335
7767,3805342762,3247780536,1672563427,1672566432,3005
7954,3713349754,3229665776,1672578628,1672581241,2613
7971,3774050956,3793086311,1672593139,1672595253,2114
7521,3760569731,3779629905,1672694198,1672696989,2791
7525,3370636709,3500894271,1672613734,1672614306,572
7654,3332072298,3735733948,1672614221,1672617223,3002
7739,3311648200,3518360734,1672657421,1672658959,1538
7494,3970117174,3236102733,1672563452,1672563990,538
7618,3298288268,3383661227,1672599509,1672599970,461
7640,3466229085,3833889105,1672558235,1672560473,2238
7945,3373384732,3711262377,1672612145,1672613725,1580
7773,3394330287,3511435497,1672694217,1672696403,2186
7939,3512217942,3424922204,1672625126,1672625908,782
7645,3404384505,3277605882,1672555816,1672556320,504
7974,3883861463,3783779671,1672636803,1672638068,1265
7562,3517077106,3520165601,1672701004,1672703868,2864
7809,3779036831,3898995675,1672584125,1672586576,2451
7619,3417061462,3730517636,1672537904,1672540986,3082
7706,3510173870,3920801189,1672584020,1672587462,3442
7740,3792473331,3518260334,1672590763,1672593898,3135
7890,3278365525,3778305740,1672556346,1672558886,2540
7903,3518163778,3511125626,1672699347,1672699412,65
7727,3772309150,3904408902,1672666585,1672668032,1447
7658,3485375593,3730517636,1672538615,1672540127,1512
7955,3533193862,3294803686,1672565303,1672568796,3493
7860,3390068992,3247815299,1672681066,1672684576,3510
7582,3776066388,3505873261,1672543651,1672546368,2717
7566,3429690204,3760492950,1672549937,1672550411,474
7841,3473562469,3533242305,1672564935,1672565830,895
7492,3505201246,3365942576,1672596195,1672599193,2998
7723,3832902928,3685187183,1672630183,1672632754,2571
7505,3501198706,3346327502,1672695162,1672698458,3296
7581,3664517356,3714821932,1672636897,1672639642,2745
7569,3500177712,3732481297,1672644246,1672646045,1799
7715,3314836094,3922337974,1672561690,1672563291,1601
7662,3922337974,3772714862,1672663994,1672664687,693
7970,3377766165,3922275416,1672620036,1672621702,1666
7854,3773205565,3774127586,1672599475,1672601080,1605
7824,3482405588,3773429448,1672599998,1672601216,1218
7973,3701184889,3510380060,1672670386,1672672098,1712
7657,3791602225,3777623166,1672580730,1672581424,694
7722,3509933351,3791115967,1672532645,1672533719,1074
7489,3319752091,3600647945,1672547004,1672548209,1205
7931,3200691026,3774066725,1672623225,1672623378,153
7485,3505193212,3533369198,1672563428,1672564343,915
7651,3311203656,3418728074,1672612402,1672613091,689
7561,3716273414,3520751702,1672545345,1672548866,3521
7711,3249247700,3509634629,1672557360,1672560444,3084
7938,3356860407,3783245561,1672615708,1672617969,2261
7716,3280599164,3716537575,1672696097,1672697662,1565
7511,3716258994,3756966035,1672669453,1672670516,1063
7515,3713786889,3792253549,1672588207,1672588273,66
7749,3552314511,3805347939,1672633320,1672636486,3166
7813,3365614305,3737079798,1672662403,1672664985,2582
7970,3714474557,3513956646,1672613383,1672615524,2141
7650,3533095755,3701967560,1672690378,1672693824,3446
7974,3229058858,3429856982,1672565346,1672565834,488
7713,3793470489,3777443199,1672596320,1672598046,1726
7889,3911159965,3600647945,1672613263,1672616100,2837
7837,3703955926,3278365525,1672599364,1672601549,2185
7734,3936227020,3485823740,1672676669,1672677389,720
7676,3756021689,3777936328,1672683607,1672685505,1898
7952,3407954858,3518791447,1672672277,1672674832,2555
7600,3516039895,3492478793,1672686162,1672688747,2585
7809,3520709480,3533242305,1672582781,1672584551,1770
7837,3505000737,3505201246,1672548360,1672550973,2613
7544,3365942576,3404384505,1672683445,1672684219,774
7799,3311203656,3772359096,1672646453,1672649150,2697
7655,3614238812,3206254161,1672650732,1672653296,2564
7511,3780914982,3760598102,1672621211,1672623066,1855
7555,3639847263,3889232789,1672533260,1672533751,491
7512,3851190615,3791602225,1672698884,1672699604,720
7556,3313564074,3780914982,1672639977,1672643066,3089
7774,3453729665,3505635228,1672683595,1672685357,1762
7601,3711973519,3610695419,1672684506,1672685725,1219
7847,3710408395,3490191091,1672556666,1672559756,3090
7908,3829232696,3336742544,1672653687,1672655898,2211
7831,3427219654,3311871871,1672619236,1672619507,271
7809,3418728074,3909238838,1672599635,1672600909,1274
7659,3518408774,3634786711,1672582261,1672583015,754
7784,3774501422,3349613093,1672677063,1672677685,622
7905,3715127362,3490191091,1672675572,1672677105,1533
7859,3792032359,3416265063,1672624053,1672626244,2191
7876,3735733948,3278365525,1672560861,1672563051,2190
7562,3779528381,3978105277,1672573087,1672575894,2807
7874,3778266283,3367902229,1672643576,1672646789,3213
7935,3405494240,3711569060,1672655109,1672658169,3060
7825,3402943525,3774520233,1672637957,1672641442,3485
7855,3534313900,3319752091,1672612976,1672613305,329
7725,3710408395,3505201246,1672579484,1672581173,1689
7706,3221536550,3231056870,1672604466,1672607986,3520
7542,3829764737,3500365158,1672613864,1672616215,2351
7964,3520206212,3311627628,1672559934,1672561414,1480
7953,3514245078,3516011407,1672678477,1672679233,756
7603,3505098372,3760569731,1672557465,1672558098,633
7791,3430352815,3815508790,1672662360,1672665461,3101
7627,3512540951,3501759100,1672681560,1672684611,3051
7485,3777806071,3736419952,1672678352,1672681312,2960
7767,3736790081,3756966035,1672639540,1672641464,1924
7976,3783429780,3430074045,1672566414,1672569137,2723
7846,3711262377,3701967560,1672622852,1672624549,1697
7766,3701274634,3701498253,1672671152,1672671358,206
7791,3773664987,3311993075,1672568393,1672571770,3377
7637,3534702203,3756424865,1672652258,1672654491,2233
7569,3883085535,3206254161,1672581084,1672583979,2895
7978,3378092448,3774127586,1672676579,1672678972,2393
7507,3509672210,3432665384,1672698723,1672702222,3499
7559,3883042241,3883861463,1672545519,1672548763,3244
7719,3224716315,3533095755,1672539510,1672542365,2855
7980,3244389794,3667680268,1672634206,1672635594,1388
7553,3756027749,3516980378,1672690841,1672694019,3178
7628,3519152550,3914290246,1672537666,1672539513,1847
7626,3405494240,3519654779,1672558979,1672562282,3303
7842,3859663348,3792844210,1672554720,1672556565,1845
7683,3500658339,3783206719,1672614547,1672616116,1569
7598,3939952128,3737051610,1672559430,1672562752,3322
7802,3792789881,3516011407,1672679872,1672682467,2595
7844,3714488548,3805519285,1672636107,1672638715,2608
7485,3428964059,3500374658,1672661861,1672662704,843
7820,3791901535,3773755137,1672547119,1672549335,2216
7550,3668005723,3407725581,1672593330,1672594779,1449
7723,3478194807,3501364586,1672574963,1672575205,242
7534,3517963492,3554917400,1672609342,1672609801,459
7755,3407673904,3342131135,1672662810,1672665231,2421
7732,3418728074,3500803339,1672655806,1672658098,2292
7487,3510711755,3773120434,1672546805,1672548722,1917
7787,3500177712,3731419510,1672601812,1672603940,2128
7702,3703718151,3516016437,1672697203,1672698430,1227
7797,3970117174,3534553510,1672590936,1672591108,172
7923,3793871337,3244389794,1672566673,1672567921,1248
7562,3853018906,3304625412,1672532342,1672533477,1135
7525,3629935998,3344364444,1672580676,1672581351,675
7823,3331845324,3336742544,1672572045,1672574506,2461
7900,3711265369,3711569060,1672548660,1672551247,2587
7952,3394330287,3915628728,1672665666,1672666491,825
7977,3206603608,3201432789,1672607169,1672609293,2124
7786,3379589402,3488244966,1672534409,1672536289,1880
7487,3209551760,3303751772,1672571095,1672572175,1080
7621,3430352815,3783705817,1672677920,1672678734,814
7565,3881477378,3738274418,1672634896,1672635065,169
7484,3756930948,3407725581,1672624902,1672625846,944
7708,3512837326,3509453566,1672549237,1672552644,3407
7844,3855424474,3710112546,1672541577,1672543027,1450
7770,3311871871,3616944364,1672605204,1672607530,2326
7962,3901990690,3514987389,1672674215,1672675087,872
7659,3732481297,3792253549,1672649362,1672649725,363
7886,3370636709,3774005526,1672627630,1672629466,1836
7823,3711308224,3465254146,1672568695,1672570742,2047
7693,3505791599,3976633198,1672628722,1672630638,1916
7910,3817316561,3976633198,1672694320,1672695405,1085
7929,3903307060,3501198706,1672703516,1672703577,61
7731,3713894336,3380035798,1672661008,1672662905,1897
7585,3505201246,3514987389,1672639987,1672640593,606
7730,3484995752,3829232696,1672572783,1672573528,745
7520,3711504540,3773950140,1672676203,1672678423,2220
7820,3475251781,3458539365,1672574675,1672578025,3350
7665,3500894271,3622054816,1672674196,1672674985,789
7977,3273500349,3388286531,1672602995,1672604974,1979
7983,3780294829,3475251781,1672638718,1672640409,1691
7867,3855424474,3387966152,1672675925,1672677813,1888
7948,3417061462,3500199935,1672541875,1672544170,2295
7511,3739106581,3898995675,1672566863,1672569452,2589
7489,3936227020,3500904641,1672597646,1672600547,2901
7594,3716900301,3500994774,1672571459,1672572819,1360
7491,3780788622,3972364603,1672587785,1672591279,3494
7884,3667680268,3200691026,1672648264,1672649419,1155
7506,3500894271,3701863557,1672631902,1672632574,672
7690,3396086535,3826633236,1672561397,1672563511,2114
7506,3247780536,3418534998,1672558462,1672559972,1510
7741,3626156564,3600647945,1672646058,1672646806,748
7572,3811694763,3783083229,1672544218,1672544387,169
7484,3791957752,3756453423,1672537414,1672539679,2265
7683,3224716315,3805519285,1672595307,1672596762,1455
7918,3701111745,3606987130,1672632329,1672634066,1737
7888,3291883916,3664517356,1672579753,1672583315,3562
7855,3780974443,3777717988,1672641156,1672644153,2997
7951,3510771358,3505649239,1672540005,1672542790,2785
7682,3494290908,3737154119,1672590329,1672591264,935
7942,3733891182,3533827120,1672576636,1672576940,304
7603,3778980116,3714962248,1672648195,1672650085,1890
7922,3360993964,3516909237,1672681545,1672683089,1544
7765,3737051610,3338367113,1672623110,1672623719,609
7662,3883551721,3793871337,1672580962,1672581928,966
7875,3519654779,3520931254,1672687863,1672688621,758
7705,3510380060,3407725581,1672628255,1672629620,1365
7656,3760183458,3387966152,1672626562,1672629199,2637
7973,3509907947,3688683847,1672613283,1672613447,164
7710,3342131135,3778341199,1672688710,1672689407,697
7490,3389115045,3713208927,1672634352,1672634499,147
7559,3716835696,3519700826,1672655660,1672655756,96
7655,3779036831,3383922351,1672546903,1672550167,3264
7613,3244436890,3244389794,1672695171,1672695897,726
7610,3534492426,3505201246,1672572376,1672575084,2708
7767,3391915886,3533371364,1672693822,1672695472,1650
7841,3273500349,3776338577,1672686531,1672688532,2001
7494,3793959750,3501601840,1672543173,1672546676,3503
7930,3825229501,3391261292,1672531392,1672533110,1718
7597,3757447189,3774204963,1672590809,1672590943,134
7774,3402943525,3811171116,1672641428,1672644194,2766
7603,3776513891,3516673015,1672534607,1672536624,2017
7751,3516011407,3516465662,1672544611,1672544750,139
7541,3774298222,3418534998,1672535346,1672537815,2469
7609,3756027749,3512142794,1672531558,1672532015,457
7939,3773755137,3772884106,1672604848,1672607672,2824
7522,3331845324,3792288302,1672605460,1672606272,812
7513,3756027749,3816454165,1672700550,1672704113,3563
7650,3489728806,3622054816,1672700944,1672701632,688
7662,3783083229,3534424200,1672641716,1672645106,3390
7870,3360506772,3510126867,1672629204,1672630480,1276
7923,3360743849,3222521619,1672685243,1672685367,124
7795,3224058172,3519912874,1672665878,1672668107,2229
7863,3885897503,3932051427,1672624373,1672625502,1129
7911,3501730685,3852595551,1672628014,1672630219,2205
7542,3710112546,3466911760,1672538474,1672540658,2184
7486,3514245078,3627937312,1672676228,1672676616,388
7885,3417970574,3223968713,1672572070,1672574167,2097
7922,3774366875,3519563836,1672569518,1672571529,2011
7924,3668005723,3778305740,1672618258,1672620590,2332
7760,3500458761,3774127586,1672701312,1672704069,2757
7555,3514719601,3232962003,1672562431,1672564284,1853
7902,3394330287,3427219654,1672588151,1672589945,1794
7745,3628819436,3779036831,1672687413,1672688633,1220
7736,3783531004,3703789494,1672569607,1672569792,185
7492,3791997875,3792668962,1672671339,1672674569,3230
7809,3859663348,3701111745,1672561066,1672561831,765
7683,3209383861,3337544549,1672679578,1672682587,3009
7662,3338367113,3424922204,1672657113,1672659657,2544
7725,3351554343,3812176780,1672578124,1672580830,2706
7489,3626156564,3891751546,1672648313,1672649447,1134
7812,3899204805,3533385867,1672690731,1672691517,786
7737,3338703270,3319752091,1672631227,1672632495,1268
7669,3500391167,3500805881,1672619567,1672621760,2193
7708,3703889596,3911245524,1672603311,1672606178,2867
7872,3519912874,3500803339,1672647448,1672648376,928
7795,3311993075,3514472925,1672534660,1672536874,2214
7929,3316173088,3516960534,1672633814,1672635886,2072
7772,3685187183,3421127249,1672650242,1672650514,272
7877,3391261292,3510937904,1672590280,1672591111,831
7760,3550946908,3710569131,1672675341,1672678274,2933
7952,3773814927,3779976989,1672619187,1672622704,3517
7487,3388372715,3737051610,1672543911,1672544890,979
7728,3895562476,3420700674,1672685726,1672686377,651
7694,3755587522,3510937904,1672612457,1672615434,2977
7961,3509933351,3772359096,1672595655,1672598366,2711
7681,3736786443,3773755137,1672692354,1672692560,206
7736,3428006164,3427219654,1672663510,1672664871,1361
7980,3515125508,3930797455,1672559706,1672562546,2840
7887,3885670556,3362000049,1672549321,1672551138,1817
7632,3288764520,3773429448,1672590651,1672591874,1223
7878,3909238838,3418728074,1672696839,1672698887,2048
7979,3606987130,3359910781,1672549506,1672550524,1018
7840,3774119563,3819727225,1672592223,1672592637,414
7496,3505973226,3755392666,1672649720,1672649842,122
7830,3427283336,3713630656,1672579594,1672581050,1456
7503,3451432842,3774338212,1672571787,1672573216,1429
7758,3533827120,3774298222,1672688414,1672689129,715
7933,3818255890,3501692334,1672693269,1672693639,370
7550,3394539273,3505135325,1672540747,1672544051,3304
7687,3756966035,3716746253,1672561950,1672564131,2181
7546,3512349371,3683959482,1672641493,1672643213,1720
7628,3833889105,3482405588,1672597373,1672600841,3468
7684,3857349323,3792384220,1672612379,1672614946,2567
7593,3394539273,3380035798,1672628079,1672628969,890
7545,3385763781,3517459919,1672696912,1672698700,1788
7869,3682061100,3710067113,1672588357,1672589580,1223
7879,3783126683,3621810464,1672636249,1672639467,3218
7522,3710408395,3757812939,1672531678,1672533712,2034
7513,3509604974,3773664987,1672546839,1672548038,1199
7952,3715492942,3516606733,1672669159,1672669250,91
7491,3683959482,3899266183,1672558965,1672559360,395
7819,3466229085,3370636709,1672559773,1672562646,2873
7673,3783509527,3614238812,1672634919,1672635361,442
7684,3716258994,3509672210,1672668279,1672668444,165
7896,3500658339,3346327502,1672606810,1672608151,1341
7675,3516223597,3511687358,1672672468,1672672770,302
7613,3880285638,3710569131,1672586402,1672587671,1269
7972,3774125065,3755943611,1672667508,1672670718,3210
7712,3432689543,3399911573,1672597023,1672598750,1727
7602,3779629905,3316222192,1672642764,1672645905,3141
7535,3379589402,3235635976,1672635309,1672636816,1507
7776,3489545239,3512349371,1672553135,1672555669,2534
7928,3885670556,3234362962,1672686916,1672687482,566
7614,3783509527,3776800213,1672624380,1672624542,162
7878,3501198706,3604539807,1672642703,1672645169,2466
7619,3936227020,3791553060,1672614587,1672615706,1119
7740,3778108318,3774520233,1672545358,1672545962,604
7720,3756021689,3311993075,1672532290,1672532437,147
7681,3501955238,3903009525,1672590129,1672590738,609
7748,3430504438,3888559320,1672664994,1672668330,3336
7511,3606186086,3926700506,1672695463,1672698633,3170
7716,3493507965,3716900301,1672580649,1672583722,3073
7620,3773755137,3601879040,1672557126,1672557245,119
7961,3783245561,3716843669,1672554331,1672555683,1352
7922,3811171116,3805292782,1672547640,1672548619,979
7720,3312333615,3778549126,1672628288,1672628656,368
7583,3516606733,3777455223,1672585635,1672586183,548
7821,3716273414,3512567240,1672692706,1672695812,3106
7774,3315583351,3520165601,1672568974,1672570307,1333
7782,3311154569,3511267139,1672615220,1672615639,419
7830,3465254146,3206603608,1672536186,1672539119,2933
7896,3792883665,3836573197,1672691689,1672692112,423
7570,3515284591,3772309150,1672598187,1672601606,3419
7877,3534702203,3715127362,1672695365,1672698157,2792
7492,3430504438,3515691540,1672687253,1672687740,487
7745,3668005723,3380035798,1672628604,1672630300,1696
7873,3319752091,3492478793,1672694588,1672697719,3131
7975,3430352815,3731419510,1672680739,1672682707,1968
7951,3378686918,3520629279,1672558128,1672558262,134
7970,3774501422,3367029997,1672666651,1672669475,2824
7509,3390068992,3757455053,1672638246,1672639906,1660
7749,3511841857,3517509185,1672625268,1672625521,253
7646,3889232789,3418728074,1672581885,1672582615,730
7855,3319752091,3933210486,1672636915,1672640454,3539
7521,3777443199,3774195321,1672629072,1672629337,265
7934,3716835696,3755042098,1672590639,1672591919,1280
7785,3922275416,3519152550,1672536532,1672536821,289
7965,3710408395,3889750851,1672598685,1672600568,1883
7846,3978105277,3778780511,1672658396,1672660590,2194
7797,3915628728,3513599775,1672596035,1672597663,1628
7528,3826633236,3899204805,1672661856,1672663760,1904
7692,3407673904,3399433690,1672603421,1672603845,424
7741,3778980116,3289061738,1672594630,1672595885,1255
7608,3757151210,3407673904,1672647022,1672649027,2005
7523,3428674539,3756451663,1672537491,1672539537,2046
7525,3825229501,3289061738,1672545201,1672547869,2668
7728,3222521619,3501759100,1672581444,1672584226,2782
7920,3286658957,3552314511,1672577874,1672578028,154
7897,3793338102,3200691026,1672657844,1672658143,299
7855,3534553510,3279721246,1672632931,1672636252,3321
7786,3511841857,3773978034,1672602242,1672605496,3254
7920,3836573197,3209383861,1672589461,1672592384,2923
7802,3505962865,3427283336,1672536288,1672539529,3241
7828,3533095755,3716197887,1672632493,1672632829,336
7638,3516673015,3505219850,1672591591,1672592528,937
7786,3713894336,3912536808,1672672050,1672674249,2199
7641,3489728806,3760183458,1672697265,1672700800,3535
7484,3334033993,3518163778,1672592820,1672593698,878
7818,3360506772,3227457126,1672538173,1672540482,2309
7672,3209027249,3713894336,1672539421,1672542103,2682
7745,3792789881,3287105466,1672660018,1672660857,839
7721,3514719601,3930791338,1672622889,1672624945,2056
7879,3362000049,3432689543,1672626853,1672629656,2803
7538,3774793839,3909238838,1672637245,1672638896,1651
7647,3516514391,3518932404,1672649931,1672652005,2074
7947,3711370563,3855424474,1672626286,1672627885,1599
7605,3220716272,3346795719,1672578138,1672581671,3533
7899,3520376528,3834257412,1672554773,1672556548,1775
7745,3783206719,3483164654,1672586164,1672586945,781
7486,3711370563,3520629279,1672586068,1672586904,836
7973,3776800213,3783126683,1672620776,1672622024,1248
7764,3701146057,3385763781,1672650756,1672652265,1509
7528,3227457126,3978115672,1672617225,1672619291,2066
7853,3611150562,3829232696,1672542423,1672545662,3239
7950,3792902982,3976633198,1672552564,1672552882,318
7870,3636867411,3201848640,1672542318,1672543009,691
7923,3755920131,3418728074,1672629320,1672630968,1648
7605,3730517636,3904775198,1672556811,1672559172,2361
7735,3378686918,3770078063,1672586555,1672588496,1941
7775,3628819436,3774010081,1672605582,1672608921,3339
7618,3703871468,3755625324,1672608868,1672611154,2286
7694,3500578848,3516011407,1672690007,1672691347,1340
7895,3776513891,3777514571,1672620683,1672621426,743
7706,3397418363,3792253549,1672532976,1672534407,1431
7560,3618873142,3715581279,1672639689,1672640704,1015
7701,3791957752,3774501422,1672626654,1672627662,1008
7657,3760183458,3792883665,1672570963,1672574261,3298
7856,3857349323,3607748895,1672607523,1672610205,2682
7777,3315583351,3774127586,1672687055,1672689647,2592
7625,3430352815,3430352815,1672693398,1672695611,2213
7772,3555214688,3756424865,1672554743,1672554878,135
7778,3533095755,3710112546,1672549445,1672550348,903
7603,3277669002,3520190170,1672650371,1672651097,726
7542,3520756859,3516039895,1672618941,1672619187,246
7532,3311152102,3608633356,1672599334,1672599405,71
7744,3757151210,3206603608,1672534646,1672538102,3456
7666,3314836094,3336751428,1672635166,1672635232,66
7815,3774339795,3515394721,1672637373,1672640384,3011
7880,3915628728,3501692334,1672656508,1672657079,571
7716,3374559242,3883042241,1672698516,1672701619,3103
7783,3779976989,3633420270,1672567001,1672568482,1481
7865,3378092448,3510937904,1672649560,1672650636,1076
7871,3815508790,3735733948,1672678598,1672680552,1954
7873,3818255890,3710112546,1672612968,1672614887,1919
7541,3391915121,3703871468,1672548593,1672549637,1044
7961,3276993580,3400804807,1672595701,1672595840,139
7806,3922275416,3793627961,1672682876,1672684053,1177
7528,3610348516,3777079686,1672541112,1672541186,74
7633,3534492426,3505883609,1672551009,1672553445,2436
7761,3792473331,3733189298,1672654813,1672656770,1957
7916,3714197325,3792844210,1672632089,1672634398,2309
7965,3360993964,3244389794,1672590360,1672593241,2881
7805,3311152102,3385763781,1672595547,1672598856,3309
7885,3756021689,3701498253,1672540894,1672543856,2962
7797,3606812411,3701995648,1672606583,1672609402,2819
7588,3774298222,3770635361,1672587351,1672589995,2644
7531,3232962003,3509604974,1672567581,1672570094,2513
7693,3791957752,3828432634,1672677627,1672678257,630
7568,3756623396,3500578848,1672542637,1672544061,1424
7928,3200691026,3517963492,1672540329,1672542904,2575
7601,3501606184,3757602960,1672604607,1672606513,1906
7919,3618873142,3234362962,1672677984,1672680105,2121
7594,3475795792,3774005526,1672679373,1672681703,2330
7860,3515125508,3852391257,1672624623,1672624758,135
7838,3318697153,3774366875,1672672695,1672674161,1466
7636,3364543015,3972364603,1672546977,1672549324,2347
7794,3793436995,3756623396,1672567749,1672570389,2640
7917,3792384220,3510173870,1672686735,1672689168,2433
7748,3783531004,3284832486,1672560173,1672563043,2870
7730,3937224533,3903962771,1672549847,1672550277,430
7548,3713786889,3774005526,1672532015,1672532461,446
7922,3533626375,3512349371,1672695492,1672697284,1792
7891,3774793839,3777455223,1672553488,1672556487,2999
7537,3701498253,3411618230,1672675536,1672676551,1015
7615,3827222533,3493507965,1672584570,1672587529,2959
7675,3533095755,3791997875,1672679990,1672682539,2549
7815,3793470489,3520706195,1672697281,1672699272,1991
7584,3756528686,3533827120,1672573252,1672576692,3440
7662,3316222192,3792883665,1672548769,1672551736,2967
7786,3336751428,3520165601,1672542303,1672544181,1878
7620,3793753089,3301107849,1672655064,1672658341,3277
7865,3711370563,3618045231,1672676825,1672679707,2882
7766,3777936328,3914259449,1672542370,1672542531,161
7910,3533137446,3703871468,1672552240,1672552420,180
7714,3736790081,3296471982,1672642440,1672644993,2553
7770,3685818092,3208844525,1672654794,1672658118,3324
7812,3755625324,3777790718,1672569726,1672572089,2363
7647,3505203158,3360506772,1672604505,1672605298,793
7974,3229058858,3351008918,1672607112,1672608120,1008
7623,3505599848,3918247820,1672649816,1672650317,501
7564,3298288268,3932051427,1672589116,1672591773,2657
7506,3925402713,3223968713,1672592987,1672593751,764
7814,3511332835,3716900301,1672585554,1672587765,2211
7879,3471220483,3827222533,1672702488,1672705865,3377
7592,3832902928,3634786711,1672630418,1672632403,1985
7577,3510380060,3805519285,1672600973,1672601480,507
7627,3490191091,3505904952,1672684237,1672687676,3439
7783,3701534009,3512217942,1672671893,1672675321,3428
7769,3756930948,3344019610,1672570455,1672572789,2334
7831,3505219850,3634995491,1672567578,1672569896,2318
7742,3511435497,3716488385,1672603006,1672603777,771
7687,3520709480,3513454145,1672692309,1672694345,2036
7940,3514987389,3516716179,1672646341,1672648049,1708
7684,3511332835,3475258557,1672554255,1672557808,3553
7527,3703718151,3276993580,1672620983,1672622839,1856
7642,3424922204,3916289176,1672630882,1672633269,2387
7505,3534553510,3883312122,1672591317,1672593262,1945
7792,3466911760,3511125626,1672567538,1672568539,1001
7786,3778266283,3736790081,1672614340,1672617632,3292
7866,3713894336,3518408774,1672703690,1672706256,2566
7701,3714962248,3359910781,1672597251,1672597527,276
7857,3520888296,3776066388,1672703103,1672704513,1410
7893,3783779671,3757455053,1672625589,1672627265,1676
7539,3639847263,3394539273,1672648345,1672650211,1866
7680,3716835696,3516016437,1672680062,1672683445,3383
7561,3713208927,3534424200,1672679262,1672681305,2043
7826,3735319397,3516065852,1672554971,1672558015,3044
7699,3518496488,3533095755,1672649416,1672650189,773
7899,3716835696,3737051610,1672583922,1672585008,1086
7713,3757246925,3500894271,1672699431,1672701163,1732
7704,3481502100,3346327502,1672683616,1672684920,1304
7946,3774501422,3688683847,1672587609,1672589831,2222
7935,3428964059,3311274543,1672636309,1672639451,3142
7682,3774556560,3899266183,1672611827,1672615171,3344
7741,3855000166,3533371364,1672588418,1672591818,3400
7700,3402943525,3519703355,1672594047,1672595573,1526
7608,3783245561,3424922204,1672624088,1672624617,529
7890,3779629905,3703223015,1672590051,1672591303,1252
7804,3774501422,3715339701,1672631777,1672633246,1469
7825,3979339287,3311415018,1672615484,1672617429,1945
7540,3713808837,3520206212,1672546289,1672547973,1684
7878,3731106822,3511841857,1672613342,1672615378,2036
7522,3816454165,3791874383,1672698204,1672698721,517
7723,3773978034,3902278226,1672581755,1672582797,1042
7571,3360743849,3880310724,1672593880,1672596232,2352
7537,3792177074,3534553510,1672589783,1672592592,2809
7636,3516629436,3513164386,1672689822,1672690728,906
7892,3755587522,3492478793,1672584342,1672584450,108
7489,3517864478,3359910781,1672551104,1672552295,1191
7719,3624761861,3773429448,1672549053,1672550253,1200
7522,3421127249,3610695419,1672632089,1672634849,2760
7521,3711198793,3772758337,1672652051,1672653230,1179
7542,3805347939,3922275620,1672563279,1672565851,2572
7873,3711380716,3500904641,1672672767,1672675581,2814
7699,3418728074,3515394721,1672690136,1672690500,364
7805,3714197325,3516039895,1672579533,1672582486,2953
7655,3701274634,3298433163,1672648340,1672649511,1171
7611,3774050956,3485375593,1672703924,1672706972,3048
7551,3505530961,3505649239,1672666709,1672668079,1370
7778,3505530961,3404384505,1672551455,1672552807,1352
7547,3533385867,3885670556,1672674576,1672677070,2494
7805,3501606184,3501486692,1672597802,1672599087,1285
7532,3291227780,3832902928,1672531580,1672531783,203
7804,3710408395,3505201246,1672609626,1672610805,1179
7678,3891751546,3711370563,1672534372,1672537525,3153
7763,3510126867,3421127249,1672551894,1672554059,2165
7776,3488244966,3391915886,1672689113,1672692068,2955
7587,3311152102,3484995752,1672652432,1672655879,3447
7511,3852595551,3701863557,1672687582,1672689700,2118
7865,3668005723,3517459919,1672541597,1672542686,1089
7793,3277669002,3828624701,1672594301,1672597415,3114
7864,3519152550,3276993580,1672554456,1672557272,2816
7567,3701274634,3802367797,1672630595,1672632462,1867
7543,3827222533,3312333615,1672558562,1672560617,2055
7739,3505873261,3703955926,1672659337,1672660506,1169
7567,3289061738,3634340855,1672654801,1672657535,2734
7745,3512510536,3242408357,1672698936,1672700822,1886
7750,3780365428,3773664987,1672611387,1672612731,1344
7791,3351554343,3235287260,1672574153,1672576636,2483
7795,3600647945,3271938399,1672665939,1672667716,1777
7699,3899204805,3501759100,1672560844,1672563841,2997
7736,3780639480,3783531004,1672573861,1672576447,2586
7581,3710112546,3760569731,1672538512,1672539488,976
7598,3509604974,3757161914,1672565729,1672568755,3026
7525,3828365570,3914290246,1672568285,1672570987,2702
7951,3757161914,3701691675,1672659245,1672660109,864
7882,3510380060,3273500349,1672699316,1672700110,794
7795,3634995491,3244436890,1672579762,1672582360,2598
7671,3334033993,3402943525,1672582577,1672584558,1981
7865,3400918687,3285400528,1672557780,1672559813,2033
7885,3760569731,3489962019,1672626222,1672627959,1737
7725,3505477652,3885670556,1672697323,1672698161,838
7888,3384951177,3284832486,1672575117,1672578082,2965
7770,3485823740,3885670556,1672576813,1672576973,160
7610,3783531004,3208844525,1672568054,1672568856,802
7828,3828624701,3417587765,1672548139,1672548770,631
7717,3516065852,3757602960,1672624995,1672627951,2956
7889,3701863557,3925402713,1672591489,1672594555,3066
7960,3713786889,3703661585,1672589946,1672591376,1430
7918,3776066388,3512540951,1672624418,1672627964,3546
7856,3828432634,3774125065,1672563345,1672564531,1186
7952,3512510536,3909331423,1672593543,1672595634,2091
7551,3434642576,3711265369,1672582272,1672585323,3051
7959,3438645253,3500894271,1672610998,1672613701,2703
7561,3607748895,3918056059,1672682527,1672682978,451
7851,3465254146,3912262917,1672564425,1672567587,3162
7922,3304056063,3783509527,1672545457,1672546011,554
7824,3244436890,3629935998,1672589163,1672589970,807
7869,3625274012,3793470489,1672596743,1672598485,1742
7526,3773205565,3311090974,1672585921,1672589355,3434
7976,3307097200,3713349754,1672673059,1672676077,3018
7865,3430074045,3481647420,1672563927,1672565988,2061
7528,3512142794,3500894271,1672698982,1672700909,1927
7604,3420432297,3710408395,1672701757,1672705347,3590
7500,3505859863,3412980697,1672599842,1672600934,1092
7489,3513201436,3882291183,1672642421,1672642670,249
7790,3978115672,3715998609,1672695920,1672698149,2229
7802,3420700674,3515125508,1672537392,1672540252,2860
7668,3772309166,3417970574,1672669477,1672670777,1300
7892,3666506258,3520730271,1672556614,1672557767,1153
7744,3921211276,3780974443,1672632374,1672635302,2928
7566,3732481297,3420700674,1672633719,1672634320,601
7910,3606186086,3792288302,1672532871,1672536449,3578
7523,3755436115,3925402713,1672602044,1672605121,3077
7615,3711198793,3809484172,1672604659,1672605749,1090
7591,3399911573,3760992710,1672588496,1672589507,1011
7886,3284639858,3509604974,1672658801,1672660664,1863
7837,3534492426,3773205565,1672567561,1672567840,279
7657,3815508790,3918247820,1672541596,1672543391,1795
7794,3374559242,3501955238,1672679976,1672683526,3550
7911,3298288268,3613683164,1672680537,1672682833,2296
7720,3344364444,3424922204,1672651693,1672652976,1283
7757,3713969578,3287105466,1672566697,1672567631,934
7684,3505000737,3510173870,1672679231,1672680680,1449
7537,3511862351,3200691026,1672685193,1672687085,1892
7572,3773429448,3396086535,1672664056,1672664799,743
7768,3510703546,3458539365,1672607595,1672609248,1653
7498,3517476351,3454042520,1672689581,1672692011,2430
7707,3234541252,3774580701,1672661745,1672663294,1549
7558,3518408774,3756027749,1672579475,1672580423,948
7550,3228165483,3514838220,1672572360,1672574742,2382
7523,3394330287,3773465237,1672606308,1672608890,2582
7591,3783083229,3500066230,1672703383,1672704823,1440
7757,3711198793,3357483218,1672675282,1672677191,1909
7949,3313564074,3303751772,1672550313,1672552483,2170
7940,3399004969,3688418210,1672639051,1672639798,747
7756,3316222192,3519601612,1672601509,1672604802,3293
7962,3818255890,3390068992,1672625833,1672626387,554
7566,3378092448,3406784491,1672664931,1672665129,198
7897,3451432842,3939952128,1672635648,1672636949,1301
7524,3500894271,3859663348,1672613343,1672614740,1397
7827,3511350608,3475251781,1672685725,1672688309,2584
7486,3516514391,3714197325,1672648767,1672650292,1525
7504,3777455223,3634786711,1672668829,1672669149,320
7966,3634786711,3910886626,1672684876,1672685614,738
7840,3808324264,3432689543,1672639439,1672641345,1906
7562,3770851318,3817621391,1672602896,1672605223,2327
7700,3405494240,3517476351,1672679065,1672681279,2214
7810,3922337974,3247780536,1672673043,1672676487,3444
7684,3510380060,3791553060,1672659158,1672659769,611
7744,3760183458,3611150562,1672543792,1672544862,1070
7582,3277605882,3314836094,1672653853,1672656501,2648
7629,3783531004,3501927421,1672572880,1672573628,748
7534,3918674986,3883042241,1672584472,1672585085,613
7669,3311152102,3773120434,1672644156,1672645278,1122
7540,3780828689,3229665776,1672632595,1672635188,2593
7852,3475396323,3791657947,1672540055,1672541156,1101
7838,3809484172,3510247121,1672702332,1672704306,1974
7968,3610348516,3756623396,1672647064,1672648345,1281
7662,3774366875,3516039895,1672634230,1672635387,1157
7918,3770101921,3500229033,1672699023,1672701252,2229
7654,3387674757,3757403279,1672615022,1672615705,683
7630,3834257412,3711265369,1672684508,1672686629,2121
7508,3757682496,3772642849,1672590156,1672592357,2201
7640,3428006164,3533385867,1672640696,1672640844,148
7508,3332072298,3733189298,1672605070,1672605160,90
7669,3617055293,3303705369,1672591441,1672592799,1358
7891,3755511676,3701967560,1672694374,1672695426,1052
7511,3514283243,3512142794,1672669933,1672672194,2261
7618,3755881905,3685818092,1672554790,1672555070,280
7862,3209048907,3518876135,1672542268,1672545829,3561
7554,3221536550,3792288302,1672599869,1672601525,1656
7830,3755587522,3500458761,1672626036,1672628453,2417
7678,3627937312,3710112546,1672668202,1672671746,3544
7687,3515691540,3448855696,1672636773,1672639648,2875
7883,3756623396,3500199935,1672679078,1672679341,263
7620,3757562897,3715581279,1672576153,1672576447,294
7937,3496269445,3311627628,1672677546,1672679853,2307
7919,3882997884,3518260334,1672698217,1672700490,2273
7890,3316173088,3816454165,1672701499,1672704615,3116
7594,3903962771,3505869747,1672676183,1672678177,1994
7976,3509352754,3518791447,1672632093,1672635123,3030
7695,3755881905,3454042520,1672625197,1672627672,2475
7514,3478194807,3345207877,1672650671,1672651169,498
7778,3234362962,3883042241,1672698390,1672699004,614
7859,3280615985,3242408357,1672575542,1672577005,1463
7529,3515691540,3313564074,1672535054,1672537460,2406
7919,3755587522,3221536550,1672661191,1672664232,3041
7853,3772053179,3779740455,1672540843,1672543354,2511
7897,3972709319,3793962300,1672688136,1672689064,928
7962,3910454786,3710112546,1672573434,1672576351,2917
7800,3533270638,3736786443,1672675796,1672679320,3524
7723,3711265369,3716273414,1672535161,1672536868,1707
7941,3534702203,3517721725,1672558337,1672559513,1176
7536,3629935998,3512166013,1672620060,1672620943,883
7862,3516980378,3774005526,1672622633,1672625622,2989
7769,3221899927,3711370563,1672611250,1672614647,3397
7835,3792177074,3316173088,1672582744,1672585941,3197
7864,3421836608,3221899927,1672614393,1672617047,2654
7567,3279721246,3501730685,1672663469,1672664613,1144
7485,3618873142,3755436115,1672583190,1672584370,1180
7751,3828624701,3791115967,1672633027,1672634419,1392
7908,3755436115,3430074045,1672626155,1672628120,1965
7498,3703441914,3534702203,1672574048,1672576706,2658
7829,3715998609,3755587522,1672617823,1672619617,1794
7656,3716900301,3701178711,1672568387,1672569034,647
7893,3883861463,3778980116,1672689190,1672689449,259
7825,3291883916,3710344260,1672533226,1672536222,2996
7681,3738502357,3509453566,1672581774,1672583747,1973
7826,3772309166,3755798867,1672590586,1672593250,2664
7877,3297463265,3501730685,1672552308,1672553819,1511
7790,3805519285,3937224533,1672680244,1672682274,2030
7718,3773598056,3701111745,1672584900,1672586712,1812
7788,3716835696,3459030804,1672552953,1672553061,108
7736,3405494240,3779740455,1672684187,1672684846,659
7621,3367902229,3713208927,1672604480,1672604624,144
7582,3682061100,3666553782,1672567657,1672569773,2116
7738,3634340855,3512349371,1672551064,1672551856,792
7706,3500894271,3822654369,1672608130,1672610730,2600
7719,3483949762,3736625083,1672605750,1672607265,1515
7826,3399535232,3618045231,1672629647,1672630614,967
7559,3772309166,3757682496,1672557623,1672558544,921
7804,3406784491,3388637594,1672582580,1672584658,2078
7489,3509453566,3883551721,1672560774,1672563243,2469
7545,3890149705,3770553384,1672661695,1672664448,2753
7674,3792883665,3828624701,1672538872,1672542315,3443
7520,3428964059,3533242305,1672572801,1672573815,1014
7611,3501198706,3688418210,1672575587,1672577785,2198
7739,3713644518,3273500349,1672656191,1672659607,3416
7753,3839849341,3778305740,1672572115,1672575335,3220
7847,3780503655,3777120536,1672643952,1672645182,1230
7881,3505173328,3288764520,1672617245,1672617333,88
7519,3315583351,3519563836,1672655842,1672657629,1787
7523,3519803045,3221899927,1672678207,1672681549,3342
7598,3774366875,3639847263,1672567280,1672568781,1501
7780,3242408357,3778266283,1672632102,1672633840,1738
7765,3774520233,3304625412,1672697851,1672698260,409
7791,3472130842,3836573197,1672555068,1672555938,870
7907,3500803339,3206593906,1672688179,1672689447,1268
7727,3284832486,3490191091,1672659520,1672660111,591
7543,3515723720,3520751702,1672699604,1672700396,792
7875,3801089989,3378092448,1672555359,1672555535,176
7505,3249247700,3312664885,1672554576,1672554674,98
7677,3715581279,3780609808,1672676397,1672679526,3129
7768,3755872268,3791334389,1672690793,1672692465,1672
7622,3365942576,3520190170,1672577266,1672578399,1133
7574,3473562469,3936227020,1672618258,1672618847,589
7826,3774204963,3247780536,1672702831,1672706407,3576
7970,3828624701,3505873261,1672693564,1672695199,1635
7915,3613683164,3634995491,1672683936,1672684347,411
7587,3757562897,3391915886,1672683161,1672686448,3287
7880,3411618230,3515860749,1672588070,1672591666,3596
7629,3533137446,3701178711,1672638390,1672640740,2350
7756,3291235378,3514245078,1672679444,1672679886,442
7875,3760569731,3407673904,1672632719,1672635010,2291
7649,3910886626,3711370563,1672694976,1672695730,754
7787,3806545488,3516909237,1672629309,1672631775,2466
7578,3271938399,3703871468,1672589809,1672592497,2688
7644,3231056870,3777079686,1672605579,1672608244,2665
7530,3774010081,3331845324,1672568946,1672572049,3103
7931,3605726278,3972709319,1672684229,1672687238,3009
7498,3792473331,3757455053,1672621631,1672622626,995
7797,3912262917,3510173870,1672542425,1672544717,2292
7622,3828365570,3972364603,1672551150,1672553073,1923
7655,3511125626,3500578848,1672655605,1672656830,1225
7832,3496051529,3430352815,1672540685,1672542697,2012
7706,3510126867,3760893269,1672609666,1672612786,3120
7550,3417587765,3336742544,1672599996,1672602262,2266
7561,3757403279,3206593906,1672571429,1672572124,695
7534,3471220483,3510857360,1672651820,1672652244,424
7724,3756453423,3458539365,1672617858,1672619741,1883
7842,3396086535,3703871468,1672656213,1672658726,2513
7637,3378436155,3930791338,1672599616,1672602115,2499
7923,3276640712,3756966035,1672536147,1672537841,1694
7795,3701984666,3505347134,1672688398,1672688737,339
7698,3756451663,3600647945,1672642404,1672642519,115
7779,3710067113,3777477395,1672600622,1672600879,257
7966,3804870229,3512969370,1672588159,1672591444,3285
7622,3975287541,3501601840,1672534076,1672536142,2066
7533,3792473331,3614238812,1672586658,1672590227,3569
7729,3533025282,3888559320,1672649178,1672652094,2916
7589,3772359096,3534424200,1672639637,1672641275,1638
7900,3621497531,3778266283,1672563657,1672564271,614
7594,3618045231,3534191820,1672543669,1672546667,2998
7783,3855937514,3298288268,1672643760,1672644423,663
7864,3473765852,3774520233,1672660200,1672660832,632
7646,3910886626,3780788622,1672577714,1672577885,171
7675,3783206719,3519069599,1672682163,1672684906,2743
7925,3518014636,3234362962,1672640034,1672641714,1680
7865,3500578848,3827222533,1672609161,1672611906,2745
7593,3509453566,3636867411,1672618679,1672618901,222
7891,3407673904,3605726278,1672670307,1672673266,2959
7770,3311154569,3333896808,1672656321,1672659042,2721
7593,3777717988,3516716179,1672581311,1672582842,1531
7518,3500578848,3378686918,1672663643,1672664603,960
7716,3710408395,3791957752,1672571946,1672574683,2737
7537,3500060260,3280964728,1672648796,1672649907,1111
7870,3533927138,3774195321,1672669225,1672671562,2337
7983,3385763781,3783531004,1672632406,1672633057,651
7629,3420700674,3501198706,1672692002,1672692766,764
7787,3667680268,3351008918,1672575524,1672577246,1722
7890,3276993580,3511862351,1672555362,1672557656,2294
7632,3377766165,3511687358,1672550669,1672551605,936
7714,3399535232,3505292701,1672550941,1672552315,1374
7754,3345207877,3221536550,1672617363,1672619858,2495
7760,3932051427,3755587522,1672602043,1672603443,1400
7678,3277939457,3755872268,1672576949,1672577784,835
7490,3344364444,3516039895,1672566778,1672567042,264
7965,3418728074,3331845324,1672622705,1672623270,565
7507,3833889105,3904408902,1672670790,1672673505,2715
7944,3779218771,3925620998,1672560372,1672562318,1946
7707,3552314511,3418534998,1672677100,1672679901,2801
7789,3778549126,3922275416,1672535703,1672538879,3176
7556,3773755137,3925620998,1672588401,1672588469,68
7821,3293695955,3311603601,1672654614,1672657521,2907
7611,3910886626,3783206719,1672678872,1672680640,1768
7891,3685818092,3407725581,1672572092,1672572991,899
7874,3494290908,3755436115,1672545377,1672548585,3208
7532,3421836608,3473562469,1672676629,1672678430,1801
7821,3666507626,3311648200,1672653610,1672656459,2849
7712,3805292782,3348261553,1672670286,1672672682,2396
7925,3505292701,3500177712,1672693842,1672694382,540
7532,3760509236,3533193862,1672640743,1672642941,2198
7879,3344019610,3791553060,1672562421,1672565758,3337
7820,3512217942,3312333615,1672614187,1672616171,1984
7952,3477649378,3772309150,1672532172,1672534702,2530
7586,3859663348,3937224533,1672685292,1672687093,1801
7725,3778780511,3312829208,1672701093,1672701732,639
7489,3473765852,3777623166,1672591247,1672593969,2722
7942,3606812411,3513599775,1672593404,1672594918,1514
7537,3832902928,3710569131,1672568939,1672570523,1584
7653,3420700674,3472130842,1672561078,1672564595,3517
7645,3399052055,3715981584,1672538738,1672540596,1858
7749,3284832486,3515394721,1672670298,1672670398,100
7948,3433804879,3828624701,1672540256,1672542848,2592
7806,3703718151,3770021824,1672658563,1672659982,1419
7725,3360506772,3780828689,1672702454,1672702911,457
7711,3249791738,3688418210,1672531804,1672532759,955
7970,3922275620,3779528381,1672573312,1672573746,434
7783,3339907603,3828365570,1672688966,1672691544,2578
7628,3311845971,3634995491,1672672210,1672674822,2612
7596,3477375368,3533242305,1672702700,1672703216,516
7861,3501955238,3909606423,1672674549,1672676177,1628
7777,3770553384,3351008918,1672576263,1672578155,1892
7699,3615046771,3312333615,1672605332,1672606143,811
7510,3509933351,3774466457,1672605991,1672606143,152
7837,3773205565,3783779671,1672698433,1672699113,680
7918,3628819436,3303751772,1672640162,1672642208,2046
7631,3710067113,3500805881,1672654077,1672656379,2302
7882,3887270940,3400918687,1672558547,1672561706,3159
7679,3519152550,3760598102,1672554440,1672556287,1847
7947,3512567240,3509672210,1672601609,1672603697,2088
7871,3505962865,3760569731,1672600537,1672602668,2131
7560,3505962865,3901877072,1672687834,1672689324,1490
7931,3791020967,3234541252,1672637043,1672639235,2192
7929,3715974031,3703661585,1672625419,1672628868,3449
7960,3914290246,3533280269,1672575867,1672577619,1752
7693,3404384505,3757682496,1672635179,1672636291,1112
7795,3755739653,3501483568,1672533587,1672535107,1520
7674,3399433690,3703718151,1672541351,1672544034,2683
7618,3773814927,3701184889,1672576359,1672577296,937
7652,3517255726,3825229501,1672670258,1672670780,522
7897,3711973519,3509352754,1672550280,1672550758,478
7616,3716488385,3819727225,1672620297,1672621012,715
7604,3756966035,3312829208,1672540242,1672542860,2618
7841,3417061462,3365614305,1672594716,1672597564,2848
7518,3515723720,3901990690,1672687957,1672689594,1637
7958,3711370563,3735733948,1672701584,1672701930,346
7798,3501486692,3396285984,1672686410,1672689274,2864
7808,3516465662,3516258476,1672629447,1672630352,905
7735,3348261553,3361230905,1672613626,1672616229,2603
7738,3518669703,3518360734,1672664202,1672667513,3311
7972,3313541986,3780813786,1672651935,1672653356,1421
7953,3512217942,3760492950,1672557644,1672558119,475
7642,3520751702,3601879040,1672604729,1672608207,3478
7602,3780503655,3505904952,1672695485,1672697650,2165
7607,3757447189,3515860749,1672686846,1672687214,368
7946,3209551760,3817621391,1672635251,1672636202,951
7652,3533242305,3399535232,1672563185,1672566384,3199
7495,3757602960,3703013906,1672662434,1672665232,2798
7674,3337544549,3517255726,1672689709,1672690785,1076
7784,3792253549,3478194807,1672635465,1672638719,3254
7547,3734828619,3515125508,1672591469,1672594422,2953
7552,3500374658,3832902928,1672575483,1672578767,3284
7679,3737051610,3627937312,1672630728,1672633832,3104
7851,3418534998,3760598102,1672623423,1672626395,2972
7858,3509907947,3244436890,1672700998,1672701315,317
7791,3416241005,3277669002,1672678394,1672680236,1842
7856,3509453566,3714821932,1672641775,1672642665,890
7732,3793871337,3534702203,1672697758,1672700589,2831
7703,3351554343,3757151210,1672597308,1672598698,1390
7695,3792844210,3883551721,1672670301,1672673140,2839
7674,3793470489,3533827120,1672543069,1672546114,3045
7786,3773205565,3853018906,1672667189,1672669368,2179
7597,3392121505,3291227780,1672571198,1672571608,410
7725,3716537575,3430074045,1672664802,1672666109,1307
7909,3757602960,3777455223,1672671265,1672672648,1383
7842,3500499542,3976390453,1672549867,1672551415,1548
7691,3755042098,3774005526,1672542344,1672543142,798
7692,3510771358,3472130842,1672551948,1672555302,3354
7688,3855602893,3773465237,1672600518,1672600977,459
7489,3516465662,3805292782,1672670375,1672670866,491
7783,3417587765,3901877072,1672655912,1672656844,932
7823,3500658339,3683766533,1672611445,1672612887,1442
7961,3311208440,3513454145,1672675107,1672677431,2324
7933,3312829208,3405494240,1672549771,1672551801,2030
7524,3520012395,3713894336,1672655967,1672656233,266
7924,3783531004,3511435497,1672696684,1672697485,801
7483,3826633236,3516011407,1672702659,1672703983,1324
7697,3399535232,3510247121,1672547569,1672549390,1821
7663,3533025282,3334033993,1672539354,1672542476,3122
7918,3304056063,3805292782,1672585662,1672586653,991
7570,3519069599,3399052055,1672675253,1672675711,458
7624,3783925755,3822654369,1672649542,1672651280,1738
7761,3475795792,3505135325,1672699476,1672699770,294
7487,3378436155,3780593036,1672656592,1672656726,134
7662,3855937514,3505962865,1672565101,1672567592,2491
7554,3520030713,3505530961,1672693012,1672696119,3107
7626,3783925755,3443698222,1672634327,1672634526,199
7712,3500066230,3756021689,1672656786,1672656938,152
7862,3883861463,3427283336,1672601722,1672602761,1039
7533,3510244400,3352603894,1672545395,1672548126,2731
7833,3514719601,3439023335,1672546277,1672546545,268
7564,3701995648,3774195321,1672678262,1672679003,741
7948,3520206212,3802367797,1672650873,1672653482,2609
7917,3760492950,3342131135,1672537589,1672538298,709
7708,3489217083,3711380716,1672556018,1672559406,3388
7713,3770553384,3774119563,1672692486,1672694740,2254
7544,3247815299,3533385867,1672657775,1672661309,3534
7980,3302626661,3511198618,1672534500,1672534871,371
7541,3887270940,3417061462,1672669498,1672673029,3531
7600,3304056063,3664170666,1672585061,1672587637,2576
7780,3514245078,3277939457,1672668831,1672670043,1212
7859,3622054816,3389115045,1672552267,1672554923,2656
7492,3714504419,3400804807,1672580321,1672581085,764
7773,3509634629,3273500349,1672634525,1672636227,1702
7694,3424922204,3911159965,1672572147,1672574243,2096
7722,3716835696,3244485293,1672682233,1672683873,1640
7701,3770763956,3284832486,1672654229,1672657089,2860
7758,3774005526,3390068992,1672680670,1672681790,1120
7841,3770447408,3715581279,1672619721,1672619892,171
7610,3760489031,3520730271,1672636951,1672640474,3523
7692,3505347134,3420432297,1672636587,1672636918,331
7485,3883861463,3505173328,1672549906,1672550982,1076
7751,3378686918,3783705817,1672603590,1672603873,283
7691,3396086535,3885897503,1672692585,1672695430,2845
7831,3209027249,3701184889,1672567077,1672568601,1524
7864,3777929708,3793436995,1672638556,1672639362,806
7966,3516065852,3780609808,1672550120,1672552593,2473
7681,3512540951,3472130842,1672669714,1672671080,1366
7876,3772337814,3389115045,1672691426,1672691821,395
7782,3346327502,3232962003,1672673176,1672675369,2193
7855,3756528686,3520730271,1672585518,1672585940,422
7726,3501486692,3500066230,1672602638,1672605414,2776
7559,3475258557,3716537575,1672672425,1672675298,2873
7660,3520888296,3311324983,1672645708,1672647851,2143
7587,3826633236,3505869747,1672626983,1672629982,2999
7714,3533270638,3514987389,1672651870,1672654775,2905
7849,3713370078,3804870229,1672591998,1672593474,1476
7546,3772746272,3885670556,1672635945,1672637296,1351
7832,3409474775,3277939457,1672665365,1672668127,2762
7739,3509907947,3358871377,1672681932,1672685299,3367
7714,3519601612,3774010081,1672589973,1672592257,2284
7910,3514245078,3774010081,1672682033,1672682527,494
7773,3430074045,3534492426,1672591106,1672591467,361
7547,3379589402,3783705817,1672629691,1672631643,1952
7554,3505347134,3249791738,1672642988,1672644477,1489
7601,3533025282,3417970574,1672678568,1672682080,3512
7936,3244389794,3519703355,1672537696,1672538367,671
7581,3517509185,3703223015,1672630562,1672633062,2500
7548,3715581279,3387966152,1672655210,1672657296,2086
7714,3780639480,3776800213,1672618306,1672620035,1729
7809,3388637594,3312664885,1672630886,1672633136,2250
7983,3731106822,3613683164,1672674501,1672675535,1034
7733,3755511676,3428006164,1672541275,1672542550,1275
7911,3773465237,3805292782,1672556891,1672559105,2214
7593,3451432842,3501364586,1672539497,1672541205,1708
7692,3851190615,3301107849,1672620952,1672622137,1185
7500,3432665384,3291235378,1672593253,1672596721,3468
7773,3373384732,3509634629,1672553941,1672554405,464
7804,3760561634,3909238838,1672663253,1672663919,666
7701,3604539807,3773429448,1672698455,1672700134,1679
7978,3312829208,3511271692,1672564109,1672564447,338
7636,3835382117,3345207877,1672582589,1672585016,2427
7922,3737079798,3518876135,1672575616,1672577707,2091
7692,3234541252,3716900301,1672541724,1672544209,2485
7885,3432665384,3715981584,1672590519,1672594117,3598
7604,3783705817,3519803045,1672641175,1672641872,697
7614,3613995936,3793436995,1672535390,1672536546,1156
7694,3817621391,3509672210,1672550199,1672551683,1484
7725,3714488548,3388637594,1672610949,1672611545,596
7483,3835382117,3829232696,1672547612,1672550321,2709
7894,3501198706,3227457126,1672639702,1672642130,2428
7694,3242408357,3430504438,1672652793,1672655166,2373
7566,3715974031,3703275621,1672662556,1672663171,615
7770,3311208440,3509672210,1672659795,1672660746,951
7491,3517077106,3792768129,1672700271,1672701741,1470
7815,3496269445,3500365158,1672640214,1672641142,928
7549,3774125065,3291227780,1672631710,1672634087,2377
7613,3206603608,3247428249,1672566670,1672567443,773
7583,3517459919,3311152102,1672610140,1672611136,996
7577,3428674539,3313564074,1672630258,1672632716,2458
7871,3711569060,3772642849,1672596682,1672597436,754
7541,3755392666,3760267716,1672652901,1672654927,2026
7860,3614238812,3466911760,1672691271,1672691495,224
7729,3238712269,3227158514,1672606128,1672608562,2434
7614,3888559320,3711308224,1672599948,1672602714,2766
7946,3509773875,3409474775,1672652626,1672652886,260
7488,3922275416,3500177712,1672546735,1672549004,2269
7981,3737079798,3391261292,1672700446,1672702504,2058
7637,3816853177,3224058172,1672580889,1672584047,3158
7576,3714821932,3829319703,1672602237,1672603600,1363
7765,3701274634,3505649239,1672557813,1672559848,2035
7706,3519700826,3701967560,1672685851,1672686530,679
7500,3505530961,3426325549,1672606115,1672607727,1612
7882,3881477378,3534553510,1672577405,1672579440,2035
7908,3533626375,3388286531,1672702179,1672703198,1019
7756,3518360734,3881477378,1672595154,1672598419,3265
7553,3427283336,3829764737,1672628231,1672630432,2201
7915,3496051529,3510380060,1672661120,1672663972,2852
7527,3370752401,3501184421,1672544964,1672546095,1131
7507,3511271692,3407954858,1672700848,1672701977,1129
7813,3209383861,3826759140,1672629056,1672631466,2410
7969,3731106822,3972709319,1672594366,1672597914,3548
7845,3637008488,3500365158,1672599598,1672600869,1271
7833,3779629905,3394539273,1672552600,1672555860,3260
7502,3774466457,3520190170,1672652589,1672652977,388
7611,3713208927,3209027249,1672559111,1672561059,1948
7620,3511862351,3505173328,1672593448,1672594557,1109
7721,3533827120,3513454145,1672604202,1672604856,654
7596,3770078063,3737079798,1672624659,1672628149,3490
7639,3533748232,3515860749,1672692711,1672692986,275
7905,3922275620,3280599164,1672627948,1672630839,2891
7737,3511841857,3512349371,1672604937,1672606356,1419
7706,3433804879,3731106822,1672681639,1672682921,1282
7733,3618873142,3318697153,1672539083,1672539920,837
7519,3792789881,3880285638,1672606760,1672608486,1726
7538,3783531004,3791942683,1672681280,1672681926,646
7636,3610695419,3480687894,1672542232,1672542495,263
7755,3379256399,3716900301,1672589637,1672592423,2786
7975,3364543015,3716537575,1672603414,1672604035,621
7604,3246596716,3364543015,1672568330,1672569618,1288
7636,3791602225,3511198618,1672688880,1672689651,771
7625,3756451663,3737051610,1672646056,1672648461,2405
7897,3418728074,3778266283,1672569252,1672572440,3188
7574,3465202715,3512510536,1672689525,1672690711,1186
7490,3710098970,3757682496,1672590820,1672592110,1290
7890,3660493209,3311152102,1672641760,1672644111,2351
7713,3736592744,3713208927,1672542849,1672543566,717
7926,3774195321,3774125065,1672646240,1672647119,879
7484,3716165213,3773978034,1672549927,1672552474,2547
7695,3734496778,3489962019,1672639243,1672640250,1007
7893,3757682496,3624312512,1672624610,1672627497,2887
7780,3512969370,3271938399,1672606561,1672609786,3225
7695,3937224533,3280615985,1672560726,1672564114,3388
7822,3912262917,3520183192,1672676934,1672679847,2913
7948,3756021689,3512837326,1672586750,1672587907,1157
7974,3360993964,3703871468,1672540149,1672541326,1177
7647,3389115045,3922275620,1672582666,1672585385,2719
7978,3774010081,3418728074,1672592599,1672592869,270
7508,3511841857,3519556068,1672540088,1672542554,2466
7509,3792032359,3404058699,1672626537,1672627796,1259
7509,3880285638,3201848640,1672586847,1672588684,1837
7651,3312829208,3318166135,1672696829,1672698652,1823
7504,3756966035,3501601840,1672554398,1672555840,1442
7725,3773950140,3918247820,1672548784,1672551514,2730
7493,3487171044,3902278226,1672697114,1672698115,1001
7484,3519152550,3501927421,1672609275,1672610775,1500
7938,3500994774,3773950140,1672635065,1672635357,292
7740,3791901535,3772884106,1672658551,1672660431,1880
7980,3514987389,3826759140,1672583636,1672586911,3275
7503,3467773920,3773120434,1672585786,1672587593,1807
7772,3311627628,3516629436,1672557095,1672557849,754
7944,3714488548,3417970574,1672667767,1672670695,2928
7910,3773950140,3303751772,1672674857,1672676795,1938
7612,3511170269,3232962003,1672678141,1672678791,650
7944,3776338577,3416427576,1672566664,1672570195,3531
7854,3716843669,3701111745,1672638572,1672639732,1160
7809,3615046771,3760183458,1672544060,1672546772,2712
7851,3481502100,3837094550,1672540036,1672541641,1605
7584,3639847263,3918674986,1672538842,1672541588,2746
7754,3360506772,3384240055,1672536260,1672538694,2434
7856,3411618230,3778341199,1672597717,1672600043,2326
7559,3783429780,3616944364,1672599326,1672601581,2255
7835,3404384505,3793436995,1672680875,1672683681,2806
7668,3738502357,3475396323,1672644252,1672644919,667
7868,3756966035,3606186086,1672680578,1672681695,1117
7548,3415546117,3471220483,1672597924,1672601352,3428
7870,3756966035,3448855696,1672541703,1672541767,64
7905,3279721246,3284832486,1672593791,1672594214,423
7694,3773598056,3917088658,1672692760,1672696193,3433
7822,3517864478,3818255890,1672593441,1672594027,586
7517,3501184421,3409474775,1672607223,1672608510,1287
7493,3297463265,3783531004,1672592002,1672592900,898
7867,3519428855,3685187183,1672632420,1672634920,2500
7578,3714474557,3922337974,1672559327,1672560832,1505
7575,3882997884,3608868877,1672597670,1672599110,1440
7858,3757602960,3774195321,1672631939,1672634343,2404
7615,3519152550,3757403279,1672631878,1672634786,2908
7789,3757562897,3666553782,1672652706,1672652814,108
7616,3772746272,3511125626,1672542130,1672544772,2642
7837,3823600322,3314836094,1672681210,1672682498,1288
7949,3624761861,3607178184,1672603467,1672604036,569
7622,3277939457,3367902229,1672589922,1672590579,657
7973,3735733948,3780828689,1672621290,1672623417,2127
7638,3792032359,3882997884,1672598941,1672600650,1709
7752,3792288302,3773950140,1672661297,1672664057,2760
7978,3826760240,3511841857,1672545146,1672548335,3189
7770,3859525941,3519912874,1672556314,1672559573,3259
7562,3404058699,3778266283,1672702281,1672705859,3578
7647,3756966035,3291235378,1672592351,1672595187,2836
7673,3776800213,3816853177,1672682626,1672685170,2544
7636,3910886626,3448855696,1672661923,1672662202,279
7695,3755881905,3487171044,1672556115,1672557797,1682
7626,3475258557,3772337814,1672606454,1672609877,3423
7932,3511350608,3826759140,1672627341,1672628677,1336
7590,3512166013,3201324715,1672688311,1672690013,1702
7509,3356860407,3914290246,1672600438,1672600667,229
7543,3809484172,3780974443,1672665609,1672667422,1813
7794,3909606423,3509773875,1672572258,1672575295,3037
7905,3517459919,3400918687,1672579244,1672582208,2964
7947,3756601594,3293695955,1672629710,1672630905,1195
7978,3703871468,3780813786,1672668692,1672670732,2040
7652,3800353779,3475251781,1672596712,1672597215,503
7656,3349613093,3883312122,1672600397,1672601753,1356
7910,3516960534,3633420270,1672589772,1672590938,1166
7913,3475258557,3359239884,1672615668,1672617463,1795
7517,3909331423,3520888296,1672702748,1672704982,2234
7718,3346327502,3682061100,1672674060,1672677431,3371
7777,3715581279,3777936328,1672669040,1672670413,1373
7949,3899266183,3829764737,1672630133,1672631198,1065
7920,3791334389,3857349323,1672675681,1672677266,1585
7588,3610695419,3280964728,1672632790,1672635169,2379
7723,3812176780,3972709319,1672602848,1672603924,1076
7848,3701184889,3221536550,1672558526,1672559703,1177
7870,3826415738,3520165601,1672674365,1672675387,1022
7979,3511312803,3533193862,1672534642,1672536596,1954
7952,3311718847,3772053179,1672598786,1672599236,450
7982,3777806071,3500894271,1672584777,1672585443,666
7929,3201432789,3791602225,1672648431,1672649012,581
7542,3307097200,3755739653,1672662458,1672665885,3427
7769,3505135325,3458539365,1672637798,1672637954,156
7880,3805292782,3685187183,1672653704,1672654173,469
7532,3783126683,3311439795,1672531782,1672534072,2290
7604,3701691675,3770553384,1672605148,1672606043,895
7606,3819727225,3509933351,1672660007,1672661186,1179
7523,3512720680,3734496778,1672552386,1672554138,1752
7612,3791942683,3703275621,1672560012,1672562404,2392
7864,3760569731,3513956646,1672604714,1672606954,2240
7746,3607178184,3360743849,1672656735,1672657065,330
7627,3703441914,3418728074,1672684510,1672685809,1299
7764,3380035798,3851190615,1672689753,1672692892,3139
7636,3701190899,3608868877,1672543785,1672545666,1881
7941,3311203656,3556951786,1672577897,1672579477,1580
7783,3365830990,3505873261,1672604491,1672605742,1251
7575,3517864478,3770851318,1672533799,1672537060,3261
7762,3365278081,3509907947,1672646870,1672647038,168
7891,3883551721,3533748232,1672558691,1672561417,2726
7894,3756027749,3901877072,1672619343,1672619948,605
7553,3606812411,3770447408,1672633061,1672634460,1399
7508,3701691675,3516629436,1672671812,1672673289,1477
7529,3755739653,3682061100,1672668305,1672670028,1723
7797,3773120434,3287105466,1672657704,1672658966,1262
7889,3311603601,3703441914,1672641204,1672642003,799
7578,3736592744,3610695419,1672533698,1672534240,542
7880,3778108318,3836573197,1672681858,1672684125,2267
7635,3500229033,3855000166,1672631499,1672633617,2118
7654,3291235378,3483949762,1672544771,1672545734,963
7967,3338703270,3227457126,1672674462,1672678058,3596
7547,3774050956,3229058858,1672533117,1672536623,3506
7817,3386707783,3485823740,1672645237,1672645799,562
7935,3289061738,3773814927,1672698604,1672699492,888
7805,3904775198,3779740455,1672619982,1672623214,3232
7939,3311627628,3779976989,1672664053,1672664578,525
7485,3501606184,3206593906,1672597474,1672600457,2983
7627,3421836608,3714504419,1672633190,1672635557,2367
7784,3400918687,3500578848,1672545786,1672548048,2262
7578,3517864478,3514283243,1672632387,1672633203,816
7963,3716746253,3780974443,1672654927,1672657269,2342
7783,3772578994,3880285638,1672687662,1672687822,160
7963,3500060260,3520751702,1672690273,1672692024,1751
7942,3429690204,3628819436,1672656203,1672657431,1228
7760,3883042241,3289061738,1672546270,1672549023,2753
7562,3201324715,3611150562,1672583949,1672587357,3408
7966,3703275621,3809059934,1672624116,1672624759,643
7547,3380035798,3360506772,1672670225,1672670811,586
7590,3711265369,3500365158,1672637236,1672638344,1108
7856,3379589402,3701065786,1672535998,1672536807,809
7494,3291227780,3391261292,1672543433,1672546573,3140
7923,3501486692,3777623166,1672625360,1672625637,277
7958,3733891182,3715998609,1672532472,1672535589,3117
7671,3519428855,3489217083,1672661133,1672663022,1889
7885,3713349754,3518014636,1672531604,1672532171,567
7483,3518408774,3773120434,1672578891,1672579569,678
7710,3505883609,3701146057,1672603801,1672606694,2893
7554,3780593036,3517963492,1672540213,1672540889,676
7925,3792032359,3914290246,1672560038,1672560985,947
7844,3832902928,3399433690,1672558618,1672561378,2760
7601,3711262377,3505962865,1672554484,1672556352,1868
7896,3304056063,3713644518,1672660917,1672661130,213
7756,3805347939,3520751702,1672653470,1672654653,1183
7964,3851190615,3397418363,1672697532,1672699673,2141
7667,3510244400,3533371364,1672592276,1672595861,3585
7549,3400918687,3514719601,1672699981,1672701242,1261
7867,3223789409,3783206719,1672613221,1672613605,384
7514,3701534009,3711198793,1672561737,1672562033,296
7804,3475251781,3387674757,1672682383,1672684730,2347
7904,3510937904,3344364444,1672596799,1672599814,3015
7846,3512142794,3331845324,1672551927,1672554787,2860
7722,3899371911,3713268590,1672644564,1672645534,970
7892,3311603601,3716165213,1672640244,1672642318,2074
7964,3826415738,3822654369,1672702839,1672705238,2399
7574,3405494240,3859663348,1672548855,1672550960,2105
7721,3516065852,3509630174,1672548285,1672550812,2527
7946,3311993075,3318697153,1672541508,1672544562,3054
7872,3500499542,3701691675,1672701444,1672702446,1002
7646,3773814927,3828624701,1672683172,1672685132,1960
7872,3915628728,3774366875,1672579862,1672582049,2187
7902,3515691540,3780294829,1672609823,1672612100,2277
7964,3446948848,3625274012,1672599729,1672602912,3183
7763,3783705817,3933210486,1672543685,1672545157,1472
7714,3755872268,3792177074,1672562625,1672564509,1884
7673,3610348516,3772544062,1672696183,1672697287,1104
7972,3534492426,3857349323,1672662220,1672662396,176
7971,3978105277,3617055293,1672620165,1672622687,2522
7580,3483949762,3604539807,1672551510,1672551692,182
7972,3533025282,3400804807,1672615170,1672615973,803
7691,3800353779,3514472925,1672623303,1672624767,1464
7526,3734828619,3858918246,1672537415,1672540258,2843
7834,3973560347,3634340855,1672659165,1672660666,1501
7947,3701534009,3516673015,1672605153,1672608061,2908
7919,3629935998,3760561634,1672665312,1672667716,2404
7831,3915628728,3405494240,1672580113,1672582775,2662
7740,3505000737,3510126867,1672565488,1672566831,1343
7817,3773978034,3668005723,1672695553,1672698601,3048
7719,3683959482,3432665384,1672640504,1672640646,142
7598,3307097200,3937224533,1672670068,1672670373,305
7905,3314245084,3777443199,1672658182,1672660135,1953
7569,3374559242,3791594391,1672564286,1672565618,1332
7973,3284832486,3760294205,1672595197,1672598293,3096
7684,3416265063,3367902229,1672665575,1672668813,3238
7718,3776513891,3804870229,1672695112,1672697416,2304
7743,3313541986,3713268590,1672693527,1672696974,3447
7515,3800353779,3534488837,1672589106,1672590871,1765
7502,3760598102,3465202715,1672595506,1672596418,912
7805,3611150562,3550946908,1672595476,1672595870,394
7686,3777929708,3533927138,1672682422,1672684132,1710
7559,3777455223,3792253549,1672616547,1672616883,336
7561,3773598056,3432689543,1672670890,1672673464,2574
7674,3783206719,3514719601,1672569115,1672570385,1270
7748,3793286136,3311761694,1672651565,1672651886,321
7749,3972709319,3365942576,1672665181,1672666714,1533
7617,3917278625,3666457294,1672617281,1672620881,3600
7730,3276993580,3509773875,1672562736,1672566158,3422
7918,3459030804,3760267716,1672679073,1672679716,643
7861,3374559242,3779528381,1672663021,1672665217,2196
7483,3247780536,3510244400,1672628489,1672631496,3007
7703,3912262917,3501955238,1672660855,1672661254,399
7578,3318697153,3883042241,1672639436,1672639669,233
7683,3737154119,3714962248,1672577640,1672578213,573
7786,3822654369,3420432297,1672690338,1672690985,647
7513,3512540951,3511359172,1672552364,1672553954,1590
7648,3922337974,3312333615,1672544591,1672544953,362
7770,3505173328,3703789494,1672610287,1672610898,611
7537,3883312122,3505649239,1672540692,1672541301,609
7586,3737154119,3489728806,1672665114,1672665453,339
7526,3903962771,3286658957,1672559798,1672560499,701
7506,3365942576,3516909237,1672638204,1672640979,2775
7680,3319752091,3808324264,1672535180,1672535527,347
7883,3773598056,3792288302,1672667957,1672668880,923
7655,3360993964,3903009525,1672671172,1672672281,1109
7890,3755920131,3760992710,1672688162,1672691567,3405
7707,3311154569,3716273414,1672701139,1672702574,1435
7918,3622054816,3776800213,1672626815,1672628408,1593
7890,3489545239,3773598056,1672610704,1672614089,3385
7574,3209048907,3713630656,1672654582,1672657882,3300
7784,3501601840,3857349323,1672616873,1672620037,3164
7682,3713808837,3629935998,1672637749,1672637942,193
7654,3979339287,3735319397,1672671396,1672674040,2644
7562,3505203158,3505530961,1672688880,1672691001,2121
7583,3772309150,3734737881,1672641188,1672642509,1321
7697,3625274012,3970117174,1672550464,1672552353,1889
7772,3533137446,3901990690,1672683850,1672687297,3447
7965,3482405588,3332072298,1672701769,1672704106,2337
7484,3818255890,3235635976,1672584103,1672586863,2760
7951,3534191820,3500060260,1672670697,1672672935,2238
7484,3664170666,3930797455,1672613350,1672613508,158
7758,3770553384,3610695419,1672620928,1672621190,262
7791,3311627628,3428674539,1672604882,1672607649,2767
7489,3496549058,3666553782,1672541929,1672543649,1720
7520,3779976989,3533369198,1672617315,1672618241,926
7510,3791657947,3607748895,1672541688,1672544509,2821
7601,3770447408,3311627628,1672689959,1672690671,712
7703,3505638204,3505098372,1672551751,1672551937,186
7543,3924549929,3482405588,1672674029,1672675352,1323
7920,3791594391,3819727225,1672531764,1672534822,3058
7672,3223968713,3792253549,1672613447,1672614889,1442
7646,3805519285,3816853177,1672571580,1672574800,3220
7932,3828365570,3311203656,1672617847,1672619447,1600
7567,3311203656,3430352815,1672652006,1672655590,3584
7795,3311274543,3736592744,1672546276,1672548633,2357
7750,3514283243,3392121505,1672623730,1672627316,3586
7878,3533280269,3505883609,1672575544,1672575662,118
7776,3701274634,3904775198,1672654769,1672655538,769
7647,3505219850,3855000166,1672616047,1672617804,1757
7805,3802367797,3370752401,1672588957,1672590393,1436
7582,3780294829,3220716272,1672657172,1672658394,1222
7679,3736592744,3791957752,1672581331,1672581674,343
7860,3209551760,3515151980,1672605709,1672607410,1701
7833,3249791738,3311761694,1672645252,1672645774,522
7597,3232962003,3520376528,1672633462,1672633873,411
7890,3883551721,3311603601,1672637841,1672641239,3398
7721,3606812411,3600647945,1672540575,1672541250,675
7653,3880310724,3666553782,1672594306,1672596739,2433
7594,3271938399,3304056063,1672647684,1672649883,2199
7899,3772337814,3805292782,1672598928,1672599045,117
7666,3209048907,3511267139,1672539173,1672540348,1175
7778,3533810360,3378436155,1672595993,1672597282,1289
7586,3683766533,3791997875,1672641312,1672642944,1632
7963,3883042241,3610348516,1672642108,1672643137,1029
7838,3807987001,3342131135,1672660998,1672661882,884
7850,3701534009,3755511676,1672587614,1672588956,1342
7684,3386707783,3520183192,1672646529,1672648669,2140
7607,3887270940,3615046771,1672672696,1672674986,2290
7962,3520888296,3501184421,1672694157,1672695346,1189
7570,3379256399,3829232696,1672615522,1672615597,75
7701,3629547065,3792768129,1672597001,1672598219,1218
7622,3760509236,3509630174,1672600255,1672603176,2921
7939,3512510536,3783126683,1672556171,1672556828,657
7674,3629935998,3520165601,1672660134,1672660636,502
7894,3773814927,3510126867,1672552364,1672554663,2299
7502,3407725581,3303705369,1672662650,1672663903,1253
7643,3777806071,3318697153,1672664603,1672666947,2344
7498,3500904641,3757161914,1672618468,1672618568,100
7873,3246596716,3412980697,1672652268,1672653705,1437
7610,3777983879,3933210486,1672692265,1672694835,2570
7845,3703735129,3791657947,1672652497,1672653670,1173
7637,3755943611,3779528381,1672676653,1672676858,205
7848,3921211276,3338367113,1672585159,1672588039,2880
7856,3505599848,3534010629,1672691053,1672694405,3352
7487,3780788622,3774005526,1672703063,1672705271,2208
7925,3247815299,3518791447,1672656052,1672658133,2081
7804,3793962300,3930791338,1672570134,1672571082,948
7931,3396285984,3891751546,1672611662,1672611828,166
7792,3370752401,3446948848,1672551995,1672553570,1575
7825,3859525941,3312829208,1672614882,1672616942,2060
7816,3512969370,3439023335,1672611384,1672614049,2665
7693,3778305740,3774204963,1672596132,1672597594,1462
7653,3513080274,3904775198,1672545208,1672547910,2702
7558,3925620998,3772746272,1672696364,1672696577,213
7964,3311090974,3200198928,1672614075,1672614869,794
7628,3417970574,3345207877,1672693593,1672696111,2518
7721,3519703355,3519700826,1672686614,1672688587,1973
7555,3921211276,3885897503,1672589418,1672591241,1823
7517,3201848640,3792844210,1672632023,1672633076,1053
7782,3520706195,3411618230,1672702761,1672703683,922
7696,3509453566,3917278625,1672613671,1672615239,1568
7929,3666553782,3298433163,1672665859,1672667917,2058
7764,3737079798,3859663348,1672681399,1672684243,2844
7677,3516039895,3975287541,1672681462,1672681783,321
7566,3488244966,3800886801,1672577259,1672580675,3416
7725,3475258557,3760489031,1672533516,1672536572,3056
7862,3304625412,3412980697,1672534322,1672536544,2222
7960,3666507626,3772359096,1672697516,1672698986,1470
7851,3500199935,3792288302,1672604480,1672606408,1928
7966,3511267139,3505219850,1672663983,1672666429,2446
7765,3776338577,3311324983,1672547329,1672550045,2716
7820,3500199935,3314836094,1672553336,1672555809,2473
7623,3760183458,3899266183,1672570913,1672573085,2172
7767,3518014404,3793962300,1672594355,1672597740,3385
7901,3311627628,3880285638,1672631490,1672632331,841
7843,3356860407,3388372715,1672657049,1672658711,1662
7951,3732481297,3432689543,1672674775,1672676155,1380
7806,3448855696,3922275416,1672602255,1672602873,618
7614,3336742544,3859525941,1672673785,1672674402,617
7882,3805347939,3466911760,1672577726,1672579512,1786
7745,3451432842,3913251733,1672568557,1672569038,481
7815,3496549058,3713969578,1672622132,1672624785,2653
7604,3711308224,3807987001,1672532359,1672534273,1914
7652,3668005723,3222448362,1672563141,1672564993,1852
7682,3713349754,3827626797,1672670507,1672671507,1000
7916,3755392666,3501184421,1672586210,1672587458,1248
7526,3388372715,3514472925,1672657750,1672660671,2921
7671,3855602893,3533137446,1672599607,1672601575,1968
7509,3399433690,3793871337,1672613285,1672616161,2876
7828,3202120784,3402943525,1672628282,1672631307,3025
7952,3713644518,3779740455,1672658110,1672658852,742
7549,3518876135,3713969578,1672625727,1672626671,944
7803,3770101921,3505638204,1672541672,1672543935,2263
7521,3760492950,3783196518,1672689951,1672690033,82
7819,3227158514,3819727225,1672595067,1672598183,3116
7533,3402943525,3777936328,1672612566,1672615877,3311
7595,3512510536,3516716179,1672655503,1672656431,928
7536,3703661585,3918247820,1672571927,1672572887,960
7725,3736625083,3880310724,1672536989,1672538793,1804
7809,3732481297,3520888296,1672571176,1672571389,213
7982,3701178711,3533095755,1672600493,1672601814,1321
7860,3555214688,3780828689,1672677136,1672677200,64
7519,3622054816,3911245524,1672538821,1672541969,3148
7954,3500458761,3501184421,1672690502,1672694004,3502
7695,3496051529,3829232696,1672667959,1672668294,335
7666,3384240055,3394330287,1672600973,1672602826,1853
7869,3837094550,3301107849,1672573156,1672573665,509
7729,3780593036,3477649378,1672612900,1672616093,3193
7827,3418728074,3505638204,1672615575,1672618441,2866
7492,3617055293,3791334389,1672702610,1672703524,914
7878,3518360734,3930791338,1672565134,1672568266,3132
7637,3311324983,3346327502,1672572484,1672575893,3409
7777,3516629436,3206603608,1672575494,1672578282,2788
7937,3624761861,3770553384,1672639862,1672640331,469
7587,3667680268,3312829208,1672585217,1672588708,3491
7526,3713370078,3333896808,1672670353,1672671270,917
7691,3370636709,3806545488,1672584807,1672585711,904
7912,3755436115,3512142794,1672614397,1672615888,1491
7840,3429690204,3793871337,1672621243,1672624131,2888
7772,3730517636,3910454786,1672642674,1672643336,662
7736,3792384220,3500803339,1672572200,1672574544,2344
7761,3224058172,3625274012,1672536642,1672538779,2137
7780,3493507965,3515723720,1672684612,1672686776,2164
7523,3975287541,3713268590,1672619469,1672622026,2557
7959,3493507965,3206593906,1672539952,1672540416,464
7808,3505973226,3520931254,1672619016,1672621232,2216
7808,3223789409,3925620998,1672648895,1672651135,2240
7950,3778308417,3485823740,1672647442,1672649033,1591
7524,3805347939,3367902229,1672608164,1672609730,1566
7920,3490191091,3883551721,1672699137,1672699461,324
7660,3236102733,3389115045,1672629540,1672631378,1838
7501,3713786889,3756462516,1672675820,1672677569,1749
7492,3710408395,3516960534,1672622127,1672622874,747
7553,3778780511,3910886626,1672685303,1672686031,728
7676,3388637594,3976633198,1672559406,1672560278,872
7711,3813052709,3201848640,1672587650,1672590985,3335
7804,3909238838,3774268456,1672623762,1672624456,694
7708,3513201436,3607748895,1672590510,1672592111,1601
7934,3234541252,3918247820,1672555856,1672556194,338
7711,3312333615,3509907947,1672641374,1672641944,570
7555,3552314511,3617055293,1672588714,1672590752,2038
7815,3512349371,3424922204,1672666710,1672668389,1679
7553,3404058699,3713894336,1672538815,1672542028,3213
7789,3793627961,3777623166,1672602768,1672605931,3163
7605,3510711755,3492478793,1672562819,1672565570,2751
7775,3606186086,3917278625,1672539121,1672540790,1669
7775,3380035798,3485008994,1672681063,1672684381,3318
7601,3500729955,3899371911,1672620516,1672623844,3328
7800,3813052709,3534010629,1672555150,1672556335,1185
7965,3412825109,3774298222,1672571613,1672574368,2755
7654,3802367797,3920801189,1672596439,1672599552,3113
7699,3235635976,3418728074,1672670141,1672673441,3300
7912,3621810464,3360506772,1672636204,1672639313,3109
7734,3735733948,3400918687,1672582249,1672582539,290
7690,3519654779,3736592744,1672700984,1672703193,2209
7559,3911245524,3710344260,1672609233,1672612729,3496
7660,3899371911,3930797455,1672679271,1672680518,1247
7625,3774204963,3634340855,1672620778,1672623627,2849
7919,3505347134,3505869747,1672613048,1672613264,216
7714,3505873261,3201848640,1672581028,1672583891,2863
7497,3378436155,3837094550,1672638752,1672639885,1133
7962,3917088658,3976633198,1672689429,1672691542,2113
7736,3913251733,3779629905,1672639196,1672640702,1506
7708,3459030804,3806545488,1672694608,1672697136,2528
7906,3314836094,3501955238,1672533846,1672536963,3117
7904,3757602960,3291235378,1672615430,1672617577,2147
7877,3935127663,3772746272,1672633573,1672637132,3559
7491,3520730271,3370636709,1672577610,1672578594,984
7533,3911159965,3500805881,1672575570,1672577407,1837
7595,3890149705,3380035798,1672633700,1672633939,239
7652,3365830990,3903962771,1672664504,1672666173,1669
7768,3500391167,3903009525,1672536955,1672537068,113
7491,3735319397,3732481297,1672579911,1672581131,1220
7817,3501759100,3755625324,1672590809,1672593570,2761
7905,3922337974,3271938399,1672548503,1672551671,3168
7908,3519428855,3625274012,1672680677,1672682873,2196
7583,3979339287,3365830990,1672643347,1672644378,1031
7817,3666553782,3390068992,1672564215,1672567441,3226
7728,3485375593,3430352815,1672639168,1672640843,1675
7726,3509453566,3760492950,1672574461,1672577762,3301
7628,3520376528,3360993964,1672652856,1672654855,1999
7772,3711198793,3311761694,1672678870,1672682172,3302
7596,3318697153,3512969370,1672578230,1672581104,2874
7520,3501198706,3610348516,1672565488,1672566799,1311
7935,3777443199,3737051610,1672615577,1672616261,684
7606,3936227020,3756623396,1672584473,1672584824,351
7715,3200691026,3505635228,1672660227,1672662736,2509
7741,3518408774,3533137446,1672573269,1672573763,494
7965,3209048907,3774466457,1672620738,1672623282,2544
7823,3367902229,3930791338,1672584044,1672586535,2491
7874,3505145247,3514283243,1672535074,1672537335,2261
7769,3512166013,3826415738,1672559218,1672562523,3305
7560,3417587765,3505173328,1672597889,1672598777,888
7484,3365278081,3513164386,1672678782,1672680574,1792
7928,3756623396,3757151210,1672665289,1672667830,2541
7656,3426325549,3703889596,1672670011,1672671686,1675
7510,3378436155,3417587765,1672630980,1672632122,1142
7517,3668898102,3512540951,1672570927,1672571567,640
7812,3249247700,3828365570,1672701811,1672703204,1393
7492,3277939457,3284832486,1672581115,1672581714,599
7939,3710408395,3979339287,1672685567,1672687973,2406
7726,3512969370,3703661585,1672667449,1672667956,507
7824,3505702787,3801089989,1672670570,1672671669,1099
7720,3271938399,3730517636,1672697502,1672698876,1374
7762,3805342762,3512142794,1672596793,1672599555,2762
7973,3483949762,3703889596,1672700885,1672703965,3080
7794,3805519285,3618873142,1672701616,1672703378,1762
7562,3701146057,3511359172,1672601831,1672604535,2704
7849,3303705369,3898995675,1672533481,1672533575,94
7664,3514245078,3805347939,1672546126,1672546496,370
7710,3209383861,3935627557,1672588309,1672591051,2742
7706,3401627165,3533371364,1672666649,1672667326,677
7741,3911245524,3783126683,1672539830,1672543276,3446
7763,3711198793,3311203656,1672613342,1672614522,1180
7736,3285400528,3346795719,1672641254,1672644070,2816
7597,3405494240,3311845971,1672686159,1672689089,2930
7845,3367029997,3737154119,1672699550,1672701524,1974
7787,3511350608,3634995491,1672597055,1672599504,2449
7661,3510380060,3922337974,1672575610,1672578148,2538
7870,3716746253,3427283336,1672651286,1672653388,2102
7684,3311993075,3515860749,1672544802,1672546439,1637
7603,3780365428,3500729955,1672564084,1672566191,2107
7943,3235287260,3857349323,1672683556,1672684798,1242
7542,3505145247,3519556068,1672574954,1672578162,3208
7663,3358871377,3688418210,1672553494,1672556308,2814
7620,3336742544,3889750851,1672609829,1672611079,1250
7688,3634786711,3420700674,1672607199,1672610626,3427
7806,3298288268,3778341199,1672652006,1672652607,601
7576,3711569060,3979339287,1672547246,1672549870,2624
7916,3777079686,3834257412,1672653981,1672657192,3211
7826,3889232789,3510594211,1672638926,1672641939,3013
7813,3903009525,3229665776,1672546801,1672547076,275
7734,3402943525,3483949762,1672624323,1672624561,238
7570,3516514391,3716488385,1672606535,1672607377,842
7829,3344019610,3273500349,1672638610,1672640254,1644
7901,3520706195,3520706195,1672535444,1672538717,3273
7885,3249791738,3792253549,1672654513,1672655711,1198
7537,3311845971,3352603894,1672703887,1672704309,422
7597,3811171116,3805342762,1672646785,1672648513,1728
7878,3883085535,3385763781,1672637572,1672639745,2173
7522,3792902982,3826759140,1672703449,1672706074,2625
7629,3246596716,3481647420,1672577035,1672580456,3421
7714,3273500349,3244485293,1672639944,1672641888,1944
7535,3774466457,3886298125,1672553484,1672556299,2815
7740,3516065852,3516258476,1672673846,1672674766,920
7619,3703661585,3777477395,1672607047,1672607933,886
7542,3855000166,3388372715,1672557100,1672559601,2501
7556,3390068992,3710408395,1672653578,1672656155,2577
7821,3311208440,3918247820,1672628604,1672631747,3143
7736,3500060260,3515860749,1672661368,1672663549,2181
7844,3616944364,3883551721,1672698456,1672700569,2113
7496,3755872268,3701995648,1672601883,1672603869,1986
7782,3792902982,3383661227,1672700342,1672700857,515
7910,3501927421,3791115967,1672544913,1672547601,2688
7644,3387966152,3516673015,1672552968,1672556187,3219
7912,3234541252,3512540951,1672661977,1672664289,2312
7892,3516065852,3427283336,1672588098,1672590679,2581
7942,3511841857,3637008488,1672661383,1672664411,3028
7693,3515723720,3360743849,1672637878,1672640530,2652
7950,3889232789,3235287260,1672653677,1672654010,333
7583,3518360734,3518014636,1672583893,1672584198,305
7952,3512510536,3234362962,1672586136,1672589405,3269
7940,3637008488,3520165601,1672638751,1672641124,2373
7488,3756021689,3344019610,1672539692,1672541496,1804
7549,3783239924,3500994774,1672619982,1672621590,1608
7868,3703013906,3774125065,1672625313,1672626847,1534
7654,3514987389,3685187183,1672599800,1672602853,3053
7594,3367029997,3432665384,1672675800,1672677236,1436
7710,3533193862,3713370078,1672572463,1672573176,713
7861,3223968713,3492478793,1672668897,1672670421,1524
7692,3520030713,3770635361,1672644755,1672646919,2164
7914,3228165483,3733189298,1672567711,1672569359,1648
7717,3342131135,3501606184,1672680192,1672680887,695
7722,3514987389,3774466457,1672538345,1672539946,1601
7738,3713349754,3793627961,1672643865,1672646304,2439
7895,3505173328,3917088658,1672635867,1672636043,176
7685,3220716272,3339907603,1672554100,1672555269,1169
7546,3774339795,3511198618,1672661061,1672663270,2209
7615,3427283336,3880310724,1672639239,1672641052,1813
7577,3510711755,3247428249,1672656204,1672658009,1805
7536,3774050956,3770553384,1672575313,1672575567,254
7687,3533369198,3505145247,1672690066,1672693355,3289
7788,3430352815,3505962865,1672533703,1672534308,605
7591,3826633236,3792384220,1672564961,1672566838,1877
7823,3618045231,3500658339,1672566817,1672569728,2911
7755,3917088658,3829232696,1672637740,1672639512,1772
7940,3736592744,3778266283,1672616845,1672618477,1632
7744,3505912939,3614238812,1672659335,1672660345,1010
7623,3778780511,3628819436,1672680457,1672683254,2797
7687,3242408357,3519654779,1672648126,1672649562,1436
7742,3756930948,3396086535,1672624646,1672627944,3298
7865,3936227020,3505702787,1672695874,1672699246,3372
7631,3311154569,3883861463,1672692379,1672692922,543
7863,3777443199,3828365570,1672655716,1672657329,1613
7934,3511350608,3307512479,1672588687,1672591752,3065
7902,3710098970,3520888296,1672597534,1672598085,551
7981,3972709319,3792768129,1672577540,1672580243,2703
7827,3394539273,3760077057,1672700381,1672703760,3379
7931,3735733948,3520730271,1672568145,1672569870,1725
7636,3515691540,3314836094,1672565698,1672568766,3068
7699,3304625412,3701534009,1672551446,1672552227,781
7515,3855602893,3516039895,1672531947,1672532587,640
7576,3756027749,3792883665,1672689552,1672691931,2379
7619,3701898991,3666507626,1672564198,1672567136,2938
7815,3910454786,3660493209,1672681907,1672685154,3247
7661,3307097200,3509907947,1672630982,1672633776,2794
7573,3430352815,3534010629,1672643807,1672645064,1257
7560,3378686918,3520730271,1672584232,1672586260,2028
7923,3770101921,3606186086,1672691403,1672694377,2974
7823,3637008488,3516039895,1672594227,1672594809,582
7740,3516465662,3534702203,1672701132,1672702811,1679
7691,3809059934,3209048907,1672621756,1672621816,60
7977,3667680268,3925620998,1672639979,1672643200,3221
7887,3891751546,3311090974,1672592867,1672593486,619
7668,3367029997,3277939457,1672611367,1672612437,1070
7935,3935627557,3792844210,1672564943,1672565829,886
7949,3978115672,3611150562,1672675262,1672675448,186
7770,3756462516,3760992710,1672656907,1672659502,2595
7587,3608868877,3755625324,1672549418,1672551241,1823
7922,3514987389,3428674539,1672672120,1672674543,2423
7925,3500229033,3774466457,1672548589,1672550649,2060
7563,3362000049,3501601840,1672663583,1672664519,936
7817,3430352815,3755881905,1672596724,1672597769,1045
7942,3501606184,3738502357,1672547663,1672548727,1064
7554,3883042241,3839849341,1672657257,1672657375,118
7529,3307512479,3783531004,1672676130,1672678421,2291
7931,3520706195,3443698222,1672550293,1672553107,2814
7749,3336751428,3516065852,1672628986,1672632009,3023
7668,3715581279,3703275621,1672586919,1672590180,3261
7790,3380035798,3626156564,1672683686,1672684277,591
7952,3667680268,3667680268,1672629730,1672630259,529
7595,3513080274,3791594391,1672590433,1672592697,2264
7525,3407673904,3777477395,1672679389,1672679758,369
7689,3311845971,3978105277,1672689898,1672693325,3427
7595,3772309166,3618045231,1672534183,1672535752,1569
7543,3311993075,3682061100,1672686956,1672689311,2355
7914,3404384505,3518669703,1672643903,1672645251,1348
7772,3344019610,3348261553,1672531862,1672535458,3596
7883,3505599848,3202120784,1672534083,1672534704,621
7671,3885670556,3229665776,1672565493,1672567098,1605
7670,3825229501,3291235378,1672639691,1672641125,1434
7585,3793086311,3501601840,1672537982,1672540486,2504
7656,3520190170,3701984666,1672662607,1672665619,3012
7872,3505135325,3505883609,1672573647,1672575097,1450
7733,3791594391,3505791599,1672701768,1672704702,2934
7513,3511198618,3516016437,1672588892,1672591636,2744
7859,3505859863,3855424474,1672625243,1672626971,1728
7608,3978105277,3520629279,1672667787,1672670772,2985
7526,3202120784,3515125508,1672578953,1672580955,2002
7972,3480687894,3391915121,1672664372,1672667039,2667
7683,3276640712,3500365158,1672701083,1672702240,1157
7681,3911159965,3713786889,1672607975,1672608635,660
7791,3501692334,3773120434,1672687079,1672689103,2024
7670,3734496778,3500177712,1672584815,1672587667,2852
7502,3500578848,3793086311,1672646430,1672648802,2372
7732,3318697153,3400804807,1672531213,1672534613,3400
7936,3476232529,3360993964,1672667403,1672668697,1294
7912,3812176780,3206593906,1672546172,1672546522,350
7785,3816853177,3206603608,1672684502,1672686269,1767
7568,3666553782,3736419952,1672676492,1672676920,428
7618,3779976989,3458539365,1672641314,1672642295,981
7688,3485375593,3778780511,1672604296,1672605763,1467
7796,3229058858,3685187183,1672636033,1672636420,387
7542,3505904952,3713370078,1672558300,1672561441,3141
7907,3227158514,3618873142,1672608167,1672610404,2237
7681,3829764737,3883861463,1672550201,1672553792,3591
7685,3244389794,3430074045,1672637977,1672638749,772
7809,3287105466,3202120784,1672575356,1672578255,2899
7922,3757246925,3488244966,1672619416,1672622557,3141
7621,3777623166,3202120784,1672694901,1672697811,2910
7557,3559110998,3533653428,1672553996,1672554210,214
7965,3714504419,3792253549,1672549041,1672549646,605
7762,3756453423,3451432842,1672623737,1672623984,247
7597,3792844210,3511198618,1672567703,1672571155,3452
7528,3318166135,3791594391,1672540970,1672542576,1606
7945,3978115672,3515151980,1672668982,1672669363,381
7946,3816853177,3534313900,1672649797,1672651480,1683
7972,3471220483,3774520233,1672551474,1672552198,724
7717,3307512479,3314245084,1672698366,1672700627,2261
7802,3774119563,3311648200,1672654236,1672655239,1003
7733,3311152102,3606812411,1672584153,1672587195,3042
7657,3793286136,3833889105,1672576063,1672577143,1080
7842,3628819436,3701967560,1672643522,1672644487,965
7744,3209027249,3780503655,1672646709,1672646958,249
7896,3701178711,3313564074,1672595133,1672595215,82
7848,3500803339,3804870229,1672677087,1672680589,3502
7914,3234541252,3802367797,1672657681,1672658019,338
7727,3501955238,3738502357,1672642526,1672643823,1297
7692,3703718151,3518360734,1672657364,1672660070,2706
7773,3510857360,3280615985,1672604085,1672605731,1646
7489,3883551721,3855424474,1672562079,1672562306,227
7817,3714197325,3783126683,1672658055,1672659814,1759
7498,3511841857,3791901535,1672566064,1672568707,2643
7922,3701498253,3514987389,1672587320,1672588145,825
7831,3501483568,3853018906,1672611572,1672612830,1258
7528,3378436155,3778108318,1672700470,1672700704,234
7596,3607178184,3777776687,1672651701,1672653925,2224
7771,3432689543,3515151980,1672633200,1672633763,563
7485,3701995648,3902278226,1672652091,1672653502,1411
7714,3882242815,3770078063,1672672019,1672675155,3136
7703,3318697153,3401627165,1672699616,1672702973,3357
7495,3791553060,3770851318,1672629416,1672629626,210
7606,3701898991,3512349371,1672620671,1672623239,2568
7586,3509604974,3780813786,1672683424,1672683992,568
7689,3383922351,3791020967,1672547632,1672548589,957
7525,3613683164,3533242305,1672546523,1672546835,312
7554,3716537575,3519601612,1672624992,1672626638,1646
7861,3277669002,3629547065,1672681443,1672683933,2490
7776,3415443558,3411618230,1672611003,1672614059,3056
7770,3783779671,3229058858,1672608366,1672611081,2715
7683,3859525941,3716273414,1672533567,1672534471,904
7571,3757682496,3298433163,1672570854,1672573654,2800
7767,3755798867,3533653428,1672628834,1672632353,3519
7732,3779036831,3805519285,1672552283,1672555587,3304
7896,3383922351,3770447408,1672643957,1672645084,1127
7926,3428006164,3857349323,1672551127,1672551685,558
7718,3703275621,3520376528,1672663090,1672664734,1644
7728,3519601612,3773950140,1672584216,1672586776,2560
7843,3626156564,3715981584,1672624630,1672627160,2530
7762,3713786889,3505173328,1672626657,1672629088,2431
7980,3793389510,3779218771,1672662893,1672666160,3267
7722,3770021824,3439023335,1672582611,1672582846,235
7492,3714488548,3904408902,1672580365,1672581598,1233
7682,3516065852,3501184421,1672611790,1672612756,966
7651,3916289176,3303705369,1672631717,1672632248,531
7973,3774119563,3505791599,1672668693,1672671450,2757
7943,3505962865,3777443199,1672656071,1672657480,1409
7790,3505859863,3418534998,1672628570,1672632169,3599
7546,3510380060,3453729665,1672554585,1672556999,2414
7825,3935127663,3236102733,1672675072,1672676107,1035
7542,3668005723,3773465237,1672555224,1672555689,465
7546,3770763956,3783779671,1672595393,1672596993,1600
7655,3774366875,3792473331,1672571390,1672571635,245
7866,3711198793,3483949762,1672557961,1672561173,3212
7970,3427219654,3715998609,1672676631,1672678098,1467
7959,3715492942,3500365158,1672535905,1672536435,530
7665,3533927138,3505201246,1672567452,1672569694,2242
7708,3365614305,3472130842,1672538361,1672539998,1637
7927,3770447408,3812176780,1672665065,1672665676,611
7497,3755798867,3616944364,1672638205,1672640023,1818
7639,3402943525,3471220483,1672558055,1672561229,3174
7943,3802367797,3356860407,1672569025,1672569363,338
7957,3533137446,3772642849,1672678166,1672680380,2214
7794,3634786711,3756930948,1672608085,1672608854,769
7513,3519803045,3559110998,1672532110,1672532723,613
7883,3935127663,3777806071,1672545100,1672547678,2578
7835,3224058172,3701190899,1672616101,1672617000,899
7739,3859525941,3399911573,1672636150,1672636566,416
7809,3757812939,3703889596,1672620995,1672623622,2627
7925,3488244966,3925620998,1672654996,1672657623,2627
7739,3221536550,3855937514,1672557924,1672560924,3000
7528,3792902982,3826633236,1672669464,1672671037,1573
7670,3242408357,3922275416,1672624197,1672624459,262
7563,3774466457,3738502357,1672614928,1672617017,2089
7588,3291235378,3517963492,1672579725,1672580085,360
7860,3417587765,3487171044,1672619980,1672620802,822
7527,3209048907,3511862351,1672598997,1672599922,925
7877,3710112546,3611150562,1672636947,1672640234,3287
7534,3776800213,3777477395,1672558411,1672559203,792
7700,3505000737,3760489031,1672684541,1672684976,435
7715,3774556560,3318166135,1672566802,1672567995,1193
7901,3621810464,3701178711,1672589777,1672591965,2188
7930,3779976989,3516514391,1672682212,1672684300,2088
7741,3667680268,3484995752,1672545467,1672545795,328
7978,3336751428,3683766533,1672656637,1672658247,1610
7603,3520183192,3756623396,1672548067,1672550240,2173
7755,3505173328,3519700826,1672535163,1672537856,2693
7665,3517864478,3780639480,1672657331,1672658590,1259
7738,3550946908,3338703270,1672600722,1672603826,3104
7715,3711973519,3774005526,1672588909,1672589279,370
7982,3807987001,3336751428,1672653481,1672653907,426
7651,3757682496,3820354437,1672588593,1672590748,2155
7829,3811694763,3634786711,1672559037,1672559588,551
7970,3804870229,3772053179,1672679508,1672682740,3232
7536,3710408395,3811694763,1672639040,1672642485,3445
7765,3247428249,3307512479,1672598991,1672600790,1799
7555,3914290246,3713630656,1672589458,1672591971,2513
7652,3501759100,3311090974,1672544918,1672546116,1198
7711,3505477652,3792789881,1672665725,1672667641,1916
7690,3367902229,3828365570,1672642759,1672642996,237
7703,3791957752,3811171116,1672626755,1672629740,2985
7904,3760294205,3904408902,1672568810,1672572236,3426
7849,3516016437,3418728074,1672685619,1672689211,3592
7638,3428674539,3235287260,1672670709,1672673693,2984
7663,3822654369,3206603608,1672565300,1672568817,3517
7834,3935127663,3736419952,1672640078,1672640726,648
7610,3517476351,3925402713,1672570235,1672572480,2245
7963,3370752401,3756966035,1672536779,1672538018,1239
7939,3534424200,3817316561,1672579294,1672580144,850
7941,3505912939,3617055293,1672642536,1672645718,3182
7958,3711262377,3793086311,1672582834,1672583663,829
7649,3714504419,3760077057,1672567861,1672570311,2450
7492,3206603608,3518408774,1672645195,1672648080,2885
7687,3773755137,3501198706,1672587566,1672588644,1078
7654,3384240055,3516258476,1672619453,1672622401,2948
7636,3500894271,3716273414,1672550689,1672552965,2276
7793,3399535232,3311603601,1672620076,1672623283,3207
7977,3756451663,3917088658,1672606099,1672609666,3567
7541,3880310724,3501198706,1672554393,1672556081,1688
7681,3518408774,3713786889,1672597858,1672601045,3187
7876,3516606733,3235287260,1672593272,1672594503,1231
7705,3882291183,3779740455,1672578068,1672581392,3324
7966,3512969370,3783531004,1672565800,1672568693,2893
7563,3716197887,3774005526,1672642676,1672643638,962
7809,3430352815,3930797455,1672620431,1672622062,1631
7625,3518932404,3510247121,1672576422,1672578340,1918
7527,3773755137,3882291183,1672634312,1672635466,1154
7960,3713808837,3533369198,1672632737,1672635076,2339
7572,3489962019,3774195321,1672639708,1672642039,2331
7634,3809916577,3682061100,1672571755,1672574356,2601
7783,3365830990,3420432297,1672652767,1672656211,3444
7498,3711262377,3606186086,1672636684,1672637248,564
7958,3737154119,3418728074,1672599100,1672601253,2153
7573,3858918246,3505219850,1672575587,1672578208,2621
7565,3500658339,3711569060,1672627587,1672629695,2108
7864,3489217083,3932051427,1672638798,1672641745,2947
7524,3223968713,3533653428,1672684378,1672685526,1148
7608,3827377568,3882997884,1672659450,1672662624,3174
7932,3778341199,3280615985,1672629322,1672632532,3210
7526,3516673015,3505145247,1672580294,1672581337,1043
7971,3510594211,3899204805,1672652889,1672653792,903
7513,3755587522,3757682496,1672566404,1672567464,1060
7766,3201324715,3370636709,1672554018,1672557204,3186
7521,3501486692,3509604974,1672698276,1672699157,881
7746,3791997875,3898995675,1672570131,1672571296,1165
7652,3791334389,3666553782,1672651971,1672652082,111
7584,3534488837,3556951786,1672650688,1672653977,3289
7792,3757682496,3533626375,1672574717,1672576127,1410
7551,3735733948,3510937904,1672631281,1672634476,3195
7721,3756930948,3783779671,1672599463,1672600872,1409
7898,3466911760,3318166135,1672557602,1672558369,767
7620,3534010629,3832902928,1672657064,1672657446,382
7865,3271938399,3365614305,1672610050,1672610957,907
7521,3783429780,3756453423,1672537922,1672538733,811
7950,3509630174,3516223597,1672597748,1672598029,281
7770,3520709480,3792768129,1672648777,1672651501,2724
7893,3510594211,3220716272,1672553889,1672556417,2528
7698,3890149705,3477649378,1672549953,1672552027,2074
7721,3377766165,3519152550,1672598461,1672601385,2924
7866,3518876135,3886298125,1672630936,1672631893,957
7504,3236102733,3402943525,1672687435,1672689124,1689
7507,3826760240,3826633236,1672587363,1672587631,268
7978,3715339701,3852595551,1672657145,1672659413,2268
7812,3783779671,3774339795,1672554216,1672555133,917
7835,3505883609,3430352815,1672684479,1672686628,2149
7485,3415443558,3776513891,1672646899,1672649280,2381
7902,3855937514,3774005526,1672637876,1672641120,3244
7720,3238712269,3793848402,1672573812,1672576992,3180
7632,3511312803,3703889596,1672543874,1672544039,165
7520,3512349371,3418728074,1672670577,1672673352,2775
7491,3380035798,3228165483,1672680165,1672680595,430
7955,3351554343,3510703546,1672574291,1672577075,2784
7594,3236102733,3512349371,1672537007,1672539913,2906
7570,3773814927,3510711755,1672553041,1672554026,985
7735,3201432789,3772544062,1672534410,1672535303,893
7632,3294803686,3412980697,1672701369,1672704719,3350
7838,3703275621,3276640712,1672656535,1672658392,1857
7498,3636867411,3401627165,1672531923,1672533528,1605
7604,3735319397,3311274543,1672540600,1672540914,314
7871,3510244400,3342131135,1672686251,1672689739,3488
7566,3713630656,3930791338,1672616643,1672617061,418
7814,3911159965,3501483568,1672630615,1672631148,533
7928,3512837326,3475396323,1672650028,1672652627,2599
7485,3396086535,3533095755,1672659180,1672662713,3533
7903,3206254161,3914259449,1672621252,1672624150,2898
7619,3757246925,3633420270,1672602646,1672604507,1861
7982,3714197325,3757562897,1672678992,1672681754,2762
7637,3387966152,3627937312,1672608951,1672611783,2832
7499,3311203656,3554917400,1672544910,1672548488,3578
7822,3882242815,3736790081,1672625233,1672626113,880
7887,3509907947,3608633356,1672593179,1672593703,524
7910,3779629905,3489545239,1672635097,1672635449,352
7911,3805347939,3770824086,1672630688,1672631309,621
7811,3510126867,3883312122,1672589335,1672590403,1068
7832,3701967560,3505883609,1672651095,1672654549,3454
7820,3918584946,3757151210,1672640912,1672642970,2058
7832,3774127586,3888559320,1672653194,1672656542,3348
7781,3711380716,3774010081,1672538149,1672538295,146
7922,3512349371,3918584946,1672650820,1672651285,465
7723,3378686918,3520709480,1672548414,1672548711,297
7654,3364543015,3610695419,1672537403,1672540672,3269
7752,3500805881,3487171044,1672554017,1672557309,3292
7615,3311845971,3774520233,1672697113,1672698505,1392
7802,3291235378,3615046771,1672660728,1672664051,3323
7773,3515125508,3777806071,1672562572,1672565207,2635
7487,3931941795,3776066388,1672668712,1672671664,2952
7749,3505962865,3710344260,1672699340,1672700297,957
7556,3855424474,3817316561,1672654016,1672654800,784
7925,3514719601,3338703270,1672654531,1672656011,1480
7797,3372883226,3618045231,1672554425,1672557874,3449
7888,3634995491,3516960534,1672699605,1672701342,1737
7967,3316222192,3533385867,1672620173,1672622214,2041
7486,3772544062,3662180254,1672568216,1672570076,1860
7983,3394539273,3311324983,1672663738,1672666637,2899
7818,3488244966,3475396323,1672663422,1672666943,3521
7785,3227457126,3607748895,1672544546,1672545608,1062
7848,3882242815,3774466457,1672583297,1672586859,3562
7962,3291227780,3926700506,1672581592,1672583621,2029
7845,3714962248,3505292701,1672585452,1672587253,1801
7742,3365942576,3703441914,1672549680,1672552487,2807
7866,3332072298,3925620998,1672638554,1672640472,1918
7840,3615046771,3519601612,1672646190,1672647526,1336
7702,3701691675,3899204805,1672655856,1672658203,2347
7711,3235635976,3736625083,1672702149,1672702316,167
7527,3835382117,3902278226,1672540753,1672542937,2184
7846,3909331423,3778305740,1672627729,1672629361,1632
7559,3505477652,3520206212,1672556755,1672557570,815
7528,3783925755,3716168623,1672631866,1672632513,647
7970,3303751772,3509604974,1672628836,1672631459,2623
7583,3511332835,3533369198,1672592248,1672594252,2004
7878,3223789409,3780914982,1672676617,1672678843,2226
7777,3791594391,3288764520,1672691304,1672693885,2581
7922,3716197887,3739106581,1672652520,1672655950,3430
7964,3800886801,3755943611,1672703003,1672706406,3403
7647,3404058699,3500499542,1672610276,1672611572,1296
7957,3429690204,3505347134,1672534726,1672536951,2225
7566,3339907603,3772309166,1672560277,1672561967,1690
7739,3773120434,3791553060,1672671216,1672674506,3290
7493,3780294829,3505135325,1672693142,1672695931,2789
7864,3791594391,3505477652,1672628134,1672630141,2007
7788,3770851318,3755798867,1672638974,1672641384,2410
7861,3778980116,3223789409,1672623785,1672625738,1953
7734,3473765852,3882997884,1672669565,1672671998,2433
7710,3512720680,3926700506,1672563684,1672566908,3224
7506,3372883226,3760569731,1672600676,1672600970,294
7625,3533626375,3510771358,1672635837,1672638218,2381
7532,3774125065,3505145247,1672698984,1672700279,1295
7747,3618045231,3344019610,1672618280,1672621141,2861
7565,3703889596,3319752091,1672535228,1672537684,2456
7649,3318697153,3429690204,1672597047,1672597957,910
7980,3701898991,3369998498,1672643789,1672645063,1274
7833,3736229191,3792032359,1672540651,1672541666,1015
7742,3360743849,3312664885,1672602417,1672604149,1732
7654,3792844210,3510173870,1672664797,1672667247,2450
7510,3710344260,3505635228,1672637341,1672638850,1509
7928,3451432842,3793436995,1672534885,1672536290,1405
7554,3520183192,3520719611,1672638444,1672639091,647
7836,3760492950,3885670556,1672579801,1672580128,327
7584,3209048907,3244173074,1672632425,1672634358,1933
7759,3899371911,3888559320,1672608249,1672610671,2422
7546,3369998498,3510771358,1672659863,1672660652,789
7591,3284832486,3808324264,1672629620,1672632286,2666
7802,3757455053,3500487333,1672614222,1672614375,153
7643,3774580701,3760893269,1672663550,1672666701,3151
7828,3624312512,3430504438,1672627010,1672629753,2743
7488,3793962300,3898995675,1672580251,1672583524,3273
7577,3406784491,3800353779,1672537308,1672538032,724
7863,3514987389,3757403279,1672694215,1672695579,1364
7519,3388286531,3248507722,1672629387,1672631419,2032
7514,3509352754,3714474557,1672667988,1672670413,2425
7751,3465202715,3500199935,1672666773,1672669809,3036
7484,3783925755,3624761861,1672698130,1672701602,3472
7560,3930797455,3909606423,1672666655,1672668002,1347
7585,3313564074,3496051529,1672676826,1672677329,503
7740,3770763956,3924549929,1672619928,1672620840,912
7904,3829319703,3200691026,1672683044,1672685920,2876
7754,3421836608,3428964059,1672570870,1672574000,3130
7916,3972364603,3617734118,1672703098,1672706198,3100
7710,3917088658,3777514571,1672616020,1672616723,703
7835,3772746272,3826759140,1672549937,1672551838,1901
7581,3517255726,3701178711,1672675386,1672677069,1683
7943,3757812939,3701111745,1672599181,1672602362,3181
7548,3485008994,3634995491,1672650141,1672653535,3394
7624,3780503655,3809484172,1672693644,1672695990,2346
7866,3360506772,3770553384,1672619028,1672621348,2320
7625,3773429448,3519428855,1672536916,1672540149,3233
7713,3903962771,3834257412,1672654334,1672657720,3386
7572,3776513891,3714821932,1672677183,1672679688,2505
7826,3513164386,3880310724,1672700830,1672702255,1425
7488,3501606184,3757403279,1672553376,1672554863,1487
7884,3836573197,3792177074,1672702333,1672704298,1965
7797,3505000737,3515723720,1672617302,1672618512,1210
7966,3459030804,3792902982,1672590691,1672592195,1504
7920,3792473331,3713894336,1672600099,1672601317,1218
7711,3774501422,3755920131,1672584730,1672584865,135
7642,3757161914,3777806071,1672536950,1672537493,543
7763,3500499542,3510937904,1672543568,1672545664,2096
7491,3332072298,3516011407,1672661190,1672662939,1749
7488,3883551721,3402943525,1672674701,1672675099,398
7892,3710112546,3701065786,1672697360,1672697639,279
7882,3509352754,3890149705,1672534457,1672536216,1759
7751,3711973519,3284639858,1672682726,1672682938,212
7775,3756623396,3713630656,1672665312,1672665951,639
7785,3311090974,3902278226,1672690871,1672691098,227
7953,3518791447,3757447189,1672580413,1672580715,302
7633,3480687894,3716746253,1672587155,1672590014,2859
7525,3476232529,3512969370,1672653924,1672654834,910
7623,3910454786,3505869747,1672647355,1672649799,2444
7801,3809484172,3405494240,1672619356,1672620879,1523
7921,3760077057,3510937904,1672569273,1672572798,3525
7653,3512683609,3703955926,1672611490,1672613811,2321
7957,3533748232,3394539273,1672562922,1672565060,2138
7883,3829319703,3509352754,1672606101,1672608790,2689
7566,3235287260,3918674986,1672648715,1672649706,991
7526,3500894271,3715189301,1672640412,1672641563,1151
7668,3201324715,3853018906,1672668525,1672669899,1374
7818,3443698222,3756462516,1672685080,1672687410,2330
7541,3424922204,3827626797,1672677047,1672679029,1982
7977,3783083229,3511163800,1672657825,1672661253,3428
7731,3895562476,3501364586,1672596711,1672597982,1271
7507,3778108318,3490191091,1672568813,1672570356,1543
7889,3805347939,3774050956,1672604271,1672606598,2327
7628,3701065786,3533371364,1672657244,1672657631,387
7604,3770021824,3289061738,1672643792,1672646426,2634
7929,3517509185,3420432297,1672620004,1672623441,3437
7744,3889232789,3496269445,1672674183,1672677558,3375
7678,3772714862,3501483568,1672569867,1672571222,1355
7509,3200198928,3520751702,1672667513,1672668747,1234
7888,3496549058,3426325549,1672597826,1672600662,2836
7619,3887270940,3617055293,1672592192,1672593794,1602
7552,3739106581,3817316561,1672586906,1672590159,3253
7797,3208844525,3910886626,1672606056,1672607504,1448
7692,3331845324,3615046771,1672624343,1672624929,586
7539,3520706195,3519152550,1672545414,1672547691,2277
7847,3662180254,3756528686,1672690365,1672690861,496
7503,3773120434,3475396323,1672580555,1672581971,1416
7571,3231056870,3909238838,1672644404,1672645456,1052
7493,3399535232,3890149705,1672593343,1672594288,945
7788,3711198793,3311845971,1672589304,1672591598,2294
7826,3899266183,3773429448,1672631273,1672632399,1126
7613,3380035798,3715974031,1672558868,1672561480,2612
7867,3511862351,3737154119,1672591009,1672591332,323
7948,3755798867,3369998498,1672641614,1672644989,3375
7811,3424922204,3883312122,1672565015,1672568238,3223
7696,3313564074,3520206212,1672565251,1672566645,1394
7581,3276993580,3625274012,1672542604,1672544475,1871
7543,3500060260,3514472925,1672567293,1672567541,248
7908,3276993580,3835382117,1672553966,1672555149,1183
7959,3485823740,3518496488,1672624995,1672625811,816
7669,3682061100,3500458761,1672537863,1672539200,1337
7948,3737154119,3792032359,1672671734,1672673255,1521
7889,3611150562,3972364603,1672531713,1672532994,1281
7549,3432665384,3315583351,1672701134,1672702683,1549
7820,3601879040,3780788622,1672570373,1672573129,2756
7820,3407673904,3311274543,1672608264,1672609580,1316
7618,3519152550,3367902229,1672666795,1672668901,2106
7728,3783531004,3511359172,1672568634,1672569426,792
7733,3682061100,3518876135,1672664789,1672664880,91
7666,3534424200,3826760240,1672541585,1672541929,344
7680,3757682496,3703735129,1672688475,1672689084,609
7905,3519428855,3714474557,1672683377,1672685987,2610
7881,3774045700,3248507722,1672566716,1672568749,2033
7581,3510126867,3793286136,1672657733,1672659036,1303
7902,3757562897,3777120536,1672669539,1672670980,1441
7882,3791115967,3800886801,1672611350,1672612099,749
7509,3978105277,3424922204,1672634291,1672634746,455
7742,3805342762,3555214688,1672570741,1672571517,776
7783,3776513891,3792844210,1672532855,1672535125,2270
7579,3516716179,3773598056,1672576696,1672577679,983
7688,3518163778,3778108318,1672699895,1672703483,3588
7908,3779976989,3827377568,1672585507,1672586830,1323
7653,3514128943,3911159965,1672562306,1672564288,1982
7967,3829232696,3738274418,1672609277,1672612737,3460
7967,3483949762,3293695955,1672636356,1672639907,3551
7947,3515284591,3760569731,1672629704,1672632052,2348
7946,3883861463,3333896808,1672641180,1672642172,992
7974,3772642849,3852595551,1672535554,1672538503,2949
7702,3391915886,3514245078,1672703310,1672703591,281
7941,3829232696,3922275620,1672601848,1672604424,2576
7747,3703223015,3407673904,1672604212,1672604701,489
7778,3391915121,3606987130,1672641461,1672642787,1326
7693,3770763956,3772642849,1672679228,1672681345,2117
7934,3208844525,3774268456,1672625793,1672626498,705
7852,3613683164,3534488837,1672554166,1672556152,1986
7773,3484995752,3520888296,1672593795,1672594223,428
7962,3500365158,3361230905,1672657150,1672659238,2088
7789,3518876135,3778305740,1672561192,1672564692,3500
7563,3510594211,3833889105,1672650916,1672653298,2382
7675,3713786889,3909606423,1672684218,1672685321,1103
7757,3755872268,3780365428,1672608373,1672609824,1451
7645,3349613093,3760569731,1672678245,1672681663,3418
7613,3311603601,3792473331,1672607213,1672608726,1513
7888,3783245561,3716197887,1672657342,1672657899,557
7831,3515125508,3513080274,1672691293,1672693465,2172
7662,3412825109,3921211276,1672645009,1672648392,3383
7679,3509933351,3517864478,1672580324,1672581696,1372
7862,3511350608,3710408395,1672540094,1672540457,363
7965,3792883665,3755872268,1672541624,1672543390,1766
7950,3760267716,3624312512,1672544234,1672546786,2552
7809,3710112546,3505912939,1672677070,1672680479,3409
7800,3378092448,3760598102,1672663721,1672666600,2879
7719,3773978034,3533626375,1672551779,1672555003,3224
7782,3513599775,3430504438,1672616835,1672620379,3544
7531,3832902928,3533385867,1672702919,1672703733,814
7629,3554917400,3791020967,1672552916,1672554260,1344
7755,3520206212,3346327502,1672612973,1672615294,2321
7909,3500177712,3757682496,1672637620,1672637788,168
7978,3465202715,3779976989,1672613351,1672613478,127
7643,3500066230,3777455223,1672615947,1672616108,161
7659,3430074045,3520888296,1672669198,1672670231,1033
7632,3777623166,3359239884,1672553838,1672556603,2765
7649,3805347939,3520376528,1672566799,1672568469,1670
7502,3518014404,3713808837,1672578929,1672579384,455
7837,3518791447,3344019610,1672652798,1672654293,1495
7947,3664170666,3367902229,1672689511,1672692004,2493
7695,3817621391,3823600322,1672572686,1672575097,2411
7674,3703871468,3394330287,1672666550,1672669367,2817
7591,3400918687,3421836608,1672597926,1672599086,1160
7758,3914290246,3520888296,1672618380,1672620296,1916
7830,3780294829,3311761694,1672572938,1672574865,1927
7975,3458539365,3772309150,1672640647,1672641874,1227
7837,3777776687,3610348516,1672678669,1672680653,1984
7667,3487171044,3757403279,1672643668,1672646105,2437
7870,3514987389,3624312512,1672680119,1672681906,1787
7630,3618045231,3511163800,1672586303,1672586646,343
7578,3236102733,3902383721,1672650606,1672653796,3190
7876,3387674757,3774125065,1672698186,1672699258,1072
7777,3626156564,3519803045,1672593053,1672595818,2765
7726,3793286136,3235287260,1672600436,1672601643,1207
7740,3755587522,3760569731,1672650548,1672651980,1432
7901,3511271692,3780503655,1672669514,1672670367,853
7971,3688418210,3774556560,1672682149,1672684452,2303
7892,3617055293,3613995936,1672618163,1672618801,638
7486,3509907947,3519703355,1672559086,1672561645,2559
7573,3629547065,3430504438,1672566168,1672569590,3422
7722,3829232696,3882242815,1672610554,1672613158,2604
7607,3685187183,3780914982,1672553034,1672555916,2882
7877,3380035798,3774125065,1672687039,1672690418,3379
7691,3510969660,3780639480,1672702883,1672705021,2138
7612,3387966152,3533193862,1672699477,1672702559,3082
7511,3471220483,3716537575,1672583404,1672586078,2674
7647,3917088658,3514987389,1672618244,1672618573,329
7698,3534313900,3291235378,1672605362,1672608071,2709
7539,3505201246,3716843669,1672539085,1672541804,2719
7612,3888559320,3617734118,1672685532,1672688642,3110
7751,3920801189,3917278625,1672641576,1672644481,2905
7878,3701995648,3518163778,1672650352,1672651988,1636
7774,3755625324,3774268456,1672650270,1672652914,2644
7803,3208844525,3307097200,1672569884,1672570779,895
7782,3518014636,3500487333,1672591317,1672593468,2151
7865,3633420270,3813052709,1672551743,1672555331,3588
7887,3488244966,3505873261,1672618098,1672621501,3403
7607,3276993580,3715127362,1672669040,1672671917,2877
7970,3406784491,3801089989,1672615182,1672618431,3249
7866,3500066230,3385763781,1672632462,1672633086,624
7579,3511350608,3501730685,1672625706,1672627308,1602
7625,3774339795,3828432634,1672689502,1672691646,2144
7705,3901877072,3342131135,1672701457,1672703927,2470
7713,3338703270,3307512479,1672598879,1672600430,1551
7921,3378092448,3505135325,1672599994,1672600238,244
7695,3713630656,3500391167,1672646398,1672647299,901
7686,3517255726,3713786889,1672549739,1672552317,2578
7628,3418728074,3813052709,1672638934,1672640111,1177
7888,3688418210,3614238812,1672550627,1672552949,2322
7956,3733891182,3778266283,1672657726,1672657936,210
7549,3291235378,3384240055,1672549132,1672549248,116
7687,3489545239,3701065786,1672544397,1672546767,2370
7941,3533810360,3858918246,1672578468,1672579564,1096
7643,3913251733,3475795792,1672575264,1672577481,2217
7754,3791874383,3757562897,1672695986,1672696259,273
7718,3520888296,3515394721,1672580264,1672580743,479
7513,3485008994,3756021689,1672577708,1672579551,1843
7784,3359910781,3311603601,1672643205,1672643669,464
7880,3249791738,3792032359,1672692184,1672692984,800
7747,3756462516,3887270940,1672638642,1672640971,2329
7870,3511125626,3773120434,1672685848,1672688770,2922
7597,3608868877,3801089989,1672687707,1672688026,319
7884,3512567240,3880310724,1672566588,1672567372,784
7822,3774125065,3625274012,1672699408,1672700045,637
7808,3409474775,3735733948,1672645856,1672649277,3421
7585,3608633356,3792844210,1672675804,1672678826,3022
7640,3979339287,3755625324,1672662084,1672664576,2492
7822,3811694763,3476232529,1672639149,1672640821,1672
7605,3284639858,3500458761,1672586650,1672589682,3032
7608,3859525941,3360506772,1672534962,1672535897,935
7530,3637008488,3832902928,1672607496,1672608124,628
7627,3397418363,3428674539,1672701787,1672702359,572
7980,3465254146,3513080274,1672675727,1672677281,1554
7933,3209027249,3756462516,1672531504,1672535014,3510
7877,3357483218,3472130842,1672703289,1672705901,2612
7700,3909331423,3501927421,1672640145,1672643225,3080
7767,3664170666,3276640712,1672587761,1672588212,451
7669,3610348516,3511687358,1672702921,1672705842,2921
7645,3304056063,3733189298,1672647244,1672648205,961
7817,3416241005,3774520233,1672619015,1672620161,1146
7769,3816853177,3509630174,1672701022,1672703381,2359
7896,3773814927,3780365428,1672607542,1672609402,1860
7770,3311152102,3783531004,1672701737,1672702467,730
7828,3475795792,3559110998,1672575498,1672578612,3114
7585,3701190899,3924549929,1672598263,1672601533,3270
7844,3701984666,3925620998,1672660999,1672663500,2501
7758,3448855696,3685187183,1672660143,1672661660,1517
7902,3316222192,3978105277,1672630891,1672633613,2722
7886,3916289176,3774010081,1672546100,1672546971,871
7591,3514838220,3701178711,1672610338,1672611412,1074
7813,3815508790,3285400528,1672545776,1672549220,3444
7814,3911159965,3820354437,1672619694,1672623016,3322
7938,3427283336,3825229501,1672644324,1672646833,2509
7971,3701898991,3774339795,1672701820,1672703078,1258
7631,3715998609,3611150562,1672603347,1672604672,1325
7816,3516039895,3921211276,1672593924,1672595703,1779
7577,3518791447,3757812939,1672661390,1672663468,2078
7512,3533827120,3703871468,1672609369,1672610685,1316
7612,3899204805,3505000737,1672629178,1672631325,2147
7889,3443698222,3520719611,1672544638,1672545028,390
7967,3935127663,3399433690,1672644721,1672646995,2274
7738,3783779671,3311993075,1672650335,1672652828,2493
7969,3904775198,3484995752,1672674191,1672675456,1265
7621,3780593036,3311603601,1672680115,1672681499,1384
7554,3756462516,3505912939,1672625257,1672626373,1116
7891,3774501422,3517864478,1672671657,1672673932,2275
7503,3307097200,3454042520,1672660849,1672662413,1564
7534,3554917400,3496269445,1672664068,1672665598,1530
7832,3809059934,3772309166,1672670539,1672671851,1312
7931,3703789494,3429690204,1672651183,1672654657,3474
7784,3520376528,3518360734,1672552330,1672555144,2814
7615,3314245084,3914290246,1672639801,1672640852,1051
7770,3518260334,3855424474,1672550358,1672552602,2244
7704,3710569131,3882997884,1672698625,1672699557,932
7961,3288764520,3224716315,1672554263,1672557147,2884
7602,3247780536,3509773875,1672651779,1672655274,3495
7785,3827626797,3780788622,1672601709,1672603634,1925
7636,3837094550,3481647420,1672674253,1672677045,2792
7650,3505193212,3826415738,1672683649,1672685531,1882
7952,3939952128,3391915121,1672621110,1672622753,1643
7932,3793086311,3703789494,1672609748,1672610624,876
7866,3902383721,3505193212,1672564949,1672565356,407
7705,3304625412,3779218771,1672668077,1672668374,297
7609,3701691675,3247428249,1672682397,1672685504,3107
7904,3501483568,3420700674,1672653125,1672655935,2810
7777,3316173088,3533927138,1672534044,1672534150,106
7581,3756453423,3779036831,1672564077,1672566503,2426
7511,3779036831,3516465662,1672687427,1672688821,1394
7633,3716273414,3757246925,1672676476,1672677183,707
7647,3774005526,3820354437,1672541777,1672543891,2114
7873,3505347134,3202120784,1672686886,1672689770,2884
7572,3734496778,3228165483,1672548569,1672551068,2499
7625,3510771358,3791874383,1672537503,1672539899,2396
7978,3489217083,3780788622,1672686936,1672689118,2182
7956,3791594391,3774045700,1672671606,1672673330,1724
7790,3519428855,3774268456,1672555115,1672556801,1686
7525,3429856982,3352603894,1672563594,1672565892,2298
7640,3772758337,3485375593,1672613982,1672617350,3368
7942,3773664987,3755587522,1672640555,1672641583,1028
7898,3200691026,3827377568,1672559627,1672562761,3134
7646,3701967560,3519700826,1672703723,1672707318,3595
7551,3624761861,3346795719,1672654474,1672656966,2492
7662,3298288268,3733189298,1672542975,1672543345,370
7550,3828365570,3621810464,1672584335,1672586642,2307
7747,3711973519,3303705369,1672678564,1672680176,1612
7607,3668898102,3614238812,1672534916,1672535818,902
7664,3601879040,3756027749,1672683297,1672684796,1499
7858,3511163800,3780365428,1672553746,1672557188,3442
7913,3792668962,3778305740,1672613996,1672617381,3385
7957,3772884106,3311871871,1672667971,1672670743,2772
7741,3716843669,3783509527,1672579505,1672581041,1536
7731,3407673904,3660493209,1672576591,1672579379,2788
7731,3430352815,3514987389,1672556293,1672556906,613
7871,3520730271,3735733948,1672609441,1672610337,896
7553,3489545239,3783206719,1672624834,1672627531,2697
7664,3793962300,3314836094,1672657197,1672660254,3057
7505,3518014404,3716900301,1672702882,1672705694,2812
7880,3520931254,3399911573,1672661241,1672664244,3003
7926,3234541252,3202120784,1672688817,1672691519,2702
7765,3898995675,3304625412,1672553031,1672555678,2647
7567,3792668962,3792789881,1672572768,1672573542,774
7591,3738274418,3209048907,1672649691,1672651083,1392
7770,3855424474,3284832486,1672548752,1672551745,2993
7691,3755739653,3510969660,1672571719,1672574960,3241
7762,3713894336,3714821932,1672627814,1672628201,387
7591,3629547065,3400918687,1672654126,1672655868,1742
7749,3378436155,3400918687,1672541662,1672544086,2424
7905,3516465662,3399433690,1672580241,1672582011,1770
7894,3249247700,3667680268,1672643393,1672646516,3123
7678,3298288268,3516258476,1672617283,1672619377,2094
7794,3311439795,3480687894,1672577593,1672580421,2828
7575,3534010629,3331845324,1672700143,1672702817,2674
7565,3505649239,3792789881,1672684789,1672685616,827
7896,3902278226,3792789881,1672599007,1672602001,2994
7548,3779740455,3311993075,1672683665,1672685772,2107
7800,3618045231,3778266283,1672645150,1672648587,3437
7554,3510173870,3519700826,1672691102,1672691791,689
7635,3760561634,3517721725,1672590976,1672591051,75
7599,3475795792,3497901842,1672645264,1672648503,3239
7619,3500487333,3244389794,1672617943,1672618402,459
7676,3518163778,3853018906,1672671427,1672672562,1135
7944,3221536550,3827377568,1672606453,1672607248,795
7873,3792668962,3279721246,1672532697,1672533008,311
7596,3806545488,3780813786,1672662027,1672662130,103
7927,3520629279,3811171116,1672637111,1672640250,3139
7756,3429856982,3793436995,1672567580,1672570685,3105
7855,3501601840,3757151210,1672640180,1672641314,1134
7847,3369998498,3793959750,1672647783,1672650898,3115
7670,3244436890,3792384220,1672641730,1672643523,1793
7568,3512720680,3791602225,1672650502,1672653792,3290
7867,3224716315,3315583351,1672605146,1672606459,1313
7793,3898995675,3512720680,1672609540,1672611914,2374
7967,3780503655,3409474775,1672641958,1672642650,692
7861,3801089989,3895562476,1672586311,1672589554,3243
7912,3737051610,3757246925,1672664938,1672665247,309
7952,3519563836,3902383721,1672561152,1672563203,2051
7938,3247780536,3510711755,1672620520,1672621478,958
7808,3510126867,3777120536,1672692420,1672694622,2202
7503,3505791599,3501759100,1672595897,1672598418,2521
7530,3774204963,3284832486,1672576507,1672578633,2126
7823,3773598056,3757246925,1672674140,1672676352,2212
7866,3360743849,3420700674,1672663415,1672663789,374
7835,3501364586,3505193212,1672587732,1672590981,3249
7516,3909238838,3485375593,1672598565,1672602123,3558
7946,3772714862,3805342762,1672629790,1672629884,94
7699,3513080274,3386707783,1672609718,1672610138,420
7688,3756027749,3615046771,1672607467,1672608468,1001
7487,3505347134,3926700506,1672691331,1672692424,1093
7540,3291227780,3313541986,1672648944,1672650468,1524
7940,3703889596,3621810464,1672532769,1672535673,2904
7753,3770447408,3496051529,1672569284,1672570059,775
7504,3415546117,3201324715,1672699417,1672701982,2565
7893,3921211276,3701178711,1672606012,1672607153,1141
7858,3783126683,3913251733,1672677893,1672678768,875
7754,3930791338,3606186086,1672680874,1672681139,265
7938,3918247820,3372883226,1672674688,1672677422,2734
7654,3505912939,3783206719,1672671019,1672673389,2370
7746,3520629279,3378436155,1672633171,1672635172,2001
7645,3412825109,3883861463,1672547797,1672549172,1375
7855,3520183192,3311761694,1672557048,1672558884,1836
7804,3488244966,3346327502,1672574292,1672575204,912
7871,3500499542,3733891182,1672649975,1672652089,2114
7931,3514245078,3793962300,1672559420,1672561797,2377
7879,3793436995,3229665776,1672636425,1672637890,1465
7850,3703718151,3515125508,1672624576,1672624860,284
7569,3757161914,3716168623,1672666779,1672668448,1669
7895,3773598056,3601879040,1672698711,1672701603,2892
7534,3755739653,3500904641,1672564537,1672565081,544
7849,3489962019,3513599775,1672637851,1672640675,2824
7915,3715581279,3898995675,1672630968,1672633325,2357
7598,3792473331,3209048907,1672695940,1672696824,884
7845,3510126867,3399911573,1672570197,1672573498,3301
7789,3733189298,3911245524,1672550831,1672551374,543
7732,3773429448,3511170269,1672619360,1672619740,380
7787,3556951786,3338703270,1672624458,1672627497,3039
7852,3777079686,3516716179,1672556187,1672559381,3194
7488,3224716315,3481647420,1672699662,1672701205,1543
7586,3378436155,3420700674,1672554919,1672556486,1567
7842,3804870229,3516223597,1672686082,1672687318,1236
7788,3772544062,3737051610,1672623014,1672623114,100
7485,3628819436,3311065516,1672590692,1672592265,1573
7952,3505530961,3779740455,1672643571,1672644827,1256
7760,3511332835,3496269445,1672572201,1672572627,426
7575,3311718847,3805342762,1672597023,1672598498,1475
7823,3627937312,3229665776,1672622351,1672625610,3259
7720,3500994774,3899371911,1672599455,1672602126,2671
7679,3559110998,3512510536,1672595649,1672595833,184
7631,3793753089,3614238812,1672541721,1672542669,948
7586,3397418363,3311627628,1672662114,1672662393,279
7899,3360506772,3386707783,1672668351,1672668833,482
7520,3311415018,3277939457,1672555827,1672556131,304
7942,3533385867,3770101921,1672540164,1672541557,1393
7939,3793959750,3345207877,1672578072,1672580178,2106
7930,3505702787,3777455223,1672576974,1672579856,2882
7630,3510857360,3779036831,1672692252,1672692979,727
7903,3312664885,3667680268,1672542157,1672545394,3237
7957,3518014636,3505477652,1672542709,1672542862,153
7795,3755042098,3930791338,1672666932,1672667845,913
7533,3534424200,3793389510,1672641449,1672643116,1667
7800,3975287541,3311274543,1672588030,1672590980,2950
7916,3809484172,3516065852,1672685540,1672689106,3566
7681,3779740455,3342131135,1672652909,1672654567,1658
7746,3770101921,3473765852,1672561477,1672564447,2970
7925,3516223597,3513454145,1672564892,1672567490,2598
7916,3518496488,3485375593,1672653612,1672655950,2338
7936,3516016437,3513454145,1672683009,1672684351,1342
7814,3606812411,3918674986,1672578946,1672580823,1877
7817,3755739653,3701184889,1672616789,1672619010,2221
7710,3809484172,3777717988,1672674776,1672675537,761
7644,3518408774,3332072298,1672590387,1672593089,2702
7597,3776066388,3519563836,1672662233,1672665085,2852
7505,3711973519,3735319397,1672613771,1672617345,3574
7555,3244485293,3516629436,1672561840,1672563115,1275
7640,3394330287,3555214688,1672596933,1672598745,1812
7796,3716537575,3517721725,1672547509,1672549293,1784
7488,3918584946,3417970574,1672653515,1672655534,2019
7535,3512969370,3519654779,1672608536,1672609520,984
7697,3399911573,3505883609,1672539626,1672540191,565
7641,3902383721,3703735129,1672662448,1672664654,2206
7620,3390068992,3395152943,1672601402,1672601673,271
7709,3857349323,3774005526,1672653706,1672655026,1320
7854,3319752091,3399433690,1672628948,1672629439,491
7745,3793627961,3518932404,1672697533,1672700615,3082
7851,3517077106,3756453423,1672621560,1672624901,3341
7853,3774010081,3520730271,1672655750,1672657750,2000
7905,3505791599,3760492950,1672653647,1672656125,2478
7979,3533095755,3520206212,1672592237,1672592719,482
7680,3639847263,3519556068,1672574231,1672575316,1085
7861,3559110998,3510703546,1672599722,1672601901,2179
7937,3777120536,3505873261,1672702698,1672705142,2444
7545,3433804879,3777514571,1672639001,1672639572,571
7935,3774204963,3399004969,1672603362,1672603728,366
7512,3770763956,3209048907,1672551327,1672554221,2894
7710,3737079798,3533385867,1672680414,1672681327,913
7840,3932051427,3899266183,1672683067,1672684313,1246
7915,3918247820,3791594391,1672684926,1672688306,3380
7771,3291235378,3610348516,1672680574,1672682274,1700
7578,3973560347,3774298222,1672688788,1672689181,393
7739,3428964059,3534492426,1672676731,1672677615,884
7864,3369998498,3505347134,1672671703,1672673077,1374
7763,3481647420,3774268456,1672561570,1672562559,989
7812,3512349371,3899266183,1672603810,1672606909,3099
7754,3774339795,3818255890,1672659828,1672663419,3591
7934,3417587765,3634786711,1672561979,1672562281,302
7875,3559110998,3511198618,1672670629,1672672077,1448
7752,3859525941,3311274543,1672531931,1672535369,3438
7782,3477649378,3978105277,1672626048,1672626652,604
7700,3426325549,3516039895,1672532434,1672532677,243
7975,3703275621,3777120536,1672698215,1672701065,2850
7834,3826759140,3519428855,1672532145,1672535711,3566
7519,3826633236,3777929708,1672683722,1672686537,2815
7547,3516673015,3378686918,1672604629,1672605533,904
7737,3513080274,3668898102,1672603539,1672603651,112
7670,3839849341,3475251781,1672616115,1672618237,2122
7898,3755739653,3780365428,1672616326,1672618350,2024
7931,3351008918,3280599164,1672700918,1672702205,1287
7778,3511332835,3473562469,1672545594,1672546569,975
7780,3739106581,3714474557,1672575065,1672576648,1583
7545,3396086535,3703275621,1672602763,1672602961,198
7919,3287105466,3505201246,1672671538,1672674599,3061
7611,3714962248,3407673904,1672588757,1672590351,1594
7660,3734496778,3716835696,1672546558,1672548451,1893
7983,3311439795,3703275621,1672678470,1672681837,3367
7560,3520376528,3501184421,1672535279,1672536226,947
7731,3829764737,3666507626,1672564063,1672565338,1275
7736,3518791447,3518260334,1672547135,1672549032,1897
7580,3509907947,3515284591,1672601552,1672604504,2952
7603,3970117174,3783779671,1672549241,1672550878,1637
7567,3316173088,3387674757,1672661653,1672664707,3054
7932,3505638204,3930797455,1672664876,1672666816,1940
7644,3391915886,3774338212,1672579650,1672580395,745
7516,3505869747,3780365428,1672565656,1672569028,3372
7869,3979339287,3887270940,1672629255,1672632187,2932
7598,3373384732,3505904952,1672649723,1672650210,487
7889,3420700674,3483164654,1672572410,1672575800,3390
7812,3334033993,3716843669,1672572035,1672573363,1328
7875,3826759140,3311627628,1672700586,1672703805,3219
7963,3500391167,3271938399,1672626480,1672627765,1285
7912,3494290908,3361230905,1672617660,1672620117,2457
7710,3349613093,3337544549,1672659682,1672662478,2796
7540,3773814927,3311152102,1672538204,1672539679,1475
7736,3505649239,3792768129,1672555551,1672558015,2464
7679,3400918687,3337544549,1672621059,1672621875,816
7722,3534010629,3552314511,1672569665,1672573129,3464
7773,3936227020,3200691026,1672561344,1672563326,1982
7599,3510771358,3778308417,1672632237,1672633887,1650
7565,3774127586,3757602960,1672643146,1672643931,785
7762,3384240055,3772309166,1672656769,1672658266,1497
7674,3518014404,3511435497,1672590587,1672591450,863
7771,3397418363,3516716179,1672542551,1672543929,1378
7925,3384240055,3399535232,1672615719,1672617067,1348
7858,3930791338,3284639858,1672609988,1672613328,3340
7825,3516909237,3637008488,1672587939,1672590349,2410
7748,3772053179,3520183192,1672584991,1672587438,2447
7899,3388372715,3307512479,1672612451,1672614382,1931
7643,3512166013,3280964728,1672557792,1672558341,549
7572,3505201246,3313541986,1672624480,1672627577,3097
7786,3244436890,3634786711,1672694339,1672696381,2042
7632,3409474775,3636867411,1672640471,1672643423,2952
7528,3510244400,3791957752,1672618907,1672619966,1059
7576,3291883916,3882997884,1672631382,1672633043,1661
7791,3369998498,3277669002,1672540709,1672542279,1570
7942,3466911760,3755392666,1672642309,1672642832,523
7819,3777929708,3515691540,1672603060,1672606354,3294
7964,3481502100,3912262917,1672547229,1672549655,2426
7577,3439023335,3318166135,1672602223,1672605695,3472
7591,3779036831,3756601594,1672693387,1672693500,113
7806,3534488837,3500066230,1672649980,1672652834,2854
7855,3426325549,3924549929,1672694053,1672696613,2560
7854,3770763956,3858918246,1672605406,1672607810,2404
7878,3683766533,3396086535,1672697020,1672698930,1910
7762,3792902982,3428674539,1672655428,1672656811,1383
7659,3348261553,3636867411,1672538463,1672540284,1821
7741,3755511676,3286658957,1672577732,1672578587,855
7732,3304056063,3510247121,1672553393,1672556617,3224
7886,3346795719,3826633236,1672687792,1672689157,1365
7972,3512683609,3514283243,1672669734,1672671936,2202
7542,3774050956,3518932404,1672679175,1672679954,779
7773,3792288302,3792384220,1672644360,1672645866,1506
7755,3511332835,3921211276,1672576532,1672580068,3536
7625,3500365158,3224716315,1672639761,1672640465,704
7531,3380035798,3703718151,1672629387,1672629513,126
7920,3533385867,3314836094,1672637055,1672637415,360
7532,3534313900,3505135325,1672682675,1672685191,2516
7616,3760992710,3731106822,1672609997,1672612828,2831
7807,3883861463,3913251733,1672550696,1672552037,1341
7872,3807987001,3534553510,1672573324,1672574393,1069
7760,3738274418,3774580701,1672583050,1672584849,1799
7820,3533137446,3509907947,1672604080,1672604994,914
7486,3511312803,3311208440,1672630914,1672631829,915
7916,3516039895,3384240055,1672615785,1672618203,2418
7946,3511163800,3634995491,1672699571,1672701968,2397
7903,3505791599,3972709319,1672606393,1672609500,3107
7819,3313564074,3519912874,1672667068,1672667526,458
7885,3932051427,3285400528,1672538254,1672540867,2613
7634,3500499542,3465202715,1672653213,1672656186,2973
7533,3514838220,3703441914,1672556957,1672557575,618
7528,3516223597,3296471982,1672703561,1672706568,3007
7838,3516258476,3716273414,1672593231,1672596354,3123
7527,3823600322,3421836608,1672682471,1672684640,2169
7658,3739106581,3733891182,1672635789,1672637635,1846
7667,3512969370,3811171116,1672692513,1672693979,1466
7678,3701184889,3770447408,1672579539,1672580077,538
7719,3311761694,3607748895,1672688633,1672690848,2215
7868,3533927138,3776066388,1672638191,1672639107,916
7774,3519912874,3520629279,1672561000,1672564331,3331
7680,3774066725,3715581279,1672663034,1672663578,544
7824,3311152102,3783779671,1672557597,1672560974,3377
7504,3780974443,3792902982,1672689941,1672690695,754
7547,3333896808,3510173870,1672620548,1672623984,3436
7874,3511359172,3882291183,1672638985,1672640920,1935
7748,3779629905,3501955238,1672690440,1672691700,1260
7823,3617055293,3280599164,1672686090,1672688633,2543
7777,3756966035,3667680268,1672554440,1672554881,441
7777,3773814927,3465254146,1672566010,1672567513,1503
7530,3510969660,3533371364,1672537164,1672538163,999
7950,3364543015,3973560347,1672558521,1672558745,224
7557,3311627628,3519563836,1672697727,1672699535,1808
7977,3777120536,3277605882,1672675762,1672676769,1007
7816,3853018906,3201324715,1672660997,1672662052,1055
7548,3229058858,3501927421,1672609895,1672610771,876
7746,3512510536,3505145247,1672618369,1672621778,3409
7495,3703871468,3301107849,1672664804,1672666797,1993
7810,3756528686,3510969660,1672563001,1672564761,1760
7556,3818255890,3509352754,1672544831,1672545813,982
7952,3303705369,3916289176,1672694267,1672695323,1056
7823,3482405588,3289061738,1672615670,1672615911,241
7943,3625274012,3512510536,1672679871,1672680238,367
7871,3235635976,3501730685,1672610321,1672612621,2300
7942,3311154569,3534191820,1672613288,1672615254,1966
7486,3311154569,3453729665,1672537086,1672539830,2744
7535,3812176780,3500229033,1672623781,1672624136,355
7728,3809916577,3519601612,1672610868,1672612046,1178
7938,3517864478,3505962865,1672630457,1672633943,3486
7589,3883551721,3534488837,1672564482,1672567915,3433
7661,3760183458,3703223015,1672600843,1672602223,1380
7638,3774501422,3434642576,1672606882,1672607891,1009
7838,3772337814,3772714862,1672654823,1672655418,595
7616,3314245084,3710408395,1672699229,1672699900,671
7731,3466229085,3829319703,1672561279,1672562917,1638
7684,3516606733,3249247700,1672616115,1672617369,1254
7652,3417970574,3519428855,1672693069,1672695967,2898
7615,3770021824,3533827120,1672556658,1672557281,623
7631,3792032359,3634340855,1672628227,1672630174,1947
7548,3932051427,3779036831,1672701875,1672703072,1197
7761,3407725581,3473765852,1672669854,1672670282,428
7694,3517509185,3688418210,1672697971,1672700975,3004
7555,3511170269,3600647945,1672535682,1672537594,1912
7856,3311152102,3246596716,1672537885,1672540150,2265
7915,3453729665,3496051529,1672570187,1672572750,2563
7569,3808324264,3703223015,1672605633,1672607590,1957
7698,3294803686,3313541986,1672637705,1672638283,578
7759,3370752401,3779740455,1672698547,1672700466,1919
7626,3298288268,3757403279,1672531892,1672533424,1532
7854,3701274634,3509907947,1672606640,1672609200,2560
7761,3859525941,3770851318,1672563711,1672565038,1327
7643,3428674539,3770021824,1672608096,1672608650,554
7960,3409474775,3511359172,1672671663,1672675221,3558
7613,3701691675,3903307060,1672566597,1672567669,1072
7616,3488244966,3791997875,1672672239,1672673771,1532
7955,3600647945,3772053179,1672563817,1672567024,3207
7747,3533748232,3904775198,1672557991,1672560943,2952
7727,3736790081,3756027749,1672579484,1672581952,2468
7554,3755920131,3533095755,1672645771,1672647139,1368
7547,3710067113,3859525941,1672693375,1672696167,2792
7899,3394539273,3904408902,1672608516,1672610712,2196
7495,3716273414,3607748895,1672658167,1672661671,3504
7803,3756453423,3774793839,1672635382,1672638169,2787
7506,3519601612,3732481297,1672577615,1672580418,2803
7591,3247815299,3372883226,1672556557,1672558733,2176
7812,3770021824,3621497531,1672641765,1672643041,1276
7749,3774793839,3517864478,1672537798,1672539988,2190
7848,3475396323,3773814927,1672691160,1672692094,934
7898,3516514391,3888559320,1672646503,1672648278,1775
7878,3755920131,3760294205,1672545778,1672547294,1516
7684,3711265369,3512683609,1672663635,1672665277,1642
7499,3304625412,3516514391,1672604373,1672606941,2568
7628,3512540951,3716843669,1672642371,1672643119,748
7959,3816853177,3229665776,1672558867,1672559609,742
7890,3714962248,3772053179,1672674532,1672675773,1241
7845,3777983879,3601879040,1672645464,1672647608,2144
7876,3624312512,3236102733,1672697270,1672700522,3252
7491,3418534998,3222521619,1672589781,1672591361,1580
7679,3713268590,3777806071,1672585530,1672586886,1356
7770,3430504438,3511350608,1672623211,1672626685,3474
7891,3516011407,3370752401,1672656096,1672659529,3433
7534,3351008918,3756424865,1672694155,1672695032,877
7643,3533369198,3711198793,1672550481,1672553377,2896
7734,3209551760,3520756859,1672652772,1672653296,524
7888,3701274634,3227457126,1672580331,1672582492,2161
7781,3791942683,3511862351,1672578431,1672581897,3466
7779,3407673904,3481502100,1672683190,1672684499,1309
7967,3715339701,3701178711,1672632289,1672632720,431
7915,3454042520,3607748895,1672536228,1672538210,1982
7683,3716488385,3384240055,1672604717,1672607769,3052
7970,3898995675,3888559320,1672637495,1672639484,1989
7532,3770763956,3378686918,1672681762,1672681863,101
7768,3519069599,3703441914,1672642634,1672645805,3171
7527,3882291183,3334033993,1672545582,1672547229,1647
7857,3793338102,3516514391,1672621347,1672624793,3446
7673,3516960534,3710098970,1672575957,1672576517,560
7484,3514245078,3533369198,1672682729,1672683487,758
7508,3234362962,3760183458,1672658939,1672661776,2837
7573,3978115672,3801089989,1672599870,1672601538,1668
7697,3617734118,3713786889,1672597188,1672600339,3151
7832,3804870229,3716488385,1672661236,1672663318,2082
7556,3519912874,3336742544,1672672215,1672673606,1391
7685,3774127586,3496051529,1672660310,1672662771,2461
7811,3515723720,3331845324,1672613610,1672614809,1199
7930,3515151980,3774127586,1672543186,1672546454,3268
7530,3615046771,3711569060,1672621163,1672621636,473
7778,3510594211,3387966152,1672533729,1672535854,2125
7483,3783509527,3427219654,1672615765,1672618397,2632
7509,3231056870,3809916577,1672538655,1672540607,1952
7898,3835382117,3701190899,1672626135,1672628227,2092
7510,3318697153,3918674986,1672671592,1672672463,871
7594,3512837326,3516909237,1672573292,1672574027,735
7708,3505173328,3805347939,1672624954,1672627413,2459
7514,3534191820,3716746253,1672666098,1672666633,535
7687,3509352754,3904408902,1672684182,1672686874,2692
7964,3276993580,3475251781,1672670193,1672670348,155
7934,3356860407,3627937312,1672616271,1672617719,1448
7633,3515125508,3512217942,1672582822,1672584241,1419
7894,3373384732,3713208927,1672644740,1672648153,3413
7830,3772642849,3613683164,1672685632,1672685729,97
7887,3714488548,3514245078,1672689518,1672692479,2961
7937,3533137446,3432665384,1672644235,1672645808,1573
7836,3780639480,3809916577,1672671321,1672673771,2450
7625,3501198706,3519703355,1672694718,1672695520,802
7529,3421836608,3510380060,1672554125,1672556965,2840
7835,3534191820,3510244400,1672667738,1672669762,2024
7826,3975287541,3505869747,1672553985,1672556354,2369
7741,3755042098,3312664885,1672686443,1672688207,1764
7812,3415546117,3772578994,1672617124,1672620005,2881
7634,3833889105,3755920131,1672635522,1672636993,1471
7646,3760569731,3475258557,1672602304,1672602753,449
7900,3311203656,3416427576,1672543892,1672545783,1891
7769,3426325549,3304056063,1672560918,1672563153,2235
7757,3779740455,3249791738,1672649026,1672651367,2341
7614,3518014404,3378686918,1672641344,1672641653,309
7603,3473765852,3931941795,1672693826,1672695574,1748
7544,3636867411,3711571712,1672582527,1672584719,2192
7830,3475258557,3716488385,1672578787,1672579617,830
7507,3223968713,3887270940,1672535083,1672536245,1162
7740,3485008994,3311415018,1672616547,1672618712,2165
7526,3501606184,3533369198,1672545276,1672545750,474
7560,3756623396,3500994774,1672679379,1672681826,2447
7974,3428006164,3773814927,1672628183,1672631774,3591
7591,3774005526,3476232529,1672582967,1672584984,2017
7635,3345207877,3930791338,1672607261,1672610806,3545
7627,3489962019,3223789409,1672621489,1672624829,3340
7958,3496051529,3716835696,1672680089,1672681822,1733
7717,3710098970,3472130842,1672703669,1672704719,1050
7818,3367902229,3513201436,1672648779,1672650783,2004
7840,3367902229,3633420270,1672558059,1672558271,212
7723,3774366875,3421127249,1672651013,1672651742,729
7964,3505973226,3313541986,1672540981,1672541169,188
7735,3518163778,3311627628,1672553111,1672554826,1715
7866,3515860749,3909606423,1672640503,1672642506,2003
7559,3505193212,3404058699,1672612940,1672615669,2729
7797,3801089989,3519563836,1672554174,1672556566,2392
7827,3817316561,3520719611,1672690556,1672691588,1032
7780,3791942683,3701898991,1672635443,1672638680,3237
7788,3610348516,3377766165,1672538821,1672540272,1451
7504,3429690204,3852595551,1672578507,1672579790,1283
7743,3805519285,3220716272,1672653815,1672656365,2550
7618,3500805881,3778305740,1672555734,1672558613,2879
7564,3617734118,3296471982,1672637615,1672638512,897
7804,3685187183,3887270940,1672669135,1672670974,1839
7805,3913251733,3511312803,1672648058,1672649774,1716
7983,3518360734,3534488837,1672646052,1672648015,1963
7532,3780593036,3777776687,1672579461,1672581664,2203
7904,3533025282,3755511676,1672625490,1672627115,1625
7511,3730517636,3510937904,1672585208,1672585367,159
7944,3889750851,3418728074,1672580504,1672580675,171
7759,3388372715,3757403279,1672590007,1672590832,825
7605,3511163800,3738502357,1672600278,1672600900,622
7883,3534424200,3235287260,1672575072,1672576684,1612
7607,3500060260,3296471982,1672636889,1672640375,3486
7702,3780365428,3760492950,1672682443,1672683420,977
7890,3492478793,3297463265,1672664179,1672667662,3483
7649,3505869747,3901877072,1672612574,1672614790,2216
7863,3915628728,3611150562,1672565654,1672565926,272
7973,3822654369,3518360734,1672679053,1672681329,2276
7599,3774005526,3859525941,1672624900,1672626008,1108
7579,3516223597,3737051610,1672628502,1672631803,3301
7733,3711569060,3855000166,1672592726,1672593913,1187
7534,3505145247,3234541252,1672548758,1672549682,924
7695,3500904641,3417970574,1672566245,1672569103,2858
7652,3337544549,3514128943,1672545428,1672548895,3467
7620,3424922204,3734737881,1672615379,1672618148,2769
7731,3505873261,3235287260,1672539115,1672540851,1736
7520,3516673015,3898995675,1672582355,1672585242,2887
7917,3500803339,3615046771,1672658117,1672659806,1689
7805,3501184421,3760294205,1672536071,1672538393,2322
7708,3777079686,3360743849,1672558217,1672559706,1489
7783,3780294829,3485008994,1672634999,1672635691,692
7667,3311761694,3792768129,1672573506,1672575600,2094
7760,3883042241,3426325549,1672702893,1672703863,970
7492,3277669002,3500177712,1672628368,1672630401,2033
7849,3939952128,3774793839,1672533961,1672537461,3500
7691,3915628728,3710408395,1672546838,1672549599,2761
7904,3716165213,3399052055,1672557502,1672558807,1305
7538,3358871377,3416427576,1672629053,1672632286,3233
7607,3534424200,3734496778,1672592601,1672594851,2250
7929,3533095755,3466911760,1672545612,1672546860,1248
7916,3735733948,3416241005,1672541149,1672543221,2072
7717,3755511676,3703275621,1672680799,1672684388,3589
7657,3711380716,3518014636,1672701501,1672704360,2859
7508,3374559242,3703889596,1672646408,1672646689,281
7937,3826415738,3397418363,1672629431,1672632518,3087
7531,3633420270,3889750851,1672564727,1672567552,2825
7737,3505347134,3399433690,1672594444,1672595630,1186
7623,3296471982,3734828619,1672649623,1672650741,1118
7896,3386707783,3513080274,1672534279,1672535623,1344
7685,3394539273,3716488385,1672692414,1672695840,3426
7565,3783245561,3520888296,1672686045,1672687669,1624
7628,3500904641,3756966035,1672601660,1672605088,3428
7717,3505201246,3511125626,1672554377,1672557837,3460
7957,3716843669,3407673904,1672598200,1672598976,776
7564,3399433690,3517864478,1672682899,1672685679,2780
7799,3510244400,3783239924,1672545154,1672545957,803
7827,3917088658,3407673904,1672556264,1672556819,555
7909,3280964728,3773664987,1672573253,1672575532,2279
7838,3713894336,3512969370,1672701246,1672702664,1418
7614,3394539273,3509453566,1672610331,1672611355,1024
7818,3505638204,3711198793,1672659803,1672662031,2228
7958,3774556560,3773664987,1672549133,1672551293,2160
7870,3793470489,3511332835,1672685584,1672687207,1623
7980,3703955926,3501184421,1672635801,1672639076,3275
7560,3779218771,3882242815,1672647307,1672649541,2234
7599,3918056059,3501606184,1672670358,1672672685,2327
7599,3388286531,3505193212,1672587696,1672588825,1129
7866,3500177712,3770078063,1672585027,1672585432,405
7620,3516980378,3409474775,1672684366,1672687655,3289
7610,3276993580,3703871468,1672650158,1672652490,2332
7889,3534313900,3489545239,1672678729,1672679767,1038
7844,3505292701,3777717988,1672563211,1672563590,379
7572,3429690204,3978115672,1672640224,1672642093,1869
7517,3516223597,3666553782,1672567120,1672568646,1526
7942,3895562476,3601879040,1672686178,1672687604,1426
7575,3359910781,3757682496,1672698936,1672699139,203
7504,3311439795,3793959750,1672578090,1672579260,1170
7731,3505883609,3473765852,1672577151,1672579257,2106
7863,3505638204,3639847263,1672681629,1672682253,624
7960,3501692334,3505869747,1672605944,1672606836,892
7549,3433804879,3731419510,1672561654,1672561729,75
7626,3792668962,3688683847,1672688280,1672691374,3094
7655,3505702787,3234541252,1672687426,1672687754,328
7823,3533193862,3552314511,1672694090,1672696808,2718
7890,3805519285,3826415738,1672537668,1672538397,729
7741,3701863557,3520376528,1672623558,1672625001,1443
7494,3501198706,3760183458,1672612891,1672613472,581
7920,3516223597,3473765852,1672616390,1672617992,1602
7763,3511359172,3412825109,1672576820,1672577376,556
7674,3791602225,3232962003,1672675366,1672676685,1319
7863,3792844210,3792473331,1672564326,1672564642,316
7538,3664517356,3970117174,1672613519,1672615704,2185
7975,3465254146,3534191820,1672625056,1672628051,2995
7554,3339907603,3716835696,1672573126,1672575720,2594
7616,3904408902,3688683847,1672686411,1672689868,3457
7971,3511163800,3757151210,1672547345,1672549525,2180
7970,3777936328,3888559320,1672586508,1672588564,2056
7548,3533369198,3756623396,1672674702,1672677104,2402
7618,3402943525,3760077057,1672663237,1672665490,2253
7971,3710112546,3621810464,1672618412,1672621874,3462
7739,3975287541,3373384732,1672650802,1672654371,3569
7575,3312664885,3881477378,1672691823,1672693094,1271
7714,3852391257,3512217942,1672590416,1672591188,772
7806,3793086311,3881477378,1672668767,1672671778,3011
7802,3755042098,3533137446,1672559587,1672562546,2959
7940,3760183458,3770763956,1672658039,1672660413,2374
7690,3291227780,3223789409,1672576909,1672578490,1581
7971,3715998609,3911159965,1672535667,1672536913,1246
7933,3772544062,3475258557,1672662055,1672663797,1742
7677,3337544549,3736419952,1672617514,1672617666,152
7716,3418728074,3829764737,1672671384,1672672016,632
7759,3415546117,3518260334,1672645472,1672645920,448
7639,3511163800,3783925755,1672597936,1672600018,2082
7625,3888559320,3606812411,1672572444,1672572832,388
7502,3757602960,3501483568,1672572701,1672573066,365
7603,3901990690,3970117174,1672677876,1672678308,432
7919,3756623396,3533137446,1672626011,1672628605,2594
7954,3512142794,3512567240,1672558934,1672559331,397
7909,3421127249,3773598056,1672591264,1672593080,1816
7653,3703955926,3209048907,1672653109,1672654607,1498
7730,3716197887,3342131135,1672703396,1672704518,1122
7622,3520719611,3505873261,1672655326,1672657474,2148
7896,3505869747,3411618230,1672601097,1672603351,2254
7810,3311415018,3512217942,1672658570,1672660327,1757
7874,3276993580,3904408902,1672564050,1672565253,1203
7634,3505883609,3510126867,1672594306,1672595685,1379
7548,3716746253,3703275621,1672538420,1672539158,738
7665,3509933351,3517255726,1672616483,1672619064,2581
7726,3515394721,3774045700,1672672508,1672673571,1063
7635,3511198618,3627937312,1672618898,1672621616,2718
7852,3772309166,3500805881,1672606234,1672608345,2111
7695,3385763781,3902383721,1672648481,1672650752,2271
7929,3516065852,3482405588,1672584747,1672587534,2787
7910,3716258994,3716168623,1672644356,1672646879,2523
7545,3249247700,3880285638,1672656534,1672657656,1122
7613,3533827120,3682061100,1672659433,1672662596,3163
7622,3805519285,3209027249,1672543186,1672546267,3081
7669,3715974031,3311208440,1672606600,1672610191,3591
7545,3880310724,3756966035,1672573175,1672574121,946
7928,3772544062,3713370078,1672578943,1672579293,350
7888,3606987130,3399535232,1672564280,1672567498,3218
7974,3534313900,3311274543,1672630337,1672632898,2561
7698,3607748895,3345207877,1672585894,1672589420,3526
7617,3519556068,3858918246,1672610936,1672611524,588
7948,3271938399,3793436995,1672665312,1672666812,1500
7800,3512969370,3611150562,1672563835,1672565461,1626
7933,3774005526,3918247820,1672673966,1672676970,3004
7866,3621810464,3685818092,1672574553,1672575161,608
7644,3917088658,3379256399,1672688680,1672689152,472
7545,3904408902,3534010629,1672532059,1672534869,2810
7578,3365830990,3757151210,1672624935,1672626025,1090
7740,3780593036,3791874383,1672557913,1672560171,2258
7761,3505904952,3271938399,1672534230,1672534357,127
7787,3858918246,3913251733,1672650822,1672652648,1826
7615,3520030713,3774195321,1672564494,1672567812,3318
7804,3500365158,3779036831,1672640372,1672640650,278
7829,3379256399,3770824086,1672584393,1672587716,3323
7611,3608633356,3515284591,1672679689,1672682642,2953
7975,3899204805,3617055293,1672610286,1672613767,3481
7854,3774339795,3805342762,1672556280,1672559802,3522
7935,3466911760,3713808837,1672570081,1672571149,1068
7551,3227457126,3359239884,1672577880,1672580194,2314
7695,3510380060,3458539365,1672629658,1672632226,2568
7744,3367902229,3351008918,1672606940,1672608768,1828
7558,3882997884,3711370563,1672702844,1672703051,207
7710,3331845324,3770101921,1672673224,1672674353,1129
7548,3396086535,3512969370,1672629970,1672633024,3054
7829,3489545239,3311203656,1672557588,1672558647,1059
7968,3760598102,3501759100,1672622449,1672622786,337
7609,3201848640,3755872268,1672604707,1672605303,596
7878,3385763781,3772359096,1672639802,1672642552,2750
7622,3756424865,3291883916,1672539589,1672540770,1181
7943,3307097200,3666457294,1672667959,1672669024,1065
7731,3279721246,3793871337,1672546022,1672549464,3442
7709,3920801189,3783245561,1672538417,1672539720,1303
7782,3484995752,3505599848,1672692134,1672694959,2825
7751,3777983879,3417970574,1672552819,1672555645,2826
7714,3517459919,3516258476,1672675639,1672677530,1891
7769,3356860407,3517459919,1672606630,1672609044,2414
7900,3505702787,3911159965,1672615970,1672618342,2372
7926,3505477652,3533270638,1672607732,1672610647,2915
7790,3307097200,3901990690,1672665177,1672667190,2013
7579,3421836608,3412825109,1672558434,1672561373,2939
7768,3777120536,3556951786,1672643606,1672644040,434
7711,3972709319,3733891182,1672588643,1672589175,532
7495,3880285638,3805519285,1672622237,1672624605,2368
7943,3298288268,3505912939,1672638811,1672639327,516
7505,3505098372,3315583351,1672687106,1672688805,1699
7579,3296471982,3490191091,1672544326,1672544447,121
7676,3773755137,3501184421,1672653352,1672656390,3038
7950,3801089989,3516016437,1672691240,1672694590,3350
7961,3793627961,3277939457,1672551035,1672554157,3122
7920,3505904952,3515394721,1672624788,1672625470,682
7530,3914259449,3716746253,1672578880,1672581140,2260
7770,3293695955,3774501422,1672658640,1672661765,3125
7914,3511271692,3701967560,1672623762,1672624344,582
7633,3291235378,3519700826,1672687201,1672687448,247
7682,3904775198,3497901842,1672685842,1672687847,2005
7750,3534488837,3505530961,1672638214,1672640179,1965
7608,3832902928,3482405588,1672697983,1672699563,1580
7650,3505702787,3378686918,1672703748,1672704318,570
7813,3406784491,3664517356,1672540569,1672542742,2173
7680,3533025282,3458539365,1672557920,1672561092,3172
7722,3813052709,3668005723,1672674655,1672677279,2624
7786,3793286136,3634786711,1672555306,1672555398,92
7584,3500904641,3378092448,1672590252,1672592512,2260
7621,3621810464,3716843669,1672539545,1672541634,2089
7573,3791942683,3415546117,1672531795,1672532392,597
7583,3519703355,3777079686,1672656134,1672656285,151
7624,3703661585,3311203656,1672575750,1672578660,2910
7582,3737079798,3628819436,1672578863,1672581856,2993
7913,3427219654,3505962865,1672544288,1672547586,3298
7819,3417587765,3501606184,1672557834,1672560033,2199
7894,3801089989,3832902928,1672652883,1672656273,3390
7518,3516629436,3505530961,1672534367,1672534586,219
7643,3683766533,3760598102,1672589450,1672591367,1917
7942,3777983879,3380035798,1672611467,1672613120,1653
7690,3858918246,3777443199,1672690712,1672693531,2819
7624,3613995936,3533242305,1672576956,1672578295,1339
7679,3516606733,3533137446,1672557216,1672557318,102
7680,3510771358,3713349754,1672561228,1672562406,1178
7718,3834257412,3777776687,1672671543,1672674361,2818
7874,3608633356,3454042520,1672595327,1672598921,3594
7722,3828432634,3770447408,1672677291,1672679188,1897
7734,3224058172,3777776687,1672633864,1672634250,386
7938,3611150562,3399433690,1672541265,1672544508,3243
7662,3776513891,3755739653,1672637299,1672638899,1600
7863,3774045700,3774338212,1672552525,1672553136,611
7970,3836573197,3475258557,1672642930,1672645300,2370
7494,3515125508,3311324983,1672598210,1672601300,3090
7749,3772578994,3791020967,1672558263,1672561677,3414
7684,3778341199,3891751546,1672589244,1672590998,1754
7878,3489962019,3518876135,1672595250,1672596558,1308
7894,3772746272,3975287541,1672601844,1672604008,2164
7630,3397418363,3493507965,1672671356,1672674004,2648
7856,3976390453,3533827120,1672700901,1672703596,2695
7704,3534553510,3783429780,1672613922,1672616385,2463
7494,3777443199,3711571712,1672565821,1672566872,1051
7687,3311993075,3509604974,1672643596,1672647114,3518
7958,3514838220,3826759140,1672579292,1672581034,1742
7838,3383922351,3500177712,1672533669,1672534651,982
7971,3511359172,3806545488,1672648229,1672650382,2153
7842,3533025282,3779528381,1672589013,1672592427,3414
7632,3387966152,3903307060,1672584078,1672586905,2827
7948,3400804807,3793871337,1672695115,1672697447,2332
7665,3805342762,3629547065,1672618759,1672619068,309
7801,3909238838,3903307060,1672662031,1672663981,1950
7498,3755739653,3777983879,1672649431,1672649890,459
7861,3514128943,3489217083,1672646198,1672647283,1085
7796,3370752401,3467773920,1672642626,1672642835,209
7721,3202120784,3615046771,1672657291,1672658145,854
7673,3773120434,3516909237,1672618309,1672621652,3343
7832,3388286531,3518669703,1672646990,1672650510,3520
7546,3303751772,3715974031,1672556582,1672556969,387
7734,3484995752,3777776687,1672542609,1672542782,173
7658,3731419510,3793436995,1672617307,1672619035,1728
7938,3520931254,3716488385,1672647892,1672651012,3120
7762,3883551721,3516039895,1672654677,1672656852,2175
7963,3713208927,3802367797,1672598532,1672598898,366
7651,3209383861,3780593036,1672637200,1672640413,3213
7787,3238712269,3519803045,1672664036,1672665270,1234
7912,3473562469,3505904952,1672687683,1672689007,1324
7887,3772642849,3357483218,1672545787,1672546789,1002
7875,3930797455,3480687894,1672578199,1672579729,1530
7762,3716746253,3783779671,1672556286,1672559777,3491
7760,3918056059,3430352815,1672630587,1672632383,1796
7776,3883861463,3554917400,1672649321,1672651125,1804
7619,3277669002,3490191091,1672680411,1672680615,204
7979,3505530961,3518669703,1672564201,1672567350,3149
7845,3736592744,3604539807,1672574202,1672577277,3075
7513,3232962003,3509672210,1672595173,1672595867,694
7890,3294803686,3318697153,1672622039,1672622380,341
7715,3430074045,3314836094,1672624950,1672627322,2372
7824,3755625324,3972364603,1672562648,1672565699,3051
7516,3910886626,3534488837,1672635326,1672637380,2054
7721,3505638204,3520190170,1672623734,1672623999,265
7650,3488244966,3738502357,1672617255,1672620172,2917
7753,3711265369,3833889105,1672664025,1672666816,2791
7875,3512969370,3793848402,1672635460,1672635614,154
7593,3662180254,3756027749,1672548698,1672549840,1142
7653,3770021824,3827626797,1672650572,1672652018,1446
7667,3307512479,3911245524,1672540209,1672541334,1125
7535,3318166135,3247428249,1672642398,1672645000,2602
7925,3227457126,3812176780,1672568653,1672569528,875
7944,3348261553,3516039895,1672610578,1672614092,3514
7830,3475258557,3311208440,1672624625,1672625816,1191
7642,3430504438,3791942683,1672649830,1672652077,2247
7808,3501759100,3755881905,1672648648,1672651916,3268
7833,3791997875,3206254161,1672576244,1672578410,2166
7505,3516716179,3221899927,1672683866,1672685974,2108
7608,3519069599,3388637594,1672673451,1672675830,2379
7509,3277669002,3760183458,1672559124,1672560103,979
7501,3895562476,3978105277,1672553438,1672553574,136
7487,3533748232,3777477395,1672633973,1672634055,82
7485,3519563836,3505869747,1672656253,1672658745,2492
7554,3802367797,3970117174,1672603684,1672607214,3530
7493,3735319397,3770635361,1672647298,1672647571,273
7729,3380035798,3534191820,1672656167,1672658765,2598
7554,3890149705,3780609808,1672663474,1672664991,1517
7924,3855000166,3515691540,1672614945,1672615210,265
7896,3783509527,3710408395,1672547147,1672548804,1657
7877,3433804879,3209048907,1672635084,1672636327,1243
7896,3500904641,3812176780,1672630803,1672633578,2775
7948,3515394721,3364543015,1672546651,1672548618,1967
7820,3227158514,3780365428,1672634621,1672636450,1829
7929,3800353779,3916289176,1672550885,1672552390,1505
7751,3608868877,3880285638,1672616296,1672616581,285
7638,3278365525,3859663348,1672702978,1672706550,3572
7805,3420700674,3976390453,1672609195,1672612568,3373
7504,3756027749,3924549929,1672562881,1672563324,443
7759,3634340855,3223968713,1672576122,1672577669,1547
7645,3518360734,3314836094,1672693718,1672694263,545
7779,3475258557,3773429448,1672592649,1672594526,1877
7874,3370752401,3392121505,1672580983,1672581555,572
7535,3622054816,3520730271,1672612957,1672614420,1463
7665,3777477395,3903307060,1672563808,1672565664,1856
7866,3513956646,3685818092,1672591541,1672593674,2133
7713,3518408774,3925402713,1672558977,1672561285,2308
7742,3922275416,3365830990,1672656487,1672657008,521
7809,3774501422,3505904952,1672643626,1672647167,3541
7571,3362000049,3778266283,1672547340,1672548930,1590
7966,3510594211,3514987389,1672686939,1672687989,1050
7827,3716273414,3734828619,1672606878,1672609412,2534
7740,3372883226,3791115967,1672567435,1672568211,776
7898,3668005723,3466229085,1672587154,1672588165,1011
7769,3629547065,3202120784,1672666481,1672669557,3076
7918,3430504438,3466229085,1672609652,1672610089,437
7535,3902278226,3613683164,1672645185,1672645990,805
7964,3855424474,3416265063,1672613348,1672613767,419
7952,3757161914,3855424474,1672641247,1672644687,3440
7983,3792288302,3774466457,1672583734,1672583837,103
7934,3756451663,3780593036,1672590238,1672592941,2703
7693,3791657947,3914259449,1672574595,1672575889,1294
7804,3837094550,3774119563,1672616390,1672618154,1764
7719,3792883665,3777936328,1672565961,1672568757,2796
7946,3701967560,3311154569,1672557675,1672559879,2204
7891,3624761861,3314836094,1672689797,1672692128,2331
7586,3236102733,3514987389,1672563038,1672564044,1006
7817,3418728074,3774339795,1672638066,1672638369,303
7784,3901877072,3311154569,1672673962,1672676385,2423
7529,3500391167,3430504438,1672577927,1672579755,1828
7785,3922275620,3505635228,1672537669,1672538260,591
7916,3370752401,3428006164,1672598739,1672600976,2237
7957,3618873142,3773755137,1672682245,1672683734,1489
7973,3793470489,3779629905,1672641250,1672642810,1560
7566,3912262917,3772714862,1672607289,1672607911,622
7717,3791874383,3533371364,1672668684,1672669168,484
7890,3500229033,3970117174,1672593003,1672595534,2531
7865,3629547065,3466229085,1672613189,1672613317,128
7521,3683959482,3760569731,1672538476,1672540616,2140
7716,3716168623,3924549929,1672687362,1672687614,252
7814,3311415018,3364543015,1672573523,1672575261,1738
7602,3515860749,3756623396,1672693576,1672696263,2687
7969,3417061462,3805347939,1672684960,1672688075,3115
7648,3475396323,3248507722,1672535939,1672536801,862
7778,3505193212,3500391167,1672628946,1672630433,1487
7639,3855424474,3779036831,1672642887,1672644064,1177
7754,3489217083,3774204963,1672590616,1672592445,1829
7883,3773755137,3774298222,1672679227,1672681654,2427
7955,3756601594,3348261553,1672633406,1672636397,2991
7512,3313564074,3510594211,1672573183,1672576436,3253
7588,3760077057,3739106581,1672571563,1672571718,155
7519,3489545239,3304056063,1672597710,1672601080,3370
7776,3365942576,3333896808,1672593176,1672593841,665
7742,3604539807,3887270940,1672576370,1672578465,2095
7600,3617734118,3451432842,1672697108,1672697438,330
7885,3778108318,3703441914,1672646149,1672648034,1885
7626,3666553782,3701498253,1672630126,1672630211,85
7794,3357483218,3247428249,1672695132,1672696340,1208
7774,3407725581,3615046771,1672537571,1672540517,2946
7864,3883085535,3904408902,1672686390,1672687405,1015
7772,3208844525,3512510536,1672606976,1672610548,3572
7662,3791602225,3348261553,1672594692,1672596296,1604
7705,3755920131,3510771358,1672627798,1672628732,934
7617,3634995491,3714962248,1672632533,1672633604,1071
7589,3710112546,3518260334,1672628953,1672630843,1890
7561,3793627961,3774125065,1672534274,1672536041,1767
7859,3886298125,3939952128,1672552003,1672553661,1658
7709,3500894271,3520751702,1672643458,1672645848,2390
7968,3910886626,3823600322,1672618353,1672619030,677
7688,3519700826,3520751702,1672684653,1672687176,2523
7971,3755625324,3793753089,1672703761,1672706785,3024
7550,3912262917,3805292782,1672593394,1672596693,3299
7881,3826760240,3774580701,1672698685,1672700717,2032
7918,3311627628,3303751772,1672613061,1672615186,2125
7965,3801089989,3432665384,1672577382,1672577583,201
7873,3760569731,3383661227,1672626791,1672627866,1075
7900,3516716179,3465254146,1672664583,1672665429,846
7695,3887270940,3220716272,1672600658,1672600738,80
7699,3825229501,3713630656,1672600053,1672600742,689
7863,3756451663,3511271692,1672601210,1672603912,2702
7632,3370636709,3780503655,1672646778,1672648048,1270
7736,3362000049,3311415018,1672614165,1672617299,3134
7932,3377766165,3533653428,1672541815,1672544771,2956
7973,3760598102,3778780511,1672539097,1672540485,1388
7814,3756021689,3780828689,1672666388,1672668506,2118
7750,3793338102,3516514391,1672661272,1672661777,505
7844,3610695419,3760598102,1672662513,1672663019,506
7627,3475795792,3351008918,1672586272,1672586609,337
7775,3433804879,3234541252,1672692864,1672693480,616
7927,3555214688,3792032359,1672683409,1672686542,3133
7901,3311208440,3534702203,1672669705,1672672186,2481
7745,3500658339,3515151980,1672546032,1672549612,3580
7558,3516673015,3501606184,1672556315,1672559900,3585
7647,3711308224,3822654369,1672686187,1672689686,3499
7768,3505362057,3501601840,1672589916,1672592991,3075
7858,3791594391,3247780536,1672682915,1672684334,1419
7975,3361230905,3885670556,1672536534,1672537167,633
7541,3379589402,3802367797,1672568254,1672569175,921
7500,3664517356,3688683847,1672674546,1672676675,2129
7687,3236102733,3778305740,1672688657,1672691821,3164
7560,3770021824,3489962019,1672548207,1672550303,2096
7826,3755392666,3618873142,1672605520,1672606318,798
7854,3618045231,3352603894,1672678703,1672679726,1023
7824,3701178711,3533193862,1672618987,1672619284,297
7546,3483164654,3505203158,1672622062,1672624493,2431
7959,3911245524,3511198618,1672566612,1672568674,2062
7690,3624761861,3518360734,1672694539,1672697222,2683
7797,3701691675,3284639858,1672548613,1672550848,2235
7600,3773429448,3533810360,1672658454,1672661055,2601
7672,3511271692,3634995491,1672544560,1672547114,2554
7555,3399004969,3701065786,1672589317,1672592067,2750
7762,3500066230,3772642849,1672580776,1672582209,1433
7635,3855937514,3776800213,1672639798,1672642507,2709
7823,3512142794,3514719601,1672642126,1672644918,2792
7841,3715974031,3774338212,1672625165,1672628638,3473
7790,3852595551,3735733948,1672681379,1672682636,1257
7695,3774066725,3688683847,1672682203,1672682673,470
7485,3367902229,3829764737,1672546577,1672548019,1442
7872,3755872268,3774520233,1672608712,1672611716,3004
7561,3793962300,3477375368,1672617187,1672620033,2846
7831,3898995675,3774338212,1672537399,1672540586,3187
7919,3713268590,3514987389,1672598817,1672600230,1413
7561,3978115672,3220716272,1672531500,1672532136,636
7787,3777514571,3917278625,1672567151,1672567815,664
7916,3513080274,3501483568,1672647259,1672649768,2509
7746,3883861463,3773950140,1672568368,1672570033,1665
7858,3777983879,3617734118,1672621247,1672623284,2037
7670,3779629905,3500729955,1672618126,1672619811,1685
7830,3392121505,3901990690,1672600961,1672601591,630
7602,3511841857,3514838220,1672554923,1672555319,396
7579,3909606423,3772309166,1672620377,1672623138,2761
7942,3388286531,3792789881,1672618617,1672620869,2252
7803,3520751702,3209383861,1672625140,1672626809,1669
7500,3407673904,3774119563,1672626110,1672626747,637
7666,3487171044,3517255726,1672683759,1672683996,237
7655,3209551760,3792668962,1672651689,1672653046,1357
7747,3774298222,3701984666,1672642751,1672646252,3501
7585,3792902982,3714488548,1672686705,1672690249,3544
7801,3365278081,3492478793,1672652455,1672654965,2510
7954,3755436115,3383661227,1672626299,1672628445,2146
7956,3757403279,3314245084,1672559869,1672560043,174
7916,3298288268,3500229033,1672681481,1672683306,1825
7909,3533095755,3334033993,1672550545,1672553320,2775
7559,3394539273,3604539807,1672552892,1672555443,2551
7775,3713268590,3904408902,1672546173,1672546925,752
7528,3517476351,3756451663,1672624302,1672626970,2668
7679,3883551721,3617055293,1672540587,1672540995,408
7485,3365614305,3757246925,1672678001,1672678294,293
7941,3533653428,3427219654,1672573730,1672577188,3458
7583,3855424474,3201432789,1672615709,1672616911,1202
7534,3711380716,3311154569,1672541755,1672543150,1395
7650,3516629436,3713630656,1672649596,1672651162,1566
7811,3311274543,3364543015,1672660215,1672661984,1769
7749,3514838220,3496269445,1672681775,1672682731,956
7979,3400804807,3277939457,1672671918,1672674656,2738
7637,3520756859,3518408774,1672696577,1672699783,3206
7531,3514719601,3793962300,1672588476,1672589733,1257
7874,3510244400,3783196518,1672568593,1672569595,1002
7516,3391261292,3471220483,1672597650,1672599770,2120
7870,3792789881,3221536550,1672627273,1672628720,1447
7897,3514838220,3738274418,1672546404,1672547601,1197
7495,3248507722,3890149705,1672625073,1672625653,580
7936,3533810360,3388372715,1672553179,1672555046,1867
7907,3891751546,3757602960,1672559826,1672560493,667
7500,3760492950,3889232789,1672535207,1672536302,1095
7907,3774366875,3505201246,1672643308,1672644308,1000
7867,3711198793,3783531004,1672632172,1672632879,707
7561,3206254161,3625274012,1672546380,1672547266,886
7941,3835382117,3395152943,1672553871,1672555175,1304
7631,3512837326,3512510536,1672539323,1672539509,186
7668,3774119563,3512142794,1672550732,1672554326,3594
7520,3683959482,3770851318,1672597879,1672601005,3126
7718,3391915886,3505530961,1672605832,1672608575,2743
7599,3811171116,3520709480,1672650572,1672652239,1667
7599,3510969660,3809059934,1672534392,1672537927,3535
7717,3772642849,3511125626,1672568608,1672571772,3164
7557,3774339795,3518876135,1672597135,1672600697,3562
7971,3778980116,3779740455,1672658892,1672661445,2553
7488,3209551760,3779218771,1672634674,1672634961,287
7649,3288764520,3247428249,1672553307,1672555942,2635
7603,3836573197,3236102733,1672624069,1672626838,2769
7867,3555214688,3231056870,1672674631,1672678144,3513
7564,3760561634,3886298125,1672587926,1672589803,1877
7509,3792668962,3453729665,1672606709,1672608570,1861
7803,3925402713,3829232696,1672702135,1672703774,1639
7905,3439023335,3935627557,1672631055,1672631207,152
7680,3476232529,3777806071,1672546088,1672548992,2904
7554,3312829208,3608633356,1672561365,1672564039,2674
7528,3783779671,3791997875,1672701793,1672703267,1474
7767,3244389794,3489545239,1672555407,1672557943,2536
7645,3511125626,3534488837,1672633730,1672635693,1963
7816,3242408357,3710112546,1672584878,1672585746,868
7726,3701498253,3777929708,1672691674,1672692247,573
7836,3497901842,3396086535,1672684668,1672685030,362
7849,3389115045,3755392666,1672648058,1672649769,1711
7945,3793959750,3332072298,1672549076,1672551762,2686
7552,3770078063,3736790081,1672662987,1672663364,377
7834,3519703355,3374559242,1672660058,1672662601,2543
7810,3837094550,3710067113,1672694905,1672698248,3343
7604,3500499542,3280615985,1672657591,1672657920,329
7795,3501692334,3496549058,1672598642,1672601511,2869
7682,3611150562,3714821932,1672652953,1672653804,851
7564,3668005723,3554917400,1672637789,1672639575,1786
7841,3517963492,3909331423,1672650839,1672651712,873
7790,3703013906,3249247700,1672649691,1672650132,441
7836,3533927138,3400804807,1672543530,1672546034,2504
7784,3770553384,3791657947,1672608974,1672611125,2151
7947,3711569060,3777983879,1672682702,1672683438,736
7710,3711380716,3512969370,1672626769,1672628543,1774
7873,3316222192,3757602960,1672696767,1672699189,2422
7562,3710098970,3303705369,1672657185,1672659700,2515
7622,3737051610,3890149705,1672663036,1672665627,2591
7921,3774298222,3519556068,1672550448,1672551425,977
7743,3483164654,3924549929,1672636449,1672639323,2874
7621,3519912874,3701498253,1672642119,1672642198,79
7684,3294803686,3475251781,1672662739,1672665316,2577
7555,3339907603,3271938399,1672671536,1672673451,1915
7580,3505135325,3716843669,1672548168,1672549675,1507
7562,3377766165,3924549929,1672654598,1672655284,686
7730,3432665384,3858918246,1672642576,1672645703,3127
7654,3418534998,3774204963,1672544629,1672545638,1009
7632,3336742544,3611150562,1672639822,1672643227,3405
7743,3517509185,3783239924,1672627380,1672629459,2079
7856,3496051529,3516980378,1672545491,1672545741,250
7648,3484995752,3407954858,1672664508,1672666861,2353
7621,3818255890,3512166013,1672604735,1672604941,206
7873,3802367797,3352603894,1672644757,1672647828,3071
7719,3505530961,3500374658,1672610452,1672613556,3104
7720,3931941795,3616944364,1672690866,1672691545,679
7897,3311065516,3629935998,1672627023,1672627641,618
7832,3344019610,3200198928,1672658976,1672661144,2168
7840,3312664885,3777806071,1672570435,1672573640,3205
7760,3517476351,3774338212,1672617758,1672619485,1727
7510,3715998609,3703871468,1672627658,1672630045,2387
7493,3510711755,3519152550,1672635307,1672636155,848
7727,3910454786,3485823740,1672563923,1672564374,451
7715,3755872268,3512510536,1672593570,1672594725,1155
7946,3613683164,3887270940,1672602689,1672605600,2911
7970,3910454786,3519703355,1672664940,1672668008,3068
7869,3714488548,3713808837,1672703953,1672707224,3271
7524,3501601840,3618873142,1672653768,1672656849,3081
7907,3858918246,3773755137,1672605983,1672607025,1042
7582,3774204963,3662180254,1672685251,1672686541,1290
7580,3511312803,3622054816,1672661141,1672664088,2947
7863,3755436115,3703889596,1672677816,1672679175,1359
7665,3519556068,3513956646,1672643350,1672646610,3260
7613,3626156564,3915628728,1672648497,1672650328,1831
7859,3466911760,3818255890,1672552626,1672553806,1180
7833,3500458761,3804870229,1672611792,1672614256,2464
7953,3756462516,3703013906,1672545135,1672548723,3588
7927,3430074045,3249247700,1672569915,1672572220,2305
7839,3770635361,3816454165,1672655195,1672657896,2701
7872,3311648200,3607748895,1672686867,1672688875,2008
7797,3514283243,3221536550,1672541061,1672541980,919
7939,3500177712,3519601612,1672577751,1672580140,2389
7854,3837094550,3316222192,1672683141,1672684475,1334
7485,3501601840,3298433163,1672655547,1672655959,412
7682,3500066230,3688418210,1672601984,1672603231,1247
7953,3501927421,3500066230,1672593082,1672596397,3315
7761,3792032359,3512349371,1672629622,1672630105,483
7747,3851190615,3783429780,1672681624,1672684771,3147
7571,3518360734,3772758337,1672553842,1672555452,1610
7728,3778266283,3407954858,1672656148,1672658604,2456
7629,3516223597,3500365158,1672580073,1672582899,2826
7975,3271938399,3360993964,1672591685,1672593069,1384
7549,3711265369,3311761694,1672531686,1672532845,1159
7847,3817621391,3517459919,1672620931,1672624163,3232
7927,3736229191,3391915121,1672636333,1672637506,1173
7584,3489962019,3443698222,1672644249,1672647684,3435
7773,3446948848,3774127586,1672609173,1672611778,2605
7937,3244436890,3924549929,1672697646,1672700882,3236
7944,3883085535,3738502357,1672677498,1672678638,1140
7786,3520706195,3913251733,1672571748,1672575165,3417
7781,3829232696,3345207877,1672647948,1672649408,1460
7730,3793470489,3409474775,1672572435,1672574216,1781
7900,3513956646,3244436890,1672550166,1672550522,356
7624,3770635361,3234541252,1672541325,1672543379,2054
7807,3505477652,3883861463,1672674879,1672678108,3229
7906,3500365158,3518360734,1672554402,1672555991,1589
7802,3505145247,3885670556,1672597087,1672597164,77
7899,3756966035,3757447189,1672591128,1672592592,1464
7884,3520206212,3715492942,1672695739,1672698272,2533
7928,3512540951,3783083229,1672680962,1672681519,557
7767,3791901535,3483949762,1672676262,1672678117,1855
7813,3711308224,3412825109,1672659427,1672660561,1134
7895,3396086535,3711198793,1672538440,1672539678,1238
7843,3833889105,3311203656,1672567970,1672568489,519
7883,3774045700,3716900301,1672689303,1672690083,780
7694,3716258994,3774501422,1672630863,1672632410,1547
7510,3511267139,3880310724,1672575421,1672578844,3423
7725,3779528381,3774119563,1672557875,1672559458,1583
7721,3511267139,3778980116,1672692053,1672695384,3331
7752,3760561634,3520888296,1672550459,1672553410,2951
7668,3513164386,3492478793,1672534472,1672536605,2133
7799,3296471982,3505201246,1672620953,1672621727,774
7550,3316222192,3501927421,1672691214,1672691608,394
7840,3313541986,3501601840,1672539950,1672542649,2699
7965,3703223015,3772884106,1672618822,1672619724,902
7899,3344364444,3451432842,1672619547,1672621333,1786
7867,3792902982,3711571712,1672699664,1672702405,2741
7772,3519428855,3880285638,1672570094,1672573424,3330
7885,3475251781,3735733948,1672657237,1672660514,3277
7583,3805519285,3534488837,1672620692,1672623647,2955
7969,3618045231,3512683609,1672668937,1672671981,3044
7864,3701995648,3624312512,1672644142,1672645128,986
7672,3514245078,3510247121,1672683187,1672685178,1991
7902,3399535232,3804870229,1672618810,1672620988,2178
7582,3519803045,3311154569,1672625455,1672627845,2390
7734,3372883226,3773814927,1672678447,1672680560,2113
7704,3902278226,3360743849,1672637437,1672639211,1774
7753,3516465662,3500803339,1672609733,1672613091,3358
7567,3234541252,3500658339,1672581022,1672582065,1043
7980,3534191820,3937224533,1672680083,1672683595,3512
7817,3714197325,3311324983,1672564452,1672566514,2062
7561,3206603608,3757161914,1672559855,1672561256,1401
7850,3399004969,3511312803,1672645761,1672647193,1432
7957,3793389510,3772309166,1672624858,1672626115,1257
7498,3405494240,3420432297,1672548274,1672550218,1944
7667,3384951177,3793959750,1672639815,1672640087,272
7886,3280964728,3817316561,1672539789,1672543310,3521
7916,3311718847,3387966152,1672593208,1672594116,908
7654,3715974031,3760569731,1672538809,1672540798,1989
7928,3520706195,3618873142,1672562415,1672565034,2619
7841,3360993964,3636867411,1672677998,1672681494,3496
7766,3510247121,3852595551,1672537858,1672540376,2518
7839,3703735129,3360993964,1672560097,1672561801,1704
7620,3312333615,3770447408,1672622364,1672623485,1121
7576,3783245561,3510244400,1672637185,1672638362,1177
7598,3783239924,3633420270,1672668664,1672669136,472
7708,3770021824,3713370078,1672697750,1672698719,969
7585,3636867411,3756453423,1672650010,1672651520,1510
7653,3510703546,3369998498,1672676815,1672679933,3118
7733,3816454165,3357483218,1672567813,1672568206,393
7709,3516039895,3792384220,1672595963,1672596156,193
7824,3496269445,3505098372,1672629453,1672630152,699
7791,3297463265,3770635361,1672685562,1672687052,1490
7602,3792902982,3453729665,1672567240,1672570679,3439
7547,3832902928,3909238838,1672538679,1672541781,3102
7929,3227457126,3626156564,1672583956,1672585192,1236
7661,3559110998,3701995648,1672598962,1672600956,1994
7683,3500894271,3500374658,1672677090,1672677520,430
7840,3820354437,3412825109,1672609656,1672612443,2787
7544,3399535232,3492478793,1672658660,1672659006,346
7525,3518669703,3428006164,1672691460,1672694886,3426
7936,3520376528,3755511676,1672687351,1672690264,2913
7521,3793338102,3901990690,1672662672,1672663759,1087
7767,3703718151,3339907603,1672609877,1672611384,1507
7863,3828365570,3772053179,1672603893,1672606804,2911
7951,3808324264,3625274012,1672620517,1672623539,3022
7951,3703871468,3500199935,1672563849,1672564317,468
7804,3505098372,3825229501,1672641014,1672641958,944
7930,3516673015,3364543015,1672703208,1672704106,898
7597,3802367797,3273500349,1672535379,1672538830,3451
7512,3360993964,3701534009,1672603314,1672605164,1850
7922,3318166135,3881477378,1672656755,1672660342,3587
7690,3286658957,3516258476,1672654993,1672658496,3503
7704,3247428249,3770101921,1672592706,1672596106,3400
7515,3887270940,3489728806,1672648733,1672649145,412
7659,3634786711,3244485293,1672685114,1672685843,729
7735,3430074045,3384240055,1672683375,1672683890,515
7794,3617734118,3713349754,1672691739,1672691966,227
7895,3234362962,3516514391,1672572922,1672573255,333
7882,3972364603,3755872268,1672584241,1672585347,1106
7529,3459030804,3387674757,1672671199,1672673296,2097
7759,3277605882,3716900301,1672543717,1672545248,1531
7962,3780609808,3613683164,1672627401,1672627629,228
7590,3701190899,3776066388,1672612494,1672613538,1044
7821,3899266183,3480687894,1672545771,1672548970,3199
7669,3904775198,3939952128,1672556512,1672558197,1685
7896,3439023335,3500365158,1672661109,1672662799,1690
7939,3500066230,3311152102,1672579394,1672582688,3294
7634,3209383861,3518014636,1672554359,1672557425,3066
7712,3485008994,3972364603,1672595153,1672596883,1730
7520,3501759100,3519601612,1672658667,1672659553,886
7504,3501759100,3519563836,1672628101,1672629494,1393
7915,3667680268,3913251733,1672594136,1672594880,744
7963,3484995752,3716900301,1672553741,1672555890,2149
7800,3780609808,3716273414,1672669399,1672671194,1795
7508,3855602893,3716258994,1672600758,1672603130,2372
7626,3668898102,3793389510,1672641310,1672643538,2228
7951,3533827120,3520706195,1672647135,1672649867,2732
7510,3855424474,3344019610,1672664167,1672664337,170
7766,3505098372,3433804879,1672653170,1672653429,259
7950,3806545488,3756601594,1672683896,1672683993,97
7894,3774339795,3385763781,1672622437,1672623970,1533
7511,3411618230,3477375368,1672699608,1672700558,950
7768,3391915886,3888559320,1672541822,1672541906,84
7484,3880285638,3517509185,1672614308,1672617617,3309
7645,3229058858,3737051610,1672535469,1672536384,915
7686,3365830990,3916289176,1672558578,1672558645,67
7565,3399052055,3778341199,1672688130,1672691044,2914
7781,3774580701,3487171044,1672613407,1672613499,92
7652,3432689543,3391915886,1672669103,1672672431,3328
7535,3513956646,3505477652,1672560621,1672561748,1127
7755,3779740455,3617734118,1672644345,1672646962,2617
7906,3433804879,3513201436,1672655187,1672656122,935
7848,3683766533,3520756859,1672564214,1672565013,799
7892,3519654779,3338703270,1672695722,1672698995,3273
7756,3887270940,3716537575,1672625249,1672626996,1747
7698,3515284591,3755392666,1672563661,1672567134,3473
7704,3772884106,3404058699,1672571453,1672574153,2700
7493,3297463265,3736592744,1672699194,1672701653,2459
7812,3471220483,3420432297,1672611185,1672613066,1881
7808,3509773875,3778549126,1672635070,1672637569,2499
7597,3774127586,3224716315,1672698616,1672699692,1076
7879,3448855696,3505638204,1672537432,1672538749,1317
7799,3776513891,3236102733,1672567379,1672570377,2998
7827,3420432297,3365942576,1672575708,1672577467,1759
7706,3736625083,3370636709,1672652279,1672653026,747
7957,3793086311,3606812411,1672626769,1672630091,3322
7688,3713808837,3772053179,1672624510,1672626673,2163
7980,3607178184,3397418363,1672563271,1672566359,3088
7727,3500199935,3757151210,1672637888,1672638691,803
7786,3899371911,3792032359,1672548061,1672550089,2028
7583,3903307060,3373384732,1672654329,1672655683,1354
7862,3505702787,3662180254,1672636972,1672639721,2749
7498,3520751702,3970117174,1672591646,1672592643,997
7967,3666457294,3783509527,1672589519,1672591740,2221
7736,3439023335,3806545488,1672633947,1672637134,3187
7662,3519069599,3730517636,1672589210,1672589827,617
7638,3613683164,3370636709,1672677540,1672678198,658
7663,3515723720,3374559242,1672657406,1672659539,2133
7503,3314836094,3426325549,1672686506,1672686795,289
7983,3501730685,3883042241,1672544724,1672545336,612
7881,3304625412,3682061100,1672542907,1672543161,254
7974,3518932404,3429856982,1672640873,1672642639,1766
7557,3716168623,3882242815,1672627424,1672628274,850
7651,3774125065,3760267716,1672685660,1672689196,3536
7539,3634786711,3755392666,1672565941,1672569125,3184
7844,3396285984,3516465662,1672669728,1672670452,724
7681,3711265369,3972709319,1672599999,1672601772,1773
7640,3909238838,3757562897,1672666101,1672667949,1848
7711,3505145247,3224716315,1672652670,1672655265,2595
7649,3391915886,3505702787,1672675501,1672676794,1293
7883,3713370078,3483164654,1672683829,1672684320,491
7795,3737154119,3224058172,1672549559,1672552967,3408
7544,3688683847,3362000049,1672663672,1672663783,111
7657,3922275620,3209383861,1672680076,1672683217,3141
7510,3975287541,3517721725,1672567375,1672567473,98
7771,3664170666,3777983879,1672680447,1672682035,1588
7657,3835382117,3505649239,1672607738,1672609354,1616
7976,3510247121,3246596716,1672666143,1672669378,3235
7731,3774127586,3829232696,1672602613,1672604617,2004
7696,3880285638,3333896808,1672633762,1672636811,3049
7620,3356860407,3396086535,1672587234,1672588833,1599
7815,3735733948,3774010081,1672553315,1672555858,2543
7814,3473765852,3738274418,1672561861,1672564827,2966
7892,3466911760,3514128943,1672696221,1672697801,1580
7764,3318697153,3774793839,1672638047,1672638963,916
7490,3533137446,3755798867,1672585301,1672588553,3252
7935,3400804807,3510380060,1672692694,1672695490,2796
7783,3779976989,3511271692,1672702702,1672706229,3527
7699,3701995648,3774066725,1672677487,1672679659,2172
7923,3736419952,3415546117,1672672868,1672673986,1118
7847,3791901535,3244485293,1672669781,1672671423,1642
7565,3756451663,3770021824,1672659095,1672659939,844
7506,3716488385,3836573197,1672680179,1672681351,1172
7537,3280964728,3857349323,1672677289,1672678177,888
7767,3400918687,3608868877,1672593525,1672596499,2974
7570,3618045231,3510771358,1672637009,1672640087,3078
7943,3428006164,3337544549,1672669649,1672672536,2887
7658,3509604974,3511359172,1672672848,1672675149,2301
7569,3395152943,3394330287,1672703847,1672705578,1731
7825,3882997884,3701898991,1672566518,1672567492,974
7657,3731419510,3713808837,1672602469,1672604449,1980
7640,3516223597,3773120434,1672625685,1672625938,253
7766,3922275620,3483164654,1672534251,1672535106,855
7794,3496269445,3770101921,1672629441,1672631103,1662
7819,3505873261,3710344260,1672674451,1672676633,2182
7690,3515723720,3604539807,1672550516,1672551116,600
7928,3475396323,3500803339,1672578299,1672579667,1368
7735,3359239884,3510247121,1672682073,1672683686,1613
7747,3372883226,3533827120,1672679163,1672680174,1011
7975,3520190170,3533371364,1672659270,1672662229,2959
7941,3402943525,3517077106,1672599202,1672602200,2998
7754,3664170666,3511862351,1672693127,1672693276,149
7552,3817621391,3925620998,1672653287,1672654591,1304
7713,3505869747,3489217083,1672615433,1672618135,2702
7891,3826760240,3512567240,1672567462,1672570936,3474
7978,3809484172,3776948966,1672633762,1672634438,676
7683,3809059934,3757246925,1672531288,1672532849,1561
7782,3520706195,3500499542,1672568745,1672572226,3481
7702,3760893269,3515125508,1672557284,1672557673,389
7922,3487171044,3760183458,1672544434,1672544593,159
7820,3783206719,3534191820,1672592055,1672592855,800
7524,3734737881,3510969660,1672676061,1672676393,332
7618,3770824086,3515125508,1672581461,1672583570,2109
7814,3783126683,3418534998,1672536764,1672540039,3275
7825,3509773875,3826760240,1672580053,1672582701,2648
7634,3911245524,3500391167,1672541900,1672542104,204
7739,3605726278,3851190615,1672558586,1672560905,2319
7685,3235635976,3313564074,1672665507,1672666381,874
7820,3666553782,3783083229,1672561516,1672565071,3555
7872,3500805881,3513599775,1672631304,1672634431,3127
7852,3760509236,3917278625,1672616598,1672617290,692
7704,3520931254,3760598102,1672546653,1672548370,1717
7660,3774127586,3614238812,1672591349,1672594839,3490
7935,3500391167,3426325549,1672679651,1672681771,2120
7907,3777776687,3399911573,1672648188,1672651161,2973
7550,3757562897,3778341199,1672560012,1672563150,3138
7908,3483164654,3978115672,1672672092,1672672537,445
7906,3311761694,3311274543,1672577571,1672579700,2129
7603,3512349371,3430074045,1672541089,1672542526,1437
7585,3886298125,3855602893,1672572335,1672573114,779
7841,3311208440,3703013906,1672566595,1672567287,692
7828,3780609808,3201432789,1672551883,1672552309,426
7944,3249791738,3356860407,1672642067,1672644442,2375
7636,3703718151,3820354437,1672561597,1672562798,1201
7635,3201432789,3667680268,1672531654,1672533093,1439
7891,3304625412,3378092448,1672556965,1672559781,2816
7931,3916289176,3777806071,1672565159,1672567261,2102
7974,3509773875,3416427576,1672694298,1672695846,1548
7751,3249247700,3383922351,1672695749,1672696682,933
7651,3518408774,3898995675,1672546646,1672549012,2366
7499,3293695955,3608868877,1672592822,1672593129,307
7654,3716746253,3303705369,1672610814,1672612396,1582
7632,3533827120,3244389794,1672543765,1672546458,2693
7708,3780813786,3280964728,1672651489,1672652248,759
7977,3827626797,3703275621,1672615870,1672616999,1129
7766,3716165213,3703275621,1672615413,1672615999,586
7816,3883861463,3518791447,1672568539,1672569270,731
7980,3311274543,3857349323,1672612769,1672613248,479
7704,3510244400,3918584946,1672631019,1672632129,1110
7568,3277605882,3357483218,1672663395,1672666105,2710
7585,3774466457,3511359172,1672561648,1672564556,2908
7709,3516065852,3777514571,1672634424,1672635150,726
7785,3802367797,3914290246,1672685666,1672686054,388
7727,3505219850,3909238838,1672579594,1672581486,1892
7746,3756966035,3922275416,1672563756,1672566130,2374
7503,3516011407,3370636709,1672592840,1672594385,1545
7611,3514987389,3520709480,1672680906,1672682400,1494
7753,3519700826,3489962019,1672545564,1672545907,343
7954,3910886626,3471220483,1672660553,1672662256,1703
7588,3466911760,3904408902,1672587210,1672589567,2357
7903,3244436890,3774339795,1672635196,1672637481,2285
7580,3505219850,3777717988,1672605311,1672607939,2628
7843,3501486692,3820354437,1672597127,1672599365,2238
7780,3883085535,3520183192,1672621759,1672622595,836
7644,3512720680,3365942576,1672636145,1672637505,1360
7917,3756451663,3448855696,1672621853,1672623381,1528
7582,3757682496,3883551721,1672656599,1672659936,3337
7980,3512567240,3909238838,1672642401,1672643009,608
7547,3533927138,3918056059,1672564696,1672568011,3315
7561,3501184421,3734828619,1672561402,1672562912,1510
7653,3783429780,3500803339,1672655251,1672655931,680
7807,3348261553,3311152102,1672694797,1672695143,346
7867,3783429780,3392121505,1672656117,1672657885,1768
7785,3811171116,3793338102,1672651106,1672651993,887
7592,3490191091,3757246925,1672613156,1672615930,2774
7595,3701534009,3978115672,1672665306,1672666504,1198
7508,3236102733,3757455053,1672698686,1672698782,96
7589,3501483568,3475795792,1672567149,1672567792,643
7699,3478194807,3518360734,1672533397,1672534963,1566
7622,3534553510,3430074045,1672614170,1672615394,1224
7853,3737154119,3223789409,1672648602,1672651143,2541
7968,3500658339,3206603608,1672676394,1672677555,1161
7760,3200691026,3755436115,1672623822,1672624116,294
7686,3774119563,3249791738,1672668390,1672671488,3098
7488,3475795792,3448855696,1672649583,1672652404,2821
7512,3774195321,3777079686,1672702601,1672703291,690
7971,3509453566,3783779671,1672649115,1672649456,341
7562,3736790081,3780503655,1672594765,1672598183,3418
7810,3293695955,3715492942,1672666518,1672668861,2343
7644,3755511676,3822654369,1672615154,1672618460,3306
7733,3904775198,3701146057,1672644339,1672644440,101
7952,3716537575,3802367797,1672594800,1672596752,1952
7615,3902278226,3238712269,1672650783,1672651542,759
7487,3505904952,3738274418,1672656047,1672656606,559
7644,3505201246,3500060260,1672640234,1672641530,1296
7487,3898995675,3755739653,1672619559,1672621251,1692
7493,3916289176,3855000166,1672636268,1672637880,1612
7969,3500803339,3979339287,1672687673,1672689444,1771
7632,3478194807,3454042520,1672644738,1672647816,3078
7696,3339907603,3500199935,1672666938,1672667590,652
7849,3311603601,3512837326,1672677123,1672678383,1260
7916,3779218771,3500487333,1672634328,1672636561,2233
7740,3511841857,3922275620,1672659807,1672660332,525
7842,3778305740,3298288268,1672575848,1672576618,770
7852,3231056870,3756966035,1672658810,1672660059,1249
7636,3716197887,3352603894,1672693785,1672694545,760
7885,3511435497,3783239924,1672682108,1672684501,2393
7706,3792177074,3510594211,1672555963,1672558472,2509
7567,3520183192,3811694763,1672659652,1672663112,3460
7740,3811171116,3534729133,1672620275,1672620740,465
7489,3714504419,3209027249,1672548844,1672549214,370
7568,3337544549,3617734118,1672633530,1672634684,1154
7899,3512969370,3514128943,1672610509,1672612582,2073
7868,3484995752,3777455223,1672620326,1672622218,1892
7694,3511359172,3533748232,1672649980,1672650515,535
7732,3500729955,3278365525,1672604027,1672604446,419
7585,3291227780,3701190899,1672679778,1672681411,1633
7581,3500060260,3512969370,1672642658,1672645163,2505
7808,3517963492,3519912874,1672571127,1672572263,1136
7776,3628819436,3417970574,1672536776,1672537035,259
7592,3520165601,3792384220,1672579623,1672581240,1617
7713,3922275416,3738274418,1672700200,1672703768,3568
7591,3772544062,3311065516,1672537507,1672540292,2785
7692,3412980697,3514472925,1672679750,1672680774,1024
7548,3608633356,3359239884,1672684208,1672686752,2544
7662,3735733948,3668005723,1672611173,1672614277,3104
7629,3516223597,3311627628,1672564072,1672564198,126
7537,3505201246,3779528381,1672545547,1672545924,377
7511,3311324983,3399911573,1672594963,1672595217,254
7726,3914290246,3337544549,1672652377,1672655004,2627
7981,3402943525,3519700826,1672626540,1672627421,881
7655,3332072298,3500578848,1672558082,1672559497,1415
7740,3533025282,3400918687,1672621761,1672625277,3516
7573,3428674539,3516223597,1672652900,1672653244,344
7706,3772337814,3533193862,1672664095,1672666072,1977
7935,3715974031,3737079798,1672678250,1672681746,3496
7698,3792473331,3360506772,1672585659,1672588742,3083
7762,3520756859,3783429780,1672614053,1672616066,2013
7981,3454042520,3756451663,1672641996,1672643953,1957
7630,3520376528,3534702203,1672684810,1672685971,1161
7856,3428964059,3770851318,1672645011,1672647117,2106
7548,3716900301,3357483218,1672684360,1672686469,2109
7887,3428964059,3793389510,1672598327,1672599994,1667
7506,3394330287,3774045700,1672690585,1672692839,2254
7507,3839849341,3399911573,1672599869,1672602293,2424
7498,3760509236,3776800213,1672700394,1672703503,3109
7849,3624761861,3401627165,1672675482,1672676280,798
7885,3793086311,3311603601,1672665719,1672666864,1145
7533,3792473331,3755920131,1672629845,1672630817,972
7546,3780365428,3418728074,1672568840,1672569281,441
7665,3512540951,3311439795,1672693934,1672694646,712
7910,3501759100,3778980116,1672570551,1672572547,1996
7600,3514283243,3313564074,1672588120,1672589930,1810
7874,3774580701,3618045231,1672629992,1672632494,2502
7967,3931941795,3338703270,1672635171,1672636989,1818
7688,3287105466,3509352754,1672657374,1672658535,1161
7778,3757562897,3770021824,1672580114,1672581241,1127
7974,3500499542,3500994774,1672597893,1672600061,2168
7615,3922337974,3483164654,1672585840,1672588080,2240
7696,3484995752,3519700826,1672534227,1672535085,858
7837,3701146057,3475396323,1672681783,1672685064,3281
7981,3780609808,3550946908,1672537758,1672538439,681
7943,3514245078,3711973519,1672619343,1672622471,3128
7608,3791997875,3807987001,1672574298,1672575215,917
7745,3792253549,3882291183,1672576029,1672577640,1611
7513,3606987130,3760183458,1672695793,1672696064,271
7540,3666457294,3772309150,1672628549,1672629002,453
7824,3828432634,3517864478,1672631951,1672632229,278
7683,3362000049,3793086311,1672597273,1672599008,1735
7583,3311648200,3933210486,1672574797,1672575038,241
7798,3683766533,3367902229,1672538879,1672540060,1181
7815,3315583351,3427283336,1672689523,1672692278,2755
7618,3311415018,3701190899,1672696115,1672697026,911
7979,3972709319,3778308417,1672649454,1672651858,2404
7965,3855000166,3731419510,1672651884,1672653807,1923
7533,3734496778,3760992710,1672680168,1672680655,487
7774,3201324715,3851190615,1672634761,1672636910,2149
7955,3356860407,3736419952,1672685205,1672686848,1643
7888,3756027749,3855000166,1672605373,1672608496,3123
7756,3374559242,3780788622,1672640366,1672643719,3353
7875,3809059934,3533653428,1672561845,1672562255,410
7516,3512837326,3389115045,1672564754,1672566602,1848
7759,3517077106,3297463265,1672541152,1672542539,1387
7803,3360506772,3774556560,1672690644,1672691607,963
7795,3756453423,3509604974,1672595094,1672596624,1530
7785,3332072298,3637008488,1672561701,1672562647,946
7661,3505000737,3777455223,1672636665,1672638687,2022
7836,3509352754,3513201436,1672682794,1672684394,1600
7927,3662180254,3714504419,1672587531,1672587792,261
7859,3701178711,3385763781,1672590190,1672590550,360
7766,3755392666,3757151210,1672563451,1672563560,109
7830,3859663348,3247815299,1672648318,1672649417,1099
7587,3774338212,3477375368,1672676846,1672678566,1720
7874,3493507965,3339907603,1672570182,1672573075,2893
7872,3774066725,3412980697,1672545803,1672548775,2972
7493,3490191091,3791874383,1672556727,1672557136,409
7737,3500578848,3505201246,1672566056,1672569204,3148
7585,3916289176,3209383861,1672614727,1672614821,94
7578,3832902928,3311718847,1672599145,1672600786,1641
7816,3399052055,3352603894,1672678471,1672680879,2408
7717,3555214688,3937224533,1672656536,1672658810,2274
7703,3519654779,3517509185,1672552030,1672554593,2563
7957,3534492426,3770101921,1672581696,1672582004,308
7977,3882997884,3736786443,1672575907,1672578587,2680
7566,3500374658,3932051427,1672637945,1672638314,369
7840,3534729133,3201432789,1672652149,1672653291,1142
7953,3333896808,3713268590,1672667009,1672669191,2182
7631,3512683609,3417970574,1672582826,1672582903,77
7832,3510969660,3505883609,1672550428,1672551746,1318
7800,3615046771,3778780511,1672691094,1672693510,2416
7699,3391261292,3715981584,1672677204,1672679043,1839
7811,3774556560,3518260334,1672683405,1672685537,2132
7946,3533748232,3660493209,1672676972,1672677379,407
7546,3882997884,3760509236,1672659380,1672659971,591
7587,3509453566,3755511676,1672587852,1672588331,479
7715,3505873261,3515723720,1672693727,1672695453,1726
7657,3970117174,3773465237,1672685177,1672687732,2555
7492,3820354437,3520183192,1672578812,1672579767,955
7631,3534492426,3516039895,1672698033,1672701615,3582
7830,3774298222,3837094550,1672616333,1672617845,1512
7839,3826415738,3756027749,1672560139,1672561849,1710
7620,3364543015,3792177074,1672536213,1672537927,1714
7782,3200691026,3859525941,1672605142,1672605563,421
7781,3732481297,3278365525,1672597606,1672600689,3083
7585,3976633198,3703889596,1672679617,1672682275,2658
7532,3428674539,3400804807,1672648315,1672650497,2182
7681,3930797455,3432665384,1672556835,1672560010,3175
7864,3791020967,3505883609,1672537049,1672540582,3533
7980,3783083229,3417587765,1672687929,1672688388,459
7871,3738274418,3298288268,1672693943,1672696425,2482
7539,3783925755,3734828619,1672702048,1672703446,1398
7489,3534010629,3772714862,1672628009,1672630789,2780
7682,3420700674,3851190615,1672580055,1672583254,3199
7718,3510173870,3731419510,1672657399,1672659795,2396
7684,3777079686,3318166135,1672580668,1672582800,2132
7701,3287105466,3505859863,1672567518,1672569984,2466
7811,3500805881,3501692334,1672576110,1672576681,571
7747,3837094550,3520751702,1672631685,1672632063,378
7679,3500391167,3755625324,1672614914,1672616404,1490
7589,3500487333,3311627628,1672621571,1672623765,2194
7695,3882997884,3760893269,1672559952,1672560685,733
7696,3792288302,3367902229,1672549104,1672549951,847
7690,3360993964,3520888296,1672565349,1672568671,3322
7947,3489962019,3533025282,1672565223,1672567457,2234
7879,3812176780,3516514391,1672592847,1672594712,1865
7561,3828432634,3500803339,1672589843,1672591285,1442
7883,3901877072,3601879040,1672550153,1672552448,2295
7806,3783239924,3891751546,1672536990,1672538473,1483
7649,3734496778,3791115967,1672660139,1672663527,3388
7525,3976633198,3475258557,1672634582,1672637696,3114
7512,3756601594,3520012395,1672638361,1672641730,3369
7873,3711370563,3448855696,1672683760,1672686005,2245
7795,3606987130,3660493209,1672615489,1672616747,1258
7735,3515284591,3637008488,1672683085,1672684406,1321
7673,3857349323,3757455053,1672587913,1672589198,1285
7551,3500894271,3917278625,1672568884,1672570336,1452
7654,3337544549,3809916577,1672696394,1672697295,901
7817,3505145247,3737154119,1672662395,1672665695,3300
7902,3817316561,3361230905,1672668825,1672670045,1220
7604,3855937514,3472130842,1672687496,1672691021,3525
7848,3312664885,3246596716,1672655570,1672657061,1491
7886,3505973226,3634340855,1672690427,1672691340,913
7814,3409474775,3511198618,1672538368,1672538929,561
7924,3792288302,3777936328,1672588811,1672591223,2412
7974,3852391257,3783925755,1672647595,1672648933,1338
7563,3386707783,3520719611,1672533501,1672533826,325
7970,3711308224,3858918246,1672686756,1672689779,3023
7903,3915628728,3358871377,1672534212,1672536529,2317
7621,3703013906,3404384505,1672653510,1672656182,2672
7917,3514987389,3780503655,1672599870,1672601640,1770
7886,3920801189,3780365428,1672606336,1672606784,448
7546,3793086311,3837094550,1672598985,1672601963,2978
7749,3731419510,3624761861,1672606807,1672609648,2841
7576,3311324983,3383661227,1672620824,1672622368,1544
7573,3516039895,3924549929,1672618274,1672620116,1842
7820,3780639480,3244173074,1672666907,1672669894,2987
7705,3500499542,3668898102,1672611045,1672611975,930
7641,3703789494,3701274634,1672643066,1672644223,1157
7806,3510380060,3518260334,1672686307,1672688954,2647
7717,3730517636,3510703546,1672657172,1672658344,1172
7799,3857349323,3774010081,1672581751,1672585089,3338
7774,3760992710,3713808837,1672607980,1672610084,2104
7898,3738502357,3626156564,1672582174,1672582643,469
7813,3770851318,3715998609,1672692607,1672695380,2773
7902,3713349754,3505635228,1672557765,1672557875,110
7969,3793848402,3901990690,1672571052,1672571823,771
7640,3501759100,3505904952,1672650722,1672652769,2047
7820,3303705369,3772758337,1672566557,1672569416,2859
7906,3809916577,3516016437,1672572438,1672575449,3011
7893,3755436115,3394539273,1672591410,1672594866,3456
7729,3505362057,3552314511,1672626895,1672628671,1776
7677,3438645253,3505973226,1672569787,1672572015,2228
7748,3918247820,3519601612,1672542897,1672543179,282
7483,3914290246,3734737881,1672682568,1672686126,3558
7505,3481647420,3511332835,1672627318,1672629557,2239
7591,3485008994,3451432842,1672604598,1672606244,1646
7746,3922337974,3828624701,1672623564,1672624870,1306
7901,3660493209,3505098372,1672642637,1672643052,415
7873,3783429780,3358871377,1672608708,1672611264,2556
7805,3793286136,3733189298,1672624915,1672626861,1946
7559,3501364586,3715981584,1672649135,1672652295,3160
7690,3615046771,3701065786,1672687839,1672691086,3247
7551,3333896808,3800886801,1672666209,1672669555,3346
7621,3534191820,3516629436,1672565510,1672568733,3223
7862,3772309166,3800353779,1672687742,1672689799,2057
7623,3378092448,3770635361,1672694818,1672697300,2482
7785,3349613093,3383661227,1672564817,1672567374,2557
7525,3791901535,3346795719,1672655667,1672658396,2729
7568,3496269445,3510711755,1672616354,1672618118,1764
7880,3736786443,3520012395,1672611477,1672612336,859
7728,3792668962,3703013906,1672664298,1672666650,2352
7574,3298433163,3236102733,1672697978,1672700129,2151
7932,3229058858,3903307060,1672571291,1672571853,562
7917,3711308224,3755920131,1672636656,1672637132,476
7974,3520376528,3517864478,1672623137,1672623887,750
7790,3394539273,3519912874,1672647782,1672649023,1241
7891,3511170269,3703718151,1672672987,1672675900,2913
7719,3773120434,3806545488,1672589797,1672590172,375
7938,3634340855,3509604974,1672576601,1672577620,1019
7739,3298288268,3760267716,1672644806,1672646375,1569
7718,3311603601,3448855696,1672565441,1672567346,1905
7702,3783531004,3662180254,1672619926,1672622693,2767
7506,3500805881,3899204805,1672618363,1672621802,3439
7755,3792668962,3819727225,1672551511,1672553804,2293
7758,3716258994,3533827120,1672648691,1672652169,3478
7980,3755511676,3426325549,1672548778,1672552172,3394
7689,3223789409,3925402713,1672604143,1672605088,945
7806,3500894271,3513164386,1672536118,1672537635,1517
7776,3500729955,3826760240,1672686284,1672686421,137
7904,3685187183,3500803339,1672544820,1672547902,3082
7967,3793871337,3352603894,1672599830,1672602200,2370
7500,3793436995,3313541986,1672588450,1672591607,3157
7773,3517864478,3367029997,1672559732,1672560879,1147
7753,3509933351,3890149705,1672689018,1672692143,3125
7902,3780639480,3715339701,1672539755,1672541091,1336
7748,3314836094,3481502100,1672636894,1672640110,3216
7801,3373384732,3773978034,1672606738,1672608466,1728
7598,3510937904,3301107849,1672563632,1672566305,2673
7933,3737079798,3793389510,1672584385,1672587266,2881
7880,3713208927,3517255726,1672678711,1672681508,2797
7856,3778305740,3793627961,1672623085,1672625980,2895
7747,3407673904,3311065516,1672695287,1672697013,1726
7834,3429690204,3427283336,1672672452,1672674716,2264
7765,3613995936,3853018906,1672678650,1672682094,3444
7573,3512540951,3277669002,1672700200,1672702609,2409
7574,3835382117,3637008488,1672659640,1672660640,1000
7542,3307097200,3344019610,1672625287,1672627032,1745
7608,3420432297,3476232529,1672577455,1672577709,254
7931,3338703270,3607748895,1672618215,1672619576,1361
7719,3244485293,3415443558,1672564582,1672565940,1358
7878,3492478793,3235287260,1672686147,1672689147,3000
7739,3516716179,3373384732,1672653814,1672654125,311
7738,3734828619,3716746253,1672619016,1672622038,3022
7513,3520730271,3291227780,1672608025,1672608960,935
7974,3760509236,3778980116,1672584945,1672587334,2389
7590,3360743849,3313564074,1672656795,1672659920,3125
7739,3882997884,3738502357,1672610918,1672611325,407
7825,3501364586,3512217942,1672574403,1672574948,545
7693,3276640712,3777806071,1672654090,1672657306,3216
7669,3666507626,3713349754,1672666128,1672668716,2588
7565,3396285984,3429856982,1672686473,1672689666,3193
7661,3731106822,3500199935,1672545659,1672546761,1102
7839,3793470489,3478194807,1672643655,1672645561,1906
7553,3433804879,3805519285,1672586984,1672587680,696
7919,3247428249,3510937904,1672555602,1672558875,3273
7485,3520376528,3517963492,1672533448,1672533885,437
7555,3311090974,3510247121,1672614041,1672614574,533
7586,3311871871,3505859863,1672649564,1672649685,121
7879,3773205565,3614238812,1672545993,1672547487,1494
7585,3514245078,3973560347,1672553323,1672555793,2470
7861,3701274634,3711265369,1672619916,1672622616,2700
7529,3807987001,3713969578,1672667780,1672669225,1445
7609,3922337974,3533280269,1672692676,1672693516,840
7593,3494290908,3500365158,1672578466,1672581786,3320
7734,3313564074,3247780536,1672561359,1672562084,725
7604,3496051529,3501184421,1672612992,1672615494,2502
7550,3519556068,3208844525,1672545077,1672545593,516
7483,3713969578,3311718847,1672566697,1672569472,2775
7559,3858918246,3618045231,1672544535,1672546401,1866
7543,3778266283,3338367113,1672635726,1672638998,3272
7737,3937224533,3500487333,1672577029,1672579921,2892
7747,3511163800,3472130842,1672670243,1672670653,410
7785,3713208927,3420700674,1672698291,1672701673,3382
7799,3734496778,3809484172,1672606033,1672608592,2559
7706,3473765852,3713894336,1672556270,1672558659,2389
7973,3774580701,3533626375,1672629356,1672631321,1965
7563,3500803339,3307097200,1672629963,1672633137,3174
7527,3733891182,3475251781,1672659834,1672661212,1378
7762,3384240055,3772758337,1672681827,1672682731,904
7826,3827377568,3817621391,1672587206,1672590321,3115
7899,3770851318,3629547065,1672623611,1672623834,223
7676,3516606733,3666553782,1672624075,1672624405,330
7659,3400918687,3921211276,1672598174,1672598701,527
7821,3976633198,3318697153,1672591697,1672591839,142
7544,3774339795,3311274543,1672617750,1672621017,3267
7643,3972364603,3710408395,1672700340,1672700851,511
7670,3792384220,3666506258,1672569945,1672570562,617
7631,3518360734,3451432842,1672647237,1672648204,967
7803,3793753089,3432665384,1672626276,1672626991,715
7713,3922275416,3773429448,1672574933,1672575552,619
7809,3760294205,3772746272,1672637313,1672640465,3152
7799,3633420270,3899204805,1672683091,1672683555,464
7899,3451432842,3621497531,1672600292,1672602778,2486
7856,3793753089,3855937514,1672657210,1672659251,2041
7634,3777790718,3533653428,1672576730,1672577425,695
7545,3610695419,3774338212,1672591247,1672592561,1314
7553,3827626797,3480687894,1672684048,1672684196,148
7662,3660493209,3883312122,1672604031,1672606961,2930
7959,3778549126,3344019610,1672540172,1672540932,760
7548,3559110998,3713268590,1672611002,1672612831,1829
7653,3703735129,3512837326,1672623968,1672625251,1283
7807,3338703270,3533137446,1672561811,1672562095,284
7513,3349613093,3379256399,1672651538,1672653486,1948
7852,3607178184,3458539365,1672626770,1672627119,349
7914,3783245561,3783083229,1672646561,1672648912,2351
7746,3338367113,3520183192,1672640813,1672641858,1045
7896,3668005723,3911245524,1672560566,1672563803,3237
7936,3756528686,3774050956,1672696017,1672697055,1038
7630,3880310724,3534492426,1672702076,1672705517,3441
7617,3511350608,3418728074,1672647250,1672648845,1595
7875,3755920131,3399911573,1672551551,1672553523,1972
7494,3424922204,3509773875,1672604352,1672605004,652
7615,3392121505,3277669002,1672629698,1672633235,3537
7722,3360743849,3509604974,1672642357,1672645933,3576
7913,3519556068,3777623166,1672601184,1672602850,1666
7622,3883551721,3627937312,1672590675,1672591543,868
7577,3800886801,3247428249,1672599986,1672601465,1479
7506,3755943611,3312829208,1672543230,1672546098,2868
7720,3776800213,3512683609,1672701637,1672704231,2594
7715,3509604974,3736625083,1672656391,1672657500,1109
7902,3533827120,3501198706,1672664667,1672668241,3574
7761,3792253549,3289061738,1672628237,1672630052,1815
7775,3829232696,3713808837,1672623467,1672626295,2828
7961,3471220483,3519803045,1672607725,1672610704,2979
7883,3500658339,3713969578,1672603782,1672606832,3050
7508,3407725581,3774268456,1672693788,1672696709,2921
7592,3755511676,3773950140,1672654357,1672656983,2626
7962,3302626661,3660493209,1672611515,1672612496,981
7768,3881477378,3757682496,1672566300,1672567276,976
7567,3512166013,3200691026,1672641974,1672644837,2863
7962,3853018906,3505201246,1672573642,1672574017,375
7489,3773598056,3617734118,1672620297,1672623002,2705
7935,3367902229,3510969660,1672626186,1672626634,448
7798,3361230905,3826633236,1672534517,1672536221,1704
7683,3895562476,3432665384,1672545642,1672549057,3415
7888,3760183458,3815508790,1672654827,1672655678,851
7511,3489545239,3773205565,1672546037,1672548104,2067
7678,3606987130,3637008488,1672595192,1672597761,2569
7893,3412825109,3776338577,1672592745,1672594760,2015
7571,3774268456,3792883665,1672586627,1672587691,1064
7800,3682061100,3683959482,1672594039,1672596848,2809
7491,3774010081,3407673904,1672668434,1672669648,1214
7507,3516514391,3401627165,1672547160,1672549984,2824
7782,3459030804,3228165483,1672559493,1672559651,158
7601,3918056059,3973560347,1672692766,1672694822,2056
7584,3235635976,3298433163,1672555661,1672558792,3131
7942,3483949762,3973560347,1672683973,1672684371,398
7697,3621810464,3773120434,1672546301,1672546938,637
7505,3383922351,3550946908,1672587858,1672589547,1689
7734,3755511676,3716843669,1672577334,1672580432,3098
7642,3883551721,3777790718,1672618037,1672618339,302
7515,3811694763,3774127586,1672584089,1672584498,409
7552,3772337814,3373384732,1672629963,1672633373,3410
7777,3388372715,3458539365,1672627512,1672629658,2146
7571,3713630656,3427219654,1672569744,1672570096,352
7791,3793338102,3534488837,1672545473,1672548321,2848
7724,3701498253,3710569131,1672600777,1672601695,918
7720,3279721246,3757682496,1672674516,1672675484,968
7669,3930791338,3756453423,1672680261,1672681817,1556
7915,3234541252,3505135325,1672544465,1672546380,1915
7675,3458539365,3823600322,1672606877,1672607700,823
7541,3792032359,3714197325,1672573245,1672575863,2618
7914,3369998498,3513454145,1672595108,1672596766,1658
7539,3713268590,3703889596,1672702122,1672705619,3497
7497,3534010629,3391915886,1672669636,1672671429,1793
7488,3817621391,3277669002,1672702439,1672702933,494
7967,3513599775,3828432634,1672656454,1672659815,3361
7867,3627937312,3228165483,1672592219,1672594286,2067
7915,3714488548,3467773920,1672588964,1672590397,1433
7491,3627937312,3664517356,1672680662,1672681485,823
7811,3298288268,3791657947,1672692833,1672694956,2123
7661,3716197887,3276993580,1672545618,1672549208,3590
7515,3518014636,3621810464,1672531671,1672533265,1594
7618,3899371911,3899204805,1672656389,1672657898,1509
7520,3372883226,3429690204,1672555274,1672557678,2404
7788,3736592744,3501198706,1672619736,1672622643,2907
7733,3533137446,3483949762,1672682086,1672683058,972
7630,3485375593,3314836094,1672567535,1672570216,2681
7723,3501364586,3369998498,1672663467,1672664353,886
7522,3443698222,3533137446,1672542500,1672545674,3174
7487,3201432789,3520719611,1672590743,1672591601,858
7713,3778305740,3683766533,1672596878,1672598940,2062
7552,3364543015,3791334389,1672567430,1672570174,2744
7538,3777623166,3439023335,1672608960,1672609417,457
7567,3209551760,3459030804,1672590979,1672591671,692
7857,3505649239,3311415018,1672583118,1672586013,2895
7745,3808324264,3805342762,1672700103,1672702605,2502
7660,3501730685,3783705817,1672578959,1672579840,881
7783,3827626797,3889750851,1672641279,1672643654,2375
7881,3710344260,3714962248,1672644794,1672646798,2004
7498,3399052055,3500060260,1672561513,1672561926,413
7753,3512142794,3825229501,1672584142,1672587062,2920
7863,3703955926,3446948848,1672536927,1672537434,507
7793,3760489031,3505098372,1672533581,1672534825,1244
7848,3501184421,3476232529,1672642512,1672642930,418
7618,3249401741,3783239924,1672671289,1672673853,2564
7921,3773755137,3666553782,1672684307,1672687420,3113
7903,3629547065,3817621391,1672567272,1672569901,2629
7725,3501730685,3633420270,1672688337,1672691304,2967
7639,3606186086,3792668962,1672541081,1672541576,495
7739,3244485293,3500060260,1672659284,1672661610,2326
7584,3757447189,3287105466,1672678309,1672680659,2350
7770,3883861463,3926700506,1672674811,1672675250,439
7539,3791594391,3519803045,1672620938,1672622385,1447
7708,3607178184,3774501422,1672553794,1672555451,1657
7505,3432689543,3772359096,1672684714,1672684854,140
7576,3513956646,3852595551,1672579570,1672582419,2849
7852,3510594211,3420432297,1672663559,1672664356,797
7501,3716746253,3811694763,1672679166,1672681050,1884
7521,3667680268,3432665384,1672668208,1672669593,1385
7785,3391261292,3411618230,1672647246,1672650709,3463
7655,3701534009,3383922351,1672579315,1672580823,1508
7896,3898995675,3828365570,1672695443,1672696257,814
7862,3510126867,3736786443,1672570687,1672570928,241
7929,3552314511,3511163800,1672678523,1672680953,2430
7704,3307512479,3501198706,1672576676,1672579284,2608
7774,3779528381,3914259449,1672562996,1672564358,1362
7573,3519601612,3933210486,1672603314,1672606597,3283
7968,3756623396,3485008994,1672622217,1672622368,151
7775,3533653428,3515151980,1672583636,1672584411,775
7895,3379589402,3396285984,1672697841,1672701304,3463
7619,3755881905,3501759100,1672682926,1672684412,1486
7905,3774066725,3811694763,1672619026,1672619375,349
7599,3418728074,3832902928,1672593821,1672596957,3136
7487,3839849341,3500060260,1672619449,1672620701,1252
7855,3533827120,3206254161,1672535341,1672537991,2650
7674,3800886801,3772578994,1672635595,1672637308,1713
7746,3605726278,3914290246,1672565670,1672567896,2226
7829,3792384220,3391915886,1672625571,1672627205,1634
7821,3505098372,3735319397,1672533453,1672536579,3126
7699,3552314511,3805342762,1672577962,1672578564,602
7612,3800353779,3244173074,1672590269,1672591493,1224
7982,3926700506,3351554343,1672652007,1672654993,2986
7523,3533369198,3500391167,1672594719,1672596600,1881
7709,3534424200,3365614305,1672697083,1672699425,2342
7509,3809059934,3302626661,1672603844,1672604406,562
7896,3778341199,3420700674,1672588356,1672589337,981
7983,3639847263,3774366875,1672642493,1672644937,2444
7906,3716273414,3716258994,1672605095,1672608417,3322
7977,3424922204,3516011407,1672639100,1672641510,2410
7646,3918056059,3427283336,1672660586,1672663266,2680
7908,3505203158,3667680268,1672657351,1672658408,1057
7759,3904775198,3346327502,1672665328,1672667167,1839
7858,3517476351,3430504438,1672650750,1672651742,992
7702,3443698222,3777806071,1672555821,1672559138,3317
7730,3311415018,3736786443,1672654732,1672656076,1344
7701,3889750851,3793848402,1672640930,1672643544,2614
7886,3534313900,3815508790,1672648696,1672649516,820
7658,3778108318,3883551721,1672602157,1672605621,3464
7824,3774005526,3732481297,1672652272,1672652687,415
7716,3811694763,3378092448,1672626187,1672629726,3539
7601,3701898991,3501184421,1672608050,1672609919,1869
7621,3533626375,3516960534,1672684667,1672684771,104
7663,3511350608,3209027249,1672657227,1672660398,3171
7584,3475258557,3716273414,1672535668,1672538729,3061
7858,3417587765,3736625083,1672531333,1672531998,665
7678,3351008918,3776066388,1672636028,1672637601,1573
7855,3779976989,3925620998,1672691580,1672694114,2534
7791,3388637594,3510594211,1672618503,1672619638,1135
7550,3600647945,3976633198,1672596030,1672597401,1371
7588,3819727225,3772746272,1672623059,1672623137,78
7545,3773598056,3412980697,1672664709,1672666505,1796
7779,3774010081,3533827120,1672698784,1672700034,1250
7606,3500229033,3206603608,1672665902,1672667610,1708
7582,3388637594,3777929708,1672587792,1672590755,2963
7634,3755872268,3509634629,1672680970,1672681605,635
7789,3484995752,3518408774,1672564832,1672565277,445
7511,3770763956,3511198618,1672674060,1672674204,144
7669,3318166135,3624761861,1672542005,1672542524,519
7771,3757602960,3701534009,1672670349,1672673479,3130
7980,3518669703,3514719601,1672666642,1672668852,2210
7588,3756601594,3776338577,1672626016,1672627204,1188
7711,3912262917,3412980697,1672682345,1672684635,2290
7557,3510937904,3809484172,1672703007,1672706535,3528
7954,3777936328,3417587765,1672675543,1672676798,1255
7909,3778308417,3783196518,1672613204,1672614965,1761
7867,3760569731,3666506258,1672534484,1672536114,1630
7555,3278365525,3501198706,1672636248,1672638475,2227
7800,3374559242,3809484172,1672544840,1672546153,1313
7614,3388637594,3660493209,1672699333,1672700328,995
7942,3519912874,3517255726,1672614561,1672617797,3236
7884,3806545488,3232962003,1672681301,1672683815,2514
7597,3760492950,3477375368,1672657857,1672658751,894
7511,3344364444,3404058699,1672556565,1672558101,1536
7525,3520719611,3510711755,1672634627,1672637762,3135
7827,3416427576,3348261553,1672544439,1672547657,3218
7881,3520719611,3313564074,1672564540,1672564823,283
7831,3737051610,3979339287,1672700021,1672702158,2137
7975,3701065786,3601879040,1672557326,1672559228,1902
7882,3519912874,3533927138,1672544504,1672544708,204
7894,3716835696,3534702203,1672598047,1672599360,1313
7551,3294803686,3783083229,1672622943,1672626348,3405
7817,3772544062,3533927138,1672654243,1672655709,1466
7665,3939952128,3346327502,1672660509,1672663189,2680
7616,3370752401,3666553782,1672616877,1672618306,1429
7760,3713268590,3277669002,1672689629,1672692121,2492
7931,3773598056,3773755137,1672566461,1672567875,1414
7662,3776338577,3972364603,1672541741,1672543339,1598
7940,3918674986,3512349371,1672610763,1672611004,241
7835,3307097200,3379256399,1672596366,1672597951,1585
7739,3244389794,3760489031,1672684580,1672686268,1688
7522,3428674539,3516909237,1672642697,1672645736,3039
7812,3817621391,3534488837,1672677400,1672677532,132
7746,3360743849,3244436890,1672646526,1672649346,2820
7771,3882291183,3792177074,1672619431,1672621905,2474
7834,3792902982,3426325549,1672646530,1672648930,2400
7624,3516980378,3783083229,1672583066,1672586402,3336
7485,3703955926,3273500349,1672670256,1672671229,973
7540,3776513891,3903009525,1672630072,1672630505,433
7775,3517509185,3715998609,1672629640,1672632222,2582
7722,3244485293,3625274012,1672633392,1672635596,2204
7847,3668898102,3316222192,1672564200,1672566023,1823
7538,3505219850,3515723720,1672536375,1672538568,2193
7955,3895562476,3608633356,1672573358,1672574176,818
7561,3627937312,3827626797,1672655802,1672658419,2617
7723,3378436155,3518791447,1672649372,1672651687,2315
7957,3826633236,3510126867,1672673129,1672674822,1693
7811,3773950140,3500729955,1672677186,1672678393,1207
7876,3501601840,3384240055,1672625452,1672626080,628
7628,3736592744,3613683164,1672587724,1672588664,940
7493,3200198928,3714474557,1672624188,1672625713,1525
7553,3815508790,3770021824,1672679748,1672682465,2717
7582,3554917400,3428964059,1672630562,1672633884,3322
7721,3496051529,3774066725,1672560043,1672561898,1855
7687,3792032359,3778305740,1672611187,1672611496,309
7870,3489217083,3783239924,1672693560,1672695847,2287
7698,3815508790,3891751546,1672544536,1672548127,3591
7820,3533626375,3715974031,1672581067,1672582364,1297
7920,3772758337,3311761694,1672595585,1672598915,3330
7615,3889750851,3664170666,1672578684,1672582027,3343
7816,3703735129,3534424200,1672537367,1672540967,3600
7578,3224058172,3880310724,1672578121,1672579870,1749
7711,3772337814,3417970574,1672547983,1672548148,165
7689,3779036831,3500805881,1672557795,1672558527,732
7854,3809484172,3710098970,1672603422,1672604487,1065
7923,3792032359,3608868877,1672653052,1672653236,184
7747,3519601612,3773978034,1672660481,1672663622,3141
7875,3760598102,3774125065,1672681961,1672682050,89
7799,3428964059,3885897503,1672587913,1672588093,180
7933,3519428855,3311648200,1672671459,1672674623,3164
7769,3888559320,3611150562,1672639606,1672640008,402
7495,3421836608,3779629905,1672647208,1672650275,3067
7862,3505201246,3311627628,1672619713,1672623029,3316
7978,3471220483,3311154569,1672619715,1672622237,2522
7826,3511312803,3244485293,1672550176,1672553653,3477
7713,3610348516,3534424200,1672658684,1672659348,664
7831,3501483568,3778308417,1672591642,1672592817,1175
7875,3534191820,3351554343,1672551732,1672552059,327
7921,3774298222,3517255726,1672652704,1672655886,3182
7729,3889232789,3822654369,1672654179,1672656615,2436
7945,3271938399,3774204963,1672590908,1672591176,268
7955,3813052709,3770078063,1672658709,1672662235,3526
7755,3778341199,3710098970,1672549158,1672549460,302
7957,3716488385,3520756859,1672609465,1672612281,2816
7505,3637008488,3511198618,1672685115,1672686183,1068
7503,3483164654,3475251781,1672674264,1672674515,251
7788,3511332835,3780365428,1672624935,1672626030,1095
7956,3808324264,3835382117,1672555064,1672557360,2296
7599,3505869747,3489217083,1672567379,1672570505,3126
7786,3511170269,3378686918,1672574582,1672577717,3135
7733,3816853177,3912262917,1672585564,1672586500,936
7833,3711262377,3516629436,1672579575,1672581850,2275
7763,3715339701,3973560347,1672695464,1672698718,3254
7516,3770851318,3792883665,1672690466,1672691838,1372
7960,3713644518,3360743849,1672680883,1672682695,1812
7617,3342131135,3516960534,1672672129,1672672275,146
7557,3228165483,3882242815,1672640147,1672642854,2707
7946,3318166135,3476232529,1672569530,1672572038,2508
7933,3501759100,3777790718,1672673647,1672676175,2528
7776,3713808837,3481647420,1672639882,1672642831,2949
7888,3912262917,3244485293,1672655324,1672656602,1278
7651,3512540951,3633420270,1672654431,1672655731,1300
7945,3234362962,3231056870,1672692851,1672693310,459
7511,3206593906,3370752401,1672697719,1672698923,1204
7733,3683959482,3777776687,1672544494,1672547132,2638
7806,3352603894,3409474775,1672591593,1672592275,682
7784,3475396323,3880285638,1672581821,1672584719,2898
7576,3889232789,3365614305,1672685622,1672688409,2787
7570,3823600322,3736229191,1672619906,1672621763,1857
7856,3489217083,3314836094,1672661889,1672664740,2851
7510,3249247700,3480687894,1672578701,1672580411,1710
7903,3465202715,3399535232,1672641798,1672645385,3587
7715,3505635228,3505219850,1672583384,1672583518,134
7752,3774045700,3516465662,1672675260,1672675743,483
7561,3385763781,3510937904,1672558095,1672561642,3547
7618,3801089989,3370752401,1672622141,1672625603,3462
7609,3427219654,3500658339,1672652460,1672654510,2050
7949,3360993964,3610695419,1672700217,1672703376,3159
7655,3792883665,3510244400,1672660786,1672661961,1175
7619,3505201246,3904775198,1672629590,1672630995,1405
7762,3755881905,3783429780,1672580229,1672582182,1953
7784,3783925755,3783509527,1672617156,1672619611,2455
7522,3617734118,3236102733,1672649593,1672650688,1095
7944,3756623396,3465202715,1672591077,1672591349,272
7647,3221899927,3520931254,1672585171,1672587633,2462
7923,3924549929,3917088658,1672597353,1672600623,3270
7793,3793470489,3512969370,1672606651,1672606732,81
7890,3420432297,3793286136,1672633054,1672634469,1415
7758,3510173870,3510711755,1672688629,1672688979,350
7758,3401627165,3714962248,1672536382,1672539597,3215
7935,3411618230,3429856982,1672624454,1672627171,2717
7939,3922275416,3931941795,1672684290,1672687749,3459
7837,3512540951,3520206212,1672569574,1672572537,2963
7808,3361230905,3760183458,1672610289,1672611233,944
7758,3224716315,3318166135,1672534381,1672534922,541
7717,3701111745,3715581279,1672618796,1672620126,1330
7632,3774066725,3516465662,1672586793,1672587399,606
7794,3505203158,3855424474,1672553469,1672555100,1631
7903,3517963492,3417587765,1672570808,1672573182,2374
7923,3428964059,3346327502,1672561070,1672561543,473
7880,3710408395,3515691540,1672638501,1672641043,2542
7513,3774466457,3519556068,1672692114,1672694527,2413
7963,3351008918,3280599164,1672532051,1672532498,447
7501,3710098970,3418728074,1672701518,1672702750,1232
7828,3432665384,3518408774,1672556674,1672557180,506
7945,3703441914,3736229191,1672554015,1672555451,1436
7549,3827377568,3979339287,1672547454,1672549956,2502
7962,3827377568,3286658957,1672607146,1672609860,2714
7724,3515394721,3777806071,1672593138,1672595020,1882
7771,3710569131,3783531004,1672588422,1672591978,3556
7815,3476232529,3701178711,1672657617,1672659217,1600
7726,3512349371,3978115672,1672636677,1672637678,1001
7678,3409474775,3209048907,1672700688,1672702909,2221
7565,3730517636,3773598056,1672556037,1672558622,2585
7669,3774125065,3909238838,1672619524,1672622888,3364
7649,3520206212,3660493209,1672644336,1672646177,1841
7970,3394539273,3454042520,1672666879,1672668827,1948
7488,3370752401,3777079686,1672625685,1672626766,1081
7944,3314245084,3792883665,1672690806,1672692133,1327
7782,3314245084,3312829208,1672697263,1672698031,768
7831,3377766165,3505904952,1672548115,1672549330,1215
7538,3515151980,3882242815,1672696579,1672698279,1700
7873,3311648200,3520165601,1672668301,1672669929,1628
7872,3829319703,3716258994,1672560843,1672562087,1244
7859,3370636709,3880285638,1672646473,1672649462,2989
7979,3714197325,3714474557,1672610320,1672611415,1095
7879,3917088658,3220716272,1672697745,1672698790,1045
7912,3518014636,3792384220,1672693432,1672695200,1768
7575,3223789409,3501486692,1672700882,1672703809,2927
7897,3533827120,3909606423,1672531432,1672534497,3065
7794,3534488837,3513201436,1672603064,1672604919,1855
7645,3918674986,3688683847,1672570037,1672570892,855
7842,3714474557,3710408395,1672628986,1672629464,478
7883,3817316561,3404384505,1672597435,1672600811,3376
7583,3200691026,3926700506,1672633707,1672635081,1374
7626,3783239924,3804870229,1672574961,1672578121,3160
7735,3509773875,3400918687,1672637579,1672640727,3148
7536,3394330287,3883861463,1672645634,1672648933,3299
7649,3757812939,3793470489,1672682230,1672684324,2094
7951,3806545488,3713808837,1672632067,1672632577,510
7555,3415546117,3634340855,1672672357,1672675109,2752
7868,3342131135,3505635228,1672663775,1672664073,298
7594,3533385867,3666507626,1672560695,1672562820,2125
7523,3715127362,3550946908,1672625410,1672627803,2393
7705,3731419510,3835382117,1672648941,1672651183,2242
7881,3634340855,3791020967,1672563482,1672565887,2405
7863,3516673015,3760893269,1672586606,1672587306,700
7622,3757602960,3826633236,1672554220,1672557024,2804
7768,3883042241,3242408357,1672666187,1672668981,2794
7723,3517255726,3713630656,1672645277,1672646407,1130
7518,3772309166,3912536808,1672702041,1672703820,1779
7755,3364543015,3500805881,1672567600,1672569193,1593
7663,3909331423,3636867411,1672583976,1672584963,987
7494,3853018906,3510594211,1672681339,1672682742,1403
7656,3518932404,3279721246,1672626940,1672629280,2340
7883,3714821932,3318166135,1672672261,1672673970,1709
7688,3979339287,3976390453,1672655565,1672657915,2350
7927,3629547065,3622054816,1672608396,1672611115,2719
7758,3534729133,3780828689,1672654826,1672658290,3464
7969,3407954858,3513164386,1672670018,1672672915,2897
7569,3925402713,3513201436,1672555092,1672556515,1423
7638,3288764520,3777120536,1672608405,1672610498,2093
7830,3388286531,3933210486,1672552184,1672553147,963
7498,3346327502,3378686918,1672585880,1672586026,146
7958,3755625324,3713208927,1672606997,1672607497,500
7845,3713268590,3701863557,1672682659,1672684404,1745
7697,3399535232,3518876135,1672621140,1672622236,1096
7911,3882242815,3888559320,1672553620,1672555440,1820
7713,3387966152,3605726278,1672606111,1672607733,1622
7662,3359910781,3244389794,1672645512,1672647695,2183
7486,3520165601,3772714862,1672641533,1672642561,1028
7836,3772544062,3793470489,1672622197,1672623370,1173
7816,3793470489,3606987130,1672664292,1672666630,2338
7948,3400804807,3855000166,1672630521,1672634038,3517
7717,3496051529,3711973519,1672672429,1672674100,1671
7631,3792473331,3911245524,1672677355,1672679721,2366
7880,3911159965,3600647945,1672696473,1672699119,2646
7856,3606812411,3770447408,1672679530,1672680335,805
7622,3534313900,3385763781,1672611592,1672614787,3195
7530,3378686918,3716258994,1672679177,1672680635,1458
7779,3773814927,3688418210,1672609403,1672612725,3322
7555,3735319397,3778266283,1672567916,1672570302,2386
7656,3201432789,3519428855,1672670963,1672671828,865
7823,3616944364,3682061100,1672583839,1672587182,3343
7686,3783239924,3514838220,1672552798,1672554499,1701
7680,3512540951,3510937904,1672688222,1672690280,2058
7944,3362000049,3517459919,1672695827,1672697256,1429
7818,3369998498,3793959750,1672689442,1672692351,2909
7803,3402943525,3783925755,1672693266,1672696833,3567
7967,3246596716,3780365428,1672537826,1672541369,3543
7568,3421127249,3901990690,1672605755,1672606367,612
7869,3511332835,3534191820,1672539047,1672539354,307
7817,3534313900,3715581279,1672654559,1672655499,940
7819,3930791338,3318697153,1672642513,1672643138,625
7788,3277939457,3791942683,1672680598,1672682027,1429
7536,3779629905,3634786711,1672572766,1672575994,3228
7616,3516016437,3912262917,1672609818,1672612011,2193
7673,3227457126,3935627557,1672563760,1672564933,1173
7919,3703275621,3380035798,1672542226,1672543345,1119
7510,3817621391,3418728074,1672537292,1672538961,1669
7952,3429690204,3311993075,1672674235,1672674692,457
7572,3828432634,3807987001,1672550485,1672552034,1549
7675,3918247820,3783705817,1672641176,1672641291,115
7880,3429690204,3662180254,1672699463,1672700945,1482
7504,3373384732,3777120536,1672636892,1672638540,1648
7855,3909331423,3446948848,1672674456,1672676585,2129
7633,3772309150,3223968713,1672669881,1672671006,1125
7937,3348261553,3715981584,1672639965,1672643003,3038
7524,3716258994,3297463265,1672685687,1672688901,3214
7857,3349613093,3534553510,1672566596,1672568514,1918
7667,3518163778,3500894271,1672612786,1672614735,1949
7570,3820354437,3346327502,1672606528,1672609903,3375
7527,3520756859,3465254146,1672594587,1672595169,582
7857,3494290908,3505201246,1672572998,1672573858,860
7678,3370752401,3777120536,1672540675,1672541979,1304
7939,3736786443,3792288302,1672561914,1672565451,3537
7696,3277605882,3509604974,1672611778,1672613008,1230
7738,3756027749,3666457294,1672643215,1672644632,1417
7533,3222521619,3520751702,1672655510,1672655866,356
7532,3318166135,3337544549,1672587065,1672588862,1797
7976,3736419952,3420432297,1672557031,1672559636,2605
7487,3778108318,3902383721,1672677231,1672679939,2708
7650,3816454165,3715339701,1672629735,1672632810,3075
7840,3634340855,3757455053,1672583744,1672585932,2188
7561,3889232789,3407673904,1672593262,1672594466,1204
7887,3501364586,3776066388,1672656120,1672658813,2693
7488,3311439795,3412980697,1672569011,1672571898,2887
7532,3372883226,3533385867,1672690430,1672692140,1710
7731,3776513891,3311065516,1672639645,1672642194,2549
7488,3516716179,3378092448,1672557525,1672560609,3084
7513,3828624701,3383922351,1672681090,1672683158,2068
7767,3777929708,3316222192,1672604454,1672605028,574
7915,3344364444,3757447189,1672687539,1672691014,3475
7814,3606186086,3417587765,1672638596,1672639516,920
7758,3624761861,3904775198,1672611589,1672613596,2007
7801,3792768129,3428964059,1672584865,1672587411,2546
7925,3778266283,3710344260,1672535121,1672536138,1017
7853,3607178184,3783126683,1672591526,1672593084,1558
7849,3517509185,3339907603,1672703695,1672705501,1806
7839,3501184421,3509907947,1672543369,1672544816,1447
7601,3903009525,3534313900,1672566492,1672567457,965
7609,3714197325,3714821932,1672660097,1672661131,1034
7724,3774793839,3505203158,1672666956,1672667388,432
7582,3731419510,3367902229,1672658921,1672661073,2152
7821,3839849341,3760598102,1672646851,1672650447,3596
7784,3519703355,3730517636,1672540033,1672541704,1671
7921,3364543015,3911159965,1672652066,1672653256,1190
7694,3222448362,3467773920,1672540165,1672543281,3116
7930,3818255890,3365830990,1672648087,1672648660,573
7934,3415546117,3792844210,1672619688,1672620617,929
7899,3500391167,3757447189,1672643231,1672645359,2128
7981,3515284591,3793338102,1672610994,1672613648,2654
7812,3235287260,3392121505,1672647894,1672649968,2074
7495,3518408774,3901990690,1672602723,1672605475,2752
7648,3774556560,3780503655,1672601141,1672602308,1167
7942,3756021689,3715127362,1672568484,1672569946,1462
7597,3314245084,3760183458,1672586807,1672588712,1905
7735,3774298222,3361230905,1672569771,1672570371,600
7759,3291227780,3483949762,1672680950,1672681286,336
7912,3780593036,3770553384,1672650995,1672653431,2436
7615,3396285984,3859525941,1672698467,1672701990,3523
7850,3533025282,3882242815,1672666208,1672667818,1610
7681,3792032359,3314836094,1672577602,1672579796,2194
7926,3770101921,3835382117,1672550138,1672551009,871
7719,3618873142,3760561634,1672696216,1672697833,1617
7857,3976633198,3791334389,1672658206,1672658658,452
7914,3402943525,3559110998,1672696888,1672698027,1139
7954,3883861463,3792768129,1672700939,1672703912,2973
7877,3618873142,3505000737,1672662968,1672664079,1111
7750,3791657947,3512837326,1672665092,1672665484,392
7658,3970117174,3682061100,1672679795,1672681163,1368
7873,3773598056,3247428249,1672536884,1672540275,3391
7756,3446948848,3778305740,1672616849,1672618844,1995
7625,3337544549,3465202715,1672659176,1672662423,3247
7527,3311415018,3337544549,1672671078,1672672727,1649
7846,3510247121,3511312803,1672699469,1672702141,2672
7771,3791874383,3513956646,1672565433,1672568566,3133
7800,3777514571,3496549058,1672625900,1672627067,1167
7516,3407954858,3777079686,1672678804,1672680203,1399
7961,3716165213,3688418210,1672683464,1672685300,1836
7619,3509634629,3429856982,1672671989,1672673133,1144
7972,3429690204,3915628728,1672555232,1672557926,2694
7532,3520719611,3910886626,1672539687,1672541114,1427
7983,3510380060,3510247121,1672673398,1672674038,640
7718,3517864478,3736592744,1672648320,1672649013,693
7947,3909606423,3616944364,1672546288,1672549470,3182
7621,3307097200,3500658339,1672629078,1672632332,3254
7922,3978105277,3475258557,1672559609,1672562243,2634
7922,3510703546,3509933351,1672702681,1672705802,3121
7596,3618873142,3760598102,1672676659,1672678725,2066
7835,3639847263,3772053179,1672676211,1672677338,1127
7581,3427219654,3512567240,1672573033,1672573365,332
7509,3517721725,3277669002,1672703493,1672705163,1670
7678,3891751546,3755920131,1672684517,1672685927,1410
7921,3628819436,3736625083,1672532931,1672534114,1183
7898,3365942576,3534488837,1672569657,1672570923,1266
7777,3703275621,3550946908,1672664042,1672667262,3220
7947,3500391167,3510857360,1672580176,1672583108,2932
7721,3302626661,3517864478,1672591255,1672594797,3542
7732,3899204805,3922275620,1672637254,1672637493,239
7724,3783429780,3533371364,1672699963,1672700922,959
7826,3515860749,3918674986,1672559254,1672560468,1214
7893,3978105277,3446948848,1672681489,1672681766,277
7945,3829232696,3500229033,1672631305,1672634628,3323
7842,3496549058,3774366875,1672685519,1672688379,2860
7644,3247780536,3783083229,1672552063,1672553506,1443
7830,3714504419,3505649239,1672669068,1672671416,2348
7830,3510594211,3783779671,1672662942,1672666377,3435
7607,3517459919,3500658339,1672697747,1672699325,1578
7765,3451432842,3902383721,1672633339,1672634294,955
7757,3793286136,3200691026,1672538283,1672539671,1388
7900,3627937312,3783239924,1672623562,1672624408,846
7979,3512720680,3791657947,1672536085,1672539492,3407
7862,3882291183,3715981584,1672531615,1672532054,439
7980,3731106822,3351554343,1672699052,1672701628,2576
7840,3373384732,3370752401,1672643607,1672646774,3167
7869,3895562476,3770763956,1672638284,1672641442,3158
7848,3311718847,3716488385,1672607523,1672610110,2587
7505,3778308417,3735733948,1672665211,1672667476,2265
7528,3278365525,3512510536,1672613005,1672614552,1547
7780,3922275416,3716197887,1672553746,1672557241,3495
7624,3888559320,3505347134,1672587763,1672589618,1855
7560,3280599164,3777455223,1672625949,1672626451,502
7740,3332072298,3770021824,1672688498,1672690274,1776
7847,3336742544,3666506258,1672616618,1672618747,2129
7976,3777929708,3280615985,1672680680,1672682553,1873
7920,3511170269,3715127362,1672681163,1672684003,2840
7723,3791957752,3716746253,1672628359,1672631354,2995
7700,3533653428,3837094550,1672545339,1672547966,2627
7504,3780609808,3711370563,1672671133,1672673402,2269
7980,3774793839,3827222533,1672642453,1672643000,547
7608,3415546117,3293695955,1672647649,1672650899,3250
7703,3703889596,3922275416,1672697028,1672698217,1189
7687,3334033993,3757161914,1672608091,1672609413,1322
7563,3736592744,3736592744,1672693253,1672693821,568
7526,3475258557,3516223597,1672645645,1672645792,147
7483,3809059934,3760598102,1672546475,1672549745,3270
7541,3344019610,3367902229,1672540943,1672542709,1766
7824,3634340855,3713370078,1672551699,1672552282,583
7502,3827377568,3513080274,1672573221,1672574729,1508
7673,3820354437,3287105466,1672540598,1672543451,2853
7637,3780503655,3424922204,1672698576,1672701337,2761
7847,3501483568,3509634629,1672661653,1672662553,900
7616,3318166135,3666506258,1672698277,1672700944,2667
7751,3500803339,3511350608,1672535530,1672535695,165
7575,3224716315,3777806071,1672570148,1672573741,3593
7947,3836573197,3552314511,1672596056,1672598469,2413
7963,3314836094,3776338577,1672548369,1672549603,1234
7845,3496051529,3500805881,1672582580,1672584639,2059
7959,3780365428,3852595551,1672611274,1672612679,1405
7542,3339907603,3972364603,1672628932,1672630070,1138
7850,3277605882,3517459919,1672595845,1672597141,1296
7697,3816454165,3284832486,1672539738,1672541539,1801
7483,3918247820,3518260334,1672552116,1672552394,278
7680,3312829208,3313564074,1672584064,1672584175,111
7547,3777936328,3811171116,1672641598,1672642307,709
7856,3511125626,3777623166,1672543778,1672544185,407
7561,3360743849,3757151210,1672628546,1672629217,671
7935,3285400528,3828432634,1672591210,1672594634,3424
7683,3755872268,3358871377,1672592349,1672593094,745
7810,3713644518,3714821932,1672702268,1672705141,2873
7539,3688683847,3827377568,1672600712,1672602435,1723
7538,3756424865,3823600322,1672608837,1672610415,1578
7940,3510247121,3356860407,1672613461,1672613628,167
7718,3710067113,3519152550,1672619686,1672620562,876
7784,3853018906,3374559242,1672587188,1672588531,1343
7697,3200691026,3369998498,1672690131,1672692974,2843
7487,3800886801,3903307060,1672631108,1672634468,3360
7873,3516223597,3772714862,1672577600,1672579664,2064
7748,3801089989,3755881905,1672653026,1672655401,2375
7581,3372883226,3770851318,1672557829,1672558286,457
7692,3501483568,3443698222,1672667611,1672670621,3010
7494,3391261292,3496051529,1672531925,1672534767,2842
7980,3755872268,3505973226,1672631122,1672632485,1363
7871,3501364586,3303751772,1672573796,1672577013,3217
7755,3904408902,3779740455,1672569287,1672570639,1352
7877,3418728074,3770763956,1672668792,1672672272,3480
7811,3834257412,3466911760,1672593636,1672595668,2032
7859,3221899927,3793627961,1672625257,1672626396,1139
7532,3396285984,3793627961,1672638781,1672639272,491
7848,3791020967,3792768129,1672587045,1672588158,1113
7885,3505962865,3312829208,1672666641,1672668643,2002
7796,3600647945,3313541986,1672629347,1672629822,475
7859,3777776687,3244485293,1672668845,1672669978,1133
7573,3711504540,3736786443,1672694566,1672697528,2962
7757,3473765852,3518014636,1672585980,1672589475,3495
7684,3510126867,3736419952,1672589288,1672592681,3393
7596,3387966152,3760561634,1672664306,1672665167,861
7571,3249401741,3774793839,1672659459,1672659651,192
7969,3385763781,3683766533,1672615027,1672618610,3583
7494,3405494240,3417970574,1672604179,1672607282,3103
7518,3779218771,3756027749,1672608575,1672609097,522
7725,3520706195,3518496488,1672654692,1672657095,2403
7557,3827222533,3818255890,1672630969,1672634141,3172
7567,3825229501,3505203158,1672692661,1672693045,384
7879,3713808837,3533385867,1672536647,1672539939,3292
7885,3276640712,3391915121,1672543019,1672545092,2073
7891,3792177074,3716273414,1672680643,1672682249,1606
7694,3417587765,3911159965,1672619728,1672621149,1421
7704,3809059934,3417587765,1672596439,1672598715,2276
7486,3833889105,3511125626,1672690924,1672691527,603
7575,3688683847,3825229501,1672535761,1672537523,1762
7650,3939952128,3606186086,1672658015,1672659478,1463
7788,3303705369,3501606184,1672647061,1672649506,2445
7962,3391915886,3791874383,1672643886,1672645857,1971
7575,3818255890,3428964059,1672624611,1672626782,2171
7571,3515394721,3890149705,1672676539,1672679562,3023
7796,3520730271,3855000166,1672579085,1672579186,101
7811,3534191820,3513080274,1672581224,1672581407,183
7758,3716165213,3774125065,1672601912,1672602723,811
7560,3777790718,3701274634,1672660039,1672660516,477
7936,3357483218,3501483568,1672680445,1672681830,1385
7568,3362000049,3467773920,1672563601,1672565147,1546
7815,3505649239,3792883665,1672680706,1672680923,217
7610,3520629279,3475396323,1672669617,1672670051,434
7796,3703223015,3510771358,1672575728,1672577402,1674
7729,3427283336,3735319397,1672600675,1672602716,2041
7562,3792844210,3481502100,1672637118,1672640293,3175
7777,3779218771,3777623166,1672591806,1672592490,684
7677,3887270940,3307512479,1672578690,1672582195,3505
7831,3903307060,3505000737,1672698248,1672698809,561
7542,3510247121,3731106822,1672674451,1672675448,997
7545,3481647420,3774520233,1672534998,1672536186,1188
7549,3716197887,3519912874,1672655506,1672657301,1795
7897,3518669703,3772884106,1672615686,1672617271,1585
7835,3311993075,3534702203,1672543191,1672545420,2229
7731,3755881905,3637008488,1672546570,1672549501,2931
7751,3396086535,3516673015,1672605146,1672605677,531
7969,3396086535,3518163778,1672690519,1672694057,3538
7819,3760294205,3827222533,1672683526,1672684580,1054
7721,3509907947,3533626375,1672689670,1672693125,3455
7538,3200691026,3550946908,1672651348,1672652345,997
7890,3664170666,3379256399,1672665952,1672669063,3111
7873,3774268456,3520751702,1672595673,1672596489,816
7878,3517864478,3432665384,1672630467,1672632973,2506
7923,3287105466,3713786889,1672554641,1672555690,1049
7638,3772309150,3918584946,1672639050,1672640058,1008
7572,3895562476,3311718847,1672657565,1672658989,1424
7542,3639847263,3273500349,1672581347,1672583005,1658
7967,3348261553,3774556560,1672636134,1672638169,2035
7704,3407954858,3222521619,1672554330,1672555720,1390
7913,3773950140,3515284591,1672570807,1672573414,2607
7955,3311993075,3783925755,1672607620,1672608645,1025
7927,3336751428,3666506258,1672580685,1672584059,3374
7896,3407673904,3473765852,1672607666,1672611095,3429
7767,3701065786,3833889105,1672566927,1672567293,366
7820,3294803686,3520030713,1672608814,1672610685,1871
7775,3883861463,3779036831,1672685140,1672687588,2448
7983,3472130842,3716843669,1672612177,1672612789,612
7533,3500658339,3737079798,1672595480,1672598840,3360
7803,3804870229,3711569060,1672661233,1672663404,2171
7761,3713630656,3407954858,1672643975,1672644413,438
7913,3501198706,3291235378,1672607433,1672609725,2292
7662,3792883665,3221536550,1672593293,1672593731,438
7537,3471220483,3500365158,1672698075,1672701468,3393
7685,3505859863,3338703270,1672587163,1672589663,2500
7776,3755798867,3409474775,1672588200,1672590135,1935
7629,3715339701,3242408357,1672639082,1672640693,1611
7849,3939952128,3827222533,1672691205,1672692253,1048
7487,3505203158,3909606423,1672591344,1672592246,902
7716,3374559242,3783239924,1672599634,1672600959,1325
7865,3480687894,3668898102,1672619201,1672619677,476
7865,3634995491,3792032359,1672676278,1672676968,690
7707,3711380716,3518014404,1672617417,1672619541,2124
7544,3311065516,3344019610,1672554625,1672556283,1658
7503,3473765852,3312829208,1672546855,1672548987,2132
7831,3483164654,3778780511,1672539783,1672541480,1697
7834,3772053179,3772309166,1672639103,1672640265,1162
7569,3505973226,3378436155,1672569398,1672569940,542
7810,3755587522,3501184421,1672612575,1672613912,1337
7655,3701184889,3703735129,1672559721,1672560529,808
7921,3533242305,3755511676,1672659228,1672660704,1476
7978,3972364603,3711504540,1672581188,1672581850,662
7903,3770447408,3235635976,1672683352,1672686650,3298
7565,3378092448,3346327502,1672558291,1672558633,342
7976,3505869747,3885670556,1672536355,1672537449,1094
7487,3533242305,3703789494,1672536897,1672537654,757
7849,3505869747,3247780536,1672548994,1672549488,494
7861,3302626661,3291235378,1672608819,1672611137,2318
7684,3483164654,3505973226,1672644745,1672646563,1818
7855,3509630174,3311152102,1672652587,1672652769,182
7522,3760492950,3736592744,1672652588,1672653467,879
7605,3519803045,3757682496,1672638496,1672639820,1324
7857,3734737881,3711265369,1672632860,1672636031,3171
7587,3757151210,3235287260,1672605377,1672606653,1276
7742,3909331423,3792668962,1672621393,1672623748,2355
7847,3770078063,3494290908,1672639927,1672640879,952
7943,3760509236,3206254161,1672672462,1672672850,388
7631,3701146057,3277669002,1672550888,1672553982,3094
7789,3930797455,3338367113,1672562347,1672562997,650
7637,3519703355,3473562469,1672671639,1672671922,283
7815,3972364603,3501606184,1672584467,1672585825,1358
7730,3520183192,3316173088,1672648384,1672651787,3403
7706,3465254146,3515125508,1672666782,1672668332,1550
7740,3805342762,3701967560,1672584370,1672585522,1152
7742,3336742544,3772359096,1672689423,1672690338,915
7972,3518876135,3778341199,1672684459,1672686336,1877
7831,3791602225,3534313900,1672698320,1672700815,2495
7788,3471220483,3882997884,1672670762,1672672656,1894
7576,3337544549,3485375593,1672655287,1672658182,2895
7829,3485375593,3303751772,1672563616,1672565507,1891
7761,3396285984,3396086535,1672553305,1672554973,1668
7645,3510173870,3396285984,1672694069,1672696892,2823
7713,3685187183,3533748232,1672535441,1672537909,2468
7632,3222521619,3394539273,1672605092,1672607514,2422
7888,3792768129,3365278081,1672602096,1672604018,1922
7695,3518669703,3755872268,1672557292,1672559989,2697
7930,3397418363,3772359096,1672579799,1672580498,699
7719,3428674539,3312829208,1672619394,1672619484,90
7491,3273500349,3760569731,1672661099,1672664682,3583
7712,3666507626,3534424200,1672689989,1672692757,2768
7596,3756930948,3713630656,1672691923,1672695013,3090
7940,3313564074,3396285984,1672643609,1672644031,422
7855,3855424474,3511125626,1672596549,1672599692,3143
7840,3559110998,3477375368,1672571893,1672572345,452
7794,3519803045,3783083229,1672596009,1672597926,1917
7802,3972364603,3701146057,1672651910,1672654741,2831
7803,3516258476,3520190170,1672533116,1672536462,3346
7640,3770851318,3774066725,1672599312,1672602152,2840
7563,3793470489,3432689543,1672613709,1672616791,3082
7810,3770635361,3520888296,1672585247,1672587341,2094
7759,3311761694,3516223597,1672681696,1672684438,2742
7976,3791957752,3533270638,1672672043,1672673800,1757
7566,3201324715,3434642576,1672601376,1672604222,2846
7632,3360506772,3516065852,1672648964,1672651097,2133
7592,3755739653,3357483218,1672563747,1672563881,134
7660,3388372715,3512142794,1672680711,1672681216,505
7899,3365830990,3734496778,1672586145,1672586242,97
7627,3411618230,3925620998,1672677072,1672679707,2635
7667,3298433163,3791874383,1672626021,1672626460,439
7746,3384951177,3284639858,1672673177,1672675242,2065
7844,3882242815,3711262377,1672540626,1672542208,1582
7746,3517864478,3511271692,1672573663,1672576631,2968
7832,3315583351,3296471982,1672696177,1672696658,481
7830,3374559242,3514472925,1672702199,1672703721,1522
7683,3777790718,3793871337,1672541333,1672544591,3258
7828,3284832486,3851190615,1672612207,1672615295,3088
7684,3500066230,3772746272,1672561634,1672563373,1739
7908,3387966152,3772309166,1672665783,1672667653,1870
7897,3668005723,3311871871,1672635373,1672638773,3400
7836,3780294829,3918247820,1672632234,1672634136,1902
7793,3221899927,3534488837,1672622790,1672626229,3439
7967,3637008488,3703441914,1672665675,1672666320,645
7794,3910886626,3505203158,1672545397,1672546245,848
7978,3500499542,3783196518,1672696008,1672698816,2808
7822,3500391167,3714962248,1672611783,1672613181,1398
7960,3500805881,3311603601,1672616856,1672620453,3597
7960,3800886801,3404384505,1672538213,1672540251,2038
7976,3520206212,3439023335,1672603692,1672604217,525
7531,3439023335,3901990690,1672622666,1672624708,2042
7704,3417587765,3407954858,1672618038,1672618400,362
7564,3813052709,3489728806,1672663741,1672665744,2003
7660,3276640712,3777477395,1672556726,1672557073,347
7581,3800886801,3886298125,1672651621,1672654769,3148
7604,3922337974,3710112546,1672662314,1672665331,3017
7896,3606812411,3412825109,1672582327,1672583644,1317
7624,3778108318,3426325549,1672648436,1672648943,507
7980,3533025282,3822654369,1672660132,1672663605,3473
7818,3520206212,3715492942,1672584141,1672586574,2433
7560,3773814927,3519428855,1672695978,1672698572,2594
7798,3760561634,3772642849,1672634689,1672635056,367
7810,3509907947,3517077106,1672636014,1672636932,918
7743,3501198706,3883312122,1672613164,1672615272,2108
7815,3812176780,3512540951,1672535695,1672539249,3554
7825,3286658957,3774195321,1672645152,1672645532,380
7700,3883551721,3517509185,1672595499,1672596331,832
7680,3505530961,3556951786,1672633068,1672636625,3557
7941,3791957752,3757602960,1672555494,1672557621,2127
7906,3922275416,3232962003,1672564695,1672566845,2150
7509,3428964059,3783239924,1672567709,1672570863,3154
7811,3733891182,3500458761,1672678833,1672682008,3175
7968,3312333615,3739106581,1672684154,1672684938,784
7938,3500578848,3778308417,1672656005,1672657614,1609
7954,3406784491,3407954858,1672562869,1672565343,2474
7785,3339907603,3509453566,1672626623,1672629693,3070
7856,3512969370,3737051610,1672661390,1672663531,2141
7930,3512837326,3703013906,1672588764,1672589707,943
7583,3755625324,3811171116,1672642175,1672643003,828
7588,3348261553,3793848402,1672561870,1672562478,608
7925,3236102733,3293695955,1672680977,1672684134,3157
7718,3510711755,3273500349,1672631258,1672633726,2468
7804,3703735129,3772337814,1672604122,1672606540,2418
7490,3509773875,3809916577,1672591626,1672594707,3081
7540,3552314511,3777776687,1672698614,1672700141,1527
7508,3514472925,3280964728,1672646933,1672650452,3519
7580,3501927421,3715998609,1672611820,1672613057,1237
7926,3223968713,3918674986,1672667184,1672667610,426
7706,3399535232,3534313900,1672580360,1672582167,1807
7941,3533242305,3827222533,1672664944,1672668289,3345
7703,3773978034,3313541986,1672682649,1672683599,950
7923,3716537575,3972364603,1672548584,1672551710,3126
7734,3505193212,3792902982,1672546797,1672548871,2074
7907,3770824086,3520206212,1672694919,1672695128,209
7501,3276993580,3756462516,1672625859,1672629344,3485
7913,3392121505,3770635361,1672703816,1672707032,3216
7670,3533927138,3465254146,1672583891,1672585210,1319
7604,3793086311,3501184421,1672645687,1672646114,427
7571,3755392666,3512540951,1672652688,1672654758,2070
7538,3755798867,3817621391,1672533034,1672535441,2407
7740,3519601612,3505000737,1672620060,1672621043,983
7939,3774127586,3778305740,1672554028,1672557302,3274
7807,3505362057,3476232529,1672545999,1672547071,1072
7556,3802367797,3418728074,1672560426,1672560937,511
7811,3922275620,3510771358,1672697242,1672699868,2626
7978,3249791738,3475258557,1672536333,1672538614,2281
7510,3517509185,3777776687,1672627934,1672630103,2169
7643,3206603608,3755739653,1672628288,1672631313,3025
7845,3475251781,3793959750,1672599151,1672601213,2062
7546,3304625412,3776800213,1672620013,1672622012,1999
7577,3972364603,3937224533,1672564715,1672567702,2987
7924,3909331423,3220716272,1672532549,1672534135,1586
7904,3914259449,3234541252,1672634427,1672635620,1193
7530,3774366875,3221899927,1672699046,1672700157,1111
7856,3757602960,3505203158,1672649354,1672652644,3290
7567,3476232529,3914290246,1672634077,1672635898,1821
7505,3978105277,3534010629,1672677819,1672679233,1414
7980,3793470489,3311648200,1672646180,1672648201,2021
7848,3613683164,3505530961,1672697970,1672698670,700
7891,3711380716,3827377568,1672586794,1672590301,3507
7618,3716197887,3511267139,1672566590,1672569655,3065
7824,3601879040,3516465662,1672591529,1672593070,1541
7907,3792384220,3513201436,1672644198,1672647098,2900
7887,3513599775,3774195321,1672591825,1672592061,236
7748,3777514571,3304056063,1672599554,1672601897,2343
7555,3476232529,3883861463,1672656381,1672659589,3208
7819,3793470489,3792789881,1672538362,1672541925,3563
7786,3852391257,3514128943,1672578785,1672580387,1602
7546,3793436995,3627937312,1672596136,1672596790,654
7830,3512217942,3420432297,1672610906,1672613638,2732
7545,3387966152,3828624701,1672695767,1672698359,2592
7683,3783083229,3757682496,1672663516,1672665403,1887
7684,3756966035,3512349371,1672667775,1672670539,2764
7801,3391261292,3770824086,1672551598,1672553611,2013
7522,3791115967,3421127249,1672592296,1672594065,1769
7951,3244389794,3703889596,1672619173,1672619302,129
7516,3792902982,3518876135,1672691933,1672692081,148
7907,3319752091,3731106822,1672620038,1672621858,1820
7586,3774066725,3416241005,1672574041,1672575153,1112
7746,3484995752,3367902229,1672696618,1672697682,1064
7915,3791020967,3550946908,1672646281,1672646496,215
7485,3793848402,3500499542,1672613345,1672614688,1343
7746,3880310724,3899371911,1672646169,1672649347,3178
7591,3931941795,3500578848,1672639788,1672640236,448
7863,3777120536,3792288302,1672681341,1672681455,114
7655,3417061462,3760509236,1672686495,1672687930,1435
7608,3817621391,3776948966,1672681144,1672683984,2840
7549,3232962003,3701898991,1672586507,1672586682,175
7534,3517509185,3756027749,1672614393,1672614632,239
7817,3883312122,3817316561,1672669205,1672670709,1504
7555,3351554343,3518360734,1672535831,1672538094,2263
7847,3818255890,3519803045,1672611027,1672613644,2617
7611,3777983879,3520719611,1672605555,1672606317,762
7786,3201324715,3519563836,1672663704,1672664975,1271
7697,3774501422,3512720680,1672587436,1672588752,1316
7957,3280615985,3510857360,1672627921,1672631076,3155
7550,3664170666,3703735129,1672594580,1672594647,67
7820,3636867411,3737154119,1672697546,1672697961,415
7522,3501198706,3519601612,1672656269,1672658197,1928
7550,3773598056,3664170666,1672676874,1672678355,1481
7905,3701111745,3516716179,1672597294,1672598758,1464
7642,3533095755,3909331423,1672576158,1672579601,3443
7733,3668005723,3756930948,1672618399,1672619255,856
7795,3501483568,3490191091,1672559672,1672562589,2917
7882,3232962003,3662180254,1672603478,1672605642,2164
7854,3510594211,3716488385,1672625230,1672627569,2339
7954,3201848640,3466911760,1672609716,1672612209,2493
7632,3776948966,3334033993,1672661026,1672661222,196
7778,3855602893,3616944364,1672661555,1672664854,3299
7566,3791874383,3307097200,1672569065,1672571226,2161
7799,3711973519,3978105277,1672539333,1672540309,976
7556,3917278625,3804870229,1672619895,1672622736,2841
7692,3885897503,3715127362,1672614252,1672617807,3555
7760,3778980116,3777455223,1672605918,1672607414,1496
7595,3777477395,3391915121,1672550817,1672552010,1193
7876,3534702203,3496549058,1672654567,1672655992,1425
7822,3802367797,3518791447,1672664230,1672665572,1342
7800,3501483568,3792473331,1672638418,1672638711,293
7972,3209383861,3932051427,1672672844,1672673099,255
7692,3899266183,3420432297,1672549715,1672551133,1418
7685,3701995648,3772758337,1672579575,1672581960,2385
7590,3793470489,3807987001,1672614126,1672614285,159
7711,3412825109,3420432297,1672626478,1672629459,2981
7554,3365278081,3223789409,1672645125,1672648422,3297
7707,3809059934,3791874383,1672646643,1672646774,131
7829,3610695419,3277939457,1672614901,1672617418,2517
7502,3760267716,3427283336,1672693169,1672693814,645
7705,3311415018,3624761861,1672630349,1672630568,219
7780,3791334389,3404058699,1672557205,1672559567,2362
7688,3487171044,3312664885,1672583356,1672584017,661
7487,3715127362,3772359096,1672531895,1672535254,3359
7488,3829764737,3828624701,1672576857,1672577341,484
7571,3780365428,3224716315,1672682106,1672685348,3242
7774,3311208440,3713208927,1672679308,1672681420,2112
7928,3664517356,3303705369,1672630462,1672631554,1092
7705,3247780536,3710112546,1672608386,1672610011,1625
7730,3519601612,3430074045,1672631120,1672633204,2084
7744,3519912874,3780503655,1672657345,1672658114,769
7772,3514838220,3312829208,1672658627,1672659618,991
7695,3935127663,3276993580,1672549501,1672552473,2972
7738,3606987130,3304625412,1672653774,1672655852,2078
7769,3514719601,3778780511,1672570911,1672572277,1366
7612,3208844525,3478194807,1672573806,1672577179,3373
7939,3605726278,3918674986,1672693653,1672695409,1756
7956,3627937312,3770447408,1672661810,1672663699,1889
7501,3481647420,3710408395,1672640982,1672643050,2068
7576,3805519285,3774338212,1672569568,1672571485,1917
7691,3336751428,3518876135,1672533157,1672535300,2143
7590,3918056059,3311154569,1672622892,1672623290,398
7601,3505883609,3791020967,1672703464,1672703927,463
7708,3791602225,3405494240,1672622306,1672625835,3529
7922,3832902928,3244173074,1672687900,1672688706,806
7684,3800353779,3882291183,1672577468,1672579227,1759
7575,3832902928,3776513891,1672630125,1672633463,3338
7930,3505000737,3505477652,1672575932,1672577730,1798
7569,3510247121,3819727225,1672543960,1672544138,178
7492,3777929708,3482405588,1672641529,1672643138,1609
7974,3791334389,3683959482,1672578508,1672578967,459
7726,3774195321,3711571712,1672557221,1672558697,1476
7521,3391915121,3755920131,1672669926,1672671167,1241
7606,3804870229,3685818092,1672579999,1672580431,432
7525,3819727225,3516258476,1672620253,1672622266,2013
7630,3736419952,3629547065,1672536579,1672538973,2394
7966,3302626661,3852391257,1672658528,1672660059,1531
7852,3439023335,3936227020,1672569433,1672572921,3488
7749,3701498253,3533385867,1672552976,1672556438,3462
7834,3903307060,3777790718,1672650614,1672653868,3254
7595,3666553782,3518932404,1672566299,1672567494,1195
7672,3304056063,3800353779,1672681893,1672682014,121
7620,3380035798,3277669002,1672593840,1672594874,1034
7714,3791334389,3774298222,1672678335,1672679180,845
7680,3760183458,3505292701,1672539896,1672540471,575
7550,3511312803,3472130842,1672572217,1672573520,1303
7536,3471220483,3826415738,1672625317,1672626704,1387
7588,3501955238,3372883226,1672659452,1672661206,1754
7642,3755872268,3710067113,1672632502,1672633323,821
7560,3701995648,3819727225,1672666287,1672669497,3210
7957,3613995936,3778108318,1672592880,1672596451,3571
7752,3714197325,3756966035,1672610737,1672612337,1600
7904,3235287260,3293695955,1672699337,1672700258,921
7936,3809916577,3792032359,1672682842,1672683670,828
7624,3777936328,3757161914,1672636557,1672638493,1936
7770,3793959750,3783083229,1672642480,1672645457,2977
7769,3703275621,3714962248,1672561255,1672563626,2371
7655,3311439795,3249401741,1672588243,1672588658,415
7972,3311993075,3613995936,1672623148,1672625705,2557
7978,3404058699,3756453423,1672657067,1672658251,1184
7836,3416241005,3777443199,1672649854,1672651521,1667
7817,3757151210,3501184421,1672701328,1672702033,705
7905,3777623166,3378436155,1672565108,1672568518,3410
7586,3417587765,3774125065,1672690747,1672693309,2562
7487,3808324264,3221536550,1672628851,1672631294,2443
7620,3400918687,3817621391,1672640350,1672641903,1553
7836,3339907603,3311845971,1672548160,1672549439,1279
7678,3739106581,3505203158,1672620168,1672620981,813
7614,3666553782,3714821932,1672625257,1672625806,549
7873,3424922204,3772544062,1672659014,1672659841,827
7822,3500803339,3505859863,1672697093,1672700157,3064
7914,3517077106,3827626797,1672582210,1672582744,534
7829,3385763781,3311324983,1672543818,1672545237,1419
7915,3922275620,3711370563,1672666766,1672670311,3545
7757,3703275621,3285400528,1672598497,1672599706,1209
7664,3369998498,3774195321,1672574771,1672576468,1697
7873,3626156564,3519912874,1672665555,1672666772,1217
7488,3485823740,3489962019,1672563283,1672566734,3451
7870,3500803339,3770851318,1672667949,1672669744,1795
7698,3231056870,3534424200,1672610773,1672611028,255
7623,3711504540,3513201436,1672578797,1672579595,798
7722,3453729665,3791020967,1672639484,1672641223,1739
7573,3505173328,3931941795,1672579226,1672579585,359
7701,3517864478,3284832486,1672532519,1672536076,3557
7825,3399911573,3711380716,1672549587,1672551403,1816
7721,3520012395,3779740455,1672632023,1672632736,713
7817,3505193212,3853018906,1672622753,1672625846,3093
7495,3716488385,3407673904,1672605506,1672605638,132
7802,3711198793,3510703546,1672679972,1672682453,2481
7850,3760183458,3716165213,1672582579,1672583161,582
7524,3511267139,3387674757,1672661821,1672664373,2552
7715,3701691675,3713630656,1672601074,1672603033,1959
7628,3346327502,3223968713,1672589270,1672590199,929
7678,3505203158,3835382117,1672562608,1672563072,464
7524,3409474775,3534702203,1672697997,1672698360,363
7861,3234541252,3618873142,1672666635,1672670184,3549
7946,3345207877,3500658339,1672660845,1672662258,1413
7744,3755798867,3496051529,1672664975,1672667790,2815
7831,3918247820,3383922351,1672573005,1672573787,782
7595,3378686918,3701534009,1672575560,1672578577,3017
7701,3774580701,3608868877,1672687435,1672688895,1460
7508,3624761861,3247780536,1672610073,1672611422,1349
7559,3925620998,3777776687,1672643228,1672643407,179
7926,3516065852,3513080274,1672655019,1672657243,2224
7866,3780294829,3416241005,1672546057,1672546912,855
7781,3783126683,3465202715,1672562236,1672563593,1357
7939,3289061738,3221536550,1672566361,1672569478,3117
7766,3716197887,3685187183,1672545379,1672548512,3133
7870,3510173870,3520719611,1672619730,1672622506,2776
7687,3515723720,3736592744,1672666931,1672669266,2335
7542,3516629436,3774338212,1672627970,1672630916,2946
7941,3313564074,3925402713,1672684751,1672686384,1633
7553,3311154569,3420700674,1672634387,1672636869,2482
7938,3427283336,3714504419,1672607079,1672609729,2650
7640,3365942576,3516960534,1672611044,1672613220,2176
7852,3607178184,3505873261,1672664705,1672665761,1056
7631,3416241005,3505869747,1672675657,1672676588,931
7684,3483949762,3780365428,1672674838,1672677943,3105
7776,3501364586,3349613093,1672545966,1672546086,120
7762,3515151980,3773664987,1672663461,1672665434,1973
7777,3517476351,3511267139,1672571182,1672571724,542
7545,3736786443,3817316561,1672680778,1672682640,1862
7871,3336751428,3780974443,1672668023,1672669551,1528
7488,3737154119,3711571712,1672547119,1672549606,2487
7577,3244389794,3621497531,1672568360,1672570612,2252
7670,3701995648,3859663348,1672546237,1672547679,1442
7651,3493507965,3513956646,1672601299,1672603637,2338
7925,3520751702,3284639858,1672574319,1672576589,2270
7963,3395152943,3757602960,1672581163,1672584004,2841
7865,3412825109,3972364603,1672659897,1672660365,468
7924,3973560347,3505883609,1672639097,1672641578,2481
7863,3500805881,3344019610,1672609257,1672609931,674
7706,3555214688,3930791338,1672700962,1672701494,532
7666,3770824086,3370752401,1672544545,1672546051,1506
7745,3400804807,3399052055,1672555141,1672555238,97
7938,3818255890,3772337814,1672688363,1672690683,2320
7725,3513956646,3835382117,1672656645,1672657923,1278
7491,3379589402,3770447408,1672665924,1672666063,139
7779,3379256399,3223968713,1672634217,1672635258,1041
7534,3607178184,3273500349,1672648169,1672649392,1223
7980,3509773875,3772884106,1672599545,1672602258,2713
7665,3791334389,3501606184,1672643090,1672645308,2218
7631,3791602225,3760893269,1672590068,1672592827,2759
7712,3779528381,3409474775,1672579390,1672580728,1338
7928,3208844525,3485823740,1672698670,1672699952,1282
7788,3519563836,3500391167,1672585483,1672587977,2494
7510,3780788622,3439023335,1672554852,1672556620,1768
7692,3819727225,3516011407,1672649430,1672651291,1861
7801,3516673015,3311993075,1672583421,1672584095,674
7670,3857349323,3610348516,1672635558,1672636319,761
7690,3519654779,3791334389,1672583903,1672585055,1152
7527,3516909237,3520706195,1672673966,1672677240,3274
7657,3364543015,3387966152,1672599088,1672601688,2600
7620,3416241005,3500374658,1672623478,1672625447,1969
7884,3488244966,3755587522,1672655184,1672658034,2850
7826,3475795792,3481647420,1672700290,1672702529,2239
7730,3793338102,3770101921,1672690720,1672690922,202
7620,3360993964,3793286136,1672677915,1672678137,222
7516,3510126867,3473562469,1672678324,1672681299,2975
7531,3792288302,3420700674,1672578535,1672580614,2079
7908,3776948966,3475251781,1672542910,1672545029,2119
7511,3487171044,3757455053,1672590669,1672591417,748
7562,3351554343,3360743849,1672637530,1672639190,1660
7534,3757682496,3391261292,1672649663,1672650965,1302
7724,3367029997,3770553384,1672687235,1672687904,669
7544,3488244966,3713268590,1672643319,1672645756,2437
7689,3617734118,3483949762,1672671351,1672671934,583
7782,3475251781,3735733948,1672581574,1672581696,122
7670,3716258994,3780974443,1672598887,1672599754,867
7722,3424922204,3829232696,1672677543,1672678136,593
7845,3374559242,3783531004,1672550042,1672553320,3278
7829,3882242815,3792883665,1672652880,1672653610,730
7923,3774501422,3922275416,1672570081,1672572641,2560
7543,3911159965,3227457126,1672703655,1672705886,2231
7792,3703889596,3976390453,1672596835,1672599805,2970
7810,3820354437,3930791338,1672564447,1672566970,2523
7830,3792789881,3482405588,1672679160,1672680212,1052
7593,3978115672,3858918246,1672554871,1672555476,605
7515,3223968713,3512720680,1672539888,1672543071,3183
7605,3433804879,3793436995,1672642023,1672642294,271
7633,3206254161,3365614305,1672673460,1672674138,678
7591,3816853177,3519654779,1672619711,1672623104,3393
7828,3608868877,3777477395,1672641483,1672642059,576
7712,3534488837,3972709319,1672633694,1672634297,603
7692,3613683164,3826759140,1672680119,1672683203,3084
7799,3667680268,3783531004,1672581839,1672584665,2826
7584,3277605882,3316173088,1672542933,1672544609,1676
7507,3829764737,3534313900,1672659548,1672661381,1833
7639,3793338102,3703871468,1672564928,1672565431,503
7769,3344019610,3514128943,1672653827,1672657090,3263
7788,3607748895,3387674757,1672632640,1672635646,3006
7644,3757403279,3755872268,1672611480,1672614330,2850
7645,3201848640,3222448362,1672645329,1672646108,779
7847,3827222533,3701178711,1672616843,1672618441,1598
7627,3520629279,3439023335,1672595751,1672597036,1285
7831,3703223015,3412980697,1672543724,1672543920,196
7766,3490191091,3760267716,1672563241,1672563774,533
7840,3713786889,3501927421,1672586340,1672587092,752
7517,3815508790,3500199935,1672646753,1672650175,3422
7634,3778266283,3976633198,1672566657,1672568090,1433
7733,3778308417,3222448362,1672562947,1672565813,2866
7598,3886298125,3755042098,1672629502,1672630726,1224
7766,3489728806,3711265369,1672691493,1672692556,1063
7655,3777776687,3200691026,1672638858,1672641180,2322
7619,3666457294,3505219850,1672646058,1672648823,2765
7697,3732481297,3791553060,1672638426,1672639746,1320
7622,3505973226,3293695955,1672590303,1672593647,3344
7917,3318166135,3772359096,1672680323,1672681537,1214
7519,3792668962,3516716179,1672630704,1672631142,438
7744,3307512479,3518791447,1672613250,1672616153,2903
7575,3434642576,3703275621,1672674914,1672675777,863
7584,3805292782,3611150562,1672653296,1672655443,2147
7848,3855424474,3827626797,1672692521,1672693470,949
7509,3512683609,3713268590,1672534034,1672536088,2054
7842,3555214688,3517077106,1672585005,1672586484,1479
7939,3519912874,3519601612,1672668895,1672671947,3052
7670,3780294829,3791942683,1672666766,1672667783,1017
7744,3516223597,3222521619,1672626930,1672627774,844
7807,3500499542,3780914982,1672606118,1672607208,1090
7826,3701995648,3428006164,1672638223,1672639478,1255
7650,3512217942,3485823740,1672631292,1672633768,2476
7773,3519700826,3533025282,1672609947,1672611233,1286
7924,3399004969,3385763781,1672596725,1672599957,3232
7639,3520376528,3755436115,1672677592,1672679622,2030
7779,3311152102,3367029997,1672694108,1672696405,2297
7855,3390068992,3278365525,1672591431,1672593951,2520
7546,3606186086,3313564074,1672553173,1672553608,435
7688,3454042520,3359239884,1672534659,1672537725,3066
7876,3633420270,3757602960,1672672608,1672673518,910
7886,3701534009,3666457294,1672550030,1672551592,1562
7783,3318697153,3776513891,1672566531,1672569124,2593
7943,3516673015,3234362962,1672562175,1672563979,1804
7565,3886298125,3359239884,1672667687,1672670833,3146
7769,3624761861,3208844525,1672583181,1672583557,376
7595,3780788622,3510244400,1672568511,1672569068,557
7648,3234541252,3512217942,1672666692,1672669814,3122
7644,3682061100,3774501422,1672697689,1672699821,2132
7803,3710408395,3520709480,1672617191,1672618135,944
7617,3516258476,3701863557,1672544540,1672545612,1072
7804,3713644518,3773755137,1672654355,1672656980,2625
7548,3839849341,3904775198,1672582127,1672584971,2844
7544,3926700506,3399911573,1672585512,1672586275,763
7917,3710569131,3516223597,1672585160,1672588498,3338
7900,3318697153,3778780511,1672646422,1672648125,1703
7791,3777790718,3378686918,1672605182,1672608015,2833
7641,3715998609,3391261292,1672675195,1672675259,64
7833,3336742544,3770851318,1672626907,1672627623,716
7685,3405494240,3839849341,1672697418,1672700580,3162
7511,3770021824,3836573197,1672691562,1672694503,2941
7865,3757403279,3755881905,1672670404,1672672319,1915
7922,3887270940,3778980116,1672635649,1672636788,1139
7701,3662180254,3517459919,1672545180,1672546444,1264
7876,3516629436,3511435497,1672585306,1672585646,340
7828,3533927138,3755798867,1672558496,1672561989,3493
7511,3737079798,3379256399,1672646187,1672648104,1917
7883,3859663348,3899371911,1672637808,1672639306,1498
7547,3780788622,3556951786,1672673707,1672675839,2132
7960,3388286531,3533193862,1672603739,1672604046,307
7675,3348261553,3477649378,1672620743,1672621663,920
7894,3778780511,3770078063,1672681310,1672681656,346
7840,3760992710,3715492942,1672580313,1672583226,2913
7895,3407673904,3666507626,1672626199,1672627672,1473
7765,3417587765,3828365570,1672536975,1672539337,2362
7660,3791874383,3404384505,1672542688,1672544702,2014
7836,3773978034,3736419952,1672574143,1672575496,1353
7980,3660493209,3384240055,1672579146,1672582235,3089
7623,3505873261,3780593036,1672671604,1672673026,1422
7925,3780609808,3402943525,1672552224,1672553143,919
7942,3515691540,3760561634,1672593657,1672593967,310
7871,3511350608,3914290246,1672655213,1672655719,506
7832,3200691026,3918584946,1672540780,1672543917,3137
7727,3420700674,3234541252,1672677314,1672678675,1361
7635,3756462516,3519601612,1672686485,1672687071,586
7929,3755943611,3735319397,1672586837,1672588978,2141
7563,3777079686,3624312512,1672552394,1672552505,111
7926,3512510536,3511198618,1672595982,1672597560,1578
7543,3835382117,3383661227,1672662823,1672663873,1050
7898,3311845971,3298288268,1672604679,1672608059,3380
7565,3516629436,3481502100,1672636573,1672637271,698
7812,3625274012,3920801189,1672676545,1672677737,1192
7678,3232962003,3828624701,1672628581,1672631551,2970
7958,3904775198,3829319703,1672551101,1672552166,1065
7831,3228165483,3516716179,1672673933,1672677031,3098
7543,3473562469,3316173088,1672644531,1672645705,1174
7805,3443698222,3780639480,1672549145,1672550751,1606
7928,3344364444,3466911760,1672693391,1672694505,1114
7683,3883085535,3515860749,1672592483,1672594743,2260
7625,3760077057,3800886801,1672646755,1672649872,3117
7975,3534729133,3244436890,1672694851,1672696477,1626
7742,3773465237,3509453566,1672593137,1672593523,386
7739,3277669002,3774125065,1672698762,1672699433,671
7695,3616944364,3607748895,1672608606,1672608823,217
7699,3401627165,3501198706,1672652132,1672653703,1571
7932,3930791338,3760489031,1672645361,1672645698,337
7567,3307097200,3459030804,1672562347,1672562608,261
7635,3736592744,3633420270,1672597517,1672598767,1250
7880,3816853177,3277669002,1672608578,1672611427,2849
7957,3774793839,3424922204,1672700922,1672701290,368
7619,3311154569,3701274634,1672655353,1672658760,3407
7679,3206603608,3711262377,1672698683,1672699473,790
7575,3534010629,3533626375,1672678063,1672680723,2660
7793,3513454145,3618873142,1672679060,1672680829,1769
7490,3713969578,3244436890,1672546322,1672548917,2595
7674,3505477652,3713370078,1672623305,1672625465,2160
7666,3805519285,3791020967,1672654499,1672655126,627
7858,3826759140,3777717988,1672611848,1672614459,2611
7580,3770101921,3793959750,1672560872,1672564140,3268
7909,3774127586,3518014636,1672633419,1672635839,2420
7851,3223789409,3639847263,1672585042,1672587829,2787
7736,3533137446,3793086311,1672653644,1672655045,1401
7846,3291227780,3918674986,1672679872,1672680419,547
7878,3319752091,3757161914,1672646818,1672649382,2564
7595,3510857360,3882997884,1672626666,1672629647,2981
7788,3209027249,3716168623,1672669975,1672671327,1352
7946,3773205565,3715189301,1672609366,1672610415,1049
7983,3514283243,3883861463,1672593492,1672596000,2508
7762,3904408902,3396086535,1672575532,1672578519,2987
7620,3792789881,3509773875,1672677337,1672678665,1328
7715,3914259449,3391915886,1672623375,1672626681,3306
7666,3516039895,3311208440,1672663864,1672667003,3139
7769,3406784491,3734737881,1672534937,1672536177,1240
7546,3518932404,3533242305,1672575115,1672578532,3417
7817,3485008994,3384951177,1672644223,1672644601,378
7513,3334033993,3307097200,1672688098,1672690996,2898
7978,3791901535,3756528686,1672626417,1672628540,2123
7723,3518163778,3621497531,1672656903,1672658353,1450
7891,3701898991,3533371364,1672540553,1672540844,291
7622,3668005723,3774125065,1672551915,1672553628,1713
7658,3711571712,3714962248,1672676632,1672679299,2667
7767,3505477652,3311648200,1672634886,1672636924,2038
7630,3811694763,3833889105,1672577080,1672578376,1296
7705,3716900301,3511271692,1672576648,1672576817,169
7532,3791997875,3458539365,1672603947,1672604123,176
7569,3279721246,3467773920,1672535097,1672537917,2820
7702,3701863557,3627937312,1672550134,1672551820,1686
7647,3513201436,3378436155,1672648675,1672650311,1636
7608,3816853177,3229058858,1672647484,1672648494,1010
7548,3772309150,3909331423,1672631166,1672631980,814
7604,3224716315,3792883665,1672685637,1672686221,584
7892,3826633236,3378092448,1672682922,1672683386,464
7828,3533626375,3713268590,1672570102,1672572871,2769
7571,3407954858,3757602960,1672641619,1672645062,3443
7611,3377766165,3200691026,1672575983,1672579453,3470
7805,3359239884,3247815299,1672652255,1672654708,2453
7588,3975287541,3783206719,1672629915,1672633301,3386
7946,3501692334,3935627557,1672533653,1672536974,3321
7837,3809059934,3827377568,1672566790,1672568073,1283
7886,3736592744,3736786443,1672613741,1672616730,2989
7891,3430504438,3701184889,1672665717,1672669002,3285
7827,3229058858,3412980697,1672582471,1672585798,3327
7723,3777806071,3774119563,1672602819,1672605906,3087
7799,3520165601,3801089989,1672536974,1672538566,1592
7972,3756623396,3514838220,1672645461,1672645994,533
7581,3311439795,3882242815,1672660741,1672661034,293
7960,3791602225,3774195321,1672628526,1672629840,1314
7756,3394539273,3520756859,1672694482,1672695382,900
7715,3855000166,3624312512,1672546214,1672548933,2719
7967,3757151210,3778308417,1672666235,1672666736,501
7511,3509604974,3773755137,1672570568,1672571177,609
7522,3231056870,3235635976,1672635197,1672635833,636
7753,3421836608,3932051427,1672547147,1672550122,2975
7767,3515394721,3817621391,1672653544,1672655458,1914
7530,3714962248,3886298125,1672639534,1672640957,1423
7613,3978105277,3475258557,1672672225,1672673530,1305
7974,3885897503,3298288268,1672598408,1672600026,1618
7624,3713349754,3229665776,1672648082,1672650619,2537
7865,3891751546,3882242815,1672574660,1672575092,432
7552,3918056059,3500391167,1672658083,1672660666,2583
7957,3533369198,3922275416,1672597357,1672598154,797
7673,3734496778,3520206212,1672638230,1672638771,541
7927,3416427576,3473765852,1672534819,1672534900,81
7851,3505145247,3917278625,1672621849,1672622371,522
7983,3505859863,3505362057,1672665094,1672668008,2914
7678,3200691026,3772642849,1672555239,1672556867,1628
7957,3500805881,3703789494,1672698461,1672701912,3451
7609,3501198706,3932051427,1672588337,1672589549,1212
7643,3616944364,3736419952,1672684512,1672685474,962
7840,3411618230,3516909237,1672661402,1672663706,2304
7970,3793848402,3815508790,1672700734,1672702554,1820
7744,3859525941,3500894271,1672703019,1672706425,3406
7749,3271938399,3518408774,1672603894,1672604512,618
7681,3361230905,3430352815,1672621895,1672622054,159
7748,3206593906,3610695419,1672588851,1672590860,2009
7915,3666457294,3813052709,1672637761,1672640729,2968
7612,3505649239,3311648200,1672631647,1672632707,1060
7873,3505873261,3805519285,1672592276,1672594856,2580
7566,3773978034,3510594211,1672543548,1672545059,1511
7863,3701967560,3713969578,1672674202,1672675337,1135
7577,3421836608,3515723720,1672648385,1672648842,457
7617,3776513891,3912262917,1672548833,1672550172,1339
7754,3911159965,3515394721,1672672571,1672675476,2905
7790,3783779671,3935127663,1672601636,1672602816,1180
7854,3774005526,3916289176,1672639180,1672642071,2891
7615,3624761861,3362000049,1672555116,1672558664,3548
7516,3773465237,3349613093,1672661217,1672661541,324
7889,3518360734,3209383861,1672567587,1672569018,1431
7911,3512837326,3480687894,1672669965,1672670039,74
7729,3331845324,3200691026,1672639131,1672642488,3357
7817,3855000166,3417587765,1672647112,1672649432,2320
7538,3533810360,3783245561,1672583909,1672584221,312
7953,3407725581,3514283243,1672547828,1672549323,1495
7705,3774501422,3778341199,1672583541,1672584613,1072
7683,3360743849,3249791738,1672604207,1672605158,951
7754,3500177712,3500729955,1672690204,1672690326,122
7774,3336742544,3318166135,1672536172,1672538198,2026
7668,3703275621,3783245561,1672676999,1672678906,1907
7710,3509453566,3516716179,1672675046,1672676081,1035
7624,3939952128,3772309150,1672657810,1672660887,3077
7947,3610695419,3755042098,1672543702,1672546364,2662
7624,3518260334,3780813786,1672679499,1672680617,1118
7668,3555214688,3755872268,1672665678,1672667319,1641
7492,3516465662,3857349323,1672531651,1672532614,963
7590,3404384505,3271938399,1672648851,1672652017,3166
7542,3716900301,3881477378,1672641865,1672642770,905
7786,3858918246,3515394721,1672618277,1672620278,2001
7833,3433804879,3855937514,1672612033,1672614783,2750
7674,3510771358,3351554343,1672661233,1672664205,2972
7893,3774501422,3757246925,1672595727,1672597131,1404
7569,3501184421,3515394721,1672652270,1672654854,2584
7814,3206603608,3601879040,1672582264,1672585206,2942
7823,3550946908,3516980378,1672615677,1672617098,1421
7509,3685818092,3756528686,1672648501,1672651687,3186
7780,3518163778,3518408774,1672681116,1672681492,376
7698,3711571712,3773978034,1672587493,1672590501,3008
7940,3804870229,3924549929,1672544479,1672547637,3158
7786,3209027249,3732481297,1672683098,1672686037,2939
7610,3311871871,3979339287,1672695414,1672696673,1259
7855,3778266283,3736592744,1672565991,1672567813,1822
7627,3534191820,3613683164,1672694584,1672695276,692
7498,3776513891,3202120784,1672532354,1672532897,543
7913,3510380060,3385763781,1672687111,1672690662,3551
7894,3607178184,3898995675,1672696194,1672698958,2764
7777,3395152943,3519703355,1672700787,1672702450,1663
7852,3617055293,3791657947,1672557608,1672558193,585
7534,3232962003,3448855696,1672587792,1672591210,3418
7848,3242408357,3500060260,1672612346,1672615067,2721
7645,3639847263,3201324715,1672547640,1672548823,1183
7895,3344019610,3827222533,1672650044,1672651418,1374
7798,3833889105,3833889105,1672675964,1672679513,3549
7783,3613995936,3505173328,1672546296,1672548175,1879
7531,3520709480,3811171116,1672623409,1672624046,637
7779,3701967560,3311603601,1672670552,1672671919,1367
7809,3835382117,3777983879,1672693871,1672695401,1530
7607,3791594391,3833889105,1672577284,1672577971,687
7514,3903962771,3307512479,1672628790,1672631012,2222
7762,3973560347,3812176780,1672586484,1672588415,1931
7962,3835382117,3227158514,1672697456,1672698218,762
7847,3939952128,3713894336,1672699087,1672700623,1536
7698,3774125065,3367029997,1672665121,1672666135,1014
7545,3426325549,3377766165,1672652808,1672656298,3490
7715,3832902928,3716488385,1672575716,1672576026,310
7655,3791657947,3311208440,1672662176,1672662832,656
7901,3733189298,3975287541,1672547910,1672549260,1350
7542,3294803686,3611150562,1672605048,1672607862,2814
7816,3399052055,3792253549,1672671091,1672674266,3175
7634,3533626375,3793848402,1672627354,1672629620,2266
7496,3772758337,3778305740,1672598061,1672599832,1771
7727,3473562469,3483164654,1672621565,1672621831,266
7941,3773950140,3235287260,1672546217,1672546304,87
7587,3780365428,3200198928,1672550246,1672552864,2618
7948,3311648200,3793086311,1672593519,1672596344,2825
7943,3234541252,3930791338,1672548302,1672548770,468
7544,3703275621,3511198618,1672605081,1672605142,61
7778,3716900301,3783126683,1672578990,1672582250,3260
7533,3756966035,3605726278,1672647296,1672650363,3067
7491,3519654779,3515860749,1672691291,1672692173,882
7922,3774045700,3902278226,1672611442,1672614405,2963
7573,3713268590,3311603601,1672561462,1672561894,432
7674,3367029997,3467773920,1672657440,1672659721,2281
7769,3716900301,3774501422,1672569372,1672572070,2698
7716,3418534998,3518791447,1672549032,1672550800,1768
7717,3485375593,3516223597,1672654490,1672658051,3561
7956,3735733948,3800353779,1672657805,1672657997,192
7506,3273500349,3519556068,1672698988,1672702222,3234
7594,3314836094,3500994774,1672685784,1672688145,2361
7933,3809059934,3760077057,1672564942,1672566452,1510
7746,3518360734,3791657947,1672581925,1672583738,1813
7966,3510594211,3556951786,1672613726,1672614589,863
7634,3467773920,3757447189,1672697501,1672700480,2979
7635,3519703355,3779528381,1672569657,1672570485,828
7948,3407673904,3783126683,1672609108,1672610535,1427
7576,3807987001,3777455223,1672631136,1672631362,226
7871,3518876135,3837094550,1672561479,1672562243,764
7895,3509907947,3399004969,1672663573,1672666620,3047
7868,3883861463,3497901842,1672608863,1672610291,1428
7674,3466911760,3882291183,1672625203,1672626030,827
7745,3770447408,3496051529,1672614009,1672616584,2575
7758,3714488548,3611150562,1672547776,1672547847,71
7551,3336751428,3614238812,1672599213,1672599650,437
7495,3666507626,3487171044,1672678889,1672680271,1382
7700,3475258557,3516011407,1672657956,1672660369,2413
7588,3701274634,3783779671,1672563978,1672567374,3396
7577,3510244400,3223968713,1672647042,1672649656,2614
7961,3611150562,3605726278,1672603903,1672605191,1288
7871,3605726278,3710098970,1672671568,1672674415,2847
7580,3407954858,3772544062,1672620215,1672622708,2493
7488,3501606184,3400804807,1672586402,1672588808,2406
7511,3430074045,3387674757,1672552894,1672555168,2274
7646,3426325549,3710098970,1672561219,1672562493,1274
7812,3279721246,3774005526,1672659942,1672660732,790
7743,3882242815,3505219850,1672651678,1672653550,1872
7914,3200198928,3701984666,1672679383,1672681034,1651
7558,3520719611,3605726278,1672692057,1672692962,905
7773,3394330287,3209027249,1672612284,1672615277,2993
7583,3482405588,3883085535,1672652351,1672653294,943
7527,3930797455,3485823740,1672582746,1672585060,2314
7565,3774268456,3852595551,1672628947,1672629698,751
7829,3770101921,3791334389,1672616087,1672618965,2878
7784,3227457126,3396285984,1672612173,1672613623,1450
7758,3634340855,3793470489,1672581508,1672583655,2147
7578,3519069599,3776338577,1672614875,1672617672,2797
7539,3229058858,3716273414,1672540343,1672543229,2886
7633,3628819436,3618873142,1672682762,1672683494,732
7784,3287105466,3736790081,1672617306,1672619081,1775
7977,3519563836,3415443558,1672695291,1672697374,2083
7892,3780813786,3793338102,1672556557,1672558226,1669
7934,3412980697,3776066388,1672564090,1672566122,2032
7821,3714962248,3736419952,1672696734,1672700037,3303
7732,3772642849,3925402713,1672678859,1672682141,3282
7859,3505145247,3773598056,1672626361,1672628653,2292
7909,3227457126,3421127249,1672689372,1672691464,2092
7717,3793959750,3774520233,1672618467,1672621954,3487
7720,3475396323,3859525941,1672565071,1672566235,1164
7980,3400804807,3760294205,1672681108,1672682387,1279
7564,3510857360,3793848402,1672579644,1672580998,1354
7848,3882291183,3703789494,1672669295,1672672891,3596
7646,3783925755,3362000049,1672601130,1672603438,2308
7716,3391915121,3311439795,1672534149,1672534330,181
7624,3793627961,3703889596,1672595062,1672597912,2850
7919,3385763781,3510711755,1672559482,1672562837,3355
7544,3510937904,3484995752,1672681636,1672684206,2570
7852,3374559242,3711370563,1672640191,1672640329,138
7558,3285400528,3411618230,1672602406,1672603591,1185
7836,3407725581,3770553384,1672541593,1672542644,1051
7958,3346327502,3882242815,1672640227,1672640754,527
7926,3500229033,3778549126,1672564585,1672566027,1442
7818,3777079686,3533025282,1672572537,1672573977,1440
7575,3793627961,3755436115,1672658342,1672661819,3477
7909,3378686918,3909238838,1672533222,1672536536,3314
7841,3244173074,3780593036,1672693987,1672697187,3200
7691,3668005723,3361230905,1672548132,1672550839,2707
7664,3711370563,3776513891,1672683410,1672684302,892
7571,3420432297,3505098372,1672702795,1672703622,827
7489,3616944364,3736592744,1672635592,1672637141,1549
7634,3664517356,3773465237,1672534117,1672537632,3515
7721,3701691675,3512349371,1672690049,1672693294,3245
7700,3755798867,3517509185,1672675123,1672676201,1078
7841,3417587765,3855000166,1672570391,1672572068,1677
7496,3399052055,3780974443,1672677387,1672679144,1757
7825,3520709480,3756462516,1672701175,1672703433,2258
7749,3891751546,3737051610,1672637598,1672639492,1894
7657,3516909237,3777477395,1672565944,1672569122,3178
7559,3357483218,3500374658,1672652151,1672652269,118
7561,3772053179,3815508790,1672649518,1672651732,2214
7970,3621810464,3710098970,1672593071,1672594386,1315
7891,3510857360,3924549929,1672578133,1672580185,2052
7683,3924549929,3755739653,1672605838,1672608526,2688
7763,3428964059,3514128943,1672537944,1672538370,426
7594,3407673904,3512683609,1672541712,1672541976,264
7970,3736419952,3229058858,1672654878,1672657853,2975
7521,3510937904,3855000166,1672674174,1672675999,1825
7656,3711569060,3713208927,1672568289,1672570497,2208
7772,3428006164,3520751702,1672679194,1672679725,531
7751,3497901842,3852595551,1672632555,1672635116,2561
7729,3520376528,3516223597,1672601656,1672604425,2769
7913,3760598102,3711262377,1672689969,1672692018,2049
7828,3466911760,3500803339,1672630409,1672631175,766
7491,3315583351,3716197887,1672668518,1672671990,3472
7796,3388286531,3520012395,1672565255,1672566111,856
7817,3311203656,3513956646,1672555682,1672559112,3430
7586,3855602893,3500805881,1672624304,1672625718,1414
7598,3703223015,3715189301,1672560753,1672561310,557
7575,3512510536,3476232529,1672607696,1672609434,1738
7830,3618045231,3773598056,1672631360,1672633456,2096
7916,3885897503,3391261292,1672566458,1672566780,322
7718,3626156564,3228165483,1672698662,1672701470,2808
7666,3776066388,3517963492,1672642972,1672644480,1508
7511,3388637594,3520629279,1672689305,1672692763,3458
7514,3772053179,3279721246,1672688164,1672691071,2907
7495,3511841857,3812176780,1672683157,1672684732,1575
7617,3496549058,3311761694,1672676717,1672677838,1121
7615,3922275620,3703275621,1672578673,1672581337,2664
7658,3501927421,3791957752,1672567117,1672568991,1874
7832,3924549929,3201432789,1672598243,1672601327,3084
7600,3828624701,3434642576,1672645274,1672646520,1246
7894,3777623166,3883551721,1672673042,1672674364,1322
7505,3513164386,3505219850,1672670349,1672673752,3403
7671,3714474557,3280615985,1672689527,1672689685,158
7844,3792177074,3778780511,1672557416,1672559545,2129
7925,3760992710,3791957752,1672620512,1672621661,1149
7844,3235635976,3664170666,1672631180,1672633444,2264
7533,3346327502,3505219850,1672554842,1672558130,3288
7894,3512567240,3488244966,1672636287,1672638356,2069
7898,3520706195,3760489031,1672630036,1672630461,425
7941,3710098970,3783206719,1672671507,1672673002,1495
7498,3714488548,3703889596,1672563256,1672564054,798
7905,3512510536,3518408774,1672649205,1672651932,2727
7876,3711262377,3550946908,1672702097,1672704789,2692
7711,3628819436,3925402713,1672569801,1672570671,870
7795,3505477652,3634340855,1672559914,1672560320,406
7573,3407673904,3808324264,1672583337,1672586409,3072
7551,3311203656,3756601594,1672684347,1672687139,2792
7863,3909238838,3466229085,1672674598,1672675644,1046
7547,3760489031,3826415738,1672603388,1672604197,809
7691,3488244966,3312829208,1672682157,1672685201,3044
7505,3770021824,3804870229,1672623085,1672624408,1323
7785,3606186086,3514245078,1672588523,1672590490,1967
7698,3792032359,3926700506,1672569476,1672572902,3426
7875,3534553510,3772578994,1672547868,1672547965,97
7701,3783429780,3337544549,1672690100,1672693287,3187
7670,3855424474,3533371364,1672675755,1672675871,116
7652,3760489031,3519152550,1672658788,1672661995,3207
7704,3779528381,3421836608,1672605028,1672607163,2135
7625,3755798867,3407725581,1672533052,1672533869,817
7966,3703441914,3701178711,1672657260,1672659981,2721
7928,3634340855,3511312803,1672657872,1672660933,3061
7938,3380035798,3774339795,1672629761,1672633150,3389
7664,3510937904,3394330287,1672578455,1672581085,2630
7870,3509352754,3500199935,1672641181,1672644077,2896
7630,3976633198,3636867411,1672537854,1672539387,1533
7717,3668005723,3505973226,1672675143,1672676579,1436
7576,3293695955,3703441914,1672554955,1672555126,171
7800,3716843669,3513599775,1672638176,1672639118,942
7507,3778549126,3512683609,1672613240,1672614218,978
7771,3701184889,3497901842,1672568088,1672569040,952
7752,3500066230,3756453423,1672566428,1672569013,2585
7745,3936227020,3885897503,1672606189,1672606493,304
7918,3510247121,3501364586,1672633823,1672636657,2834
7570,3221536550,3883085535,1672535304,1672536316,1012
7774,3487171044,3634786711,1672676918,1672680412,3494
7829,3510969660,3817316561,1672673851,1672677268,3417
7650,3516465662,3428964059,1672605602,1672607070,1468
7709,3734737881,3416427576,1672551165,1672553396,2231
7517,3392121505,3467773920,1672607055,1672608413,1358
7678,3370636709,3606812411,1672625307,1672625482,175
7661,3509630174,3505000737,1672662789,1672664576,1787
7718,3731106822,3730517636,1672637821,1672640062,2241
7583,3555214688,3811171116,1672581943,1672582410,467
7730,3512837326,3500229033,1672563030,1672563114,84
7603,3416265063,3930797455,1672617360,1672618268,908
7767,3703718151,3772746272,1672660975,1672662306,1331
7584,3715492942,3791997875,1672533281,1672534668,1387
7670,3772746272,3793389510,1672556238,1672559541,3303
7886,3339907603,3515691540,1672635833,1672636977,1144
7535,3518360734,3348261553,1672689175,1672689749,574
7737,3713808837,3311324983,1672588046,1672588160,114
7956,3406784491,3511687358,1672667650,1672668478,828
7504,3922275416,3756623396,1672578710,1672579607,897
7714,3757161914,3776948966,1672546733,1672548024,1291
7981,3518932404,3737051610,1672620114,1672622267,2153
7983,3734496778,3244485293,1672667514,1672669315,1801
7523,3833889105,3815508790,1672632889,1672633538,649
7726,3852391257,3622054816,1672564427,1672565648,1221
7929,3489545239,3228165483,1672542806,1672543509,703
7862,3780593036,3505362057,1672556144,1672557781,1637
7741,3519654779,3438645253,1672622842,1672623629,787
7548,3703871468,3613995936,1672589386,1672589739,353
7692,3516606733,3555214688,1672568521,1672569245,724
7943,3424922204,3311154569,1672551736,1672554691,2955
7513,3201848640,3783705817,1672581356,1672584033,2677
7697,3401627165,3711370563,1672605527,1672607387,1860
7793,3492478793,3978105277,1672582180,1672584272,2092
7839,3519601612,3516960534,1672688866,1672688979,113
7951,3477649378,3489962019,1672628905,1672630873,1968
7610,3293695955,3500374658,1672670807,1672672152,1345
7763,3622054816,3780914982,1672613377,1672614065,688
7720,3715127362,3227457126,1672533165,1672535707,2542
7910,3601879040,3685187183,1672594720,1672597966,3246
7521,3853018906,3791874383,1672589439,1672591805,2366
7923,3895562476,3801089989,1672611671,1672613544,1873
7888,3244173074,3332072298,1672631768,1672633065,1297
7674,3780828689,3829232696,1672666135,1672669668,3533
7709,3520756859,3367902229,1672555977,1672557556,1579
7550,3828365570,3223789409,1672567717,1672570367,2650
7486,3773429448,3505791599,1672640694,1672642792,2098
7900,3880285638,3358871377,1672554045,1672555453,1408
7609,3883861463,3505000737,1672537393,1672537505,112
7911,3770021824,3360743849,1672600101,1672603166,3065
7626,3472130842,3533270638,1672627378,1672628644,1266
7801,3344019610,3229665776,1672535906,1672538983,3077
7488,3511435497,3777776687,1672658180,1672660489,2309
7752,3510937904,3637008488,1672650746,1672652039,1293
7502,3313541986,3512217942,1672631155,1672631846,691
7820,3505362057,3634995491,1672634306,1672636602,2296
7614,3311203656,3511841857,1672555414,1672555701,287
7892,3922337974,3519601612,1672588351,1672590792,2441
7783,3481502100,3776948966,1672534402,1672536981,2579
7758,3223968713,3520030713,1672687657,1672688133,476
7780,3534313900,3902383721,1672612583,1672613896,1313
7766,3360743849,3500803339,1672572975,1672575966,2991
7612,3610348516,3280599164,1672556498,1672559498,3000
7699,3903307060,3500578848,1672694025,1672694302,277
7701,3284832486,3770763956,1672652904,1672653081,177
7608,3372883226,3637008488,1672642600,1672644828,2228
7615,3500499542,3505869747,1672654628,1672655810,1182
7641,3914290246,3331845324,1672680039,1672681085,1046
7490,3899266183,3930791338,1672690847,1672693394,2547
7542,3500729955,3755943611,1672643407,1672646963,3556
7507,3827626797,3485375593,1672590890,1672594253,3363
7981,3510771358,3475396323,1672613819,1672614627,808
7621,3772758337,3882291183,1672531638,1672531835,197
7939,3772337814,3483164654,1672669778,1672673291,3513
7694,3976390453,3477375368,1672665368,1672665608,240
7698,3801089989,3516465662,1672581302,1672583481,2179
7965,3404384505,3316173088,1672596326,1672596767,441
7765,3859525941,3924549929,1672564771,1672565688,917
7555,3703223015,3235287260,1672633560,1672636102,2542
7957,3760992710,3399052055,1672612039,1672613737,1698
7583,3501364586,3362000049,1672533201,1672535798,2597
7496,3520183192,3365614305,1672540273,1672543014,2741
7714,3501730685,3805347939,1672635065,1672635784,719
7729,3757447189,3755798867,1672576593,1672579356,2763
7655,3633420270,3939952128,1672655065,1672657379,2314
7516,3550946908,3918584946,1672542203,1672544374,2171
7641,3703223015,3224716315,1672571310,1672573719,2409
7576,3703661585,3307512479,1672534725,1672537422,2697
7873,3500729955,3224058172,1672692116,1672694512,2396
7779,3344019610,3772884106,1672534852,1672535884,1032
7902,3500066230,3500391167,1672589297,1672590028,731
7890,3520888296,3832902928,1672703198,1672705860,2662
7644,3618873142,3515125508,1672534711,1672536696,1985
7620,3792473331,3500894271,1672555650,1672556018,368
7628,3311718847,3604539807,1672661689,1672662568,879
7828,3296471982,3505599848,1672557172,1672560495,3323
7807,3488244966,3505173328,1672605398,1672607837,2439
7568,3783206719,3227457126,1672703105,1672703563,458
7524,3505638204,3736786443,1672645144,1672646914,1770
7761,3909238838,3338367113,1672531295,1672532782,1487
7866,3773755137,3412980697,1672612904,1672615569,2665
7540,3311154569,3223968713,1672697149,1672699514,2365
7497,3303751772,3711370563,1672633861,1672636344,2483
7967,3380035798,3634995491,1672665052,1672666138,1086
7903,3912262917,3511841857,1672576504,1672579581,3077
7490,3716197887,3520730271,1672636910,1672640159,3249
7516,3815508790,3711504540,1672677030,1672680150,3120
7816,3606186086,3534488837,1672668121,1672669075,954
7848,3516909237,3774556560,1672622886,1672625400,2514
7941,3792789881,3365942576,1672548103,1672551216,3113
7648,3777717988,3778980116,1672560776,1672563792,3016
7806,3888559320,3367029997,1672638984,1672641029,2045
7582,3972364603,3509352754,1672584016,1672586211,2195
7645,3399052055,3277605882,1672695464,1672695993,529
7540,3701967560,3926700506,1672652678,1672654977,2299
7669,3791874383,3755436115,1672649117,1672651468,2351
7519,3834257412,3534492426,1672610161,1672612108,1947
7833,3505362057,3318697153,1672620053,1672622315,2262
7812,3234541252,3518408774,1672701463,1672702940,1477
7944,3513080274,3713370078,1672686660,1672689061,2401
7834,3387674757,3247815299,1672579731,1672580223,492
7576,3792789881,3792177074,1672683552,1672685817,2265
7491,3792902982,3756453423,1672538335,1672541005,2670
7559,3881477378,3755042098,1672611521,1672613444,1923
7893,3420432297,3519654779,1672553185,1672556417,3232
7682,3715339701,3774050956,1672626762,1672630349,3587
7977,3711370563,3311154569,1672674923,1672677481,2558
7524,3485823740,3501730685,1672630962,1672634370,3408
7590,3404058699,3505173328,1672539535,1672541662,2127
7637,3359239884,3914259449,1672593674,1672595126,1452
7595,3514128943,3492478793,1672676584,1672678496,1912
7784,3714474557,3772884106,1672582666,1672584606,1940
7506,3416241005,3418534998,1672576125,1672578898,2773
7701,3836573197,3617734118,1672658650,1672660043,1393
7494,3510857360,3346327502,1672656694,1672657263,569
7807,3732481297,3510380060,1672573683,1672574270,587
7869,3533810360,3791874383,1672566646,1672567518,872
7593,3429690204,3377766165,1672575657,1672576016,359
7731,3734828619,3885670556,1672536522,1672537686,1164
7641,3792177074,3601879040,1672558508,1672561898,3390
7654,3618873142,3683766533,1672672058,1672673762,1704
7773,3516716179,3534553510,1672611401,1672613408,2007
7769,3500499542,3716537575,1672693513,1672695073,1560
7929,3365278081,3777514571,1672662244,1672663547,1303
7621,3716843669,3979339287,1672549342,1672552088,2746
7874,3777079686,3773429448,1672594209,1672595163,954
7805,3515691540,3518408774,1672600502,1672602122,1620
7554,3559110998,3793959750,1672672554,1672675892,3338
7704,3520751702,3701178711,1672551522,1672552304,782
7884,3229665776,3716843669,1672566268,1672568001,1733
7592,3626156564,3234541252,1672626128,1672629263,3135
7865,3883042241,3885897503,1672687768,1672690558,2790
7651,3394539273,3512142794,1672662728,1672664202,1474
7754,3621497531,3880285638,1672538918,1672539295,377
7852,3774366875,3229058858,1672570457,1672571246,789
7872,3500060260,3516065852,1672601548,1672604315,2767
7511,3800353779,3776066388,1672597865,1672600310,2445
7980,3913251733,3291235378,1672544593,1672544726,133
7923,3909331423,3885670556,1672531558,1672534900,3342
7635,3978115672,3714821932,1672632276,1672634852,2576
7657,3247815299,3685818092,1672672479,1672674190,1711
7677,3352603894,3296471982,1672656395,1672659698,3303
7660,3685187183,3755798867,1672552569,1672554444,1875
7918,3515284591,3716273414,1672607910,1672609787,1877
7854,3783925755,3394330287,1672671923,1672672224,301
7639,3755739653,3367902229,1672574848,1672578086,3238
7943,3501927421,3714504419,1672593889,1672595256,1367
7776,3465202715,3227457126,1672673734,1672675132,1398
7638,3716165213,3770763956,1672627811,1672630080,2269
7528,3776066388,3509630174,1672583378,1672586972,3594
7542,3511359172,3711262377,1672571857,1672574148,2291
7528,3520751702,3312333615,1672702291,1672704312,2021
7828,3937224533,3511170269,1672658790,1672661029,2239
7498,3701184889,3701967560,1672581005,1672582019,1014
7839,3359910781,3500894271,1672694761,1672696334,1573
7883,3311718847,3399433690,1672617595,1672619205,1610
7634,3229058858,3466229085,1672670194,1672672952,2758
7552,3501759100,3516465662,1672692037,1672695254,3217
7865,3206254161,3701178711,1672625950,1672629481,3531
7620,3505173328,3756930948,1672546874,1672548056,1182
7942,3777806071,3496269445,1672626247,1672628889,2642
7553,3516673015,3489962019,1672568698,1672570292,1594
7794,3779036831,3511163800,1672641873,1672643880,2007
7512,3606987130,3229665776,1672607085,1672608393,1308
7967,3888559320,3937224533,1672594143,1672596924,2781
7862,3760294205,3755943611,1672558618,1672562109,3491
7950,3392121505,3516258476,1672546074,1672548920,2846
7502,3519803045,3839849341,1672675768,1672677352,1584
7892,3314836094,3510969660,1672577187,1672580256,3069
7666,3682061100,3520183192,1672667530,1672668529,999
7859,3855000166,3202120784,1672555195,1672558773,3578
7958,3760183458,3311203656,1672551671,1672552228,557
7886,3227457126,3500994774,1672608743,1672609231,488
7532,3421836608,3756930948,1672612956,1672616415,3459
7841,3978105277,3972364603,1672579149,1672581940,2791
7676,3662180254,3853018906,1672633159,1672635644,2485
7876,3713349754,3716843669,1672559842,1672562211,2369
7565,3600647945,3293695955,1672601647,1672603083,1436
7960,3315583351,3311065516,1672590473,1672592282,1809
7971,3206603608,3773598056,1672692802,1672694594,1792
7853,3496051529,3379256399,1672635346,1672635561,215
7936,3737079798,3734737881,1672537714,1672540260,2546
7649,3516673015,3533095755,1672645636,1672646985,1349
7926,3471220483,3505362057,1672600765,1672601586,821
7829,3777079686,3772642849,1672689583,1672690662,1079
7876,3519069599,3346795719,1672604749,1672606497,1748
7587,3520751702,3533748232,1672557038,1672558992,1954
7924,3780974443,3772309150,1672541058,1672543132,2074
7811,3311203656,3509933351,1672661938,1672663029,1091
7522,3519428855,3501606184,1672569910,1672570255,345
7940,3701146057,3852595551,1672624056,1672627439,3383
7714,3512510536,3511862351,1672682345,1672683455,1110
7778,3731419510,3711262377,1672698668,1672701260,2592
7858,3428674539,3511198618,1672610235,1672611676,1441
7982,3500803339,3791942683,1672660034,1672660128,94
7601,3311415018,3805292782,1672626180,1672627457,1277
7675,3533095755,3978105277,1672703996,1672704237,241
7701,3859525941,3610348516,1672593793,1672594465,672
7728,3918056059,3511841857,1672561483,1672564754,3271
7504,3859525941,3685818092,1672674468,1672675479,1011
7757,3421836608,3773205565,1672634044,1672634668,624
7629,3417061462,3902278226,1672548693,1672550167,1474
7882,3516716179,3421127249,1672542918,1672546338,3420
7940,3625274012,3902383721,1672690572,1672691292,720
7710,3511350608,3608868877,1672584451,1672585356,905
7855,3513164386,3703223015,1672609201,1672610471,1270
7867,3909238838,3836573197,1672676765,1672678812,2047
7490,3716168623,3614238812,1672696880,1672699877,2997
7679,3418728074,3556951786,1672573616,1672575835,2219
7816,3606186086,3485008994,1672587701,1672591240,3539
7918,3516039895,3807987001,1672593972,1672594168,196
7545,3501927421,3510244400,1672541804,1672544340,2536
7498,3505973226,3365614305,1672652120,1672653054,934
7765,3512217942,3359910781,1672539771,1672542801,3030
7550,3533385867,3500229033,1672595973,1672598916,2943
7813,3701190899,3791334389,1672651097,1672653447,2350
7730,3837094550,3701146057,1672610179,1672611492,1313
7791,3411618230,3713786889,1672561241,1672563664,2423
7713,3510771358,3496269445,1672628308,1672630891,2583
7816,3904775198,3280964728,1672626775,1672627042,267
7631,3714821932,3201848640,1672568676,1672571764,3088
7759,3780593036,3756623396,1672648194,1672651150,2956
7950,3733189298,3416265063,1672657201,1672660719,3518
7682,3737154119,3792668962,1672580772,1672581138,366
7911,3465202715,3288764520,1672568379,1672570521,2142
7623,3386707783,3777929708,1672604146,1672605370,1224
7775,3505962865,3365942576,1672683331,1672685226,1895
7568,3356860407,3777514571,1672550949,1672552654,1705
7584,3416427576,3280964728,1672627627,1672629023,1396
7740,3534010629,3774195321,1672569132,1672571906,2774
7745,3390068992,3516909237,1672675835,1672675903,68
7522,3757602960,3793848402,1672595800,1672595894,94
7705,3517721725,3344364444,1672650594,1672653530,2936
7567,3293695955,3822654369,1672630839,1672631701,862
7685,3249401741,3505791599,1672701275,1672701965,690
7635,3489545239,3505145247,1672652697,1672654792,2095
7813,3496269445,3471220483,1672650249,1672652063,1814
7528,3770021824,3937224533,1672586788,1672588189,1401
7752,3510380060,3516606733,1672673885,1672676869,2984
7904,3244173074,3273500349,1672572371,1672574735,2364
7743,3852595551,3757602960,1672634565,1672638024,3459
7892,3616944364,3409474775,1672666720,1672667371,651
7835,3505201246,3716168623,1672563868,1672566122,2254
7543,3516223597,3402943525,1672676023,1672679166,3143
7674,3453729665,3716746253,1672578979,1672580678,1699
7545,3774045700,3296471982,1672564347,1672567769,3422
7874,3806545488,3774066725,1672582292,1672582849,557
7819,3293695955,3777443199,1672660864,1672661340,476
7488,3777623166,3770635361,1672655728,1672656862,1134
7979,3624761861,3634995491,1672633179,1672634129,950
7591,3780609808,3505000737,1672650677,1672652625,1948
7686,3494290908,3783705817,1672589949,1672591590,1641
7791,3534424200,3480687894,1672678399,1672680417,2018
7552,3756601594,3736592744,1672683488,1672686447,2959
7851,3370752401,3859663348,1672543006,1672545634,2628
7918,3773978034,3224716315,1672552173,1672555129,2956
7585,3918056059,3760489031,1672663442,1672666168,2726
7540,3777983879,3710408395,1672597385,1672597942,557
7699,3369998498,3773205565,1672586401,1672588246,1845
7952,3716537575,3416241005,1672633981,1672634205,224
7695,3496549058,3533827120,1672534093,1672534496,403
7553,3496051529,3772758337,1672617299,1672619672,2373
7617,3249401741,3772746272,1672701981,1672703868,1887
7748,3451432842,3458539365,1672600237,1672602715,2478
7881,3855424474,3859663348,1672666671,1672667776,1105
7691,3716537575,3336751428,1672640420,1672643259,2839
7528,3421127249,3273500349,1672682311,1672684165,1854
7602,3427219654,3443698222,1672604379,1672606146,1767
7497,3466911760,3601879040,1672605056,1672607142,2086
7979,3757151210,3337544549,1672580516,1672583019,2503
7541,3772337814,3823600322,1672648472,1672649547,1075
7852,3793338102,3885670556,1672672625,1672675895,3270
7750,3714197325,3800886801,1672640581,1672640982,401
7823,3701146057,3890149705,1672665732,1672666039,307
7603,3312829208,3518014404,1672655328,1672655727,399
7967,3776338577,3608868877,1672581833,1672582404,571
7935,3397418363,3364543015,1672672848,1672674656,1808
7889,3715981584,3817621391,1672616917,1672617908,991
7979,3701984666,3756601594,1672644991,1672647465,2474
7933,3516016437,3777983879,1672662000,1672663688,1688
7717,3828624701,3610695419,1672614153,1672614808,655
7862,3760598102,3701995648,1672555455,1672557740,2285
7975,3773814927,3496051529,1672628997,1672632447,3450
7926,3716835696,3201432789,1672598615,1672600884,2269
7888,3417587765,3701967560,1672629608,1672630016,408
7520,3683959482,3770553384,1672593515,1672594413,898
7666,3715581279,3517077106,1672596053,1672597283,1230
7949,3783126683,3552314511,1672628663,1672630360,1697
7491,3511125626,3903307060,1672550443,1672552939,2496
7950,3800353779,3792032359,1672630819,1672631814,995
7691,3805519285,3791020967,1672630971,1672634201,3230
7894,3505292701,3827626797,1672536999,1672538005,1006
7775,3834257412,3683959482,1672689264,1672690391,1127
7848,3358871377,3853018906,1672543455,1672545228,1773
7884,3466229085,3715127362,1672552895,1672555142,2247
7525,3533095755,3774556560,1672680344,1672683443,3099
7651,3231056870,3520730271,1672547717,1672548540,823
7761,3520706195,3978105277,1672577546,1672580464,2918
7741,3417061462,3492478793,1672635433,1672637849,2416
7773,3774556560,3899204805,1672696161,1672696446,285
7504,3518876135,3716168623,1672544433,1672545319,886
7830,3338367113,3910454786,1672608566,1672611055,2489
7540,3533095755,3703275621,1672644509,1672645458,949
7544,3520706195,3332072298,1672580970,1672582779,1809
7547,3519069599,3554917400,1672592099,1672595237,3138
7822,3714962248,3505219850,1672600693,1672601513,820
7912,3760598102,3277939457,1672672510,1672673803,1293
7560,3778341199,3627937312,1672619135,1672622234,3099
7782,3910454786,3885897503,1672567093,1672568816,1723
7909,3505791599,3902383721,1672675088,1672678091,3003
7726,3777623166,3399052055,1672548907,1672549296,389
7632,3701691675,3516606733,1672650618,1672651028,410
7903,3313541986,3519654779,1672614247,1672616361,2114
7598,3500994774,3500803339,1672591866,1672593303,1437
7484,3518669703,3351554343,1672682277,1672684455,2178
7965,3406784491,3505904952,1672636370,1672639250,2880
7773,3703661585,3774204963,1672565815,1672566909,1094
7540,3756424865,3773429448,1672632423,1672634176,1753
7559,3480687894,3407725581,1672609729,1672611891,2162
7956,3348261553,3370636709,1672672104,1672674565,2461
7611,3505219850,3756528686,1672625350,1672627099,1749
7626,3889232789,3713349754,1672535176,1672538521,3345
7935,3404058699,3298433163,1672658919,1672661962,3043
7649,3770101921,3713370078,1672636762,1672638466,1704
7629,3500199935,3701898991,1672650489,1672652814,2325
7787,3939952128,3511125626,1672662670,1672663581,911
7547,3249247700,3501606184,1672642016,1672644327,2311
7512,3755511676,3416427576,1672603969,1672604844,875
7536,3791942683,3510711755,1672563093,1672566071,2978
7695,3311154569,3883551721,1672566233,1672569672,3439
7811,3901877072,3501184421,1672558052,1672560043,1991
7493,3365614305,3351008918,1672625015,1672625564,549
7568,3433804879,3365942576,1672628848,1672629422,574
7919,3510969660,3390068992,1672596084,1672598669,2585
7630,3409474775,3805342762,1672557947,1672558184,237
7967,3434642576,3660493209,1672682846,1672684195,1349
7873,3206254161,3779218771,1672703444,1672704717,1273
7538,3208844525,3518791447,1672643327,1672645364,2037
7907,3249401741,3451432842,1672660377,1672662357,1980
7595,3791942683,3362000049,1672649583,1672650743,1160
7812,3666457294,3397418363,1672595977,1672599024,3047
7871,3232962003,3235635976,1672625061,1672628264,3203
7698,3780788622,3496269445,1672567342,1672569580,2238
7777,3922275620,3416265063,1672634073,1672637421,3348
7566,3493507965,3370752401,1672610910,1672611558,648
7517,3501606184,3235287260,1672684222,1672686681,2459
7858,3397418363,3505477652,1672654181,1672655014,833
7818,3244436890,3777623166,1672574291,1672576661,2370
7890,3467773920,3833889105,1672598146,1672600624,2478
7605,3334033993,3510857360,1672664802,1672666753,1951
7624,3434642576,3791901535,1672628494,1672630099,1605
7855,3494290908,3277669002,1672568917,1672572447,3530
7880,3520756859,3710112546,1672557548,1672559643,2095
7770,3533653428,3714962248,1672657160,1672658431,1271
7884,3608868877,3817621391,1672550350,1672552231,1881
7805,3716488385,3773429448,1672619034,1672621448,2414
7487,3515723720,3802367797,1672567049,1672570096,3047
7847,3500177712,3515723720,1672636509,1672637571,1062
7906,3711370563,3511359172,1672549919,1672550488,569
7669,3200198928,3852391257,1672696458,1672698122,1664
7981,3827377568,3318697153,1672559802,1672561749,1947
7905,3606186086,3774125065,1672603206,1672604077,871
7968,3510380060,3829232696,1672666613,1672668851,2238
7815,3500499542,3476232529,1672672671,1672672944,273
7663,3518932404,3827626797,1672604392,1672605514,1122
7521,3512540951,3885897503,1672666195,1672666686,491
7783,3774466457,3625274012,1672640972,1672644434,3462
7517,3421127249,3201432789,1672552240,1672555656,3416
7934,3501601840,3903009525,1672577127,1672578764,1637
7863,3516258476,3778108318,1672669507,1672669921,414
7781,3774580701,3903009525,1672563128,1672565625,2497
7810,3780365428,3534313900,1672561762,1672565105,3343
7821,3336751428,3475396323,1672689382,1672691503,2121
7829,3880310724,3509453566,1672641294,1672644516,3222
7735,3331845324,3711198793,1672650653,1672652826,2173
7682,3516980378,3516716179,1672695967,1672696680,713
7958,3777983879,3514987389,1672687173,1672687946,773
7845,3755920131,3501927421,1672563659,1672563984,325
7802,3910454786,3912262917,1672616968,1672617833,865
7777,3511125626,3222448362,1672588403,1672591717,3314
7974,3732481297,3244436890,1672561003,1672564097,3094
7623,3800353779,3793871337,1672602104,1672602775,671
7850,3887270940,3434642576,1672561377,1672564588,3211
7575,3772337814,3792032359,1672533090,1672536518,3428
7603,3703013906,3805292782,1672612093,1672615253,3160
7648,3760267716,3516223597,1672604536,1672607055,2519
7817,3379256399,3200198928,1672667455,1672667747,292
7914,3817316561,3396086535,1672623124,1672626003,2879
7806,3703718151,3235287260,1672598039,1672599843,1804
7490,3979339287,3500374658,1672566194,1672568837,2643
7842,3500177712,3770553384,1672698347,1672698601,254
7577,3313564074,3427283336,1672652877,1672653930,1053
7916,3304056063,3477375368,1672534870,1672537055,2185
7623,3512510536,3380035798,1672598062,1672601262,3200
7915,3777514571,3834257412,1672664969,1672667184,2215
7521,3467773920,3610695419,1672539423,1672540685,1262
7497,3475795792,3517864478,1672672397,1672673827,1430
7908,3416427576,3227457126,1672631111,1672633244,2133
7586,3778341199,3505347134,1672540949,1672543828,2879
7585,3489728806,3235287260,1672660958,1672662534,1576
7890,3610348516,3399004969,1672561708,1672562358,650
7795,3501483568,3783779671,1672678549,1672681066,2517
7718,3714474557,3533137446,1672657729,1672660874,3145
7692,3304056063,3911159965,1672537884,1672538511,627
7787,3714474557,3772746272,1672535422,1672538985,3563
7697,3614238812,3315583351,1672602746,1672602916,170
7846,3777929708,3760492950,1672617596,1672620985,3389
7766,3783245561,3606987130,1672608445,1672609329,884
7741,3779976989,3716273414,1672559004,1672561468,2464
7555,3773429448,3518876135,1672612706,1672614710,2004
7714,3286658957,3473562469,1672614149,1672615228,1079
7841,3311274543,3420432297,1672573979,1672576848,2869
7592,3756623396,3387674757,1672665834,1672666736,902
7490,3513956646,3713786889,1672603987,1672604679,692
7908,3713268590,3835382117,1672539433,1672539602,169
7967,3911245524,3916289176,1672580748,1672581911,1163
7836,3512969370,3757403279,1672555810,1672559384,3574
7628,3811694763,3501601840,1672609998,1672610488,490
7492,3349613093,3509630174,1672532234,1672535601,3367
7868,3972364603,3634786711,1672593134,1672595851,2717
7637,3839849341,3829232696,1672589196,1672590628,1432
7897,3770824086,3703789494,1672604741,1672607342,2601
7671,3224716315,3783206719,1672566542,1672569024,2482
7978,3792844210,3918674986,1672683779,1672684855,1076
7817,3760267716,3311208440,1672688539,1672690328,1789
7781,3505173328,3514283243,1672699882,1672701163,1281
7622,3937224533,3621810464,1672602513,1672603511,998
7744,3313541986,3828432634,1672532223,1672534897,2674
7750,3714504419,3976633198,1672644419,1672645292,873
7811,3774366875,3200198928,1672603239,1672603404,165
7516,3757562897,3639847263,1672554724,1672555091,367
7794,3898995675,3891751546,1672591331,1672592285,954
7761,3223968713,3733189298,1672630305,1672631747,1442
7611,3559110998,3209027249,1672547632,1672550838,3206
7725,3685818092,3501692334,1672671568,1672672969,1401
7501,3793627961,3510771358,1672666126,1672666195,69
7560,3515151980,3791657947,1672683454,1672686820,3366
7704,3836573197,3882291183,1672631521,1672633005,1484
7559,3772309166,3533810360,1672637900,1672638082,182
7615,3475795792,3247815299,1672580858,1672582464,1606
7974,3359910781,3755436115,1672669424,1672672488,3064
7766,3516514391,3978115672,1672674128,1672676973,2845
7594,3416427576,3793627961,1672676501,1672677433,932
7962,3711380716,3271938399,1672624468,1672624571,103
7720,3346327502,3736790081,1672623030,1672623447,417
7608,3899266183,3793753089,1672663114,1672664980,1866
7796,3465254146,3515394721,1672608420,1672610164,1744
7580,3622054816,3399004969,1672630166,1672632725,2559
7637,3369998498,3818255890,1672665594,1672667503,1909
7935,3780813786,3636867411,1672668260,1672669617,1357
7933,3703275621,3417587765,1672565877,1672566074,197
7981,3301107849,3519703355,1672635006,1672637425,2419
7892,3385763781,3534702203,1672629093,1672632440,3347
7618,3244173074,3359910781,1672552703,1672554180,1477
7846,3512349371,3755392666,1672590735,1672591352,617
7520,3772544062,3234541252,1672690200,1672691142,942
7494,3519152550,3711973519,1672573660,1672575118,1458
7800,3738502357,3390068992,1672679420,1672680539,1119
7860,3515394721,3777477395,1672605378,1672608019,2641
7968,3738274418,3336751428,1672606694,1672608106,1412
7762,3509672210,3534553510,1672622459,1672624245,1786
7907,3760077057,3688418210,1672574443,1672575401,958
7863,3701146057,3373384732,1672604980,1672605735,755
7745,3534492426,3511312803,1672645336,1672647737,2401
7574,3379256399,3793848402,1672580298,1672581524,1226
7897,3333896808,3465202715,1672628263,1672630270,2007
7741,3478194807,3777936328,1672606646,1672607961,1315
7615,3515723720,3778980116,1672642269,1672643265,996
7908,3519654779,3501759100,1672688190,1672688615,425
7804,3777514571,3519803045,1672596895,1672599352,2457
7692,3276993580,3428674539,1672695556,1672696166,610
7579,3518496488,3901877072,1672598778,1672599763,985
7724,3505292701,3792253549,1672537727,1672539338,1611
7836,3882291183,3703661585,1672580874,1672584095,3221
7816,3501692334,3406784491,1672586311,1672589131,2820
7570,3554917400,3791334389,1672560257,1672563442,3185
7483,3359239884,3399004969,1672626061,1672629074,3013
7909,3439023335,3711198793,1672576142,1672579488,3346
7589,3770101921,3407954858,1672533239,1672536415,3176
7745,3505219850,3357483218,1672577979,1672581238,3259
7736,3760992710,3859525941,1672541618,1672542500,882
7563,3732481297,3404058699,1672642981,1672643126,145
7756,3714962248,3533626375,1672588033,1672590565,2532
7855,3853018906,3773598056,1672606763,1672609170,2407
7804,3311845971,3533095755,1672689265,1672689620,355
7816,3365278081,3634786711,1672625295,1672625378,83
7979,3430074045,3501955238,1672658552,1672659249,697
7796,3756601594,3361230905,1672579002,1672582414,3412
7721,3501184421,3505869747,1672571751,1672574751,3000
7770,3512837326,3516960534,1672577660,1672578451,791
7607,3622054816,3760561634,1672580863,1672583024,2161
7806,3710344260,3903307060,1672620055,1672623148,3093
7802,3793286136,3534488837,1672590887,1672592034,1147
7647,3715189301,3701178711,1672617780,1672618221,441
7793,3417587765,3779218771,1672631661,1672633543,1882
7728,3404384505,3822654369,1672583573,1672585250,1677
7538,3778305740,3979339287,1672642448,1672644229,1781
7842,3737154119,3534424200,1672670963,1672672549,1586
7799,3780639480,3519152550,1672532125,1672533589,1464
7519,3736786443,3298433163,1672586150,1672586784,634
7953,3519703355,3500658339,1672558561,1672562073,3512
7805,3791334389,3505201246,1672645370,1672646129,759
7858,3206254161,3427283336,1672541487,1672544226,2739
7745,3610695419,3793286136,1672601706,1672602376,670
7610,3621810464,3359239884,1672688834,1672691397,2563
7869,3404384505,3770763956,1672599273,1672602399,3126
7682,3510703546,3930791338,1672636350,1672638637,2287
7536,3517509185,3372883226,1672692832,1672693928,1096
7695,3682061100,3881477378,1672649980,1672652419,2439
7940,3291235378,3512683609,1672663072,1672664925,1853
7601,3224716315,3505912939,1672635905,1672638757,2852
7751,3791602225,3911159965,1672584335,1672586799,2464
7824,3519428855,3489217083,1672602855,1672606302,3447
7581,3805347939,3793848402,1672557243,1672558546,1303
7497,3505702787,3818255890,1672553161,1672556285,3124
7498,3365614305,3360743849,1672590094,1672591725,1631
7548,3921211276,3756623396,1672550774,1672551016,242
7504,3793871337,3534702203,1672541969,1672544504,2535
7714,3911159965,3519556068,1672576406,1672577979,1573
7923,3792177074,3516673015,1672652556,1672655263,2707
7734,3711569060,3534492426,1672558475,1672558906,431
7587,3430504438,3209027249,1672578605,1672581979,3374
7883,3926700506,3713268590,1672556705,1672557878,1173
7754,3509453566,3931941795,1672531792,1672533505,1713
7493,3774466457,3714197325,1672566759,1672570069,3310
7760,3516039895,3827626797,1672612244,1672615619,3375
7945,3608868877,3349613093,1672597247,1672597336,89
7817,3433804879,3221536550,1672559967,1672562372,2405
7577,3510126867,3711380716,1672637773,1672638862,1089
7832,3208844525,3666507626,1672609076,1672611163,2087
7490,3391915886,3516629436,1672627602,1672628601,999
7903,3666457294,3428674539,1672686350,1672687981,1631
7627,3882291183,3760509236,1672664636,1672666516,1880
7542,3223789409,3505000737,1672658879,1672660581,1702
7690,3800886801,3881477378,1672671956,1672673301,1345
7964,3757455053,3518360734,1672554191,1672555222,1031
7622,3509773875,3505193212,1672625456,1672626090,634
7893,3518669703,3511312803,1672539854,1672540491,637
7951,3505873261,3779740455,1672602043,1672603523,1480
7755,3515723720,3715581279,1672626576,1672626726,150
7516,3610348516,3510969660,1672566077,1672568508,2431
7889,3714821932,3713786889,1672622152,1672622812,660
7929,3972364603,3688418210,1672689592,1672691775,2183
7788,3488244966,3520183192,1672672649,1672675001,2352
7591,3715492942,3755625324,1672597833,1672600589,2756
7909,3314836094,3500729955,1672607949,1672610152,2203
7566,3496051529,3773205565,1672634612,1672636855,2243
7578,3801089989,3783925755,1672641273,1672643382,2109
7630,3918584946,3792032359,1672583265,1672586467,3202
7781,3890149705,3711370563,1672645141,1672647335,2194
7511,3428964059,3713969578,1672643715,1672645289,1574
7768,3505292701,3480687894,1672614736,1672617067,2331
7872,3520931254,3901877072,1672555886,1672558190,2304
7980,3208844525,3617734118,1672567601,1672569549,1948
7613,3515860749,3778341199,1672649249,1672649881,632
7686,3805292782,3837094550,1672577554,1672580224,2670
7549,3880310724,3772544062,1672655486,1672655877,391
7667,3512217942,3280599164,1672578330,1672579331,1001
7658,3311871871,3428964059,1672670474,1672672312,1838
7882,3311415018,3735319397,1672659551,1672661479,1928
7906,3388286531,3607748895,1672649386,1672650445,1059
7512,3221536550,3501364586,1672553174,1672556025,2851
7854,3886298125,3514283243,1672585739,1672587794,2055
7803,3500229033,3757403279,1672605315,1672606140,825
7805,3732481297,3701065786,1672638458,1672639855,1397
7563,3202120784,3715492942,1672532968,1672534664,1696
7487,3855937514,3209027249,1672578129,1672580443,2314
7649,3244173074,3556951786,1672630264,1672630932,668
7565,3774045700,3827222533,1672624665,1672626993,2328
7535,3757562897,3772309150,1672665108,1672666099,991
7622,3294803686,3827377568,1672655367,1672655798,431
7733,3776948966,3370752401,1672662162,1672664153,1991
7895,3792288302,3755872268,1672623973,1672626662,2689
7716,3701274634,3714962248,1672574660,1672578185,3525
7866,3520888296,3820354437,1672621239,1672622870,1631
7777,3739106581,3793848402,1672579973,1672582514,2541
7602,3514719601,3778305740,1672578128,1672578468,340
7574,3533371364,3387966152,1672557692,1672558149,457
7616,3715974031,3774050956,1672600785,1672603655,2870
7975,3701498253,3973560347,1672583832,1672587197,3365
7918,3289061738,3837094550,1672652756,1672655849,3093
7887,3772359096,3362000049,1672673389,1672673722,333
7613,3777717988,3428674539,1672673770,1672677099,3329
7531,3510771358,3792844210,1672619664,1672622013,2349
7544,3701498253,3221899927,1672569054,1672570494,1440
7843,3827377568,3517721725,1672662826,1672665567,2741
7788,3774204963,3509352754,1672627890,1672628399,509
7753,3713370078,3770021824,1672620361,1672622628,2267
7936,3511312803,3490191091,1672577076,1672577976,900
7569,3475396323,3802367797,1672563517,1672564165,648
7672,3605726278,3513956646,1672631846,1672635257,3411
7921,3701498253,3710569131,1672575259,1672577782,2523
7913,3922275620,3791115967,1672588964,1672592393,3429
7890,3880310724,3880285638,1672686487,1672686686,199
7861,3760267716,3280599164,1672614010,1672614388,378
7616,3613995936,3703889596,1672640966,1672642907,1941
7760,3234541252,3703718151,1672553169,1672555487,2318
7618,3778549126,3886298125,1672544142,1672546302,2160
7486,3448855696,3510594211,1672643259,1672644370,1111
7846,3519563836,3778980116,1672625992,1672628548,2556
7721,3608868877,3238712269,1672557496,1672558585,1089
7762,3713894336,3311871871,1672596556,1672599273,2717
7982,3222521619,3772884106,1672593921,1672595133,1212
7743,3903307060,3500365158,1672639453,1672640380,927
7824,3518408774,3277669002,1672555170,1672558567,3397
7902,3978115672,3533748232,1672540026,1672541141,1115
7559,3518669703,3311845971,1672660052,1672660747,695
7641,3757602960,3912536808,1672578376,1672579133,757
7836,3833889105,3629935998,1672631538,1672633949,2411
7507,3791594391,3827626797,1672577954,1672578385,431
7531,3783239924,3791942683,1672693735,1672695551,1816
7535,3826633236,3760598102,1672598185,1672599987,1802
7507,3793286136,3318697153,1672680002,1672680414,412
7580,3519152550,3249791738,1672596826,1672599808,2982
7687,3683959482,3500904641,1672647940,1672650393,2453
7709,3277669002,3882242815,1672699263,1672699506,243
7646,3512349371,3428006164,1672627862,1672628217,355
7692,3311274543,3416265063,1672580418,1672583582,3164
7578,3617734118,3301107849,1672570681,1672573395,2714
7533,3716197887,3459030804,1672632380,1672633371,991
7755,3793848402,3777120536,1672557919,1672558132,213
7602,3772337814,3901990690,1672598799,1672600972,2173
7562,3417061462,3777623166,1672605614,1672607079,1465
7593,3514472925,3443698222,1672621327,1672623162,1835
7641,3774050956,3223968713,1672698761,1672700408,1647
7894,3760893269,3454042520,1672683209,1672683583,374
7493,3776948966,3505173328,1672632717,1672634876,2159
7662,3792032359,3311324983,1672701393,1672702370,977
7895,3606186086,3811694763,1672613945,1672614010,65
7938,3505362057,3703441914,1672671471,1672672157,686
7810,3505873261,3505362057,1672610067,1672611221,1154
7896,3277669002,3773465237,1672614877,1672616072,1195
7714,3533193862,3392121505,1672679121,1672681022,1901
7776,3319752091,3637008488,1672554844,1672556910,2066
7710,3791115967,3730517636,1672661671,1672663170,1499
7888,3777455223,3509352754,1672616631,1672618894,2263
7708,3777936328,3978105277,1672581414,1672583745,2331
7689,3279721246,3839849341,1672676330,1672677991,1661
7514,3792789881,3783083229,1672640647,1672641763,1116
7735,3773755137,3773950140,1672600927,1672601659,732
7600,3510247121,3770635361,1672622954,1672625905,2951
7882,3772746272,3420432297,1672685770,1672686342,572
7749,3828624701,3332072298,1672633801,1672634694,893
7865,3734496778,3773465237,1672596379,1672598404,2025
7959,3276993580,3792253549,1672700025,1672701252,1227
7533,3475795792,3911159965,1672698179,1672700321,2142
7786,3352603894,3701863557,1672576110,1672579194,3084
7851,3755881905,3221899927,1672690621,1672693672,3051
7859,3516465662,3517476351,1672650050,1672651987,1937
7960,3247780536,3518014404,1672615158,1672618156,2998
7734,3773120434,3885670556,1672689731,1672690678,947
7759,3800886801,3516673015,1672638334,1672641246,2912
7981,3891751546,3304056063,1672564057,1672566649,2592
7682,3889750851,3610695419,1672637550,1672637909,359
7646,3516258476,3426325549,1672655674,1672657079,1405
7655,3688683847,3518260334,1672637426,1672640555,3129
7812,3533280269,3606186086,1672540755,1672543055,2300
7950,3826633236,3427219654,1672550165,1672550473,308
7623,3484995752,3774005526,1672644708,1672646970,2262
7710,3924549929,3311154569,1672551507,1672553339,1832
7773,3738274418,3606186086,1672587837,1672591316,3479
7648,3391261292,3817621391,1672633510,1672635984,2474
7506,3756021689,3387674757,1672554134,1672554512,378
7561,3737079798,3534553510,1672558700,1672561588,2888
7891,3516039895,3428964059,1672672819,1672673422,603
7805,3505135325,3346327502,1672688680,1672691004,2324
7790,3774010081,3377766165,1672608375,1672610405,2030
7897,3516465662,3883085535,1672618431,1672619481,1050
7556,3500805881,3392121505,1672670845,1672673142,2297
7864,3315583351,3739106581,1672627020,1672629707,2687
7781,3703718151,3793871337,1672615241,1672618814,3573
7952,3737051610,3520751702,1672617803,1672620361,2558
7756,3344364444,3519654779,1672621597,1672622713,1116
7705,3774045700,3519654779,1672624680,1672625358,678
7674,3823600322,3921211276,1672633041,1672633378,337
7817,3222521619,3362000049,1672622199,1672625622,3423
7644,3471220483,3518014404,1672668877,1672671804,2927
7816,3236102733,3367029997,1672702830,1672704371,1541
7585,3500374658,3331845324,1672585220,1672586070,850
7923,3352603894,3716746253,1672534143,1672536779,2636
7688,3418728074,3534553510,1672689897,1672692677,2780
7840,3276993580,3417587765,1672604440,1672605896,1456
7900,3783531004,3516960534,1672683897,1672687182,3285
7679,3777929708,3505635228,1672675631,1672677379,1748
7895,3307097200,3349613093,1672696495,1672699317,2822
7715,3201848640,3774268456,1672534450,1672535446,996
7865,3510594211,3500487333,1672552455,1672554437,1982
7550,3627937312,3822654369,1672579617,1672582656,3039
7731,3807987001,3711380716,1672680610,1672682574,1964
7875,3501198706,3839849341,1672611849,1672612253,404
7693,3913251733,3519069599,1672642090,1672644639,2549
7725,3817621391,3515860749,1672583024,1672586260,3236
7713,3755587522,3770851318,1672663266,1672665338,2072
7532,3365278081,3520751702,1672677551,1672679075,1524
7491,3348261553,3716273414,1672552410,1672552699,289
7890,3349613093,3505912939,1672675604,1672675701,97
7694,3757447189,3434642576,1672614646,1672614982,336
7825,3793962300,3280964728,1672545114,1672547388,2274
7591,3518791447,3924549929,1672594667,1672596171,1504
7798,3703871468,3903009525,1672543676,1672546562,2886
7916,3774298222,3857349323,1672675291,1672677672,2381
7682,3505219850,3517963492,1672555559,1672556855,1296
7496,3628819436,3757562897,1672627296,1672629328,2032
7584,3303751772,3311203656,1672693027,1672696395,3368
7681,3399004969,3520730271,1672538946,1672540330,1384
7522,3604539807,3713349754,1672555752,1672558164,2412
7948,3792902982,3756623396,1672647143,1672649743,2600
7773,3774556560,3777477395,1672646298,1672647635,1337
7696,3231056870,3935127663,1672582736,1672585204,2468
7578,3715127362,3755943611,1672621435,1672622946,1511
7878,3357483218,3443698222,1672567198,1672568844,1646
7931,3458539365,3780974443,1672545146,1672545483,337
7771,3496269445,3780609808,1672549985,1672551787,1802
7484,3736625083,3711265369,1672586963,1672590355,3392
7543,3500199935,3511267139,1672647488,1672649289,1801
7739,3777079686,3512510536,1672655377,1672658669,3292
7979,3755587522,3793959750,1672654913,1672655912,999
7863,3512969370,3404384505,1672546548,1672549052,2504
7885,3520206212,3509453566,1672689926,1672691915,1989
7921,3500066230,3483949762,1672656787,1672657682,895
7810,3446948848,3804870229,1672643169,1672644147,978
7532,3520183192,3616944364,1672546625,1672547227,602
7880,3298288268,3465202715,1672588427,1672588947,520
7668,3827377568,3770021824,1672535778,1672538198,2420
7938,3755943611,3792768129,1672557504,1672560068,2564
7789,3889232789,3932051427,1672536925,1672539813,2888
7821,3372883226,3333896808,1672549137,1672549299,162
7486,3512683609,3359910781,1672616020,1672619217,3197
7868,3359910781,3778341199,1672559967,1672561217,1250
7794,3915628728,3505292701,1672556125,1672559097,2972
7565,3828432634,3760492950,1672653030,1672656170,3140
7980,3500894271,3920801189,1672592688,1672594061,1373
7725,3710569131,3737051610,1672616285,1672616894,609
7501,3713349754,3755042098,1672581478,1672583347,1869
7885,3288764520,3713370078,1672678175,1672679171,996
7645,3792288302,3703718151,1672569024,1672572578,3554
7899,3611150562,3520756859,1672628672,1672628906,234
7553,3510244400,3552314511,1672684294,1672687675,3381
7615,3883551721,3395152943,1672605572,1672607259,1687
7530,3351008918,3517077106,1672607964,1672611464,3500
7653,3932051427,3378686918,1672625450,1672626257,807
7571,3488244966,3780813786,1672625837,1672626151,314
7867,3716746253,3550946908,1672584817,1672588168,3351
7636,3209027249,3485008994,1672568983,1672569353,370
7807,3614238812,3209551760,1672685240,1672685455,215
7842,3360993964,3917278625,1672655044,1672657403,2359
7496,3520629279,3714504419,1672673642,1672674901,1259
7637,3512720680,3518932404,1672700859,1672701966,1107
7853,3703735129,3809916577,1672569033,1672570466,1433
7798,3937224533,3517476351,1672624765,1672625154,389
7950,3384951177,3510247121,1672610448,1672612786,2338
7860,3514283243,3512567240,1672654362,1672656111,1749
7842,3608633356,3344019610,1672692590,1672695952,3362
7839,3627937312,3439023335,1672639408,1672641206,1798
7668,3421127249,3888559320,1672658362,1672659094,732
7884,3757161914,3512166013,1672566658,1672569065,2407
7695,3715492942,3772053179,1672552302,1672554761,2459
7562,3477375368,3891751546,1672553402,1672555947,2545
7886,3284639858,3311203656,1672701269,1672703677,2408
7489,3851190615,3505702787,1672603176,1672605521,2345
7982,3372883226,3298433163,1672577593,1672578502,909
7504,3352603894,3501486692,1672544934,1672548011,3077
7815,3482405588,3737154119,1672641477,1672643656,2179
7948,3805292782,3918056059,1672618751,1672621041,2290
7885,3811694763,3716258994,1672604263,1672605257,994
7615,3510126867,3683959482,1672616462,1672618049,1587
7638,3500729955,3505702787,1672600126,1672601577,1451
7933,3276993580,3298433163,1672666013,1672668441,2428
7503,3904408902,3304625412,1672595697,1672598024,2327
7983,3231056870,3800353779,1672667172,1672670719,3547
7804,3209048907,3716746253,1672662948,1672666454,3506
7910,3822654369,3311415018,1672580673,1672581072,399
7678,3312829208,3358871377,1672593615,1672594230,615
7818,3701863557,3533095755,1672579899,1672581512,1613
7725,3311324983,3475396323,1672639805,1672640818,1013
7908,3716168623,3349613093,1672566074,1672568125,2051
7754,3817621391,3417970574,1672600912,1672602230,1318
7501,3511125626,3827377568,1672560178,1672563404,3226
7761,3513599775,3783925755,1672690648,1672693894,3246
7909,3533927138,3514128943,1672571711,1672573136,1425
7875,3793436995,3791553060,1672562578,1672563141,563
7606,3792473331,3839849341,1672581587,1672584123,2536
7727,3739106581,3777477395,1672680580,1672682411,1831
7918,3296471982,3899371911,1672583097,1672586572,3475
7633,3534313900,3516039895,1672570033,1672573370,3337
7783,3791115967,3357483218,1672690435,1672692672,2237
7898,3899266183,3378686918,1672612585,1672614417,1832
7600,3730517636,3533369198,1672668031,1672669598,1567
7636,3518014636,3496549058,1672587758,1672588367,609
7823,3294803686,3772309150,1672654426,1672654905,479
7948,3249791738,3930791338,1672701450,1672701753,303
7611,3904408902,3701065786,1672565292,1672567685,2393
7787,3488244966,3851190615,1672609303,1672611356,2053
7902,3701691675,3520206212,1672546239,1672546666,427
7790,3757246925,3357483218,1672591870,1672593510,1640
7583,3516039895,3500994774,1672591861,1672594172,2311
7820,3616944364,3777790718,1672601217,1672604407,3190
7959,3711308224,3505599848,1672627164,1672629816,2652
7643,3516673015,3912262917,1672589007,1672590430,1423
7898,3703441914,3779036831,1672580704,1672581563,859
7603,3224716315,3773664987,1672610774,1672611950,1176
7862,3806545488,3904775198,1672646003,1672646473,470
7969,3855602893,3315583351,1672674108,1672674399,291
7632,3600647945,3772359096,1672656757,1672660172,3415
7517,3518260334,3755881905,1672673543,1672674417,874
7747,3755436115,3783239924,1672668539,1672669737,1198
7658,3792883665,3832902928,1672564315,1672566741,2426
7511,3778108318,3384951177,1672600019,1672600986,967
7664,3351008918,3359239884,1672616063,1672617318,1255
7841,3760489031,3418728074,1672668907,1672670092,1185
7875,3853018906,3411618230,1672653938,1672654755,817
7621,3277605882,3703735129,1672545554,1672547112,1558
7955,3394539273,3314836094,1672600631,1672601707,1076
7653,3520012395,3777936328,1672643797,1672645463,1666
7617,3399535232,3311718847,1672620443,1672620530,87
7560,3519069599,3480687894,1672590850,1672592253,1403
7527,3791997875,3476232529,1672686189,1672687941,1752
7744,3232962003,3276993580,1672559486,1672560070,584
7901,3481502100,3516980378,1672645068,1672646078,1010
7571,3349613093,3834257412,1672630384,1672633837,3453
7798,3311415018,3533137446,1672590371,1672592485,2114
7974,3500487333,3367902229,1672686819,1672688391,1572
7710,3774520233,3311065516,1672613731,1672615459,1728
7531,3520206212,3852391257,1672690882,1672692792,1910
7773,3716843669,3518408774,1672567871,1672568812,941
7962,3533927138,3898995675,1672613819,1672615078,1259
7954,3284832486,3534010629,1672697689,1672700307,2618
7661,3701984666,3793389510,1672544109,1672545805,1696
7716,3783509527,3401627165,1672550342,1672553252,2910
7969,3772337814,3779036831,1672674405,1672677212,2807
7872,3421127249,3760992710,1672677793,1672678867,1074
7619,3513201436,3505292701,1672549887,1672552162,2275
7679,3510594211,3359239884,1672626842,1672630247,3405
7801,3774366875,3760569731,1672678358,1672678633,275
7711,3519069599,3438645253,1672540456,1672543041,2585
7691,3756462516,3465202715,1672561640,1672563623,1983
7917,3912536808,3760509236,1672537602,1672538722,1120
7983,3778341199,3500391167,1672678486,1672681380,2894
7881,3624761861,3428674539,1672622596,1672625106,2510
7824,3511198618,3815508790,1672702851,1672705593,2742
7689,3760077057,3780813786,1672583296,1672583921,625
7940,3899266183,3284832486,1672541039,1672544591,3552
7715,3792902982,3793389510,1672687833,1672688137,304
7511,3509352754,3511267139,1672633973,1672637390,3417
7939,3613995936,3917278625,1672620415,1672623906,3491
7690,3533385867,3701274634,1672540944,1672543885,2941
7867,3496269445,3515691540,1672688167,1672688273,106
7829,3533827120,3429856982,1672619117,1672621679,2562
7744,3660493209,3772758337,1672638671,1672639951,1280
7794,3600647945,3475795792,1672532588,1672534556,1968
7513,3914259449,3777936328,1672580373,1672582532,2159
7504,3935127663,3711308224,1672559735,1672562235,2500
7561,3510937904,3756528686,1672600798,1672604090,3292
7979,3201432789,3209048907,1672626490,1672628787,2297
7502,3710098970,3792253549,1672695194,1672695506,312
7530,3517721725,3481647420,1672636375,1672638922,2547
7865,3514128943,3515284591,1672636947,1672637917,970
7726,3533653428,3701898991,1672653430,1672654847,1417
7888,3756601594,3735319397,1672618553,1672620542,1989
7957,3386707783,3276640712,1672676356,1672677622,1266
7807,3713370078,3770763956,1672580269,1672582596,2327
7948,3736229191,3734828619,1672637093,1672637623,530
7571,3319752091,3711198793,1672541922,1672545034,3112
7497,3416427576,3448855696,1672572927,1672575247,2320
7941,3481502100,3417061462,1672600542,1672601859,1317
7665,3247780536,3918056059,1672574957,1672578522,3565
7574,3760183458,3399004969,1672582239,1672582358,119
7652,3773429448,3922275620,1672605828,1672608687,2859
7978,3209048907,3715581279,1672638165,1672639110,945
7932,3780294829,3760992710,1672555912,1672558195,2283
7709,3779740455,3783083229,1672568840,1672571505,2665
7898,3756424865,3757403279,1672550135,1672553352,3217
7486,3760509236,3755625324,1672604172,1672605227,1055
7486,3277939457,3428006164,1672696225,1672698015,1790
7557,3733891182,3921211276,1672662545,1672663045,500
7692,3505145247,3779218771,1672541608,1672542132,524
7772,3636867411,3311603601,1672692739,1672694881,2142
7912,3364543015,3973560347,1672568445,1672570842,2397
7932,3501486692,3505098372,1672565677,1672565828,151
7850,3513599775,3489217083,1672657231,1672657484,253
7978,3367902229,3792177074,1672574010,1672577337,3327
7510,3617055293,3715339701,1672589568,1672591241,1673
7937,3783196518,3882997884,1672585359,1672586061,702
7930,3512349371,3208844525,1672571368,1672573578,2210
7816,3883312122,3515125508,1672575141,1672577574,2433
7623,3777443199,3773598056,1672654800,1672657064,2264
7799,3514283243,3505292701,1672563711,1672565197,1486
7978,3776513891,3279721246,1672575078,1672578148,3070
7874,3715581279,3600647945,1672566359,1672567077,718
7540,3500060260,3773664987,1672560265,1672563681,3416
7571,3899371911,3379256399,1672691692,1672693961,2269
7719,3703661585,3465202715,1672679732,1672681141,1409
7489,3800353779,3481502100,1672610999,1672614351,3352
7680,3346327502,3485823740,1672633379,1672634806,1427
7612,3206593906,3714962248,1672675454,1672676977,1523
7646,3783206719,3777983879,1672555230,1672557810,2580
7677,3473765852,3756966035,1672532843,1672536404,3561
7941,3629935998,3912262917,1672571775,1672573237,1462
7559,3779976989,3774338212,1672692511,1672693183,672
7948,3501364586,3500391167,1672629891,1672630280,389
7919,3685818092,3249791738,1672701425,1672702252,827
7928,3736592744,3617734118,1672546309,1672549743,3434
7709,3703735129,3516606733,1672668468,1672669977,1509
7948,3487171044,3291227780,1672624429,1672626488,2059
7713,3500199935,3770635361,1672699021,1672702126,3105
7904,3773755137,3716900301,1672613530,1672616021,2491
7683,3801089989,3485823740,1672692002,1672693857,1855
7703,3510711755,3939952128,1672571847,1672572470,623
7734,3668898102,3496549058,1672638257,1672638471,214
7815,3357483218,3792288302,1672609160,1672610119,959
7795,3518876135,3793627961,1672663071,1672664464,1393
7538,3391915886,3701898991,1672667340,1672668685,1345
7908,3388372715,3339907603,1672628259,1672631361,3102
7681,3516016437,3500578848,1672683289,1672683551,262
7835,3378092448,3793871337,1672624220,1672625077,857
7954,3336742544,3710344260,1672633963,1672636536,2573
7768,3352603894,3936227020,1672635415,1672638093,2678
7675,3921211276,3736625083,1672554817,1672555101,284
7533,3601879040,3800886801,1672642923,1672645760,2837
7600,3774045700,3756453423,1672597136,1672597476,340
7874,3625274012,3701274634,1672544413,1672545862,1449
7625,3611150562,3484995752,1672556449,1672557752,1303
7937,3367029997,3756451663,1672682474,1672685248,2774
7612,3501927421,3438645253,1672544390,1672547658,3268
7634,3516980378,3772337814,1672631924,1672635118,3194
7708,3515723720,3756453423,1672675848,1672676465,617
7845,3246596716,3433804879,1672634456,1672636610,2154
7548,3932051427,3500365158,1672551703,1672552483,780
7534,3701065786,3826759140,1672689426,1672692443,3017
7491,3519563836,3430074045,1672658255,1672660093,1838
7938,3889232789,3779629905,1672665533,1672665604,71
7787,3533653428,3791115967,1672594467,1672594703,236
7698,3360993964,3660493209,1672632119,1672634571,2452
7974,3277939457,3793436995,1672602538,1672604179,1641
7533,3779976989,3813052709,1672673587,1672673670,83
7671,3713969578,3391261292,1672547563,1672548330,767
7723,3242408357,3772884106,1672581491,1672583005,1514
7704,3715998609,3384240055,1672602976,1672606164,3188
7813,3912262917,3520206212,1672692882,1672696467,3585
7870,3805347939,3228165483,1672596325,1672599379,3054
7515,3277939457,3228165483,1672699359,1672702340,2981
7617,3902383721,3755392666,1672547546,1672549359,1813
7808,3634995491,3756021689,1672579542,1672581726,2184
7639,3629935998,3505869747,1672608006,1672609486,1480
7862,3228165483,3311090974,1672554306,1672556161,1855
7888,3760267716,3909331423,1672542942,1672546302,3360
7777,3518932404,3757562897,1672628544,1672628785,241
7727,3887270940,3365942576,1672594428,1672596517,2089
7671,3935127663,3780294829,1672663490,1672664309,819
7744,3711262377,3910454786,1672691663,1672693061,1398
7839,3910886626,3778266283,1672552624,1672554523,1899
7706,3755042098,3206254161,1672663906,1672665061,1155
7600,3714197325,3505098372,1672594641,1672596431,1790
7775,3510711755,3607748895,1672660645,1672663033,2388
7826,3911159965,3737079798,1672660356,1672662515,2159
7766,3701898991,3277669002,1672555640,1672558855,3215
7494,3755392666,3500805881,1672656270,1672657898,1628
7864,3701178711,3505201246,1672583584,1672585788,2204
7944,3629547065,3716273414,1672585812,1672587038,1226
7789,3511267139,3903962771,1672623708,1672625333,1625
7906,3793627961,3839849341,1672571258,1672571838,580
7758,3710408395,3485823740,1672567973,1672570565,2592
7809,3882291183,3513599775,1672566579,1672566986,407
7975,3345207877,3520751702,1672586567,1672588133,1566
7915,3859525941,3349613093,1672533091,1672534541,1450
7832,3534488837,3634995491,1672702064,1672703890,1826
7918,3895562476,3714197325,1672678677,1672681914,3237
7927,3774204963,3517255726,1672538527,1672542117,3590
7716,3298433163,3885670556,1672537701,1672540208,2507
7646,3394539273,3822654369,1672649276,1672651317,2041
7844,3505201246,3976390453,1672627876,1672630042,2166
7785,3682061100,3774127586,1672592607,1672595212,2605
7499,3735733948,3783239924,1672644746,1672647897,3151
7929,3710569131,3703718151,1672598660,1672601541,2881
7688,3791115967,3756601594,1672667783,1672669460,1677
7832,3399004969,3899266183,1672554900,1672557000,2100
7630,3755436115,3911159965,1672567510,1672568260,750
7673,3550946908,3415443558,1672634861,1672637863,3002
7765,3477649378,3307512479,1672622002,1672622362,360
7741,3622054816,3332072298,1672684066,1672686948,2882
7504,3716843669,3482405588,1672671957,1672674542,2585
7685,3755436115,3280964728,1672537786,1672539625,1839
7980,3880310724,3711370563,1672686897,1672688282,1385
7803,3520751702,3312829208,1672619187,1672621462,2275
7840,3666506258,3703013906,1672595923,1672597963,2040
7558,3715981584,3223968713,1672545712,1672548867,3155
7731,3910454786,3756453423,1672532677,1672534692,2015
7844,3734737881,3716165213,1672665161,1672667817,2656
7864,3779976989,3505962865,1672680583,1672681900,1317
7913,3792883665,3512969370,1672603251,1672606527,3276
7754,3511435497,3825229501,1672621493,1672621750,257
7658,3703661585,3888559320,1672551533,1672553284,1751
7583,3534313900,3627937312,1672560838,1672562965,2127
7580,3886298125,3509352754,1672552250,1672552816,566
7658,3362000049,3791997875,1672680073,1672683036,2963
7642,3713208927,3921211276,1672658532,1672660136,1604
7818,3500374658,3774005526,1672549128,1672549670,542
7736,3930797455,3716258994,1672653613,1672656358,2745
7762,3433804879,3608868877,1672578802,1672581304,2502
7947,3500229033,3337544549,1672546862,1672549909,3047
7662,3791020967,3514838220,1672670353,1672670719,366
7928,3505347134,3777717988,1672587797,1672591279,3482
7658,3533827120,3505859863,1672625815,1672628273,2458
7814,3793338102,3518408774,1672545154,1672546703,1549
7698,3517963492,3816454165,1672694485,1672696670,2185
7558,3621497531,3511841857,1672595936,1672597951,2015
7808,3791115967,3770763956,1672545212,1672547516,2304
7905,3514283243,3710408395,1672592153,1672595268,3115
7904,3774268456,3713208927,1672585840,1672587996,2156
7837,3703013906,3510594211,1672642375,1672644164,1789
7965,3624761861,3835382117,1672537887,1672541209,3322
7818,3773465237,3518014636,1672657199,1672657334,135
7794,3248507722,3801089989,1672652442,1672653997,1555
7572,3783509527,3791334389,1672693108,1672696234,3126
7958,3397418363,3279721246,1672671792,1672673239,1447
7716,3409474775,3534424200,1672535637,1672535819,182
7899,3825229501,3777623166,1672646807,1672649118,2311
7530,3792288302,3511350608,1672659062,1672660807,1745
7789,3711504540,3513599775,1672627756,1672630919,3163
7534,3666553782,3399535232,1672577304,1672579142,1838
7528,3367902229,3510703546,1672610255,1672612199,1944
7812,3736229191,3505912939,1672551358,1672554077,2719
7630,3791874383,3819727225,1672701604,1672702808,1204
7554,3918247820,3608868877,1672660849,1672661527,678
7683,3505635228,3228165483,1672605131,1672605269,138
7702,3713630656,3201848640,1672559037,1672560140,1103
7652,3688683847,3520719611,1672567129,1672569229,2100
7869,3520709480,3832902928,1672672180,1672674098,1918
7634,3294803686,3777477395,1672699148,1672701416,2268
7876,3713208927,3417061462,1672679699,1672682190,2491
7638,3703718151,3235635976,1672637980,1672641437,3457
7690,3703441914,3713208927,1672613567,1672615905,2338
7878,3550946908,3232962003,1672670175,1672670646,471
7545,3311603601,3511435497,1672623498,1672626939,3441
7490,3739106581,3514245078,1672695244,1672698426,3182
7725,3301107849,3703718151,1672658647,1672660486,1839
7563,3626156564,3515691540,1672594366,1672597082,2716
7741,3519428855,3791997875,1672652666,1672654759,2093
7673,3533626375,3601879040,1672620960,1672624259,3299
7652,3301107849,3286658957,1672622812,1672623283,471
7582,3783779671,3913251733,1672663652,1672664661,1009
7846,3607178184,3402943525,1672558527,1672561638,3111
7740,3701691675,3777477395,1672667593,1672670126,2533
7508,3496051529,3500066230,1672595601,1672597727,2126
7653,3791942683,3770851318,1672676443,1672678874,2431
7721,3465254146,3407725581,1672683288,1672684512,1224
7545,3783779671,3736786443,1672641826,1672643628,1802
7705,3412825109,3760569731,1672547165,1672547749,584
7734,3505869747,3731106822,1672556337,1672559832,3495
7690,3514719601,3311993075,1672578574,1672581114,2540
7596,3288764520,3826759140,1672631373,1672632637,1264
7758,3379589402,3400918687,1672669050,1672671872,2822
7836,3430504438,3224058172,1672566405,1672569050,2645
7740,3774204963,3483949762,1672536943,1672537395,452
7872,3777929708,3777477395,1672606666,1672610006,3340
7636,3356860407,3293695955,1672562012,1672562087,75
7901,3222448362,3713630656,1672665286,1672666515,1229
7631,3916289176,3407954858,1672589493,1672590841,1348
7680,3701065786,3889750851,1672580863,1672582274,1411
7846,3415546117,3711308224,1672589239,1672591346,2107
7628,3505869747,3812176780,1672702355,1672704925,2570
7909,3512969370,3235287260,1672571721,1672574323,2602
7851,3710569131,3792902982,1672580627,1672581886,1259
7483,3777717988,3817621391,1672627856,1672631168,3312
7830,3511125626,3390068992,1672672351,1672673731,1380
7483,3513201436,3625274012,1672586377,1672588399,2022
7541,3534553510,3515691540,1672616233,1672619409,3176
7629,3249401741,3407673904,1672681008,1672681837,829
7819,3228165483,3910454786,1672622974,1672623716,742
7565,3307097200,3756453423,1672626903,1672629959,3056
7772,3304056063,3500177712,1672681199,1672683266,2067
7918,3430352815,3778780511,1672622118,1672624215,2097
7849,3624312512,3277605882,1672567825,1672570277,2452
7488,3311993075,3520030713,1672572020,1672574723,2703
7847,3778266283,3855602893,1672670073,1672671217,1144
7832,3319752091,3793338102,1672566758,1672569735,2977
7505,3701146057,3978105277,1672689975,1672692560,2585
7848,3710067113,3476232529,1672572657,1672573205,548
7956,3297463265,3792177074,1672534013,1672536835,2822
7594,3607178184,3624761861,1672614720,1672616865,2145
7824,3533827120,3772642849,1672662826,1672664675,1849
7561,3420432297,3710098970,1672656034,1672657357,1323
7887,3228165483,3505649239,1672652702,1672653867,1165
7812,3344019610,3882242815,1672639749,1672643132,3383
7765,3779036831,3312829208,1672556367,1672559694,3327
7690,3662180254,3373384732,1672653707,1672657198,3491
7804,3714197325,3472130842,1672559874,1672563052,3178
7807,3930791338,3520719611,1672682685,1672684616,1931
7696,3822654369,3774298222,1672545379,1672548429,3050
7862,3365278081,3710067113,1672562286,1672565539,3253
7766,3755739653,3756623396,1672554005,1672556610,2605
7967,3512837326,3805519285,1672615772,1672616706,934
7973,3518932404,3500391167,1672592840,1672595109,2269
7707,3734496778,3716165213,1672693311,1672693468,157
7499,3899266183,3378436155,1672690689,1672692065,1376
7880,3625274012,3511198618,1672544688,1672547987,3299
7747,3813052709,3401627165,1672658314,1672659316,1002
7837,3246596716,3516223597,1672696749,1672698898,2149
7542,3294803686,3429856982,1672667897,1672670723,2826
7885,3420700674,3223789409,1672542833,1672546138,3305
7486,3517864478,3378686918,1672615935,1672616230,295
7692,3628819436,3703871468,1672663581,1672665523,1942
7746,3475258557,3244436890,1672694704,1672696586,1882
7880,3885897503,3621497531,1672589601,1672591641,2040
7658,3420700674,3757682496,1672627693,1672628868,1175
7564,3351554343,3280599164,1672586055,1672586679,624
7579,3755872268,3716537575,1672544416,1672545385,969
7793,3715189301,3509933351,1672703763,1672705965,2202
7637,3279721246,3501601840,1672699416,1672702163,2747
7581,3756623396,3756451663,1672665954,1672666184,230
7699,3791553060,3406784491,1672565313,1672568262,2949
7856,3405494240,3733891182,1672542282,1672544399,2117
7516,3280964728,3516065852,1672673127,1672675933,2806
7684,3683766533,3836573197,1672546772,1672549925,3153
7752,3755587522,3756930948,1672595498,1672596541,1043
7805,3384240055,3221536550,1672562548,1672565659,3111
7804,3774119563,3500578848,1672641771,1672643011,1240
7973,3715998609,3229665776,1672649351,1672650655,1304
7752,3533810360,3358871377,1672658665,1672659039,374
7548,3285400528,3458539365,1672624007,1672626854,2847
7518,3757455053,3756601594,1672658560,1672659290,730
7624,3777443199,3760569731,1672621391,1672623710,2319
7512,3451432842,3501927421,1672675934,1672678552,2618
7842,3510711755,3909606423,1672632083,1672632762,679
7566,3756601594,3505904952,1672672939,1672675065,2126
7545,3224058172,3416265063,1672569243,1672569478,235
7798,3625274012,3736786443,1672614319,1672616011,1692
7606,3496549058,3514987389,1672657908,1672659648,1740
7969,3351008918,3760077057,1672629089,1672630921,1832
7928,3711262377,3400804807,1672668075,1672669135,1060
7903,3777477395,3234541252,1672531467,1672533968,2501
7742,3288764520,3889750851,1672550323,1672552171,1848
7882,3812176780,3373384732,1672603963,1672605896,1933
7597,3412825109,3302626661,1672622863,1672626397,3534
7631,3514838220,3304056063,1672671945,1672672182,237
7849,3711380716,3331845324,1672584136,1672584352,216
7535,3500391167,3417587765,1672604393,1672606687,2294
7708,3501730685,3518408774,1672621449,1672622795,1346
7649,3209027249,3636867411,1672626301,1672629456,3155
7868,3430074045,3501601840,1672678490,1672681450,2960
7760,3316222192,3244485293,1672654648,1672656131,1483
7873,3505145247,3883551721,1672625635,1672627564,1929
7594,3516606733,3826759140,1672692531,1672693836,1305
7490,3774466457,3520190170,1672626699,1672629880,3181
7642,3714504419,3501692334,1672595960,1672598882,2922
7694,3757812939,3386707783,1672682331,1672682826,495
7970,3519912874,3533137446,1672533130,1672535433,2303
7627,3903962771,3517963492,1672626602,1672627444,842
7883,3634340855,3533369198,1672677022,1672678129,1107
7759,3514128943,3400804807,1672654820,1672656654,1834
7919,3505649239,3367029997,1672546106,1672549186,3080
7703,3800886801,3606987130,1672693455,1672695742,2287
7523,3757812939,3500803339,1672670755,1672671109,354
7579,3519152550,3939952128,1672626845,1672629948,3103
7726,3232962003,3520709480,1672593987,1672595816,1829
7639,3500199935,3855602893,1672687462,1672688014,552
7553,3555214688,3827626797,1672687217,1672690644,3427
7607,3517864478,3858918246,1672537887,1672540941,3054
7721,3770078063,3496051529,1672535764,1672538491,2727
7902,3889232789,3202120784,1672567356,1672569727,2371
7779,3291227780,3639847263,1672637923,1672641051,3128
7666,3509453566,3911245524,1672575015,1672575452,437
7601,3311065516,3501486692,1672660539,1672661027,488
7661,3902278226,3819727225,1672562385,1672564551,2166
7650,3804870229,3713349754,1672582290,1672582997,707
7510,3534488837,3891751546,1672627126,1672628738,1612
7718,3701498253,3975287541,1672694253,1672696491,2238
7732,3509672210,3200691026,1672567247,1672569511,2264
7851,3770824086,3776513891,1672544654,1672545881,1227
7654,3792789881,3774066725,1672670774,1672671326,552
7773,3918247820,3780609808,1672665078,1672666953,1875
7910,3293695955,3917278625,1672554971,1672556193,1222
7556,3534702203,3518360734,1672689889,1672691750,1861
7671,3760992710,3835382117,1672600826,1672601132,306
7583,3703955926,3512837326,1672549664,1672551009,1345
7572,3416241005,3703441914,1672618297,1672618919,622
7705,3916289176,3488244966,1672563894,1672567074,3180
7872,3401627165,3701498253,1672650763,1672651250,487
7950,3925620998,3417970574,1672628871,1672631412,2541
7923,3735319397,3978105277,1672701980,1672703475,1495
7907,3774793839,3714474557,1672674640,1672677540,2900
7749,3517255726,3780503655,1672644366,1672645347,981
7535,3220716272,3625274012,1672600628,1672604138,3510
7898,3916289176,3428964059,1672594446,1672596768,2322
7520,3519601612,3714821932,1672631859,1672633969,2110
7631,3387966152,3930797455,1672650020,1672650192,172
7795,3489962019,3760893269,1672539408,1672541951,2543
7857,3715127362,3365830990,1672550062,1672551203,1141
7586,3465202715,3512349371,1672695139,1672697193,2054
7887,3716488385,3828624701,1672562833,1672563364,531
7728,3606812411,3501184421,1672688494,1672689758,1264
7526,3500729955,3505292701,1672573353,1672573582,229
7727,3791020967,3756462516,1672587864,1672589273,1409
7781,3519601612,3791901535,1672671478,1672673696,2218
7918,3736786443,3812176780,1672654109,1672657020,2911
7709,3390068992,3731419510,1672572270,1672573200,930
7602,3311761694,3976633198,1672618905,1672619935,1030
7958,3511312803,3518791447,1672667592,1672668871,1279
7634,3489217083,3505599848,1672652245,1672654533,2288
7938,3338703270,3511350608,1672645936,1672648541,2605
7752,3715974031,3480687894,1672696306,1672698951,2645
7727,3451432842,3501198706,1672627902,1672630880,2978
7613,3715339701,3917088658,1672577639,1672579604,1965
7849,3972364603,3501483568,1672567279,1672568453,1174
7487,3357483218,3379589402,1672657858,1672658682,824
7667,3822654369,3735319397,1672608152,1672611455,3303
7672,3714821932,3757447189,1672686397,1672688853,2456
7579,3318697153,3774119563,1672670767,1672671299,532
7798,3505362057,3780639480,1672594471,1672596009,1538
7670,3774338212,3881477378,1672701679,1672703544,1865
7962,3816853177,3514719601,1672691376,1672692509,1133
7734,3500894271,3792883665,1672652015,1672652304,289
7937,3512567240,3379589402,1672533922,1672534094,172
7569,3224716315,3701984666,1672613625,1672614529,904
7563,3297463265,3372883226,1672693812,1672696625,2813
7680,3500994774,3773814927,1672569001,1672570296,1295
7592,3711262377,3385763781,1672569690,1672572631,2941
7590,3485823740,3773465237,1672591565,1672594295,2730
7645,3424922204,3201324715,1672580908,1672583897,2989
7897,3770021824,3367029997,1672611628,1672614635,3007
7892,3779629905,3778308417,1672689315,1672690566,1251
7966,3370752401,3914290246,1672655074,1672655606,532
7842,3511359172,3533270638,1672574738,1672577134,2396
7750,3500487333,3917088658,1672690919,1672691409,490
7743,3780294829,3515394721,1672649353,1672652859,3506
7911,3818255890,3666553782,1672627648,1672627847,199
7700,3898995675,3550946908,1672697439,1672697949,510
7939,3512837326,3311208440,1672644626,1672645245,619
7642,3509907947,3902278226,1672653976,1672654903,927
7658,3514245078,3733189298,1672611207,1672614104,2897
7715,3777514571,3783705817,1672675059,1672678171,3112
7768,3336742544,3755625324,1672603404,1672604168,764
7615,3736229191,3910454786,1672565664,1672567649,1985
7722,3505347134,3434642576,1672574796,1672576564,1768
7731,3792473331,3904408902,1672651186,1672652402,1216
7594,3793959750,3487171044,1672692397,1672695238,2841
7794,3296471982,3780974443,1672613375,1672615055,1680
7629,3511163800,3711262377,1672543020,1672544301,1281
7959,3736625083,3514245078,1672627291,1672629980,2689
7696,3703789494,3501955238,1672610287,1672612281,1994
7750,3438645253,3518876135,1672537789,1672537851,62
7943,3432689543,3713208927,1672699609,1672703122,3513
7704,3516606733,3615046771,1672636651,1672638900,2249
7641,3516980378,3811694763,1672645941,1672647376,1435
7912,3518014636,3391261292,1672646284,1672648898,2614
7833,3399911573,3792177074,1672611932,1672613303,1371
7973,3910886626,3344019610,1672646858,1672647230,372
7953,3466911760,3701111745,1672666596,1672668530,1934
7732,3516673015,3715581279,1672631381,1672631693,312
7923,3334033993,3715127362,1672679579,1672680050,471
7644,3703223015,3430074045,1672596012,1672596941,929
7891,3516629436,3783531004,1672596380,1672596964,584
7606,3701178711,3912536808,1672639652,1672642022,2370
7694,3533025282,3783531004,1672698970,1672700734,1764
7981,3348261553,3792768129,1672587354,1672589208,1854
7632,3421836608,3510969660,1672591913,1672594780,2867
7845,3432689543,3805342762,1672676778,1672676897,119
7754,3227457126,3755881905,1672653965,1672654631,666
7783,3428674539,3773755137,1672603624,1672606925,3301
7737,3453729665,3918056059,1672681687,1672683902,2215
7620,3514838220,3755739653,1672596882,1672599108,2226
7830,3505193212,3756451663,1672700497,1672701796,1299
7942,3227158514,3828624701,1672545908,1672548374,2466
7961,3770101921,3976633198,1672639595,1672640814,1219
7717,3899266183,3359239884,1672567760,1672568902,1142
7752,3776513891,3756528686,1672593452,1672593591,139
7505,3505145247,3713786889,1672697103,1672699682,2579
7631,3610695419,3515125508,1672693352,1672695048,1696
7980,3756451663,3711973519,1672594625,1672594814,189
7636,3822654369,3501955238,1672536274,1672536697,423
7576,3466229085,3715981584,1672542593,1672544195,1602
7799,3978105277,3515860749,1672622099,1672622930,831
7837,3227158514,3780788622,1672622184,1672622649,465
7814,3970117174,3852595551,1672556734,1672559010,2276
7494,3682061100,3489545239,1672654810,1672656339,1529
7912,3882291183,3760492950,1672672815,1672674657,1842
7654,3899371911,3311718847,1672576154,1672576789,635
7901,3932051427,3776800213,1672554466,1672554738,272
7603,3736592744,3501759100,1672598904,1672601910,3006
7972,3925402713,3336742544,1672609316,1672610282,966
7518,3779036831,3500994774,1672611383,1672611957,574
7940,3332072298,3472130842,1672637083,1672637827,744
7978,3488244966,3284832486,1672654826,1672657450,2624
7897,3607178184,3533193862,1672628605,1672630228,1623
7751,3755798867,3772758337,1672561734,1672564879,3145
7870,3839849341,3889750851,1672595744,1672598726,2982
7515,3783126683,3911245524,1672584849,1672586775,1926
7873,3805342762,3533193862,1672650965,1672651171,206
7674,3485823740,3914259449,1672570394,1672572638,2244
7842,3209383861,3273500349,1672691097,1672693396,2299
7489,3346795719,3417970574,1672680935,1672681508,573
7575,3271938399,3511267139,1672574011,1672577099,3088
7722,3701184889,3404058699,1672657338,1672659035,1697
7692,3244173074,3715127362,1672640779,1672642949,2170
7596,3512540951,3755392666,1672578649,1672579312,663
7684,3738502357,3711265369,1672655109,1672657912,2803
7557,3916289176,3811694763,1672548711,1672552253,3542
7847,3501927421,3454042520,1672587267,1672588528,1261
7958,3520206212,3397418363,1672561418,1672564032,2614
7501,3710098970,3500904641,1672677256,1672677842,586
7961,3711308224,3288764520,1672701995,1672704462,2467
7836,3249791738,3937224533,1672684351,1672685401,1050
7614,3793871337,3701691675,1672629666,1672632694,3028
7729,3778305740,3509604974,1672696032,1672699629,3597
7941,3634995491,3515860749,1672577659,1672580703,3044
7513,3734828619,3533242305,1672621101,1672624445,3344
7966,3910886626,3888559320,1672650539,1672653788,3249
7610,3316222192,3932051427,1672583534,1672586072,2538
7820,3895562476,3793871337,1672686288,1672688400,2112
7743,3510711755,3356860407,1672575809,1672578888,3079
7949,3606987130,3391915886,1672625164,1672625797,633
7710,3732481297,3783083229,1672671246,1672674704,3458
7951,3791874383,3713894336,1672666463,1672668002,1539
7802,3400918687,3505859863,1672560582,1672563741,3159
7546,3793436995,3792789881,1672565976,1672569145,3169
7490,3412980697,3777717988,1672661170,1672661688,518
7877,3311065516,3780593036,1672597168,1672598895,1727
7490,3520756859,3407725581,1672609774,1672610161,387
7598,3791334389,3760492950,1672670835,1672672241,1406
7850,3316222192,3514245078,1672598180,1672599420,1240
7650,3512567240,3636867411,1672560086,1672563634,3548
7666,3519152550,3972709319,1672684077,1672685577,1500
7566,3505702787,3519556068,1672554962,1672558267,3305
7977,3426325549,3477375368,1672590404,1672592528,2124
7555,3520709480,3510969660,1672557145,1672558439,1294
7643,3332072298,3511170269,1672642688,1672644338,1650
7797,3519069599,3711308224,1672617994,1672620459,2465
7598,3736790081,3501483568,1672610826,1672610917,91
7934,3284639858,3778980116,1672679095,1672681249,2154
7702,3973560347,3703013906,1672594888,1672595405,517
7694,3937224533,3510247121,1672538333,1672541237,2904
7612,3516909237,3351008918,1672604168,1672606728,2560
7815,3501759100,3505859863,1672703140,1672706638,3498
7756,3714488548,3512969370,1672669006,1672670202,1196
7787,3500805881,3377766165,1672647235,1672647906,671
7884,3533095755,3911159965,1672628063,1672629501,1438
7842,3710067113,3517864478,1672588026,1672589246,1220
7948,3791997875,3485375593,1672555239,1672557698,2459
7805,3505962865,3517459919,1672553772,1672557112,3340
7667,3714821932,3500229033,1672655177,1672657562,2385
7816,3223968713,3857349323,1672675709,1672679127,3418
7555,3555214688,3711370563,1672590624,1672591689,1065
7537,3822654369,3918674986,1672624520,1672627078,2558
7623,3505362057,3518932404,1672561361,1672563440,2079
7736,3760077057,3302626661,1672655531,1672658491,2960
7936,3715998609,3365830990,1672586342,1672586674,332
7625,3793627961,3314245084,1672549133,1672552487,3354
7717,3667680268,3389115045,1672572994,1672576041,3047
7808,3533385867,3513164386,1672601738,1672604744,3006
7703,3533810360,3911245524,1672642772,1672644739,1967
7720,3402943525,3668898102,1672591725,1672594435,2710
7794,3783509527,3610695419,1672673039,1672675614,2575
7651,3312664885,3430352815,1672601114,1672603449,2335
7495,3500994774,3399535232,1672640602,1672641904,1302
7553,3899371911,3399052055,1672629082,1672632547,3465
7843,3779218771,3770078063,1672553927,1672554048,121
7806,3882997884,3501955238,1672656137,1672658155,2018
7964,3899371911,3703661585,1672603043,1672605012,1969
7547,3757447189,3511350608,1672666323,1672666810,487
7641,3520183192,3634340855,1672628288,1672631426,3138
7502,3882997884,3500658339,1672554347,1672557336,2989
7592,3756453423,3232962003,1672614300,1672617608,3308
7559,3715998609,3313541986,1672610434,1672613771,3337
7898,3291235378,3859525941,1672625790,1672626024,234
7487,3434642576,3477375368,1672553176,1672556062,2886
7766,3534492426,3312829208,1672542855,1672545824,2969
7568,3291235378,3501927421,1672626017,1672626836,819
7666,3280964728,3774066725,1672658181,1672659240,1059
7897,3805519285,3246596716,1672587950,1672590495,2545
7765,3914259449,3336742544,1672605415,1672606711,1296
7809,3883042241,3389115045,1672554254,1672557568,3314
7670,3713808837,3760598102,1672649320,1672650624,1304
7977,3509604974,3406784491,1672701659,1672703525,1866
7844,3779528381,3972709319,1672660391,1672663456,3065
7746,3232962003,3710098970,1672549928,1672553270,3342
7658,3605726278,3311203656,1672549934,1672551188,1254
7722,3379256399,3903307060,1672539552,1672540045,493
7871,3501927421,3510937904,1672548649,1672550915,2266
7614,3703889596,3448855696,1672616040,1672619340,3300
7656,3774066725,3780294829,1672578919,1672579544,625
7705,3895562476,3505873261,1672658367,1672659773,1406
7649,3385763781,3930797455,1672602527,1672605508,2981
7802,3777717988,3385763781,1672534973,1672536281,1308
7716,3244173074,3774501422,1672688801,1672690983,2182
7808,3853018906,3367902229,1672634327,1672637640,3313
7633,3374559242,3978115672,1672541228,1672542123,895
7669,3891751546,3616944364,1672684011,1672685673,1662
7982,3505873261,3277669002,1672590968,1672593705,2737
7823,3701967560,3500066230,1672602243,1672603891,1648
7890,3500391167,3488244966,1672535460,1672538893,3433
7787,3430504438,3779218771,1672678809,1672682405,3596
7678,3715998609,3365278081,1672701312,1672704588,3276
7911,3404058699,3915628728,1672601210,1672603358,2148
7970,3500365158,3511332835,1672557651,1672558353,702
7618,3773814927,3827377568,1672627527,1672628477,950
7805,3392121505,3202120784,1672597651,1672600753,3102
7801,3734496778,3500458761,1672538461,1672539899,1438
7866,3713349754,3909606423,1672688410,1672689531,1121
7963,3915628728,3639847263,1672678888,1672680799,1911
7880,3805292782,3826415738,1672611742,1672613419,1677
7968,3519700826,3779036831,1672657488,1672658988,1500
7684,3209027249,3298288268,1672676211,1672677829,1618
7908,3852595551,3714962248,1672567911,1672568297,386
7709,3776513891,3778108318,1672614251,1672617432,3181
7955,3710408395,3715339701,1672665614,1672668793,3179
7620,3242408357,3829232696,1672623336,1672626094,2758
7728,3783429780,3519152550,1672610375,1672610461,86
7845,3559110998,3776948966,1672642495,1672645104,2609
7676,3430352815,3772053179,1672659133,1672662197,3064
7867,3345207877,3780914982,1672673724,1672676144,2420
7913,3509630174,3909238838,1672584125,1672584566,441
7763,3776948966,3505135325,1672629812,1672630599,787
7901,3365830990,3520376528,1672532343,1672534065,1722
7969,3244436890,3731106822,1672703441,1672705840,2399
7534,3833889105,3227158514,1672548641,1672551865,3224
7585,3780639480,3520756859,1672692140,1672693052,912
7759,3451432842,3520165601,1672623848,1672627057,3209
7726,3489962019,3613995936,1672613073,1672616270,3197
7662,3817621391,3496549058,1672596940,1672599135,2195
7683,3511271692,3377766165,1672649153,1672650470,1317
7598,3776948966,3206254161,1672649820,1672650385,565
7734,3505203158,3711370563,1672689193,1672691765,2572
7613,3517864478,3972709319,1672655478,1672655621,143
7696,3770851318,3279721246,1672623212,1672626290,3078
7825,3829764737,3732481297,1672565898,1672568888,2990
7532,3772359096,3365614305,1672577719,1672580544,2825
7972,3336751428,3774195321,1672677881,1672680727,2846
7875,3534010629,3244173074,1672639133,1672639906,773
7738,3613683164,3901990690,1672600587,1672603067,2480
7720,3731419510,3520190170,1672615064,1672616200,1136
7678,3770021824,3715981584,1672610351,1672612286,1935
7911,3976633198,3501486692,1672566081,1672569472,3391
7489,3703441914,3556951786,1672545186,1672546098,912
7925,3883085535,3480687894,1672534428,1672537319,2891
7542,3513164386,3517459919,1672624995,1672626711,1716
7862,3779218771,3427283336,1672670984,1672672302,1318
7660,3520190170,3774005526,1672603063,1672603297,234
7929,3736229191,3500487333,1672634009,1672636959,2950
7937,3783239924,3311090974,1672539278,1672542173,2895
7908,3780788622,3859663348,1672637945,1672641441,3496
7605,3703013906,3816853177,1672665118,1672665992,874
7716,3760509236,3701498253,1672630614,1672632530,1916
7812,3827222533,3500199935,1672697066,1672699872,2806
7896,3511271692,3333896808,1672620246,1672621157,911
7925,3777079686,3206254161,1672678490,1672679676,1186
7597,3519654779,3901877072,1672699102,1672702253,3151
7806,3303751772,3511332835,1672683995,1672686731,2736
7726,3755392666,3901990690,1672702989,1672703329,340
7651,3811694763,3404384505,1672698842,1672701162,2320
7686,3683766533,3516011407,1672648341,1672648542,201
7521,3891751546,3404384505,1672698816,1672701741,2925
7903,3920801189,3311603601,1672559165,1672561015,1850
7754,3513201436,3805519285,1672544724,1672545347,623
7661,3739106581,3757151210,1672537374,1672538184,810
7567,3405494240,3505883609,1672534392,1672537414,3022
7893,3682061100,3432689543,1672647826,1672651319,3493
7491,3779629905,3770078063,1672676386,1672677433,1047
7907,3500578848,3757682496,1672626161,1672627114,953
7737,3396285984,3307512479,1672691804,1672693313,1509
7957,3509604974,3533193862,1672540440,1672543233,2793
7978,3604539807,3234541252,1672674554,1672677762,3208
7760,3411618230,3344019610,1672611776,1672613645,1869
7922,3497901842,3701111745,1672651328,1672654772,3444
7526,3519654779,3244436890,1672680614,1672681478,864
7561,3922275416,3829764737,1672658573,1672659501,928
7611,3755798867,3284639858,1672601425,1672602489,1064
7802,3500365158,3242408357,1672602553,1672605426,2873
7830,3714504419,3501483568,1672625075,1672627058,1983
7615,3703441914,3488244966,1672670247,1672672861,2614
7525,3533371364,3979339287,1672627518,1672628535,1017
7922,3774127586,3736790081,1672549260,1672552852,3592
7805,3475251781,3820354437,1672575314,1672575441,127
7802,3910886626,3513201436,1672590209,1672592920,2711
7888,3511687358,3235635976,1672643317,1672643529,212
7805,3471220483,3776338577,1672640893,1672641044,151
7924,3625274012,3497901842,1672543325,1672544201,876
7814,3362000049,3774298222,1672698345,1672701036,2691
7704,3772337814,3297463265,1672636906,1672638843,1937
7874,3505347134,3792668962,1672625224,1672625855,631
7902,3471220483,3852391257,1672554616,1672555265,649
7826,3505873261,3701498253,1672624189,1672626295,2106
7526,3805519285,3534424200,1672589803,1672591673,1870
7775,3394330287,3519601612,1672606901,1672608298,1397
7713,3418534998,3780503655,1672643777,1672646287,2510
7578,3664517356,3466911760,1672579254,1672580028,774
7815,3779740455,3822654369,1672547246,1672549313,2067
7699,3773755137,3818255890,1672689696,1672691313,1617
7682,3318697153,3512510536,1672618205,1672620444,2239
7611,3399535232,3976633198,1672610586,1672613833,3247
7597,3427283336,3829232696,1672556998,1672557397,399
7534,3209048907,3791942683,1672684275,1672687642,3367
7651,3880310724,3822654369,1672697508,1672699611,2103
7691,3467773920,3307097200,1672544761,1672548034,3273
7676,3360506772,3817621391,1672625170,1672626515,1345
7654,3244485293,3515125508,1672667283,1672668115,832
7970,3511435497,3359910781,1672589217,1672589667,450
7638,3519069599,3303751772,1672618620,1672618937,317
7515,3855424474,3277605882,1672673582,1672676051,2469
7776,3407673904,3715339701,1672543643,1672545083,1440
7680,3774125065,3519703355,1672597587,1672601084,3497
7792,3284832486,3421127249,1672582394,1672585488,3094
7669,3307512479,3701995648,1672541557,1672542888,1331
7722,3514128943,3776800213,1672644515,1672645087,572
7944,3552314511,3755587522,1672581512,1672584544,3032
7643,3701274634,3533371364,1672585482,1672586964,1482
7505,3777443199,3288764520,1672667294,1672669998,2704
7847,3510594211,3513201436,1672543361,1672546873,3512
7859,3780914982,3701967560,1672650121,1672650555,434
7961,3516465662,3701898991,1672634202,1672634514,312
7644,3780365428,3500060260,1672656234,1672657151,917
7507,3501606184,3793627961,1672634149,1672637399,3250
7681,3621810464,3510173870,1672592618,1672594515,1897
7601,3222448362,3518932404,1672650552,1672653076,2524
7491,3401627165,3367902229,1672604259,1672604602,343
7668,3235635976,3511435497,1672571001,1672571830,829
7554,3668898102,3777120536,1672640584,1672643028,2444
7697,3206593906,3505873261,1672576714,1672578193,1479
7662,3685187183,3516716179,1672629761,1672631650,1889
7814,3760561634,3481647420,1672662517,1672663394,877
7807,3509773875,3389115045,1672602451,1672602523,72
7954,3618873142,3288764520,1672692626,1672692907,281
7549,3858918246,3501606184,1672548883,1672549940,1057
7631,3511350608,3518932404,1672605266,1672606882,1616
7784,3443698222,3716197887,1672690055,1672692622,2567
7746,3778980116,3416241005,1672545387,1672547461,2074
7863,3914290246,3471220483,1672633668,1672636047,2379
7545,3909331423,3244173074,1672589033,1672591005,1972
7740,3509634629,3793627961,1672592363,1672595214,2851
7697,3731419510,3387966152,1672563494,1672566994,3500
7757,3336751428,3361230905,1672683203,1672684103,900
7898,3760598102,3248507722,1672547753,1672550818,3065
7637,3852391257,3793959750,1672532302,1672535194,2892
7522,3739106581,3247780536,1672656211,1672659268,3057
7955,3482405588,3760509236,1672695794,1672696245,451
7571,3774010081,3757403279,1672541677,1672543788,2111
7906,3342131135,3793286136,1672653287,1672654037,750
7524,3534729133,3500805881,1672703821,1672704458,637
7651,3780914982,3833889105,1672698119,1672698565,446
7751,3936227020,3770824086,1672676461,1672678184,1723
7970,3757602960,3533371364,1672599542,1672601392,1850
7972,3793959750,3605726278,1672553917,1672556961,3044
7587,3311993075,3430352815,1672661488,1672661686,198
7906,3711308224,3520629279,1672545338,1672548112,2774
7942,3730517636,3828432634,1672626024,1672626677,653
7813,3515125508,3249791738,1672636528,1672637581,1053
7982,3420432297,3793848402,1672587920,1672591121,3201
7620,3793470489,3626156564,1672663440,1672663610,170
7885,3793286136,3280615985,1672664570,1672665538,968
7713,3512969370,3757682496,1672533816,1672534659,843
7585,3783705817,3312664885,1672615531,1672616304,773
7590,3777929708,3512540951,1672626864,1672629623,2759
7927,3910886626,3304625412,1672635780,1672639375,3595
7627,3418534998,3501606184,1672567578,1672569702,2124
7898,3757812939,3516223597,1672696843,1672698017,1174
7843,3247428249,3736790081,1672597372,1672599938,2566
7882,3606987130,3311627628,1672618989,1672621631,2642
7940,3511862351,3882291183,1672602579,1672604176,1597
7815,3701967560,3409474775,1672628698,1672630466,1768
7850,3516258476,3520888296,1672654097,1672655106,1009
7644,3710098970,3516011407,1672626655,1672626843,188
7549,3361230905,3311627628,1672612079,1672612734,655
7958,3836573197,3505791599,1672579881,1672581268,1387
7531,3501364586,3931941795,1672541974,1672545326,3352
7666,3516011407,3772642849,1672683440,1672683857,417
7837,3533653428,3808324264,1672622452,1672625697,3245
7641,3607178184,3701691675,1672545933,1672548359,2426
7752,3501955238,3792883665,1672656465,1672659256,2791
7925,3711569060,3739106581,1672649528,1672653087,3559
7620,3307097200,3827626797,1672634846,1672636593,1747
7504,3481647420,3713808837,1672614624,1672616236,1612
7865,3311065516,3500729955,1672621769,1672622624,855
7658,3349613093,3772714862,1672547213,1672549988,2775
7671,3855937514,3234362962,1672595041,1672595329,288
7551,3820354437,3534010629,1672625402,1672625908,506
7586,3887270940,3517509185,1672539066,1672541575,2509
7860,3500658339,3777514571,1672599932,1672601875,1943
7522,3711380716,3932051427,1672591435,1672593366,1931
7677,3336751428,3247428249,1672592724,1672593914,1190
7485,3922275416,3411618230,1672631511,1672632614,1103
7875,3780828689,3914290246,1672670238,1672673009,2771
7604,3826760240,3793389510,1672563462,1672566151,2689
7514,3511435497,3209383861,1672603807,1672606751,2944
7922,3519803045,3505362057,1672667115,1672668482,1367
7753,3511359172,3223968713,1672641159,1672643210,2051
7914,3465202715,3634340855,1672660070,1672660403,333
7934,3223968713,3556951786,1672674617,1672676192,1575
7683,3500229033,3311439795,1672536322,1672537632,1310
7592,3818255890,3465202715,1672671117,1672672958,1841
7748,3509604974,3610348516,1672600441,1672601804,1363
7742,3473765852,3280599164,1672550652,1672551870,1218
7927,3730517636,3511125626,1672573891,1672575223,1332
7711,3517509185,3777929708,1672581147,1672584231,3084
7527,3512142794,3391915886,1672646458,1672648903,2445
7609,3372883226,3505638204,1672623830,1672626433,2603
7910,3778780511,3336742544,1672592213,1672594749,2536
7709,3334033993,3887270940,1672617738,1672620037,2299
7657,3760077057,3365830990,1672583083,1672583626,543
7916,3909606423,3505883609,1672637524,1672638925,1401
7785,3756021689,3511125626,1672623867,1672627112,3245
7884,3716165213,3519428855,1672601076,1672604182,3106
7486,3515125508,3757161914,1672674707,1672675805,1098
7747,3235287260,3715581279,1672632822,1672633381,559
7783,3404058699,3409474775,1672604378,1672605800,1422
7765,3311993075,3737154119,1672624764,1672627914,3150
7520,3533280269,3509773875,1672590134,1672592707,2573
7867,3883551721,3454042520,1672531216,1672533146,1930
7795,3773465237,3400804807,1672682923,1672686073,3150
7781,3520751702,3387674757,1672651927,1672653696,1769
7857,3933210486,3783206719,1672660871,1672661677,806
7806,3397418363,3736786443,1672685223,1672685744,521
7517,3760077057,3783705817,1672533762,1672533926,164
7900,3816853177,3311993075,1672658897,1672659537,640
7768,3516465662,3760183458,1672644839,1672648418,3579
7708,3348261553,3520629279,1672640278,1672641647,1369
7954,3501364586,3901877072,1672669129,1672669824,695
7618,3520751702,3505145247,1672600990,1672604029,3039
7575,3513201436,3809916577,1672560266,1672563633,3367
7662,3365942576,3480687894,1672622164,1672622280,116
7558,3505173328,3518260334,1672683968,1672686998,3030
7509,3516909237,3433804879,1672683250,1672683835,585
7563,3380035798,3511332835,1672642170,1672645521,3351
7854,3757682496,3453729665,1672563328,1672565489,2161
7538,3515394721,3511312803,1672596942,1672600174,3232
7744,3500374658,3533653428,1672695228,1672697690,2462
7826,3737079798,3379256399,1672584261,1672584524,263
7623,3480687894,3311203656,1672670674,1672673055,2381
7526,3776948966,3604539807,1672638322,1672640734,2412
7752,3331845324,3244485293,1672611088,1672613322,2234
7662,3301107849,3629547065,1672635705,1672635990,285
7562,3511271692,3770851318,1672559748,1672562064,2316
7748,3736625083,3519912874,1672610340,1672612728,2388
7876,3500904641,3735733948,1672656836,1672659506,2670
7913,3756453423,3738502357,1672570149,1672571945,1796
7928,3209383861,3930791338,1672584740,1672586593,1853
7674,3429690204,3238712269,1672675591,1672677921,2330
7641,3770021824,3817621391,1672688988,1672690250,1262
7554,3533653428,3760077057,1672623255,1672625222,1967
7596,3377766165,3628819436,1672670014,1672671481,1467
7975,3774119563,3716273414,1672655860,1672658338,2478
7776,3760183458,3903307060,1672658383,1672659662,1279
7618,3783531004,3710112546,1672585809,1672586260,451
7916,3793627961,3505173328,1672539834,1672541449,1615
7638,3319752091,3285400528,1672583141,1672583953,812
7704,3757151210,3883085535,1672702962,1672704481,1519
7598,3513599775,3904775198,1672626277,1672627288,1011
7694,3500458761,3855000166,1672671623,1672674899,3276
7806,3880285638,3392121505,1672611810,1672615098,3288
7550,3891751546,3291883916,1672564585,1672566663,2078
7845,3311761694,3344364444,1672633051,1672636444,3393
7782,3774050956,3835382117,1672656522,1672659796,3274
7759,3475795792,3501601840,1672618043,1672620539,2496
7890,3311415018,3512540951,1672636817,1672639499,2682
7604,3701111745,3937224533,1672629314,1672630089,775
7798,3383661227,3711569060,1672687048,1672689807,2759
7911,3716835696,3235635976,1672616673,1672619260,2587
7692,3973560347,3760077057,1672599856,1672600541,685
7531,3379589402,3710408395,1672564485,1672567880,3395
7913,3835382117,3481647420,1672616252,1672618805,2553
7573,3224058172,3391261292,1672582624,1672583616,992
7721,3774298222,3517476351,1672559203,1672562168,2965
7798,3500177712,3916289176,1672604851,1672606645,1794
7802,3703013906,3505201246,1672608440,1672610062,1622
7611,3882291183,3773205565,1672540689,1672541722,1033
7956,3388286531,3978105277,1672596452,1672598682,2230
7918,3439023335,3773814927,1672639054,1672641403,2349
7914,3855937514,3777079686,1672567344,1672570504,3160
7730,3925402713,3533137446,1672666575,1672668546,1971
7903,3805292782,3509634629,1672562795,1672565575,2780
7563,3519912874,3793436995,1672676558,1672679857,3299
7498,3617055293,3428674539,1672550247,1672551212,965
7648,3770635361,3223789409,1672615403,1672617931,2528
7748,3805342762,3291227780,1672592645,1672594315,1670
7902,3774195321,3311152102,1672632899,1672636443,3544
7494,3829232696,3367902229,1672671629,1672673949,2320
7772,3520709480,3533369198,1672568303,1672569661,1358
7522,3500487333,3772578994,1672629670,1672631347,1677
7687,3780639480,3668898102,1672553166,1672553586,420
7643,3364543015,3715492942,1672635326,1672637366,2040
7735,3793627961,3614238812,1672552476,1672553329,853
7823,3772758337,3774010081,1672661246,1672663993,2747
7844,3337544549,3417587765,1672678283,1672681448,3165
7488,3772642849,3903962771,1672635393,1672638358,2965
7974,3533280269,3517459919,1672584817,1672585064,247
7610,3505599848,3716900301,1672568090,1672571555,3465
7786,3311871871,3533927138,1672592466,1672593677,1211
7787,3780828689,3826760240,1672682571,1672685780,3209
7974,3379256399,3666506258,1672536457,1672538287,1830
7919,3688418210,3533371364,1672532324,1672534055,1731
7913,3453729665,3505649239,1672597084,1672600077,2993
7484,3791594391,3773664987,1672671676,1672672279,603
7764,3311415018,3713644518,1672663487,1672666129,2642
7529,3973560347,3516016437,1672660997,1672661864,867
7728,3514472925,3518408774,1672550751,1672553132,2381
7645,3475251781,3703735129,1672633986,1672635550,1564
7689,3284832486,3825229501,1672560991,1672562582,1591
7574,3703871468,3882291183,1672555563,1672555757,194
7724,3716168623,3701995648,1672676253,1672678027,1774
7950,3511170269,3733189298,1672678080,1672681676,3596
7884,3770021824,3716197887,1672659772,1672659955,183
7823,3493507965,3904408902,1672611927,1672615423,3496
7571,3345207877,3826759140,1672681054,1672684224,3170
7934,3783509527,3793338102,1672570247,1672571233,986
7615,3232962003,3500803339,1672563912,1672564053,141
7740,3731419510,3242408357,1672531720,1672533772,2052
7698,3776948966,3703735129,1672676602,1672678113,1511
7567,3666506258,3839849341,1672640330,1672640877,547
7792,3757403279,3293695955,1672675878,1672678419,2541
7800,3313564074,3757447189,1672545715,1672547491,1776
7890,3774005526,3394539273,1672563287,1672563412,125
7570,3793338102,3276993580,1672544159,1672544782,623
7872,3713786889,3420700674,1672663781,1672664776,995
7970,3779740455,3791020967,1672645562,1672648330,2768
7556,3736625083,3459030804,1672699592,1672700216,624
7951,3235635976,3510126867,1672544299,1672547066,2767
7685,3518496488,3277939457,1672578795,1672581699,2904
7598,3276640712,3505193212,1672674046,1672675266,1220
7851,3314245084,3334033993,1672572391,1672575637,3246
7955,3411618230,3302626661,1672539769,1672540102,333
7524,3903962771,3405494240,1672648429,1672648956,527
7573,3500894271,3755625324,1672563876,1672567016,3140
7898,3774580701,3622054816,1672585809,1672586288,479
7600,3930791338,3520931254,1672662226,1672664666,2440
7632,3621497531,3757455053,1672559847,1672561973,2126
7661,3773664987,3883861463,1672583870,1672585421,1551
7520,3520165601,3401627165,1672578157,1672579487,1330
7572,3716488385,3716273414,1672674094,1672677015,2921
7652,3365830990,3500487333,1672684717,1672686795,2078
7835,3223968713,3373384732,1672552466,1672554764,2298
7954,3703789494,3755739653,1672672266,1672674650,2384
7528,3402943525,3515151980,1672667772,1672670959,3187
7788,3501601840,3713644518,1672684457,1672685983,1526
7684,3778266283,3500199935,1672560762,1672561809,1047
7575,3394330287,3360993964,1672641990,1672645171,3181
7938,3277669002,3756027749,1672675095,1672675896,801
7700,3505791599,3770824086,1672663600,1672664493,893
7841,3601879040,3311154569,1672577738,1672579561,1823
7841,3760077057,3716168623,1672551426,1672553318,1892
7882,3500365158,3518876135,1672655538,1672656953,1415
7490,3778980116,3613995936,1672543919,1672547459,3540
7802,3837094550,3515151980,1672657917,1672660238,2321
7852,3513599775,3428964059,1672571805,1672572905,1100
7970,3519152550,3359910781,1672648966,1672651098,2132
7833,3812176780,3917278625,1672683428,1672685341,1913
7492,3737051610,3496549058,1672625593,1672628156,2563
7972,3711569060,3601879040,1672581184,1672582732,1548
7764,3701184889,3760509236,1672682924,1672683457,533
7908,3494290908,3520751702,1672600064,1672600784,720
7652,3489217083,3772544062,1672544880,1672547827,2947
7608,3921211276,3667680268,1672698093,1672699495,1402
7490,3818255890,3298433163,1672688268,1672688706,438
7592,3360506772,3378686918,1672630840,1672632207,1367
7590,3490191091,3505145247,1672610130,1672610285,155
7592,3432665384,3889750851,1672684948,1672687112,2164
7805,3835382117,3711265369,1672588123,1672588470,347
7706,3380035798,3201848640,1672689367,1672689997,630
7702,3629547065,3515125508,1672616529,1672618723,2194
7978,3714504419,3757151210,1672567301,1672568176,875
7594,3772337814,3301107849,1672629753,1672632169,2416
7673,3520730271,3777079686,1672545007,1672545193,186
7571,3809059934,3780788622,1672587818,1672591410,3592
7564,3713644518,3891751546,1672691228,1672693939,2711
7554,3518496488,3780639480,1672584506,1672585665,1159
7578,3606812411,3825229501,1672646507,1672648245,1738
7772,3232962003,3809484172,1672541874,1672544760,2886
7689,3792032359,3394539273,1672599158,1672599592,434
7565,3465254146,3801089989,1672696069,1672699332,3263
7493,3344364444,3480687894,1672622027,1672622513,486
7945,3222521619,3238712269,1672631265,1672631625,360
7732,3501730685,3244389794,1672670903,1672671303,400
7700,3311324983,3891751546,1672661000,1672662014,1014
7714,3206254161,3351554343,1672540050,1672541014,964
7598,3772544062,3970117174,1672564956,1672568417,3461
7897,3277605882,3554917400,1672636509,1672639903,3394
7625,3352603894,3805519285,1672609827,1672611934,2107
7542,3668005723,3235635976,1672576449,1672577928,1479
7892,3760492950,3885670556,1672676998,1672677217,219
7727,3883312122,3515860749,1672603732,1672606065,2333
7570,3715998609,3311208440,1672625234,1672627690,2456
7648,3312333615,3311154569,1672657311,1672658402,1091
7527,3365614305,3880285638,1672566005,1672566706,701
7887,3466229085,3307512479,1672652834,1672656122,3288
7953,3910454786,3792473331,1672700622,1672700759,137
7971,3933210486,3756021689,1672662767,1672666046,3279
7492,3510711755,3313541986,1672688326,1672688472,146
7797,3509773875,3716168623,1672539511,1672542006,2495
7777,3716273414,3714504419,1672585268,1672588333,3065
7867,3466229085,3779740455,1672632873,1672634440,1567
7719,3970117174,3519428855,1672611462,1672614300,2838
7628,3639847263,3757602960,1672624476,1672627594,3118
7699,3496549058,3792177074,1672612927,1672615540,2613
7577,3924549929,3434642576,1672680172,1672681219,1047
7845,3511687358,3378436155,1672642885,1672644835,1950
7489,3316173088,3783531004,1672575904,1672576967,1063
7943,3683959482,3520751702,1672643612,1672646487,2875
7720,3857349323,3291235378,1672568330,1672571341,3011
7900,3313564074,3512349371,1672593648,1672594080,432
7786,3500729955,3776513891,1672558225,1672558600,375
7947,3534191820,3360743849,1672583762,1672586233,2471
7974,3770635361,3912536808,1672620269,1672621247,978
7800,3515151980,3711380716,1672565141,1672568104,2963
7549,3855000166,3904775198,1672591391,1672594190,2799
7518,3621810464,3519703355,1672561320,1672561859,539
7527,3511435497,3703275621,1672642787,1672643906,1119
7498,3478194807,3773120434,1672580722,1672584136,3414
7775,3201432789,3412980697,1672634465,1672635309,844
7983,3473765852,3716900301,1672652914,1672653032,118
7726,3829764737,3511198618,1672598579,1672599064,485
7528,3773429448,3901877072,1672536375,1672539192,2817
7877,3288764520,3755943611,1672616447,1672617889,1442
7571,3970117174,3248507722,1672674272,1672675272,1000
7855,3512142794,3917088658,1672565689,1672569277,3588
7858,3731106822,3922275416,1672700653,1672703081,2428
7776,3311627628,3345207877,1672650432,1672652488,2056
7541,3774556560,3889232789,1672653994,1672656145,2151
7943,3716273414,3826760240,1672539220,1672539342,122
7613,3515284591,3826760240,1672656436,1672657146,710
7509,3238712269,3738274418,1672631705,1672635262,3557
7747,3360743849,3500229033,1672672921,1672673713,792
7881,3772337814,3311203656,1672562256,1672565003,2747
7715,3792253549,3757562897,1672583586,1672584772,1186
7624,3518496488,3776800213,1672610345,1672611671,1326
7550,3780974443,3373384732,1672537667,1672541078,3411
7798,3791997875,3520012395,1672701444,1672704926,3482
7539,3688418210,3489728806,1672559507,1672561010,1503
7951,3476232529,3433804879,1672542285,1672545769,3484
7618,3711571712,3820354437,1672631518,1672633428,1910
7638,3400804807,3777776687,1672681812,1672682906,1094
7819,3293695955,3883042241,1672667456,1672670309,2853
7948,3601879040,3234362962,1672655391,1672657754,2363
7793,3937224533,3519563836,1672588775,1672591684,2909
7572,3778980116,3231056870,1672695201,1672697889,2688
7977,3793338102,3805519285,1672598994,1672601619,2625
7927,3303705369,3509672210,1672685432,1672687875,2443
7900,3773978034,3914259449,1672648020,1672649292,1272
7834,3399911573,3716165213,1672700886,1672703547,2661
7937,3614238812,3777717988,1672542868,1672543337,469
7892,3972364603,3760183458,1672624067,1672626660,2593
7540,3819727225,3291235378,1672653954,1672655711,1757
7753,3427283336,3792288302,1672601924,1672604027,2103
7625,3496549058,3201432789,1672546233,1672549299,3066
7853,3777514571,3314245084,1672561955,1672562834,879
7800,3828432634,3783509527,1672663476,1672666993,3517
7869,3475795792,3298433163,1672664505,1672665464,959
7945,3774580701,3510380060,1672614344,1672615504,1160
7874,3621497531,3710569131,1672676533,1672677680,1147
7782,3783429780,3511198618,1672621638,1672623491,1853
7667,3624761861,3777477395,1672690360,1672693882,3522
7709,3714821932,3778980116,1672677925,1672678695,770
7690,3772309150,3312664885,1672608416,1672610918,2502
7541,3711308224,3757812939,1672630325,1672633421,3096
7767,3516606733,3517476351,1672685481,1672687721,2240
7742,3505530961,3379589402,1672674848,1672675174,326
7848,3505912939,3490191091,1672640392,1672642001,1609
7513,3774793839,3288764520,1672606661,1672609973,3312
7794,3520730271,3777776687,1672613342,1672614438,1096
7913,3361230905,3280615985,1672577651,1672577763,112
7614,3384240055,3519700826,1672681502,1672682332,830
7660,3666507626,3711308224,1672545288,1672546697,1409
7964,3936227020,3520756859,1672634618,1672637962,3344
7656,3516960534,3311603601,1672532190,1672535281,3091
7808,3734828619,3972709319,1672545069,1672546129,1060
7721,3533626375,3512837326,1672537191,1672537514,323
7822,3234541252,3756451663,1672626373,1672627299,926
7804,3770851318,3489545239,1672638686,1672640490,1804
7529,3412980697,3519700826,1672672029,1672675340,3311
7924,3755436115,3276640712,1672541502,1672545010,3508
7740,3279721246,3244485293,1672565054,1672565860,806
7905,3778308417,3715492942,1672595700,1672596953,1253
7598,3377766165,3307097200,1672536870,1672539090,2220
7612,3505173328,3201324715,1672579323,1672580574,1251
7947,3783126683,3311415018,1672667989,1672668781,792
7717,3415546117,3701898991,1672650680,1672650794,114
7584,3273500349,3505193212,1672550444,1672552057,1613
7931,3914290246,3776800213,1672534113,1672536814,2701
7743,3715998609,3485375593,1672649421,1672652745,3324
7907,3515151980,3701691675,1672593991,1672594185,194
7790,3783779671,3757161914,1672531929,1672534742,2813
7659,3851190615,3772758337,1672674911,1672677593,2682
7837,3711380716,3509453566,1672639787,1672641303,1516
7825,3617055293,3465254146,1672658721,1672659364,643
7558,3714474557,3755872268,1672652383,1672655508,3125
7901,3201324715,3777806071,1672577725,1672578936,1211
7611,3517459919,3975287541,1672682603,1672684705,2102
7730,3918584946,3505530961,1672587915,1672588689,774
7894,3666457294,3904408902,1672607307,1672610335,3028
7808,3516039895,3515284591,1672666073,1672669390,3317
7869,3756966035,3979339287,1672571048,1672571154,106
7954,3513454145,3714197325,1672597098,1672599589,2491
7519,3501601840,3882242815,1672614834,1672618324,3490
7657,3244389794,3501601840,1672695084,1672696329,1245
7602,3774298222,3792177074,1672597296,1672598215,919
7648,3278365525,3891751546,1672559895,1672563260,3365
7530,3774298222,3244485293,1672568993,1672572553,3560
7620,3618045231,3244485293,1672553994,1672557520,3526
7639,3778308417,3660493209,1672690552,1672693743,3191
7707,3755436115,3914290246,1672598559,1672599943,1384
7552,3772053179,3610695419,1672570115,1672570817,702
7798,3783779671,3835382117,1672559433,1672559939,506
7793,3312333615,3505193212,1672581353,1672582090,737
7931,3904775198,3792177074,1672588746,1672590692,1946
7656,3713786889,3505477652,1672583233,1672586611,3378
7878,3621810464,3488244966,1672597036,1672597586,550
7587,3516039895,3793338102,1672586108,1672587707,1599
7910,3791957752,3516606733,1672649175,1672650458,1283
7732,3399535232,3379589402,1672700251,1672703771,3520
7844,3683959482,3229058858,1672565999,1672568718,2719
7918,3518669703,3774045700,1672640701,1672642227,1526
7687,3516909237,3533827120,1672596092,1672596539,447
7737,3533653428,3802367797,1672652233,1672652948,715
7901,3887270940,3792177074,1672661488,1672663208,1720
7678,3835382117,3918247820,1672571026,1672571405,379
7828,3909238838,3472130842,1672663907,1672664783,876
7853,3757682496,3921211276,1672596651,1672598924,2273
7937,3793338102,3360993964,1672684916,1672687552,2636
7790,3209551760,3477375368,1672618692,1672620806,2114
7791,3626156564,3485375593,1672676116,1672677167,1051
7822,3360743849,3783779671,1672634941,1672636558,1617
7765,3285400528,3792384220,1672568277,1672571298,3021
7952,3777936328,3277939457,1672603541,1672604182,641
7898,3307097200,3909238838,1672573631,1672575806,2175
7535,3716168623,3783531004,1672677444,1672679377,1933
7691,3500499542,3364543015,1672628562,1672630788,2226
7658,3516629436,3501730685,1672608075,1672610632,2557
7891,3345207877,3200691026,1672621778,1672624071,2293
7856,3475251781,3231056870,1672694266,1672695809,1543
7827,3711504540,3833889105,1672650881,1672652505,1624
7603,3500060260,3501601840,1672666701,1672668487,1786
7981,3516011407,3302626661,1672614081,1672614319,238
7655,3459030804,3774520233,1672682352,1672685901,3549
7549,3459030804,3703441914,1672692671,1672693377,706
7565,3533369198,3228165483,1672665691,1672666817,1126
7598,3710098970,3791997875,1672539296,1672540586,1290
7897,3404058699,3611150562,1672686579,1672689456,2877
7697,3715581279,3883861463,1672610807,1672613005,2198
7983,3773120434,3855000166,1672677220,1672679170,1950
7932,3688418210,3819727225,1672604891,1672605835,944
7605,3776066388,3793389510,1672698074,1672698630,556
7632,3396285984,3914290246,1672621226,1672623858,2632
7503,3304056063,3911159965,1672555888,1672556829,941
7675,3774501422,3809916577,1672688859,1672691279,2420
7734,3713644518,3277669002,1672553552,1672556023,2471
7897,3778549126,3311274543,1672555922,1672559425,3503
7554,3417587765,3859525941,1672703552,1672704406,854
7581,3716168623,3760561634,1672660393,1672662985,2592
7899,3777806071,3303705369,1672630652,1672632986,2334
7660,3364543015,3517721725,1672572562,1672573492,930
7906,3779740455,3734496778,1672650995,1672652858,1863
7594,3500994774,3931941795,1672587877,1672588502,625
7499,3703871468,3935127663,1672673108,1672674397,1289
7863,3311152102,3307512479,1672533148,1672534199,1051
7733,3711308224,3610348516,1672692853,1672695076,2223
7630,3466229085,3510711755,1672655622,1672657747,2125
7942,3505962865,3311324983,1672610694,1672611138,444
7703,3832902928,3805342762,1672558125,1672559277,1152
7630,3201848640,3880285638,1672549716,1672551760,2044
7620,3361230905,3424922204,1672644366,1672645249,883
7490,3666506258,3911245524,1672585126,1672587070,1944
7526,3633420270,3772309166,1672586551,1672588351,1800
7900,3519912874,3224716315,1672556375,1672557408,1033
7576,3737051610,3500578848,1672649478,1672650748,1270
7923,3510173870,3417587765,1672554048,1672556190,2142
7651,3209551760,3760294205,1672684204,1672687035,2831
7518,3805519285,3773598056,1672580925,1672581337,412
7831,3500365158,3716258994,1672587081,1672589253,2172
7570,3618045231,3777983879,1672696162,1672696238,76
7524,3904408902,3519803045,1672663669,1672664316,647
7508,3351554343,3519556068,1672534529,1672538057,3528
7787,3550946908,3755625324,1672611993,1672612193,200
7717,3516606733,3412980697,1672595556,1672597992,2436
7637,3415546117,3926700506,1672535121,1672537148,2027
7492,3229665776,3516909237,1672679893,1672682392,2499
7679,3774050956,3318166135,1672620849,1672623876,3027
7866,3360506772,3509453566,1672690226,1672691491,1265
7876,3489728806,3829319703,1672687890,1672688495,605
7892,3890149705,3903009525,1672685150,1672688512,3362
7556,3829232696,3511271692,1672616351,1672618527,2176
7726,3922275416,3420432297,1672549557,1672549885,328
7710,3512142794,3516465662,1672540872,1672541167,295
7864,3793286136,3772578994,1672561224,1672563653,2429
7540,3780609808,3780294829,1672692565,1672694981,2416
7728,3683766533,3628819436,1672688602,1672689367,765
7858,3760598102,3367902229,1672538939,1672540934,1995
7748,3520751702,3701534009,1672683138,1672685457,2319
7893,3285400528,3517476351,1672533279,1672535427,2148
7917,3500904641,3273500349,1672645299,1672645613,314
7829,3792177074,3487171044,1672544930,1672546731,1801
7837,3738502357,3607748895,1672562091,1672562955,864
7913,3733891182,3703735129,1672702240,1672702737,497
7857,3755042098,3510247121,1672650513,1672653867,3354
7860,3314836094,3515151980,1672589714,1672590684,970
7958,3793286136,3505477652,1672587503,1672590018,2515
7952,3608633356,3475396323,1672640704,1672644299,3595
7614,3903307060,3514245078,1672635610,1672638519,2909
7964,3316222192,3509773875,1672624836,1672626921,2085
7906,3792789881,3666507626,1672552088,1672552280,192
7809,3420432297,3755739653,1672536927,1672538283,1356
7821,3500199935,3780593036,1672554122,1672554297,175
7518,3757562897,3714504419,1672609900,1672612315,2415
7660,3284832486,3500199935,1672548651,1672551027,2376
7578,3777806071,3505173328,1672600195,1672601559,1364
7975,3518014404,3291235378,1672580680,1672583519,2839
7827,3519556068,3770021824,1672544331,1672547418,3087
7927,3828432634,3234541252,1672599443,1672599560,117
7749,3505201246,3793338102,1672619860,1672621950,2090
7835,3837094550,3518496488,1672582532,1672583303,771
7694,3518014404,3793086311,1672690954,1672693770,2816
7530,3384240055,3235287260,1672602665,1672603007,342
7895,3520190170,3773429448,1672656020,1672656539,519
7873,3280964728,3793286136,1672580421,1672583583,3162
7926,3391261292,3756966035,1672621004,1672623850,2846
7886,3520709480,3501364586,1672548957,1672550111,1154
7918,3346327502,3312664885,1672644580,1672645302,722
7943,3715998609,3515723720,1672566738,1672569079,2341
7874,3792032359,3716900301,1672683987,1672684463,476
7504,3458539365,3391261292,1672649908,1672653081,3173
7610,3701984666,3791602225,1672663199,1672664841,1642
7918,3501364586,3773978034,1672655795,1672657487,1692
7682,3513080274,3511125626,1672650935,1672653744,2809
7499,3757151210,3515284591,1672661067,1672663345,2278
7783,3777477395,3793338102,1672663660,1672664616,956
7785,3774010081,3909606423,1672551892,1672553119,1227
7573,3516629436,3780365428,1672582633,1672585123,2490
7901,3519152550,3316222192,1672685107,1672686300,1193
7769,3515125508,3480687894,1672629431,1672631060,1629
7625,3500499542,3331845324,1672637442,1672639619,2177
7812,3505530961,3737051610,1672617372,1672618206,834
7827,3426325549,3465202715,1672623124,1672624816,1692
7591,3519803045,3514987389,1672596628,1672598949,2321
7740,3483949762,3773205565,1672685991,1672689300,3309
7648,3614238812,3201848640,1672604066,1672606675,2609
7493,3358871377,3911245524,1672631782,1672632218,436
7759,3760569731,3914259449,1672571828,1672574454,2626
7824,3229058858,3418534998,1672660817,1672663980,3163
7952,3517255726,3360506772,1672597061,1672598719,1658
7890,3911159965,3902278226,1672595481,1672598274,2793
7710,3222521619,3242408357,1672598994,1672599386,392
7921,3298433163,3514472925,1672602321,1672605214,2893
7935,3514987389,3288764520,1672649657,1672653179,3522
7639,3516011407,3601879040,1672646071,1672647731,1660
7850,3519654779,3552314511,1672627011,1672627179,168
7864,3550946908,3666507626,1672591908,1672595177,3269
7939,3774466457,3514283243,1672648126,1672649770,1644
7498,3891751546,3517459919,1672663164,1672663231,67
7924,3518496488,3432689543,1672616861,1672620366,3505
7865,3500904641,3475396323,1672681297,1672683689,2392
7781,3492478793,3249791738,1672545538,1672545955,417
7674,3805342762,3688683847,1672536475,1672537416,941
7905,3500904641,3601879040,1672626316,1672629236,2920
7926,3411618230,3760569731,1672571475,1672572089,614
7772,3509453566,3291227780,1672549028,1672551816,2788
7531,3296471982,3301107849,1672686003,1672689282,3279
7925,3922275620,3311203656,1672656166,1672657833,1667
7613,3737051610,3914259449,1672578502,1672581782,3280
7939,3773465237,3772642849,1672557849,1672558590,741
7625,3629935998,3756930948,1672619626,1672621787,2161
7729,3703013906,3395152943,1672578037,1672580613,2576
7702,3715981584,3792789881,1672690521,1672690602,81
7955,3234362962,3757455053,1672669158,1672671729,2571
7624,3716165213,3511170269,1672661974,1672664222,2248
7962,3755798867,3201848640,1672675241,1672677729,2488
7582,3485375593,3501955238,1672625664,1672625963,299
7598,3774045700,3793338102,1672571780,1672574519,2739
7513,3493507965,3701111745,1672533643,1672536363,2720
7510,3791115967,3512510536,1672674345,1672676647,2302
7949,3392121505,3511841857,1672583591,1672584360,769
7745,3829764737,3534553510,1672638082,1672640184,2102
7715,3701898991,3716488385,1672620614,1672624051,3437
7804,3400804807,3311415018,1672673204,1672673468,264
7718,3711571712,3511312803,1672666750,1672669356,2606
7632,3407725581,3505638204,1672576710,1672578121,1411
7772,3514987389,3364543015,1672624407,1672627991,3584
7686,3912262917,3703661585,1672574933,1672577740,2807
7530,3703889596,3280964728,1672612698,1672613719,1021
7663,3481647420,3284832486,1672639979,1672642259,2280
7511,3505791599,3911159965,1672532131,1672535103,2972
7784,3342131135,3757682496,1672683641,1672685246,1605
7653,3780813786,3400918687,1672693720,1672695144,1424
7773,3344364444,3220716272,1672608382,1672610248,1866
7620,3418534998,3520183192,1672683064,1672684006,942
7938,3476232529,3512142794,1672686520,1672689972,3452
7602,3773598056,3360506772,1672613754,1672615351,1597
7755,3930797455,3886298125,1672631516,1672631802,286
7699,3976390453,3886298125,1672646550,1672646767,217
7600,3512142794,3774366875,1672533277,1672535460,2183
7545,3519703355,3314245084,1672557565,1672559957,2392
7484,3918584946,3512720680,1672571152,1672573707,2555
7888,3975287541,3362000049,1672576970,1672578371,1401
7910,3550946908,3319752091,1672647955,1672649189,1234
7671,3388637594,3731419510,1672632869,1672636238,3369
7572,3389115045,3336751428,1672697014,1672699677,2663
7556,3776800213,3533810360,1672683295,1672684862,1567
7653,3520756859,3629935998,1672598576,1672601547,2971
7518,3459030804,3520706195,1672573142,1672573942,800
7515,3481647420,3976633198,1672534865,1672535385,520
7610,3519912874,3555214688,1672548105,1672550654,2549
7614,3667680268,3501601840,1672686223,1672688534,2311
7588,3311203656,3711380716,1672682975,1672685775,2800
7903,3405494240,3604539807,1672697969,1672700254,2285
7848,3606987130,3501364586,1672623291,1672624008,717
7877,3737154119,3514719601,1672697902,1672700043,2141
7577,3501730685,3760893269,1672547521,1672549511,1990
7880,3244173074,3520888296,1672679972,1672680344,372
7762,3501759100,3365614305,1672601540,1672603801,2261
7559,3385763781,3505873261,1672683867,1672685929,2062
7888,3477375368,3487171044,1672635554,1672638355,2801
7588,3311718847,3511170269,1672657576,1672661078,3502
7971,3227158514,3454042520,1672567134,1672567948,814
7857,3805292782,3755042098,1672633525,1672637011,3486
7579,3510857360,3362000049,1672581155,1672582259,1104
7918,3886298125,3512720680,1672598398,1672598553,155
7579,3394539273,3501606184,1672542033,1672543381,1348
7847,3518791447,3611150562,1672596648,1672596910,262
7942,3756462516,3533810360,1672663078,1672663780,702
7973,3490191091,3637008488,1672638148,1672638880,732
7492,3311761694,3346327502,1672622134,1672625253,3119
7545,3481502100,3791594391,1672700711,1672701226,515
7924,3428964059,3932051427,1672636785,1672639184,2399
7926,3736419952,3637008488,1672538707,1672539032,325
7771,3432689543,3736592744,1672621660,1672621931,271
7751,3701190899,3384240055,1672551090,1672552943,1853
7525,3716746253,3307097200,1672575016,1672576826,1810
7587,3780593036,3636867411,1672608470,1672610586,2116
7686,3637008488,3756601594,1672691970,1672695182,3212
7585,3926700506,3773814927,1672558164,1672558304,140
7950,3510126867,3760598102,1672551214,1672553658,2444
7656,3774580701,3555214688,1672597921,1672598205,284
7742,3331845324,3716746253,1672639313,1672642322,3009
7501,3756528686,3416241005,1672600276,1672603553,3277
7641,3358871377,3828432634,1672641157,1672643360,2203
7756,3780593036,3716900301,1672627448,1672629078,1630
7820,3815508790,3852595551,1672670591,1672672810,2219
7692,3780828689,3520888296,1672556681,1672559641,2960
7618,3731106822,3883312122,1672675367,1672678373,3006
7489,3817316561,3710067113,1672557399,1672560710,3311
7659,3783705817,3793962300,1672600230,1672600471,241
7574,3244173074,3778308417,1672580724,1672581674,950
7509,3370636709,3792844210,1672623730,1672624728,998
7920,3714821932,3703955926,1672607063,1672608149,1086
7911,3779528381,3303705369,1672582750,1672583338,588
7497,3791553060,3297463265,1672556960,1672558087,1127
7492,3293695955,3760992710,1672620250,1672621378,1128
7954,3511170269,3351008918,1672673290,1672676250,2960
7859,3791957752,3510969660,1672624343,1672625533,1190
7519,3901877072,3554917400,1672684437,1672686412,1975
7640,3512540951,3466911760,1672552651,1672554038,1387
7677,3827222533,3760294205,1672694111,1672697605,3494
7617,3780593036,3770021824,1672644448,1672645598,1150
7562,3607178184,3809484172,1672674313,1672675216,903
7692,3505599848,3828365570,1672593797,1672596697,2900
7579,3815508790,3757246925,1672701401,1672703743,2342
7577,3703955926,3510244400,1672562275,1672565327,3052
7507,3387674757,3505859863,1672682914,1672683900,986
7901,3779218771,3513599775,1672636915,1672637029,114
7979,3773814927,3714821932,1672633300,1672636132,2832
7611,3515125508,3519152550,1672559692,1672561561,1869
7913,3716488385,3518408774,1672683371,1672683541,170
7576,3757447189,3416265063,1672655918,1672656978,1060
7516,3933210486,3791115967,1672700507,1672702429,1922
7844,3533653428,3827377568,1672560258,1672562439,2181
7492,3533927138,3772337814,1672558835,1672559701,866
7580,3291883916,3473562469,1672676713,1672677217,504
7671,3500994774,3427219654,1672643129,1672645367,2238
7653,3500803339,3291227780,1672567011,1672568360,1349
7845,3394539273,3473562469,1672546271,1672546479,208
7823,3505292701,3373384732,1672533077,1672533171,94
7623,3770763956,3244436890,1672577007,1672578361,1354
7677,3701967560,3475251781,1672601512,1672602727,1215
7899,3399004969,3731106822,1672541286,1672542303,1017
7528,3780609808,3533025282,1672698644,1672699597,953
7553,3791874383,3509634629,1672571776,1672572866,1090
7587,3774466457,3500458761,1672576347,1672576944,597
7690,3809916577,3311871871,1672552891,1672555866,2975
7939,3236102733,3519556068,1672685167,1672686159,992
7527,3828365570,3783925755,1672627921,1672629702,1781
7849,3736790081,3222521619,1672621895,1672624206,2311
7721,3902278226,3421836608,1672644648,1672647790,3142
7863,3505599848,3315583351,1672647664,1672650559,2895
7853,3311993075,3516258476,1672685389,1672685627,238
7972,3496051529,3248507722,1672637660,1672637974,314
7669,3791874383,3516909237,1672582106,1672584375,2269
7546,3416265063,3516716179,1672558389,1672559158,769
7958,3773814927,3297463265,1672653899,1672656662,2763
7496,3820354437,3713808837,1672534104,1672536284,2180
7634,3511435497,3519152550,1672581170,1672583078,1908
7517,3555214688,3505873261,1672684454,1672684756,302
7684,3420432297,3774339795,1672674761,1672676817,2056
7639,3701190899,3777929708,1672637975,1672639227,1252
7810,3770851318,3426325549,1672619303,1672619383,80
7824,3922275620,3280964728,1672608361,1672609650,1289
7710,3711973519,3882291183,1672697216,1672700748,3532
7945,3734496778,3520030713,1672589369,1672589559,190
7868,3301107849,3901877072,1672671955,1672675071,3116
7651,3622054816,3701691675,1672695073,1672697026,1953
7578,3783531004,3685818092,1672538792,1672540033,1241
7697,3534191820,3339907603,1672614265,1672615375,1110
7906,3916289176,3715339701,1672661217,1672661732,515
7693,3701111745,3235635976,1672596434,1672599780,3346
7807,3716746253,3510126867,1672676216,1672677411,1195
7711,3756021689,3500060260,1672568385,1672570047,1662
7703,3451432842,3772578994,1672652703,1672656111,3408
7559,3774298222,3886298125,1672603057,1672604985,1928
7550,3336751428,3351554343,1672597436,1672597838,402
7546,3370636709,3420432297,1672534481,1672537545,3064
7918,3793959750,3396285984,1672638474,1672638766,292
7839,3344019610,3792789881,1672547575,1672547922,347
7803,3716843669,3453729665,1672552614,1672556176,3562
7921,3420700674,3519428855,1672624918,1672627387,2469
7497,3836573197,3312333615,1672659440,1672659918,478
7745,3777514571,3477375368,1672629587,1672631054,1467
7888,3792288302,3770553384,1672543164,1672545741,2577
7582,3664170666,3443698222,1672671050,1672671696,646
7726,3510380060,3533137446,1672650034,1672650285,251
7632,3388372715,3516011407,1672613278,1672615254,1976
7504,3791957752,3792384220,1672692342,1672694323,1981
7561,3316222192,3901877072,1672598412,1672598598,186
7511,3510173870,3555214688,1672678835,1672680123,1288
7926,3311154569,3311208440,1672638159,1672639444,1285
7777,3755798867,3418534998,1672608182,1672610500,2318
7961,3476232529,3430074045,1672668382,1672670112,1730
7641,3428006164,3316173088,1672562889,1672563398,509
7702,3285400528,3511687358,1672596811,1672599588,2777
7805,3756966035,3509453566,1672696711,1672699488,2777
7805,3244485293,3533748232,1672671219,1672674656,3437
7954,3338703270,3918584946,1672537100,1672538294,1194
7757,3916289176,3465254146,1672560238,1672563528,3290
7674,3505883609,3711198793,1672699266,1672700144,878
7522,3509672210,3701065786,1672545909,1672549429,3520
7725,3883042241,3505635228,1672618265,1672619702,1437
7946,3634340855,3621497531,1672585489,1672587278,1789
7718,3714962248,3404058699,1672683764,1672685662,1898
7661,3885670556,3511841857,1672587506,1672588719,1213
7735,3303751772,3505530961,1672648865,1672649296,431
7750,3348261553,3481647420,1672685734,1672689027,3293
7641,3792668962,3428964059,1672666882,1672668169,1287
7490,3714821932,3973560347,1672564613,1672567824,3211
7640,3534729133,3404058699,1672547634,1672548472,838
7898,3517509185,3760294205,1672689179,1672691477,2298
7889,3311627628,3418534998,1672638203,1672638869,666
7850,3887270940,3514283243,1672549797,1672552355,2558
7559,3792789881,3412825109,1672618238,1672619320,1082
7960,3737079798,3517864478,1672583783,1672585691,1908
7888,3501606184,3917278625,1672612247,1672615588,3341
7714,3520706195,3365614305,1672533565,1672533996,431
7824,3515284591,3713208927,1672697460,1672699777,2317
7603,3510247121,3501601840,1672659164,1672662522,3358
7798,3519912874,3429856982,1672623285,1672625901,2616
7929,3520706195,3399004969,1672564506,1672565531,1025
7924,3777717988,3400918687,1672612842,1672613951,1109
7818,3851190615,3777936328,1672694145,1672695964,1819
7612,3800353779,3513164386,1672668301,1672669214,913
7771,3755587522,3421127249,1672673617,1672675057,1440
7926,3227457126,3501955238,1672583673,1672584442,769
7838,3779629905,3776948966,1672629072,1672631892,2820
7527,3518163778,3319752091,1672632752,1672634423,1671
7967,3351008918,3770447408,1672560570,1672560632,62
7879,3500458761,3505869747,1672621500,1672622878,1378
7911,3770553384,3626156564,1672650778,1672652286,1508
7925,3713894336,3970117174,1672591207,1672594112,2905
7874,3512349371,3510247121,1672690100,1672690861,761
7612,3512540951,3533371364,1672680324,1672681001,677
7510,3793338102,3311324983,1672561741,1672562172,431
7816,3533810360,3776338577,1672628513,1672629991,1478
7604,3339907603,3247780536,1672542575,1672543853,1278
7822,3318697153,3314245084,1672678122,1672678719,597
7693,3770078063,3885670556,1672596285,1672598599,2314
7926,3607178184,3777514571,1672551924,1672553850,1926
7581,3755920131,3500391167,1672686766,1672687514,748
7708,3757151210,3518014404,1672698714,1672699958,1244
7793,3857349323,3757151210,1672652576,1672654545,1969
7825,3855937514,3511312803,1672681435,1672684937,3502
7587,3710112546,3513956646,1672585277,1672587374,2097
7883,3284832486,3519601612,1672662071,1672662948,877
7730,3373384732,3477375368,1672572022,1672573617,1595
7968,3501364586,3201324715,1672537276,1672537497,221
7869,3774045700,3827626797,1672626398,1672626957,559
7865,3349613093,3979339287,1672620971,1672623823,2852
7680,3386707783,3776066388,1672642630,1672646071,3441
7788,3793871337,3792902982,1672554033,1672556116,2083
7589,3399535232,3533927138,1672590381,1672590649,268
7982,3756424865,3496269445,1672562430,1672563915,1485
7498,3515860749,3703735129,1672669461,1672670531,1070
7922,3518496488,3853018906,1672599681,1672600577,896
7746,3855424474,3517963492,1672682771,1672685751,2980
7532,3466911760,3783126683,1672596907,1672597569,662
7567,3935127663,3246596716,1672664472,1672666751,2279
7885,3627937312,3519803045,1672586957,1672588430,1473
7857,3424922204,3337544549,1672547129,1672549612,2483
7719,3279721246,3349613093,1672585967,1672587257,1290
7587,3701065786,3780828689,1672539894,1672541897,2003
7733,3904408902,3311065516,1672629860,1672631234,1374
7762,3311208440,3916289176,1672667532,1672668766,1234
7550,3792668962,3715189301,1672545374,1672545564,190
7924,3792177074,3817316561,1672694161,1672695063,902
7860,3791997875,3224716315,1672532724,1672534191,1467
7486,3518932404,3703789494,1672616996,1672618505,1509
7970,3711370563,3378092448,1672633597,1672636223,2626
7759,3935127663,3319752091,1672628928,1672632257,3329
7738,3779976989,3232962003,1672654601,1672656569,1968
7635,3733891182,3533748232,1672605083,1672607165,2082
7512,3501198706,3428006164,1672633717,1672634843,1126
7563,3534488837,3279721246,1672586297,1672588647,2350
7881,3615046771,3666506258,1672703909,1672704784,875
7828,3757455053,3621497531,1672608049,1672610015,1966
7757,3399911573,3509604974,1672571469,1672574161,2692
7637,3311208440,3511163800,1672699045,1672701577,2532
7740,3510857360,3779629905,1672624501,1672625691,1190
7656,3774520233,3512166013,1672682897,1672683276,379
7662,3895562476,3828365570,1672655185,1672657781,2596
7860,3475251781,3792253549,1672703678,1672703928,250
7575,3510380060,3510703546,1672648658,1672651152,2494
7854,3833889105,3774005526,1672533422,1672537016,3594
7811,3816454165,3534424200,1672671859,1672674405,2546
7652,3621497531,3701967560,1672585973,1672587120,1147
7684,3496549058,3396285984,1672605495,1672605778,283
7910,3519428855,3388637594,1672578309,1672579977,1668
7678,3443698222,3338367113,1672672355,1672675719,3364
7783,3732481297,3519700826,1672568659,1672572082,3423
7717,3307512479,3809484172,1672697103,1672698297,1194
7968,3432689543,3427219654,1672703214,1672703806,592
7677,3473765852,3755739653,1672542292,1672542696,404
7879,3378436155,3360743849,1672567810,1672571064,3254
7938,3735733948,3500458761,1672560965,1672561758,793
7952,3489545239,3533025282,1672596164,1672598148,1984
7849,3533385867,3975287541,1672639349,1672641185,1836
7937,3516039895,3777936328,1672670880,1672674084,3204
7804,3760492950,3922275620,1672624550,1672625689,1139
7846,3500499542,3346327502,1672638989,1672639146,157
7836,3780788622,3514719601,1672616454,1672617275,821
7823,3490191091,3755798867,1672626516,1672627338,822
7531,3311324983,3505904952,1672667929,1672669462,1533
7978,3783126683,3713630656,1672578220,1672580111,1891
7913,3390068992,3280599164,1672597012,1672599598,2586
7586,3378686918,3513956646,1672590815,1672591619,804
7546,3626156564,3780813786,1672578233,1672580014,1781
7898,3809484172,3276993580,1672543833,1672545494,1661
7701,3711380716,3391915121,1672654931,1672656604,1673
7958,3533927138,3288764520,1672622169,1672624153,1984
7739,3792473331,3683959482,1672531240,1672534187,2947
7494,3629547065,3473765852,1672559159,1672561162,2003
7499,3229058858,3701178711,1672580702,1672581253,551
7864,3714821932,3973560347,1672679176,1672680354,1178
7652,3774466457,3608868877,1672578451,1672581307,2856
7567,3505869747,3773120434,1672572959,1672574653,1694
7753,3918584946,3416265063,1672601166,1672601232,66
7959,3791901535,3520190170,1672582878,1672584524,1646
7571,3783083229,3791657947,1672655280,1672658006,2726
7918,3791553060,3244485293,1672554165,1672555625,1460
7528,3701146057,3903962771,1672628737,1672628964,227
7790,3428964059,3500904641,1672571042,1672573699,2657
7759,3318166135,3826633236,1672602201,1672603993,1792
7526,3624761861,3773950140,1672613985,1672614774,789
7847,3509933351,3777623166,1672587454,1672590798,3344
7976,3757161914,3793086311,1672532662,1672534684,2022
7880,3666553782,3757602960,1672694085,1672694314,229
7919,3792789881,3855937514,1672550927,1672552014,1087
7912,3889750851,3734828619,1672685880,1672688140,2260
7565,3793389510,3516016437,1672593464,1672594605,1141
7957,3402943525,3780593036,1672604412,1672605942,1530
7789,3519601612,3701967560,1672630765,1672631097,332
7880,3206603608,3311324983,1672587664,1672589044,1380
7584,3683959482,3713786889,1672566070,1672567726,1656
7830,3396086535,3618045231,1672671881,1672674241,2360
7671,3760992710,3234541252,1672586690,1672588202,1512
7737,3514719601,3244389794,1672560276,1672561324,1048
7792,3505869747,3519703355,1672595985,1672598381,2396
7887,3756027749,3683959482,1672537919,1672539664,1745
7520,3311718847,3501606184,1672667336,1672669371,2035
7483,3314836094,3777079686,1672557704,1672558251,547
7583,3778108318,3833889105,1672540454,1672541274,820
7956,3515860749,3755587522,1672677431,1672677844,413
7548,3511350608,3910454786,1672560237,1672562895,2658
7650,3701995648,3515151980,1672600557,1672601573,1016
7979,3289061738,3500229033,1672617683,1672619714,2031
7829,3304056063,3518932404,1672677049,1672680004,2955
7714,3512217942,3394539273,1672666625,1672669761,3136
7726,3365830990,3339907603,1672592615,1672593922,1307
7910,3512683609,3737051610,1672669024,1672669582,558
7835,3601879040,3774339795,1672581242,1672581448,206
7982,3805342762,3774520233,1672612677,1672614794,2117
7640,3511170269,3918584946,1672701748,1672703501,1753
7868,3515151980,3617055293,1672693596,1672694610,1014
7641,3472130842,3711973519,1672603858,1672606526,2668
7775,3345207877,3773950140,1672617307,1672619235,1928
7544,3458539365,3914259449,1672609627,1672610987,1360
7734,3780294829,3334033993,1672665773,1672667206,1433
7493,3519601612,3505477652,1672655588,1672659076,3488
7962,3519703355,3639847263,1672569770,1672569836,66
7531,3200198928,3734737881,1672650984,1672652641,1657
7965,3774556560,3303751772,1672662021,1672663640,1619
7924,3819727225,3773598056,1672609912,1672610065,153
7745,3621810464,3917088658,1672566385,1672568424,2039
7966,3399052055,3227457126,1672570898,1672572688,1790
7692,3209383861,3367029997,1672655855,1672658539,2684
7657,3475251781,3912536808,1672623813,1672626647,2834
7682,3666553782,3711370563,1672621823,1672625048,3225
7774,3714504419,3227457126,1672644452,1672645464,1012
7882,3520030713,3774520233,1672596299,1672597350,1051
7930,3311648200,3774520233,1672663653,1672666084,2431
7812,3760569731,3520756859,1672637501,1672640245,2744
7903,3519700826,3735319397,1672596394,1672597091,697
7962,3383922351,3289061738,1672548458,1672548848,390
7564,3489217083,3802367797,1672658259,1672659760,1501
7531,3770763956,3713969578,1672554224,1672557744,3520
7962,3715339701,3937224533,1672657343,1672660093,2750
7920,3713208927,3489545239,1672685445,1672688179,2734
7666,3891751546,3791553060,1672604166,1672606158,1992
7549,3438645253,3550946908,1672604796,1672606225,1429
7599,3311648200,3779629905,1672544962,1672547372,2410
7741,3311154569,3817316561,1672657165,1672658048,883
7653,3734737881,3399004969,1672547825,1672549735,1910
7503,3365942576,3826760240,1672552691,1672554178,1487
7657,3806545488,3774127586,1672681824,1672681902,78
7931,3311603601,3757602960,1672655247,1672655332,85
7924,3365942576,3280599164,1672597182,1672599316,2134
7804,3701274634,3715581279,1672637670,1672640591,2921
7613,3773664987,3206254161,1672630628,1672631817,1189
7974,3512510536,3713894336,1672700442,1672700739,297
7835,3465254146,3716488385,1672661920,1672662023,103
7633,3666507626,3774125065,1672543125,1672544893,1768
7584,3533025282,3516223597,1672596613,1672600146,3533
7827,3715127362,3909606423,1672628931,1672629386,455
7748,3736786443,3791602225,1672578640,1672578737,97
7628,3780828689,3701190899,1672596785,1672597284,499
7498,3683766533,3378092448,1672546690,1672549390,2700
7766,3485823740,3701146057,1672619585,1672621814,2229
7588,3311871871,3244485293,1672570440,1672571909,1469
7593,3516223597,3505098372,1672643081,1672644314,1233
7532,3519703355,3399052055,1672571560,1672571763,203
7488,3485008994,3520888296,1672661306,1672664549,3243
7905,3701967560,3220716272,1672676499,1672678950,2451
7644,3809916577,3756027749,1672612436,1672615099,2663
7641,3793871337,3890149705,1672565009,1672567022,2013
7589,3316222192,3533369198,1672658419,1672660878,2459
7552,3318697153,3418728074,1672570656,1672573427,2771
7524,3511435497,3805292782,1672661192,1672663104,1912
7503,3883861463,3533280269,1672582665,1672585745,3080
7670,3911245524,3533242305,1672564161,1672566182,2021
7741,3713969578,3757161914,1672544202,1672547459,3257
7777,3701995648,3825229501,1672695936,1672698630,2694
7578,3227158514,3626156564,1672689326,1672692243,2917
7723,3331845324,3802367797,1672695037,1672697267,2230
7519,3710067113,3377766165,1672563419,1672563581,162
7682,3430074045,3911245524,1672551742,1672554598,2856
7585,3391915121,3500066230,1672599818,1672602139,2321
7920,3501483568,3793627961,1672663319,1672665444,2125
7588,3836573197,3505530961,1672601910,1672602112,202
7545,3278365525,3839849341,1672644046,1672646068,2022
7674,3429856982,3500458761,1672653505,1672653665,160
7737,3773598056,3685818092,1672570958,1672572629,1671
7634,3514283243,3918674986,1672681661,1672684941,3280
7583,3756528686,3791942683,1672701886,1672702213,327
7763,3505292701,3311871871,1672592118,1672593186,1068
7563,3339907603,3505638204,1672636852,1672638817,1965
7594,3933210486,3512683609,1672545931,1672546620,689
7528,3756424865,3774366875,1672625910,1672628674,2764
7491,3351008918,3316222192,1672689326,1672689509,183
7940,3302626661,3509453566,1672619721,1672622362,2641
7544,3777514571,3891751546,1672636873,1672637679,806
7975,3465202715,3757403279,1672677553,1672679660,2107
7939,3399004969,3858918246,1672556390,1672558389,1999
7757,3793753089,3510380060,1672553317,1672556293,2976
7523,3514838220,3917088658,1672587326,1672589517,2191
7715,3244485293,3224058172,1672691425,1672691970,545
7715,3914259449,3298433163,1672586493,1672587861,1368
7589,3779036831,3430504438,1672590250,1672591759,1509
7569,3367902229,3779740455,1672600370,1672600584,214
7789,3505362057,3206603608,1672616739,1672619367,2628
7507,3779218771,3489728806,1672655375,1672658739,3364
7613,3703441914,3346327502,1672582341,1672583317,976
7862,3772544062,3778266283,1672638512,1672640494,1982
7675,3604539807,3805292782,1672609309,1672609891,582
7709,3800353779,3303751772,1672670787,1672671879,1092
7793,3534729133,3791602225,1672600914,1672603354,2440
7483,3515125508,3617734118,1672682171,1672682646,475
7928,3772309150,3404384505,1672613652,1672615767,2115
7841,3735319397,3755392666,1672536815,1672540069,3254
7636,3777623166,3362000049,1672663874,1672667253,3379
7579,3933210486,3773429448,1672613094,1672614517,1423
7907,3973560347,3777079686,1672555456,1672555757,301
7666,3512217942,3755625324,1672618055,1672619039,984
7684,3520719611,3703889596,1672685058,1672686046,988
7698,3533653428,3505292701,1672663803,1672666954,3151
7782,3223968713,3904408902,1672561768,1672565157,3389
7902,3390068992,3209383861,1672577315,1672580733,3418
7524,3882291183,3627937312,1672539255,1672541506,2251
7928,3286658957,3783531004,1672637908,1672640233,2325
7543,3511350608,3828624701,1672669889,1672672174,2285
7501,3480687894,3430074045,1672689072,1672689195,123
7814,3487171044,3773598056,1672622642,1672625171,2529
7679,3311274543,3480687894,1672570181,1672572308,2127
7714,3500805881,3505292701,1672681040,1672682272,1232
7721,3778341199,3399052055,1672565053,1672566812,1759
7721,3516065852,3633420270,1672646781,1672648043,1262
7586,3427283336,3628819436,1672534579,1672536182,1603
7586,3902278226,3223789409,1672564407,1672567424,3017
7706,3664170666,3434642576,1672608362,1672610793,2431
7522,3277669002,3465254146,1672602906,1672604261,1355
7693,3809916577,3516465662,1672680340,1672683500,3160
7807,3430352815,3533385867,1672614864,1672615406,542
7814,3367029997,3903962771,1672629438,1672631626,2188
7964,3629547065,3311274543,1672691178,1672692609,1431
7499,3883861463,3519700826,1672610364,1672612596,2232
7786,3805347939,3703889596,1672678321,1672680239,1918
7834,3313541986,3520190170,1672619267,1672620361,1094
7765,3792288302,3304625412,1672550911,1672551202,291
7738,3510126867,3520888296,1672678948,1672679381,433
7807,3809059934,3780639480,1672562214,1672562566,352
7803,3855937514,3510771358,1672533198,1672533673,475
7668,3802367797,3711571712,1672548335,1672549170,835
7673,3453729665,3379256399,1672639716,1672640317,601
7895,3777717988,3512217942,1672603174,1672603781,607
7786,3489545239,3396285984,1672697280,1672698606,1326
7640,3520165601,3533748232,1672695483,1672696617,1134
7880,3311603601,3682061100,1672648424,1672651819,3395
7491,3828365570,3420432297,1672618952,1672619848,896
7958,3533748232,3829319703,1672608370,1672611831,3461
7748,3516909237,3510857360,1672621842,1672625127,3285
7864,3533827120,3730517636,1672562255,1672562744,489
7816,3734828619,3406784491,1672535810,1672537620,1810
7616,3362000049,3773755137,1672590215,1672590329,114
7562,3791657947,3510380060,1672609764,1672612750,2986
7774,3298433163,3515151980,1672588690,1672590242,1552
7863,3512540951,3289061738,1672668732,1672669670,938
7966,3234362962,3793470489,1672637952,1672638075,123
7974,3711569060,3755511676,1672609293,1672610371,1078
7809,3280615985,3791901535,1672545737,1672546198,461
7522,3500805881,3829319703,1672642288,1672643535,1247
7633,3505649239,3773429448,1672614054,1672614483,429
7839,3227158514,3780914982,1672639335,1672642337,3002
7873,3509672210,3701111745,1672579882,1672581331,1449
7684,3485375593,3926700506,1672651391,1672651714,323
7521,3392121505,3514283243,1672618735,1672619288,553
7649,3809916577,3701863557,1672679668,1672680303,635
7598,3475251781,3385763781,1672626423,1672628927,2504
7883,3618873142,3430504438,1672623675,1672625165,1490
7672,3500894271,3501364586,1672596275,1672596841,566
7969,3701184889,3208844525,1672567251,1672570084,2833
7513,3809059934,3783126683,1672598810,1672602100,3290
7568,3555214688,3380035798,1672587297,1672589911,2614
7574,3804870229,3501759100,1672636536,1672639753,3217
7856,3509634629,3338367113,1672577936,1672579007,1071
7861,3777455223,3510711755,1672567037,1672569323,2286
7616,3756930948,3783705817,1672652991,1672654951,1960
7769,3922337974,3666553782,1672605249,1672605786,537
7872,3370752401,3793871337,1672540733,1672543887,3154
7515,3755739653,3806545488,1672700933,1672702413,1480
7758,3756451663,3209551760,1672562216,1672565289,3073
7628,3827222533,3501486692,1672547992,1672550951,2959
7568,3388286531,3760569731,1672651551,1672654097,2546
7570,3714962248,3774501422,1672571147,1672571500,353
7508,3247815299,3482405588,1672703059,1672706435,3376
7488,3407725581,3637008488,1672664590,1672666305,1715
7573,3774298222,3731106822,1672653686,1672654036,350
7577,3791115967,3608633356,1672606389,1672608630,2241
7854,3800353779,3852595551,1672550128,1672553626,3498
7977,3517459919,3783509527,1672698267,1672701559,3292
7552,3737154119,3975287541,1672666119,1672668260,2141
7817,3209048907,3774520233,1672676379,1672677216,837
7901,3235287260,3778780511,1672634631,1672637705,3074
7864,3801089989,3760492950,1672545172,1672547680,2508
7697,3793959750,3770824086,1672674546,1672674942,396
7504,3629935998,3733891182,1672682530,1672685453,2923
7983,3386707783,3911245524,1672682285,1672683815,1530
7757,3756930948,3501927421,1672586437,1672588026,1589
7782,3851190615,3783083229,1672550820,1672552663,1843
7492,3622054816,3882997884,1672537072,1672538728,1656
7515,3514283243,3793871337,1672664716,1672665687,971
7702,3772359096,3520165601,1672631869,1672631946,77
7771,3710408395,3714962248,1672557257,1672558827,1570
7782,3518669703,3505135325,1672634434,1672635370,936
7931,3736790081,3855000166,1672674554,1672675796,1242
7904,3791334389,3792253549,1672548439,1672549677,1238
7947,3500229033,3512217942,1672644470,1672647098,2628
7701,3360993964,3248507722,1672687709,1672691297,3588
7932,3395152943,3247428249,1672698767,1672701434,2667
7712,3221899927,3701995648,1672541675,1672545148,3473
7701,3772746272,3683959482,1672583289,1672583532,243
7652,3513080274,3505173328,1672669488,1672672699,3211
7489,3713644518,3703223015,1672636882,1672639866,2984
7494,3774520233,3287105466,1672583015,1672585384,2369
7787,3793389510,3271938399,1672685148,1672688538,3390
7675,3513201436,3206603608,1672673811,1672676645,2834
7664,3613683164,3801089989,1672654334,1672656908,2574
7899,3809916577,3291227780,1672695876,1672697139,1263
7909,3936227020,3515125508,1672668302,1672669566,1264
7667,3514245078,3660493209,1672597311,1672600312,3001
7795,3475396323,3770101921,1672551435,1672551540,105
7563,3432665384,3792768129,1672630630,1672632435,1805
7667,3518163778,3517476351,1672544157,1672544861,704
7830,3534191820,3792789881,1672554848,1672557159,2311
7891,3361230905,3249791738,1672542650,1672545041,2391
7657,3518669703,3770763956,1672570511,1672570784,273
7716,3346327502,3517255726,1672566849,1672567612,763
7689,3780639480,3342131135,1672616912,1672617398,486
7629,3760569731,3683766533,1672587225,1672587519,294
7713,3249247700,3209048907,1672560650,1672563121,2471
7806,3519428855,3972364603,1672654771,1672656287,1516
7535,3713808837,3550946908,1672621898,1672622129,231
7652,3891751546,3774066725,1672620444,1672624025,3581
7724,3791553060,3639847263,1672552929,1672556292,3363
7880,3637008488,3247815299,1672557359,1672560775,3416
7592,3774338212,3791334389,1672555435,1672556841,1406
7557,3235635976,3273500349,1672540671,1672542400,1729
7624,3772309150,3514128943,1672645691,1672646805,1114
7781,3302626661,3703661585,1672682344,1672685159,2815
7676,3711973519,3922337974,1672678065,1672679600,1535
7516,3713349754,3533193862,1672633243,1672635799,2556
7610,3533193862,3505869747,1672663548,1672663609,61
7538,3316173088,3518014404,1672545273,1672546869,1596
7622,3311627628,3489962019,1672689672,1672691137,1465
7936,3835382117,3512349371,1672638075,1672640368,2293
7614,3489728806,3793286136,1672595166,1672598293,3127
7857,3304625412,3773664987,1672567149,1672568711,1562
7770,3513164386,3827377568,1672581145,1672583505,2360
7911,3772758337,3714197325,1672567422,1672567592,170
7725,3773978034,3925620998,1672703120,1672705744,2624
7585,3792288302,3388637594,1672702280,1672702583,303
7902,3518163778,3520706195,1672681420,1672684513,3093
7782,3518014636,3534424200,1672615194,1672617303,2109
7521,3778780511,3344364444,1672679625,1672679733,108
7574,3887270940,3903962771,1672640484,1672641244,760
7491,3880285638,3500499542,1672585233,1672586226,993
7875,3533810360,3736419952,1672535650,1672537350,1700
7531,3246596716,3835382117,1672547409,1672549014,1605
7955,3206593906,3911245524,1672649407,1672652104,2697
7522,3774520233,3755625324,1672555474,1672557311,1837
7784,3975287541,3313564074,1672635174,1672635932,758
7623,3972709319,3271938399,1672551525,1672554356,2831
7504,3933210486,3772544062,1672638146,1672638840,694
7925,3615046771,3405494240,1672560683,1672561956,1273
7671,3739106581,3688683847,1672620122,1672622031,1909
7944,3777455223,3311154569,1672533738,1672534508,770
7886,3312664885,3913251733,1672548796,1672551971,3175
7508,3813052709,3512217942,1672545036,1672547384,2348
7862,3774125065,3713969578,1672703943,1672704781,838
7776,3513164386,3494290908,1672661816,1672665179,3363
7604,3533371364,3505873261,1672585819,1672587372,1553
7691,3428964059,3500894271,1672636668,1672638963,2295
7924,3438645253,3760267716,1672566422,1672569190,2768
7700,3388372715,3776800213,1672642118,1672643654,1536
7668,3466911760,3910454786,1672700362,1672703128,2766
7909,3379589402,3880285638,1672695904,1672696544,640
7618,3760561634,3515691540,1672677964,1672680629,2665
7865,3496051529,3311627628,1672607489,1672611046,3557
7943,3514283243,3511332835,1672642420,1672645595,3175
7498,3701984666,3774580701,1672635015,1672635455,440
7570,3516465662,3855937514,1672534549,1672535954,1405
7865,3904775198,3774556560,1672674425,1672677281,2856
7765,3792789881,3399911573,1672668556,1672672022,3466
7720,3505859863,3319752091,1672610677,1672611044,367
7751,3890149705,3760183458,1672640332,1672641635,1303
7484,3337544549,3811694763,1672592895,1672595966,3071
7537,3703735129,3852391257,1672624971,1672627864,2893
7651,3931941795,3664517356,1672660090,1672662587,2497
7847,3501692334,3418728074,1672685338,1672686342,1004
7818,3358871377,3922337974,1672661534,1672663053,1519
7551,3755872268,3520709480,1672687029,1672690477,3448
7762,3303705369,3249247700,1672602690,1672605216,2526
7968,3481647420,3813052709,1672591533,1672594163,2630
7537,3520206212,3500805881,1672598358,1672598932,574
7483,3774010081,3901990690,1672571448,1672574882,3434
7741,3280615985,3736419952,1672663302,1672665744,2442
7588,3774066725,3859663348,1672664443,1672665604,1161
7614,3351554343,3509933351,1672631904,1672634712,2808
7796,3302626661,3710344260,1672547899,1672551398,3499
7613,3533748232,3776948966,1672578540,1672578770,230
7536,3835382117,3372883226,1672630130,1672632389,2259
7961,3338703270,3472130842,1672561477,1672564505,3028
7802,3318166135,3518360734,1672640732,1672644180,3448
7629,3417061462,3634340855,1672546775,1672548339,1564
7492,3716168623,3851190615,1672587924,1672591107,3183
7619,3448855696,3904775198,1672700267,1672702779,2512
7730,3826759140,3932051427,1672575243,1672577438,2195
7974,3247780536,3505219850,1672694342,1672697827,3485
7669,3683959482,3809484172,1672658282,1672659086,804
7910,3505791599,3816454165,1672571718,1672571839,121
7875,3918584946,3311845971,1672572331,1672572558,227
7732,3311090974,3505649239,1672696298,1672699785,3487
7942,3774125065,3783245561,1672629683,1672630849,1166
7889,3514987389,3760569731,1672602892,1672602987,95
7659,3800886801,3917088658,1672672519,1672676097,3578
7695,3918584946,3391261292,1672626952,1672630174,3222
7695,3606812411,3816454165,1672637450,1672640995,3545
7848,3716168623,3776066388,1672624445,1672627978,3533
7888,3247428249,3293695955,1672565025,1672568206,3181
7666,3512217942,3238712269,1672667429,1672669000,1571
7492,3500658339,3443698222,1672627896,1672630620,2724
7803,3424922204,3922337974,1672606883,1672608036,1153
7778,3280964728,3284639858,1672546005,1672547997,1992
7954,3520709480,3519428855,1672693250,1672695878,2628
7968,3377766165,3505201246,1672667801,1672670647,2846
7675,3783925755,3426325549,1672568091,1672570271,2180
7784,3520706195,3685818092,1672691468,1672692028,560
7579,3711265369,3662180254,1672559022,1672561793,2771
7704,3822654369,3859663348,1672587298,1672588198,900
7546,3519700826,3510244400,1672572460,1672575279,2819
7580,3792902982,3770447408,1672680766,1672682108,1342
7542,3917278625,3636867411,1672676152,1672679622,3470
7711,3311090974,3534313900,1672593737,1672594792,1055
7633,3716165213,3800886801,1672555148,1672556327,1179
7843,3505599848,3791957752,1672688031,1672690360,2329
7691,3550946908,3778266283,1672572103,1672572562,459
7494,3312664885,3505362057,1672688574,1672690098,1524
7702,3517476351,3710408395,1672619447,1672622458,3011
7524,3505203158,3512567240,1672603133,1672603698,565
7977,3505362057,3519601612,1672698576,1672700902,2326
7494,3780788622,3731419510,1672587966,1672589723,1757
7888,3779218771,3315583351,1672664230,1672665373,1143
7642,3370752401,3701178711,1672690834,1672692217,1383
7523,3505530961,3776338577,1672691846,1672694108,2262
7642,3500060260,3777623166,1672604564,1672604844,280
7948,3621810464,3756528686,1672693470,1672696570,3100
7910,3500729955,3711973519,1672593829,1672596148,2319
7767,3757682496,3367902229,1672623850,1672624608,758
7667,3772053179,3621497531,1672589995,1672592409,2414
7851,3933210486,3377766165,1672569445,1672571328,1883
7671,3783779671,3519556068,1672690696,1672691477,781
7550,3760489031,3792177074,1672597051,1672599555,2504
7820,3757812939,3756930948,1672644720,1672648300,3580
7798,3805292782,3311993075,1672637799,1672641330,3531
7780,3774556560,3533385867,1672645737,1672648903,3166
7780,3730517636,3298433163,1672599899,1672602517,2618
7962,3774556560,3780828689,1672610335,1672612846,2511
7981,3816853177,3238712269,1672539375,1672539952,577
7797,3280599164,3755739653,1672539049,1672539509,460
7524,3885670556,3518163778,1672624891,1672627714,2823
7937,3534191820,3236102733,1672656039,1672657744,1705
7569,3519703355,3978115672,1672700354,1672703869,3515
7762,3296471982,3509933351,1672686607,1672689806,3199
7761,3783429780,3293695955,1672611587,1672612309,722
7967,3307512479,3407725581,1672642475,1672645263,2788
7983,3616944364,3500658339,1672609165,1672609367,202
7973,3501601840,3783239924,1672649855,1672652349,2494
7859,3559110998,3685187183,1672568521,1672570495,1974
7969,3520183192,3511687358,1672642831,1672646071,3240
7594,3505362057,3777936328,1672570815,1672572218,1403
7868,3924549929,3885897503,1672695308,1672696241,933
7785,3976390453,3489728806,1672603987,1672606615,2628
7674,3384951177,3517963492,1672685610,1672686041,431
7936,3783925755,3534702203,1672684764,1672685406,642
7503,3209383861,3701984666,1672677984,1672679719,1735
7923,3501692334,3485008994,1672646235,1672649303,3068
7630,3773205565,3208844525,1672689095,1672692094,2999
7813,3533927138,3458539365,1672694377,1672696048,1671
7983,3783925755,3517255726,1672701557,1672704431,2874
7523,3621497531,3511170269,1672687942,1672689186,1244
7725,3826759140,3779740455,1672595627,1672598578,2951
7571,3701146057,3912536808,1672687783,1672690820,3037
7863,3379589402,3346795719,1672637335,1672639752,2417
7955,3774366875,3714197325,1672592868,1672595721,2853
7864,3882997884,3518669703,1672647684,1672649030,1346
7839,3909238838,3793086311,1672545609,1672548965,3356
7632,3783083229,3448855696,1672625473,1672627395,1922
7904,3501955238,3516016437,1672580131,1672580488,357
7662,3516673015,3227158514,1672646911,1672649009,2098
7699,3760183458,3614238812,1672626791,1672630058,3267
7983,3804870229,3664170666,1672701788,1672705312,3524
7763,3483949762,3606186086,1672685270,1672688176,2906
7751,3975287541,3683766533,1672638410,1672641485,3075
7543,3344364444,3917278625,1672690434,1672692161,1727
7583,3889232789,3511170269,1672546468,1672547691,1223
7618,3933210486,3514128943,1672559627,1672560194,567
7673,3407725581,3800353779,1672695808,1672697410,1602
7980,3379589402,3311324983,1672575732,1672578885,3153
7625,3505219850,3515284591,1672594356,1672597244,2888
7715,3701691675,3534702203,1672695561,1672697333,1772
7806,3855000166,3399052055,1672568216,1672571561,3345
7788,3829319703,3716273414,1672571864,1672574871,3007
7895,3933210486,3973560347,1672537668,1672539041,1373
7911,3519654779,3236102733,1672593317,1672596529,3212
7548,3509604974,3777514571,1672562723,1672565573,2850
7899,3533827120,3757246925,1672578727,1672581754,3027
7971,3311603601,3836573197,1672601625,1672603230,1605
7793,3713630656,3311203656,1672605645,1672606414,769
7832,3703013906,3220716272,1672582903,1672586185,3282
7559,3701146057,3716537575,1672675611,1672676620,1009
7969,3621810464,3453729665,1672565361,1672566799,1438
7490,3736592744,3315583351,1672628240,1672629648,1408
7835,3209551760,3500365158,1672648414,1672650777,2363
7689,3779740455,3505135325,1672584761,1672586826,2065
7814,3760598102,3829319703,1672598638,1672599272,634
7669,3359910781,3802367797,1672574160,1672577481,3321
7877,3416241005,3629547065,1672581241,1672584080,2839
7662,3895562476,3481502100,1672658372,1672658649,277
7895,3438645253,3756027749,1672612206,1672612469,263
7957,3227158514,3520756859,1672549762,1672551500,1738
7601,3387674757,3792768129,1672666821,1672669371,2550
7834,3730517636,3634340855,1672535318,1672538344,3026
7864,3760294205,3805342762,1672540894,1672541428,534
7509,3489728806,3793962300,1672613115,1672613673,558
7879,3490191091,3738502357,1672663877,1672666482,2605
7593,3666553782,3886298125,1672653939,1672654122,183
7921,3774339795,3760267716,1672556926,1672558708,1782
7495,3519069599,3812176780,1672531443,1672532083,640
7641,3360993964,3232962003,1672612747,1672613882,1135
7863,3336751428,3224058172,1672559414,1672562317,2903
7624,3485823740,3500060260,1672562284,1672563183,899
7724,3518014404,3534191820,1672633691,1672634725,1034
7674,3738502357,3477375368,1672628520,1672631674,3154
7509,3511170269,3701184889,1672680194,1672681471,1277
7892,3667680268,3518791447,1672554026,1672556477,2451
7774,3734737881,3501730685,1672611542,1672615115,3573
7738,3734496778,3976390453,1672562259,1672562703,444
7531,3311603601,3793753089,1672671720,1672675168,3448
7829,3519601612,3615046771,1672611812,1672613612,1800
7504,3791901535,3500994774,1672565148,1672565458,310
7963,3716273414,3811171116,1672588773,1672588969,196
7818,3755436115,3760569731,1672540935,1672543808,2873
7788,3311065516,3386707783,1672647368,1672647869,501
7954,3520012395,3715339701,1672536827,1672540350,3523
7790,3391915121,3512540951,1672588231,1672591732,3501
7965,3411618230,3332072298,1672617095,1672620412,3317
7970,3809916577,3858918246,1672689291,1672691504,2213
7961,3614238812,3633420270,1672606096,1672609689,3593
7773,3511271692,3822654369,1672625145,1672626902,1757
7585,3201432789,3779036831,1672599539,1672600955,1416
7725,3780365428,3770021824,1672586998,1672589546,2548
7585,3889232789,3399911573,1672662579,1672663296,717
7819,3388286531,3972709319,1672546534,1672548137,1603
7782,3505292701,3780365428,1672545281,1672547575,2294
7975,3715581279,3914290246,1672680413,1672682525,2112
7700,3509634629,3626156564,1672543700,1672546953,3253
7617,3467773920,3208844525,1672606254,1672607782,1528
7937,3383922351,3666506258,1672685667,1672689254,3587
7685,3701984666,3236102733,1672535572,1672539019,3447
7949,3519803045,3895562476,1672703327,1672703544,217
7834,3509604974,3629547065,1672534573,1672537407,2834
7758,3229058858,3360743849,1672642923,1672643328,405
7538,3703013906,3298288268,1672542093,1672545267,3174
7830,3793436995,3489962019,1672681766,1672681906,140
7714,3859525941,3883312122,1672570544,1672572557,2013
7747,3475251781,3454042520,1672546880,1672548076,1196
7690,3516223597,3922275620,1672688378,1672689190,812
7759,3688683847,3806545488,1672591293,1672592777,1484
7962,3533137446,3817621391,1672560792,1672561398,606
7884,3606987130,3920801189,1672561294,1672563707,2413
7553,3975287541,3777623166,1672612025,1672612338,313
7655,3248507722,3236102733,1672629225,1672632017,2792
7907,3485375593,3770447408,1672564714,1672567239,2525
7739,3701146057,3783705817,1672597620,1672598255,635
7658,3614238812,3883085535,1672683286,1672685298,2012
7640,3336742544,3757562897,1672613424,1672615056,1632
7485,3488244966,3383922351,1672610477,1672611828,1351
7612,3703275621,3909238838,1672681190,1672682869,1679
7617,3311065516,3365278081,1672608413,1672609549,1136
7804,3777455223,3770553384,1672604583,1672606840,2257
7863,3359239884,3383661227,1672547991,1672549997,2006
7881,3429856982,3777443199,1672664306,1672667024,2718
7924,3515723720,3312333615,1672661526,1672664074,2548
7694,3386707783,3792668962,1672686407,1672688842,2435
7553,3770447408,3443698222,1672586613,1672588010,1397
7899,3519069599,3400804807,1672592907,1672593371,464
7767,3399535232,3473562469,1672702396,1672704957,2561
7897,3937224533,3505973226,1672636733,1672637269,536
7950,3733189298,3367029997,1672646620,1672649835,3215
7593,3904408902,3209383861,1672539766,1672542271,2505
7512,3311718847,3493507965,1672621961,1672623517,1556
7489,3898995675,3822654369,1672556668,1672557810,1142
7922,3757562897,3826633236,1672625935,1672629350,3415
7973,3510937904,3505962865,1672539394,1672541606,2212
7805,3882291183,3732481297,1672627087,1672630318,3231
7844,3391915886,3520709480,1672550933,1672552472,1539
7894,3621497531,3972364603,1672599568,1672601692,2124
7493,3713786889,3520730271,1672702815,1672705602,2787
7535,3713786889,3511271692,1672537851,1672540464,2613
7483,3312333615,3510244400,1672608534,1672610497,1963
7590,3701995648,3550946908,1672645322,1672648590,3268
7893,3516223597,3500729955,1672675165,1672676127,962
7638,3500894271,3779528381,1672621827,1672625213,3386
7591,3312664885,3760992710,1672621813,1672622537,724
7770,3772884106,3772578994,1672540088,1672540405,317
7563,3600647945,3902383721,1672563078,1672565146,2068
7875,3618045231,3783245561,1672627728,1672629683,1955
7495,3710098970,3515125508,1672667629,1672669762,2133
7949,3608633356,3311065516,1672608218,1672610545,2327
7583,3735319397,3248507722,1672620805,1672623372,2567
7547,3792253549,3921211276,1672674442,1672674575,133
7740,3332072298,3518932404,1672563334,1672563600,266
7943,3378436155,3517077106,1672646928,1672648219,1291
7602,3774127586,3793753089,1672639285,1672641589,2304
7689,3713644518,3533242305,1672581529,1672583505,1976
7878,3710112546,3776800213,1672534841,1672535310,469
7880,3512166013,3734828619,1672627068,1672627544,476
7775,3346795719,3516980378,1672625273,1672626681,1408
7841,3611150562,3471220483,1672651207,1672651508,301
7833,3520376528,3713208927,1672680416,1672682612,2196
7497,3828432634,3772309150,1672678045,1672681621,3576
7498,3780365428,3477649378,1672686227,1672689584,3357
7596,3714488548,3533748232,1672534680,1672537254,2574
7926,3420432297,3710569131,1672619412,1672620836,1424
7624,3711569060,3520376528,1672549615,1672550810,1195
7684,3365278081,3772578994,1672663749,1672665060,1311
7490,3735733948,3859663348,1672702929,1672704647,1718
7707,3911159965,3429690204,1672675952,1672679248,3296
7578,3617055293,3736786443,1672663379,1672665490,2111
7731,3912536808,3298433163,1672609210,1672610820,1610
7715,3516039895,3372883226,1672661898,1672662743,845
7954,3519912874,3783239924,1672672248,1672673918,1670
7892,3716165213,3510937904,1672590641,1672593402,2761
7660,3634995491,3688683847,1672660966,1672662061,1095
7598,3513599775,3811171116,1672579825,1672580631,806
7931,3344019610,3710344260,1672612124,1672614576,2452
7565,3483164654,3465202715,1672578329,1672580420,2091
7755,3478194807,3516258476,1672605347,1672606493,1146
7789,3202120784,3918584946,1672598249,1672600443,2194
7751,3533280269,3716835696,1672669710,1672670723,1013
7612,3716488385,3519556068,1672609536,1672612362,2826
7981,3511862351,3829232696,1672601555,1672604279,2724
7676,3668005723,3714504419,1672658141,1672659097,956
7730,3519654779,3735733948,1672684168,1672685833,1665
7779,3221899927,3533369198,1672686237,1672687315,1078
7983,3711973519,3394539273,1672551013,1672553140,2127
7771,3714504419,3918584946,1672658239,1672659107,868
7846,3515151980,3505098372,1672644943,1672647149,2206
7765,3318697153,3390068992,1672584449,1672585321,872
7574,3791334389,3734828619,1672605517,1672605620,103
7553,3500458761,3760294205,1672543290,1672545117,1827
7910,3332072298,3809484172,1672559313,1672560179,866
7977,3621497531,3420700674,1672621297,1672623137,1840
7575,3337544549,3836573197,1672537400,1672538965,1565
7976,3701184889,3533193862,1672700057,1672700926,869
7900,3760569731,3351008918,1672583620,1672584698,1078
7552,3501730685,3248507722,1672647597,1672649713,2116
7878,3511170269,3501364586,1672546374,1672546449,75
7597,3379256399,3770553384,1672573037,1672574781,1744
7860,3918674986,3858918246,1672656360,1672658880,2520
7596,3791874383,3249401741,1672574602,1672575718,1116
7571,3711370563,3311871871,1672606065,1672607694,1629
7641,3426325549,3511170269,1672537119,1672539996,2877
7947,3349613093,3200691026,1672665508,1672667860,2352
7493,3271938399,3773978034,1672587221,1672588980,1759
7602,3501730685,3703955926,1672676102,1672678988,2886
7607,3760183458,3852391257,1672584123,1672587431,3308
7819,3383661227,3701498253,1672540921,1672543973,3052
7524,3711262377,3511862351,1672636239,1672636946,707
7970,3520165601,3760992710,1672703406,1672704916,1510
7870,3517077106,3778108318,1672702359,1672704742,2383
7834,3899371911,3756462516,1672655851,1672656931,1080
7767,3500374658,3534553510,1672573425,1672575548,2123
7886,3517509185,3703718151,1672541212,1672542920,1708
7510,3903962771,3757161914,1672538942,1672541037,2095
7852,3433804879,3911159965,1672543261,1672546481,3220
7959,3505599848,3912536808,1672559384,1672562983,3599
7675,3714504419,3777936328,1672534921,1672537600,2679
7852,3770763956,3519563836,1672651932,1672655065,3133
7735,3755739653,3634995491,1672602447,1672603532,1085
7809,3618045231,3307097200,1672543955,1672545729,1774
7554,3915628728,3370752401,1672587034,1672587343,309
7821,3520376528,3505973226,1672654318,1672655315,997
7622,3432689543,3512142794,1672692986,1672694165,1179
7868,3505173328,3417587765,1672684881,1672688110,3229
7648,3500487333,3496549058,1672681087,1672681684,597
7765,3780639480,3395152943,1672553021,1672556271,3250
7622,3500177712,3883861463,1672613635,1672616299,2664
7704,3510380060,3391915121,1672634209,1672636082,1873
7673,3756601594,3365942576,1672697848,1672698555,707
7748,3554917400,3339907603,1672579713,1672579857,144
7671,3701534009,3701065786,1672645680,1672646671,991
7872,3736229191,3401627165,1672543602,1672546945,3343
7558,3429856982,3356860407,1672533281,1672534882,1601
7766,3446948848,3519556068,1672631714,1672632627,913
7828,3387674757,3405494240,1672540677,1672542553,1876
7799,3634340855,3318697153,1672611776,1672613710,1934
7906,3399004969,3802367797,1672588999,1672591405,2406
7694,3501184421,3512969370,1672681207,1672682228,1021
7795,3793753089,3979339287,1672652879,1672654951,2072
7764,3637008488,3852391257,1672578449,1672578964,515
7868,3792032359,3351008918,1672590161,1672592268,2107
7838,3773978034,3888559320,1672682587,1672684015,1428
7906,3791901535,3249247700,1672622163,1672623189,1026
7665,3714504419,3512969370,1672558225,1672558666,441
7721,3500658339,3757812939,1672563815,1672566055,2240
7580,3773755137,3516258476,1672610569,1672611914,1345
7577,3351554343,3736790081,1672578499,1672581359,2860
7807,3757447189,3338367113,1672674254,1672677240,2986
7704,3634995491,3311208440,1672649454,1672649772,318
7681,3291235378,3613995936,1672563596,1672565397,1801
7525,3757403279,3711370563,1672602611,1672604036,1425
7616,3407673904,3627937312,1672554455,1672556911,2456
7778,3777776687,3509907947,1672532244,1672534569,2325
7846,3713786889,3666506258,1672700304,1672700478,174
7539,3249247700,3973560347,1672542161,1672545166,3005
7588,3637008488,3618045231,1672621889,1672624924,3035
7515,3792844210,3500658339,1672703436,1672706879,3443
7765,3510771358,3244436890,1672612874,1672613289,415
7568,3716197887,3533810360,1672587439,1672589364,1925
7980,3424922204,3636867411,1672677616,1672679803,2187
7534,3505883609,3701065786,1672590845,1672591452,607
7680,3311152102,3364543015,1672596207,1672596903,696
7978,3505635228,3518360734,1672670819,1672673047,2228
7933,3855000166,3520888296,1672665275,1672666817,1542
7851,3500365158,3315583351,1672683783,1672685003,1220
7491,3898995675,3433804879,1672631714,1672634012,2298
7579,3316222192,3412825109,1672686239,1672687133,894
7902,3755920131,3511841857,1672698630,1672701210,2580
7906,3711198793,3716197887,1672584164,1672586708,2544
7946,3534488837,3932051427,1672676018,1672676458,440
7970,3912536808,3383661227,1672596671,1672598805,2134
7930,3666457294,3514472925,1672558641,1672559580,939
7723,3834257412,3338703270,1672634104,1672634750,646
7612,3792177074,3534553510,1672603703,1672606135,2432
7805,3511267139,3249247700,1672638688,1672640903,2215
7889,3912262917,3378092448,1672640010,1672640653,643
7524,3511350608,3773598056,1672679336,1672679766,430
7724,3889750851,3895562476,1672585732,1672588007,2275
7836,3936227020,3716273414,1672623249,1672623920,671
7919,3349613093,3312664885,1672698809,1672700063,1254
7861,3412825109,3518932404,1672641536,1672642741,1205
7890,3518014636,3209383861,1672699086,1672702363,3277
7925,3713969578,3273500349,1672570926,1672571319,393
7537,3480687894,3791874383,1672589277,1672589427,150
7944,3772578994,3792844210,1672683170,1672685422,2252
7512,3494290908,3515394721,1672653781,1672656559,2778
7738,3520709480,3336742544,1672584097,1672586221,2124
7540,3780974443,3291227780,1672691045,1672692506,1461
7832,3534424200,3494290908,1672686539,1672689129,2590
7666,3701691675,3608633356,1672632743,1672634014,1271
7895,3360743849,3480687894,1672694820,1672695686,866
7818,3459030804,3834257412,1672656695,1672659153,2458
7530,3774050956,3515723720,1672591809,1672592895,1086
7951,3793962300,3518163778,1672672379,1672674615,2236
7806,3783239924,3247815299,1672631176,1672634699,3523
7769,3776338577,3774005526,1672539837,1672541934,2097
7632,3791115967,3783509527,1672630014,1672632779,2765
7659,3459030804,3701984666,1672632287,1672633127,840
7709,3922275620,3804870229,1672660781,1672663472,2691
7921,3209551760,3438645253,1672643549,1672646741,3192
7816,3201324715,3510173870,1672563366,1672563901,535
7709,3399004969,3312333615,1672533420,1672533851,431
7958,3509773875,3666457294,1672561850,1672562534,684
7969,3477375368,3825229501,1672542784,1672545488,2704
7637,3793470489,3520888296,1672558411,1672559721,1310
7607,3711380716,3774045700,1672618289,1672619223,934
7975,3807987001,3500458761,1672560507,1672563069,2562
7501,3783925755,3780639480,1672588764,1672589428,664
7791,3711504540,3737051610,1672550777,1672552907,2130
7489,3311845971,3426325549,1672641061,1672641290,229
7942,3736625083,3715998609,1672624822,1672626543,1721
7768,3774125065,3520706195,1672599617,1672602938,3321
7697,3500729955,3713894336,1672535677,1672537836,2159
7512,3910454786,3756451663,1672692933,1672695445,2512
7680,3516514391,3519703355,1672620476,1672624012,3536
7637,3608633356,3792177074,1672652929,1672654150,1221
7787,3206593906,3805347939,1672697825,1672701150,3325
7768,3520931254,3221536550,1672566255,1672566351,96
7663,3920801189,3500578848,1672606392,1672608735,2343
7830,3201848640,3418728074,1672656733,1672656965,232
7616,3511350608,3511125626,1672602089,1672602262,173
7615,3396086535,3836573197,1672603818,1672605646,1828
7527,3921211276,3494290908,1672695446,1672696505,1059
7966,3417970574,3511435497,1672703218,1672705078,1860
7621,3346327502,3392121505,1672672628,1672673902,1274
7833,3516465662,3818255890,1672603615,1672605187,1572
7688,3332072298,3556951786,1672558631,1672559530,899
7854,3512142794,3701274634,1672564927,1672565267,340
7842,3510711755,3776513891,1672636999,1672637080,81
7678,3509453566,3793627961,1672633094,1672635103,2009
7853,3777806071,3774066725,1672616582,1672619193,2611
7559,3711262377,3737154119,1672680229,1672681760,1531
7636,3909331423,3481502100,1672544468,1672544872,404
7854,3514128943,3505599848,1672566799,1672570064,3265
7948,3756424865,3777477395,1672663634,1672664482,848
7653,3227457126,3804870229,1672656374,1672658074,1700
7623,3895562476,3438645253,1672553262,1672555707,2445
7852,3500391167,3772642849,1672614490,1672616018,1528
7945,3206254161,3209551760,1672687131,1672687598,467
7867,3756601594,3510244400,1672594838,1672597481,2643
7495,3777936328,3533927138,1672672176,1672675715,3539
7859,3711198793,3668005723,1672649506,1672651849,2343
7821,3303705369,3303751772,1672646250,1672648826,2576
7533,3774066725,3409474775,1672703867,1672706403,2536
7919,3779629905,3510857360,1672552422,1672553254,832
7648,3248507722,3390068992,1672571225,1672572401,1176
7870,3552314511,3756601594,1672567982,1672569652,1670
7713,3336742544,3757562897,1672685698,1672687326,1628
7505,3933210486,3496549058,1672636112,1672636364,252
7897,3397418363,3500374658,1672679436,1672681230,1794
7771,3511687358,3666457294,1672592588,1672593676,1088
7950,3917088658,3206254161,1672611219,1672613798,2579
7670,3533369198,3618873142,1672607320,1672608159,839
7613,3622054816,3516039895,1672684589,1672685032,443
7548,3391915121,3668898102,1672632139,1672633436,1297
7887,3937224533,3783206719,1672591903,1672594657,2754
7686,3359239884,3311845971,1672678796,1672681743,2947
7550,3518163778,3534729133,1672648701,1672650710,2009
7791,3711571712,3505904952,1672611937,1672615268,3331
7712,3333896808,3880285638,1672562803,1672564029,1226
7896,3779036831,3777806071,1672577064,1672577238,174
7683,3465202715,3662180254,1672678645,1672680716,2071
7542,3344019610,3515151980,1672631874,1672634756,2882
7539,3201848640,3488244966,1672560048,1672562618,2570
7724,3774501422,3511312803,1672575005,1672575339,334
7706,3227457126,3791657947,1672599068,1672599204,136
7870,3304625412,3757682496,1672624695,1672627347,2652
7548,3621497531,3791602225,1672562131,1672565191,3060
7503,3221899927,3924549929,1672620611,1672623723,3112
7653,3889750851,3924549929,1672691985,1672695167,3182
7899,3514987389,3714197325,1672644082,1672647398,3316
7766,3505873261,3489217083,1672683139,1672683741,602
7724,3822654369,3511350608,1672676675,1672677337,662
7973,3735733948,3760077057,1672628853,1672629474,621
7512,3898995675,3511687358,1672535689,1672535955,266
7534,3485008994,3918674986,1672537097,1672537469,372
7867,3852595551,3399004969,1672562599,1672566015,3416
7963,3397418363,3516223597,1672610694,1672611378,684
7534,3432689543,3715339701,1672676887,1672677745,858
7935,3516465662,3613683164,1672628174,1672628552,378
7649,3770824086,3604539807,1672690411,1672693278,2867
7708,3505791599,3505702787,1672680264,1672680476,212
7945,3235287260,3415546117,1672656624,1672659456,2832
7750,3315583351,3738274418,1672663529,1672664903,1374
7607,3533025282,3882997884,1672547038,1672549944,2906
7549,3278365525,3703955926,1672563407,1672565029,1622
7708,3701498253,3505193212,1672562607,1672563692,1085
7921,3509634629,3485823740,1672578731,1672579682,951
7618,3614238812,3713786889,1672571665,1672574921,3256
7784,3791874383,3816454165,1672618503,1672620278,1775
7971,3815508790,3372883226,1672697899,1672699022,1123
7956,3899266183,3311439795,1672578985,1672579752,767
7922,3370752401,3533025282,1672699899,1672702653,2754
7732,3852595551,3520012395,1672533594,1672534529,935
7821,3438645253,3916289176,1672637451,1672638183,732
7559,3513454145,3517077106,1672598538,1672601246,2708
7543,3467773920,3248507722,1672672140,1672675447,3307
7797,3713969578,3517459919,1672674187,1672677184,2997
7630,3505599848,3606812411,1672560984,1672562055,1071
7920,3490191091,3509907947,1672686418,1672687170,752
7598,3777514571,3477649378,1672684597,1672688049,3452
7776,3904408902,3703889596,1672565506,1672566611,1105
7895,3792177074,3201324715,1672679822,1672679913,91
7979,3783206719,3978105277,1672630575,1672631274,699
7587,3500487333,3396086535,1672703995,1672706213,2218
7757,3773465237,3829764737,1672568282,1672568537,255
7955,3666506258,3731106822,1672601095,1672602861,1766
7743,3757812939,3813052709,1672580220,1672583781,3561
7494,3505135325,3825229501,1672670398,1672670878,480
7532,3829764737,3533385867,1672689278,1672692187,2909
7550,3360993964,3271938399,1672700786,1672701130,344
7739,3520756859,3476232529,1672697633,1672701004,3371
7820,3338703270,3273500349,1672662694,1672665387,2693
7886,3505362057,3311439795,1672548437,1672551136,2699
7848,3604539807,3703789494,1672620862,1672622539,1677
7483,3238712269,3703871468,1672682270,1672684095,1825
7881,3356860407,3827222533,1672670002,1672672470,2468
7508,3311324983,3505201246,1672606541,1672609925,3384
7930,3909606423,3229058858,1672556151,1672558892,2741
7849,3505883609,3792844210,1672545702,1672547239,1537
7779,3389115045,3774050956,1672568217,1672569597,1380
7761,3430074045,3716488385,1672539676,1672542489,2813
7931,3515860749,3500499542,1672689839,1672692414,2575
7855,3512540951,3772544062,1672568827,1672570923,2096
7486,3510937904,3777079686,1672592913,1672594918,2005
7497,3711262377,3505193212,1672655396,1672658103,2707
7773,3459030804,3515125508,1672599135,1672599923,788
7686,3713630656,3373384732,1672657419,1672660875,3456
7810,3668005723,3783206719,1672601099,1672601272,173
7963,3517255726,3664517356,1672653410,1672653735,325
7795,3783925755,3668898102,1672699640,1672701175,1535
7521,3500391167,3733189298,1672652043,1672652708,665
7857,3238712269,3505883609,1672544605,1672546649,2044
7636,3909606423,3827222533,1672535302,1672538184,2882
7954,3516223597,3448855696,1672549265,1672549799,534
7645,3534424200,3701984666,1672640654,1672643166,2512
7655,3399535232,3284639858,1672696297,1672699245,2948
7718,3616944364,3505203158,1672693924,1672697101,3177
7650,3806545488,3601879040,1672671194,1672672228,1034
7814,3829764737,3388372715,1672698248,1672700926,2678
7591,3515394721,3501955238,1672663387,1672664838,1451
7973,3459030804,3891751546,1672604163,1672605544,1381
7765,3520030713,3701146057,1672539736,1672542275,2539
7777,3816454165,3209383861,1672690523,1672691152,629
7950,3713630656,3519556068,1672688247,1672689843,1596
7635,3772714862,3246596716,1672644180,1672646040,1860
7932,3711308224,3311718847,1672539016,1672540512,1496
7843,3813052709,3304056063,1672676113,1672677361,1248
7714,3779976989,3351554343,1672596281,1672597828,1547
7757,3885897503,3209048907,1672682954,1672684964,2010
7813,3711569060,3710344260,1672545823,1672548862,3039
7909,3454042520,3420700674,1672680159,1672681878,1719
7491,3778305740,3500894271,1672649468,1672651918,2450
7666,3365942576,3311871871,1672649454,1672649611,157
7840,3415443558,3206603608,1672671345,1672674132,2787
7529,3774338212,3473765852,1672686803,1672688963,2160
7914,3443698222,3793871337,1672570747,1672571662,915
7846,3202120784,3805292782,1672639660,1672641049,1389
7777,3496549058,3400804807,1672590520,1672593756,3236
7535,3511125626,3713268590,1672618761,1672620187,1426
7935,3500729955,3377766165,1672582348,1672584977,2629
7892,3682061100,3883861463,1672577823,1672579930,2107
7748,3970117174,3500578848,1672675361,1672677896,2535
7622,3515723720,3513599775,1672628246,1672628358,112
7627,3496269445,3819727225,1672616778,1672619822,3044
7809,3939952128,3311065516,1672634871,1672636607,1736
7518,3774119563,3917088658,1672552924,1672554419,1495
7888,3972364603,3829319703,1672563117,1672566090,2973
7929,3533280269,3247780536,1672694317,1672697604,3287
7902,3500904641,3500499542,1672670401,1672673085,2684
7667,3600647945,3378436155,1672649468,1672652037,2569
7574,3374559242,3760077057,1672696324,1672696614,290
7899,3505173328,3972364603,1672621301,1672623181,1880
7571,3713969578,3836573197,1672592656,1672595162,2506
7614,3337544549,3780294829,1672545082,1672547201,2119
7887,3293695955,3711571712,1672604820,1672607895,3075
7657,3500229033,3617734118,1672673574,1672676631,3057
7919,3346795719,3294803686,1672628271,1672631594,3323
7712,3433804879,3819727225,1672549171,1672550217,1046
7767,3666506258,3222521619,1672618358,1672621143,2785
7714,3489217083,3792883665,1672688700,1672691125,2425
7684,3668898102,3471220483,1672595597,1672596981,1384
7615,3500578848,3512349371,1672554759,1672557274,2515
7664,3777717988,3772309150,1672573238,1672576080,2842
7913,3778108318,3391915121,1672576878,1672578859,1981
7906,3232962003,3624312512,1672654825,1672655726,901
7733,3518876135,3365278081,1672651086,1672653378,2292
7828,3316173088,3338367113,1672624652,1672624967,315
7532,3501483568,3760569731,1672669528,1672672417,2889
7787,3316173088,3793389510,1672701138,1672703460,2322
7579,3925620998,3737079798,1672592712,1672593844,1132
7911,3805347939,3714504419,1672628942,1672629251,309
7878,3200691026,3715581279,1672638405,1672640451,2046
7752,3827626797,3374559242,1672593215,1672593386,171
7790,3496269445,3518260334,1672653046,1672654538,1492
7862,3792288302,3608633356,1672625617,1672625982,365
7916,3662180254,3229665776,1672562190,1672564851,2661
7793,3978105277,3817621391,1672612304,1672615387,3083
7769,3512969370,3236102733,1672697834,1672699861,2027
7663,3793871337,3399535232,1672656704,1672658653,1949
7867,3514283243,3409474775,1672651191,1672652944,1753
7836,3731106822,3932051427,1672558825,1672559470,645
7852,3448855696,3777936328,1672554443,1672556222,1779
7487,3899204805,3604539807,1672675348,1672675590,242
7639,3533025282,3793753089,1672577287,1672577895,608
7596,3605726278,3714197325,1672607276,1672607535,259
7842,3318166135,3710112546,1672642453,1672643836,1383
7694,3780593036,3505962865,1672676641,1672679062,2421
7969,3336751428,3756021689,1672615685,1672615968,283
7874,3808324264,3294803686,1672614612,1672615202,590
7899,3853018906,3510380060,1672636702,1672639350,2648
7943,3432689543,3701178711,1672641411,1672642946,1535
7860,3465202715,3249247700,1672682107,1672683958,1851
7483,3733189298,3816454165,1672598286,1672600540,2254
7587,3533242305,3634995491,1672652436,1672652865,429
7623,3200198928,3222521619,1672591862,1672593114,1252
7894,3711265369,3229665776,1672695975,1672696582,607
7551,3809916577,3509933351,1672609292,1672609596,304
7804,3476232529,3774204963,1672540058,1672540475,417
7722,3780365428,3772746272,1672555755,1672558289,2534
7917,3779740455,3516011407,1672550488,1672552691,2203
7646,3516673015,3416427576,1672699314,1672701513,2199
7727,3383922351,3533369198,1672560957,1672564250,3293
7533,3922337974,3774066725,1672622775,1672626164,3389
7587,3760183458,3515723720,1672635445,1672636930,1485
7847,3882291183,3232962003,1672699908,1672700364,456
7700,3209383861,3809484172,1672623712,1672626915,3203
7975,3501730685,3637008488,1672533727,1672537170,3443
7574,3418728074,3500499542,1672590325,1672590617,292
7614,3733891182,3793753089,1672557691,1672560044,2353
7790,3401627165,3774268456,1672696224,1672696752,528
7841,3501927421,3859663348,1672541425,1672544130,2705
7632,3517509185,3513956646,1672687311,1672688099,788
7672,3608868877,3805342762,1672691414,1672692469,1055
7489,3818255890,3533927138,1672683743,1672685395,1652
7636,3515125508,3736786443,1672563844,1672564439,595
7547,3716165213,3772884106,1672627676,1672629992,2316
7597,3517509185,3793436995,1672533244,1672536189,2945
7595,3510771358,3514838220,1672542372,1672542867,495
7645,3792253549,3501759100,1672684981,1672687749,2768
7553,3837094550,3224058172,1672627845,1672630408,2563
7760,3716273414,3443698222,1672565078,1672567307,2229
7739,3208844525,3715581279,1672636682,1672636789,107
7637,3791957752,3859525941,1672657883,1672659736,1853
7825,3229058858,3417587765,1672594762,1672595797,1035
7740,3512683609,3770101921,1672555557,1672558251,2694
7714,3303705369,3624312512,1672646410,1672648589,2179
7648,3516011407,3807987001,1672586627,1672587550,923
7618,3888559320,3738502357,1672618056,1672620829,2773
7639,3500658339,3783245561,1672647437,1672649531,2094
7603,3639847263,3711504540,1672570903,1672573988,3085
7780,3778108318,3443698222,1672565878,1672569372,3494
7809,3519912874,3510594211,1672575572,1672577536,1964
7940,3489728806,3428964059,1672566400,1672568149,1749
7936,3473562469,3933210486,1672696262,1672699252,2990
7708,3835382117,3710408395,1672695697,1672699129,3432
7563,3887270940,3757246925,1672559485,1672561775,2290
7784,3634340855,3774466457,1672586356,1672587677,1321
7818,3209383861,3311324983,1672623151,1672624598,1447
7514,3756930948,3433804879,1672540099,1672540795,696
7731,3660493209,3772642849,1672700997,1672701705,708
7668,3510937904,3918247820,1672607494,1672608984,1490
7626,3490191091,3779036831,1672656858,1672657548,690
7777,3505702787,3757812939,1672701104,1672702280,1176
7641,3715581279,3338703270,1672614561,1672617620,3059
7867,3918584946,3533748232,1672563062,1672563748,686
7664,3773465237,3314245084,1672555746,1672556700,954
7608,3418728074,3836573197,1672590972,1672591497,525
7846,3634995491,3465202715,1672648199,1672651245,3046
7562,3778980116,3513956646,1672628739,1672630033,1294
7637,3505873261,3291235378,1672577856,1672581275,3419
7889,3235287260,3533385867,1672619565,1672621058,1493
7519,3501759100,3760598102,1672628079,1672631029,2950
7484,3812176780,3373384732,1672624958,1672628388,3430
7848,3730517636,3448855696,1672659274,1672662001,2727
7749,3909238838,3246596716,1672660931,1672663519,2588
7900,3757812939,3518163778,1672593017,1672595119,2102
7727,3772053179,3505859863,1672701199,1672703856,2657
7948,3307512479,3389115045,1672536021,1672539135,3114
7583,3903009525,3505599848,1672559339,1672559942,603
7548,3755042098,3519556068,1672571566,1672574719,3153
7970,3391261292,3515723720,1672693679,1672694342,663
7597,3481502100,3610695419,1672619596,1672621993,2397
7532,3760992710,3774580701,1672537849,1672540721,2872
7613,3505201246,3779528381,1672592968,1672593031,63
7515,3510126867,3516960534,1672578313,1672578960,647
7750,3391915121,3793959750,1672600723,1672602076,1353
7781,3391915121,3716168623,1672635996,1672636243,247
7902,3311274543,3249247700,1672658937,1672661909,2972
7752,3505292701,3399052055,1672570631,1672572577,1946
7946,3533280269,3783206719,1672607633,1672611049,3416
7691,3509933351,3806545488,1672548974,1672551158,2184
7841,3793848402,3664517356,1672651414,1672654613,3199
7820,3760992710,3774125065,1672555116,1672558429,3313
7515,3346795719,3791997875,1672554054,1672554513,459
7978,3513454145,3760294205,1672668071,1672670988,2917
7803,3778266283,3976633198,1672595665,1672596637,972
7811,3244485293,3933210486,1672629574,1672630780,1206
7874,3855937514,3816853177,1672593033,1672594711,1678
7622,3930797455,3500199935,1672629082,1672630091,1009
7909,3710408395,3349613093,1672599042,1672601166,2124
7645,3756623396,3314245084,1672681667,1672681947,280
7493,3223789409,3816853177,1672685396,1672685528,132
7695,3443698222,3783925755,1672625114,1672628492,3378
7845,3621497531,3311203656,1672539040,1672542550,3510
7501,3806545488,3791874383,1672666361,1672667758,1397
7485,3756930948,3276640712,1672578951,1672581619,2668
7552,3701111745,3833889105,1672593010,1672594282,1272
7722,3429856982,3791997875,1672668058,1672670928,2870
7919,3288764520,3510969660,1672695240,1672695820,580
7983,3505702787,3664170666,1672550068,1672550145,77
7652,3976633198,3703955926,1672574724,1672575356,632
7806,3234541252,3517963492,1672538137,1672541355,3218
7551,3625274012,3360743849,1672583481,1672586237,2756
7592,3606987130,3921211276,1672693776,1672697116,3340
7543,3500894271,3516016437,1672665345,1672665895,550
7880,3201848640,3273500349,1672666816,1672667244,428
7971,3978105277,3855602893,1672645940,1672646633,693
7762,3826759140,3774366875,1672675519,1672676915,1396
7574,3397418363,3713969578,1672660109,1672662599,2490
7871,3713208927,3772337814,1672622037,1672625142,3105
7484,3770553384,3478194807,1672566978,1672567124,146
7824,3889232789,3397418363,1672619512,1672621227,1715
7790,3512720680,3246596716,1672668232,1672668776,544
7526,3485375593,3734737881,1672581539,1672582427,888
7812,3505649239,3227158514,1672635133,1672638124,2991
7557,3421836608,3518014636,1672554722,1672557922,3200
7929,3511359172,3776800213,1672544514,1672545374,860
7774,3500729955,3777443199,1672568494,1672569526,1032
7946,3316173088,3505203158,1672594835,1672597390,2555
7641,3427283336,3518932404,1672667016,1672668272,1256
7791,3365942576,3851190615,1672635359,1672637727,2368
7557,3662180254,3493507965,1672544301,1672546873,2572
7945,3206603608,3481502100,1672619857,1672622418,2561
7630,3778980116,3362000049,1672583004,1672586541,3537
7659,3500805881,3518496488,1672580537,1672582808,2271
7555,3888559320,3711973519,1672562996,1672565072,2076
7496,3365942576,3701898991,1672556969,1672557794,825
7891,3760492950,3534553510,1672558188,1672558253,65
7636,3774556560,3519428855,1672605595,1672606749,1154
7561,3511271692,3519069599,1672624677,1672625385,708
7687,3465202715,3715492942,1672616654,1672617080,426
7610,3899266183,3511332835,1672566040,1672568955,2915
7797,3710569131,3701146057,1672677168,1672680594,3426
7508,3249791738,3891751546,1672688646,1672689976,1330
7527,3352603894,3483949762,1672694401,1672696946,2545
7883,3791657947,3855000166,1672618687,1672621070,2383
7847,3826633236,3757455053,1672663528,1672665362,1834
7487,3793871337,3783083229,1672551313,1672552427,1114
7979,3396086535,3311603601,1672598588,1672600265,1677
7595,3772642849,3774125065,1672606481,1672608029,1548
7560,3391261292,3711504540,1672544485,1672546493,2008
7551,3920801189,3757812939,1672641572,1672642884,1312
7839,3224058172,3774119563,1672542099,1672542223,124
7577,3772309150,3778780511,1672588317,1672588671,354
7569,3514245078,3606812411,1672634018,1672635125,1107
7871,3713894336,3346795719,1672617962,1672621316,3354
7660,3314245084,3792473331,1672545121,1672546720,1599
7977,3701065786,3481647420,1672621811,1672623562,1751
7601,3429856982,3780639480,1672613231,1672615548,2317
7975,3227457126,3293695955,1672561657,1672565236,3579
7672,3512510536,3812176780,1672645460,1672646197,737
7819,3511350608,3816853177,1672617617,1672618905,1288
7638,3716488385,3756453423,1672696501,1672699331,2830
7959,3404058699,3334033993,1672651609,1672652332,723
7910,3716197887,3489962019,1672666099,1672667606,1507
7732,3910454786,3505962865,1672661373,1672663703,2330
7493,3774204963,3515860749,1672549620,1672551124,1504
7645,3515723720,3855937514,1672657419,1672657965,546
7761,3780503655,3247780536,1672672774,1672675412,2638
7981,3311065516,3711571712,1672640640,1672642752,2112
7950,3378436155,3783245561,1672535564,1672535913,349
7970,3772714862,3791997875,1672590807,1672591936,1129
7568,3534010629,3624312512,1672686394,1672687044,650
7581,3926700506,3509630174,1672549241,1672549702,461
7872,3500229033,3206603608,1672602540,1672605667,3127
7897,3760561634,3311845971,1672675721,1672676180,459
7975,3793848402,3244436890,1672586283,1672589193,2910
7694,3793753089,3701984666,1672592255,1672595288,3033
7567,3760489031,3634340855,1672568347,1672571251,2904
7619,3714962248,3311203656,1672550806,1672553471,2665
7502,3505145247,3511267139,1672630020,1672632583,2563
7884,3853018906,3904775198,1672625203,1672626520,1317
7902,3276993580,3420432297,1672570072,1672572877,2805
7827,3973560347,3783239924,1672698302,1672701052,2750
7976,3554917400,3738274418,1672533660,1672535649,1989
7804,3235635976,3518014404,1672655454,1672657688,2234
7812,3685187183,3388637594,1672675539,1672676579,1040
7598,3519563836,3224058172,1672648097,1672649673,1576
7570,3780788622,3380035798,1672702791,1672705783,2992
7915,3780365428,3517963492,1672542466,1672543908,1442
7741,3518260334,3817316561,1672652897,1672653343,446
7903,3500177712,3519601612,1672549586,1672550878,1292
7846,3666507626,3294803686,1672583318,1672584895,1577
7863,3779740455,3276640712,1672702610,1672703693,1083
7529,3467773920,3515125508,1672675830,1672678076,2246
7571,3756966035,3898995675,1672545150,1672546358,1208
7521,3776948966,3481502100,1672558982,1672559274,292
7505,3298433163,3780788622,1672605858,1672609217,3359
7717,3501730685,3793338102,1672633647,1672637078,3431
7632,3921211276,3500458761,1672555024,1672556238,1214
7704,3773598056,3701190899,1672607765,1672610440,2675
7961,3534010629,3783239924,1672545538,1672548971,3433
7665,3370752401,3735733948,1672684489,1672687372,2883
7590,3446948848,3756027749,1672680639,1672682243,1604
7684,3235635976,3783531004,1672652395,1672654230,1835
7860,3208844525,3828624701,1672660890,1672661972,1082
7773,3516960534,3710569131,1672634027,1672635999,1972
7817,3383922351,3701498253,1672647782,1672649187,1405
7895,3880310724,3280615985,1672631707,1672632937,1230
7577,3333896808,3359910781,1672666134,1672667373,1239
7710,3828365570,3418534998,1672566533,1672567097,564
7791,3715492942,3710408395,1672554160,1672556725,2565
7677,3389115045,3633420270,1672557551,1672558381,830
7554,3777455223,3882997884,1672559740,1672562159,2419
7572,3249791738,3500803339,1672630088,1672631811,1723
7792,3550946908,3791874383,1672666582,1672668717,2135
7924,3858918246,3756623396,1672592788,1672594533,1745
7484,3416427576,3773664987,1672665270,1672667445,2175
7931,3520751702,3221899927,1672625394,1672625767,373
7514,3505219850,3365830990,1672677374,1672680727,3353
7670,3311993075,3777929708,1672624298,1672627567,3269
7533,3711569060,3392121505,1672532137,1672533267,1130
7841,3484995752,3666553782,1672589901,1672592285,2384
7758,3779528381,3668005723,1672678741,1672682104,3363
7676,3667680268,3783206719,1672553336,1672554940,1604
7817,3224716315,3520751702,1672601711,1672602923,1212
7533,3392121505,3244436890,1672545040,1672545665,625
7532,3935127663,3935127663,1672579281,1672580275,994
7638,3238712269,3711504540,1672680315,1672683436,3121
7714,3505904952,3510771358,1672622482,1672623564,1082
7928,3606186086,3407954858,1672535765,1672536079,314
7845,3716165213,3510771358,1672551954,1672553915,1961
7946,3883042241,3533748232,1672555862,1672557842,1980
7770,3418534998,3802367797,1672581180,1672582277,1097
7877,3501198706,3246596716,1672598675,1672601396,2721
7960,3514719601,3716843669,1672558377,1672561428,3051
7542,3760489031,3911159965,1672578480,1672579503,1023
7839,3715189301,3279721246,1672634482,1672635873,1391
7679,3514472925,3618873142,1672632964,1672635475,2511
7948,3517963492,3780914982,1672546671,1672549463,2792
7978,3518260334,3852595551,1672621482,1672622700,1218
7775,3512720680,3920801189,1672688866,1672690151,1285
7850,3610348516,3774580701,1672555900,1672556544,644
7873,3829232696,3512142794,1672673534,1672676639,3105
7861,3360993964,3500499542,1672678455,1672680040,1585
7938,3755872268,3891751546,1672674369,1672677886,3517
7560,3236102733,3406784491,1672632126,1672635117,2991
7765,3716843669,3710067113,1672564033,1672564972,939
7647,3774045700,3716197887,1672569248,1672572133,2885
7982,3520629279,3512969370,1672638635,1672641261,2626
7523,3613995936,3770021824,1672597627,1672598047,420
7537,3482405588,3279721246,1672598638,1672601127,2489
7823,3505638204,3514128943,1672536801,1672537230,429
7692,3505859863,3505859863,1672678761,1672679379,618
7533,3756424865,3505702787,1672611420,1672612074,654
7765,3859663348,3514719601,1672604728,1672606753,2025
7783,3757812939,3465254146,1672680257,1672682628,2371
7585,3773755137,3318166135,1672609397,1672612995,3598
7761,3534488837,3805342762,1672605931,1672608926,2995
7716,3757246925,3516606733,1672537900,1672540315,2415
7959,3772758337,3288764520,1672561988,1672563470,1482
7678,3311603601,3859663348,1672689117,1672692696,3579
7729,3427283336,3805347939,1672607992,1672610332,2340
7762,3755392666,3716168623,1672632461,1672633355,894
7826,3344019610,3223789409,1672633659,1672634178,519
7862,3511359172,3791020967,1672703545,1672706903,3358
7517,3511163800,3365830990,1672632104,1672633541,1437
7485,3760294205,3778341199,1672557226,1672560143,2917
7918,3318697153,3932051427,1672681430,1672682025,595
7586,3416265063,3501486692,1672601356,1672603007,1651
7541,3778780511,3793871337,1672630372,1672632764,2392
7799,3756601594,3514128943,1672556817,1672558903,2086
7848,3913251733,3533626375,1672591335,1672594151,2816
7780,3805342762,3533385867,1672575463,1672578020,2557
7700,3234362962,3760492950,1672547948,1672550665,2717
7954,3510771358,3518932404,1672571492,1672572394,902
7907,3756027749,3885897503,1672685888,1672686120,232
7979,3882242815,3713349754,1672625779,1672629056,3277
7729,3922337974,3783126683,1672570199,1672570953,754
7775,3319752091,3918247820,1672589276,1672589743,467
7577,3611150562,3512837326,1672690064,1672690924,860
7924,3505292701,3731419510,1672683185,1672684183,998
7699,3731106822,3501730685,1672543607,1672546566,2959
7658,3898995675,3534010629,1672615408,1672615525,117
7796,3319752091,3234362962,1672564840,1672567933,3093
7610,3777790718,3715974031,1672623578,1672625191,1613
7685,3249401741,3520165601,1672553151,1672556582,3431
7689,3516258476,3517459919,1672580949,1672581594,645
7805,3480687894,3715974031,1672678637,1672680385,1748
7551,3979339287,3515691540,1672639215,1672642335,3120
7579,3518014636,3298433163,1672610951,1672611992,1041
7814,3833889105,3666457294,1672559115,1672559368,253
7493,3772309150,3280599164,1672702463,1672704079,1616
7820,3904775198,3311203656,1672652089,1672653106,1017
7943,3344019610,3505477652,1672603616,1672605009,1393
7494,3770447408,3881477378,1672543619,1672544625,1006
7868,3809484172,3783239924,1672638215,1672641087,2872
7889,3515860749,3501483568,1672550524,1672552317,1793
7512,3714821932,3783239924,1672609823,1672610650,827
7943,3386707783,3505973226,1672542309,1672543047,738
7717,3304056063,3518876135,1672650400,1672653473,3073
7490,3774005526,3512217942,1672682994,1672685973,2979
7977,3899204805,3510711755,1672546653,1672547749,1096
7911,3505219850,3505962865,1672557194,1672558602,1408
7692,3889232789,3515860749,1672670461,1672671839,1378
7638,3792253549,3668898102,1672643592,1672646683,3091
7841,3489217083,3505173328,1672649400,1672649614,214
7636,3378092448,3434642576,1672545991,1672547613,1622
7904,3311603601,3472130842,1672535112,1672538409,3297
7719,3416241005,3855424474,1672664004,1672666682,2678
7868,3303705369,3201432789,1672575086,1672575274,188
7899,3319752091,3520931254,1672683168,1672683282,114
7798,3520730271,3772309150,1672597877,1672598290,413
7727,3778308417,3756528686,1672587745,1672588583,838
7686,3779036831,3805347939,1672579563,1672581083,1520
7487,3774520233,3793086311,1672605725,1672605978,253
7690,3510969660,3312829208,1672680750,1672684325,3575
7950,3774204963,3770021824,1672666939,1672668099,1160
7711,3427283336,3683959482,1672599873,1672603364,3491
7888,3391261292,3917088658,1672545939,1672546174,235
7721,3314245084,3349613093,1672666024,1672667064,1040
7564,3314836094,3774119563,1672623220,1672625840,2620
7758,3624761861,3667680268,1672664980,1672665288,308
7743,3489217083,3200691026,1672539258,1672541874,2616
7613,3778266283,3757682496,1672582750,1672584931,2181
7897,3912536808,3922337974,1672550057,1672550220,163
7886,3903307060,3496549058,1672589908,1672592306,2398
7786,3774119563,3701274634,1672546157,1672547115,958
7632,3399911573,3509630174,1672586496,1672586810,314
7641,3779528381,3417587765,1672551882,1672552517,635
7898,3756424865,3511125626,1672539720,1672540915,1195
7539,3772758337,3823600322,1672640893,1672642648,1755
7483,3500904641,3512510536,1672552008,1672553970,1962
7695,3509933351,3804870229,1672590340,1672590895,555
7883,3827222533,3730517636,1672594135,1672595123,988
7860,3311439795,3505219850,1672670884,1672671224,340
7927,3277605882,3710408395,1672636961,1672637847,886
7835,3918247820,3713268590,1672672493,1672672878,385
7659,3774339795,3420700674,1672617494,1672618694,1200
7561,3617055293,3779528381,1672555601,1672558143,2542
7524,3247815299,3509604974,1672577888,1672578366,478
7690,3471220483,3516909237,1672607933,1672610428,2495
7976,3433804879,3914290246,1672599672,1672600590,918
7876,3509933351,3791657947,1672615162,1672618176,3014
7509,3344019610,3516716179,1672613354,1672614350,996
7837,3836573197,3634340855,1672534540,1672537448,2908
7743,3280964728,3235635976,1672661855,1672664087,2232
7498,3501184421,3518163778,1672683807,1672685809,2002
7940,3559110998,3800353779,1672678745,1672680603,1858
7922,3501606184,3774045700,1672657953,1672658269,316
7591,3533810360,3533927138,1672629766,1672630430,664
7958,3852595551,3703441914,1672542996,1672543721,725
7499,3736786443,3505869747,1672679413,1672681673,2260
7757,3791901535,3303751772,1672551711,1672552547,836
7574,3247815299,3379256399,1672608477,1672609819,1342
7639,3805347939,3315583351,1672658467,1672658988,521
7732,3979339287,3701967560,1672660958,1672661660,702
7573,3792253549,3770078063,1672673966,1672675435,1469
7598,3703275621,3783083229,1672579797,1672581032,1235
7673,3703871468,3399911573,1672657281,1672658896,1615
7906,3757403279,3505145247,1672559528,1672562790,3262
7709,3284832486,3505362057,1672555336,1672556034,698
7798,3932051427,3221536550,1672555920,1672559232,3312
7725,3715981584,3477375368,1672644075,1672644310,235
7691,3500177712,3820354437,1672584578,1672586024,1446
7839,3388372715,3313541986,1672630245,1672632958,2713
7886,3774045700,3852391257,1672681933,1672682522,589
7518,3318166135,3407725581,1672565654,1672567675,2021
7707,3500499542,3511271692,1672576125,1672579702,3577
7976,3520629279,3770824086,1672661092,1672664659,3567
7668,3512540951,3756528686,1672678675,1672680831,2156
7910,3819727225,3755511676,1672638029,1672639725,1696
7938,3311845971,3338703270,1672606708,1672609723,3015
7740,3832902928,3516465662,1672541051,1672543426,2375
7552,3600647945,3510969660,1672606628,1672606739,111
7802,3828365570,3511267139,1672683039,1672684399,1360
7883,3534702203,3772884106,1672582854,1672585580,2726
7856,3783705817,3505530961,1672650885,1672652386,1501
7550,3806545488,3303751772,1672573709,1672574484,775
7599,3412980697,3735319397,1672629576,1672632993,3417
7925,3715339701,3517255726,1672677633,1672679666,2033
7921,3815508790,3617734118,1672669964,1672671425,1461
7680,3703955926,3209048907,1672576726,1672579893,3167
7796,3286658957,3380035798,1672670137,1672672167,2030
7655,3912536808,3379256399,1672577896,1672580037,2141
7533,3778305740,3817316561,1672677431,1672680164,2733
7969,3426325549,3774793839,1672611908,1672613969,2061
7809,3510711755,3755625324,1672667175,1672668486,1311
7927,3667680268,3496549058,1672661134,1672663803,2669
7485,3432689543,3772714862,1672692146,1672693996,1850
7684,3793959750,3701111745,1672700841,1672703570,2729
7982,3899266183,3232962003,1672558918,1672560817,1899
7660,3202120784,3793627961,1672582613,1672584018,1405
7664,3361230905,3666507626,1672696290,1672698388,2098
7981,3518496488,3473562469,1672613454,1672614308,854
7787,3473765852,3792384220,1672546727,1672548112,1385
7872,3496051529,3713208927,1672599522,1672602200,2678
7916,3774005526,3285400528,1672537232,1672539342,2110
7718,3793286136,3516716179,1672686401,1672688394,1993
7528,3931941795,3483949762,1672694674,1672697197,2523
7559,3247780536,3776948966,1672635043,1672636863,1820
7694,3500658339,3352603894,1672662021,1672664578,2557
7498,3883861463,3520206212,1672695279,1672698713,3434
7654,3505638204,3505962865,1672665793,1672667686,1893
7660,3882291183,3224716315,1672681755,1672685245,3490
7849,3792902982,3773598056,1672621799,1672624960,3161
7494,3385763781,3339907603,1672700202,1672703396,3194
7615,3773205565,3903307060,1672634836,1672636995,2159
7516,3516514391,3512683609,1672691518,1672691761,243
7961,3221899927,3791657947,1672542756,1672543852,1096
7658,3755872268,3418534998,1672702134,1672705386,3252
7727,3909606423,3378436155,1672591438,1672592005,567
7878,3610348516,3451432842,1672640951,1672641823,872
7884,3206603608,3515394721,1672626379,1672627756,1377
7759,3510173870,3487171044,1672685845,1672688691,2846
7726,3345207877,3391915886,1672538019,1672538538,519
7842,3792668962,3931941795,1672680183,1672680654,471
7774,3515284591,3770078063,1672688003,1672689920,1917
7587,3883042241,3774366875,1672579732,1672582236,2504
7594,3716197887,3939952128,1672545845,1672547400,1555
7711,3518496488,3533827120,1672701042,1672701994,952
7726,3756966035,3716168623,1672604036,1672605339,1303
7587,3511862351,3515723720,1672679431,1672682213,2782
7541,3815508790,3777936328,1672598637,1672602136,3499
7918,3378686918,3629547065,1672587194,1672590367,3173
7891,3489545239,3778549126,1672634758,1672638154,3396
7783,3836573197,3634340855,1672575111,1672576146,1035
7711,3279721246,3520706195,1672659182,1672662757,3575
7801,3777623166,3615046771,1672662100,1672663646,1546
7979,3931941795,3533748232,1672648981,1672650808,1827
7564,3793627961,3737051610,1672547357,1672550546,3189
7592,3415546117,3605726278,1672539250,1672542739,3489
7798,3882291183,3520376528,1672699723,1672702876,3153
7824,3978115672,3402943525,1672669444,1672671006,1562
7888,3428006164,3222448362,1672647951,1672648081,130
7732,3519152550,3918056059,1672622913,1672625424,2511
7853,3512142794,3770851318,1672574960,1672577505,2545
7572,3500499542,3791942683,1672558698,1672559313,615
7760,3291883916,3714821932,1672600824,1672601196,372
7885,3778341199,3421836608,1672703954,1672706887,2933
7910,3883312122,3487171044,1672683908,1672684707,799
7782,3473562469,3703661585,1672624765,1672627939,3174
7743,3734737881,3332072298,1672674667,1672678166,3499
7700,3851190615,3346327502,1672674369,1672676137,1768
7497,3311603601,3399433690,1672534060,1672535812,1752
7550,3711569060,3511359172,1672617224,1672620446,3222
7603,3510711755,3882242815,1672560935,1672563740,2805
7754,3520183192,3311627628,1672552955,1672555897,2942
7590,3904775198,3357483218,1672613444,1672614820,1376
7750,3377766165,3369998498,1672654767,1672654869,102
7903,3511435497,3683959482,1672555974,1672557698,1724
7616,3439023335,3420700674,1672628982,1672631967,2985
7574,3780788622,3701274634,1672697492,1672700493,3001
7501,3500729955,3307097200,1672625326,1672627732,2406
7820,3517077106,3634340855,1672645860,1672649071,3211
7542,3618045231,3511359172,1672602014,1672605363,3349
7820,3903307060,3815508790,1672624038,1672625527,1489
7959,3392121505,3516065852,1672546722,1672547661,939
7665,3778108318,3901877072,1672576904,1672578567,1663
7629,3311154569,3372883226,1672545731,1672545945,214
7630,3777776687,3497901842,1672596569,1672596860,291
7924,3731106822,3880310724,1672586690,1672588689,1999
7777,3348261553,3209048907,1672610228,1672613013,2785
7743,3780828689,3360993964,1672548522,1672551563,3041
7685,3505649239,3773755137,1672657113,1672660452,3339
7853,3734828619,3933210486,1672688764,1672690014,1250
7824,3510771358,3606987130,1672674229,1672674343,114
7709,3703013906,3783239924,1672604100,1672606660,2560
7864,3555214688,3802367797,1672600041,1672603606,3565
7563,3716197887,3338703270,1672582638,1672584080,1442
7712,3514128943,3614238812,1672701065,1672704509,3444
7590,3505201246,3835382117,1672692907,1672693913,1006
7802,3235287260,3826760240,1672657838,1672660690,2852
7502,3420700674,3772309166,1672655414,1672658322,2908
7875,3778308417,3737051610,1672608093,1672610070,1977
7515,3793871337,3792288302,1672679224,1672681796,2572
7530,3772746272,3918584946,1672637800,1672638984,1184
7695,3517864478,3933210486,1672676794,1672677723,929
7783,3911245524,3710067113,1672650552,1672651287,735
7644,3365830990,3519152550,1672565660,1672566022,362
7980,3783245561,3316173088,1672623338,1672626653,3315
7806,3518496488,3221899927,1672561921,1672564647,2726
7564,3234541252,3533193862,1672538171,1672541435,3264
7868,3780974443,3664170666,1672612115,1672613419,1304
7659,3616944364,3234362962,1672610382,1672613204,2822
7491,3514245078,3979339287,1672637281,1672639544,2263
7710,3774466457,3610348516,1672606571,1672609121,2550
7688,3827222533,3291235378,1672611401,1672613193,1792
7817,3388637594,3391915886,1672693838,1672695627,1789
7949,3777936328,3518163778,1672663579,1672663889,310
7491,3737051610,3827377568,1672561765,1672564857,3092
7719,3512540951,3629547065,1672547681,1672549523,1842
7933,3480687894,3777079686,1672650609,1672653783,3174
7783,3483949762,3666553782,1672652156,1672653931,1775
7868,3500894271,3397418363,1672648217,1672650068,1851
7828,3511687358,3346795719,1672548262,1672548960,698
7553,3903962771,3617055293,1672698901,1672698985,84
7739,3288764520,3209551760,1672636800,1672638541,1741
7806,3685818092,3779036831,1672638293,1672638789,496
7733,3827377568,3805342762,1672641236,1672644627,3391
7682,3902383721,3899266183,1672594899,1672596896,1997
7844,3714962248,3737051610,1672602374,1672603804,1430
7757,3518669703,3851190615,1672591172,1672593657,2485
7641,3465202715,3533193862,1672594261,1672597655,3394
7851,3827222533,3249401741,1672606807,1672609274,2467
7553,3815508790,3373384732,1672668388,1672669103,715
7877,3384951177,3666507626,1672565606,1672567997,2391
7561,3713644518,3406784491,1672539813,1672542317,2504
7835,3606987130,3777936328,1672539034,1672541647,2613
7641,3505145247,3777443199,1672562566,1672565252,2686
7680,3757602960,3925620998,1672684535,1672685208,673
7853,3513956646,3755881905,1672579045,1672581831,2786
7875,3970117174,3277669002,1672696372,1672698176,1804
7564,3760893269,3418534998,1672570975,1672572732,1757
7974,3428006164,3511687358,1672679616,1672680916,1300
7628,3911159965,3500487333,1672697909,1672700740,2831
7832,3505219850,3291883916,1672613242,1672615119,1877
7679,3660493209,3716168623,1672697429,1672698356,927
7517,3778108318,3312829208,1672615611,1672618027,2416
7726,3914259449,3756451663,1672576765,1672580229,3464
7585,3816853177,3813052709,1672682698,1672684292,1594
7790,3209027249,3346327502,1672572802,1672574586,1784
7794,3777455223,3791553060,1672660509,1672663448,2939
7525,3402943525,3466229085,1672540231,1672543271,3040
7930,3303705369,3716900301,1672546800,1672549228,2428
7594,3500894271,3924549929,1672700097,1672702956,2859
7874,3280599164,3827377568,1672692176,1672694522,2346
7870,3387674757,3337544549,1672680211,1672681402,1191
7949,3757812939,3777477395,1672554515,1672557414,2899
7881,3501198706,3396285984,1672553802,1672554221,419
7883,3902383721,3294803686,1672636184,1672638714,2530
7543,3513164386,3235635976,1672560003,1672560437,434
7486,3936227020,3509634629,1672537390,1672538592,1202
7788,3505530961,3420700674,1672683005,1672684481,1476
7762,3774005526,3496051529,1672575759,1672577382,1623
7814,3520709480,3809484172,1672675693,1672677201,1508
7574,3606987130,3339907603,1672643210,1672643922,712
7848,3703789494,3664170666,1672679285,1672680222,937
7888,3770553384,3509672210,1672632459,1672635893,3434
7779,3909331423,3244173074,1672562281,1672565508,3227
7746,3483164654,3489217083,1672558564,1672560451,1887
7602,3780828689,3348261553,1672645410,1672645685,275
7592,3930797455,3279721246,1672567679,1672569066,1387
7935,3416427576,3627937312,1672674196,1672677616,3420
7652,3778266283,3424922204,1672659044,1672662185,3141
7700,3777477395,3774366875,1672573338,1672573487,149
7667,3889750851,3859525941,1672602312,1672605896,3584
7809,3500177712,3633420270,1672646326,1672648835,2509
7552,3736229191,3756424865,1672664093,1672665543,1450
7982,3513454145,3480687894,1672660562,1672663926,3364
7732,3404058699,3316173088,1672659940,1672662469,2529
7641,3512567240,3703735129,1672597585,1672598843,1258
7527,3616944364,3512837326,1672649673,1672651139,1466
7547,3289061738,3500458761,1672636045,1672638999,2954
7791,3634995491,3429690204,1672580311,1672581340,1029
7857,3666457294,3510711755,1672675975,1672678352,2377
7804,3511862351,3534492426,1672554162,1672556346,2184
7939,3518408774,3520751702,1672683308,1672684229,921
7722,3777079686,3904775198,1672606433,1672606844,411
7558,3222448362,3533137446,1672604140,1672605019,879
7889,3277939457,3902278226,1672632119,1672634280,2161
7722,3666553782,3351554343,1672608049,1672609532,1483
7813,3515151980,3922275416,1672596862,1672598530,1668
7883,3607748895,3517459919,1672672835,1672675028,2193
7832,3978115672,3500499542,1672662832,1672665115,2283
7886,3271938399,3221536550,1672641600,1672642032,432
7527,3505791599,3489728806,1672531607,1672533586,1979
7965,3710067113,3793959750,1672654274,1672654660,386
7867,3276993580,3816853177,1672568435,1672570894,2459
7508,3783779671,3383661227,1672626730,1672627766,1036
7682,3816454165,3404058699,1672557121,1672558968,1847
7540,3501692334,3477649378,1672565994,1672566445,451
7811,3791942683,3774339795,1672629163,1672631379,2216
7906,3711262377,3683766533,1672579866,1672581985,2119
7532,3293695955,3634995491,1672637746,1672638556,810
7793,3420700674,3909331423,1672596937,1672600012,3075
7802,3338703270,3519700826,1672609387,1672610088,701
7550,3970117174,3715127362,1672670142,1672672480,2338
7829,3774520233,3534488837,1672693391,1672696104,2713
7529,3517721725,3685187183,1672567445,1672570090,2645
7615,3520206212,3703889596,1672570903,1672573595,2692
7668,3773950140,3735319397,1672585198,1672587767,2569
7804,3296471982,3792789881,1672603028,1672605999,2971
7731,3855000166,3713630656,1672580052,1672583559,3507
7959,3978115672,3501364586,1672547640,1672547823,183
7701,3772746272,3336742544,1672687562,1672689354,1792
7952,3682061100,3501730685,1672572609,1672573665,1056
7749,3770824086,3500487333,1672684337,1672684805,468
7723,3682061100,3514283243,1672593100,1672595607,2507
7491,3298433163,3370636709,1672572067,1672574128,2061
7871,3389115045,3791874383,1672652368,1672654996,2628
7535,3475251781,3777477395,1672533504,1672537025,3521
7907,3520931254,3711571712,1672552735,1672554805,2070
7813,3731419510,3383922351,1672541547,1672542468,921
7637,3200198928,3757812939,1672677347,1672677460,113
7934,3703889596,3756966035,1672607869,1672609268,1399
7809,3853018906,3399535232,1672584458,1672585915,1457
7817,3247428249,3412980697,1672693770,1672696868,3098
7895,3516980378,3976390453,1672600709,1672602959,2250
7892,3772746272,3516629436,1672578383,1672579056,673
7923,3808324264,3622054816,1672578994,1672580298,1304
7515,3312664885,3500894271,1672590639,1672593321,2682
7847,3208844525,3664517356,1672613447,1672615802,2355
7686,3454042520,3755042098,1672550089,1672552205,2116
7659,3404058699,3533385867,1672660651,1672660744,93
7842,3925620998,3711308224,1672582881,1672586213,3332
7753,3778341199,3500066230,1672662682,1672663564,882
7511,3889232789,3534729133,1672535777,1672538598,2821
7691,3701274634,3222448362,1672550922,1672552498,1576
7717,3760077057,3533748232,1672550547,1672552973,2426
7729,3301107849,3805347939,1672677656,1672678988,1332
7802,3715974031,3710098970,1672605064,1672605760,696
7966,3701967560,3756021689,1672687336,1672690737,3401
7560,3881477378,3733189298,1672536707,1672538032,1325
7620,3793753089,3520012395,1672556193,1672558388,2195
7721,3311090974,3248507722,1672662230,1672662695,465
7678,3925402713,3454042520,1672565562,1672566470,908
7516,3513080274,3901877072,1672614199,1672615467,1268
7829,3827626797,3311065516,1672654197,1672655123,926
7929,3534424200,3918247820,1672635517,1672637553,2036
7886,3783779671,3516960534,1672656690,1672660131,3441
7511,3793338102,3209048907,1672559668,1672559783,115
7676,3760183458,3783126683,1672677647,1672680280,2633
7646,3825229501,3485008994,1672616060,1672616453,393
7886,3777623166,3365830990,1672542704,1672544276,1572
7747,3827377568,3369998498,1672551470,1672553284,1814
7683,3713268590,3783239924,1672654168,1672654983,815
7670,3826759140,3520190170,1672580892,1672582371,1479
7746,3485375593,3516065852,1672701212,1672701901,689
7911,3716258994,3755920131,1672624848,1672627965,3117
7695,3388286531,3427219654,1672623448,1672624554,1106
7906,3509672210,3757246925,1672669974,1672672046,2072
7594,3417061462,3311203656,1672563080,1672564979,1899
7628,3895562476,3828432634,1672679621,1672681204,1583
7817,3819727225,3978105277,1672656784,1672659550,2766
7648,3685187183,3903962771,1672559047,1672559693,646
7915,3518876135,3200198928,1672649224,1672651149,1925
7812,3792768129,3500578848,1672566735,1672568509,1774
7836,3427219654,3391915121,1672677016,1672680613,3597
7741,3701967560,3511359172,1672545949,1672547817,1868
7805,3349613093,3510126867,1672582219,1672584292,2073
7636,3505638204,3427283336,1672659833,1672662176,2343
7700,3206593906,3713644518,1672693493,1672694871,1378
7744,3716900301,3791942683,1672603061,1672604695,1634
7517,3511125626,3520751702,1672679352,1672682215,2863
7858,3365830990,3760561634,1672604209,1672605064,855
7831,3715492942,3511271692,1672622896,1672626092,3196
7892,3732481297,3760183458,1672623542,1672624194,652
7658,3755511676,3701146057,1672619486,1672622679,3193
7737,3755943611,3501198706,1672543442,1672544205,763
7626,3606812411,3756027749,1672615838,1672618081,2243
7592,3793753089,3918056059,1672545991,1672548513,2522
7720,3756462516,3703889596,1672549477,1672551416,1939
7958,3220716272,3517459919,1672606057,1672607870,1813
7491,3792668962,3465254146,1672549761,1672551254,1493
7952,3972364603,3501364586,1672683823,1672684222,399
7822,3407954858,3401627165,1672663150,1672664454,1304
7909,3511350608,3755920131,1672692107,1672692602,495
7959,3804870229,3610695419,1672627906,1672627982,76
7686,3227158514,3793389510,1672668085,1672670546,2461
7863,3200198928,3713969578,1672549056,1672550930,1874
7610,3533748232,3760183458,1672533452,1672535738,2286
7854,3755042098,3224058172,1672680095,1672681790,1695
7630,3855424474,3365942576,1672669266,1672669708,442
7914,3316173088,3606812411,1672674615,1672676624,2009
7716,3918247820,3518791447,1672625536,1672627514,1978
7868,3520888296,3505362057,1672692183,1672692796,613
7545,3792768129,3472130842,1672568248,1672571708,3460
7515,3501364586,3760569731,1672675955,1672676587,632
7781,3772337814,3291235378,1672558755,1672561797,3042
7787,3235287260,3760267716,1672533966,1672534082,116
7617,3904408902,3520931254,1672567141,1672570330,3189
7778,3514245078,3713370078,1672593108,1672594864,1756
7734,3500803339,3311648200,1672606636,1672609509,2873
7545,3783083229,3715189301,1672624392,1672625750,1358
7494,3793470489,3774466457,1672693477,1672693797,320
7688,3734496778,3736229191,1672650016,1672650609,593
7690,3773950140,3851190615,1672540808,1672542002,1194
7873,3912262917,3509933351,1672589090,1672591902,2812
7913,3351008918,3772642849,1672599093,1672602519,3426
7949,3500658339,3608633356,1672640217,1672643749,3532
7847,3618873142,3933210486,1672666239,1672667978,1739
7743,3783429780,3852595551,1672590932,1672591195,263
7579,3604539807,3427283336,1672618529,1672621785,3256
7820,3387966152,3559110998,1672626571,1672627421,850
7740,3399004969,3703661585,1672700150,1672701405,1255
7765,3776066388,3791957752,1672554878,1672554946,68
7664,3505962865,3505145247,1672614974,1672618497,3523
7921,3880310724,3760561634,1672532984,1672534659,1675
7860,3817621391,3755872268,1672657283,1672657496,213
7560,3932051427,3361230905,1672591464,1672592319,855
7877,3505219850,3880310724,1672612402,1672615807,3405
7820,3512540951,3711380716,1672570231,1672571313,1082
7612,3713644518,3430504438,1672597587,1672599749,2162
7963,3777936328,3703889596,1672608392,1672611801,3409
7975,3517509185,3396086535,1672624358,1672626374,2016
7768,3667680268,3859663348,1672698770,1672700918,2148
7776,3365614305,3932051427,1672612575,1672613606,1031
7746,3701691675,3776066388,1672656783,1672659635,2852
7732,3779740455,3772309150,1672550010,1672551282,1272
7567,3713644518,3346327502,1672541863,1672542350,487
7883,3899266183,3777936328,1672594972,1672598104,3132
7922,3430352815,3500229033,1672665994,1672667408,1414
7885,3518408774,3496269445,1672610739,1672611327,588
7493,3682061100,3303705369,1672614146,1672614899,753
7655,3800886801,3314245084,1672692381,1672695077,2696
7506,3338703270,3534492426,1672673375,1672676533,3158
7896,3917278625,3559110998,1672546754,1672549106,2352
7969,3819727225,3476232529,1672556636,1672557516,880
7949,3800353779,3889750851,1672563988,1672567510,3522
7945,3513956646,3517864478,1672568564,1672568800,236
7904,3501692334,3510173870,1672551919,1672552251,332
7806,3510703546,3791901535,1672541504,1672544095,2591
7719,3200198928,3519803045,1672613296,1672616813,3517
7483,3311208440,3517963492,1672594297,1672595109,812
7950,3520183192,3434642576,1672603189,1672603985,796
7943,3685187183,3615046771,1672560904,1672562489,1585
7933,3614238812,3776513891,1672534169,1672535134,965
7629,3701184889,3837094550,1672542319,1672545492,3173
7573,3613995936,3519803045,1672542034,1672542702,668
7753,3713808837,3420700674,1672556584,1672558427,1843
7871,3756528686,3737154119,1672532952,1672534812,1860
7827,3902383721,3520931254,1672678429,1672681648,3219
7680,3475258557,3664517356,1672702748,1672705479,2731
7713,3853018906,3791602225,1672623802,1672626540,2738
7561,3559110998,3607748895,1672693312,1672695905,2593
7581,3416265063,3273500349,1672657781,1672659624,1843
7804,3429690204,3832902928,1672667340,1672670501,3161
7935,3344019610,3480687894,1672563759,1672565401,1642
7535,3664170666,3918056059,1672693993,1672696328,2335
7713,3293695955,3505098372,1672700948,1672701612,664
7678,3903962771,3505599848,1672556260,1672557920,1660
7660,3405494240,3367902229,1672570509,1672573699,3190
7882,3688418210,3774195321,1672621171,1672623404,2233
7857,3701995648,3384951177,1672635379,1672636623,1244
7664,3396285984,3606987130,1672668693,1672668878,185
7751,3513599775,3247815299,1672637907,1672639237,1330
7609,3780974443,3249791738,1672698822,1672700291,1469
7655,3780813786,3534313900,1672696467,1672698142,1675
7664,3888559320,3774298222,1672620938,1672623954,3016
7798,3889232789,3757151210,1672632225,1672632733,508
7630,3778108318,3519654779,1672564101,1672564563,462
7925,3416265063,3399004969,1672618249,1672620345,2096
7927,3534488837,3277605882,1672696432,1672697249,817
7513,3757455053,3777936328,1672637262,1672637504,242
7730,3201848640,3517509185,1672677422,1672677813,391
7787,3903962771,3755739653,1672543986,1672544504,518
7791,3756462516,3510857360,1672617407,1672618115,708
7923,3711265369,3716197887,1672581958,1672585315,3357
7775,3777790718,3805292782,1672660675,1672663282,2607
7979,3417061462,3774556560,1672543333,1672544851,1518
7920,3733189298,3918584946,1672648749,1672649608,859
7519,3481647420,3920801189,1672659594,1672662245,2651
7541,3774501422,3500487333,1672668044,1672668167,123
7921,3682061100,3231056870,1672667119,1672670479,3360
7615,3311603601,3351554343,1672581504,1672582440,936
7941,3904775198,3509352754,1672671891,1672675231,3340
7618,3412980697,3807987001,1672572766,1672575442,2676
7487,3505145247,3801089989,1672673344,1672674360,1016
7605,3400804807,3774580701,1672583841,1672585363,1522
7558,3703275621,3520931254,1672592720,1672594792,2072
7839,3783126683,3511170269,1672539636,1672542753,3117
7619,3859525941,3755872268,1672655441,1672657935,2494
7878,3501601840,3886298125,1672592659,1672595462,2803
7525,3793470489,3935627557,1672540801,1672543801,3000
7877,3513599775,3516716179,1672549924,1672551992,2068
7924,3792789881,3224716315,1672624540,1672627437,2897
7551,3773120434,3342131135,1672557350,1672559818,2468
7700,3514283243,3501483568,1672591834,1672594392,2558
7944,3780813786,3500658339,1672617073,1672619619,2546
7802,3500658339,3228165483,1672590155,1672591930,1775
7730,3505873261,3412980697,1672596483,1672598617,2134
7805,3736419952,3517864478,1672660351,1672660825,474
7602,3372883226,3500994774,1672638254,1672640309,2055
7885,3606987130,3466911760,1672684754,1672687779,3025
7775,3855424474,3855000166,1672596007,1672596278,271
7978,3713644518,3533748232,1672567428,1672568396,968
7684,3829232696,3552314511,1672573094,1672575285,2191
7860,3428674539,3505912939,1672659159,1672660608,1449
7880,3710408395,3249247700,1672699821,1672699907,86
7778,3288764520,3713808837,1672696595,1672698072,1477
7525,3505973226,3783206719,1672541931,1672544343,2412
7860,3244485293,3715189301,1672586733,1672588616,1883
7695,3756424865,3933210486,1672666523,1672666797,274
7591,3774195321,3715998609,1672559993,1672561399,1406
7563,3701863557,3500803339,1672657339,1672660104,2765
7554,3932051427,3778266283,1672582128,1672585135,3007
7514,3859525941,3778305740,1672569138,1672571983,2845
7860,3500391167,3520183192,1672583917,1672585373,1456
7604,3778108318,3511841857,1672666557,1672668769,2212
7718,3360743849,3625274012,1672592331,1672595427,3096
7593,3311761694,3773814927,1672643784,1672645655,1871
7713,3757455053,3737079798,1672578703,1672582285,3582
7652,3534492426,3904408902,1672611255,1672611848,593
7651,3303705369,3774010081,1672681182,1672681474,292
7536,3332072298,3737079798,1672586874,1672589787,2913
7685,3316173088,3701065786,1672687677,1672690195,2518
7798,3714474557,3732481297,1672585584,1672587159,1575
7958,3520165601,3533653428,1672647903,1672650412,2509
7882,3976390453,3885897503,1672642496,1672644916,2420
7569,3500060260,3500729955,1672545261,1672546373,1112
7608,3911159965,3514283243,1672658006,1672658687,681
7850,3970117174,3733189298,1672608385,1672611547,3162
7611,3903009525,3925402713,1672617431,1672621030,3599
7539,3772309150,3715981584,1672586521,1672587441,920
7856,3483164654,3774338212,1672701058,1672702058,1000
7881,3710112546,3756451663,1672579220,1672581390,2170
7833,3407673904,3307512479,1672579632,1672581721,2089
7944,3774298222,3533137446,1672695607,1672696353,746
7601,3510857360,3772642849,1672694110,1672695980,1870
7789,3774010081,3520012395,1672535834,1672537059,1225
7854,3608633356,3820354437,1672702286,1672703953,1667
7932,3359239884,3361230905,1672585221,1672587001,1780
7676,3778308417,3432689543,1672562693,1672562990,297
7577,3520183192,3793086311,1672699131,1672701650,2519
7623,3774268456,3972364603,1672693533,1672696886,3353
7881,3711198793,3533385867,1672549603,1672551650,2047
7861,3774045700,3473765852,1672536250,1672538855,2605
7669,3783779671,3378092448,1672531521,1672531699,178
7864,3757682496,3365942576,1672641415,1672643361,1946
7727,3739106581,3500578848,1672607300,1672608740,1440
7817,3518360734,3519428855,1672606002,1672609469,3467
7523,3500229033,3772578994,1672663079,1672665626,2547
7519,3516258476,3610695419,1672687528,1672688725,1197
7619,3510857360,3533653428,1672622230,1672625667,3437
7527,3716273414,3518408774,1672648823,1672650274,1451
7504,3791901535,3713208927,1672545149,1672546766,1617
7735,3909331423,3496051529,1672554015,1672555631,1616
7520,3505362057,3637008488,1672540279,1672541192,913
7763,3453729665,3505873261,1672616323,1672619035,2712
7755,3793871337,3738502357,1672626057,1672627883,1826
7790,3389115045,3319752091,1672642568,1672643765,1197
7884,3458539365,3755436115,1672610085,1672610469,384
7695,3793848402,3517864478,1672654536,1672654616,80
7581,3792883665,3234541252,1672638867,1672639881,1014
7778,3500177712,3978105277,1672590369,1672591505,1136
7575,3827626797,3826415738,1672582491,1672584793,2302
7865,3387674757,3972364603,1672622537,1672626108,3571
7797,3516514391,3779528381,1672533322,1672535670,2348
7515,3389115045,3622054816,1672550397,1672550710,313
7729,3779629905,3505859863,1672577638,1672580059,2421
7715,3891751546,3827222533,1672696641,1672698464,1823
7947,3904775198,3714488548,1672629147,1672631320,2173
7950,3882997884,3716900301,1672583799,1672586213,2414
7549,3666506258,3481502100,1672628386,1672631549,3163
7677,3772544062,3360743849,1672654628,1672658175,3547
7727,3668005723,3777455223,1672642522,1672644977,2455
7717,3903962771,3633420270,1672659840,1672660289,449
7862,3806545488,3774466457,1672625732,1672628075,2343
7638,3424922204,3773120434,1672658239,1672661258,3019
7522,3511198618,3820354437,1672606046,1672607208,1162
7526,3611150562,3379589402,1672699876,1672700592,716
7936,3510969660,3412825109,1672558704,1672562148,3444
7505,3777806071,3209048907,1672655293,1672655771,478
7837,3703871468,3607178184,1672612460,1672615898,3438
7552,3365278081,3616944364,1672633448,1672633553,105
7695,3500066230,3534424200,1672577989,1672581486,3497
7581,3755392666,3534702203,1672645031,1672646626,1595
7582,3511198618,3510126867,1672634538,1672635013,475
7927,3883551721,3666553782,1672659637,1672661339,1702
7686,3637008488,3777776687,1672548846,1672549455,609
7571,3859663348,3500994774,1672639600,1672641300,1700
7846,3511170269,3406784491,1672563172,1672565028,1856
7620,3311718847,3505203158,1672646744,1672649367,2623
7485,3333896808,3774010081,1672665511,1672667791,2280
7707,3505869747,3777806071,1672554109,1672556975,2866
7851,3773664987,3501486692,1672571325,1672573298,1973
7584,3303705369,3364543015,1672700524,1672703144,2620
7594,3509672210,3311761694,1672675995,1672678555,2560
7948,3774010081,3809916577,1672633228,1672634369,1141
7731,3429690204,3851190615,1672626694,1672629468,2774
7956,3780593036,3224058172,1672577584,1672579697,2113
7883,3755436115,3229058858,1672584453,1672586639,2186
7583,3780974443,3289061738,1672651414,1672652705,1291
7548,3519803045,3428964059,1672584156,1672586226,2070
7740,3972709319,3311648200,1672587674,1672588792,1118
7875,3793470489,3851190615,1672675581,1672676305,724
7498,3636867411,3247780536,1672598499,1672599009,510
7974,3755587522,3783083229,1672567195,1672568423,1228
7767,3365614305,3520376528,1672638293,1672641154,2861
7955,3711380716,3533280269,1672550347,1672553698,3351
7929,3378686918,3711571712,1672553433,1672554247,814
7864,3777983879,3937224533,1672653586,1672656520,2934
7610,3855602893,3802367797,1672597703,1672599263,1560
7930,3880310724,3756424865,1672547908,1672550029,2121
7818,3756424865,3664517356,1672599377,1672599644,267
7531,3760509236,3832902928,1672685196,1672688582,3386
7771,3976633198,3701691675,1672606942,1672608542,1600
7803,3931941795,3715974031,1672667945,1672668980,1035
7717,3201432789,3311065516,1672574356,1672574797,441
7901,3514838220,3533810360,1672587089,1672587592,503
7618,3901877072,3772337814,1672675562,1672676004,442
7499,3399433690,3772578994,1672657477,1672659659,2182
7856,3511332835,3770553384,1672662209,1672662569,360
7851,3887270940,3777983879,1672643626,1672645609,1983
7571,3520730271,3206254161,1672553044,1672554763,1719
7717,3231056870,3621810464,1672667062,1672669320,2258
7926,3627937312,3500066230,1672591301,1672591559,258
7529,3976390453,3911245524,1672702665,1672705154,2489
7912,3279721246,3779036831,1672545126,1672548299,3173
7946,3339907603,3516039895,1672605680,1672606412,732
7677,3475795792,3235635976,1672681458,1672684229,2771
7704,3319752091,3895562476,1672703080,1672704899,1819
7843,3515125508,3618045231,1672592675,1672596218,3543
7783,3910454786,3760569731,1672603100,1672606128,3028
7797,3756462516,3236102733,1672632336,1672635848,3512
7509,3883085535,3772746272,1672547587,1672549757,2170
7622,3511271692,3367902229,1672588882,1672591195,2313
7671,3337544549,3505000737,1672564434,1672566823,2389
7596,3855000166,3902383721,1672615106,1672616316,1210
7743,3311415018,3520719611,1672605807,1672607019,1212
7669,3289061738,3365614305,1672688884,1672690135,1251
7676,3815508790,3770447408,1672599308,1672599821,513
7764,3311627628,3518791447,1672699747,1672702322,2575
7829,3791334389,3711569060,1672630866,1672631063,197
7882,3805292782,3505635228,1672538091,1672539635,1544
7658,3701967560,3826415738,1672669379,1672672332,2953
7854,3516223597,3783925755,1672687380,1672689208,1828
7513,3277669002,3312829208,1672532394,1672535825,3431
7849,3373384732,3615046771,1672590323,1672593869,3546
7714,3418534998,3773120434,1672598011,1672598935,924
7721,3783206719,3311871871,1672671115,1672671422,307
7567,3510380060,3208844525,1672690750,1672693286,2536
7792,3465254146,3757151210,1672595185,1672598567,3382
7780,3780294829,3735733948,1672545546,1672546175,629
7504,3859525941,3937224533,1672586885,1672587101,216
7678,3485823740,3911159965,1672558089,1672558666,577
7578,3418728074,3617055293,1672582443,1672582504,61
7488,3777477395,3736790081,1672627228,1672628763,1535
7933,3756453423,3916289176,1672689995,1672690532,537
7849,3902278226,3715981584,1672562329,1672564482,2153
7707,3515723720,3512837326,1672632586,1672636131,3545
7486,3770021824,3307512479,1672674772,1672676964,2192
7904,3793389510,3617055293,1672666818,1672670315,3497
7812,3516716179,3515125508,1672630479,1672633344,2865
7965,3779629905,3433804879,1672660097,1672663096,2999
7914,3777776687,3379589402,1672593908,1672597486,3578
7879,3731106822,3791874383,1672565930,1672569498,3568
7722,3716168623,3420700674,1672566552,1672568806,2254
7833,3559110998,3302626661,1672671383,1672673392,2009
7678,3791334389,3512540951,1672698789,1672701932,3143
7598,3427283336,3713808837,1672589678,1672590030,352
7822,3783705817,3628819436,1672662945,1672665361,2416
7867,3514987389,3778266283,1672617145,1672619737,2592
7954,3760294205,3713630656,1672657273,1672658137,864
7670,3552314511,3500894271,1672542073,1672545169,3096
7804,3832902928,3757682496,1672668042,1672668701,659
7567,3520931254,3534702203,1672553173,1672555012,1839
7871,3517864478,3227158514,1672691582,1672692585,1003
7589,3247780536,3701146057,1672541711,1672541795,84
7665,3637008488,3516909237,1672644182,1672644365,183
7524,3791874383,3533193862,1672542274,1672542807,533
7963,3615046771,3221536550,1672614802,1672616736,1934
7610,3420700674,3779036831,1672695697,1672699173,3476
7797,3826633236,3516716179,1672625846,1672628672,2826
7525,3511267139,3517864478,1672533082,1672535132,2050
7582,3399911573,3756021689,1672597399,1672597833,434
7602,3511862351,3500658339,1672592003,1672594074,2071
7860,3756966035,3773465237,1672600728,1672603287,2559
7610,3713208927,3505635228,1672642597,1672646096,3499
7595,3500578848,3466229085,1672577492,1672578534,1042
7952,3615046771,3416241005,1672544471,1672546068,1597
7659,3533385867,3550946908,1672558660,1672561772,3112
7742,3774119563,3360506772,1672686364,1672689669,3305
7837,3496549058,3505912939,1672570947,1672572057,1110
7852,3826633236,3518669703,1672687295,1672689914,2619
7923,3774010081,3739106581,1672649984,1672651893,1909
7742,3621497531,3520730271,1672617928,1672619189,1261
7570,3415546117,3791334389,1672703659,1672705887,2228
7666,3342131135,3626156564,1672581743,1672583509,1766
7897,3480687894,3500904641,1672689820,1672691348,1528
7651,3783531004,3716488385,1672636841,1672638183,1342
7935,3365942576,3511198618,1672603540,1672605611,2071
7494,3774045700,3471220483,1672570320,1672571267,947
7656,3473765852,3411618230,1672641787,1672644509,2722
7698,3755511676,3791942683,1672558867,1672560810,1943
7571,3533927138,3937224533,1672610911,1672613495,2584
7687,3922275416,3409474775,1672656042,1672657166,1124
7862,3701995648,3734496778,1672642645,1672643283,638
7629,3756462516,3505638204,1672597197,1672598555,1358
7584,3634995491,3312829208,1672600352,1672603273,2921
7555,3514472925,3714474557,1672606231,1672606562,331
7734,3770824086,3737079798,1672675010,1672677911,2901
7638,3509604974,3882291183,1672682007,1672685360,3353
7803,3757161914,3276640712,1672557016,1672557707,691
7846,3713894336,3735733948,1672668574,1672670702,2128
7814,3791957752,3500066230,1672656072,1672658796,2724
7924,3716835696,3826760240,1672645644,1672648430,2786
7786,3505912939,3378436155,1672681552,1672682087,535
7852,3428964059,3232962003,1672576789,1672577399,610
7867,3400804807,3293695955,1672659984,1672661224,1240
7836,3910454786,3881477378,1672693856,1672697415,3559
7863,3489545239,3715189301,1672697270,1672700007,2737
7808,3793436995,3505193212,1672587371,1672589508,2137
7617,3534191820,3737079798,1672672933,1672674037,1104
7529,3400804807,3783083229,1672589889,1672590110,221
7771,3505859863,3510594211,1672555282,1672556064,782
7696,3483164654,3488244966,1672624647,1672627644,2997
7527,3792384220,3249791738,1672655390,1672656732,1342
7972,3516980378,3889232789,1672584714,1672587114,2400
7706,3634995491,3385763781,1672675053,1672675249,196
7710,3533371364,3627937312,1672533890,1672537382,3492
7831,3858918246,3937224533,1672583223,1672584291,1068
7622,3770447408,3287105466,1672702214,1672705782,3568
7805,3668898102,3454042520,1672551679,1672552759,1080
7558,3901877072,3774339795,1672537154,1672540691,3537
7921,3774195321,3772884106,1672538460,1672541571,3111
7904,3518791447,3515860749,1672622805,1672625256,2451
7933,3793338102,3932051427,1672560577,1672561697,1120
7717,3511687358,3505201246,1672572720,1672575860,3140
7772,3777776687,3916289176,1672568185,1672570141,1956
7882,3209027249,3209027249,1672677327,1672677713,386
7779,3773814927,3711571712,1672557120,1672558612,1492
7794,3513599775,3778108318,1672683085,1672684715,1630
7498,3757447189,3407725581,1672583780,1672586611,2831
7622,3792288302,3244173074,1672593428,1672594933,1505
7863,3733189298,3783531004,1672561949,1672564598,2649
7626,3505098372,3362000049,1672656806,1672657684,878
7524,3501483568,3827222533,1672560714,1672562430,1716
7802,3297463265,3510173870,1672645426,1672648604,3178
7975,3710112546,3510969660,1672561629,1672564127,2498
7916,3509453566,3351008918,1672545509,1672545921,412
7949,3777983879,3916289176,1672648377,1672649746,1369
7490,3311648200,3388286531,1672546527,1672549965,3438
7605,3511267139,3889232789,1672646481,1672649326,2845
7504,3201848640,3883085535,1672543973,1672546617,2644
7719,3222521619,3505635228,1672687894,1672690700,2806
7850,3387674757,3505912939,1672554616,1672557014,2398
7718,3418534998,3391915121,1672546545,1672546798,253
7761,3206254161,3418728074,1672684944,1672687361,2417
7515,3249247700,3517459919,1672589438,1672589644,206
7965,3756966035,3223789409,1672655727,1672659142,3415
7792,3367029997,3334033993,1672541243,1672542143,900
7770,3780828689,3501184421,1672678063,1672679116,1053
7649,3711504540,3519069599,1672542248,1672545811,3563
7913,3311439795,3519654779,1672667923,1672670335,2412
7532,3755587522,3351008918,1672583254,1672585850,2596
7930,3922337974,3793389510,1672565041,1672565744,703
7632,3918674986,3369998498,1672569341,1672570102,761
7608,3276993580,3280964728,1672560373,1672563497,3124
7658,3783925755,3520183192,1672549312,1672551731,2419
7891,3516629436,3520376528,1672579717,1672582384,2667
7723,3432665384,3772359096,1672539716,1672543112,3396
7967,3809059934,3713630656,1672639224,1672641827,2603
7638,3828624701,3710112546,1672683438,1672685045,1607
7803,3757447189,3760492950,1672680431,1672683929,3498
7810,3925402713,3201432789,1672601615,1672604172,2557
7748,3889750851,3397418363,1672548443,1672549493,1050
7900,3755392666,3277605882,1672671842,1672675323,3481
7737,3715998609,3614238812,1672579398,1672582123,2725
7873,3852595551,3760509236,1672562362,1672564129,1767
7749,3247815299,3244436890,1672629795,1672631080,1285
7581,3935127663,3713786889,1672548427,1672549747,1320
7720,3776066388,3920801189,1672569113,1672572024,2911
7742,3298433163,3792288302,1672615157,1672616363,1206
7766,3559110998,3608633356,1672556714,1672557914,1200
7903,3510857360,3711571712,1672623877,1672624994,1117
7612,3772309150,3604539807,1672552957,1672553670,713
7735,3313541986,3791874383,1672635477,1672639043,3566
7763,3516011407,3489728806,1672671700,1672674411,2711
7579,3899266183,3756021689,1672546218,1672547947,1729
7973,3344019610,3912536808,1672565877,1672566561,684
7709,3556951786,3772544062,1672683842,1672685888,2046
7681,3634995491,3783245561,1672656653,1672660104,3451
7539,3714474557,3859663348,1672596849,1672600187,3338
7640,3756623396,3338367113,1672595787,1672597332,1545
7645,3834257412,3514987389,1672675570,1672678319,2749
7719,3291227780,3520165601,1672671724,1672674703,2979
7534,3220716272,3311090974,1672697953,1672699820,1867
7604,3777776687,3711571712,1672686143,1672689517,3374
7596,3501198706,3825229501,1672583667,1672586140,2473
7580,3416241005,3534729133,1672545341,1672545675,334
7662,3517963492,3633420270,1672595914,1672599331,3417
7646,3448855696,3517509185,1672690560,1672693675,3115
7801,3244173074,3416427576,1672554922,1672555022,100
7843,3489545239,3501486692,1672625330,1672628897,3567
7754,3515691540,3427283336,1672544857,1672547434,2577
7592,3922337974,3901877072,1672621329,1672622861,1532
7832,3736592744,3476232529,1672588199,1672588570,371
7863,3519601612,3533369198,1672577939,1672580152,2213
7738,3774466457,3297463265,1672613513,1672614062,549
7934,3280964728,3601879040,1672541779,1672545124,3345
7668,3365278081,3911159965,1672550490,1672551348,858
7812,3319752091,3772309166,1672662896,1672663469,573
7600,3497901842,3206254161,1672571990,1672573897,1907
7726,3834257412,3501927421,1672537571,1672538164,593
7535,3605726278,3362000049,1672557119,1672557743,624
7856,3755881905,3518932404,1672582810,1672585659,2849
7809,3515151980,3369998498,1672567313,1672568582,1269
7694,3519700826,3778549126,1672667186,1672670405,3219
7818,3760492950,3757562897,1672650810,1672653780,2970
7646,3518014404,3903307060,1672643369,1672644676,1307
7706,3757161914,3459030804,1672608779,1672609836,1057
7879,3885897503,3509604974,1672558504,1672561643,3139
7632,3925620998,3783245561,1672560587,1672560846,259
7556,3757403279,3418534998,1672634082,1672635198,1116
7779,3918584946,3710112546,1672701018,1672702898,1880
7695,3510126867,3737154119,1672656797,1672659865,3068
7655,3756528686,3887270940,1672658173,1672658412,239
7753,3889750851,3736592744,1672660366,1672662493,2127
7643,3513454145,3901990690,1672600491,1672601337,846
7731,3520751702,3910886626,1672687974,1672690378,2404
7723,3629935998,3827626797,1672661808,1672661996,188
7572,3931941795,3809916577,1672577200,1672580542,3342
7958,3772714862,3733189298,1672693986,1672694180,194
7559,3855424474,3809059934,1672634124,1672635047,923
7547,3500487333,3509773875,1672658810,1672660764,1954
7582,3818255890,3511862351,1672536556,1672538296,1740
7971,3976633198,3446948848,1672577477,1672578306,829
7950,3209551760,3200198928,1672573481,1672575491,2010
7585,3808324264,3610348516,1672631105,1672632135,1030
7785,3760077057,3611150562,1672693383,1672695291,1908
7899,3793338102,3833889105,1672666317,1672669398,3081
7582,3472130842,3832902928,1672559303,1672561570,2267
7929,3516016437,3627937312,1672605770,1672606011,241
7699,3477649378,3519654779,1672635622,1672636044,422
7633,3511267139,3515284591,1672598463,1672601126,2663
7896,3514245078,3206603608,1672688943,1672689154,211
7709,3920801189,3303751772,1672691804,1672694039,2235
7940,3826760240,3372883226,1672568480,1672569986,1506
7536,3970117174,3516039895,1672570626,1672570898,272
7530,3517476351,3714197325,1672675276,1672678128,2852
7901,3760077057,3512349371,1672678263,1672680216,1953
7511,3304625412,3505912939,1672653606,1672653949,343
7776,3277605882,3428674539,1672677803,1672679192,1389
7903,3778980116,3909331423,1672668481,1672671721,3240
7620,3792902982,3416265063,1672684230,1672685339,1109
7978,3778308417,3792253549,1672563023,1672564242,1219
7826,3883551721,3978105277,1672560975,1672563013,2038
7767,3777776687,3365278081,1672541133,1672541318,185
7795,3517963492,3500487333,1672615990,1672618827,2837
7783,3227158514,3303751772,1672634917,1672635505,588
7809,3911245524,3234541252,1672568274,1672570738,2464
7933,3710112546,3793959750,1672603996,1672604267,271
7510,3222521619,3430504438,1672696868,1672697306,438
7973,3405494240,3519654779,1672598952,1672601191,2239
7743,3922275620,3605726278,1672666157,1672667235,1078
7644,3903962771,3235635976,1672575064,1672578027,2963
7823,3737051610,3662180254,1672584854,1672586095,1241
7525,3338367113,3624761861,1672689052,1672689163,111
7810,3902278226,3889750851,1672597132,1672600332,3200
7675,3421836608,3318166135,1672561527,1672563764,2237
7967,3312333615,3512540951,1672662433,1672663579,1146
7757,3277939457,3791997875,1672637228,1672638772,1544
7578,3361230905,3733189298,1672641734,1672642575,841
7598,3248507722,3501730685,1672692653,1672693948,1295
7582,3420432297,3909238838,1672697423,1672697587,164
7656,3501955238,3500894271,1672570999,1672573405,2406
7816,3288764520,3344364444,1672582538,1672582960,422
7837,3533242305,3236102733,1672562247,1672565112,2865
7735,3280964728,3391915886,1672608844,1672611010,2166
7948,3780365428,3666457294,1672555780,1672557384,1604
7743,3428964059,3512166013,1672658396,1672658925,529
7775,3487171044,3227158514,1672679346,1672682156,2810
7551,3221899927,3515125508,1672578630,1672581799,3169
7935,3912262917,3783083229,1672582062,1672582278,216
7780,3505347134,3858918246,1672539245,1672541294,2049
7946,3337544549,3516258476,1672553854,1672557205,3351
7492,3520030713,3338367113,1672642928,1672645403,2475
7845,3515723720,3399004969,1672689260,1672690918,1658
7870,3519700826,3380035798,1672605498,1672606209,711
7826,3519601612,3501606184,1672559126,1672560357,1231
7638,3606987130,3505791599,1672631796,1672635205,3409
7829,3518163778,3791657947,1672666658,1672667790,1132
7914,3304056063,3714504419,1672684690,1672688185,3495
7705,3513454145,3509672210,1672545497,1672547985,2488
7934,3399004969,3776513891,1672576739,1672579696,2957
7575,3839849341,3500994774,1672611827,1672612780,953
7560,3515860749,3909331423,1672682722,1672684265,1543
7534,3791553060,3407725581,1672541100,1672541227,127
7544,3917088658,3756601594,1672559043,1672559401,358
7922,3772714862,3716258994,1672623856,1672625563,1707
7731,3774338212,3716197887,1672659309,1672659480,171
7894,3533242305,3454042520,1672643092,1672645849,2757
7889,3710344260,3501364586,1672558806,1672560576,1770
7550,3505292701,3711504540,1672610201,1672611170,969
7861,3534488837,3770635361,1672569841,1672570922,1081
7798,3792384220,3774127586,1672540359,1672543053,2694
7904,3780365428,3791115967,1672594599,1672595880,1281
7575,3201324715,3286658957,1672698058,1672698969,911
7895,3433804879,3774580701,1672595253,1672598436,3183
7643,3533193862,3276640712,1672673937,1672677330,3393
7794,3517721725,3416427576,1672578514,1672581912,3398
7917,3417061462,3505477652,1672682998,1672686064,3066
7745,3505702787,3512540951,1672588297,1672591317,3020
7812,3412825109,3757812939,1672650661,1672653550,2889
7496,3346795719,3772309150,1672607807,1672608640,833
7780,3778308417,3518163778,1672672919,1672675323,2404
7754,3401627165,3639847263,1672644574,1672646461,1887
7662,3793848402,3779976989,1672696252,1672697222,970
7820,3736790081,3713630656,1672608975,1672610476,1501
7662,3516960534,3514128943,1672563096,1672566050,2954
7776,3829232696,3770447408,1672619861,1672623218,3357
7552,3610348516,3412980697,1672698024,1672701004,2980
7908,3835382117,3485375593,1672547020,1672549671,2651
7535,3510937904,3634786711,1672695796,1672696507,711
7770,3903962771,3774119563,1672545139,1672547099,1960
7979,3473562469,3716835696,1672622771,1672624188,1417
7744,3713969578,3736229191,1672577790,1672580212,2422
7923,3534488837,3394330287,1672655402,1672655684,282
7641,3483949762,3734496778,1672662801,1672663412,611
7755,3793962300,3294803686,1672671212,1672674610,3398
7752,3851190615,3374559242,1672633642,1672635574,1932
7828,3791602225,3818255890,1672608445,1672609241,796
7983,3519654779,3756528686,1672533706,1672533945,239
7872,3516514391,3703955926,1672607760,1672610155,2395
7640,3711262377,3318697153,1672545742,1672548641,2899
7729,3202120784,3518932404,1672543001,1672543277,276
7594,3780609808,3715974031,1672562055,1672564166,2111
7587,3505219850,3793436995,1672673278,1672676127,2849
7511,3429690204,3778549126,1672680734,1672681228,494
7570,3616944364,3520190170,1672661070,1672664594,3524
7705,3855424474,3885897503,1672542567,1672542714,147
7871,3887270940,3664170666,1672643003,1672646167,3164
7629,3755511676,3806545488,1672553230,1672555386,2156
7902,3710098970,3359239884,1672634629,1672637974,3345
7860,3909331423,3628819436,1672537950,1672538492,542
7586,3303705369,3780593036,1672613099,1672613177,78
7742,3209383861,3510857360,1672563798,1672565576,1778
7587,3772714862,3774050956,1672647792,1672649385,1593
7759,3978115672,3891751546,1672677220,1672677415,195
7969,3311718847,3501927421,1672695239,1672696280,1041
7914,3809059934,3477649378,1672605932,1672606358,426
7507,3511198618,3505193212,1672691663,1672692081,418
7592,3899204805,3533025282,1672534516,1672537574,3058
7485,3772309166,3756623396,1672640840,1672643755,2915
7652,3792032359,3629935998,1672668505,1672669065,560
7653,3208844525,3510247121,1672686604,1672686723,119
7836,3733891182,3234541252,1672559788,1672562235,2447
7677,3516514391,3909238838,1672700860,1672701840,980
7931,3823600322,3511198618,1672534917,1672535032,115
7764,3534313900,3826760240,1672578750,1672580248,1498
7593,3500060260,3316173088,1672672253,1672675425,3172
7523,3516629436,3505362057,1672695248,1672696731,1483
7883,3970117174,3813052709,1672545561,1672548791,3230
7971,3501483568,3773429448,1672561921,1672565140,3219
7544,3559110998,3815508790,1672586068,1672588105,2037
7622,3483164654,3518876135,1672614552,1672617510,2958
7831,3236102733,3772746272,1672542737,1672544473,1736
7964,3246596716,3500578848,1672553370,1672554363,993
7531,3428674539,3487171044,1672645572,1672648464,2892
7686,3780788622,3518932404,1672603647,1672606224,2577
7725,3473562469,3312829208,1672606377,1672607532,1155
7883,3511862351,3438645253,1672679784,1672682701,2917
7651,3600647945,3918584946,1672687998,1672688399,401
7660,3505201246,3505219850,1672599750,1672601483,1733
7830,3278365525,3922275620,1672607384,1672610954,3570
7596,3770763956,3760561634,1672557353,1672558380,1027
7962,3734828619,3520629279,1672582803,1672585865,3062
7684,3209027249,3304625412,1672613508,1672615593,2085
7759,3505477652,3209048907,1672688165,1672689655,1490
7642,3453729665,3688418210,1672544644,1672546770,2126
7591,3380035798,3890149705,1672694496,1672694862,366
7763,3500177712,3755587522,1672622630,1672625048,2418
7955,3791957752,3501483568,1672606404,1672609585,3181
7946,3228165483,3511198618,1672688477,1672690796,2319
7898,3899266183,3774366875,1672591187,1672593582,2395
7562,3777936328,3513454145,1672545590,1672547720,2130
7974,3731106822,3688683847,1672646968,1672649475,2507
7921,3773978034,3836573197,1672690877,1672692706,1829
7808,3667680268,3755798867,1672614832,1672617468,2636
7620,3778980116,3242408357,1672542286,1672543690,1404
7665,3774127586,3855000166,1672570280,1672570362,82
7980,3500458761,3513599775,1672634893,1672636593,1700
7824,3701691675,3505873261,1672628712,1672630275,1563
7780,3200691026,3277939457,1672548322,1672548817,495
7541,3501955238,3711262377,1672660510,1672663073,2563
7650,3883085535,3902383721,1672623694,1672624057,363
7968,3473562469,3277669002,1672677174,1672680382,3208
7723,3465202715,3520206212,1672604197,1672607348,3151
7555,3778308417,3234362962,1672610560,1672611282,722
7939,3533927138,3311993075,1672690172,1672690601,429
7878,3500199935,3916289176,1672647174,1672648761,1587
7526,3421127249,3534313900,1672702742,1672702836,94
7641,3634995491,3910886626,1672535753,1672535814,61
7723,3202120784,3246596716,1672600792,1672603058,2266
7862,3489217083,3772309166,1672641149,1672644206,3057
7878,3703889596,3519428855,1672646411,1672648045,1634
7785,3817621391,3512683609,1672547665,1672551237,3572
7501,3301107849,3271938399,1672683949,1672684247,298
7585,3776800213,3859663348,1672582936,1672584715,1779
7742,3664170666,3716900301,1672688156,1672691610,3454
7658,3505000737,3517721725,1672560702,1672562263,1561
7973,3360993964,3518014636,1672598686,1672600660,1974
7771,3517963492,3703223015,1672679171,1672681001,1830
7621,3394539273,3783196518,1672693968,1672696117,2149
7748,3777936328,3475795792,1672588218,1672590693,2475
7849,3901990690,3738502357,1672645479,1672647626,2147
7982,3404384505,3428964059,1672545333,1672545679,346
7827,3772714862,3388372715,1672549705,1672549849,144
7896,3935627557,3772544062,1672678070,1672679593,1523
7897,3517864478,3618873142,1672621514,1672621902,388
7483,3516980378,3372883226,1672546840,1672547966,1126
7944,3885670556,3338703270,1672683494,1672685247,1753
7578,3774793839,3715492942,1672593107,1672594111,1004
7674,3220716272,3319752091,1672661458,1672662009,551
7660,3513956646,3512720680,1672651110,1672653346,2236
7550,3520629279,3703871468,1672678262,1672680436,2174
7938,3829232696,3783239924,1672544194,1672545277,1083
7728,3703871468,3756930948,1672632827,1672633306,479
7735,3776800213,3298433163,1672652063,1672654429,2366
7701,3505530961,3510380060,1672549976,1672552000,2024
7705,3792883665,3703223015,1672584306,1672584647,341
7687,3811171116,3618045231,1672630852,1672631724,872
7765,3516016437,3976390453,1672663646,1672665273,1627
7605,3826415738,3713349754,1672663239,1672663660,421
7654,3859525941,3244173074,1672682767,1672686161,3394
7962,3826759140,3816454165,1672680044,1672683140,3096
7620,3816853177,3917278625,1672546878,1672549907,3029
7970,3713894336,3730517636,1672541256,1672543911,2655
7946,3628819436,3780593036,1672577161,1672578281,1120
7645,3779036831,3500487333,1672593115,1672594852,1737
7736,3773465237,3352603894,1672533269,1672535267,1998
7539,3770021824,3404058699,1672583388,1672586196,2808
7731,3510703546,3505530961,1672604556,1672608108,3552
7587,3716843669,3615046771,1672628052,1672629501,1449
7823,3500199935,3774298222,1672623630,1672625358,1728
7886,3359239884,3701274634,1672645643,1672646112,469
7843,3755872268,3629547065,1672630000,1672630224,224
7927,3236102733,3276993580,1672642239,1672644963,2724
7718,3418728074,3510703546,1672538502,1672539076,574
7493,3703789494,3534702203,1672603968,1672605014,1046
7935,3505173328,3772578994,1672532423,1672533323,900
7827,3889232789,3223968713,1672685581,1672687748,2167
7950,3776066388,3313564074,1672694960,1672697306,2346
7709,3466911760,3637008488,1672657312,1672657934,622
7721,3284832486,3430504438,1672607413,1672611006,3593
7829,3465202715,3277939457,1672559470,1672560867,1397
7692,3412825109,3618045231,1672651098,1672652862,1764
7497,3510771358,3756424865,1672532320,1672535373,3053
7751,3776338577,3778341199,1672675275,1672677801,2526
7509,3917088658,3703661585,1672598161,1672599764,1603
7787,3517864478,3634995491,1672652009,1672653973,1964
7726,3903307060,3895562476,1672561455,1672561957,502
7855,3922275620,3822654369,1672562380,1672563588,1208
7819,3636867411,3338367113,1672557351,1672557882,531
7804,3338703270,3510857360,1672683408,1672683970,562
7501,3755739653,3937224533,1672596690,1672600065,3375
7816,3429856982,3777790718,1672630982,1672634242,3260
7867,3520709480,3777929708,1672683217,1672686405,3188
7606,3604539807,3716168623,1672685341,1672688502,3161
7628,3284832486,3780639480,1672697872,1672698895,1023
7853,3520706195,3772053179,1672634331,1672637921,3590
7851,3825229501,3377766165,1672691740,1672693678,1938
7714,3388637594,3420700674,1672562221,1672563509,1288
7847,3811694763,3515151980,1672536766,1672539565,2799
7779,3634340855,3364543015,1672692192,1672693399,1207
7955,3710408395,3505859863,1672551749,1672551810,61
7897,3760267716,3903009525,1672546371,1672547420,1049
7757,3713969578,3206593906,1672606306,1672609168,2862
7912,3351008918,3246596716,1672556436,1672559410,2974
7648,3556951786,3520706195,1672685341,1672686952,1611
7649,3882242815,3294803686,1672615038,1672615345,307
7928,3555214688,3516606733,1672678047,1672679586,1539
7733,3882997884,3555214688,1672556381,1672556943,562
7542,3737051610,3400804807,1672611490,1672612195,705
7551,3510857360,3407673904,1672535556,1672536400,844
7726,3701190899,3859525941,1672652827,1672655910,3083
7724,3711198793,3516960534,1672700736,1672704293,3557
7665,3701995648,3770824086,1672554046,1672557406,3360
7727,3520931254,3533626375,1672554795,1672558066,3271
7690,3311324983,3346327502,1672693740,1672694701,961
7566,3783531004,3533025282,1672604158,1672606774,2616
7505,3976633198,3505000737,1672571815,1672572017,202
7916,3783245561,3316222192,1672607601,1672609271,1670
7875,3756027749,3512510536,1672587738,1672589364,1626
7781,3500487333,3338703270,1672656787,1672659069,2282
7659,3772309150,3909238838,1672678972,1672679314,342
7972,3664517356,3791594391,1672608218,1672611161,2943
7769,3703871468,3365830990,1672572362,1672574965,2603
7901,3617055293,3778780511,1672597830,1672601403,3573
7943,3372883226,3774010081,1672692507,1672693985,1478
7500,3311065516,3701065786,1672636750,1672639827,3077
7506,3774556560,3757812939,1672612748,1672615847,3099
7586,3473765852,3224716315,1672540748,1672542448,1700
7569,3509773875,3500374658,1672616183,1672619726,3543
7881,3772714862,3280599164,1672685458,1672688191,2733
7651,3760267716,3770553384,1672701904,1672703889,1985
7565,3518496488,3302626661,1672560348,1672563448,3100
7975,3234362962,3512683609,1672572792,1672573653,861
7885,3802367797,3533371364,1672681144,1672682774,1630
7566,3311648200,3909606423,1672689768,1672690697,929
7916,3556951786,3520012395,1672647866,1672648951,1085
7940,3783083229,3209048907,1672549536,1672552839,3303
7765,3416427576,3853018906,1672587894,1672591476,3582
7743,3534553510,3883085535,1672540398,1672543502,3104
7552,3779528381,3777120536,1672698780,1672700936,2156
7943,3701498253,3291235378,1672543610,1672546509,2899
7896,3505098372,3200198928,1672672539,1672675711,3172
7727,3378436155,3701190899,1672551736,1672552248,512
7697,3488244966,3703955926,1672670512,1672673330,2818
7931,3505362057,3639847263,1672662839,1672663046,207
7872,3370752401,3319752091,1672700228,1672703193,2965
7631,3734496778,3703223015,1672554420,1672556677,2257
7731,3922275620,3515394721,1672589802,1672592076,2274
7770,3881477378,3512720680,1672653658,1672656270,2612
7880,3792288302,3387674757,1672631137,1672633504,2367
7547,3505859863,3922275620,1672609784,1672610968,1184
7715,3731419510,3802367797,1672680425,1672682046,1621
7630,3296471982,3779218771,1672608612,1672610149,1537
7683,3818255890,3970117174,1672605870,1672608415,2545
7484,3296471982,3793871337,1672630924,1672632629,1705
7663,3227158514,3284639858,1672610836,1672611104,268
7833,3311871871,3703275621,1672628627,1672629351,724
7617,3418534998,3793286136,1672703330,1672705017,1687
7593,3634786711,3738502357,1672684911,1672687142,2231
7714,3925620998,3715974031,1672544850,1672545611,761
7518,3760992710,3534191820,1672586569,1672589747,3178
7494,3711569060,3533025282,1672553039,1672554752,1713
7947,3833889105,3792177074,1672660538,1672662544,2006
7697,3505362057,3271938399,1672636508,1672638245,1737
7522,3774339795,3792473331,1672641018,1672644564,3546
7734,3793753089,3791602225,1672660593,1672661448,855
7675,3791553060,3887270940,1672556902,1672559185,2283
7682,3518163778,3774010081,1672657656,1672658585,929
7702,3734737881,3792883665,1672594989,1672595381,392
7536,3668898102,3714821932,1672559327,1672562684,3357
7607,3667680268,3501692334,1672640578,1672640944,366
7667,3509352754,3500994774,1672669770,1672670472,702
7904,3716165213,3703661585,1672587617,1672590256,2639
7730,3909331423,3401627165,1672668926,1672671716,2790
7610,3417970574,3773205565,1672551790,1672555052,3262
7887,3480687894,3757682496,1672534781,1672537850,3069
7516,3770553384,3298288268,1672677767,1672680927,3160
7918,3511862351,3611150562,1672588606,1672591510,2904
7490,3475795792,3222448362,1672645222,1672645706,484
7535,3518791447,3639847263,1672694404,1672695139,735
7570,3883312122,3418728074,1672559734,1672560564,830
7665,3311154569,3505173328,1672607434,1672609368,1934
7639,3500391167,3755739653,1672676388,1672678920,2532
7705,3515723720,3433804879,1672624570,1672627893,3323
7941,3711262377,3412825109,1672699154,1672700341,1187
7604,3711265369,3505973226,1672571887,1672574303,2416
7660,3466229085,3227158514,1672614915,1672616505,1590
7959,3514245078,3805347939,1672641084,1672644627,3543
7571,3249247700,3428964059,1672607257,1672609054,1797
7528,3773664987,3716258994,1672563026,1672566375,3349
7584,3285400528,3516465662,1672542980,1672545718,2738
7809,3792844210,3760492950,1672533381,1672534138,757
7894,3458539365,3501601840,1672534049,1672536545,2496
7529,3360743849,3899266183,1672664179,1672667494,3315
7553,3924549929,3666507626,1672651277,1672654485,3208
7836,3760294205,3387966152,1672695010,1672696627,1617
7710,3466911760,3701984666,1672698814,1672699292,478
7576,3606186086,3701995648,1672566983,1672568990,2007
7619,3713268590,3519803045,1672612843,1672614101,1258
7795,3505530961,3805519285,1672573073,1672576490,3417
7680,3773814927,3778780511,1672701006,1672701109,103
7831,3701691675,3809484172,1672562503,1672565779,3276
7645,3533385867,3404058699,1672599203,1672599304,101
7726,3770763956,3783206719,1672595875,1672598437,2562
7891,3713786889,3511170269,1672614989,1672615793,804
7836,3882997884,3550946908,1672658035,1672661215,3180
7745,3374559242,3778341199,1672599718,1672601807,2089
7836,3791901535,3774268456,1672669924,1672672910,2986
7762,3518496488,3519912874,1672663415,1672665172,1757
7938,3662180254,3208844525,1672543424,1672544817,1393
7552,3465202715,3387966152,1672547481,1672549628,2147
7903,3500658339,3291883916,1672690087,1672690236,149
7495,3701498253,3736625083,1672542800,1672544237,1437
7725,3835382117,3500805881,1672608980,1672611448,2468
7807,3505530961,3516980378,1672533149,1672535591,2442
7678,3613683164,3471220483,1672701501,1672702384,883
7507,3685818092,3554917400,1672695062,1672698411,3349
7539,3533137446,3711571712,1672536501,1672539482,2981
7543,3783239924,3244389794,1672696293,1672697659,1366
7823,3777776687,3505904952,1672687938,1672688338,400
7686,3518014404,3520931254,1672541099,1672544456,3357
7750,3500578848,3510771358,1672613207,1672616168,2961
7745,3223968713,3224058172,1672659314,1672660560,1246
7693,3417970574,3735319397,1672597314,1672598582,1268
7713,3618045231,3409474775,1672682354,1672683684,1330
7759,3311090974,3509672210,1672573767,1672575224,1457
7705,3780828689,3895562476,1672676501,1672679605,3104
7896,3234362962,3516606733,1672639976,1672641801,1825
7883,3909331423,3737154119,1672660199,1672660313,114
7854,3294803686,3791957752,1672558945,1672560733,1788
7632,3703275621,3624761861,1672620140,1672620853,713
7878,3399052055,3828365570,1672583050,1672586250,3200
7844,3716746253,3683766533,1672662737,1672665056,2319
7857,3316173088,3634340855,1672607713,1672608163,450
7506,3466911760,3760267716,1672611259,1672611918,659
7906,3311274543,3710569131,1672556899,1672560227,3328
7658,3791020967,3809916577,1672676252,1672677521,1269
7506,3701898991,3777936328,1672536641,1672539596,2955
7556,3313564074,3715974031,1672561192,1672563262,2070
7819,3303751772,3416265063,1672644530,1672646990,2460
7521,3391915121,3396285984,1672542088,1672542492,404
7649,3738274418,3313541986,1672597931,1672598689,758
7743,3792177074,3407954858,1672683685,1672684085,400
7682,3811171116,3428964059,1672543424,1672546589,3165
7934,3509907947,3777929708,1672585922,1672586949,1027
7937,3760992710,3512720680,1672641905,1672643618,1713
7643,3518014404,3284832486,1672662497,1672664599,2102
7805,3438645253,3624761861,1672612926,1672614200,1274
7742,3512217942,3448855696,1672671044,1672673001,1957
7518,3513454145,3399433690,1672601879,1672603691,1812
7588,3517721725,3772309166,1672591464,1672594096,2632
7914,3511163800,3805347939,1672597588,1672598595,1007
7486,3412980697,3307097200,1672600801,1672603509,2708
7642,3378092448,3622054816,1672542035,1672543673,1638
7565,3344019610,3303751772,1672604291,1672606584,2293
7483,3772884106,3505347134,1672639961,1672640083,122
7913,3338703270,3703789494,1672655697,1672658813,3116
7981,3312333615,3710569131,1672553498,1672555545,2047
7570,3772746272,3426325549,1672609659,1672610977,1318
7614,3374559242,3512166013,1672532422,1672533798,1376
7698,3312664885,3501759100,1672630035,1672633289,3254
7746,3533748232,3903962771,1672555486,1672558946,3460
7636,3774793839,3755943611,1672596232,1672597203,971
7933,3519912874,3519601612,1672568598,1672571492,2894
7928,3249247700,3703955926,1672619938,1672623440,3502
7622,3515151980,3889232789,1672554497,1672558032,3535
7638,3755587522,3248507722,1672580964,1672582493,1529
7901,3483164654,3505973226,1672658147,1672660066,1919
7718,3505193212,3714821932,1672564857,1672566736,1879
7830,3614238812,3778108318,1672651188,1672654767,3579
7555,3779740455,3501606184,1672605644,1672607542,1898
7497,3772544062,3247428249,1672554957,1672557464,2507
7972,3475258557,3770447408,1672550921,1672554043,3122
7605,3637008488,3417061462,1672604962,1672606597,1635
7626,3774045700,3778780511,1672656961,1672657269,308
7574,3244389794,3518669703,1672637345,1672638119,774
7782,3396285984,3756424865,1672689160,1672692646,3486
7875,3515723720,3534313900,1672541481,1672544943,3462
7818,3713894336,3473562469,1672682328,1672683261,933
7599,3533095755,3783196518,1672651499,1672651564,65
7607,3710408395,3311845971,1672629486,1672630522,1036
7925,3780974443,3817316561,1672542840,1672544459,1619
7893,3533369198,3287105466,1672551220,1672552365,1145
7976,3738502357,3533385867,1672613441,1672616164,2723
7896,3909606423,3606812411,1672629906,1672632109,2203
7740,3736790081,3715981584,1672545671,1672547122,1451
7577,3774119563,3701967560,1672681813,1672682917,1104
7695,3756027749,3778780511,1672576837,1672578244,1407
7511,3773205565,3477375368,1672618535,1672620285,1750
7900,3412980697,3774127586,1672628251,1672630787,2536
7617,3737079798,3780503655,1672619045,1672619877,832
7501,3975287541,3348261553,1672637183,1672639516,2333
7555,3209027249,3898995675,1672545601,1672546636,1035
7720,3792384220,3793470489,1672681470,1672681679,209
7863,3637008488,3855602893,1672664380,1672666472,2092
7697,3338703270,3244389794,1672645348,1672647931,2583
7532,3811171116,3666553782,1672660970,1672662340,1370
7804,3774466457,3738502357,1672620999,1672622260,1261
7716,3288764520,3770851318,1672538181,1672540928,2747
7777,3755511676,3773465237,1672559329,1672560853,1524
7763,3510703546,3791334389,1672583960,1672585242,1282
7693,3805519285,3889750851,1672673190,1672674250,1060
7508,3760893269,3734828619,1672600480,1672603122,2642
7887,3930797455,3779036831,1672634604,1672636557,1953
7885,3666457294,3511267139,1672562599,1672564937,2338
7585,3760509236,3364543015,1672621122,1672624087,2965
7760,3477375368,3972709319,1672630208,1672633748,3540
7920,3627937312,3774125065,1672642655,1672644520,1865
7679,3633420270,3778341199,1672564848,1672565720,872
7830,3489728806,3711198793,1672643854,1672647147,3293
7656,3639847263,3711370563,1672570148,1672570604,456
7981,3370636709,3935127663,1672670515,1672671615,1100
7636,3387674757,3311065516,1672592763,1672594313,1550
7942,3972709319,3276993580,1672657597,1672659849,2252
7858,3978115672,3365942576,1672553479,1672555804,2325
7583,3434642576,3505362057,1672658760,1672659371,611
7604,3902278226,3512349371,1672577453,1672578809,1356
7743,3311154569,3715981584,1672568583,1672570591,2008
7891,3922337974,3805292782,1672531848,1672533279,1431
7524,3516465662,3512969370,1672616285,1672618007,1722
7909,3816853177,3505859863,1672579430,1672582694,3264
7733,3517509185,3520629279,1672628739,1672632199,3460
7757,3716165213,3793470489,1672590921,1672594091,3170
7915,3774050956,3483164654,1672594209,1672596876,2667
7688,3668898102,3773814927,1672566857,1672567024,167
7606,3780639480,3512837326,1672693784,1672696328,2544
7666,3922275416,3554917400,1672611392,1672613931,2539
7937,3773755137,3339907603,1672544270,1672547734,3464
7712,3228165483,3716835696,1672657503,1672658240,737
7727,3791602225,3235287260,1672537335,1672538033,698
7592,3518163778,3829764737,1672610096,1672612877,2781
7716,3618873142,3715974031,1672605845,1672607150,1305
7564,3333896808,3668005723,1672641782,1672642954,1172
7570,3780813786,3621497531,1672633395,1672636916,3521
7950,3509672210,3467773920,1672559980,1672561754,1774
7723,3760598102,3517864478,1672578324,1672580356,2032
7695,3713208927,3792768129,1672634937,1672636794,1857
7834,3496549058,3500904641,1672667795,1672669552,1757
7729,3200198928,3235635976,1672611054,1672612188,1134
7928,3760598102,3710408395,1672539065,1672542529,3464
7566,3512142794,3805519285,1672581128,1672583046,1918
7939,3755042098,3518014636,1672649032,1672652429,3397
7806,3613995936,3296471982,1672607635,1672610216,2581
7870,3779740455,3757403279,1672607731,1672610261,2530
7877,3715492942,3880285638,1672574205,1672577773,3568
7946,3505869747,3922337974,1672609832,1672613315,3483
7681,3378436155,3820354437,1672672976,1672673603,627
7576,3501759100,3399535232,1672574759,1672577481,2722
7630,3518360734,3477375368,1672578712,1672580035,1323
7817,3828624701,3793436995,1672558740,1672559261,521
7744,3505873261,3412825109,1672553897,1672554759,862
7661,3926700506,3318697153,1672535027,1672536393,1366
7708,3224716315,3511125626,1672696804,1672700361,3557
7865,3399535232,3792288302,1672633745,1672634475,730
7545,3428006164,3783083229,1672533092,1672535418,2326
7530,3716488385,3285400528,1672616383,1672616916,533
7614,3519556068,3701111745,1672605762,1672609066,3304
7868,3517721725,3501692334,1672672354,1672672797,443
7489,3739106581,3533626375,1672631126,1672634592,3466
7752,3517077106,3509634629,1672681243,1672682615,1372
7755,3439023335,3505292701,1672588405,1672591629,3224
7920,3496269445,3399004969,1672557404,1672557695,291
7752,3804870229,3636867411,1672644531,1672647033,2502
7788,3475396323,3249401741,1672587883,1672591287,3404
7672,3387966152,3716197887,1672580103,1672581962,1859
7924,3736625083,3505193212,1672667272,1672667852,580
7977,3756021689,3922275620,1672545556,1672549151,3595
7521,3307097200,3738274418,1672628315,1672628508,193
7831,3280964728,3373384732,1672595795,1672597177,1382
7842,3505638204,3903962771,1672670802,1672672025,1223
7594,3511267139,3390068992,1672626650,1672628855,2205
7904,3312829208,3509630174,1672532945,1672535647,2702
7662,3421127249,3533270638,1672657346,1672657619,273
7903,3918674986,3791334389,1672661935,1672663882,1947
7498,3902278226,3605726278,1672672223,1672674545,2322
7629,3533025282,3234541252,1672655545,1672657512,1967
7638,3837094550,3970117174,1672682977,1672684898,1921
7907,3311871871,3554917400,1672641993,1672645201,3208
7532,3231056870,3513080274,1672667956,1672671411,3455
7717,3792253549,3533095755,1672663709,1672664474,765
7939,3756424865,3710098970,1672532536,1672534513,1977
7693,3244173074,3902278226,1672622756,1672623252,496
7833,3776066388,3533369198,1672614040,1672614398,358
7817,3278365525,3276993580,1672547723,1672548586,863
7946,3516909237,3512683609,1672559351,1672559571,220
7502,3415546117,3232962003,1672607339,1672608053,714
7969,3424922204,3601879040,1672539141,1672539935,794
7910,3428964059,3703718151,1672622294,1672622870,576
7921,3757403279,3533927138,1672595307,1672596264,957
7610,3777790718,3770078063,1672664563,1672668142,3579
7924,3899371911,3383922351,1672590182,1672592316,2134
7695,3920801189,3778108318,1672690356,1672693080,2724
7832,3500894271,3485375593,1672670352,1672671551,1199
7618,3443698222,3311603601,1672665438,1672668362,2924
7574,3930791338,3931941795,1672608301,1672610546,2245
7743,3851190615,3399052055,1672634786,1672636183,1397
7559,3715581279,3780639480,1672606868,1672609044,2176
7541,3418728074,3516960534,1672618642,1672619888,1246
7622,3639847263,3760183458,1672681429,1672683140,1711
7816,3634786711,3483949762,1672594967,1672598505,3538
7891,3338703270,3895562476,1672558273,1672560083,1810
7664,3738502357,3757682496,1672680947,1672683679,2732
7770,3714488548,3511125626,1672638523,1672640885,2362
7541,3439023335,3294803686,1672548513,1672551037,2524
7485,3475795792,3922275416,1672535654,1672539037,3383
7862,3406784491,3361230905,1672690388,1672691380,992
7652,3666507626,3777936328,1672677795,1672677949,154
7866,3518496488,3920801189,1672554222,1672554552,330
7669,3605726278,3716746253,1672574995,1672576114,1119
7824,3828624701,3429690204,1672582563,1672583724,1161
7502,3613995936,3774580701,1672602218,1672604628,2410
7859,3514283243,3505873261,1672695887,1672696841,954
7897,3311415018,3516016437,1672609719,1672610218,499
7928,3201324715,3917088658,1672587615,1672590588,2973
7652,3792789881,3367029997,1672691695,1672695208,3513
7960,3880285638,3922275416,1672546052,1672548958,2906
7926,3420700674,3277939457,1672574659,1672575436,777
7872,3505649239,3703223015,1672553014,1672555395,2381
7677,3711262377,3703718151,1672621572,1672624158,2586
7793,3774066725,3497901842,1672631550,1672631655,105
7551,3755587522,3222448362,1672565747,1672568658,2911
7560,3880285638,3779740455,1672593775,1672596937,3162
7836,3913251733,3756601594,1672659149,1672660124,975
7574,3367902229,3772309150,1672677834,1672679991,2157
7688,3500374658,3918674986,1672636608,1672638947,2339
7719,3383922351,3534488837,1672565398,1672565499,101
7580,3703718151,3793470489,1672626378,1672629118,2740
7751,3514128943,3777806071,1672656637,1672656874,237
7879,3206603608,3792032359,1672619185,1672619971,786
7766,3360506772,3509453566,1672676059,1672677005,946
7936,3755943611,3792768129,1672630594,1672633735,3141
7510,3315583351,3713786889,1672647685,1672648123,438
7819,3511312803,3939952128,1672679446,1672682390,2944
7855,3417587765,3510173870,1672660986,1672661674,688
7531,3517963492,3716168623,1672568868,1672571259,2391
7730,3701274634,3510126867,1672594462,1672596051,1589
7686,3533025282,3517077106,1672700812,1672700897,85
7666,3770101921,3778341199,1672642598,1672643100,502
7680,3755625324,3713969578,1672546546,1672546855,309
7495,3396285984,3365830990,1672700006,1672700216,210
7587,3360506772,3412980697,1672653067,1672655366,2299
7608,3855602893,3837094550,1672604196,1672607784,3588
7726,3520206212,3701534009,1672604497,1672605597,1100
7780,3607748895,3793871337,1672604410,1672605763,1353
7931,3519152550,3804870229,1672622404,1672624862,2458
7583,3493507965,3516065852,1672636588,1672637103,515
7857,3903962771,3918056059,1672549091,1672549621,530
7669,3312664885,3791334389,1672652321,1672653034,713
7552,3774204963,3232962003,1672583325,1672585770,2445
7510,3510126867,3516011407,1672599333,1672602697,3364
7938,3418534998,3399004969,1672659470,1672659965,495
7910,3755042098,3852391257,1672612425,1672613877,1452
7727,3756027749,3534488837,1672590348,1672593405,3057
7571,3222448362,3518932404,1672616452,1672617143,691
7766,3477649378,3505098372,1672576319,1672578915,2596
7882,3827222533,3534191820,1672703342,1672704115,773
7712,3509907947,3791553060,1672562070,1672564318,2248
7641,3755920131,3662180254,1672547135,1672547801,666
7750,3454042520,3922275620,1672625336,1672628858,3522
7835,3770635361,3510857360,1672542442,1672545423,2981
7971,3516960534,3779740455,1672632031,1672633321,1290
7622,3778308417,3605726278,1672643493,1672646650,3157
7494,3485375593,3883085535,1672605382,1672606163,781
7555,3276993580,3417061462,1672586132,1672588819,2687
7903,3817316561,3372883226,1672580793,1672582777,1984
7973,3703955926,3757151210,1672628930,1672630232,1302
7946,3793470489,3505883609,1672544586,1672546940,2354
7590,3883085535,3430504438,1672629623,1672630316,693
7580,3518791447,3756966035,1672580112,1672580214,102
7813,3701984666,3792844210,1672546181,1672547187,1006
7901,3783509527,3715581279,1672703675,1672705193,1518
7839,3792288302,3755625324,1672571104,1672574135,3031
7977,3793627961,3701111745,1672648316,1672651904,3588
7686,3298433163,3716165213,1672687832,1672688056,224
7932,3420700674,3883551721,1672658017,1672661463,3446
7883,3388286531,3428964059,1672633711,1672636083,2372
7512,3311648200,3777717988,1672614819,1672616929,2110
7784,3779976989,3606987130,1672611452,1672612620,1168
7832,3209383861,3476232529,1672631199,1672634256,3057
7632,3550946908,3610348516,1672569898,1672570924,1026
7967,3715581279,3505193212,1672563336,1672564573,1237
7710,3387966152,3711504540,1672539047,1672539680,633
7905,3915628728,3776948966,1672663896,1672666677,2781
7800,3402943525,3802367797,1672613929,1672616299,2370
7942,3853018906,3783239924,1672641864,1672644614,2750
7697,3501692334,3710344260,1672635880,1672637643,1763
7643,3312333615,3793086311,1672615478,1672615651,173
7667,3516980378,3500658339,1672546340,1672549894,3554
7525,3701863557,3477649378,1672640181,1672643554,3373
7498,3716835696,3489728806,1672591897,1672595149,3252
7606,3234362962,3925402713,1672628730,1672629263,533
7869,3917278625,3501692334,1672581629,1672584161,2532
7659,3384951177,3500177712,1672573315,1672574708,1393
7605,3624312512,3783925755,1672684966,1672688074,3108
7702,3883312122,3791657947,1672612414,1672615341,2927
7951,3312333615,3351008918,1672595302,1672598716,3414
7806,3509352754,3438645253,1672599295,1672601793,2498
7545,3372883226,3716488385,1672662371,1672662852,481
7692,3608868877,3534702203,1672658549,1672658958,409
7659,3909238838,3735733948,1672578312,1672580619,2307
7903,3618873142,3229665776,1672624760,1672625694,934
7800,3387966152,3773120434,1672689239,1672690533,1294
7505,3345207877,3501364586,1672634918,1672636139,1221
7528,3822654369,3421127249,1672659949,1672660917,968
7548,3533270638,3666457294,1672686390,1672687511,1121
7520,3617055293,3518408774,1672619321,1672622513,3192
7737,3639847263,3777776687,1672688239,1672691797,3558
7543,3774556560,3629547065,1672549908,1672553033,3125
7604,3780813786,3772578994,1672574248,1672576102,1854
7877,3636867411,3500729955,1672616164,1672619109,2945
7927,3804870229,3918247820,1672678994,1672680396,1402
7648,3516011407,3773120434,1672683537,1672685925,2388
7855,3918584946,3736790081,1672609896,1672610164,268
7959,3351554343,3404384505,1672647871,1672648964,1093
7838,3505635228,3399535232,1672582543,1672584775,2232
7746,3839849341,3770851318,1672666104,1672667532,1428
7920,3622054816,3555214688,1672693291,1672696575,3284
7633,3475258557,3517077106,1672541734,1672543388,1654
7776,3280615985,3534553510,1672685445,1672687083,1638
7954,3512510536,3783126683,1672605783,1672606222,439
7566,3711973519,3206593906,1672555458,1672556043,585
7769,3505193212,3369998498,1672574239,1672577804,3565
7654,3476232529,3791602225,1672559877,1672560926,1049
7929,3351008918,3882291183,1672564282,1672564956,674
7891,3372883226,3780365428,1672700667,1672703653,2986
7664,3490191091,3555214688,1672582825,1672583391,566
7821,3429690204,3688683847,1672691773,1672694792,3019
7772,3518014636,3515151980,1672600140,1672600910,770
7706,3774005526,3859525941,1672607321,1672607690,369
7504,3710067113,3359910781,1672645214,1672646009,795
7820,3855000166,3710098970,1672694715,1672696497,1782
7727,3311324983,3901990690,1672564046,1672566744,2698
7980,3302626661,3807987001,1672590663,1672593577,2914
7489,3510771358,3710408395,1672560410,1672563921,3511
7760,3475396323,3501955238,1672554543,1672555683,1140
7906,3683766533,3939952128,1672559267,1672561327,2060
7822,3293695955,3755587522,1672604034,1672606791,2757
7872,3772053179,3662180254,1672699078,1672702221,3143
7886,3970117174,3200198928,1672608167,1672608290,123
7582,3559110998,3633420270,1672567584,1672568507,923
7626,3505973226,3713644518,1672617225,1672618624,1399
7905,3515691540,3520206212,1672652192,1672653446,1254
7639,3475251781,3734737881,1672656881,1672659979,3098
7655,3736786443,3809059934,1672561948,1672564309,2361
7589,3859525941,3757562897,1672534316,1672536707,2391
7903,3890149705,3805519285,1672604692,1672605906,1214
7831,3372883226,3244436890,1672660914,1672662005,1091
7684,3505219850,3505193212,1672671814,1672674768,2954
7852,3859663348,3756462516,1672564772,1672567559,2787
7505,3505219850,3370752401,1672549035,1672550535,1500
7662,3779740455,3780639480,1672631088,1672634604,3516
7731,3811171116,3534010629,1672548439,1672551192,2753
7794,3903307060,3688418210,1672534176,1672535080,904
7856,3505193212,3314245084,1672653878,1672656067,2189
7883,3500578848,3622054816,1672658440,1672660793,2353
7916,3512837326,3318166135,1672569717,1672570814,1097
7716,3772884106,3716843669,1672577905,1672581044,3139
7865,3489217083,3760267716,1672635525,1672636202,677
7654,3889750851,3611150562,1672653892,1672656966,3074
7681,3715981584,3519556068,1672670394,1672672864,2470
7947,3249247700,3359910781,1672644481,1672645415,934
7562,3760077057,3480687894,1672654652,1672656027,1375
7597,3453729665,3933210486,1672635000,1672635435,435
7598,3625274012,3360506772,1672648121,1672649102,981
7838,3777929708,3334033993,1672606866,1672607985,1119
7594,3509630174,3890149705,1672678173,1672679258,1085
7842,3711265369,3756451663,1672545433,1672548721,3288
7934,3685187183,3937224533,1672552520,1672552987,467
7700,3501483568,3500374658,1672654301,1672657120,2819
7533,3772758337,3703871468,1672579611,1672582553,2942
7513,3793436995,3688683847,1672614823,1672616934,2111
7885,3534488837,3291235378,1672584233,1672584949,716
7918,3755511676,3792473331,1672690125,1672693221,3096
7683,3311439795,3703735129,1672594808,1672596664,1856
7666,3231056870,3793389510,1672601404,1672602973,1569
7732,3809059934,3367029997,1672688614,1672690538,1924
7630,3829319703,3778305740,1672543914,1672544955,1041
7618,3512567240,3834257412,1672537769,1672540635,2866
7774,3734496778,3614238812,1672662521,1672665334,2813
7706,3505702787,3313541986,1672693432,1672695509,2077
7848,3773978034,3516065852,1672702952,1672704256,1304
7612,3710112546,3501759100,1672580156,1672580601,445
7797,3311761694,3917088658,1672682564,1672682723,159
7729,3776800213,3772578994,1672554272,1672556124,1852
7503,3416265063,3459030804,1672641272,1672641861,589
7708,3608633356,3517721725,1672681107,1672682177,1070
7724,3880285638,3248507722,1672635512,1672637953,2441
7536,3624761861,3516960534,1672614012,1672614557,545
7733,3701146057,3201848640,1672671106,1672672045,939
7487,3399052055,3249247700,1672567795,1672570519,2724
7724,3386707783,3666553782,1672638423,1672638799,376
7896,3607748895,3701184889,1672599617,1672603017,3400
7777,3488244966,3756451663,1672578210,1672579491,1281
7920,3920801189,3713644518,1672657559,1672657671,112
7863,3285400528,3492478793,1672626132,1672627760,1628
7551,3412825109,3733189298,1672611746,1672613496,1750
7889,3284639858,3396086535,1672582788,1672583958,1170
7973,3701984666,3459030804,1672551121,1672551344,223
7924,3634340855,3520030713,1672640156,1672643537,3381
7925,3533025282,3510857360,1672607592,1672610478,2886
7713,3476232529,3277605882,1672620521,1672621207,686
7911,3501606184,3883085535,1672588370,1672590672,2302
7613,3780593036,3511350608,1672694676,1672697991,3315
7733,3783083229,3780503655,1672584085,1672587239,3154
7776,3701111745,3489545239,1672600774,1672604180,3406
7504,3517476351,3280615985,1672568942,1672570697,1755
7484,3399052055,3505219850,1672601036,1672602147,1111
7495,3518876135,3773950140,1672619158,1672621340,2182
7905,3201848640,3421836608,1672577903,1672578521,618
7809,3516258476,3279721246,1672663982,1672664282,300
7888,3815508790,3756021689,1672533984,1672536798,2814
7749,3738274418,3793962300,1672699716,1672702785,3069
7525,3458539365,3778780511,1672633379,1672634035,656
7577,3774119563,3473765852,1672627833,1672628768,935
7664,3550946908,3534313900,1672593767,1672594638,871
7715,3516514391,3793848402,1672645103,1672645790,687
7630,3622054816,3519428855,1672639277,1672639399,122
7885,3792032359,3505599848,1672562967,1672563445,478
7736,3511687358,3809484172,1672563516,1672566904,3388
7599,3485008994,3910886626,1672638091,1672640716,2625
7832,3505173328,3417061462,1672662081,1672665314,3233
7493,3520931254,3512217942,1672637946,1672641104,3158
7758,3809059934,3899266183,1672574448,1672576259,1811
7876,3287105466,3774366875,1672672733,1672674364,1631
7958,3432689543,3978105277,1672586986,1672589171,2185
7602,3891751546,3224058172,1672686464,1672689208,2744
7954,3776513891,3311603601,1672604303,1672606093,1790
7500,3772746272,3534424200,1672596631,1672597550,919
7771,3715974031,3482405588,1672595327,1672598250,2923
7794,3307097200,3791553060,1672566616,1672570095,3479
7632,3231056870,3519654779,1672666237,1672668882,2645
7691,3505702787,3307512479,1672557955,1672561420,3465
7860,3791901535,3247780536,1672694079,1672694256,177
7662,3311603601,3716488385,1672642749,1672645121,2372
7927,3776513891,3935627557,1672607353,1672608375,1022
7777,3516258476,3466911760,1672651458,1672653199,1741
7886,3209048907,3296471982,1672665684,1672666063,379
7639,3792883665,3716197887,1672655852,1672656922,1070
7882,3793959750,3711569060,1672621768,1672625186,3418
7724,3922337974,3533653428,1672613140,1672614787,1647
7931,3703871468,3772714862,1672565056,1672566572,1516
7913,3500229033,3234362962,1672593229,1672593773,544
7519,3710569131,3617055293,1672565814,1672568357,2543
7953,3276993580,3277939457,1672558855,1672559485,630
7904,3895562476,3500894271,1672591656,1672593718,2062
7590,3223789409,3621810464,1672699642,1672700304,662
7533,3664517356,3711973519,1672553780,1672554698,918
7606,3500729955,3701984666,1672700187,1672702971,2784
7693,3757403279,3809484172,1672575997,1672579213,3216
7525,3780294829,3370752401,1672569361,1672569693,332
7820,3760561634,3776513891,1672562831,1672565711,2880
7816,3518260334,3287105466,1672605980,1672608853,2873
7517,3315583351,3780294829,1672672229,1672674219,1990
7594,3412825109,3809059934,1672559469,1672562763,3294
7894,3509352754,3783196518,1672545148,1672546417,1269
7582,3501927421,3244436890,1672627392,1672627609,217
7645,3533270638,3716168623,1672700161,1672700971,810
7734,3757562897,3777623166,1672536241,1672537150,909
7914,3518360734,3534702203,1672635048,1672637194,2146
7612,3391915121,3701146057,1672618881,1672621123,2242
7838,3827222533,3554917400,1672662901,1672664509,1608
7626,3519703355,3513454145,1672567580,1672568014,434
7831,3811171116,3933210486,1672648171,1672651217,3046
7626,3505135325,3792844210,1672642652,1672645338,2686
7773,3438645253,3505193212,1672629589,1672630253,664
7974,3715974031,3417061462,1672567626,1672570641,3015
7611,3855602893,3713630656,1672563820,1672564250,430
7695,3791997875,3634340855,1672609230,1672609426,196
7779,3825229501,3772758337,1672614450,1672614520,70
7645,3682061100,3418534998,1672698873,1672701765,2892
7502,3713630656,3510594211,1672688424,1672688922,498
7562,3489545239,3783126683,1672678989,1672679854,865
7819,3515860749,3792768129,1672572011,1672575275,3264
7813,3399433690,3668898102,1672595666,1672598038,2372
7823,3711569060,3805347939,1672657168,1672658992,1824
7681,3933210486,3779036831,1672581101,1672581425,324
7645,3773814927,3489728806,1672598428,1672599502,1074
7503,3976390453,3287105466,1672583690,1672585997,2307
7749,3613683164,3307097200,1672655166,1672658169,3003
7863,3605726278,3773120434,1672637233,1672640142,2909
7704,3715581279,3501759100,1672614827,1672618376,3549
7486,3809484172,3829319703,1672629448,1672629522,74
7591,3621810464,3918056059,1672574948,1672577997,3049
7963,3713808837,3791334389,1672531951,1672534508,2557
7605,3534424200,3481647420,1672628812,1672628962,150
7703,3791334389,3559110998,1672570492,1672573270,2778
7880,3500487333,3774127586,1672612357,1672613130,773
7537,3515284591,3512969370,1672642785,1672643551,766
7564,3405494240,3533137446,1672546545,1672547914,1369
7799,3613683164,3276640712,1672654939,1672657414,2475
7662,3624312512,3976390453,1672689692,1672692720,3028
7873,3311203656,3783925755,1672542641,1672545481,2840
7616,3911245524,3517721725,1672670529,1672673089,2560
7733,3774556560,3416427576,1672672445,1672673640,1195
7755,3809059934,3711370563,1672600969,1672604077,3108
7863,3608633356,3792177074,1672628713,1672629611,898
7591,3247428249,3432689543,1672573762,1672574636,874
7685,3505869747,3734496778,1672601126,1672604319,3193
7978,3404058699,3505530961,1672611872,1672612844,972
7485,3817621391,3238712269,1672616979,1672620309,3330
7552,3774339795,3833889105,1672556498,1672558083,1585
7890,3889750851,3773978034,1672637537,1672639734,2197
7894,3370636709,3777443199,1672638407,1672639503,1096
7890,3229058858,3776948966,1672588161,1672590197,2036
7591,3780593036,3777983879,1672703330,1672705317,1987
7819,3757455053,3613995936,1672627696,1672629752,2056
7965,3755625324,3487171044,1672652982,1672654539,1557
7696,3601879040,3516514391,1672628598,1672631316,2718
7529,3336751428,3778980116,1672666669,1672668600,1931
7530,3760569731,3337544549,1672686757,1672687374,617
7843,3421836608,3534313900,1672652811,1672653098,287
7968,3209551760,3774268456,1672667893,1672670214,2321
7979,3888559320,3637008488,1672548422,1672549306,884
7485,3899266183,3360993964,1672615583,1672616761,1178
7605,3304056063,3519152550,1672596456,1672597954,1498
7941,3351554343,3792288302,1672696762,1672698283,1521
7515,3935627557,3701190899,1672575138,1672577822,2684
7788,3428674539,3711569060,1672661524,1672662058,534
7680,3518360734,3501955238,1672699374,1672702504,3130
7744,3333896808,3533095755,1672573828,1672575233,1405
7883,3837094550,3800886801,1672570879,1672573683,2804
7535,3500499542,3406784491,1672663135,1672664399,1264
7914,3800886801,3505530961,1672544980,1672545685,705
7498,3683766533,3229665776,1672586991,1672587793,802
7778,3776513891,3505530961,1672653137,1672654281,1144
7585,3774338212,3430504438,1672647809,1672648855,1046
7625,3500487333,3701534009,1672676471,1672676953,482
7764,3608633356,3448855696,1672608199,1672608503,304
7818,3510703546,3627937312,1672555842,1672556231,389
7828,3601879040,3711262377,1672576604,1672577899,1295
7910,3805519285,3791874383,1672616067,1672616402,335
7560,3505638204,3880310724,1672619949,1672620612,663
7856,3512720680,3817316561,1672570827,1672571224,397
7633,3776800213,3756451663,1672670253,1672673193,2940
7619,3817316561,3288764520,1672546806,1672548773,1967
7898,3606987130,3388372715,1672692327,1672694840,2513
7849,3303705369,3780639480,1672554609,1672554715,106
7953,3779218771,3430074045,1672609700,1672613294,3594
7528,3533095755,3209551760,1672615628,1672615970,342
7752,3417970574,3313564074,1672621127,1672622970,1843
7927,3511271692,3520376528,1672641617,1672644498,2881
7639,3318697153,3475258557,1672607151,1672610559,3408
7486,3518876135,3416265063,1672671748,1672672004,256
7697,3516606733,3384240055,1672589067,1672591430,2363
7842,3779740455,3793470489,1672567970,1672569983,2013
7536,3514472925,3701898991,1672543843,1672545290,1447
7715,3904408902,3734828619,1672572982,1672574343,1361
7836,3516673015,3925402713,1672632820,1672635834,3014
7624,3500177712,3383922351,1672621492,1672621738,246
7926,3514283243,3489962019,1672620054,1672622840,2786
7768,3500229033,3600647945,1672701553,1672703317,1764
7850,3510857360,3500499542,1672546826,1672550193,3367
7956,3716258994,3664517356,1672676982,1672677228,246
7941,3899266183,3930797455,1672539290,1672542177,2887
7946,3411618230,3387674757,1672642778,1672644903,2125
7818,3501927421,3380035798,1672693895,1672694192,297
7905,3505193212,3511312803,1672587171,1672587654,483
7732,3792384220,3201324715,1672582148,1672584900,2752
7526,3516606733,3714504419,1672631532,1672633810,2278
7648,3703735129,3512217942,1672661504,1672663289,1785
7778,3291883916,3513956646,1672652380,1672655969,3589
7813,3477649378,3667680268,1672567918,1672570532,2614
7941,3703275621,3909238838,1672592027,1672592155,128
7851,3475258557,3520888296,1672668518,1672670521,2003
7680,3294803686,3770635361,1672668889,1672669826,937
7639,3701863557,3773950140,1672596217,1672598662,2445
7860,3701863557,3711504540,1672636996,1672637539,543
7965,3738274418,3777455223,1672587327,1672588186,859
7616,3234541252,3223968713,1672582870,1672584745,1875
7870,3911159965,3914290246,1672621967,1672623762,1795
7958,3510703546,3533385867,1672634647,1672636503,1856
7491,3518360734,3809059934,1672558022,1672559655,1633
7935,3311627628,3792668962,1672587120,1672590648,3528
7597,3475258557,3777776687,1672583192,1672584047,855
7835,3793286136,3881477378,1672572601,1672574091,1490
7708,3222448362,3386707783,1672668046,1672669890,1844
7896,3533137446,3859663348,1672649653,1672649788,135
7982,3293695955,3520030713,1672588589,1672591057,2468
7796,3756462516,3714504419,1672655320,1672658673,3353
7710,3516223597,3713969578,1672679070,1672680196,1126
7893,3301107849,3809916577,1672559807,1672562147,2340
7671,3858918246,3792473331,1672690837,1672692860,2023
7581,3519654779,3760598102,1672665140,1672666828,1688
7966,3778108318,3411618230,1672542809,1672543627,818
7519,3511267139,3607748895,1672679840,1672680021,181
7888,3703789494,3221899927,1672689595,1672691009,1414
7484,3774556560,3518932404,1672575064,1672578322,3258
7583,3660493209,3792473331,1672645701,1672646355,654
7662,3793871337,3429856982,1672591787,1672594982,3195
7544,3360993964,3737079798,1672693339,1672694911,1572
7812,3880285638,3505219850,1672673545,1672675036,1491
7703,3297463265,3833889105,1672541940,1672542876,936
7899,3512720680,3510969660,1672551751,1672554997,3246
7966,3342131135,3367902229,1672700540,1672703952,3412
7673,3512166013,3516716179,1672621506,1672623069,1563
7839,3467773920,3517864478,1672541019,1672541098,79
7568,3972364603,3519152550,1672631068,1672634622,3554
7864,3819727225,3500365158,1672700812,1672703665,2853
7777,3338367113,3244485293,1672549758,1672553216,3458
7890,3512510536,3509773875,1672590582,1672593068,2486
7507,3780828689,3249247700,1672596414,1672599234,2820
7774,3710067113,3505201246,1672613985,1672615361,1376
7848,3918056059,3791657947,1672687428,1672689519,2091
7929,3711370563,3516016437,1672643978,1672646176,2198
7888,3400918687,3311203656,1672640130,1672640711,581
7488,3509933351,3510711755,1672679625,1672682075,2450
7786,3805519285,3533025282,1672598571,1672601452,2881
7940,3774520233,3223789409,1672558034,1672558465,431
7784,3777623166,3388372715,1672670104,1672670209,105
7653,3500994774,3500578848,1672570259,1672573136,2877
7525,3791942683,3293695955,1672651175,1672654120,2945
7546,3520719611,3777514571,1672681296,1672684537,3241
7965,3429690204,3511271692,1672618703,1672619972,1269
7578,3434642576,3685187183,1672590133,1672591893,1760
7891,3716258994,3933210486,1672559907,1672562664,2757
7664,3909606423,3757447189,1672682410,1672685865,3455
7533,3774204963,3666506258,1672586670,1672590075,3405
7833,3384951177,3319752091,1672678664,1672681447,2783
7596,3518932404,3505362057,1672608687,1672609993,1306
7974,3518260334,3511312803,1672667458,1672670062,2604
7535,3516039895,3800353779,1672575734,1672578933,3199
7605,3629935998,3248507722,1672688268,1672688416,148
7885,3930797455,3939952128,1672684999,1672686943,1944
7877,3417061462,3710098970,1672614688,1672616891,2203
7914,3910454786,3792384220,1672661821,1672663964,2143
7910,3777929708,3710098970,1672618220,1672618863,643
7928,3611150562,3514838220,1672572913,1672574135,1222
7776,3607748895,3533193862,1672655998,1672658082,2084
7699,3791997875,3756027749,1672589723,1672590152,429
7623,3505292701,3500365158,1672553946,1672555671,1725
7850,3400804807,3774195321,1672540854,1672541239,385
7737,3298433163,3792177074,1672671732,1672672114,382
7535,3772746272,3378436155,1672603151,1672605851,2700
7599,3249401741,3519803045,1672608367,1672609783,1416
7909,3424922204,3885670556,1672658945,1672661913,2968
7498,3777790718,3511350608,1672531572,1672532289,717
7550,3701984666,3519912874,1672667596,1672669552,1956
7633,3318166135,3493507965,1672650839,1672651310,471
7537,3778549126,3601879040,1672698842,1672701087,2245
7644,3713630656,3517459919,1672656406,1672657233,827
7907,3303751772,3316173088,1672595562,1672596817,1255
7561,3511435497,3512837326,1672540116,1672541205,1089
7699,3336751428,3773755137,1672683234,1672683467,233
7641,3510244400,3378436155,1672652633,1672656030,3397
7959,3882242815,3481647420,1672660731,1672663044,2313
7736,3793848402,3516223597,1672551677,1672554175,2498
7752,3939952128,3716900301,1672658689,1672659755,1066
7811,3315583351,3513599775,1672583290,1672583388,98
7559,3247428249,3509352754,1672621741,1672623771,2030
7750,3485375593,3284639858,1672600871,1672603492,2621
7747,3617055293,3829319703,1672637004,1672637084,80
7637,3280615985,3817621391,1672672810,1672674512,1702
7722,3227457126,3975287541,1672584919,1672588447,3528
7847,3857349323,3925620998,1672565352,1672565864,512
7677,3716258994,3852595551,1672645357,1672648810,3453
7946,3733891182,3249401741,1672587678,1672591205,3527
7524,3931941795,3501364586,1672622328,1672625425,3097
7893,3827377568,3249791738,1672627176,1672627297,121
7636,3882291183,3917278625,1672588589,1672591715,3126
7841,3314836094,3459030804,1672660432,1672660862,430
7981,3711973519,3791957752,1672638810,1672640762,1952
7504,3710569131,3730517636,1672647399,1672650457,3058
7635,3604539807,3280964728,1672621283,1672622928,1645
7642,3517459919,3304056063,1672671274,1672672527,1253
7914,3926700506,3511841857,1672540650,1672544240,3590
7865,3805342762,3776800213,1672588451,1672590867,2416
7888,3783925755,3249401741,1672546469,1672547366,897
7572,3370752401,3828432634,1672561568,1672563210,1642
7653,3629935998,3400804807,1672590034,1672591688,1654
7928,3311718847,3757602960,1672549668,1672550008,340
7651,3505000737,3318166135,1672674211,1672676512,2301
7983,3883085535,3932051427,1672699938,1672703459,3521
7800,3627937312,3774204963,1672567507,1672569322,1815
7962,3420700674,3201848640,1672536199,1672539343,3144
7505,3428964059,3885670556,1672637117,1672640117,3000
7689,3206254161,3505873261,1672533792,1672536936,3144
7750,3520888296,3899204805,1672605268,1672606066,798
7675,3399052055,3889750851,1672680407,1672681873,1466
7949,3311993075,3500487333,1672569695,1672571372,1677
7630,3891751546,3816853177,1672637946,1672638251,305
7574,3533369198,3556951786,1672563298,1672565979,2681
7872,3465254146,3505912939,1672577381,1672578604,1223
7838,3311203656,3780828689,1672697110,1672700285,3175
7928,3439023335,3359239884,1672566450,1672568287,1837
7815,3823600322,3826415738,1672627643,1672631154,3511
7658,3662180254,3909606423,1672588734,1672591199,2465
7863,3559110998,3201324715,1672640791,1672644122,3331
7569,3779218771,3513454145,1672625656,1672627442,1786
7632,3285400528,3791553060,1672625205,1672627265,2060
7621,3773978034,3246596716,1672693372,1672694195,823
7791,3668898102,3739106581,1672610460,1672610756,296
7676,3400918687,3701984666,1672535272,1672535441,169
7592,3391915121,3505599848,1672596057,1672597226,1169
7584,3793753089,3291235378,1672700079,1672700978,899
7933,3912262917,3222448362,1672702964,1672703800,836
7625,3291235378,3935627557,1672678374,1672681907,3533
7714,3713370078,3509630174,1672683178,1672683437,259
7947,3519069599,3516606733,1672641069,1672641402,333
7892,3276993580,3465202715,1672615853,1672616107,254
7579,3510771358,3756528686,1672567516,1672569438,1922
7576,3303705369,3224716315,1672567990,1672571120,3130
7661,3512217942,3396285984,1672558136,1672561609,3473
7543,3634340855,3500066230,1672659722,1672662953,3231
7658,3716258994,3344019610,1672546478,1672549541,3063
7540,3829319703,3757447189,1672596345,1672599547,3202
7596,3512969370,3777936328,1672623048,1672625643,2595
7637,3774366875,3500894271,1672574665,1672576753,2088
7760,3224716315,3505638204,1672582081,1672585141,3060
7538,3701111745,3837094550,1672627871,1672628053,182
7788,3902383721,3734737881,1672625247,1672625915,668
7536,3973560347,3516716179,1672703976,1672704851,875
7716,3815508790,3501606184,1672620176,1672623643,3467
7747,3501730685,3482405588,1672556134,1672558715,2581
7930,3332072298,3249791738,1672587895,1672589218,1323
7808,3715127362,3755042098,1672676998,1672679380,2382
7736,3200691026,3972364603,1672604355,1672607040,2685
7721,3222448362,3519556068,1672532289,1672533312,1023
7887,3770021824,3206254161,1672558983,1672559863,880
7838,3202120784,3780609808,1672682157,1672684442,2285
7788,3534424200,3760489031,1672555653,1672555970,317
7714,3221536550,3482405588,1672699157,1672699331,174
7759,3314836094,3783239924,1672610295,1672613297,3002
7755,3311627628,3512349371,1672608655,1672611587,2932
7579,3783245561,3514128943,1672549412,1672550527,1115
7483,3517077106,3402943525,1672655920,1672657075,1155
7543,3800353779,3505702787,1672561624,1672563921,2297
7888,3511267139,3434642576,1672657263,1672658833,1570
7783,3715974031,3733189298,1672656413,1672656964,551
7850,3791553060,3774793839,1672547347,1672548932,1585
7835,3534010629,3360743849,1672574521,1672574847,326
7851,3777455223,3236102733,1672546862,1672549198,2336
7815,3755739653,3533827120,1672535334,1672538342,3008
7490,3777514571,3668898102,1672651605,1672651731,126
7781,3610695419,3711262377,1672654427,1672654768,341
7950,3209551760,3518014636,1672539949,1672541414,1465
7731,3714821932,3510126867,1672649594,1672650531,937
7588,3399911573,3511267139,1672613983,1672614242,259
7573,3716197887,3500578848,1672654931,1672657302,2371
7942,3730517636,3770824086,1672635390,1672637544,2154
7626,3316173088,3501927421,1672635790,1672639002,3212
7668,3783925755,3428674539,1672668505,1672668830,325
7827,3737051610,3770824086,1672621660,1672624089,2429
7766,3683766533,3446948848,1672575567,1672578208,2641
7716,3311627628,3713808837,1672702173,1672702679,506
7951,3383661227,3516039895,1672607988,1672610726,2738
7859,3780788622,3885897503,1672643458,1672643808,350
7864,3736790081,3664170666,1672645745,1672649161,3416
7809,3346795719,3783509527,1672535564,1672538333,2769
7821,3736786443,3713786889,1672533608,1672536661,3053
7827,3475795792,3415546117,1672578778,1672580321,1543
7810,3770635361,3454042520,1672583611,1672585146,1535
7773,3500060260,3667680268,1672561007,1672561296,289
7821,3772578994,3509604974,1672698875,1672699469,594
7944,3610695419,3496269445,1672567883,1672570537,2654
7759,3883042241,3409474775,1672562867,1672564836,1969
7697,3703871468,3857349323,1672643809,1672647076,3267
7968,3505201246,3500177712,1672698000,1672698912,912
7523,3716900301,3828432634,1672673966,1672676282,2316
7612,3388286531,3391261292,1672643931,1672644682,751
7920,3755042098,3931941795,1672570826,1672572574,1748
7729,3520706195,3311627628,1672605447,1672606771,1324
7752,3505219850,3358871377,1672666550,1672668514,1964
7930,3639847263,3311718847,1672622822,1672625066,2244
7651,3404384505,3916289176,1672659276,1672662645,3369
7854,3520165601,3556951786,1672703317,1672704993,1676
7527,3500803339,3394539273,1672589142,1672591489,2347
7801,3517476351,3483164654,1672566771,1672567526,755
7798,3420700674,3809916577,1672547886,1672548657,771
7867,3809484172,3629935998,1672668756,1672672107,3351
7624,3716258994,3533137446,1672689798,1672692427,2629
7653,3520012395,3792768129,1672620970,1672622627,1657
7917,3760893269,3626156564,1672611715,1672613435,1720
7492,3738274418,3793286136,1672699326,1672701394,2068
7489,3400918687,3391915886,1672697703,1672701066,3363
7553,3221899927,3430074045,1672581952,1672583562,1610
7661,3517077106,3916289176,1672700916,1672704082,3166
7565,3710067113,3793627961,1672645781,1672646816,1035
7618,3809059934,3805519285,1672535797,1672536685,888
7929,3489217083,3510711755,1672614648,1672615696,1048
7755,3805519285,3777120536,1672575916,1672576998,1082
7857,3374559242,3701863557,1672678550,1672679121,571
7709,3822654369,3839849341,1672561934,1672562542,608
7501,3703718151,3511170269,1672542298,1672542601,303
7899,3511312803,3716835696,1672664700,1672667629,2929
7572,3779976989,3520706195,1672660109,1672662327,2218
7982,3734496778,3360993964,1672668201,1672671331,3130
7671,3417970574,3859525941,1672642893,1672646014,3121
7864,3291883916,3833889105,1672586539,1672589179,2640
7960,3710569131,3783531004,1672653402,1672656051,2649
7620,3791020967,3883861463,1672697304,1672698597,1293
7551,3791115967,3606812411,1672623668,1672624277,609
7680,3276640712,3622054816,1672588714,1672589809,1095
7952,3509453566,3533025282,1672566732,1672569528,2796
7710,3501927421,3516960534,1672610228,1672612115,1887
7612,3483949762,3500199935,1672633251,1672635879,2628
7742,3772746272,3533137446,1672541935,1672542675,740
7870,3500458761,3510380060,1672662913,1672665281,2368
7808,3514987389,3517963492,1672606687,1672610169,3482
7691,3517476351,3662180254,1672695508,1672698231,2723
7958,3511350608,3520376528,1672630417,1672632113,1696
7961,3808324264,3493507965,1672543492,1672543734,242
7564,3554917400,3755511676,1672675072,1672675662,590
7483,3399911573,3415546117,1672578860,1672579366,506
7652,3467773920,3516039895,1672613316,1672615442,2126
7895,3735733948,3793086311,1672676759,1672678358,1599
7860,3501759100,3733891182,1672680169,1672681879,1710
7858,3248507722,3533242305,1672548451,1672551712,3261
7665,3229665776,3301107849,1672640963,1672643687,2724
7501,3610348516,3244389794,1672654078,1672654254,176
7775,3426325549,3832902928,1672679092,1672680182,1090
7584,3924549929,3415546117,1672542250,1672542831,581
7961,3510703546,3426325549,1672595263,1672598374,3111
7824,3520719611,3626156564,1672667029,1672669336,2307
7804,3778266283,3223968713,1672647158,1672649839,2681
7777,3490191091,3429856982,1672604027,1672606080,2053
7691,3311065516,3280599164,1672662379,1672664073,1694
7830,3852595551,3776338577,1672649014,1672651838,2824
7789,3484995752,3399052055,1672600145,1672602288,2143
7879,3716488385,3664517356,1672565123,1672568477,3354
7787,3494290908,3516223597,1672664335,1672665382,1047
7668,3223789409,3518791447,1672599616,1672601005,1389
7966,3779528381,3518876135,1672586232,1672589427,3195
7576,3273500349,3711571712,1672702422,1672705075,2653
7769,3484995752,3519601612,1672642011,1672644820,2809
7483,3339907603,3809484172,1672532621,1672534408,1787
7741,3682061100,3509672210,1672665307,1672666362,1055
7913,3713268590,3552314511,1672608263,1672608978,715
7564,3384240055,3509634629,1672662291,1672662698,407
7691,3516629436,3533810360,1672539873,1672541004,1131
7702,3512837326,3822654369,1672562704,1672563354,650
7702,3412980697,3380035798,1672663834,1672666290,2456
7619,3710344260,3755798867,1672560242,1672563191,2949
7695,3608868877,3715974031,1672653553,1672654957,1404
7776,3776338577,3424922204,1672607537,1672610875,3338
7531,3777983879,3777477395,1672611028,1672614154,3126
7621,3276993580,3511687358,1672668173,1672670815,2642
7722,3711571712,3757447189,1672678410,1672679831,1421
7862,3512969370,3817316561,1672581492,1672583178,1686
7662,3634340855,3505219850,1672603321,1672606574,3253
7642,3903307060,3404058699,1672625100,1672626842,1742
7580,3518876135,3510771358,1672689202,1672689461,259
7869,3534313900,3500177712,1672634530,1672637280,2750
7802,3783705817,3344019610,1672550552,1672553493,2941
7707,3392121505,3714488548,1672645145,1672648639,3494
7801,3511359172,3224058172,1672570308,1672573137,2829
7959,3882291183,3420700674,1672537707,1672539262,1555
7919,3360993964,3427219654,1672556835,1672557471,636
7972,3501601840,3903307060,1672564704,1672566169,1465
7714,3703661585,3439023335,1672598354,1672601725,3371
7921,3512166013,3483949762,1672696057,1672696213,156
7955,3227158514,3783245561,1672555954,1672559200,3246
7861,3360743849,3511359172,1672568267,1672569088,821
7638,3774298222,3209048907,1672654259,1672655613,1354
7698,3406784491,3735319397,1672701876,1672703173,1297
7770,3534492426,3400804807,1672689960,1672692241,2281
7687,3701691675,3939952128,1672629604,1672631188,1584
7865,3715974031,3451432842,1672557758,1672561039,3281
7975,3407725581,3202120784,1672638334,1672641594,3260
7912,3291883916,3520709480,1672572930,1672574006,1076
7874,3710067113,3342131135,1672665997,1672666728,731
7972,3304056063,3756930948,1672592107,1672594126,2019
7659,3916289176,3505219850,1672547765,1672548479,714
7653,3826633236,3889232789,1672645133,1672647354,2221
7746,3505904952,3832902928,1672688556,1672690301,1745
7765,3933210486,3779036831,1672621726,1672622758,1032
7898,3777983879,3465202715,1672650043,1672652145,2102
7781,3772758337,3397418363,1672631412,1672633445,2033
7970,3519700826,3629547065,1672544246,1672547522,3276
7908,3621497531,3428674539,1672684738,1672686046,1308
7492,3512217942,3757455053,1672595255,1672598101,2846
7565,3836573197,3342131135,1672686349,1672689892,3543
7523,3828432634,3778980116,1672605177,1672605842,665
7810,3223789409,3520888296,1672642768,1672644644,1876
7742,3501198706,3734737881,1672698197,1672701702,3505
7696,3311324983,3881477378,1672699674,1672703199,3525
7842,3501927421,3793286136,1672654172,1672654533,361
7683,3664517356,3783925755,1672542438,1672544523,2085
7568,3534729133,3778305740,1672598961,1672601386,2425
7783,3913251733,3481502100,1672680515,1672682983,2468
7787,3918056059,3770851318,1672663232,1672665156,1924
7511,3476232529,3783531004,1672539316,1672542392,3076
7982,3511312803,3918584946,1672611387,1672613810,2423
7849,3890149705,3496549058,1672626388,1672629690,3302
7701,3311993075,3466911760,1672691499,1672692129,630
7690,3859663348,3935627557,1672543168,1672544770,1602
7934,3932051427,3757812939,1672684701,1672687770,3069
7930,3713370078,3731419510,1672541471,1672544551,3080
7774,3505173328,3783239924,1672648890,1672650825,1935
7497,3853018906,3517459919,1672694458,1672694737,279
7827,3922275620,3501606184,1672536517,1672538775,2258
7847,3760489031,3248507722,1672544029,1672545926,1897
7935,3517255726,3685818092,1672602223,1672602748,525
7492,3610348516,3338367113,1672579069,1672582469,3400
7801,3628819436,3227158514,1672700573,1672701179,606
7907,3816853177,3432689543,1672679626,1672680058,432
7541,3855937514,3520012395,1672555158,1672557013,1855
7951,3289061738,3773950140,1672575348,1672576243,895
7917,3501955238,3303751772,1672549350,1672551036,1686
7548,3533270638,3514245078,1672535633,1672537990,2357
7718,3703889596,3701111745,1672580309,1672581977,1668
7668,3779528381,3209551760,1672608354,1672609595,1241
7804,3780294829,3711571712,1672591090,1672593644,2554
7542,3805347939,3533626375,1672678547,1672680227,1680
7825,3634995491,3451432842,1672625109,1672628166,3057
7567,3801089989,3756601594,1672635360,1672635878,518
7685,3517963492,3401627165,1672644285,1672645858,1573
7487,3369998498,3918247820,1672702897,1672705394,2497
7497,3412825109,3242408357,1672665661,1672667312,1651
7846,3289061738,3770101921,1672618343,1672619390,1047
7781,3415443558,3285400528,1672666494,1672669041,2547
7797,3357483218,3716843669,1672670335,1672671039,704
7667,3774366875,3517459919,1672566194,1672566664,470
7738,3606186086,3883861463,1672552448,1672554088,1640
7809,3918247820,3778980116,1672608695,1672611746,3051
7491,3500994774,3273500349,1672629950,1672632995,3045
7520,3505973226,3520376528,1672690571,1672693415,2844
7951,3505962865,3817316561,1672561377,1672564363,2986
7593,3294803686,3201432789,1672700681,1672703605,2924
7523,3446948848,3342131135,1672547422,1672549637,2215
7665,3760492950,3774580701,1672677108,1672677547,439
7837,3534424200,3909238838,1672542026,1672544984,2958
7556,3791334389,3500994774,1672572336,1672573343,1007
7583,3792902982,3520030713,1672544077,1672546694,2617
7615,3378436155,3885897503,1672690927,1672693123,2196
7530,3791602225,3737051610,1672660197,1672662104,1907
7895,3465254146,3416427576,1672532150,1672532407,257
7679,3778266283,3662180254,1672687012,1672688096,1084
7519,3338367113,3277605882,1672653666,1672653776,110
7980,3779976989,3773755137,1672652880,1672653057,177
7952,3780593036,3271938399,1672658633,1672659884,1251
7555,3509352754,3360993964,1672642620,1672646172,3552
7668,3622054816,3895562476,1672572979,1672574697,1718
7514,3509773875,3667680268,1672617863,1672618527,664
7652,3280615985,3793871337,1672560049,1672560124,75
7829,3773814927,3489962019,1672612804,1672612923,119
7754,3554917400,3501759100,1672641829,1672644447,2618
7909,3774793839,3807987001,1672585003,1672587482,2479
7974,3311648200,3475795792,1672539158,1672539337,179
7682,3417587765,3832902928,1672540391,1672540576,185
7706,3315583351,3783206719,1672548168,1672548439,271
7954,3774045700,3791874383,1672569746,1672570595,849
7831,3519700826,3505203158,1672693843,1672695553,1710
7919,3716258994,3391915121,1672673182,1672673384,202
7820,3519152550,3890149705,1672610947,1672611956,1009
7864,3206593906,3901990690,1672696797,1672697907,1110
7662,3377766165,3284639858,1672683054,1672684958,1904
7836,3783925755,3244485293,1672643977,1672644243,266
7784,3533748232,3711265369,1672567624,1672569158,1534
7814,3610695419,3510711755,1672665862,1672668908,3046
7642,3756528686,3710344260,1672648455,1672650432,1977
7939,3500487333,3412825109,1672668999,1672672161,3162
7539,3534702203,3484995752,1672604368,1672606648,2280
7619,3346327502,3430352815,1672658248,1672660732,2484
7976,3417587765,3374559242,1672582321,1672585140,2819
7729,3515151980,3513164386,1672537635,1672539809,2174
7752,3489962019,3500803339,1672660459,1672662805,2346
7791,3613995936,3774195321,1672604410,1672606928,2518
7519,3616944364,3448855696,1672696979,1672698947,1968
7818,3755436115,3757161914,1672656528,1672658578,2050
7826,3512217942,3755042098,1672670233,1672673497,3264
7541,3312333615,3311324983,1672685608,1672687693,2085
7850,3813052709,3276640712,1672558380,1672559801,1421
7608,3314245084,3490191091,1672553008,1672556257,3249
7868,3206254161,3774268456,1672623591,1672625880,2289
7639,3284832486,3379256399,1672588456,1672589939,1483
7749,3776066388,3736625083,1672666784,1672667950,1166
7956,3417587765,3453729665,1672573647,1672575279,1632
7733,3770101921,3517963492,1672596271,1672599851,3580
7594,3970117174,3383661227,1672618851,1672619092,241
7697,3533137446,3516909237,1672701254,1672704386,3132
7740,3606186086,3805342762,1672646356,1672648779,2423
7492,3778980116,3318697153,1672688836,1672692145,3309
7719,3774195321,3617055293,1672547396,1672547751,355
7639,3800353779,3629935998,1672610072,1672611019,947
7819,3286658957,3774580701,1672553042,1672555055,2013
7650,3222448362,3311152102,1672641657,1672644632,2975
7512,3511435497,3209383861,1672604209,1672607116,2907
7488,3516980378,3533280269,1672674573,1672676354,1781
7885,3534702203,3756027749,1672587080,1672588991,1911
7744,3774338212,3378436155,1672611716,1672615304,3588
7696,3903307060,3242408357,1672601303,1672603065,1762
7952,3668005723,3792789881,1672602495,1672603192,697
7782,3514283243,3379256399,1672608674,1672611710,3036
7935,3829232696,3793286136,1672701227,1672701662,435
7884,3760893269,3533653428,1672644100,1672647071,2971
7696,3921211276,3737079798,1672647052,1672648989,1937
7795,3701967560,3458539365,1672689626,1672692170,2544
7898,3222521619,3757602960,1672635974,1672637902,1928
7634,3418534998,3666457294,1672696860,1672697070,210
7664,3777514571,3280964728,1672596991,1672599338,2347
7750,3791901535,3512567240,1672579287,1672579373,86
7500,3519152550,3378686918,1672559247,1672560868,1621
7852,3666507626,3812176780,1672641875,1672643467,1592
7878,3760267716,3757161914,1672689640,1672689969,329
7948,3505869747,3713894336,1672610432,1672613907,3475
7810,3778341199,3931941795,1672643871,1672645258,1387
7816,3805342762,3703735129,1672612102,1672612406,304
7830,3793959750,3898995675,1672594465,1672596269,1804
7797,3296471982,3501927421,1672580340,1672581176,836
7879,3779629905,3311065516,1672544216,1672544805,589
7946,3505702787,3426325549,1672668090,1672668341,251
7703,3416241005,3777477395,1672558121,1672559873,1752
7817,3760569731,3755436115,1672614596,1672616131,1535
7891,3715581279,3369998498,1672644899,1672648326,3427
7720,3701898991,3380035798,1672567783,1672568024,241
7750,3755798867,3519912874,1672646539,1672649281,2742
7974,3776338577,3487171044,1672681080,1672683541,2461
7963,3533193862,3313541986,1672641123,1672642691,1568
7810,3501483568,3511687358,1672696633,1672698806,2173
7927,3857349323,3819727225,1672543562,1672546111,2549
7655,3337544549,3379589402,1672681757,1672684050,2293
7937,3331845324,3770021824,1672589312,1672589757,445
7661,3922275620,3903307060,1672571290,1672572352,1062
7544,3430504438,3972709319,1672575899,1672577419,1520
7935,3778108318,3397418363,1672636323,1672639254,2931
7804,3513080274,3485008994,1672696237,1672698247,2010
7492,3777623166,3483949762,1672633362,1672634367,1005
7595,3303751772,3509453566,1672633943,1672635579,1636
7570,3811171116,3311065516,1672665875,1672667182,1307
7881,3773120434,3760489031,1672608646,1672608789,143
7860,3514472925,3608633356,1672661807,1672665036,3229
7863,3757246925,3791553060,1672628234,1672631298,3064
7690,3772884106,3242408357,1672648370,1672651636,3266
7806,3755881905,3777120536,1672693610,1672696749,3139
7559,3978115672,3485823740,1672608602,1672610561,1959
7906,3405494240,3826415738,1672617747,1672618588,841
7900,3760267716,3514838220,1672627203,1672629700,2497
7489,3511267139,3760183458,1672630173,1672632467,2294
7503,3716273414,3624761861,1672680490,1672681070,580
7913,3851190615,3448855696,1672570999,1672573179,2180
7876,3826415738,3481502100,1672600003,1672600876,873
7524,3244389794,3512217942,1672628254,1672628780,526
7728,3505973226,3736592744,1672637240,1672639781,2541
7842,3394330287,3817621391,1672688832,1672692376,3544
7580,3801089989,3714488548,1672591734,1672592720,986
7779,3715998609,3716197887,1672538397,1672539968,1571
7542,3208844525,3715981584,1672561335,1672562260,925
7763,3513201436,3634786711,1672563388,1672565067,1679
7664,3774466457,3616944364,1672601006,1672602351,1345
7706,3446948848,3402943525,1672682814,1672683327,513
7761,3512567240,3778108318,1672580144,1672580236,92
7483,3629935998,3772746272,1672577248,1672580095,2847
7829,3791901535,3480687894,1672593051,1672593849,798
7596,3736229191,3774298222,1672637986,1672639119,1133
7819,3511198618,3511163800,1672694471,1672696113,1642
7917,3823600322,3417970574,1672555474,1672555933,459
7839,3616944364,3701184889,1672533135,1672536096,2961
7521,3518496488,3774005526,1672533823,1672535837,2014
7865,3836573197,3793871337,1672626074,1672627665,1591
7726,3935627557,3519703355,1672693185,1672694655,1470
7542,3909606423,3533371364,1672690945,1672691249,304
7792,3467773920,3760509236,1672606238,1672609182,2944
7563,3334033993,3284832486,1672607451,1672607935,484
7914,3206254161,3311648200,1672700339,1672703434,3095
7610,3783245561,3453729665,1672553712,1672554436,724
7645,3757447189,3365830990,1672681391,1672682063,672
7504,3234362962,3511359172,1672606933,1672610456,3523
7632,3774195321,3511125626,1672641058,1672644592,3534
7676,3776066388,3791334389,1672555330,1672557131,1801
7747,3714821932,3777120536,1672662752,1672664736,1984
7855,3701863557,3235287260,1672632665,1672632741,76
7746,3710067113,3760992710,1672564892,1672568001,3109
7570,3756453423,3501184421,1672535385,1672538958,3573
7963,3904775198,3774580701,1672608566,1672610878,2312
7907,3434642576,3774466457,1672648326,1672649401,1075
7498,3826633236,3757161914,1672668251,1672670856,2605
7569,3396086535,3519703355,1672534509,1672537870,3361
7729,3510711755,3517963492,1672671909,1672672416,507
7828,3715189301,3755436115,1672539608,1672541674,2066
7724,3779218771,3837094550,1672656034,1672657166,1132
7671,3311274543,3899266183,1672592593,1672595548,2955
7549,3404384505,3777983879,1672594372,1672594819,447
7596,3829232696,3757246925,1672587204,1672588252,1048
7745,3302626661,3773664987,1672642557,1672643710,1153
7953,3501759100,3496549058,1672688939,1672690357,1418
7501,3909331423,3278365525,1672702962,1672705517,2555
7847,3793848402,3891751546,1672680372,1672683651,3279
7586,3688683847,3439023335,1672570680,1672573734,3054
7833,3517509185,3247815299,1672635257,1672636574,1317
7548,3362000049,3293695955,1672695127,1672696368,1241
7516,3451432842,3311274543,1672678273,1672680666,2393
7636,3615046771,3387674757,1672620404,1672621045,641
7983,3779218771,3388637594,1672668555,1672671604,3049
7962,3515723720,3554917400,1672561407,1672563803,2396
7557,3311324983,3903307060,1672681724,1672684387,2663
7897,3439023335,3505973226,1672692817,1672696188,3371
7844,3916289176,3428964059,1672575163,1672575460,297
7832,3417587765,3201432789,1672610603,1672612729,2126
7760,3615046771,3311993075,1672603990,1672606384,2394
7656,3903009525,3358871377,1672612844,1672614828,1984
7613,3772714862,3791942683,1672635778,1672636903,1125
7850,3935627557,3859663348,1672601813,1672604646,2833
7832,3777936328,3298433163,1672614234,1672616428,2194
7777,3757246925,3359239884,1672574394,1672576426,2032
7750,3514719601,3432689543,1672625620,1672627283,1663
7723,3301107849,3428964059,1672597675,1672600715,3040
7912,3359239884,3760489031,1672692376,1672694218,1842
7703,3534010629,3885897503,1672555426,1672557502,2076
7720,3516716179,3760561634,1672638119,1672641170,3051
7962,3770824086,3367029997,1672561986,1672563816,1830
7630,3792902982,3459030804,1672544507,1672545733,1226
7562,3519428855,3774204963,1672624345,1672624934,589
7734,3550946908,3509453566,1672574025,1672576148,2123
7511,3510703546,3914259449,1672540788,1672540895,107
7545,3505201246,3421127249,1672622455,1672623345,890
7924,3399911573,3396285984,1672700992,1672702645,1653
7515,3518014636,3360743849,1672693392,1672693884,492
7493,3828365570,3505201246,1672662758,1672665161,2403
7486,3516514391,3427219654,1672641860,1672643249,1389
7623,3774366875,3512683609,1672610176,1672612419,2243
7619,3772714862,3520030713,1672690941,1672691505,564
7496,3770851318,3484995752,1672682778,1672682927,149
7729,3505292701,3513956646,1672673088,1672675918,2830
7575,3512349371,3513956646,1672590424,1672591406,982
7877,3515151980,3772884106,1672654414,1672656370,1956
7571,3516016437,3780974443,1672659900,1672661203,1303
7689,3520719611,3859663348,1672655434,1672656327,893
7633,3701146057,3466229085,1672597802,1672599837,2035
7729,3734496778,3779976989,1672648548,1672651506,2958
7542,3311439795,3370752401,1672703680,1672704384,704
7562,3755511676,3519556068,1672665435,1672666113,678
7869,3774501422,3514283243,1672588193,1672590099,1906
7908,3664170666,3500904641,1672695901,1672698718,2817
7712,3829319703,3277669002,1672668321,1672671408,3087
7502,3774066725,3800886801,1672566172,1672568521,2349
7927,3855424474,3979339287,1672581421,1672584213,2792
7939,3701146057,3755798867,1672608909,1672610180,1271
7649,3311603601,3505173328,1672694506,1672695036,530
7929,3772309166,3372883226,1672582258,1672585361,3103
7620,3780593036,3774556560,1672688341,1672690193,1852
7777,3556951786,3430504438,1672598810,1672601544,2734
7579,3501483568,3626156564,1672591114,1672593434,2320
7577,3715974031,3777717988,1672639457,1672639664,207
7711,3780294829,3615046771,1672567194,1672569747,2553
7610,3756462516,3367902229,1672658845,1672659583,738
7504,3394330287,3451432842,1672551656,1672554076,2420
7759,3777936328,3930797455,1672564362,1672566014,1652
7958,3501730685,3890149705,1672549566,1672550036,470
7765,3519912874,3914259449,1672598406,1672601359,2953
7506,3828624701,3412980697,1672605831,1672608015,2184
7656,3357483218,3550946908,1672531714,1672533966,2252
7648,3792844210,3314245084,1672573236,1672576804,3568
7726,3385763781,3701178711,1672585520,1672586523,1003
7905,3760492950,3930797455,1672546523,1672549170,2647
7690,3427283336,3352603894,1672603870,1672604670,800
7739,3772337814,3918584946,1672607169,1672608952,1783
7960,3909238838,3421127249,1672695645,1672697052,1407
7911,3359910781,3512510536,1672676245,1672678114,1869
7514,3791594391,3534010629,1672666389,1672666833,444
7977,3467773920,3911245524,1672573254,1672575300,2046
7828,3509453566,3247780536,1672677463,1672678675,1212
7893,3518260334,3715998609,1672638707,1672640726,2019
7623,3770447408,3605726278,1672600307,1672603009,2702
7905,3772642849,3715339701,1672698714,1672701306,2592
7624,3348261553,3394330287,1672670868,1672671498,630
7944,3490191091,3490191091,1672542156,1672544927,2771
7532,3244485293,3827377568,1672561353,1672564728,3375
7504,3730517636,3432689543,1672645183,1672648050,2867
7587,3533748232,3516629436,1672596388,1672597430,1042
7878,3791553060,3485375593,1672542412,1672545664,3252
7584,3516016437,3801089989,1672609111,1672611416,2305
7633,3509604974,3505962865,1672657458,1672659194,1736
7722,3244436890,3534191820,1672667363,1672668736,1373
7543,3774793839,3823600322,1672609133,1672610728,1595
7636,3228165483,3736592744,1672606040,1672607333,1293
7600,3809484172,3835382117,1672597301,1672598106,805
7831,3312829208,3516606733,1672650865,1672652840,1975
7753,3332072298,3277939457,1672575225,1672577335,2110
7867,3482405588,3836573197,1672689842,1672689903,61
7929,3420432297,3429856982,1672659662,1672660375,713
7800,3780365428,3209383861,1672557099,1672559439,2340
7886,3228165483,3914290246,1672693067,1672695206,2139
7542,3880310724,3533927138,1672535933,1672536324,391
7639,3898995675,3396285984,1672622636,1672625308,2672
7495,3404384505,3516606733,1672658968,1672661368,2400
7793,3772309150,3518014636,1672599955,1672601394,1439
7591,3380035798,3311415018,1672548549,1672549166,617
7489,3716488385,3939952128,1672614900,1672615846,946
7855,3511163800,3510771358,1672534955,1672538376,3421
7735,3316222192,3287105466,1672696573,1672699255,2682
7794,3511267139,3805292782,1672533164,1672534933,1769
7836,3793286136,3338703270,1672698345,1672700363,2018
7589,3311274543,3365278081,1672602490,1672605593,3103
7506,3731106822,3828624701,1672670148,1672673699,3551
7918,3520183192,3756623396,1672670070,1672673344,3274
7489,3344364444,3517459919,1672538385,1672538933,548
7983,3783705817,3881477378,1672589191,1672590630,1439
7702,3399535232,3898995675,1672621576,1672623819,2243
7819,3777790718,3501184421,1672665515,1672667863,2348
7541,3773950140,3344364444,1672613032,1672616537,3505
7636,3475795792,3634340855,1672582944,1672583979,1035
7958,3622054816,3515723720,1672565639,1672565956,317
7922,3291235378,3792288302,1672572681,1672573698,1017
7964,3685818092,3404384505,1672596742,1672597492,750
7596,3421127249,3378092448,1672671759,1672674858,3099
7924,3500229033,3404384505,1672542669,1672545314,2645
7820,3514128943,3429690204,1672570024,1672572031,2007
7539,3533137446,3703661585,1672623083,1672624699,1616
7568,3276993580,3792768129,1672654200,1672656484,2284
7871,3318697153,3514283243,1672684300,1672687260,2960
7604,3716746253,3519428855,1672619317,1672620724,1407
7597,3517255726,3273500349,1672539145,1672541083,1938
7719,3760561634,3284639858,1672690071,1672691077,1006
7582,3715581279,3716537575,1672627983,1672628067,84
7775,3634995491,3501955238,1672613828,1672616036,2208
7567,3608633356,3777120536,1672552679,1672555670,2991
7483,3311152102,3783705817,1672608873,1672609073,200
7787,3206593906,3922337974,1672699169,1672700095,926
7793,3757403279,3500729955,1672613713,1672615020,1307
7638,3346327502,3496051529,1672621298,1672622959,1661
7663,3621810464,3209383861,1672551674,1672553411,1737
7684,3736786443,3501486692,1672691865,1672693316,1451
7915,3304625412,3936227020,1672531801,1672532618,817
7840,3388286531,3533927138,1672606178,1672608456,2278
7775,3910454786,3512540951,1672689091,1672691526,2435
7708,3287105466,3774366875,1672688931,1672691697,2766
7565,3792768129,3520709480,1672683698,1672684403,705
7978,3827626797,3500229033,1672692754,1672694646,1892
7802,3773465237,3715981584,1672676071,1672677167,1096
7800,3880285638,3514472925,1672632372,1672633238,866
7801,3466911760,3200198928,1672683588,1672683806,218
7516,3429856982,3883861463,1672676188,1672679502,3314
7693,3755920131,3793753089,1672672513,1672673014,501
7652,3822654369,3303751772,1672545129,1672547806,2677
7688,3512540951,3516065852,1672590102,1672592056,1954
7982,3779976989,3520730271,1672670767,1672673161,2394
7546,3277669002,3385763781,1672554733,1672557913,3180
7954,3280964728,3773598056,1672570968,1672572553,1585
7618,3475396323,3510126867,1672610743,1672611681,938
7548,3516039895,3511125626,1672565643,1672569169,3526
7896,3792032359,3825229501,1672671807,1672674238,2431
7615,3534424200,3772758337,1672557172,1672559520,2348
7721,3200198928,3776066388,1672651110,1672652700,1590
7680,3509604974,3500994774,1672597265,1672597972,707
7782,3917088658,3792768129,1672540387,1672543235,2848
7957,3976633198,3685187183,1672670469,1672672417,1948
7967,3311415018,3624761861,1672597581,1672600806,3225
7595,3238712269,3314245084,1672537328,1672537835,507
7947,3773664987,3760267716,1672601414,1672601777,363
7601,3505292701,3407673904,1672642724,1672643912,1188
7613,3774195321,3505530961,1672657131,1672659234,2103
7781,3780639480,3774556560,1672700678,1672701662,984
7665,3777806071,3501601840,1672597963,1672598056,93
7497,3809916577,3809484172,1672623813,1672624728,915
7522,3231056870,3756930948,1672691349,1672694542,3193
7941,3818255890,3760077057,1672662228,1672663283,1055
7846,3465202715,3365942576,1672691280,1672692465,1185
7820,3533025282,3513164386,1672647185,1672648623,1438
7860,3534191820,3793436995,1672616197,1672617849,1652
7783,3912262917,3774366875,1672589438,1672589947,509
7604,3701178711,3755042098,1672570542,1672572338,1796
7794,3360993964,3509604974,1672648236,1672651045,2809
7495,3780639480,3756623396,1672615288,1672617370,2082
7551,3760598102,3755920131,1672633149,1672635881,2732
7899,3501184421,3346327502,1672591466,1672592515,1049
7873,3458539365,3711973519,1672625553,1672626290,737
7560,3770635361,3485375593,1672697557,1672698699,1142
7964,3917278625,3517721725,1672643047,1672644022,975
7931,3783126683,3703955926,1672653295,1672653937,642
7569,3773598056,3231056870,1672558660,1672561779,3119
7871,3791901535,3365614305,1672702833,1672705773,2940
7558,3520751702,3344019610,1672565394,1672567767,2373
7744,3757403279,3505791599,1672615569,1672618378,2809
7768,3780788622,3776066388,1672615905,1672619111,3206
7561,3779976989,3883312122,1672557541,1672560519,2978
7748,3311993075,3297463265,1672576021,1672578862,2841
7529,3756930948,3733891182,1672619269,1672621823,2554
7520,3311208440,3475795792,1672641864,1672644873,3009
7705,3857349323,3793962300,1672535438,1672538344,2906
7929,3311648200,3512349371,1672695130,1672696452,1322
7777,3200691026,3936227020,1672640224,1672641195,971
7681,3777079686,3428964059,1672601736,1672602337,601
7751,3936227020,3835382117,1672551501,1672553630,2129
7786,3932051427,3770447408,1672658393,1672660902,2509
7965,3311761694,3510173870,1672661259,1672663604,2345
7939,3611150562,3970117174,1672556589,1672558131,1542
7822,3311871871,3246596716,1672661167,1672661635,468
7929,3716258994,3467773920,1672625179,1672627140,1961
7864,3800886801,3316173088,1672594084,1672595022,938
7595,3701184889,3710098970,1672553271,1672554506,1235
7819,3606186086,3773755137,1672567564,1672569943,2379
7573,3757151210,3818255890,1672574740,1672577226,2486
7617,3778341199,3501759100,1672545292,1672546704,1412
7605,3629935998,3364543015,1672621063,1672623433,2370
7537,3510380060,3915628728,1672661178,1672663241,2063
7833,3518496488,3608633356,1672621400,1672622409,1009
7618,3247428249,3825229501,1672553301,1672553869,568
7721,3510857360,3280599164,1672574750,1672575712,962
7806,3516980378,3505292701,1672669110,1672672371,3261
7962,3209048907,3500374658,1672535007,1672535097,90
7836,3352603894,3826759140,1672594405,1672597921,3516
7823,3903307060,3360506772,1672623914,1672624102,188
7802,3519700826,3402943525,1672605267,1672607623,2356
7633,3311993075,3386707783,1672552323,1672554316,1993
7777,3624761861,3701065786,1672622999,1672625115,2116
7628,3430504438,3791334389,1672661890,1672663441,1551
7948,3605726278,3772309150,1672668006,1672671601,3595
7967,3459030804,3428006164,1672559551,1672561450,1899
7812,3429690204,3473562469,1672620008,1672620567,559
7795,3917278625,3459030804,1672612775,1672615981,3206
7942,3209048907,3534492426,1672592338,1672592570,232
7498,3420700674,3802367797,1672633138,1672633691,553
7947,3737154119,3778341199,1672577943,1672579756,1813
7658,3734828619,3664170666,1672665405,1672667949,2544
7710,3490191091,3857349323,1672662135,1672663042,907
7647,3688683847,3817316561,1672665101,1672665293,192
7513,3791594391,3505649239,1672552920,1672554460,1540
7744,3391915886,3501927421,1672598580,1672600534,1954
7554,3505962865,3773814927,1672602407,1672602786,379
7903,3296471982,3510771358,1672646819,1672649483,2664
7849,3792288302,3238712269,1672538043,1672541514,3471
7747,3779528381,3730517636,1672698218,1672699100,882
7718,3780813786,3714504419,1672618994,1672619394,400
7831,3777717988,3492478793,1672634229,1672635399,1170
7950,3622054816,3791657947,1672591760,1672592956,1196
7496,3311603601,3518360734,1672654126,1672655532,1406
7710,3509604974,3820354437,1672588352,1672590547,2195
7705,3839849341,3517459919,1672674872,1672676865,1993
7897,3311065516,3710067113,1672563515,1672566290,2775
7931,3372883226,3738274418,1672685488,1672687526,2038
7529,3534488837,3624761861,1672699326,1672702376,3050
7897,3231056870,3496051529,1672700571,1672702528,1957
7842,3515125508,3344019610,1672533947,1672537430,3483
7671,3901990690,3511359172,1672641490,1672642930,1440
7823,3510857360,3318697153,1672549414,1672549582,168
7620,3271938399,3415546117,1672625560,1672629026,3466
7970,3826759140,3400918687,1672612332,1672612650,318
7881,3889232789,3883312122,1672628427,1672629895,1468
7758,3391915121,3534010629,1672609086,1672611587,2501
7696,3235635976,3511359172,1672686990,1672688126,1136
7830,3293695955,3918056059,1672538686,1672541698,3012
7793,3516465662,3518496488,1672609871,1672610138,267
7956,3792288302,3360506772,1672544344,1672545985,1641
7730,3820354437,3639847263,1672646490,1672646917,427
7936,3505883609,3791901535,1672576005,1672578190,2185
7810,3780788622,3888559320,1672598151,1672600801,2650
7532,3737079798,3512349371,1672619473,1672621839,2366
7759,3501606184,3556951786,1672545674,1672547465,1791
7602,3780828689,3311152102,1672636519,1672639282,2763
7813,3236102733,3731419510,1672682258,1672685206,2948
7691,3780974443,3396086535,1672634822,1672637933,3111
7534,3756027749,3505912939,1672541491,1672544246,2755
7785,3311065516,3816853177,1672532070,1672535302,3232
7822,3338367113,3716168623,1672537929,1672538927,998
7864,3780503655,3505347134,1672586524,1672588056,1532
7544,3703661585,3500066230,1672565457,1672565529,72
7711,3621810464,3755042098,1672701155,1672702391,1236
7880,3287105466,3627937312,1672571970,1672575228,3258
7794,3777079686,3780639480,1672592599,1672594986,2387
7775,3618045231,3515394721,1672655147,1672655738,591
7745,3777717988,3339907603,1672644090,1672646931,2841
7679,3604539807,3311208440,1672670298,1672671652,1354
7670,3500229033,3415443558,1672685171,1672687194,2023
7571,3345207877,3607748895,1672658107,1672660778,2671
7953,3852595551,3534702203,1672670256,1672670964,708
7847,3288764520,3519803045,1672656555,1672659580,3025
7820,3792253549,3823600322,1672684553,1672685976,1423
7925,3509352754,3481502100,1672567225,1672568426,1201
7740,3509672210,3515691540,1672599984,1672600064,80
7982,3426325549,3886298125,1672702587,1672705655,3068
7755,3666507626,3386707783,1672689180,1672692023,2843
7668,3391915121,3783206719,1672588377,1672590783,2406
7937,3760561634,3817316561,1672602288,1672605153,2865
7490,3755392666,3517864478,1672580435,1672580664,229
7710,3520012395,3311871871,1672547952,1672548294,342
7690,3533827120,3805519285,1672692224,1672695314,3090
7726,3611150562,3490191091,1672622925,1672623956,1031
7918,3772544062,3249791738,1672570371,1672572181,1810
7667,3332072298,3501955238,1672574482,1672575478,996
7723,3338703270,3500803339,1672678498,1672680305,1807
7797,3518360734,3834257412,1672552261,1672554775,2514
7633,3914290246,3224058172,1672699882,1672700385,503
7686,3774520233,3618045231,1672545958,1672546214,256
7967,3311152102,3515151980,1672654817,1672657328,2511
7677,3757447189,3780593036,1672634451,1672634876,425
7831,3714197325,3939952128,1672606953,1672610341,3388
7784,3277669002,3314245084,1672656652,1672657477,825
7767,3793627961,3511267139,1672582635,1672582922,287
7842,3316222192,3910454786,1672689635,1672692423,2788
7982,3895562476,3714474557,1672616799,1672619179,2380
7968,3666457294,3770763956,1672610745,1672614101,3356
7939,3903307060,3888559320,1672677421,1672679327,1906
7799,3285400528,3208844525,1672577260,1672578792,1532
7820,3793338102,3778108318,1672659134,1672660883,1749
7741,3730517636,3935627557,1672683896,1672685662,1766
7508,3533810360,3887270940,1672531989,1672534851,2862
7637,3773755137,3220716272,1672615766,1672619025,3259
7793,3489545239,3378436155,1672666517,1672669086,2569
7870,3360743849,3715492942,1672576411,1672579613,3202
7731,3512142794,3823600322,1672549169,1672551820,2651
7607,3501730685,3791553060,1672609956,1672611802,1846
7521,3807987001,3774050956,1672628970,1672631214,2244
7741,3513201436,3516716179,1672696105,1672698478,2373
7629,3772642849,3516673015,1672661964,1672665104,3140
7520,3774298222,3500499542,1672675318,1672675737,419
7947,3736790081,3914259449,1672585883,1672588474,2591
7823,3519803045,3904408902,1672653449,1672656006,2557
7575,3793848402,3454042520,1672591420,1672592713,1293
7570,3311208440,3515860749,1672544998,1672546879,1881
7610,3828365570,3396285984,1672631196,1672634594,3398
7605,3475396323,3777623166,1672576782,1672579247,2465
7767,3637008488,3616944364,1672633827,1672636253,2426
7749,3792473331,3736625083,1672539693,1672540704,1011
7812,3922337974,3201848640,1672652363,1672652463,100
7740,3417587765,3420432297,1672631825,1672633345,1520
7669,3922275416,3516629436,1672702197,1672705245,3048
7646,3773465237,3912536808,1672663788,1672666384,2596
7626,3331845324,3505904952,1672697347,1672700848,3501
7618,3505859863,3227158514,1672652728,1672654432,1704
7558,3600647945,3516629436,1672592243,1672593330,1087
7558,3316173088,3714504419,1672673239,1672673360,121
7914,3783531004,3777717988,1672551723,1672554905,3182
7664,3703275621,3773664987,1672581778,1672584626,2848
7814,3774195321,3710569131,1672605478,1672607804,2326
7485,3903307060,3229665776,1672687210,1672689194,1984
7568,3555214688,3516716179,1672649715,1672652532,2817
7837,3713349754,3716488385,1672605919,1672606207,288
7854,3519428855,3667680268,1672532661,1672533673,1012
7747,3496269445,3360506772,1672572932,1672574613,1681
7689,3733189298,3373384732,1672543967,1672544565,598
7732,3415546117,3715189301,1672564029,1672565885,1856
7864,3660493209,3534492426,1672660620,1672661346,726
7597,3430074045,3913251733,1672542572,1672543456,884
7770,3365942576,3770447408,1672584710,1672586816,2106
7950,3711370563,3909606423,1672656530,1672657967,1437
7500,3713349754,3713630656,1672622374,1672623138,764
7871,3346795719,3280964728,1672633108,1672633750,642
7945,3912536808,3515284591,1672542642,1672546237,3595
7736,3777623166,3235287260,1672554324,1672556915,2591
7958,3501364586,3465202715,1672546880,1672549267,2387
7713,3783509527,3509352754,1672626224,1672629814,3590
7791,3715339701,3662180254,1672535393,1672538707,3314
7927,3736229191,3818255890,1672695917,1672697820,1903
7903,3454042520,3701190899,1672690777,1672692074,1297
7604,3772642849,3490191091,1672536196,1672537197,1001
7609,3387966152,3279721246,1672661916,1672662645,729
7866,3882242815,3421127249,1672566577,1672567340,763
7566,3534729133,3735733948,1672563399,1672565157,1758
7573,3774339795,3793627961,1672606080,1672606287,207
7845,3899204805,3511267139,1672620811,1672621125,314
7689,3755042098,3277939457,1672658598,1672660738,2140
7927,3760294205,3489217083,1672631853,1672632627,774
7735,3475795792,3378092448,1672570225,1672572845,2620
7711,3777983879,3714962248,1672552869,1672556426,3557
7587,3311415018,3793470489,1672568162,1672568489,327
7693,3520931254,3273500349,1672556347,1672558946,2599
7820,3472130842,3487171044,1672578165,1672580995,2830
7709,3360506772,3344019610,1672662402,1672665491,3089
7799,3246596716,3918056059,1672590510,1672591034,524
7919,3534553510,3505193212,1672640389,1672643847,3458
7661,3737154119,3402943525,1672644144,1672644547,403
7872,3296471982,3807987001,1672545194,1672548239,3045
7759,3501198706,3613683164,1672605884,1672608635,2751
7944,3910886626,3443698222,1672672492,1672674956,2464
7500,3610695419,3701274634,1672629198,1672629388,190
7539,3312829208,3774066725,1672571792,1672574370,2578
7766,3800353779,3703735129,1672649393,1672652139,2746
7851,3713808837,3909238838,1672632667,1672633782,1115
7523,3774580701,3774501422,1672541806,1672542057,251
7581,3480687894,3760561634,1672546274,1672549772,3498
7749,3401627165,3800353779,1672686034,1672688236,2202
7572,3755872268,3395152943,1672639116,1672640975,1859
7946,3809484172,3828432634,1672700060,1672703526,3466
7867,3776948966,3760267716,1672544112,1672544693,581
7552,3737051610,3730517636,1672677105,1672679437,2332
7617,3801089989,3337544549,1672601152,1672601493,341
7578,3772309150,3793286136,1672571978,1672574645,2667
7643,3792032359,3791553060,1672626590,1672627700,1110
7829,3515125508,3338703270,1672562576,1672564255,1679
7710,3783705817,3755625324,1672676835,1672679379,2544
7748,3500229033,3454042520,1672606042,1672608452,2410
7966,3703889596,3701898991,1672537351,1672540324,2973
7563,3392121505,3221536550,1672603269,1672604636,1367
7700,3412825109,3453729665,1672540263,1672542340,2077
7518,3339907603,3755042098,1672539370,1672540468,1098
7877,3756453423,3734828619,1672612381,1672614407,2026
7961,3912262917,3439023335,1672561226,1672561756,530
7858,3911159965,3505702787,1672677775,1672679441,1666
7500,3288764520,3859663348,1672576914,1672579592,2678
7691,3770078063,3478194807,1672682375,1672684477,2102
7675,3505362057,3853018906,1672663762,1672666813,3051
7499,3501486692,3802367797,1672703681,1672706884,3203
7783,3427283336,3931941795,1672633358,1672636680,3322
7547,3223789409,3809916577,1672687170,1672688689,1519
7546,3918247820,3618873142,1672563448,1672565728,2280
7513,3972709319,3280615985,1672693148,1672694842,1694
7491,3338367113,3417061462,1672565461,1672566478,1017
7821,3307097200,3855937514,1672545074,1672548494,3420
7886,3342131135,3303705369,1672701431,1672702344,913
7606,3792473331,3829232696,1672543110,1672545327,2217
7875,3465202715,3417587765,1672614119,1672615079,960
7484,3360506772,3836573197,1672655672,1672657065,1393
7655,3783531004,3242408357,1672593346,1672593817,471
7668,3276993580,3534010629,1672592362,1672594926,2564
7599,3362000049,3517864478,1672535029,1672537013,1984
7556,3377766165,3399911573,1672594910,1672597101,2191
7655,3533280269,3481502100,1672548472,1672551365,2893
7978,3404058699,3701534009,1672679530,1672683085,3555
7546,3227457126,3509672210,1672691423,1672691932,509
7918,3293695955,3636867411,1672666827,1672669424,2597
7583,3885897503,3519703355,1672536310,1672537034,724
7689,3280964728,3209383861,1672538010,1672540492,2482
7657,3760893269,3713268590,1672589407,1672591148,1741
7825,3739106581,3791901535,1672609541,1672610609,1068
7972,3367029997,3221899927,1672571400,1672574635,3235
7559,3516673015,3809916577,1672690000,1672691672,1672
7554,3757403279,3685818092,1672572574,1672574959,2385
7915,3311203656,3247780536,1672685777,1672688126,2349
7838,3278365525,3380035798,1672582002,1672584389,2387
7839,3827222533,3755920131,1672588060,1672589002,942
7554,3467773920,3513454145,1672702763,1672702866,103
7533,3516039895,3391915886,1672604647,1672607108,2461
7488,3933210486,3439023335,1672582780,1672585669,2889
7808,3903009525,3477649378,1672649985,1672651050,1065
7588,3247815299,3516039895,1672665348,1672665443,95
7950,3770078063,3610695419,1672679277,1672679549,272
7685,3715581279,3388637594,1672641855,1672643561,1706
7893,3512837326,3555214688,1672534062,1672534558,496
7820,3430504438,3505135325,1672690780,1672691880,1100
7558,3710344260,3518014636,1672598405,1672601748,3343
7879,3827222533,3634340855,1672557557,1672560928,3371
7839,3314245084,3513956646,1672577230,1672580340,3110
7917,3533242305,3519803045,1672599560,1672601878,2318
7931,3774338212,3859525941,1672566878,1672568626,1748
7914,3284639858,3899204805,1672648174,1672648557,383
7555,3511332835,3757602960,1672676171,1672677458,1287
7748,3918584946,3516960534,1672599168,1672601249,2081
7607,3236102733,3509630174,1672560116,1672562789,2673
7859,3703275621,3716843669,1672535977,1672537495,1518
7592,3783083229,3857349323,1672683170,1672685130,1960
7814,3792883665,3774556560,1672567731,1672570580,2849
7562,3311845971,3793470489,1672656732,1672657682,950
7587,3511267139,3756462516,1672575198,1672575970,772
7801,3386707783,3391915886,1672576502,1672579706,3204
7495,3208844525,3511359172,1672548867,1672550105,1238
7897,3552314511,3937224533,1672583627,1672586536,2909
7546,3505904952,3882242815,1672634186,1672637595,3409
7963,3898995675,3902278226,1672583729,1672585318,1589
7908,3483164654,3760183458,1672573095,1672573770,675
7598,3772359096,3783705817,1672538285,1672539721,1436
7951,3703441914,3505883609,1672562081,1672562997,916
7555,3853018906,3303705369,1672606156,1672609064,2908
7753,3713268590,3773664987,1672552879,1672553778,899
7650,3313541986,3792032359,1672638852,1672639235,383
7846,3338367113,3247428249,1672577983,1672581406,3423
7809,3912536808,3931941795,1672624893,1672627309,2416
7770,3533270638,3512510536,1672607236,1672607453,217
7551,3298433163,3534191820,1672599647,1672602546,2899
7744,3827626797,3837094550,1672573673,1672574953,1280
7565,3485008994,3778341199,1672562769,1672563045,276
7829,3772337814,3735733948,1672579532,1672582793,3261
7804,3500904641,3273500349,1672535539,1672538160,2621
7628,3513599775,3534702203,1672587075,1672589263,2188
7698,3311415018,3811694763,1672541207,1672543606,2399
7565,3780294829,3756623396,1672597432,1672598927,1495
7914,3510247121,3400918687,1672629690,1672632898,3208
7832,3342131135,3505859863,1672610403,1672613700,3297
7601,3515860749,3777443199,1672588798,1672590313,1515
7649,3683959482,3505962865,1672613525,1672615156,1631
7593,3772578994,3228165483,1672539127,1672541671,2544
7945,3772642849,3407725581,1672536033,1672536132,99
7716,3736592744,3839849341,1672666780,1672667919,1139
7567,3224058172,3910886626,1672647713,1672650130,2417
7725,3792177074,3373384732,1672636705,1672638928,2223
7871,3777717988,3500374658,1672656237,1672659716,3479
7906,3783509527,3930791338,1672687169,1672687709,540
7874,3800886801,3417970574,1672698737,1672699638,901
7529,3666507626,3302626661,1672671475,1672673682,2207
7775,3533927138,3793627961,1672635690,1672637177,1487
7659,3637008488,3828624701,1672584154,1672586997,2843
7501,3490191091,3407725581,1672540561,1672541069,508
7582,3817621391,3313564074,1672685896,1672688704,2808
7871,3533626375,3605726278,1672673846,1672674783,937
7925,3311203656,3344019610,1672683066,1672686442,3376
7861,3396285984,3829764737,1672668237,1672669056,819
7970,3519703355,3244389794,1672604089,1672606770,2681
7811,3800886801,3918584946,1672600678,1672603098,2420
7731,3783083229,3733891182,1672673080,1672676513,3433
7832,3520751702,3426325549,1672674842,1672677500,2658
7706,3311152102,3701898991,1672697223,1672697382,159
7965,3772578994,3770763956,1672680315,1672682979,2664
7611,3370636709,3791594391,1672563053,1672565625,2572
7825,3858918246,3922275620,1672586549,1672589671,3122
7972,3774195321,3703223015,1672628746,1672631269,2523
7517,3500199935,3926700506,1672615593,1672618358,2765
7752,3899371911,3899371911,1672699766,1672701840,2074
7817,3772578994,3516960534,1672596644,1672597210,566
7767,3778308417,3312664885,1672640007,1672643306,3299
7637,3511687358,3883042241,1672636716,1672638923,2207
7763,3223968713,3307512479,1672591132,1672594239,3107
7871,3520756859,3311627628,1672540492,1672542690,2198
7682,3505201246,3505869747,1672574497,1672576104,1607
7586,3384240055,3533626375,1672641523,1672643455,1932
7616,3839849341,3555214688,1672633662,1672634123,461
7895,3515151980,3500499542,1672635212,1672637159,1947
7704,3519563836,3516960534,1672549233,1672549936,703
7557,3828365570,3613683164,1672564046,1672567106,3060
7892,3818255890,3516960534,1672662925,1672665042,2117
7774,3391261292,3606812411,1672669999,1672673573,3574
7707,3710098970,3509634629,1672667491,1672667921,430
7575,3514245078,3517077106,1672534029,1672536326,2297
7816,3780974443,3249247700,1672623751,1672626550,2799
7754,3515860749,3510771358,1672648094,1672650885,2791
7490,3852391257,3904775198,1672593886,1672596598,2712
7655,3391915121,3756021689,1672613800,1672616020,2220
7708,3774125065,3448855696,1672615592,1672616993,1401
7699,3902383721,3489728806,1672617916,1672619522,1606
7720,3411618230,3344019610,1672606387,1672608488,2101
7971,3493507965,3201324715,1672556125,1672557277,1152
7872,3429856982,3793389510,1672602096,1672602617,521
7955,3913251733,3514245078,1672679694,1672681899,2205
7499,3517459919,3496051529,1672611354,1672611756,402
7949,3514719601,3467773920,1672612699,1672614245,1546
7880,3716488385,3914259449,1672552772,1672555063,2291
7896,3533626375,3399052055,1672585029,1672588183,3154
7898,3520629279,3512720680,1672544795,1672547174,2379
7591,3792768129,3826633236,1672590679,1672593892,3213
7756,3932051427,3311845971,1672571824,1672575238,3414
7517,3899204805,3222448362,1672593386,1672595662,2276
7697,3701065786,3757562897,1672617297,1672618808,1511
7959,3917278625,3773664987,1672660277,1672663790,3513
7791,3777929708,3773429448,1672605488,1672607012,1524
7893,3500729955,3793871337,1672655453,1672658450,2997
7675,3387674757,3778305740,1672612205,1672612472,267
7690,3505649239,3756966035,1672559148,1672560099,951
7782,3512567240,3793436995,1672685229,1672685995,766
7793,3917088658,3348261553,1672639943,1672640075,132
7750,3405494240,3556951786,1672595203,1672596542,1339
7832,3223789409,3903009525,1672659201,1672662625,3424
7665,3622054816,3774338212,1672552530,1672554964,2434
7829,3777514571,3976390453,1672675163,1672676648,1485
7756,3401627165,3520183192,1672574694,1672575286,592
7946,3500177712,3481502100,1672689408,1672690260,852
7685,3773978034,3515125508,1672586021,1672586582,561
7646,3882997884,3819727225,1672609839,1672610496,657
7649,3500229033,3792253549,1672629420,1672631645,2225
7630,3780813786,3501606184,1672640789,1672641438,649
7655,3883312122,3716273414,1672532261,1672535281,3020
7669,3710112546,3418534998,1672610892,1672612196,1304
7695,3500458761,3733891182,1672545581,1672547158,1577
7483,3399004969,3407725581,1672648754,1672651775,3021
7858,3601879040,3500374658,1672699287,1672701467,2180
7515,3760267716,3389115045,1672573636,1672574227,591
7665,3778108318,3774338212,1672569669,1672573018,3349
7569,3713786889,3778980116,1672638863,1672641936,3073
7845,3972709319,3783239924,1672544434,1672544563,129
7520,3772578994,3756021689,1672629546,1672629825,279
7908,3901990690,3978105277,1672535469,1672536002,533
7812,3209027249,3703735129,1672678366,1672681605,3239
7777,3618045231,3881477378,1672567288,1672568768,1480
7836,3510244400,3685818092,1672584484,1672586906,2422
7774,3606987130,3510857360,1672696624,1672697795,1171
7933,3291883916,3448855696,1672550048,1672551130,1082
7760,3618873142,3520190170,1672678297,1672681176,2879
7765,3386707783,3827626797,1672616073,1672616337,264
7847,3500729955,3244436890,1672603241,1672604712,1471
7925,3710098970,3383661227,1672551103,1672551181,78
7882,3839849341,3344019610,1672628563,1672630622,2059
7524,3701898991,3826759140,1672607458,1672610615,3157
7863,3757447189,3910886626,1672624933,1672627128,2195
7530,3552314511,3311065516,1672608322,1672610381,2059
7597,3500499542,3500803339,1672667732,1672668368,636
7532,3380035798,3710344260,1672649170,1672650667,1497
7694,3792902982,3816454165,1672649000,1672650412,1412
7980,3534729133,3409474775,1672689665,1672691683,2018
7894,3774195321,3315583351,1672546693,1672548642,1949
7669,3511435497,3318697153,1672632380,1672635964,3584
7886,3533927138,3517476351,1672581274,1672582417,1143
7614,3501364586,3737154119,1672549683,1672552981,3298
7804,3885670556,3777455223,1672638047,1672639033,986
7566,3509604974,3772053179,1672584575,1672586343,1768
7511,3703789494,3909606423,1672582713,1672584696,1983
7599,3898995675,3533385867,1672670512,1672673124,2612
7500,3701146057,3858918246,1672554965,1672557387,2422
7609,3288764520,3388286531,1672601994,1672602361,367
7723,3465202715,3434642576,1672683428,1672684481,1053
7743,3533827120,3711370563,1672549946,1672551847,1901
7604,3505635228,3834257412,1672584609,1672585275,666
7964,3760492950,3533626375,1672651159,1672654328,3169
7754,3816853177,3713969578,1672609655,1672611927,2272
7682,3755920131,3552314511,1672602650,1672605921,3271
7840,3278365525,3516258476,1672684059,1672686903,2844
7802,3755436115,3666457294,1672541089,1672543462,2373
7849,3505135325,3757602960,1672582766,1672584427,1661
7905,3666553782,3912536808,1672542938,1672543599,661
7649,3345207877,3883551721,1672615560,1672618982,3422
7621,3500374658,3453729665,1672548783,1672551427,2644
7786,3420700674,3303751772,1672619963,1672621519,1556
7918,3501483568,3855937514,1672609905,1672609990,85
7674,3512510536,3828365570,1672570371,1672570826,455
7616,3617734118,3518932404,1672577891,1672579096,1205
7624,3518932404,3336742544,1672688569,1672691877,3308
7488,3515723720,3711380716,1672668849,1672669496,647
7554,3378092448,3411618230,1672685590,1672686262,672
7778,3827377568,3511332835,1672693824,1672696582,2758
7925,3248507722,3703661585,1672550616,1672551696,1080
7945,3778980116,3832902928,1672553484,1672556922,3438
7898,3914259449,3510857360,1672683952,1672684480,528
7501,3519700826,3701984666,1672568545,1672570583,2038
7548,3935127663,3500499542,1672695322,1672698742,3420
7763,3446948848,3713969578,1672567558,1672568105,547
7713,3601879040,3793848402,1672622364,1672625956,3592
7706,3365942576,3815508790,1672603050,1672606545,3495
7942,3716488385,3613995936,1672548836,1672549670,834
7871,3534492426,3716537575,1672675035,1672677767,2732
7973,3703889596,3385763781,1672650180,1672652757,2577
7770,3898995675,3500994774,1672568179,1672569000,821
7700,3509672210,3533095755,1672622921,1672626402,3481
7819,3889750851,3613683164,1672675893,1672676554,661
7590,3755436115,3904775198,1672589964,1672591676,1712
7556,3379589402,3757151210,1672537850,1672540576,2726
7846,3394330287,3427283336,1672545434,1672547992,2558
7595,3511271692,3514283243,1672553918,1672556364,2446
7885,3614238812,3512510536,1672653099,1672655627,2528
7611,3774045700,3534488837,1672700179,1672701312,1133
7935,3703223015,3800886801,1672658294,1672661056,2762
7823,3793848402,3822654369,1672555842,1672556561,719
7924,3417587765,3895562476,1672545891,1672548898,3007
7723,3756021689,3778549126,1672589340,1672592557,3217
7708,3711265369,3793389510,1672694576,1672698023,3447
7882,3517476351,3369998498,1672621582,1672624283,2701
7587,3534553510,3554917400,1672695881,1672698526,2645
7627,3823600322,3637008488,1672678414,1672681281,2867
7725,3429856982,3384240055,1672677144,1672680679,3535
7882,3660493209,3505962865,1672607235,1672610314,3079
7718,3710408395,3208844525,1672536159,1672536523,364
7882,3516960534,3792288302,1672599109,1672600761,1652
7511,3500391167,3505098372,1672634244,1672634428,184
7590,3501364586,3716168623,1672679037,1672681868,2831
7587,3349613093,3407673904,1672616185,1672617842,1657
7970,3520012395,3518163778,1672557077,1672560443,3366
7627,3238712269,3411618230,1672566151,1672568691,2540
7849,3774119563,3913251733,1672626611,1672627395,784
7651,3772544062,3417061462,1672566164,1672567548,1384
7553,3713969578,3714197325,1672688575,1672690502,1927
7497,3483949762,3249247700,1672558685,1672560907,2222
7917,3826760240,3760294205,1672639597,1672642716,3119
7492,3234362962,3791942683,1672639896,1672642332,2436
7631,3779976989,3451432842,1672622553,1672625559,3006
7889,3779036831,3683766533,1672598370,1672600962,2592
7617,3348261553,3533270638,1672584254,1672585000,746
7941,3454042520,3513599775,1672675958,1672678251,2293
7844,3534553510,3415443558,1672603382,1672604897,1515
7559,3517721725,3514283243,1672650894,1672654436,3542
7618,3518014404,3512720680,1672625193,1672625337,144
7509,3229665776,3913251733,1672546984,1672549058,2074
7503,3816853177,3822654369,1672550993,1672552516,1523
7495,3515691540,3520012395,1672680193,1672680771,578
7493,3512540951,3249247700,1672575387,1672578117,2730
7545,3713349754,3780828689,1672634169,1672637459,3290
7819,3776800213,3500578848,1672617042,1672619165,2123
7549,3278365525,3639847263,1672654248,1672655918,1670
7718,3520030713,3416265063,1672565665,1672568815,3150
7520,3793338102,3338703270,1672544079,1672544320,241
7892,3600647945,3792768129,1672565186,1672565727,541
7933,3313541986,3859663348,1672543505,1672545457,1952
7614,3608633356,3280964728,1672613767,1672616836,3069
7840,3400918687,3772359096,1672588455,1672591586,3131
7695,3516011407,3409474775,1672562587,1672564491,1904
7493,3533748232,3511267139,1672570070,1672570428,358
7828,3429690204,3514245078,1672532917,1672534635,1718
7527,3286658957,3832902928,1672604215,1672607094,2879
7519,3639847263,3773120434,1672651663,1672653000,1337
7597,3716537575,3501927421,1672593564,1672595537,1973
7755,3516960534,3930797455,1672533012,1672535981,2969
7632,3434642576,3407725581,1672703319,1672705580,2261
7552,3882997884,3778305740,1672697383,1672700628,3245
7607,3918247820,3497901842,1672593855,1672594409,554
7759,3505145247,3736786443,1672547662,1672550333,2671
7596,3298288268,3636867411,1672591402,1672591570,168
7580,3209383861,3779740455,1672672209,1672674695,2486
7616,3407673904,3757246925,1672539634,1672541470,1836
7910,3344019610,3493507965,1672655531,1672655888,357
7885,3534492426,3512567240,1672702284,1672702598,314
7742,3311208440,3520376528,1672594875,1672596110,1235
7639,3515860749,3910886626,1672634663,1672636313,1650
7800,3857349323,3774268456,1672577651,1672580767,3116
7559,3715998609,3852391257,1672687514,1672690813,3299
7565,3388372715,3779218771,1672668473,1672668818,345
7484,3733891182,3534729133,1672533210,1672534369,1159
7956,3311761694,3359239884,1672540234,1672543816,3582
7774,3415546117,3633420270,1672598222,1672601106,2884
7753,3756528686,3714504419,1672552880,1672554716,1836
7688,3511332835,3626156564,1672583062,1672584434,1372
7552,3600647945,3716746253,1672573370,1672576021,2651
7520,3248507722,3664517356,1672579748,1672582240,2492
7606,3209048907,3396086535,1672576142,1672579455,3313
7544,3500487333,3481647420,1672606714,1672607019,305
7851,3760183458,3405494240,1672637292,1672637854,562
7726,3715339701,3399433690,1672687193,1672689599,2406
7681,3701498253,3417061462,1672559711,1672560497,786
7538,3311324983,3772337814,1672584724,1672584988,264
7700,3501486692,3465202715,1672640711,1672642536,1825
7523,3774268456,3511435497,1672623733,1672625621,1888
7858,3229058858,3513454145,1672633184,1672633802,618
7752,3518163778,3416427576,1672674018,1672676450,2432
7970,3311871871,3511312803,1672616596,1672618493,1897
7760,3909238838,3505973226,1672536255,1672537383,1128
7913,3334033993,3430504438,1672599102,1672600938,1836
7488,3485823740,3505362057,1672635889,1672637798,1909
7884,3359910781,3701995648,1672639695,1672640484,789
7833,3711973519,3451432842,1672640875,1672642873,1998
7553,3903962771,3701898991,1672621601,1672622126,525
7721,3490191091,3664517356,1672640697,1672643594,2897
7603,3209048907,3500177712,1672589251,1672591100,1849
7938,3509352754,3232962003,1672649505,1672650439,934
7684,3701498253,3512349371,1672620605,1672623125,2520
7552,3621810464,3514128943,1672563935,1672566453,2518
7720,3493507965,3533369198,1672642156,1672642635,479
7604,3505635228,3505530961,1672604941,1672606153,1212
7700,3511271692,3921211276,1672696284,1672697321,1037
7962,3513164386,3800353779,1672683508,1672684917,1409
7528,3757455053,3774045700,1672539106,1672540656,1550
7730,3378436155,3206593906,1672688599,1672690560,1961
7982,3396285984,3812176780,1672693064,1672694638,1574
7791,3420700674,3756462516,1672582842,1672583637,795
7671,3716258994,3517459919,1672575562,1672578034,2472
7647,3516465662,3780788622,1672687412,1672690666,3254
7790,3716537575,3978105277,1672682336,1672684135,1799
7825,3778305740,3791901535,1672588780,1672590461,1681
7501,3338367113,3509672210,1672681610,1672684034,2424
7714,3291883916,3505000737,1672672595,1672675062,2467
7588,3918584946,3666457294,1672690807,1672690941,134
7530,3701967560,3518014636,1672533048,1672533441,393
7690,3760267716,3344019610,1672643038,1672643386,348
7765,3710112546,3713349754,1672665608,1672668477,2869
7597,3221536550,3505883609,1672537367,1672540619,3252
7564,3734496778,3760489031,1672687801,1672688129,328
7518,3716537575,3501759100,1672632985,1672636288,3303
7626,3509453566,3756528686,1672699683,1672699912,229
7634,3909238838,3475251781,1672564372,1672567485,3113
7543,3505098372,3791594391,1672694911,1672695480,569
7555,3713808837,3774127586,1672540345,1672540458,113
7698,3424922204,3516980378,1672647900,1672650211,2311
7865,3378436155,3367029997,1672694988,1672696539,1551
7760,3298288268,3937224533,1672556831,1672559756,2925
7838,3492478793,3737051610,1672566697,1672570280,3583
7499,3792384220,3501955238,1672656474,1672659315,2841
7960,3516716179,3399433690,1672551112,1672551938,826
7878,3500578848,3793470489,1672537418,1672538117,699
7886,3206593906,3883085535,1672644092,1672645172,1080
7715,3760294205,3311090974,1672686500,1672689284,2784
7871,3512217942,3780639480,1672701225,1672702557,1332
7687,3715974031,3933210486,1672580049,1672582787,2738
7556,3827626797,3760561634,1672546342,1672547896,1554
7658,3337544549,3439023335,1672633633,1672636775,3142
7654,3779740455,3779036831,1672666172,1672669651,3479
7565,3701995648,3378436155,1672627286,1672629108,1822
7796,3514128943,3770447408,1672620947,1672624435,3488
7794,3417061462,3634786711,1672628578,1672629286,708
7746,3481647420,3208844525,1672628201,1672629467,1266
7781,3303751772,3783531004,1672632968,1672633800,832
7597,3519428855,3359910781,1672566699,1672567987,1288
7677,3770078063,3829232696,1672659008,1672660139,1131
7558,3485008994,3793470489,1672538070,1672541211,3141
7925,3760489031,3318697153,1672554305,1672555967,1662
7928,3772714862,3735733948,1672624600,1672626999,2399
7654,3731106822,3500487333,1672659222,1672659633,411
7554,3513164386,3972364603,1672631041,1672633245,2204
7605,3552314511,3519069599,1672612444,1672615459,3015
7795,3475258557,3791997875,1672623373,1672626542,3169
7739,3420432297,3624312512,1672553969,1672554860,891
7502,3711370563,3514987389,1672594194,1672597656,3462
7781,3666507626,3774195321,1672642791,1672644147,1356
7578,3922337974,3606987130,1672641241,1672642924,1683
7823,3406784491,3713644518,1672549039,1672549146,107
7823,3731419510,3378436155,1672599288,1672600216,928
7953,3519803045,3600647945,1672612679,1672613650,971
7503,3664517356,3917088658,1672651369,1672652594,1225
7973,3516514391,3621497531,1672603617,1672606350,2733
7568,3716165213,3520730271,1672617735,1672619752,2017
7858,3760893269,3501483568,1672635406,1672638078,2672
7836,3208844525,3713808837,1672626767,1672627038,271
7579,3823600322,3755872268,1672701452,1672703947,2495
7843,3500803339,3291227780,1672701308,1672704104,2796
7630,3780813786,3622054816,1672578789,1672580027,1238
7906,3716537575,3828624701,1672687195,1672690762,3567
7804,3777120536,3618873142,1672701598,1672704013,2415
7857,3520190170,3777623166,1672595365,1672597586,2221
7596,3385763781,3716197887,1672615897,1672617890,1993
7772,3739106581,3757562897,1672697330,1672699589,2259
7850,3816454165,3421127249,1672622573,1672625185,2612
7790,3703275621,3760893269,1672677617,1672680087,2470
7698,3505193212,3500177712,1672630611,1672634108,3497
7815,3772758337,3311065516,1672661758,1672662705,947
7801,3760294205,3666457294,1672590087,1672593026,2939
7534,3505000737,3855424474,1672559635,1672561602,1967
7912,3710112546,3770078063,1672593763,1672596562,2799
7823,3477649378,3286658957,1672675950,1672677322,1372
7863,3519803045,3828624701,1672593207,1672594355,1148
7861,3715581279,3600647945,1672635626,1672636822,1196
7668,3815508790,3616944364,1672574427,1672577583,3156
7862,3816853177,3234541252,1672582676,1672585082,2406
7693,3501759100,3774556560,1672675556,1672678304,2748
7495,3853018906,3392121505,1672651406,1672654568,3162
7822,3505000737,3509907947,1672650269,1672650775,506
7629,3380035798,3774556560,1672623801,1672626122,2321
7771,3774204963,3715998609,1672552088,1672552579,491
7612,3772309166,3387966152,1672555755,1672556030,275
7938,3459030804,3494290908,1672566293,1672569285,2992
7714,3511332835,3404384505,1672579844,1672581036,1192
7824,3387674757,3917088658,1672595946,1672596667,721
7719,3401627165,3399911573,1672642244,1672642495,251
7590,3516016437,3289061738,1672693487,1672696290,2803
7853,3514472925,3792844210,1672618998,1672621988,2990
7944,3774204963,3777929708,1672672574,1672674861,2287
7962,3388372715,3773814927,1672697379,1672698193,814
7608,3307512479,3356860407,1672667016,1672667821,805
7959,3793959750,3497901842,1672531933,1672535153,3220
7764,3513454145,3616944364,1672692165,1672693389,1224
7576,3517864478,3683766533,1672660801,1672664177,3376
7961,3774119563,3836573197,1672698501,1672701683,3182
7937,3429690204,3792668962,1672539160,1672540857,1697
7682,3773814927,3829232696,1672571424,1672572166,742
7487,3772359096,3755511676,1672567203,1672569921,2718
7547,3734496778,3514283243,1672668388,1672669428,1040
7830,3791334389,3520709480,1672558795,1672560366,1571
7937,3615046771,3364543015,1672597832,1672601137,3305
7821,3773429448,3793959750,1672614955,1672618292,3337
7484,3314245084,3773598056,1672652990,1672654809,1819
7900,3454042520,3714821932,1672660168,1672661934,1766
7494,3859525941,3473765852,1672621305,1672623424,2119
7583,3793389510,3520012395,1672686038,1672689214,3176
7603,3313541986,3760893269,1672598563,1672600935,2372
7639,3534492426,3760509236,1672608990,1672612032,3042
7697,3519700826,3517509185,1672691322,1672693484,2162
7963,3683959482,3770101921,1672633714,1672634761,1047
7939,3711504540,3501364586,1672698237,1672698401,164
7697,3520165601,3760893269,1672603422,1672605482,2060
7523,3685187183,3417587765,1672621928,1672625112,3184
7855,3446948848,3891751546,1672621214,1672621649,435
7501,3711973519,3880310724,1672666341,1672666937,596
7953,3792473331,3688683847,1672630040,1672632342,2302
7971,3780503655,3394330287,1672575534,1672575828,294
7771,3903307060,3608868877,1672604315,1672606152,1837
7707,3501601840,3773664987,1672637311,1672638986,1675
7794,3710344260,3774338212,1672540164,1672540246,82
7524,3466911760,3972709319,1672678178,1672680759,2581
7937,3772309166,3811694763,1672677976,1672679400,1424
7524,3500904641,3715492942,1672549030,1672551109,2079
7681,3220716272,3516909237,1672555048,1672555982,934
7815,3683766533,3889232789,1672700680,1672701299,619
7532,3668005723,3791901535,1672631475,1672632305,830
7577,3501364586,3804870229,1672567007,1672567311,304
7587,3885670556,3804870229,1672571140,1672572945,1805
7762,3513080274,3200691026,1672585803,1672588853,3050
7677,3793753089,3773755137,1672685469,1672686216,747
7942,3792288302,3370636709,1672567730,1672571101,3371
7928,3386707783,3885670556,1672618883,1672620701,1818
7784,3780609808,3475251781,1672699658,1672702007,2349
7612,3387966152,3815508790,1672551531,1672554662,3131
7955,3613683164,3289061738,1672628549,1672631069,2520
7551,3667680268,3778108318,1672547127,1672547504,377
7767,3201432789,3935127663,1672577720,1672578453,733
7671,3783239924,3515125508,1672630185,1672632390,2205
7964,3246596716,3633420270,1672697213,1672699093,1880
7980,3917088658,3828432634,1672682511,1672685050,2539
7521,3319752091,3777079686,1672676772,1672679738,2966
7717,3358871377,3625274012,1672562228,1672562909,681
7634,3637008488,3914259449,1672615001,1672616883,1882
7934,3388637594,3711569060,1672557791,1672559030,1239
7695,3480687894,3666457294,1672680741,1672684161,3420
7675,3501483568,3610348516,1672665219,1672665781,562
7911,3770851318,3834257412,1672581647,1672583904,2257
7591,3777929708,3823600322,1672666930,1672669718,2788
7528,3804870229,3734828619,1672683228,1672686442,3214
7835,3505904952,3515860749,1672572621,1672574379,1758
7928,3399052055,3520629279,1672613038,1672614187,1149
7491,3779976989,3511125626,1672573888,1672574631,743
7517,3301107849,3401627165,1672694344,1672696648,2304
7502,3778780511,3917278625,1672536798,1672540219,3421
7567,3365278081,3711380716,1672590301,1672591987,1686
7939,3399052055,3519703355,1672604128,1672605791,1663
7701,3716746253,3776800213,1672701014,1672703644,2630
7553,3634786711,3291235378,1672632103,1672633817,1714
7862,3791334389,3791901535,1672608152,1672610068,1916
7492,3509352754,3401627165,1672557347,1672559590,2243
7742,3791020967,3516011407,1672597594,1672597798,204
7789,3882291183,3516673015,1672665247,1672666424,1177
7586,3811171116,3235635976,1672678079,1672680447,2368
7737,3885897503,3777929708,1672641779,1672643948,2169
7497,3851190615,3302626661,1672694542,1672694645,103
7966,3772884106,3738274418,1672652143,1672655003,2860
7688,3505649239,3339907603,1672653581,1672657006,3425
7849,3518408774,3809059934,1672535006,1672535481,475
7970,3715127362,3227158514,1672533239,1672534000,761
7940,3360506772,3634995491,1672578463,1672579572,1109
7766,3513454145,3509634629,1672641800,1672644477,2677
7795,3432689543,3780813786,1672626125,1672626715,590
7849,3416265063,3926700506,1672532923,1672534981,2058
7550,3777936328,3500894271,1672637758,1672637970,212
7591,3505145247,3826415738,1672687866,1672690197,2331
7862,3773978034,3496549058,1672607016,1672608199,1183
7770,3713370078,3755042098,1672682991,1672685940,2949
7982,3776513891,3500729955,1672570391,1672572211,1820
7761,3774580701,3792844210,1672617740,1672618148,408
7968,3429690204,3519703355,1672533848,1672536722,2874
7580,3713644518,3520931254,1672637293,1672638721,1428
7501,3298288268,3286658957,1672643631,1672644382,751
7894,3477375368,3534424200,1672645894,1672648602,2708
7886,3617734118,3490191091,1672573583,1672576817,3234
7945,3716165213,3818255890,1672615133,1672615761,628
7734,3918584946,3224058172,1672562742,1672563340,598
7983,3807987001,3774010081,1672546665,1672547573,908
7573,3378436155,3360506772,1672672685,1672674022,1337
7486,3229665776,3883861463,1672540621,1672542550,1929
7507,3755511676,3515284591,1672646465,1672649937,3472
7552,3209027249,3939952128,1672663607,1672665244,1637
7883,3399535232,3227158514,1672634040,1672635973,1933
7493,3710408395,3512217942,1672700767,1672702227,1460
7892,3505193212,3902383721,1672595281,1672597234,1953
7892,3614238812,3485008994,1672672325,1672673398,1073
7891,3344364444,3552314511,1672582555,1672585382,2827
7979,3249791738,3701534009,1672599421,1672600728,1307
7671,3617734118,3793627961,1672553863,1672555792,1929
7753,3930791338,3500365158,1672564104,1672565748,1644
7673,3701111745,3820354437,1672576624,1672578036,1412
7564,3737051610,3277669002,1672591929,1672593685,1756
7768,3365278081,3338367113,1672632211,1672632536,325
7794,3910454786,3509634629,1672575543,1672576732,1189
7749,3360506772,3430074045,1672638519,1672639561,1042
7645,3779036831,3298433163,1672569352,1672569618,266
7960,3477375368,3883861463,1672590697,1672593150,2453
7729,3519069599,3501692334,1672563721,1672565043,1322
7592,3516980378,3793086311,1672548004,1672548583,579
7765,3512567240,3505791599,1672601023,1672604053,3030
7810,3625274012,3715981584,1672655960,1672657170,1210
7590,3756462516,3688418210,1672582696,1672586027,3331
7843,3732481297,3278365525,1672578128,1672581264,3136
7535,3443698222,3772578994,1672607155,1672610164,3009
7538,3731106822,3385763781,1672656559,1672659525,2966
7570,3666507626,3505193212,1672640133,1672640441,308
7789,3516011407,3517476351,1672693669,1672694067,398
7594,3970117174,3505904952,1672591841,1672593239,1398
7777,3533095755,3882997884,1672672253,1672675418,3165
7581,3421127249,3924549929,1672546481,1672549126,2645
7699,3311439795,3304625412,1672624179,1672624659,480
7520,3791553060,3805342762,1672576651,1672577918,1267
7642,3828624701,3805342762,1672576799,1672579802,3003
7825,3234541252,3855000166,1672590260,1672592717,2457
7771,3701274634,3361230905,1672691138,1672691478,340
7946,3533810360,3792902982,1672694512,1672697160,2648
7771,3774520233,3534553510,1672560533,1672561578,1045
7530,3492478793,3476232529,1672645052,1672645397,345
7679,3853018906,3432689543,1672621317,1672623187,1870
7945,3625274012,3505635228,1672618095,1672620459,2364
7529,3791657947,3757455053,1672673137,1672674965,1828
7528,3383922351,3345207877,1672605920,1672608165,2245
7776,3505203158,3922275416,1672562513,1672565947,3434
7827,3887270940,3715981584,1672541653,1672542115,462
7683,3511350608,3244436890,1672565804,1672568899,3095
7542,3701274634,3855602893,1672691462,1672694414,2952
7659,3618045231,3501692334,1672663568,1672665390,1822
7911,3791942683,3388637594,1672556675,1672558166,1491
7802,3666553782,3882997884,1672535979,1672537742,1763
7979,3509352754,3518791447,1672696038,1672697090,1052
7497,3939952128,3757562897,1672588862,1672589942,1080
7588,3512142794,3394330287,1672563408,1672565842,2434
7655,3667680268,3520706195,1672616161,1672619536,3375
7925,3791553060,3912262917,1672557796,1672559800,2004
7746,3757682496,3365614305,1672546698,1672549652,2954
7969,3415546117,3792253549,1672566701,1672568501,1800
7566,3428006164,3774338212,1672563358,1672566928,3570
7851,3791553060,3734828619,1672605162,1672607084,1922
7919,3774298222,3911245524,1672676221,1672678528,2307
7513,3515284591,3505098372,1672688363,1672691691,3328
7844,3715981584,3783429780,1672670176,1672671679,1503
7510,3351554343,3628819436,1672612478,1672613489,1011
7827,3284639858,3520751702,1672700909,1672703735,2826
7978,3505873261,3899204805,1672651542,1672653392,1850
7830,3513201436,3505000737,1672611125,1672611857,732
7638,3379589402,3293695955,1672702725,1672704670,1945
7485,3505912939,3783196518,1672561544,1672563966,2422
7576,3512567240,3513080274,1672570501,1672573924,3423
7578,3490191091,3480687894,1672550903,1672551476,573
7946,3311603601,3517864478,1672608269,1672608668,399
7855,3339907603,3311152102,1672644139,1672645085,946
7553,3500391167,3509907947,1672685897,1672686383,486
7628,3780503655,3780609808,1672568746,1672569592,846
7854,3342131135,3396285984,1672551644,1672553806,2162
7588,3510937904,3899371911,1672571375,1672573774,2399
7577,3776513891,3362000049,1672634938,1672637025,2087
7965,3301107849,3778341199,1672656656,1672659417,2761
7607,3711504540,3618045231,1672560153,1672560324,171
7961,3377766165,3311761694,1672628466,1672628573,107
7951,3513080274,3520030713,1672629392,1672630226,834
7792,3477649378,3779218771,1672553869,1672555614,1745
7894,3311154569,3520756859,1672672109,1672675291,3182
7861,3513599775,3513599775,1672678625,1672679085,460
7712,3312829208,3490191091,1672598829,1672601719,2890
7553,3516629436,3737079798,1672665149,1672668252,3103
7758,3701534009,3774520233,1672560090,1672562884,2794
7768,3489728806,3510703546,1672608939,1672610828,1889
7923,3249791738,3735319397,1672700530,1672703578,3048
7523,3517721725,3513599775,1672592776,1672593687,911
7824,3520012395,3236102733,1672553795,1672556610,2815
7814,3307512479,3365942576,1672587236,1672587576,340
7808,3703013906,3359239884,1672635831,1672636498,667
7693,3817621391,3895562476,1672590759,1672593187,2428
7956,3505000737,3516980378,1672675134,1672676639,1505
7534,3774793839,3513164386,1672606148,1672606219,71
7790,3792384220,3201324715,1672667896,1672670288,2392
7958,3510126867,3760294205,1672563272,1672563491,219
7676,3780593036,3519601612,1672621129,1672623979,2850
7957,3362000049,3518876135,1672633123,1672633562,439
7706,3221899927,3783531004,1672614409,1672614585,176
7538,3973560347,3311152102,1672614676,1672616722,2046
7730,3935127663,3465254146,1672665142,1672665883,741
7709,3500066230,3472130842,1672648195,1672651567,3372
7969,3533827120,3417061462,1672571446,1672572129,683
7921,3396086535,3774050956,1672641546,1672642464,918
7741,3516606733,3978105277,1672656035,1672657047,1012
7625,3395152943,3933210486,1672635859,1672636185,326
7881,3475258557,3311203656,1672535498,1672537833,2335
7554,3898995675,3667680268,1672567146,1672570122,2976
7755,3406784491,3505000737,1672689555,1672691562,2007
7861,3820354437,3420700674,1672632078,1672635219,3141
7876,3533385867,3792253549,1672545452,1672546719,1267
7714,3509907947,3516039895,1672618282,1672619930,1648
7856,3935627557,3427283336,1672695208,1672695322,114
7621,3519069599,3607748895,1672617830,1672620731,2901
7760,3420432297,3399535232,1672648284,1672649106,822
7622,3227457126,3833889105,1672532629,1672535552,2923
7793,3509453566,3774580701,1672637548,1672640303,2755
7776,3791957752,3770101921,1672621569,1672622296,727
7550,3701898991,3760509236,1672559571,1672559650,79
7629,3716835696,3480687894,1672639399,1672640551,1152
7490,3451432842,3475251781,1672603095,1672606128,3033
7850,3505219850,3516465662,1672565610,1672568818,3208
7962,3626156564,3774466457,1672687791,1672690928,3137
7593,3518360734,3311761694,1672637333,1672638339,1006
7759,3701498253,3710112546,1672587773,1672590537,2764
7775,3430074045,3783925755,1672618391,1672621677,3286
7701,3634340855,3816853177,1672594648,1672595620,972
7780,3520165601,3505173328,1672604499,1672608035,3536
7956,3514838220,3914290246,1672674960,1672675115,155
7600,3477375368,3516980378,1672532654,1672534445,1791
7866,3424922204,3703275621,1672613259,1672615446,2187
7819,3713268590,3716168623,1672574214,1672577201,2987
7829,3851190615,3716900301,1672545642,1672546346,704
7735,3533270638,3772746272,1672665475,1672668727,3252
7940,3505477652,3774580701,1672560911,1672564326,3415
7497,3512567240,3518876135,1672642483,1672643090,607
7697,3757447189,3756021689,1672553967,1672554732,765
7825,3703223015,3904775198,1672678484,1672679549,1065
7627,3779528381,3516223597,1672570182,1672572889,2707
7757,3459030804,3229058858,1672635533,1672638780,3247
7727,3701534009,3501198706,1672633782,1672634623,841
7927,3291227780,3910886626,1672637571,1672639162,1591
7582,3400918687,3715492942,1672545304,1672547962,2658
7497,3755511676,3832902928,1672681120,1672684486,3366
7602,3516223597,3776066388,1672664546,1672667202,2656
7536,3277669002,3777623166,1672573634,1672575974,2340
7541,3921211276,3346795719,1672601933,1672602870,937
7798,3314245084,3417061462,1672536635,1672537487,852
7821,3773755137,3607748895,1672595940,1672597844,1904
7629,3715581279,3836573197,1672597160,1672598302,1142
7502,3407725581,3518791447,1672671487,1672674481,2994
7529,3778308417,3496269445,1672598341,1672601769,3428
7905,3533653428,3517864478,1672641215,1672644799,3584
7497,3757403279,3931941795,1672545004,1672548441,3437
7617,3487171044,3277669002,1672703091,1672703810,719
7513,3280599164,3505098372,1672538446,1672542042,3596
7774,3351554343,3817316561,1672632362,1672634398,2036
7511,3388637594,3399535232,1672653285,1672656249,2964
7519,3385763781,3735319397,1672658479,1672660492,2013
7933,3500391167,3885670556,1672562755,1672565786,3031
7975,3713969578,3519703355,1672628622,1672631884,3262
7565,3622054816,3889232789,1672611980,1672615205,3225
7605,3827222533,3515284591,1672551320,1672554627,3307
7826,3793470489,3629547065,1672610143,1672610870,727
7898,3760267716,3407673904,1672681119,1672682582,1463
7650,3273500349,3701274634,1672554299,1672557619,3320
7627,3396285984,3378092448,1672600033,1672601007,974
7632,3701995648,3932051427,1672690870,1672692602,1732
7909,3391915886,3501483568,1672538909,1672541837,2928
7852,3777443199,3774127586,1672628519,1672629457,938
7603,3807987001,3834257412,1672696811,1672700262,3451
7543,3426325549,3703735129,1672606053,1672607580,1527
7981,3890149705,3783245561,1672631782,1672632860,1078
7852,3770021824,3755881905,1672554463,1672556452,1989
7498,3711504540,3792253549,1672681599,1672683463,1864
7828,3311871871,3755881905,1672586119,1672587548,1429
7764,3407954858,3618045231,1672546505,1672549426,2921
7648,3420432297,3978105277,1672570092,1672570688,596
7485,3701065786,3711569060,1672642211,1672644913,2702
7803,3736790081,3311761694,1672611607,1672612806,1199
7894,3931941795,3755739653,1672533223,1672534983,1760
7618,3608633356,3509630174,1672703504,1672703580,76
7852,3338367113,3792789881,1672545298,1672545672,374
7884,3834257412,3666506258,1672682560,1672685400,2840
7669,3500904641,3509773875,1672656262,1672657246,984
7604,3791602225,3516960534,1672543729,1672546302,2573
7768,3772337814,3617055293,1672663335,1672666442,3107
7883,3917278625,3713786889,1672628674,1672631767,3093
7541,3713786889,3280599164,1672531535,1672534800,3265
7577,3374559242,3918247820,1672697542,1672698022,480
7796,3792473331,3404058699,1672617722,1672619166,1444
7537,3311415018,3519556068,1672550855,1672551225,370
7869,3883551721,3238712269,1672537822,1672540646,2824
7792,3935627557,3716843669,1672609203,1672612628,3425
7887,3429856982,3471220483,1672653281,1672655089,1808
7639,3736786443,3399433690,1672571570,1672574128,2558
7639,3770635361,3780294829,1672643131,1672643890,759
7859,3500177712,3610695419,1672624315,1672627704,3389
7527,3337544549,3777120536,1672577365,1672578583,1218
7916,3817621391,3311154569,1672664855,1672665609,754
7878,3917278625,3417061462,1672558620,1672560337,1717
7870,3739106581,3391261292,1672541669,1672543582,1913
7924,3518014404,3399433690,1672678345,1672679136,791
7624,3757246925,3780593036,1672630163,1672633245,3082
7640,3780365428,3710112546,1672694516,1672696139,1623
7592,3244436890,3793753089,1672594977,1672595931,954
7518,3311154569,3836573197,1672579880,1672581130,1250
7649,3276640712,3772884106,1672654107,1672657696,3589
7903,3930797455,3555214688,1672607753,1672609920,2167
7688,3510247121,3519428855,1672590230,1672592186,1956
7574,3249791738,3805342762,1672565346,1672566246,900
7598,3286658957,3924549929,1672699577,1672701958,2381
7835,3662180254,3511841857,1672682607,1672682707,100
7603,3338703270,3534010629,1672598017,1672601446,3429
7577,3475258557,3391261292,1672604244,1672605096,852
7559,3520183192,3839849341,1672563541,1672566645,3104
7497,3736790081,3424922204,1672690023,1672692449,2426
7503,3834257412,3500391167,1672685936,1672686264,328
7845,3835382117,3489217083,1672679689,1672681892,2203
7696,3399052055,3774125065,1672691627,1672691792,165
7902,3512567240,3315583351,1672554675,1672555060,385
7836,3774298222,3367902229,1672603911,1672606502,2591
7880,3520756859,3834257412,1672703615,1672704002,387
7912,3511198618,3232962003,1672655279,1672658214,2935
7675,3711571712,3394330287,1672598029,1672599901,1872
7885,3734737881,3780914982,1672619106,1672621703,2597
7746,3244173074,3293695955,1672602209,1672604585,2376
7717,3534010629,3760561634,1672584579,1672585196,617
7929,3313541986,3512540951,1672595143,1672597180,2037
7795,3827377568,3755436115,1672614684,1672615474,790
7686,3227457126,3500066230,1672627436,1672630557,3121
7543,3776800213,3666507626,1672579180,1672582524,3344
7515,3396285984,3777929708,1672604171,1672604506,335
7615,3770553384,3783779671,1672660975,1672661834,859
7862,3792032359,3391915121,1672636736,1672637566,830
7511,3505193212,3613683164,1672567931,1672568573,642
7889,3621810464,3792668962,1672686236,1672687223,987
7535,3660493209,3772714862,1672628714,1672629059,345
7874,3334033993,3360506772,1672604129,1672605057,928
7665,3979339287,3778108318,1672632914,1672634384,1470
7916,3780788622,3519563836,1672531423,1672533746,2323
7651,3336742544,3429856982,1672691715,1672694807,3092
7927,3760077057,3662180254,1672608644,1672609962,1318
7759,3505873261,3668898102,1672595176,1672597247,2071
7952,3372883226,3829232696,1672656222,1672658007,1785
7505,3200691026,3736625083,1672574890,1672576556,1666
7791,3716835696,3481502100,1672676564,1672677502,938
7594,3770763956,3520629279,1672686056,1672687686,1630
7511,3367029997,3666507626,1672534785,1672538218,3433
7960,3733189298,3298288268,1672557106,1672558016,910
7704,3515125508,3901877072,1672659479,1672659622,143
7915,3783083229,3510711755,1672605054,1672608389,3335
7946,3716537575,3520190170,1672658821,1672660954,2133
7522,3918247820,3668898102,1672563463,1672565397,1934
7493,3500578848,3792668962,1672663281,1672666622,3341
7944,3916289176,3773598056,1672545808,1672548234,2426
7492,3232962003,3511271692,1672685953,1672689392,3439
7491,3756453423,3772714862,1672639851,1672642578,2727
7489,3500229033,3813052709,1672568685,1672569070,385
7641,3249401741,3505000737,1672659076,1672661308,2232
7772,3349613093,3387674757,1672691921,1672693448,1527
7521,3604539807,3916289176,1672610653,1672612486,1833
7963,3489728806,3359239884,1672557958,1672558634,676
7758,3701065786,3701178711,1672633930,1672634247,317
7483,3901990690,3333896808,1672550611,1672552755,2144
7887,3774793839,3774501422,1672621443,1672623581,2138
7978,3369998498,3760893269,1672626576,1672628889,2313
7625,3703441914,3716273414,1672587287,1672587358,71
7557,3887270940,3428674539,1672540118,1672542856,2738
7965,3496549058,3388286531,1672648235,1672651533,3298
7793,3703889596,3772578994,1672662668,1672665007,2339
7578,3757447189,3400804807,1672622889,1672625270,2381
7893,3500805881,3400918687,1672652545,1672654302,1757
7701,3533626375,3505638204,1672615601,1672617219,1618
7940,3517459919,3778341199,1672680932,1672684385,3453
7596,3783531004,3773429448,1672583170,1672586175,3005
7853,3901877072,3714504419,1672666895,1672667812,917
7980,3780593036,3755587522,1672666424,1672666822,398
7758,3714504419,3519700826,1672651130,1672651891,761
7636,3429856982,3807987001,1672548992,1672549517,525
7515,3234541252,3772337814,1672532684,1672533480,796
7832,3481647420,3336751428,1672636804,1672637412,608
7861,3978115672,3311274543,1672538687,1672541407,2720
7736,3760492950,3710344260,1672657751,1672658805,1054
7932,3475258557,3922275416,1672612093,1672613484,1391
7523,3518014404,3475251781,1672578008,1672580480,2472
7896,3298433163,3500994774,1672681436,1672683741,2305
7512,3500066230,3660493209,1672620402,1672622964,2562
7520,3703735129,3817621391,1672577532,1672579358,1826
7869,3519152550,3716165213,1672591784,1672594757,2973
7761,3248507722,3485375593,1672589552,1672592127,2575
7537,3482405588,3501730685,1672639183,1672641304,2121
7672,3793959750,3533137446,1672564013,1672564617,604
7891,3757812939,3774010081,1672590280,1672593816,3536
7912,3365830990,3513454145,1672544235,1672545551,1316
7699,3774466457,3626156564,1672698388,1672699950,1562
7908,3247780536,3776513891,1672703796,1672705985,2189
7978,3756027749,3703441914,1672552026,1672553749,1723
7803,3359239884,3757602960,1672677973,1672680737,2764
7846,3518876135,3607748895,1672609239,1672611222,1983
7818,3916289176,3783429780,1672645942,1672648871,2929
7782,3713969578,3829764737,1672673344,1672673978,634
7525,3311324983,3610695419,1672654176,1672655528,1352
7670,3880310724,3614238812,1672588169,1672590156,1987
7756,3344019610,3238712269,1672696122,1672699016,2894
7849,3426325549,3703718151,1672608961,1672610916,1955
7889,3853018906,3731419510,1672622497,1672623200,703
7896,3236102733,3827222533,1672636310,1672637293,983
7824,3890149705,3510969660,1672687432,1672689647,2215
7790,3606186086,3489728806,1672674379,1672676706,2327
7495,3500365158,3517509185,1672559171,1672560015,844
7852,3972364603,3701111745,1672568578,1672569572,994
7900,3516258476,3505530961,1672664923,1672666978,2055
7580,3280615985,3388372715,1672553881,1672556732,2851
7856,3622054816,3773950140,1672669178,1672670920,1742
7710,3512540951,3791115967,1672637866,1672641247,3381
7644,3792032359,3772758337,1672571171,1672572669,1498
7519,3792883665,3793753089,1672636847,1672638844,1997
7730,3806545488,3311993075,1672576463,1672579024,2561
7741,3774556560,3616944364,1672553135,1672555184,2049
7707,3516960534,3973560347,1672550639,1672553505,2866
7941,3701065786,3735733948,1672615988,1672618453,2465
7932,3418728074,3668898102,1672690142,1672691980,1838
7721,3730517636,3400804807,1672702316,1672702492,176
7579,3755392666,3519654779,1672602699,1672604810,2111
7883,3760489031,3888559320,1672617747,1672619917,2170
7961,3737051610,3395152943,1672604782,1672605696,914
7926,3736419952,3600647945,1672604942,1672607159,2217
7569,3394330287,3779528381,1672532729,1672533054,325
7810,3505791599,3911159965,1672636942,1672637609,667
7551,3935127663,3489962019,1672699738,1672702596,2858
7733,3703223015,3916289176,1672698357,1672701018,2661
7895,3533095755,3342131135,1672681881,1672684940,3059
7946,3485375593,3627937312,1672654858,1672657503,2645
7871,3227457126,3882997884,1672660035,1672661066,1031
7829,3344364444,3895562476,1672590960,1672594436,3476
7834,3773978034,3396086535,1672636998,1672638391,1393
7854,3516065852,3509933351,1672640049,1672643406,3357
7959,3755436115,3703735129,1672687003,1672690554,3551
7684,3520376528,3221536550,1672666147,1672666592,445
7627,3629935998,3500458761,1672694323,1672697703,3380
7525,3434642576,3626156564,1672689684,1672693010,3326
7565,3774556560,3430352815,1672682499,1672683397,898
7832,3514838220,3808324264,1672644766,1672644856,90
7633,3636867411,3783206719,1672605418,1672607887,2469
7714,3505791599,3703275621,1672695905,1672697401,1496
7754,3773120434,3510969660,1672590040,1672590357,317
7524,3926700506,3430352815,1672622365,1672624398,2033
7542,3911245524,3520751702,1672597192,1672597863,671
7892,3513201436,3369998498,1672663535,1672664453,918
7606,3701984666,3937224533,1672695443,1672696188,745
7575,3920801189,3755872268,1672682680,1672685500,2820
7762,3774010081,3777079686,1672554756,1672558120,3364
7585,3716900301,3774339795,1672697421,1672698424,1003
7517,3358871377,3780503655,1672702414,1672703883,1469
7493,3501486692,3885897503,1672699091,1672699789,698
7806,3519556068,3316173088,1672657582,1672660317,2735
7488,3359239884,3421836608,1672596229,1672599041,2812
7889,3492478793,3880310724,1672595007,1672595891,884
7500,3811694763,3472130842,1672594723,1672598180,3457
7691,3772642849,3246596716,1672697498,1672697965,467
7596,3783925755,3509604974,1672676239,1672678944,2705
7907,3773950140,3772544062,1672576860,1672577614,754
7692,3792844210,3421836608,1672685171,1672686534,1363
7505,3311993075,3280964728,1672619592,1672620721,1129
7649,3404384505,3533810360,1672566934,1672569765,2831
7598,3394539273,3301107849,1672643133,1672643466,333
7921,3505962865,3516629436,1672676207,1672677865,1658
7795,3701111745,3715189301,1672692289,1672693002,713
7717,3666506258,3806545488,1672640245,1672640320,75
7616,3925402713,3516011407,1672701756,1672703556,1800
7910,3701995648,3312333615,1672655449,1672657547,2098
7576,3755392666,3734496778,1672684226,1672685016,790
7966,3519601612,3515860749,1672635561,1672638908,3347
7807,3924549929,3882291183,1672632506,1672632618,112
7627,3772642849,3271938399,1672573036,1672576231,3195
7926,3505477652,3510969660,1672575360,1672576448,1088
7604,3826759140,3918674986,1672581702,1672583078,1376
7624,3935627557,3760992710,1672563232,1672563429,197
7666,3344364444,3713969578,1672591369,1672592801,1432
7674,3883312122,3229665776,1672635368,1672637321,1953
7915,3501364586,3774580701,1672544895,1672545762,867
7515,3778308417,3360743849,1672622012,1672622266,254
7625,3910454786,3605726278,1672694915,1672696504,1589
7843,3517963492,3534729133,1672641809,1672643186,1377
7969,3713894336,3827377568,1672545938,1672547430,1492
7858,3757151210,3501730685,1672631845,1672634999,3154
7827,3791657947,3755872268,1672620678,1672621566,888
7797,3733891182,3515151980,1672680097,1672682799,2702
7721,3807987001,3516980378,1672694082,1672694206,124
7870,3533653428,3459030804,1672615413,1672618406,2993
7970,3933210486,3372883226,1672641756,1672643645,1889
7689,3510771358,3778305740,1672600769,1672604015,3246
7642,3701274634,3318697153,1672633192,1672633480,288
7756,3432665384,3311603601,1672548855,1672551606,2751
7698,3516514391,3756528686,1672568688,1672570981,2293
7731,3514719601,3501483568,1672577486,1672577691,205
7874,3714474557,3773755137,1672549176,1672549822,646
7879,3778305740,3316222192,1672594963,1672596775,1812
7501,3701111745,3734737881,1672682611,1672685565,2954
7571,3424922204,3778308417,1672560599,1672563319,2720
7601,3533748232,3417061462,1672692347,1672694897,2550
7503,3517864478,3505962865,1672634116,1672637283,3167
7666,3770635361,3374559242,1672667434,1672668807,1373
7902,3477375368,3774338212,1672617999,1672618755,756
7547,3716488385,3813052709,1672597818,1672597995,177
7943,3505193212,3500066230,1672652003,1672654468,2465
7805,3666457294,3773598056,1672658706,1672658868,162
7761,3518014636,3770824086,1672648360,1672651275,2915
7865,3976633198,3808324264,1672540130,1672541787,1657
7783,3500729955,3921211276,1672576514,1672577923,1409
7909,3395152943,3533927138,1672584869,1672585524,655
7908,3505219850,3505791599,1672691803,1672695334,3531
7703,3776513891,3760489031,1672652996,1672655285,2289
7810,3438645253,3885670556,1672628606,1672628884,278
7892,3601879040,3516980378,1672670262,1672670436,174
7552,3533280269,3772053179,1672645613,1672646959,1346
7824,3516716179,3533369198,1672642137,1672644523,2386
7627,3534702203,3500458761,1672571034,1672572606,1572
7821,3388286531,3227457126,1672531460,1672533731,2271
7693,3512567240,3713786889,1672539270,1672540457,1187
7760,3471220483,3453729665,1672603816,1672603987,171
7911,3716273414,3600647945,1672603957,1672607028,3071
7928,3773429448,3774556560,1672543065,1672544089,1024
7757,3773950140,3685187183,1672567077,1672570653,3576
7836,3235287260,3505912939,1672584229,1672584685,456
7520,3801089989,3617734118,1672689533,1672690922,1389
7925,3377766165,3792668962,1672657504,1672657954,450
7946,3778308417,3500374658,1672662625,1672666044,3419
7810,3533927138,3348261553,1672579444,1672582891,3447
7891,3277605882,3780914982,1672640423,1672641644,1221
7708,3668898102,3829319703,1672691091,1672691430,339
7727,3713349754,3625274012,1672676634,1672678959,2325
7936,3757562897,3703955926,1672572051,1672575298,3247
7625,3242408357,3336742544,1672563226,1672563615,389
7954,3819727225,3714474557,1672544789,1672546905,2116
7503,3311274543,3475396323,1672578646,1672580695,2049
7689,3409474775,3519601612,1672662630,1672666194,3564
7938,3466911760,3714474557,1672621401,1672622103,702
7802,3714474557,3713349754,1672576959,1672579089,2130
7532,3505219850,3780365428,1672612334,1672615276,2942
7927,3780593036,3859525941,1672573545,1672575043,1498
7767,3505145247,3234541252,1672551692,1672554016,2324
7828,3772578994,3505201246,1672531855,1672534211,2356
7489,3359910781,3756528686,1672628656,1672629526,870
7705,3509352754,3533927138,1672665928,1672669250,3322
7652,3779218771,3888559320,1672636524,1672636960,436
7650,3513454145,3273500349,1672643323,1672645231,1908
7568,3791594391,3488244966,1672638804,1672641928,3124
7515,3516980378,3505635228,1672663668,1672665957,2289
7759,3552314511,3918674986,1672548388,1672551485,3097
7604,3778108318,3904775198,1672592393,1672595590,3197
7784,3710067113,3513956646,1672607277,1672610027,2750
7694,3606987130,3519563836,1672591686,1672594686,3000
7878,3882242815,3912536808,1672636742,1672638299,1557
7742,3509453566,3505635228,1672703686,1672704550,864
7759,3755872268,3511350608,1672680634,1672682110,1476
7946,3534488837,3778305740,1672571367,1672574908,3541
7964,3316173088,3509352754,1672579554,1672582107,2553
7832,3312664885,3505873261,1672660317,1672660824,507
7711,3332072298,3755920131,1672594182,1672595150,968
7545,3772053179,3935127663,1672533259,1672535058,1799
7787,3244485293,3703013906,1672645713,1672648051,2338
7505,3505859863,3277669002,1672652625,1672656147,3522
7629,3534492426,3688683847,1672636128,1672636745,617
7699,3755625324,3882291183,1672571907,1672573401,1494
7565,3622054816,3313541986,1672537288,1672538663,1375
7883,3917278625,3713786889,1672629129,1672631115,1986
7810,3208844525,3406784491,1672587623,1672587862,239
7741,3607178184,3614238812,1672682208,1672683039,831
7607,3783083229,3505477652,1672540809,1672542073,1264
7948,3505791599,3715339701,1672558324,1672561182,2858
7850,3778780511,3520888296,1672537497,1672537579,82
7842,3902383721,3774466457,1672653711,1672654687,976
7962,3401627165,3774366875,1672603520,1672605996,2476
7841,3755920131,3533927138,1672697681,1672700052,2371
7569,3533810360,3978105277,1672577707,1672579481,1774
7670,3510126867,3716835696,1672701962,1672702723,761
7901,3774298222,3926700506,1672539506,1672542852,3346
7911,3505599848,3756528686,1672660751,1672661606,855
7555,3827377568,3286658957,1672701253,1672701475,222
7726,3516606733,3826759140,1672680608,1672683215,2607
7488,3770763956,3770851318,1672567487,1672569203,1716
7727,3307097200,3511198618,1672633280,1672634909,1629
7821,3511359172,3774339795,1672654970,1672655226,256
7641,3770851318,3516223597,1672670068,1672672369,2301
7957,3311154569,3509672210,1672612434,1672615369,2935
7878,3777806071,3739106581,1672682491,1672683115,624
7858,3383661227,3338703270,1672607208,1672608912,1704
7773,3518496488,3481502100,1672565406,1672567033,1627
7864,3613995936,3773978034,1672651840,1672654267,2427
7982,3311274543,3617055293,1672680289,1672682087,1798
7673,3342131135,3311152102,1672660589,1672663773,3184
7615,3520206212,3209383861,1672664134,1672664724,590
7953,3277605882,3511267139,1672640954,1672642426,1472
7533,3621810464,3518932404,1672565485,1672568436,2951
7627,3432689543,3783925755,1672702798,1672704819,2021
7943,3534010629,3516716179,1672637370,1672638986,1616
7502,3935127663,3501606184,1672575881,1672576387,506
7587,3823600322,3888559320,1672698492,1672701759,3267
7885,3618873142,3738274418,1672689495,1672692354,2859
7512,3776338577,3505098372,1672668687,1672670527,1840
7585,3370636709,3601879040,1672544984,1672546689,1705
7903,3518260334,3606987130,1672667100,1672670196,3096
7778,3509933351,3734737881,1672633027,1672633932,905
7946,3307097200,3358871377,1672597405,1672598144,739
7664,3516016437,3378686918,1672665297,1672668046,2749
7741,3505477652,3332072298,1672537312,1672540624,3312
7792,3534553510,3298288268,1672581851,1672585235,3384
7632,3388637594,3783509527,1672614029,1672616934,2905
7538,3664170666,3510594211,1672591574,1672593545,1971
7967,3247780536,3713630656,1672622336,1672623874,1538
7937,3501486692,3421836608,1672537666,1672538990,1324
7582,3710408395,3772359096,1672606935,1672609434,2499
7486,3903962771,3510173870,1672622267,1672623810,1543
7786,3311203656,3505362057,1672619659,1672622363,2704
7758,3509604974,3517077106,1672581415,1672582186,771
7718,3825229501,3315583351,1672650605,1672651889,1284
7809,3701190899,3500729955,1672541507,1672544226,2719
7841,3516011407,3792789881,1672693896,1672695729,1833
7972,3311871871,3791901535,1672640941,1672642460,1519
7931,3639847263,3311203656,1672609797,1672611942,2145
7511,3805519285,3489962019,1672555963,1672556673,710
7814,3793470489,3406784491,1672617368,1672619728,2360
7944,3298288268,3505635228,1672551311,1672554257,2946
7540,3736625083,3792768129,1672578751,1672580480,1729
7859,3774580701,3516065852,1672542700,1672544273,1573
7623,3828432634,3715981584,1672690298,1672693806,3508
7873,3701691675,3510247121,1672698673,1672699357,684
7850,3793086311,3311208440,1672589146,1672590059,913
7861,3757161914,3773120434,1672622498,1672623169,671
7717,3616944364,3501606184,1672580061,1672583425,3364
7897,3294803686,3510126867,1672629745,1672631131,1386
7656,3513956646,3467773920,1672609164,1672611589,2425
7714,3783126683,3757812939,1672554003,1672557485,3482
7788,3311324983,3386707783,1672679170,1672680247,1077
7901,3714821932,3520190170,1672677314,1672680828,3514
7713,3516514391,3793871337,1672602970,1672605429,2459
7678,3373384732,3715981584,1672703190,1672706381,3191
7710,3756930948,3791901535,1672674013,1672674367,354
7488,3500229033,3710569131,1672642083,1672642621,538
7919,3314245084,3481502100,1672625153,1672626728,1575
7744,3356860407,3736229191,1672637638,1672640796,3158
7503,3534313900,3387966152,1672671350,1672673727,2377
7868,3311274543,3610348516,1672665772,1672668649,2877
7889,3399535232,3783239924,1672656238,1672659104,2866
7502,3333896808,3446948848,1672675039,1672678122,3083
7807,3420700674,3533270638,1672622714,1672624137,1423
7521,3518932404,3473562469,1672664634,1672665402,768
7820,3478194807,3511312803,1672662676,1672666241,3565
7697,3777806071,3792473331,1672638916,1672641761,2845
7809,3429856982,3809059934,1672558150,1672560688,2538
7822,3859525941,3511841857,1672624645,1672625929,1284
7616,3792668962,3475795792,1672650568,1672652041,1473
7665,3772309150,3804870229,1672648008,1672649039,1031
7738,3448855696,3351554343,1672648877,1672649669,792
7890,3601879040,3780639480,1672609503,1672611518,2015
7839,3710344260,3772884106,1672700177,1672700365,188
7599,3756528686,3737079798,1672628119,1672631341,3222
7619,3770078063,3883085535,1672691219,1672693086,1867
7519,3311090974,3244389794,1672573192,1672575806,2614
7864,3909331423,3223968713,1672650820,1672653069,2249
7895,3316173088,3617734118,1672599701,1672600091,390
7878,3930791338,3909606423,1672644727,1672644854,127
7486,3774050956,3880285638,1672691400,1672693134,1734
7569,3780503655,3517077106,1672603732,1672603933,201
7748,3757812939,3710408395,1672575560,1672577582,2022
7928,3500391167,3711380716,1672685432,1672688805,3373
7774,3777790718,3924549929,1672588821,1672591330,2509
7706,3710098970,3774338212,1672658787,1672662346,3559
7980,3316173088,3387674757,1672682968,1672685155,2187
7895,3779036831,3298288268,1672633398,1672636558,3160
7540,3458539365,3618045231,1672535162,1672536324,1162
7865,3701111745,3389115045,1672668438,1672669238,800
7498,3396086535,3406784491,1672537312,1672539685,2373
7509,3229058858,3349613093,1672551203,1672554644,3441
7730,3918247820,3511687358,1672588809,1672591923,3114
7636,3917278625,3505000737,1672695162,1672695970,808
7822,3811171116,3509604974,1672697188,1672698186,998
7737,3534553510,3783245561,1672612809,1672613233,424
7898,3516465662,3975287541,1672645511,1672648507,2996
7483,3716900301,3473562469,1672656228,1672659178,2950
7715,3475396323,3792768129,1672551801,1672552448,647
7793,3209383861,3701178711,1672686437,1672688108,1671
7602,3703223015,3509634629,1672566437,1672568365,1928
7942,3822654369,3475396323,1672605617,1672607295,1678
7869,3520629279,3418534998,1672674430,1672676913,2483
7748,3624312512,3716273414,1672697144,1672699913,2769
7776,3516716179,3510937904,1672694917,1672695505,588
7772,3511332835,3772309150,1672658209,1672660110,1901
7982,3500060260,3807987001,1672572560,1672575290,2730
7894,3770101921,3512837326,1672627920,1672631440,3520
7916,3509933351,3475396323,1672619490,1672621119,1629
7968,3229665776,3853018906,1672656419,1672659421,3002
7658,3912262917,3387674757,1672680137,1672682347,2210
7504,3500487333,3774195321,1672570650,1672571206,556
7835,3757562897,3279721246,1672613457,1672614044,587
7747,3910886626,3533095755,1672594117,1672596147,2030
7515,3518014404,3826633236,1672540582,1672541678,1096
7643,3793436995,3481647420,1672615854,1672616248,394
7961,3510771358,3505904952,1672665628,1672668422,2794
7558,3714504419,3713969578,1672607598,1672610102,2504
7777,3918247820,3513164386,1672682441,1672684519,2078
7911,3756462516,3756451663,1672695873,1672699084,3211
7508,3711504540,3517864478,1672535233,1672538635,3402
7531,3715189301,3777983879,1672665995,1672668675,2680
7866,3716843669,3606987130,1672676764,1672678602,1838
7664,3836573197,3509907947,1672687684,1672689919,2235
7729,3220716272,3776513891,1672686562,1672688607,2045
7837,3909238838,3534313900,1672597608,1672600995,3387
7557,3367902229,3534553510,1672579854,1672583160,3306
7904,3391915121,3811694763,1672683129,1672684830,1701
7919,3889232789,3513080274,1672596605,1672596733,128
7596,3516606733,3402943525,1672624888,1672626923,2035
7857,3509634629,3703735129,1672646762,1672648465,1703
7639,3713808837,3428674539,1672675584,1672677948,2364
7941,3734828619,3668898102,1672703057,1672705173,2116
7756,3505362057,3711571712,1672580314,1672581976,1662
7642,3634995491,3512510536,1672555045,1672555203,158
7873,3533748232,3388372715,1672648773,1672651840,3067
7964,3626156564,3901877072,1672676160,1672678620,2460
7621,3313564074,3792032359,1672692907,1672695616,2709
7903,3939952128,3703013906,1672663100,1672664396,1296
7535,3701274634,3312333615,1672677891,1672677975,84
7506,3500374658,3716273414,1672532516,1672535246,2730
7949,3311718847,3755392666,1672679798,1672680975,1177
7642,3311324983,3492478793,1672638015,1672639206,1191
7623,3359910781,3918247820,1672659934,1672661480,1546
7594,3417970574,3808324264,1672600664,1672602639,1975
7953,3792668962,3509352754,1672696458,1672696631,173
7930,3312829208,3429856982,1672561165,1672562888,1723
7835,3734496778,3519700826,1672685155,1672685830,675
7748,3760267716,3510711755,1672588783,1672590857,2074
7855,3520730271,3624761861,1672690239,1672690557,318
7851,3344019610,3716273414,1672644805,1672646356,1551
7887,3730517636,3284832486,1672561289,1672562175,886
7538,3311203656,3662180254,1672619439,1672620739,1300
7791,3387674757,3232962003,1672569504,1672571158,1654
7897,3429856982,3311439795,1672531266,1672532756,1490
7669,3407673904,3518014404,1672559190,1672560464,1274
7599,3662180254,3757403279,1672545138,1672547426,2288
7494,3500904641,3791553060,1672661401,1672663295,1894
7744,3418728074,3755881905,1672633011,1672634096,1085
7522,3855937514,3757447189,1672681577,1672684761,3184
7645,3434642576,3808324264,1672570676,1672572844,2168
7493,3734737881,3791334389,1672571987,1672575386,3399
7690,3779036831,3533025282,1672644553,1672644874,321
7867,3828432634,3505638204,1672609830,1672610704,874
7707,3683959482,3244436890,1672691570,1672694958,3388
7967,3512540951,3313541986,1672599683,1672603267,3584
7719,3412825109,3851190615,1672614547,1672617250,2703
7793,3701898991,3481502100,1672679566,1672680855,1289
7519,3778308417,3608868877,1672553760,1672555428,1668
7572,3515151980,3912536808,1672674746,1672677724,2978
7823,3688418210,3780639480,1672635371,1672637831,2460
7916,3311154569,3773429448,1672666358,1672669606,3248
7878,3534191820,3783925755,1672633118,1672634539,1421
7811,3501759100,3338703270,1672595975,1672596397,422
7573,3511170269,3206593906,1672570039,1672573329,3290
7634,3716900301,3711370563,1672652889,1672653318,429
7879,3621497531,3311648200,1672536037,1672537026,989
7554,3424922204,3772758337,1672537925,1672541294,3369
7856,3520012395,3247815299,1672583419,1672586561,3142
7934,3289061738,3783531004,1672695620,1672698666,3046
7863,3505203158,3505292701,1672628352,1672630922,2570
7499,3510126867,3757246925,1672539735,1672541047,1312
7498,3783925755,3473765852,1672562007,1672564302,2295
7616,3935127663,3417970574,1672549567,1672552431,2864
7789,3757455053,3488244966,1672615953,1672618519,2566
7682,3221899927,3515691540,1672679840,1672682891,3051
7597,3533653428,3277605882,1672576405,1672579977,3572
7960,3228165483,3512142794,1672613029,1672615634,2605
7953,3778780511,3770635361,1672573246,1672576293,3047
7563,3512142794,3779528381,1672624630,1672624871,241
7944,3515125508,3703789494,1672679015,1672681943,2928
7523,3774580701,3500177712,1672607511,1672608526,1015
7614,3533025282,3772714862,1672574549,1672574625,76
7834,3816454165,3505201246,1672692016,1672692106,90
7607,3473765852,3625274012,1672532038,1672532655,617
7692,3512683609,3512567240,1672642553,1672643309,756
7844,3515125508,3828624701,1672659203,1672659371,168
7700,3533827120,3277939457,1672670031,1672671871,1840
7582,3792473331,3520190170,1672604469,1672606422,1953
7800,3517963492,3804870229,1672533365,1672533605,240
7847,3377766165,3793389510,1672622464,1672623901,1437
7645,3505477652,3475396323,1672551342,1672553492,2150
7818,3710067113,3510244400,1672669716,1672671521,1805
7684,3278365525,3512837326,1672549384,1672550398,1014
7556,3385763781,3416265063,1672596223,1672596887,664
7598,3916289176,3792883665,1672676243,1672677169,926
7658,3316173088,3774366875,1672688853,1672691595,2742
7554,3500458761,3783206719,1672611579,1672613947,2368
7818,3533810360,3634995491,1672607179,1672609110,1931
7815,3209048907,3514987389,1672628224,1672628299,75
7569,3429690204,3489217083,1672563084,1672564418,1334
7645,3517963492,3370752401,1672619021,1672619493,472
7530,3513454145,3783196518,1672594405,1672595522,1117
7682,3793871337,3924549929,1672588164,1672588488,324
7604,3311324983,3496051529,1672544999,1672547007,2008
7712,3666507626,3711569060,1672571724,1672575191,3467
7588,3428674539,3271938399,1672570091,1672572091,2000
7677,3284639858,3500658339,1672620694,1672622986,2292
7562,3509907947,3511312803,1672540537,1672542862,2325
7747,3774556560,3351554343,1672679845,1672680153,308
7763,3713208927,3533369198,1672593129,1672594651,1522
7927,3703275621,3792288302,1672569917,1672571374,1457
7957,3494290908,3757812939,1672597961,1672598350,389
7568,3378686918,3488244966,1672674525,1672677222,2697
7900,3404058699,3917088658,1672629580,1672631380,1800
7651,3314245084,3615046771,1672624715,1672627693,2978
7715,3500578848,3307512479,1672587341,1672590748,3407
7945,3817316561,3552314511,1672621482,1672622455,973
7824,3760569731,3703789494,1672587241,1672590722,3481
7627,3783206719,3533369198,1672624890,1672627738,2848
7611,3520030713,3331845324,1672659848,1672662635,2787
7513,3517963492,3471220483,1672627500,1672628832,1332
7856,3407954858,3315583351,1672563478,1672564138,660
7982,3345207877,3734828619,1672562165,1672565166,3001
7802,3388372715,3483164654,1672695429,1672698133,2704
7909,3311324983,3713630656,1672610990,1672612690,1700
7620,3301107849,3732481297,1672658911,1672660977,2066
7732,3757682496,3883861463,1672594644,1672597875,3231
7829,3920801189,3387674757,1672609892,1672610030,138
7828,3793962300,3774045700,1672571201,1672573534,2333
7560,3519654779,3510857360,1672654972,1672656477,1505
7534,3899266183,3939952128,1672638201,1672641106,2905
7643,3520376528,3385763781,1672543036,1672543253,217
7934,3533626375,3909238838,1672586355,1672587465,1110
7947,3388637594,3806545488,1672579036,1672580253,1217
7564,3716537575,3438645253,1672609578,1672612875,3297
7662,3978115672,3510969660,1672576604,1672579489,2885
7687,3520751702,3904408902,1672657107,1672660601,3494
7618,3244436890,3701111745,1672611356,1672613969,2613
7918,3886298125,3465254146,1672624056,1672627262,3206
7733,3666506258,3829764737,1672690668,1672692424,1756
7712,3475258557,3346795719,1672538991,1672539995,1004
7708,3701190899,3772337814,1672623099,1672625452,2353
7632,3277939457,3912536808,1672691982,1672692617,635
7490,3887270940,3429690204,1672701236,1672704154,2918
7521,3303751772,3859663348,1672576204,1672578060,1856
7571,3512540951,3278365525,1672651272,1672654228,2956
7765,3859663348,3778341199,1672613275,1672614595,1320
7616,3774339795,3703735129,1672639584,1672642157,2573
7793,3778780511,3338367113,1672676920,1672679656,2736
7703,3294803686,3777514571,1672580754,1672581079,325
7567,3533270638,3802367797,1672686652,1672689359,2707
7841,3701498253,3516016437,1672696665,1672697181,516
7559,3511435497,3234362962,1672576941,1672580063,3122
7601,3364543015,3914290246,1672686330,1672687079,749
7495,3505477652,3432665384,1672681468,1672682928,1460
7604,3501486692,3311203656,1672687219,1672687758,539
7638,3311415018,3294803686,1672547373,1672549332,1959
7670,3792883665,3756424865,1672689146,1672689309,163
7691,3710344260,3760489031,1672545487,1672547737,2250
7852,3513080274,3458539365,1672678260,1672679144,884
7718,3793286136,3533371364,1672679060,1672681473,2413
7922,3931941795,3333896808,1672639672,1672640163,491
7870,3713786889,3783779671,1672664687,1672665171,484
7495,3634786711,3757455053,1672544212,1672547711,3499
7516,3311761694,3912536808,1672563049,1672565082,2033
7738,3701065786,3421127249,1672654133,1672655229,1096
7535,3793848402,3515860749,1672698346,1672699206,860
7583,3534424200,3895562476,1672692238,1672694985,2747
7843,3778305740,3399004969,1672689905,1672691606,1701
7975,3519069599,3713268590,1672611660,1672612042,382
7834,3791020967,3505638204,1672559256,1672562217,2961
7823,3533827120,3510594211,1672598746,1672600899,2153
7705,3714962248,3773120434,1672661364,1672661980,616
7945,3298288268,3454042520,1672567825,1672571318,3493
7556,3519703355,3809059934,1672550531,1672553933,3402
7705,3383922351,3430074045,1672612473,1672615897,3424
7678,3482405588,3885897503,1672576026,1672578009,1983
7876,3516606733,3776513891,1672557845,1672558499,654
7918,3289061738,3760183458,1672701605,1672704078,2473
7522,3826760240,3793848402,1672672783,1672673522,739
7854,3505135325,3510711755,1672690281,1672691591,1310
7495,3791997875,3519428855,1672586571,1672588795,2224
7671,3490191091,3407954858,1672658438,1672660116,1678
7619,3533810360,3512837326,1672557967,1672560186,2219
7569,3667680268,3716488385,1672677623,1672681105,3482
7796,3627937312,3791020967,1672539812,1672540819,1007
7727,3404384505,3500177712,1672626808,1672629314,2506
7898,3757562897,3774195321,1672617589,1672618106,517
7957,3221536550,3701184889,1672648636,1672649154,518
7638,3501927421,3404384505,1672535377,1672535675,298
7829,3512166013,3688683847,1672607123,1672608894,1771
7875,3772544062,3249401741,1672534365,1672537898,3533
7879,3756027749,3811171116,1672669487,1672672690,3203
7600,3780974443,3209048907,1672641076,1672642402,1326
7506,3713808837,3903009525,1672699852,1672700408,556
7801,3518163778,3757403279,1672683278,1672684573,1295
7979,3516606733,3703718151,1672699744,1672703228,3484
7523,3501601840,3829319703,1672599510,1672602357,2847
7841,3783779671,3760492950,1672547400,1672547929,529
7900,3852595551,3793389510,1672623078,1672623239,161
7765,3703718151,3407954858,1672539752,1672543128,3376
7698,3416241005,3534702203,1672587145,1672589168,2023
7946,3913251733,3416427576,1672630446,1672632061,1615
7682,3903307060,3792789881,1672534830,1672537082,2252
7915,3475795792,3812176780,1672688961,1672690082,1121
7743,3713630656,3485823740,1672700321,1672702497,2176
7651,3500391167,3336751428,1672544050,1672545649,1599
7687,3318697153,3510126867,1672563072,1672563904,832
7626,3976633198,3713349754,1672688425,1672689981,1556
7488,3249401741,3822654369,1672599015,1672602500,3485
7531,3511359172,3401627165,1672610512,1672612165,1653
7883,3221899927,3827626797,1672605645,1672609167,3522
7971,3439023335,3399911573,1672684095,1672686903,2808
7876,3899371911,3793753089,1672576759,1672578707,1948
7506,3667680268,3701274634,1672672183,1672675151,2968
7793,3738274418,3383922351,1672563941,1672566977,3036
7834,3913251733,3311274543,1672602995,1672606135,3140
7586,3778108318,3519803045,1672546906,1672549301,2395
7975,3780294829,3629547065,1672541253,1672544454,3201
7969,3791553060,3492478793,1672625634,1672628978,3344
7803,3505530961,3772359096,1672593146,1672593913,767
7636,3935627557,3701274634,1672622683,1672625985,3302
7807,3716537575,3517963492,1672589049,1672589969,920
7517,3800886801,3780365428,1672604026,1672604670,644
7960,3395152943,3516960534,1672598118,1672601422,3304
7890,3760598102,3979339287,1672688612,1672692103,3491
7705,3511350608,3625274012,1672624097,1672625809,1712
7738,3783531004,3813052709,1672656041,1672656566,525
7859,3224716315,3420700674,1672695936,1672697897,1961
7971,3970117174,3701274634,1672572453,1672574213,1760
7966,3857349323,3852595551,1672575551,1672576276,725
7901,3424922204,3372883226,1672574606,1672577754,3148
7653,3880310724,3311845971,1672658509,1672659794,1285
7675,3823600322,3755872268,1672660080,1672663180,3100
7958,3627937312,3774204963,1672606128,1672608637,2509
7782,3249247700,3518791447,1672557757,1672559917,2160
7556,3311845971,3716843669,1672551801,1672554663,2862
7531,3388637594,3760893269,1672572481,1672573519,1038
7575,3715189301,3770824086,1672695319,1672696776,1457
7777,3760509236,3610695419,1672671208,1672673100,1892
7747,3772758337,3711262377,1672692849,1672693857,1008
7903,3777455223,3774366875,1672559565,1672559772,207
7916,3701534009,3234362962,1672621294,1672622424,1130
7744,3209048907,3802367797,1672592060,1672595644,3584
7781,3201432789,3518932404,1672650886,1672651586,700
7857,3389115045,3783126683,1672656416,1672658686,2270
7836,3774339795,3235287260,1672585092,1672586571,1479
7853,3510380060,3755511676,1672609806,1672612533,2727
7813,3280599164,3910886626,1672553006,1672554274,1268
7873,3489217083,3345207877,1672538894,1672542047,3153
7935,3778305740,3516629436,1672692299,1672694858,2559
7971,3235635976,3666507626,1672549380,1672552196,2816
7978,3520888296,3703441914,1672642859,1672643666,807
7913,3505219850,3286658957,1672678940,1672679848,908
7816,3533927138,3828432634,1672546480,1672548950,2470
7754,3774339795,3710098970,1672634607,1672634929,322
7597,3396285984,3244436890,1672618701,1672620967,2266
7798,3279721246,3505000737,1672547171,1672548928,1757
7689,3733891182,3480687894,1672624741,1672625670,929
7734,3826415738,3773429448,1672642156,1672643437,1281
7897,3276640712,3979339287,1672581027,1672584215,3188
7506,3826759140,3511862351,1672546880,1672547665,785
7837,3550946908,3734828619,1672594984,1672597059,2075
7561,3418534998,3399911573,1672656949,1672660348,3399
7560,3500177712,3505203158,1672553340,1672555143,1803
7819,3802367797,3509672210,1672643828,1672644685,857
7679,3715127362,3826633236,1672605512,1672608785,3273
7872,3774066725,3505883609,1672614057,1672614950,893
7834,3248507722,3505362057,1672669429,1672671564,2135
7726,3511125626,3509933351,1672576781,1672577662,881
7522,3738502357,3811171116,1672573564,1672576986,3422
7661,3520190170,3533369198,1672664493,1672666912,2419
7655,3501927421,3206603608,1672569861,1672569991,130
7975,3755872268,3311154569,1672642494,1672646084,3590
7536,3361230905,3424922204,1672588484,1672591621,3137
7722,3701184889,3715189301,1672576877,1672578599,1722
7919,3910454786,3780609808,1672597752,1672599117,1365
7774,3730517636,3301107849,1672617631,1672618003,372
7559,3701498253,3378686918,1672564296,1672566577,2281
7545,3735319397,3273500349,1672578745,1672579685,940
7877,3901990690,3713786889,1672649316,1672651741,2425
7847,3777514571,3518876135,1672575151,1672577389,2238
7501,3776800213,3639847263,1672686330,1672687048,718
7505,3280615985,3287105466,1672540954,1672544411,3457
7654,3701995648,3500177712,1672703413,1672705425,2012
7776,3511312803,3978115672,1672655114,1672658122,3008
7770,3815508790,3555214688,1672698349,1672700931,2582
7908,3439023335,3501483568,1672599785,1672601239,1454
7751,3783509527,3511271692,1672558550,1672561928,3378
7743,3822654369,3755392666,1672579964,1672582526,2562
7564,3791997875,3701190899,1672558373,1672558796,423
7816,3939952128,3286658957,1672639069,1672641469,2400
7699,3311090974,3930797455,1672610741,1672611441,700
7875,3777983879,3910886626,1672597914,1672599009,1095
7718,3760569731,3772053179,1672580056,1672582958,2902
7568,3304056063,3639847263,1672678749,1672678821,72
7585,3533626375,3770824086,1672569809,1672571452,1643
7486,3793338102,3493507965,1672602403,1672602964,561
7712,3434642576,3348261553,1672564826,1672565567,741
7966,3930797455,3231056870,1672650363,1672652305,1942
7616,3710408395,3855424474,1672603255,1672603548,293
7962,3715189301,3505649239,1672690348,1672691554,1206
7605,3518791447,3500658339,1672627385,1672629386,2001
7801,3399433690,3791657947,1672582676,1672584921,2245
7976,3829232696,3409474775,1672585206,1672586765,1559
7918,3936227020,3500904641,1672629772,1672631779,2007
7577,3716488385,3911159965,1672536481,1672539074,2593
7742,3500374658,3370636709,1672612993,1672614871,1878
7948,3624761861,3475251781,1672605361,1672608278,2917
7758,3515860749,3511163800,1672592807,1672593419,612
7659,3783083229,3703441914,1672562636,1672562848,212
7748,3757246925,3519563836,1672546704,1672547320,616
7950,3792032359,3490191091,1672635052,1672635947,895
7632,3605726278,3505883609,1672543200,1672543599,399
7736,3360506772,3280599164,1672594602,1672594829,227
7919,3688683847,3391915121,1672576464,1672579373,2909
7494,3600647945,3291235378,1672598567,1672599643,1076
7620,3465254146,3482405588,1672703205,1672706202,2997
7679,3935127663,3514245078,1672549021,1672552426,3405
7658,3209383861,3227457126,1672586243,1672587536,1293
7576,3730517636,3777079686,1672567086,1672568531,1445
7574,3926700506,3925402713,1672609365,1672612673,3308
7774,3713268590,3248507722,1672615911,1672616734,823
7602,3711370563,3284639858,1672658114,1672659529,1415
7836,3793389510,3760893269,1672565099,1672567539,2440
7962,3201848640,3510711755,1672648795,1672650812,2017
7635,3201848640,3772714862,1672555565,1672557516,1951
7937,3336742544,3605726278,1672696730,1672699534,2804
7877,3348261553,3760569731,1672644882,1672645798,916
7897,3818255890,3773950140,1672667648,1672668091,443
7934,3776948966,3713808837,1672537208,1672537737,529
7599,3772309166,3823600322,1672596429,1672599791,3362
7859,3666457294,3624761861,1672615656,1672619044,3388
7770,3605726278,3774010081,1672656657,1672659665,3008
7667,3802367797,3533927138,1672703570,1672705015,1445
7766,3819727225,3489545239,1672564936,1672567521,2585
7877,3791657947,3776066388,1672610051,1672612463,2412
7493,3715998609,3500894271,1672687037,1672687838,801
7950,3276640712,3293695955,1672541661,1672541742,81
7921,3611150562,3307097200,1672653702,1672655605,1903
7588,3231056870,3809484172,1672564843,1672566535,1692
7974,3804870229,3298433163,1672656814,1672659046,2232
7680,3827377568,3378092448,1672680146,1672683082,2936
7502,3783239924,3804870229,1672553936,1672555491,1555
7733,3550946908,3500578848,1672584169,1672586570,2401
7595,3517459919,3312664885,1672660989,1672661396,407
7546,3734828619,3534424200,1672697157,1672697362,205
7658,3664517356,3312664885,1672551303,1672553743,2440
7687,3809916577,3516039895,1672698722,1672699950,1228
7936,3774005526,3404058699,1672599609,1672601298,1689
7865,3481647420,3903962771,1672657894,1672659712,1818
7982,3909606423,3912536808,1672608302,1672610795,2493
7895,3311439795,3667680268,1672537001,1672539500,2499
7875,3519703355,3783429780,1672619156,1672622586,3430
7810,3318166135,3505638204,1672673993,1672674949,956
7928,3496549058,3792384220,1672627416,1672630725,3309
7540,3516016437,3515691540,1672611109,1672612429,1320
7928,3716197887,3512720680,1672697130,1672698329,1199
7950,3349613093,3520012395,1672624230,1672626513,2283
7661,3378686918,3386707783,1672566726,1672570040,3314
7936,3703275621,3713808837,1672613223,1672613448,225
7696,3774010081,3710112546,1672654267,1672656911,2644
7621,3606186086,3500066230,1672644337,1672644690,353
7586,3236102733,3778266283,1672629140,1672631433,2293
7916,3404058699,3827626797,1672701790,1672702001,211
7920,3608633356,3776948966,1672635310,1672635627,317
7869,3511332835,3701995648,1672632488,1672634136,1648
7670,3249401741,3930791338,1672629302,1672632267,2965
7960,3342131135,3513080274,1672609411,1672612738,3327
7593,3918584946,3304625412,1672595557,1672597722,2165
7890,3387674757,3792844210,1672558589,1672560531,1942
7552,3475258557,3510937904,1672665931,1672666641,710
7580,3895562476,3636867411,1672678976,1672681143,2167
7589,3220716272,3773978034,1672676362,1672677576,1214
7692,3453729665,3511350608,1672644701,1672647606,2905
7803,3505173328,3388637594,1672625851,1672625966,115
7708,3716746253,3668005723,1672632047,1672632736,689
7724,3792768129,3342131135,1672596739,1672598433,1694
7713,3362000049,3911159965,1672686269,1672688699,2430
7841,3232962003,3972709319,1672602730,1672605419,2689
7753,3886298125,3783245561,1672701497,1672702276,779
7599,3534010629,3736790081,1672557393,1672560078,2685
7679,3774501422,3509352754,1672618413,1672621584,3171
7724,3792883665,3685187183,1672552942,1672554268,1326
7975,3501692334,3920801189,1672633891,1672635064,1173
7663,3362000049,3516016437,1672645530,1672646638,1108
7916,3533927138,3509604974,1672697413,1672697851,438
7958,3505193212,3816853177,1672628675,1672630781,2106
7834,3500365158,3828432634,1672694640,1672695903,1263
7944,3972364603,3774195321,1672543588,1672544908,1320
7600,3912536808,3826760240,1672534253,1672537064,2811
7859,3559110998,3505362057,1672542068,1672543613,1545
7532,3792253549,3490191091,1672566469,1672568267,1798
7884,3500487333,3839849341,1672677355,1672680399,3044
7760,3703661585,3634995491,1672575370,1672576174,804
7564,3510594211,3370636709,1672700799,1672701243,444
7533,3518669703,3634786711,1672651280,1672654578,3298
7919,3307512479,3485375593,1672580513,1672582948,2435
7962,3304056063,3228165483,1672625839,1672629062,3223
7668,3732481297,3515125508,1672555346,1672557734,2388
7548,3735319397,3774195321,1672533605,1672533826,221
7718,3832902928,3714474557,1672698054,1672698217,163
7733,3520709480,3346795719,1672564278,1672567400,3122
7508,3774010081,3685818092,1672696322,1672699486,3164
7486,3937224533,3304056063,1672598030,1672598642,612
7515,3416427576,3465202715,1672621295,1672623571,2276
7758,3390068992,3935627557,1672548090,1672551034,2944
7688,3780974443,3774366875,1672593521,1672596580,3059
7697,3882242815,3972709319,1672612304,1672615739,3435
7498,3520165601,3703955926,1672688150,1672688594,444
7959,3516909237,3222448362,1672688648,1672691362,2714
7840,3857349323,3500658339,1672652641,1672654548,1907
7670,3778549126,3917088658,1672665729,1672668223,2494
7898,3287105466,3519069599,1672639383,1672639740,357
7782,3429856982,3517963492,1672637564,1672640848,3284
7632,3481502100,3277605882,1672540446,1672543955,3509
7503,3833889105,3777120536,1672561157,1672563435,2278
7499,3428964059,3823600322,1672552024,1672554860,2836
7698,3777776687,3358871377,1672653638,1672655629,1991
7752,3975287541,3399535232,1672576965,1672578366,1401
7945,3405494240,3489728806,1672608447,1672610245,1798
7775,3716197887,3972709319,1672609322,1672609410,88
7563,3976633198,3515860749,1672652808,1672654259,1451
7597,3616944364,3701967560,1672544572,1672546910,2338
7536,3770635361,3505347134,1672540240,1672541724,1484
7921,3711504540,3883551721,1672587709,1672588703,994
7524,3816454165,3701065786,1672574684,1672577434,2750
7547,3711571712,3828624701,1672578930,1672580606,1676
7652,3711973519,3510594211,1672678255,1672678721,466
7924,3311439795,3618045231,1672622765,1672624199,1434
7912,3783206719,3882291183,1672632021,1672635168,3147
7672,3918056059,3518496488,1672543731,1672544405,674
7668,3809484172,3756966035,1672636846,1672638658,1812
7843,3399535232,3379589402,1672609077,1672609293,216
7532,3793848402,3520183192,1672562350,1672563636,1286
7783,3774066725,3757151210,1672646540,1672648958,2418
7591,3913251733,3465202715,1672603627,1672605255,1628
7730,3688683847,3802367797,1672620990,1672621945,955
7495,3664170666,3715974031,1672672866,1672676222,3356
7918,3774268456,3384951177,1672647059,1672647425,366
7528,3614238812,3206254161,1672678364,1672681065,2701
7936,3791602225,3374559242,1672687168,1672689513,2345
7505,3716900301,3735319397,1672560211,1672561549,1338
7933,3770447408,3235635976,1672601068,1672602485,1417
7837,3639847263,3505201246,1672621971,1672624504,2533
7581,3505791599,3505203158,1672576461,1672577607,1146
7640,3244173074,3711973519,1672629115,1672629534,419
7558,3390068992,3736592744,1672578686,1672579875,1189
7641,3514245078,3311203656,1672537712,1672538278,566
7853,3223789409,3773814927,1672547528,1672547829,301
7580,3688418210,3505530961,1672635386,1672638705,3319
7625,3288764520,3415443558,1672607059,1672608721,1662
7566,3296471982,3822654369,1672615504,1672616539,1035
7571,3494290908,3792032359,1672590185,1672592162,1977
7813,3222448362,3783925755,1672605730,1672608549,2819
7772,3774195321,3337544549,1672550352,1672550759,407
7752,3610695419,3772884106,1672674145,1672674504,359
7705,3899266183,3755625324,1672544014,1672546210,2196
7763,3734737881,3534313900,1672700684,1672702432,1748
7959,3828365570,3607178184,1672651034,1672653675,2641
7594,3731419510,3773978034,1672543623,1672544549,926
7804,3311761694,3392121505,1672679764,1672681030,1266
7667,3365614305,3280964728,1672545530,1672548378,2848
7571,3505362057,3365278081,1672558794,1672559520,726
7629,3533748232,3711262377,1672620142,1672621368,1226
7643,3484995752,3505883609,1672532795,1672535149,2354
7809,3520706195,3391261292,1672640960,1672644386,3426
7754,3776513891,3514472925,1672697740,1672697863,123
7802,3827222533,3451432842,1672609848,1672611228,1380
7913,3516065852,3792384220,1672602123,1672603799,1676
7787,3823600322,3887270940,1672605263,1672608087,2824
7842,3454042520,3772309150,1672694021,1672695006,985
7616,3703735129,3918584946,1672543598,1672546788,3190
7756,3805292782,3710569131,1672656408,1672658928,2520
7758,3201324715,3880285638,1672691827,1672694805,2978
7484,3734828619,3935127663,1672671476,1672672542,1066
7889,3242408357,3778780511,1672578456,1672579855,1399
7707,3520376528,3715339701,1672610586,1672611681,1095
7666,3859525941,3471220483,1672623521,1672623763,242
7704,3827626797,3514472925,1672546974,1672548151,1177
7626,3936227020,3791957752,1672591779,1672595254,3475
7965,3516016437,3626156564,1672600946,1672602945,1999
7826,3534191820,3783239924,1672625044,1672627416,2372
7647,3627937312,3852391257,1672700231,1672702497,2266
7901,3606987130,3517963492,1672544767,1672546469,1702
7597,3791901535,3760492950,1672606581,1672607387,806
7669,3791657947,3344019610,1672540976,1672544304,3328
7540,3420432297,3901990690,1672551676,1672554444,2768
7766,3792883665,3668898102,1672533134,1672535229,2095
7959,3711198793,3714821932,1672661344,1672662487,1143
7872,3429690204,3209551760,1672570869,1672574112,3243
7759,3792844210,3519152550,1672593208,1672595213,2005
7948,3911245524,3516909237,1672539301,1672542059,2758
7603,3533371364,3489728806,1672676731,1672679865,3134
7853,3714474557,3515151980,1672614870,1672618142,3272
7967,3518496488,3501198706,1672640276,1672642481,2205
7590,3711504540,3505362057,1672533749,1672533975,226
7499,3714488548,3836573197,1672701148,1672702468,1320
7566,3365278081,3311152102,1672581714,1672583801,2087
7920,3791553060,3773205565,1672589405,1672591309,1904
7773,3359239884,3356860407,1672551863,1672552449,586
7483,3828624701,3777806071,1672547104,1672550441,3337
7874,3520719611,3711571712,1672604380,1672605992,1612
7684,3385763781,3777477395,1672638188,1672639190,1002
7544,3805342762,3420700674,1672561497,1672561885,388
7754,3608633356,3828365570,1672650357,1672652119,1762
7818,3914259449,3291235378,1672684191,1672685818,1627
7539,3400918687,3735319397,1672541267,1672542580,1313
7983,3703223015,3666507626,1672578133,1672580178,2045
7709,3520751702,3614238812,1672665923,1672666536,613
7959,3703275621,3466911760,1672693024,1672693144,120
7570,3899266183,3685818092,1672688318,1672688610,292
7576,3311993075,3338703270,1672596773,1672597852,1079
7710,3780365428,3791997875,1672565318,1672566596,1278
7755,3774501422,3774520233,1672649888,1672653384,3496
7562,3736419952,3701178711,1672576728,1672577071,343
7501,3481647420,3520709480,1672555253,1672557779,2526
7513,3783531004,3760992710,1672540449,1672543469,3020
7815,3359239884,3231056870,1672555400,1672555970,570
7979,3534010629,3783196518,1672564425,1672567586,3161
7642,3407673904,3428006164,1672569077,1672569455,378
7595,3438645253,3511359172,1672613300,1672615288,1988
7568,3713208927,3756027749,1672556849,1672558235,1386
7576,3701111745,3516016437,1672622251,1672625230,2979
7801,3714821932,3757151210,1672696454,1672696686,232
7927,3779218771,3519556068,1672623710,1672624608,898
7541,3379589402,3756930948,1672580849,1672583480,2631
7876,3500894271,3534488837,1672597733,1672599049,1316
7954,3770635361,3776948966,1672669134,1672671876,2742
7736,3701065786,3554917400,1672565810,1672568244,2434
7797,3360506772,3701274634,1672647403,1672649671,2268
7776,3514987389,3364543015,1672652420,1672653411,991
7873,3777079686,3200691026,1672699034,1672700988,1954
7725,3362000049,3512837326,1672614473,1672617622,3149
7543,3732481297,3344019610,1672615244,1672617410,2166
7588,3773429448,3510969660,1672577259,1672580078,2819
7930,3519556068,3426325549,1672611825,1672614281,2456
7652,3811171116,3817621391,1672542565,1672544399,1834
7541,3737154119,3757246925,1672576873,1672577711,838
7920,3378436155,3515691540,1672653329,1672655872,2543
7744,3285400528,3825229501,1672699184,1672701727,2543
7647,3319752091,3512166013,1672655515,1672656178,663
7914,3898995675,3793627961,1672597497,1672598760,1263
7579,3713630656,3608868877,1672569957,1672570746,789
7783,3533270638,3613995936,1672540660,1672541891,1231
7816,3783509527,3378436155,1672625857,1672628423,2566
7625,3793959750,3792844210,1672575292,1672578414,3122
7484,3505145247,3760294205,1672617597,1672617916,319
7678,3515691540,3777120536,1672692772,1672694104,1332
7936,3432665384,3514245078,1672684372,1672687658,3286
7948,3285400528,3505362057,1672573551,1672576644,3093
7920,3909331423,3774066725,1672644847,1672646463,1616
7488,3904408902,3634786711,1672534291,1672536899,2608
7653,3514987389,3513599775,1672595038,1672596781,1743
7530,3313541986,3925402713,1672652868,1672653424,556
7638,3246596716,3511841857,1672543596,1672546824,3228
7894,3311993075,3756601594,1672695939,1672697523,1584
7585,3518876135,3430074045,1672546767,1672550335,3568
7852,3792768129,3780365428,1672599282,1672602328,3046
7971,3783206719,3826759140,1672699464,1672702904,3440
7576,3319752091,3792789881,1672653005,1672654871,1866
7569,3384951177,3613683164,1672666107,1672668644,2537
7831,3895562476,3755392666,1672583703,1672585969,2266
7595,3888559320,3201432789,1672531622,1672531877,255
7570,3505135325,3777983879,1672628777,1672629909,1132
7873,3731106822,3791020967,1672634795,1672636316,1521
7739,3228165483,3776338577,1672556119,1672556250,131
7622,3903962771,3514838220,1672629361,1672632588,3227
7681,3488244966,3519700826,1672656717,1672656961,244
7833,3792288302,3809916577,1672575647,1672575771,124
7885,3401627165,3835382117,1672566606,1672568217,1611
7958,3783925755,3880285638,1672643600,1672643891,291
7950,3780788622,3757447189,1672604236,1672605371,1135
7934,3485823740,3817316561,1672669785,1672671009,1224
7848,3604539807,3811171116,1672610463,1672612988,2525
7853,3701534009,3277939457,1672605850,1672606820,970
7856,3617055293,3336751428,1672545003,1672546640,1637
7780,3760077057,3505873261,1672628582,1672630642,2060
7681,3780593036,3755042098,1672632059,1672635248,3189
7916,3772053179,3805519285,1672556380,1672559855,3475
7637,3373384732,3855937514,1672565194,1672565733,539
7507,3937224533,3509352754,1672543959,1672545543,1584
7914,3370636709,3517476351,1672556836,1672558783,1947
7704,3229665776,3533270638,1672651948,1672653653,1705
7540,3304056063,3792768129,1672668607,1672669592,985
7633,3370752401,3773664987,1672682184,1672685311,3127
7619,3550946908,3311439795,1672603337,1672603537,200
7540,3517721725,3284639858,1672566589,1672566892,303
7555,3756027749,3777776687,1672700714,1672704245,3531
7505,3482405588,3407725581,1672619198,1672622503,3305
7754,3505859863,3220716272,1672621147,1672621978,831
7807,3925620998,3972709319,1672641468,1672642856,1388
7793,3293695955,3389115045,1672682391,1672683770,1379
7529,3505362057,3825229501,1672560075,1672563107,3032
7647,3518163778,3509352754,1672565493,1672566707,1214
7858,3777983879,3512510536,1672560627,1672562431,1804
7765,3500894271,3391915886,1672621033,1672622389,1356
7722,3915628728,3895562476,1672590334,1672592656,2322
7772,3501692334,3711571712,1672620804,1672622763,1959
7722,3511312803,3400804807,1672639187,1672640961,1774
7977,3384951177,3772578994,1672583365,1672585537,2172
7827,3736229191,3774556560,1672676979,1672678321,1342
7755,3701190899,3898995675,1672542650,1672542841,191
7942,3316222192,3716165213,1672664475,1672664838,363
7707,3916289176,3273500349,1672657514,1672658608,1094
7748,3396086535,3621497531,1672604633,1672606320,1687
7653,3611150562,3922337974,1672625540,1672626747,1207
7626,3778549126,3318697153,1672666368,1672666937,569
7824,3935127663,3505530961,1672563058,1672565057,1999
7786,3912536808,3857349323,1672578011,1672580157,2146
7913,3511312803,3319752091,1672658272,1672660968,2696
7883,3518496488,3533137446,1672619127,1672622564,3437
7967,3311152102,3246596716,1672647680,1672650814,3134
7762,3224716315,3713349754,1672608745,1672610174,1429
7896,3688683847,3501184421,1672688457,1672690953,2496
7631,3756021689,3832902928,1672571581,1672574607,3026
7529,3792883665,3883551721,1672628135,1672629306,1171
7929,3887270940,3780365428,1672626701,1672627175,474
7570,3311065516,3477649378,1672681635,1672684076,2441
7609,3519700826,3711973519,1672643663,1672646561,2898
7504,3713268590,3978105277,1672696468,1672696715,247
7930,3711198793,3288764520,1672605983,1672606406,423
7540,3303705369,3280964728,1672637430,1672638772,1342
7883,3703275621,3390068992,1672683660,1672685476,1816
7672,3973560347,3780593036,1672590053,1672591896,1843
7899,3405494240,3783509527,1672687449,1672689690,2241
7612,3388372715,3519563836,1672631849,1672633215,1366
7528,3511687358,3608633356,1672660031,1672663344,3313
7487,3774338212,3715974031,1672632949,1672633461,512
7540,3714197325,3515691540,1672570399,1672573492,3093
7908,3772746272,3519601612,1672564379,1672566539,2160
7660,3534729133,3432689543,1672546083,1672549368,3285
7675,3715981584,3311152102,1672600590,1672601346,756
7535,3505000737,3852391257,1672679517,1672681910,2393
7860,3311154569,3313564074,1672698391,1672699781,1390
7658,3497901842,3668005723,1672656132,1672659031,2899
7837,3783206719,3617734118,1672594663,1672597031,2368
7690,3757455053,3319752091,1672676665,1672679129,2464
7623,3348261553,3701178711,1672564395,1672565970,1575
7635,3604539807,3511170269,1672567796,1672568276,480
7692,3514719601,3429856982,1672688269,1672688521,252
7692,3312829208,3828365570,1672551244,1672551875,631
7524,3881477378,3883085535,1672678193,1672680029,1836
7974,3701534009,3606987130,1672560489,1672561711,1222
7827,3337544549,3235287260,1672580371,1672581236,865
7526,3400918687,3475396323,1672635898,1672638727,2829
7640,3780813786,3793848402,1672584213,1672587671,3458
7631,3201324715,3514128943,1672601192,1672602712,1520
7851,3312333615,3520730271,1672600871,1672602685,1814
7594,3703889596,3701274634,1672551428,1672553010,1582
7533,3828432634,3606186086,1672682911,1672684888,1977
7638,3501601840,3757812939,1672688725,1672692046,3321
7543,3401627165,3773120434,1672642921,1672645827,2906
7880,3710112546,3378092448,1672591517,1672591984,467
7689,3489728806,3298433163,1672585754,1672587057,1303
7863,3606186086,3736786443,1672611979,1672614496,2517
7982,3534729133,3770763956,1672573036,1672574469,1433
7799,3318697153,3858918246,1672586064,1672586752,688
7964,3976633198,3229058858,1672651336,1672654827,3491
7707,3291235378,3773205565,1672563100,1672565450,2350
7577,3511687358,3777790718,1672624507,1672627467,2960
7913,3367029997,3888559320,1672650007,1672653250,3243
7953,3792768129,3883312122,1672667187,1672667986,799
7726,3510711755,3406784491,1672631849,1672633835,1986
7665,3703889596,3664517356,1672632855,1672634999,2144
7775,3611150562,3629935998,1672578808,1672581890,3082
7945,3478194807,3783126683,1672567234,1672569276,2042
7887,3533827120,3311274543,1672673341,1672675726,2385
7600,3608633356,3475396323,1672700577,1672701572,995
7837,3776066388,3356860407,1672569268,1672572301,3033
7682,3388286531,3639847263,1672581546,1672585082,3536
7634,3294803686,3770824086,1672691200,1672694432,3232
7504,3238712269,3311439795,1672609270,1672611740,2470
7902,3703871468,3424922204,1672643934,1672644357,423
7645,3859525941,3882291183,1672596620,1672598677,2057
7526,3911159965,3716835696,1672658432,1672659319,887
7602,3383661227,3828432634,1672668328,1672668803,475
7498,3710408395,3774501422,1672702656,1672704573,1917
7589,3755625324,3505873261,1672553355,1672555704,2349
7729,3318697153,3772359096,1672533314,1672536714,3400
7778,3755739653,3904775198,1672668906,1672669156,250
7801,3628819436,3220716272,1672670809,1672671213,404
7779,3424922204,3500487333,1672570814,1672573455,2641
7970,3510126867,3501198706,1672622618,1672626116,3498
7524,3533095755,3777079686,1672698794,1672700603,1809
7860,3710112546,3716537575,1672546863,1672549194,2331
7938,3505362057,3481502100,1672652522,1672652872,350
7978,3489962019,3484995752,1672581762,1672583277,1515
7500,3621810464,3356860407,1672646649,1672650242,3593
7724,3777717988,3430074045,1672604645,1672605563,918
7943,3511125626,3313564074,1672596006,1672597499,1493
7918,3716165213,3331845324,1672563247,1672566775,3528
7502,3500994774,3757455053,1672606817,1672609588,2771
7828,3473765852,3757562897,1672664170,1672665407,1237
7704,3493507965,3505599848,1672687287,1672687912,625
7514,3792032359,3780788622,1672593649,1672596916,3267
7646,3734496778,3511332835,1672598362,1672601940,3578
7840,3711308224,3520206212,1672562880,1672562940,60
7851,3291235378,3793470489,1672645725,1672646245,520
7552,3713808837,3633420270,1672567175,1672568547,1372
7546,3472130842,3394539273,1672576296,1672577555,1259
7726,3711571712,3793470489,1672544747,1672545017,270
7719,3920801189,3703441914,1672563340,1672565459,2119
7527,3505203158,3482405588,1672656224,1672657531,1307
7495,3510244400,3234541252,1672627178,1672630453,3275
7805,3500729955,3783429780,1672543623,1672546630,3007
7754,3625274012,3703889596,1672642086,1672642968,882
7603,3345207877,3666457294,1672688830,1672691133,2303
7863,3510173870,3466229085,1672591183,1672593671,2488
7552,3859525941,3512720680,1672673522,1672676121,2599
7483,3774793839,3209027249,1672627402,1672627701,299
7548,3772309166,3667680268,1672570486,1672573623,3137
7626,3716197887,3755625324,1672697798,1672699907,2109
7568,3339907603,3511163800,1672556962,1672560187,3225
7605,3430352815,3466911760,1672653216,1672654761,1545
7893,3773120434,3516039895,1672701512,1672703687,2175
7982,3793338102,3298433163,1672657493,1672657723,230
7673,3489962019,3738274418,1672664679,1672666531,1852
7887,3406784491,3367029997,1672628012,1672629244,1232
7801,3351554343,3223789409,1672638578,1672640972,2394
7561,3937224533,3505098372,1672571778,1672572426,648
7731,3777983879,3505098372,1672630114,1672630261,147
7819,3915628728,3520206212,1672579188,1672580472,1284
7715,3909331423,3517721725,1672638663,1672641391,2728
7879,3793436995,3291227780,1672671664,1672674199,2535
7550,3516065852,3826415738,1672684419,1672686798,2379
7683,3703889596,3737051610,1672663714,1672666842,3128
7526,3280599164,3312829208,1672679059,1672681692,2633
7692,3505702787,3287105466,1672640526,1672642132,1606
7561,3774556560,3500803339,1672658465,1672659586,1121
7936,3277605882,3298433163,1672644656,1672644999,343
7632,3711973519,3489962019,1672543341,1672546011,2670
7586,3520709480,3800353779,1672546518,1672548038,1520
7511,3910454786,3757246925,1672578929,1672580027,1098
7749,3247428249,3277669002,1672694925,1672696533,1608
7660,3888559320,3415546117,1672612256,1672612872,616
7894,3358871377,3510380060,1672553649,1672554254,605
7730,3518014404,3512166013,1672677780,1672679472,1692
7663,3756930948,3289061738,1672612905,1672616263,3358
7706,3891751546,3516514391,1672575472,1672577694,2222
7821,3851190615,3909606423,1672664215,1672666123,1908
7902,3500803339,3501198706,1672676063,1672677100,1037
7804,3209027249,3770851318,1672697248,1672699208,1960
7691,3364543015,3780974443,1672615107,1672615693,586
7761,3613995936,3738274418,1672584786,1672586784,1998
7707,3533810360,3384240055,1672555088,1672555716,628
7620,3500199935,3516065852,1672598682,1672601947,3265
7949,3505203158,3827222533,1672656308,1672658319,2011
7711,3737154119,3756966035,1672621875,1672621965,90
7643,3417970574,3778780511,1672634491,1672635161,670
7829,3402943525,3505477652,1672548834,1672551102,2268
7636,3533095755,3280599164,1672541909,1672544357,2448
7836,3809484172,3935627557,1672576291,1672578923,2632
7502,3242408357,3715974031,1672633202,1672635554,2352
7799,3201848640,3533242305,1672632999,1672636197,3198
7761,3395152943,3433804879,1672562180,1672565438,3258
7494,3777983879,3476232529,1672579485,1672581356,1871
7900,3882997884,3345207877,1672582075,1672584240,2165
7910,3633420270,3365942576,1672652233,1672653923,1690
7660,3703275621,3852595551,1672590381,1672590992,611
7723,3500499542,3518163778,1672558678,1672560027,1349
7582,3713894336,3509907947,1672621902,1672623930,2028
7950,3683766533,3489962019,1672614237,1672616085,1848
7718,3297463265,3501184421,1672658022,1672658369,347
7662,3417970574,3778980116,1672548061,1672548665,604
7947,3773598056,3534488837,1672633033,1672633093,60
7646,3518408774,3757812939,1672555807,1672557633,1826
7590,3770851318,3314836094,1672660641,1672661435,794
7824,3238712269,3287105466,1672670942,1672673034,2092
7654,3481502100,3773429448,1672559751,1672563082,3331
7896,3505219850,3416265063,1672703458,1672705445,1987
7850,3311603601,3311274543,1672535712,1672536650,938
7668,3483164654,3200691026,1672640232,1672642820,2588
7793,3515860749,3779218771,1672586541,1672589042,2501
7976,3903962771,3242408357,1672619939,1672621197,1258
7932,3516039895,3776800213,1672606469,1672609348,2879
7802,3713349754,3280599164,1672552076,1672555299,3223
7506,3496051529,3736419952,1672607781,1672610209,2428
7612,3505791599,3805292782,1672602662,1672605457,2795
7778,3512349371,3516011407,1672660110,1672660828,718
7816,3736229191,3770447408,1672611937,1672612048,111
7537,3760183458,3780828689,1672539546,1672540861,1315
7856,3510771358,3711198793,1672536529,1672537937,1408
7575,3501955238,3489728806,1672611099,1672612482,1383
7904,3520183192,3715127362,1672626943,1672630110,3167
7618,3501692334,3774010081,1672570872,1672572658,1786
7520,3755739653,3600647945,1672557453,1672557883,430
7858,3206254161,3792473331,1672668998,1672669213,215
7522,3378436155,3716746253,1672585596,1672587399,1803
7747,3356860407,3500499542,1672564954,1672566234,1280
7508,3514472925,3224716315,1672650669,1672654233,3564
7852,3279721246,3914290246,1672572524,1672576121,3597
7490,3916289176,3823600322,1672554920,1672558415,3495
7845,3379589402,3517509185,1672686471,1672687276,805
7614,3511687358,3802367797,1672596505,1672599431,2926
7964,3832902928,3247780536,1672613189,1672615652,2463
7861,3793753089,3716197887,1672655021,1672655275,254
7684,3244173074,3520730271,1672556172,1672559235,3063
7858,3473562469,3426325549,1672655576,1672658290,2714
7908,3774125065,3666507626,1672584023,1672584448,425
7956,3774045700,3311090974,1672588214,1672590156,1942
7534,3774520233,3390068992,1672534395,1672534815,420
7555,3756930948,3514128943,1672565711,1672567801,2090
7634,3793871337,3755920131,1672698441,1672701671,3230
7486,3816454165,3511841857,1672628163,1672628888,725
7553,3828432634,3516909237,1672691281,1672694772,3491
7970,3379256399,3342131135,1672668314,1672670663,2349
7895,3510771358,3505912939,1672616849,1672618513,1664
7875,3510594211,3518360734,1672547548,1672548854,1306
7856,3516514391,3777079686,1672647906,1672648683,777
7584,3311871871,3367902229,1672582727,1672584012,1285
7559,3783779671,3701863557,1672662298,1672662498,200
7699,3920801189,3515691540,1672692454,1672695026,2572
7839,3516980378,3883861463,1672649701,1672652170,2469
7920,3668898102,3755436115,1672580191,1672583358,3167
7755,3682061100,3520888296,1672564069,1672565974,1905
7513,3757246925,3244389794,1672610582,1672611184,602
7661,3618045231,3509907947,1672565895,1672568509,2614
7826,3311154569,3774520233,1672571172,1672571266,94
7883,3489217083,3209551760,1672573281,1672574233,952
7848,3755511676,3488244966,1672628457,1672631591,3134
7779,3626156564,3501692334,1672575417,1672577738,2321
7604,3756027749,3500904641,1672556292,1672558865,2573
7491,3922275620,3512969370,1672603800,1672606447,2647
7873,3779036831,3516039895,1672584250,1672587576,3326
7812,3533369198,3829319703,1672687086,1672690463,3377
7941,3286658957,3888559320,1672638072,1672639725,1653
7559,3715339701,3505347134,1672674548,1672675613,1065
7898,3772309166,3228165483,1672625582,1672626718,1136
7810,3500177712,3489962019,1672645215,1672646149,934
7509,3736625083,3365614305,1672536759,1672538192,1433
7702,3760569731,3475258557,1672589157,1672592650,3493
7515,3273500349,3851190615,1672625573,1672626606,1033
7684,3791657947,3517509185,1672535946,1672538156,2210
7725,3311154569,3756528686,1672607628,1672610885,3257
7715,3710344260,3311439795,1672611988,1672614438,2450
7688,3731419510,3303705369,1672626366,1672628048,1682
7671,3755511676,3505973226,1672545969,1672547659,1690
7965,3756027749,3517721725,1672550645,1672551830,1185
7630,3513201436,3520206212,1672547549,1672550409,2860
7937,3901990690,3791334389,1672689830,1672690919,1089
7620,3303751772,3703789494,1672547806,1672548151,345
7667,3713969578,3209027249,1672692958,1672695632,2674
7791,3809916577,3711262377,1672686972,1672689069,2097
7781,3701178711,3791115967,1672670281,1672672252,1971
7740,3791594391,3397418363,1672612396,1672614590,2194
7812,3501486692,3853018906,1672537571,1672537838,267
7922,3519703355,3887270940,1672695501,1672698135,2634
7770,3791874383,3736625083,1672660291,1672663746,3455
7925,3533810360,3755943611,1672693063,1672695331,2268
7511,3880285638,3520376528,1672642647,1672643638,991
7879,3311090974,3774005526,1672558710,1672559222,512
7807,3279721246,3660493209,1672568140,1672570591,2451
7704,3556951786,3607178184,1672629293,1672631944,2651
7720,3428674539,3505347134,1672536206,1672539103,2897
7510,3899266183,3223968713,1672601062,1672602975,1913
7662,3757682496,3428674539,1672659928,1672661799,1871
7745,3903962771,3224716315,1672667010,1672669541,2531
7591,3792789881,3916289176,1672675431,1672676288,857
7836,3701498253,3311871871,1672688159,1672689107,948
7659,3298288268,3783239924,1672614615,1672616369,1754
7578,3517963492,3385763781,1672653408,1672653934,526
7583,3760509236,3500374658,1672590262,1672593353,3091
7851,3909238838,3500487333,1672688245,1672690091,1846
7500,3481502100,3774127586,1672543008,1672545932,2924
7483,3201324715,3634340855,1672616022,1672617435,1413
7596,3770078063,3235635976,1672569186,1672570202,1016
7783,3485008994,3736419952,1672548979,1672552277,3298
7750,3626156564,3520030713,1672642314,1672643957,1643
7668,3520709480,3912536808,1672680307,1672681152,845
7755,3379256399,3516011407,1672582857,1672583018,161
7677,3534729133,3852391257,1672674195,1672677164,2969
7753,3607178184,3374559242,1672614682,1672615339,657
7790,3458539365,3511359172,1672532738,1672534774,2036
7687,3312829208,3756623396,1672679374,1672681052,1678
7832,3336742544,3760077057,1672703500,1672706134,2634
7850,3819727225,3755872268,1672574211,1672576667,2456
7816,3770824086,3554917400,1672577906,1672578692,786
7960,3475251781,3505135325,1672690571,1672694068,3497
7532,3714488548,3490191091,1672559233,1672562630,3397
7807,3703871468,3774050956,1672652473,1672654617,2144
7622,3733891182,3489217083,1672554178,1672556706,2528
7613,3311415018,3792473331,1672608453,1672611441,2988
7504,3518360734,3836573197,1672577460,1672580812,3352
7727,3606812411,3512510536,1672615253,1672618539,3286
7748,3493507965,3407673904,1672563340,1672564372,1032
7909,3791874383,3757562897,1672659727,1672659902,175
7911,3755739653,3666507626,1672563708,1672565958,2250
7739,3918247820,3514245078,1672582518,1672586063,3545
7712,3792177074,3783531004,1672574900,1672578378,3478
7953,3736592744,3773120434,1672684911,1672685957,1046
7908,3397418363,3518260334,1672599735,1672600372,637
7930,3915628728,3774298222,1672684611,1672685508,897
7773,3713786889,3209027249,1672564008,1672564465,457
7607,3910886626,3405494240,1672650666,1672651190,524
7508,3756424865,3517721725,1672624155,1672626437,2282
7936,3235287260,3344364444,1672600979,1672603383,2404
7810,3912262917,3385763781,1672578248,1672578539,291
7571,3314245084,3777929708,1672691477,1672694982,3505
7931,3510247121,3780503655,1672658896,1672661708,2812
7491,3666457294,3773664987,1672616803,1672620229,3426
7518,3238712269,3273500349,1672693197,1672693656,459
7496,3345207877,3395152943,1672592393,1672594456,2063
7801,3416427576,3628819436,1672646039,1672649026,2987
7706,3914259449,3206254161,1672683981,1672685547,1566
7763,3483949762,3633420270,1672628674,1672629043,369
7779,3756930948,3432689543,1672622683,1672624007,1324
7845,3756528686,3405494240,1672596986,1672597130,144
7639,3505000737,3246596716,1672659346,1672662847,3501
7739,3715189301,3730517636,1672575999,1672576893,894
7794,3505873261,3421836608,1672588524,1672589107,583
7740,3792384220,3827222533,1672601716,1672605059,3343
7535,3773755137,3520030713,1672685748,1672685958,210
7873,3280964728,3520730271,1672638525,1672641870,3345
7780,3416241005,3518014404,1672533916,1672537187,3271
7598,3731419510,3716746253,1672645247,1672647456,2209
7697,3505193212,3772337814,1672702246,1672703102,856
7653,3801089989,3298433163,1672554039,1672555712,1673
7777,3716165213,3518669703,1672582823,1672584530,1707
7804,3736786443,3780503655,1672608105,1672609172,1067
7914,3533280269,3473765852,1672664540,1672666778,2238
7756,3855000166,3625274012,1672670034,1672673181,3147
7751,3384240055,3496051529,1672582856,1672584364,1508
7734,3772337814,3494290908,1672635876,1672635978,102
7722,3701984666,3372883226,1672586611,1672587206,595
7894,3715974031,3735319397,1672626261,1672626801,540
7642,3514472925,3244485293,1672559158,1672560309,1151
7958,3710112546,3773465237,1672563884,1672564280,396
7727,3757682496,3930797455,1672553453,1672554442,989
7529,3284832486,3710112546,1672587381,1672589798,2417
7683,3345207877,3772544062,1672588378,1672589139,761
7483,3512837326,3489728806,1672683609,1672686918,3309
7657,3783126683,3500994774,1672700569,1672702917,2348
7776,3510937904,3777477395,1672599225,1672601730,2505
7557,3880285638,3755943611,1672686260,1672687802,1542
7597,3510247121,3882997884,1672552211,1672554524,2313
7635,3510703546,3778266283,1672650113,1672653244,3131
7547,3373384732,3500487333,1672536174,1672538863,2689
7768,3505145247,3391915886,1672636164,1672638287,2123
7947,3688418210,3349613093,1672699388,1672700417,1029
7651,3336751428,3249247700,1672585254,1672587579,2325
7896,3378686918,3510244400,1672548230,1672548400,170
7937,3703735129,3793753089,1672650193,1672653564,3371
7867,3825229501,3701065786,1672531771,1672533380,1609
7957,3760267716,3855937514,1672629647,1672631875,2228
7816,3417587765,3832902928,1672589048,1672591835,2787
7522,3501184421,3511312803,1672647861,1672650402,2541
7651,3774556560,3533827120,1672630872,1672633634,2762
7689,3385763781,3516514391,1672573887,1672577136,3249
7802,3780503655,3516909237,1672558630,1672559354,724
7856,3519654779,3777776687,1672611694,1672615146,3452
7580,3311090974,3624312512,1672639645,1672641252,1607
7854,3397418363,3772337814,1672557581,1672558187,606
7568,3777443199,3520183192,1672656243,1672659284,3041
7775,3809916577,3772359096,1672541102,1672541381,279
7494,3639847263,3701111745,1672615305,1672618757,3452
7828,3604539807,3318697153,1672632426,1672633547,1121
7963,3533369198,3760569731,1672591210,1672594014,2804
7934,3352603894,3517476351,1672532635,1672536216,3581
7827,3513080274,3777623166,1672678666,1672680906,2240
7696,3793338102,3617734118,1672665943,1672666598,655
7759,3716900301,3249791738,1672542909,1672544079,1170
7734,3505973226,3311993075,1672619175,1672619394,219
7789,3614238812,3624761861,1672536041,1672538169,2128
7796,3711504540,3855602893,1672544013,1672547600,3587
7663,3224716315,3757403279,1672587102,1672589709,2607
7891,3473562469,3500729955,1672578644,1672581262,2618
7880,3757682496,3773814927,1672644607,1672645976,1369
7581,3400804807,3505962865,1672696234,1672696454,220
7855,3351554343,3346795719,1672537369,1672538163,794
7516,3925620998,3617055293,1672695925,1672697569,1644
7651,3714474557,3421836608,1672629905,1672630389,484
7940,3374559242,3501759100,1672582474,1672584296,1822
7525,3703661585,3710344260,1672655282,1672657661,2379
7506,3714488548,3311993075,1672703324,1672705815,2491
7578,3514283243,3505638204,1672691976,1672692411,435
7582,3791657947,3778341199,1672665078,1672667542,2464
7671,3783196518,3514838220,1672534799,1672538107,3308
7850,3666457294,3935127663,1672569321,1672571312,1991
7953,3716537575,3760509236,1672674792,1672675363,571
7538,3859663348,3421836608,1672628099,1672630805,2706
7617,3389115045,3383922351,1672563576,1672567087,3511
7727,3533270638,3483164654,1672608327,1672610102,1775
7549,3249791738,3887270940,1672635975,1672636059,84
7757,3293695955,3473765852,1672685130,1672688277,3147
7537,3517721725,3716537575,1672678085,1672679308,1223
7957,3703789494,3793962300,1672669788,1672672166,2378
7572,3809059934,3483949762,1672589397,1672592899,3502
7586,3488244966,3902278226,1672606670,1672608856,2186
7643,3485008994,3513201436,1672593317,1672596091,2774
7914,3501601840,3520206212,1672532083,1672534661,2578
7524,3533270638,3247780536,1672649003,1672651346,2343
7524,3500365158,3902383721,1672643717,1672644336,619
7821,3755625324,3804870229,1672564360,1672564726,366
7729,3249247700,3518408774,1672672578,1672673794,1216
7903,3404058699,3774268456,1672576863,1672578484,1621
7617,3416427576,3483164654,1672653352,1672656740,3388
7662,3808324264,3511312803,1672597291,1672597717,426
7521,3533242305,3485823740,1672582605,1672584769,2164
7983,3930797455,3510969660,1672570825,1672571990,1165
7697,3713644518,3518669703,1672677339,1672678609,1270
7737,3883085535,3777717988,1672699015,1672702225,3210
7746,3421127249,3520756859,1672692054,1672693352,1298
7496,3817621391,3346795719,1672561898,1672563926,2028
7779,3516629436,3311274543,1672616147,1672618657,2510
7980,3301107849,3716273414,1672536700,1672539109,2409
7906,3828432634,3793627961,1672548924,1672550688,1764
7489,3756601594,3857349323,1672539212,1672542740,3528
7721,3714821932,3899266183,1672655147,1672658383,3236
7700,3774119563,3703889596,1672678375,1672678473,98
7669,3904408902,3430504438,1672622933,1672624283,1350
7773,3622054816,3664170666,1672557197,1672557676,479
7701,3756462516,3234362962,1672626417,1672627858,1441
7836,3935127663,3293695955,1672657791,1672659357,1566
7619,3505599848,3489962019,1672667596,1672668427,831
7674,3302626661,3477375368,1672567652,1672570221,2569
7645,3975287541,3284639858,1672622486,1672622585,99
7506,3734496778,3359910781,1672543031,1672544728,1697
7639,3276993580,3755392666,1672659219,1672659816,597
7934,3773120434,3779528381,1672638029,1672641206,3177
7675,3777623166,3313541986,1672637600,1672639115,1515
7576,3807987001,3520756859,1672622729,1672626325,3596
7919,3837094550,3271938399,1672699425,1672700739,1314
7899,3890149705,3770553384,1672634045,1672634835,790
7532,3510244400,3511267139,1672683015,1672683223,208
7874,3710408395,3683959482,1672701872,1672701964,92
7937,3852595551,3534313900,1672662249,1672662417,168
7566,3822654369,3517077106,1672638438,1672641455,3017
7800,3617734118,3711198793,1672678299,1672678370,71
7742,3411618230,3510173870,1672585799,1672588057,2258
7775,3396086535,3756021689,1672685715,1672687328,1613
7949,3311718847,3482405588,1672539904,1672541871,1967
7892,3972709319,3501955238,1672680106,1672682084,1978
7725,3406784491,3291235378,1672672485,1672674410,1925
7551,3512142794,3365614305,1672702069,1672702234,165
7540,3427219654,3287105466,1672614614,1672615859,1245
7513,3407954858,3209383861,1672599708,1672602671,2963
7555,3792384220,3883085535,1672583271,1672586297,3026
7564,3533369198,3760077057,1672625143,1672626358,1215
7964,3634340855,3822654369,1672632392,1672632628,236
7636,3701534009,3418728074,1672571099,1672572110,1011
7813,3519700826,3427283336,1672698435,1672701453,3018
7714,3624312512,3509630174,1672544062,1672547330,3268
7913,3314245084,3407725581,1672533289,1672535754,2465
7636,3365830990,3501927421,1672697564,1672700500,2936
7514,3757246925,3516909237,1672551239,1672554039,2800
7649,3735319397,3613995936,1672597655,1672599391,1736
7752,3500729955,3303705369,1672632364,1672632453,89
7831,3816853177,3783245561,1672550347,1672550886,539
7785,3370752401,3357483218,1672618491,1672620201,1710
7796,3755920131,3387674757,1672569612,1672572896,3284
7550,3514838220,3386707783,1672693679,1672695854,2175
7584,3277939457,3519069599,1672558863,1672562060,3197
7517,3517459919,3533927138,1672682415,1672682783,368
7751,3472130842,3500729955,1672664067,1672667109,3042
7809,3273500349,3518791447,1672690029,1672692125,2096
7762,3976390453,3517476351,1672623904,1672625622,1718
7964,3811171116,3715581279,1672695053,1672697597,2544
7546,3421836608,3533369198,1672563214,1672565247,2033
7535,3793389510,3733891182,1672577354,1672578944,1590
7696,3735319397,3614238812,1672555855,1672558328,2473
7607,3714504419,3505869747,1672672076,1672672664,588
7634,3477649378,3760598102,1672547316,1672548494,1178
7742,3515860749,3400918687,1672576543,1672579538,2995
7651,3792768129,3791115967,1672533097,1672533860,763
7490,3439023335,3556951786,1672647131,1672648944,1813
7882,3519654779,3510244400,1672616247,1672617017,770
7707,3770824086,3976633198,1672656195,1672658017,1822
7805,3734737881,3501364586,1672663333,1672666186,2853
7983,3249791738,3715189301,1672645051,1672646273,1222
7820,3289061738,3716900301,1672612035,1672614751,2716
7621,3533280269,3518014404,1672579450,1672579527,77
7493,3505347134,3483164654,1672580616,1672581973,1357
7814,3780813786,3776066388,1672574415,1672576340,1925
7854,3390068992,3517963492,1672692791,1672695324,2533
7872,3311152102,3488244966,1672583300,1672584833,1533
7854,3313541986,3783245561,1672697132,1672700138,3006
7823,3975287541,3307512479,1672698356,1672699743,1387
7919,3427219654,3979339287,1672643824,1672645350,1526
7674,3516980378,3716537575,1672640864,1672643872,3008
7896,3415546117,3505904952,1672548201,1672550273,2072
7533,3374559242,3774010081,1672576096,1672579023,2927
7712,3792844210,3534553510,1672585263,1672586169,906
7884,3229665776,3783083229,1672571064,1672573752,2688
7496,3432665384,3346795719,1672698863,1672699958,1095
7650,3500229033,3518260334,1672675703,1672677718,2015
7744,3736419952,3701863557,1672593956,1672596899,2943
7553,3760992710,3500177712,1672632578,1672635235,2657
7491,3711504540,3683766533,1672605545,1672608323,2778
7913,3793959750,3418534998,1672686798,1672687193,395
7483,3511198618,3220716272,1672702513,1672703739,1226
7519,3774339795,3510969660,1672695194,1672696367,1173
7550,3554917400,3520030713,1672681574,1672681857,283
7968,3533748232,3811694763,1672625173,1672627874,2701
7809,3443698222,3337544549,1672657805,1672659607,1802
7750,3913251733,3793871337,1672664373,1672665945,1572
7615,3509352754,3512349371,1672568598,1672570759,2161
7937,3518163778,3514283243,1672570818,1672573528,2710
7968,3819727225,3776066388,1672626732,1672629542,2810
7800,3518260334,3415443558,1672609554,1672612729,3175
7893,3505530961,3407725581,1672639915,1672642103,2188
7754,3716537575,3473562469,1672585023,1672586737,1714
7654,3777717988,3757455053,1672542318,1672545196,2878
7713,3378436155,3826759140,1672642730,1672645772,3042
7649,3792668962,3792844210,1672654178,1672657641,3463
7814,3370752401,3780639480,1672684365,1672686033,1668
7749,3365830990,3316173088,1672631916,1672633348,1432
7586,3792844210,3783705817,1672627834,1672629213,1379
7934,3857349323,3703275621,1672636672,1672639216,2544
7575,3516980378,3510937904,1672643266,1672644881,1615
7509,3792789881,3778108318,1672569096,1672570989,1893
7842,3409474775,3731419510,1672665274,1672667653,2379
7573,3501692334,3621810464,1672647884,1672648730,846
7485,3501184421,3331845324,1672641124,1672643074,1950
7747,3703013906,3518360734,1672652233,1672653438,1205
7829,3920801189,3852391257,1672667851,1672671097,3246
7491,3291883916,3792473331,1672586914,1672587188,274
7759,3285400528,3505193212,1672610856,1672610989,133
7927,3509907947,3774793839,1672607499,1672609022,1523
7856,3296471982,3277669002,1672644381,1672647092,2711
7830,3756623396,3770078063,1672595478,1672595759,281
7856,3511359172,3514245078,1672684037,1672684859,822
7729,3505873261,3318697153,1672636926,1672640340,3414
7761,3448855696,3970117174,1672695879,1672699459,3580
7599,3716835696,3614238812,1672609362,1672612545,3183
7946,3783429780,3389115045,1672615699,1672617442,1743
7772,3634340855,3512969370,1672611347,1672612013,666
7868,3516716179,3774520233,1672633551,1672634073,522
7878,3829319703,3501606184,1672657615,1672658661,1046
7627,3466229085,3248507722,1672531569,1672532876,1307
7584,3367029997,3520030713,1672536749,1672538805,2056
7675,3716900301,3713349754,1672657140,1672659598,2458
7755,3427219654,3793627961,1672698915,1672700576,1661
7721,3882291183,3757246925,1672575756,1672576335,579
7834,3773465237,3277605882,1672624444,1672625940,1496
7651,3509453566,3475396323,1672535072,1672537873,2801
7954,3520719611,3311718847,1672599382,1672600221,839
7627,3618873142,3791602225,1672620351,1672622169,1818
7663,3512683609,3201848640,1672583406,1672586366,2960
7928,3534553510,3209048907,1672614798,1672615291,493
7573,3713268590,3500994774,1672583107,1672585632,2525
7492,3757403279,3467773920,1672696749,1672698309,1560
7493,3901990690,3510173870,1672541644,1672543602,1958
7822,3500374658,3770447408,1672608154,1672610828,2674
7702,3370636709,3465202715,1672658501,1672661493,2992
7567,3383661227,3511332835,1672692446,1672694783,2337
7632,3912536808,3711308224,1672600240,1672600662,422
7927,3409474775,3534424200,1672635698,1672639147,3449
7819,3935127663,3359910781,1672542344,1672544581,2237
7556,3757562897,3713969578,1672656403,1672659464,3061
7910,3837094550,3345207877,1672693684,1672695050,1366
7968,3378686918,3407725581,1672557228,1672558693,1465
7855,3701534009,3791997875,1672553967,1672557143,3176
7783,3517459919,3732481297,1672572302,1672572865,563
7798,3238712269,3791115967,1672536548,1672540059,3511
7483,3701898991,3791874383,1672611777,1672612989,1212
7723,3791901535,3883551721,1672672821,1672676047,3226
7832,3519152550,3519803045,1672639566,1672639927,361
7837,3534313900,3391261292,1672546459,1672546805,346
7817,3792768129,3760492950,1672671547,1672674755,3208
7617,3774298222,3552314511,1672690118,1672692038,1920
7643,3760598102,3610695419,1672683453,1672686550,3097
7875,3756424865,3701190899,1672571057,1672573329,2272
7582,3779036831,3701146057,1672626766,1672628896,2130
7923,3313541986,3828365570,1672691933,1672692094,161
7867,3777929708,3446948848,1672632883,1672633067,184
7649,3420700674,3513080274,1672588546,1672591728,3182
7837,3520756859,3519563836,1672690180,1672690563,383
7638,3780503655,3501606184,1672689297,1672691564,2267
7781,3432665384,3793436995,1672703610,1672705264,1654
7617,3935127663,3489217083,1672676133,1672679183,3050
7811,3921211276,3235287260,1672601244,1672604664,3420
7934,3496269445,3780813786,1672676972,1672677671,699
7483,3404058699,3716746253,1672633198,1672633508,310
7625,3534424200,3793338102,1672603144,1672603349,205
7510,3755392666,3826415738,1672553081,1672554166,1085
7942,3760294205,3756528686,1672613634,1672616275,2641
7576,3412980697,3757151210,1672554900,1672555804,904
7673,3716835696,3235635976,1672636537,1672638709,2172
7849,3920801189,3772746272,1672652450,1672654179,1729
7491,3823600322,3901990690,1672683992,1672686791,2799
7695,3517255726,3314245084,1672589294,1672590755,1461
7666,3222521619,3703871468,1672663867,1672664060,193
7653,3881477378,3500487333,1672550269,1672553494,3225
7909,3922275416,3809059934,1672650683,1672652603,1920
7576,3473765852,3627937312,1672671928,1672673496,1568
7691,3716165213,3513080274,1672653636,1672654786,1150
7756,3505193212,3774268456,1672660453,1672663801,3348
7618,3828624701,3809059934,1672549676,1672550743,1067
7795,3396086535,3701984666,1672688205,1672691772,3567
7661,3755872268,3901877072,1672639465,1672640102,637
7492,3910886626,3518932404,1672591744,1672594967,3223
7573,3515125508,3882997884,1672602056,1672604619,2563
7857,3416427576,3338703270,1672687368,1672688011,643
7898,3711198793,3714504419,1672659202,1672661693,2491
7525,3451432842,3311718847,1672598622,1672602073,3451
7812,3496549058,3505883609,1672627766,1672630121,2355
7965,3774195321,3791874383,1672669488,1672670995,1507
7587,3779976989,3819727225,1672548047,1672550506,2459
7958,3476232529,3828432634,1672590999,1672593275,2276
7964,3756021689,3534729133,1672566030,1672568735,2705
7811,3432665384,3505962865,1672625967,1672628006,2039
7583,3505193212,3276640712,1672682768,1672685709,2941
7779,3221899927,3390068992,1672694455,1672694681,226
7938,3715492942,3303751772,1672681274,1672683603,2329
7674,3501184421,3757602960,1672644983,1672647184,2201
7801,3756027749,3777455223,1672652564,1672652884,320
7683,3357483218,3405494240,1672665201,1672668659,3458
7716,3809916577,3520183192,1672539599,1672541719,2120
7732,3242408357,3489728806,1672656644,1672657805,1161
7793,3512142794,3248507722,1672547108,1672550654,3546
7820,3515284591,3489728806,1672619907,1672623288,3381
7528,3776338577,3783779671,1672556421,1672558387,1966
7740,3235287260,3773978034,1672559248,1672562421,3173
7495,3311648200,3286658957,1672568715,1672569483,768
7639,3755739653,3760561634,1672668591,1672668938,347
7649,3338367113,3391261292,1672666391,1672668306,1915
7911,3756623396,3247780536,1672582413,1672584053,1640
7608,3828365570,3369998498,1672578244,1672579439,1195
7948,3779976989,3533242305,1672540005,1672541511,1506
7669,3770824086,3223789409,1672553557,1672555891,2334
7647,3247428249,3201324715,1672682013,1672683923,1910
7693,3430074045,3510594211,1672560872,1672564156,3284
7848,3209027249,3517459919,1672680533,1672682271,1738
7547,3534191820,3416265063,1672540672,1672544173,3501
7951,3800353779,3715581279,1672693559,1672696741,3182
7933,3685187183,3509672210,1672597010,1672598000,990
7533,3429856982,3611150562,1672618087,1672620823,2736
7854,3307097200,3936227020,1672649704,1672651992,2288
7826,3517255726,3505201246,1672615544,1672617659,2115
7667,3370752401,3930797455,1672650788,1672651954,1166
7789,3516629436,3513956646,1672664564,1672667173,2609
7796,3533827120,3829319703,1672667165,1672667794,629
7906,3755881905,3792902982,1672667026,1672667429,403
7831,3384240055,3732481297,1672651967,1672654378,2411
7737,3606186086,3303705369,1672696903,1672698965,2062
7842,3409474775,3826760240,1672573550,1672574660,1110
7523,3384240055,3288764520,1672654007,1672654591,584
7563,3918674986,3760077057,1672642792,1672643475,683
7803,3516011407,3703275621,1672691384,1672694751,3367
7894,3755920131,3249791738,1672624670,1672628149,3479
7809,3710098970,3516465662,1672597395,1672599532,2137
7875,3533810360,3715492942,1672666648,1672668205,1557
7832,3792883665,3222521619,1672702615,1672703340,725
7586,3514472925,3386707783,1672537355,1672538940,1585
7550,3736229191,3820354437,1672674830,1672675467,637
7943,3608633356,3816454165,1672541853,1672542803,950
7902,3311154569,3770078063,1672649551,1672650136,585
7768,3888559320,3617055293,1672658805,1672659655,850
7743,3476232529,3883085535,1672563922,1672567291,3369
7518,3760893269,3791594391,1672591022,1672593877,2855
7586,3518014404,3903307060,1672641463,1672644926,3463
7628,3505145247,3688683847,1672595231,1672596307,1076
7854,3244485293,3232962003,1672619434,1672619773,339
7861,3772884106,3512540951,1672622521,1672623017,496
7860,3883312122,3516065852,1672630846,1672632072,1226
7636,3817621391,3465202715,1672570780,1672571870,1090
7522,3715492942,3307512479,1672535729,1672537468,1739
7957,3910454786,3417061462,1672554709,1672557468,2759
7904,3377766165,3513164386,1672573018,1672576562,3544
7809,3776066388,3715998609,1672658246,1672658587,341
7853,3716746253,3360993964,1672609373,1672612934,3561
7773,3608868877,3501364586,1672596554,1672599283,2729
7883,3520190170,3703275621,1672644036,1672644555,519
7730,3772642849,3307097200,1672679856,1672682390,2534
7610,3811171116,3466229085,1672674687,1672676005,1318
7571,3206603608,3836573197,1672556823,1672559032,2209
7671,3793753089,3313564074,1672541410,1672542393,983
7526,3772746272,3917278625,1672700780,1672703629,2849
7973,3772309150,3516960534,1672664675,1672665572,897
7741,3904408902,3501184421,1672551792,1672551991,199
7758,3373384732,3859663348,1672621940,1672624050,2110
7751,3757447189,3291235378,1672673614,1672676305,2691
7931,3780813786,3903962771,1672689879,1672692921,3042
7897,3809916577,3855424474,1672669348,1672670503,1155
7874,3319752091,3793470489,1672678615,1672678768,153
7712,3505859863,3360993964,1672595361,1672598569,3208
7569,3407725581,3533653428,1672670299,1672673786,3487
7859,3783196518,3888559320,1672687583,1672689094,1511
7828,3520206212,3826415738,1672603889,1672605487,1598
7877,3342131135,3812176780,1672537367,1672538682,1315
7979,3731106822,3348261553,1672617295,1672619644,2349
7963,3511267139,3517509185,1672533470,1672536249,2779
7644,3837094550,3859663348,1672540023,1672542000,1977
7719,3770101921,3802367797,1672553507,1672556037,2530
7682,3918584946,3783245561,1672571359,1672572392,1033
7508,3451432842,3716843669,1672629940,1672632300,2360
7504,3917278625,3776513891,1672560214,1672560391,177
7561,3509634629,3703735129,1672613693,1672616099,2406
7803,3505145247,3278365525,1672532034,1672534623,2589
7494,3534553510,3518014636,1672670132,1672670852,720
7962,3511198618,3738274418,1672532676,1672536134,3458
7722,3735319397,3933210486,1672669820,1672673263,3443
7940,3515860749,3520719611,1672628008,1672630789,2781
7797,3701190899,3432689543,1672609331,1672611684,2353
7764,3513164386,3404058699,1672598210,1672599120,910
7574,3512142794,3511350608,1672634634,1672635646,1012
7775,3755798867,3520706195,1672600605,1672603044,2439
7720,3921211276,3475258557,1672568398,1672568780,382
7661,3518408774,3519563836,1672542639,1672542955,316
7897,3316173088,3912536808,1672657020,1672658673,1653
7672,3801089989,3772746272,1672701111,1672701848,737
7632,3918056059,3287105466,1672534712,1672535710,998
7821,3458539365,3224716315,1672684220,1672687797,3577
7684,3778341199,3359239884,1672677791,1672678664,873
7508,3662180254,3783245561,1672612989,1672613871,882
7832,3755798867,3459030804,1672547742,1672549903,2161
7732,3916289176,3770851318,1672670225,1672673312,3087
7662,3505869747,3756930948,1672611049,1672613296,2247
7867,3777623166,3773664987,1672678277,1672680746,2469
7811,3760561634,3485375593,1672560709,1672562238,1529
7853,3792253549,3291235378,1672647045,1672648649,1604
7596,3514838220,3246596716,1672632818,1672634919,2101
7922,3466229085,3509773875,1672641049,1672642284,1235
7846,3770851318,3280599164,1672703809,1672706610,2801
7574,3427219654,3701691675,1672646027,1672646391,364
7749,3778108318,3859525941,1672654753,1672657424,2671
7871,3533927138,3277939457,1672568616,1672571790,3174
7661,3518408774,3244436890,1672631825,1672633494,1669
7518,3899371911,3772309166,1672609829,1672611838,2009
7606,3516909237,3453729665,1672597464,1672598563,1099
7570,3509907947,3510380060,1672583044,1672586447,3403
7581,3534488837,3500229033,1672685180,1672687683,2503
7789,3451432842,3780365428,1672674695,1672676713,2018
7835,3516980378,3755798867,1672683687,1672686660,2973
7888,3855424474,3711370563,1672553900,1672554634,734
7950,3792902982,3889232789,1672615828,1672616241,413
7731,3302626661,3391915121,1672658795,1672661762,2967
7925,3903962771,3488244966,1672601510,1672601663,153
7941,3833889105,3777929708,1672558369,1672561856,3487
7679,3783206719,3819727225,1672673357,1672676403,3046
7740,3206254161,3332072298,1672611655,1672614080,2425
7579,3247428249,3287105466,1672678418,1672678604,186
7483,3511350608,3827626797,1672685867,1672687082,1215
7689,3533653428,3834257412,1672680131,1672681327,1196
7669,3505973226,3755511676,1672535907,1672536761,854
7796,3515723720,3378436155,1672672915,1672675482,2567
7943,3855937514,3201848640,1672548626,1672549155,529
7747,3858918246,3298288268,1672545425,1672548127,2702
7872,3430352815,3604539807,1672588120,1672590811,2691
7860,3533385867,3773205565,1672544988,1672548211,3223
7690,3387966152,3516980378,1672579691,1672580907,1216
7565,3756451663,3836573197,1672621687,1672622647,960
7980,3505649239,3716900301,1672683054,1672686140,3086
7654,3756528686,3505193212,1672667975,1672669255,1280
7599,3713786889,3668005723,1672639161,1672639359,198
7962,3703441914,3979339287,1672698295,1672700231,1936
7573,3391915121,3513164386,1672643657,1672644685,1028
7750,3710569131,3606987130,1672543125,1672544976,1851
7950,3811694763,3774793839,1672591235,1672592245,1010
7681,3793962300,3714197325,1672680597,1672682763,2166
7589,3760893269,3280599164,1672561984,1672565541,3557
7685,3701863557,3855602893,1672693235,1672696593,3358
7706,3774125065,3755436115,1672697054,1672698142,1088
7851,3515151980,3533385867,1672541750,1672545032,3282
7922,3778305740,3318697153,1672548431,1672550531,2100
7959,3429690204,3509773875,1672613919,1672616341,2422
7783,3359910781,3517721725,1672663234,1672663731,497
7858,3917088658,3716168623,1672699601,1672701840,2239
7937,3313564074,3505599848,1672593413,1672594688,1275
7642,3500803339,3505873261,1672541429,1672544722,3293
7834,3811171116,3482405588,1672641808,1672642844,1036
7905,3533242305,3606186086,1672659973,1672663433,3460
7673,3629547065,3311090974,1672569872,1672573168,3296
7834,3511350608,3731106822,1672677242,1672679369,2127
7533,3514472925,3505530961,1672592726,1672596116,3390
7779,3793959750,3412825109,1672666901,1672670190,3289
7722,3248507722,3380035798,1672686386,1672689390,3004
7958,3510711755,3505883609,1672700757,1672701494,737
7906,3516909237,3312664885,1672696938,1672699075,2137
7929,3516716179,3249791738,1672541250,1672544734,3484
7829,3406784491,3714197325,1672609574,1672611160,1586
7864,3716835696,3311208440,1672621524,1672624805,3281
7961,3756528686,3778308417,1672682701,1672685320,2619
7633,3778980116,3857349323,1672613993,1672615957,1964
7533,3500458761,3607748895,1672668677,1672670885,2208
7761,3314836094,3792177074,1672570357,1672571106,749
7562,3298288268,3291235378,1672644410,1672644834,424
7938,3518163778,3511170269,1672685363,1672687236,1873
7549,3776066388,3510857360,1672553912,1672556343,2431
7520,3516465662,3883085535,1672648310,1672650702,2392
7930,3756623396,3311154569,1672689560,1672690248,688
7581,3899266183,3883551721,1672640830,1672641121,291
7832,3916289176,3407725581,1672618622,1672621539,2917
7896,3772758337,3399911573,1672610396,1672613827,3431
7944,3392121505,3501184421,1672702365,1672703383,1018
7512,3519563836,3407725581,1672661592,1672663879,2287
7881,3384951177,3776513891,1672648339,1672649341,1002
7787,3519563836,3760077057,1672663869,1672666702,2833
7808,3738502357,3223968713,1672685195,1672686385,1190
7925,3822654369,3533095755,1672663813,1672664890,1077
7907,3500805881,3505973226,1672633900,1672637141,3241
7699,3342131135,3783531004,1672586888,1672587071,183
7790,3713349754,3487171044,1672661769,1672662828,1059
7574,3311718847,3792768129,1672612555,1672616007,3452
7501,3407954858,3206603608,1672675076,1672678366,3290
7537,3247815299,3516909237,1672554329,1672556131,1802
7627,3475396323,3475396323,1672619601,1672622930,3329
7841,3933210486,3778980116,1672621006,1672624359,3353
7585,3227457126,3512683609,1672599833,1672602855,3022
7797,3534191820,3429690204,1672626326,1672627413,1087
7543,3777936328,3913251733,1672552755,1672554555,1800
7682,3510594211,3703661585,1672637012,1672638089,1077
7765,3793753089,3516465662,1672646779,1672646976,197
7880,3520206212,3489962019,1672631670,1672633782,2112
7952,3770078063,3490191091,1672556342,1672557994,1652
7515,3710569131,3783126683,1672611431,1672614617,3186
7847,3755392666,3757161914,1672674983,1672678548,3565
7978,3512837326,3777929708,1672556742,1672560257,3515
7777,3222521619,3534424200,1672684304,1672686574,2270
7771,3346795719,3316173088,1672684145,1672687244,3099
7750,3825229501,3475251781,1672576164,1672578750,2586
7960,3534010629,3615046771,1672542760,1672543851,1091
7767,3734496778,3737079798,1672691997,1672693377,1380
7960,3559110998,3777079686,1672686071,1672688607,2536
7704,3973560347,3534492426,1672636968,1672639593,2625
7814,3925620998,3701178711,1672590755,1672591551,796
7664,3791602225,3760509236,1672551053,1672552415,1362
7845,3773664987,3688683847,1672635673,1672637555,1882
7799,3773814927,3793848402,1672604656,1672607565,2909
7873,3505873261,3918584946,1672691715,1672693948,2233
7526,3284639858,3715127362,1672686856,1672689862,3006
7891,3429690204,3711198793,1672606926,1672609122,2196
7573,3760561634,3356860407,1672689414,1672690495,1081
7857,3384951177,3427219654,1672662041,1672662805,764
7513,3505859863,3201432789,1672588635,1672589733,1098
7501,3301107849,3855424474,1672595038,1672597135,2097
7935,3925620998,3637008488,1672537234,1672539122,1888
7932,3515394721,3407673904,1672660061,1672661965,1904
7708,3711198793,3827626797,1672697460,1672698869,1409
7869,3792768129,3307097200,1672590011,1672590260,249
7562,3757682496,3416265063,1672615723,1672616682,959
7645,3617734118,3973560347,1672677149,1672678237,1088
7569,3451432842,3362000049,1672631521,1672634294,2773
7777,3517864478,3345207877,1672585172,1672585780,608
7824,3475795792,3780914982,1672557357,1672558869,1512
7634,3895562476,3792768129,1672662848,1672665595,2747
7638,3774204963,3512166013,1672623454,1672626642,3188
7795,3772578994,3307512479,1672620507,1672620962,455
7578,3513080274,3279721246,1672698638,1672701131,2493
7510,3247428249,3511163800,1672638167,1672641615,3448
7680,3716488385,3500391167,1672695079,1672696362,1283
7555,3338703270,3760893269,1672662159,1672662330,171
7822,3855424474,3774010081,1672586614,1672586918,304
7977,3515151980,3500658339,1672592348,1672594927,2579
7559,3500904641,3365614305,1672627481,1672628656,1175
7773,3777623166,3359239884,1672564959,1672565240,281
7677,3774580701,3505135325,1672540804,1672541833,1029
7565,3348261553,3336742544,1672656714,1672659515,2801
7978,3683766533,3234362962,1672587661,1672588564,903
7951,3534702203,3914259449,1672582657,1672584179,1522
7675,3607178184,3756966035,1672649622,1672649759,137
7947,3800886801,3374559242,1672608275,1672611817,3542
7753,3903009525,3701967560,1672632641,1672633089,448
7654,3432665384,3772309166,1672575018,1672576671,1653
7487,3360743849,3880285638,1672661953,1672664786,2833
7869,3600647945,3534424200,1672654569,1672656198,1629
7570,3514719601,3828624701,1672536254,1672537581,1327
7911,3280615985,3770078063,1672653028,1672656108,3080
7884,3271938399,3783245561,1672599839,1672601435,1596
7581,3757562897,3853018906,1672688289,1672689934,1645
7813,3358871377,3610695419,1672670530,1672673318,2788
7926,3701184889,3276640712,1672675122,1672678498,3376
7868,3349613093,3666506258,1672585389,1672588443,3054
7876,3855424474,3311993075,1672690769,1672691557,788
7799,3439023335,3244173074,1672637550,1672637809,259
7916,3509672210,3235635976,1672676425,1672678253,1828
7768,3518014404,3396285984,1672656989,1672657643,654
7835,3800353779,3206603608,1672652873,1672656436,3563
7552,3887270940,3220716272,1672647405,1672648195,790
7767,3396285984,3711262377,1672627527,1672629284,1757
7620,3399911573,3903307060,1672672233,1672674765,2532
7710,3533810360,3493507965,1672556169,1672556944,775
7533,3756528686,3400918687,1672670545,1672673113,2568
7597,3975287541,3734737881,1672614602,1672615549,947
7745,3332072298,3511170269,1672602524,1672604707,2183
7513,3396086535,3883551721,1672643765,1672645608,1843
7559,3882997884,3517963492,1672643882,1672645357,1475
7757,3716746253,3346327502,1672672359,1672674051,1692
7977,3793338102,3416427576,1672540263,1672541532,1269
7742,3760598102,3937224533,1672612544,1672614044,1500
7677,3829764737,3349613093,1672593269,1672594031,762
7623,3478194807,3390068992,1672601220,1672603289,2069
7916,3369998498,3510244400,1672663876,1672666228,2352
7551,3925402713,3755881905,1672622567,1672623830,1263
7896,3244389794,3534010629,1672569128,1672572412,3284
7793,3793338102,3904408902,1672608139,1672608212,73
7928,3520931254,3920801189,1672647252,1672648880,1628
7629,3494290908,3735319397,1672534783,1672537055,2272
7633,3756528686,3238712269,1672655122,1672655613,491
7737,3505347134,3227457126,1672562437,1672565082,2645
7892,3279721246,3774119563,1672592448,1672595772,3324
7560,3604539807,3303751772,1672550692,1672554250,3558
7665,3783239924,3519601612,1672552184,1672555465,3281
7569,3388637594,3360506772,1672561696,1672563789,2093
7735,3520190170,3331845324,1672661526,1672664376,2850
7761,3608868877,3772642849,1672564647,1672565681,1034
7915,3793627961,3666506258,1672599926,1672602268,2342
7910,3855424474,3304625412,1672554381,1672555853,1472
7818,3701498253,3311274543,1672573008,1672574629,1621
7853,3898995675,3606812411,1672628417,1672630772,2355
7825,3703718151,3505859863,1672562549,1672563923,1374
7751,3511267139,3770021824,1672572375,1672573311,936
7814,3701534009,3716165213,1672660987,1672661679,692
7532,3516011407,3501606184,1672579307,1672580952,1645
7645,3516980378,3760294205,1672651386,1672654322,2936
7676,3716197887,3411618230,1672537423,1672539830,2407
7517,3779629905,3757151210,1672660327,1672662443,2116
7879,3351554343,3501730685,1672597351,1672600392,3041
7577,3770447408,3772746272,1672661669,1672662895,1226
7796,3429856982,3793436995,1672651499,1672652507,1008
7844,3311603601,3249791738,1672598411,1672600162,1751
7798,3780788622,3511267139,1672551598,1672552838,1240
7679,3660493209,3427283336,1672668563,1672670040,1477
7909,3701111745,3533270638,1672569367,1672571541,2174
7853,3780914982,3346327502,1672651702,1672655170,3468
7861,3716835696,3979339287,1672620230,1672622915,2685
7919,3312664885,3755881905,1672685697,1672688110,2413
7688,3500729955,3791942683,1672542926,1672543973,1047
7907,3808324264,3901990690,1672696887,1672697567,680
7790,3634340855,3334033993,1672678263,1672680243,1980
7577,3816454165,3505145247,1672663945,1672664790,845
7914,3517963492,3913251733,1672679899,1672681975,2076
7594,3716835696,3883042241,1672642027,1672644475,2448
7920,3505000737,3783196518,1672592653,1672594981,2328
7934,3774298222,3501955238,1672584610,1672586255,1645
7854,3713370078,3858918246,1672560616,1672561223,607
7541,3483949762,3792668962,1672625086,1672627139,2053
7516,3516223597,3517721725,1672573718,1672574127,409
7965,3773814927,3760489031,1672682397,1672684789,2392
7652,3483949762,3494290908,1672538437,1672541989,3552
7603,3777776687,3505873261,1672624185,1672626479,2294
7744,3600647945,3914290246,1672590434,1672593355,2921
7562,3517509185,3792883665,1672533588,1672536472,2884
7652,3291883916,3973560347,1672562808,1672565457,2649
7840,3520931254,3247815299,1672697152,1672697859,707
7816,3804870229,3399911573,1672629961,1672631954,1993
7658,3701146057,3606812411,1672560142,1672562226,2084
7719,3792384220,3500199935,1672592729,1672594414,1685
7520,3534702203,3910454786,1672571036,1672574375,3339
7835,3559110998,3783705817,1672597416,1672598741,1325
7565,3777477395,3489728806,1672659450,1672661710,2260
7730,3800353779,3311415018,1672633828,1672635520,1692
7715,3710408395,3407954858,1672676474,1672679888,3414
7982,3736592744,3362000049,1672536093,1672536688,595
7978,3914290246,3533827120,1672561931,1672564825,2894
7616,3276640712,3770553384,1672629130,1672631977,2847
7661,3975287541,3220716272,1672552485,1672552942,457
7948,3534492426,3466229085,1672580788,1672581523,735
7652,3808324264,3715981584,1672569922,1672570337,415
7958,3819727225,3249791738,1672679988,1672680675,687
7929,3439023335,3430074045,1672586582,1672589724,3142
7629,3505203158,3714474557,1672676479,1672679985,3506
7576,3917088658,3430504438,1672631051,1672632718,1667
7666,3516716179,3351554343,1672627454,1672627754,300
7808,3703955926,3800353779,1672624223,1672625726,1503
7670,3394330287,3757562897,1672675392,1672675641,249
7775,3510857360,3774556560,1672535972,1672536087,115
7584,3827222533,3383922351,1672625823,1672626219,396
7910,3853018906,3552314511,1672624731,1672625167,436
7868,3404058699,3416241005,1672624858,1672626478,1620
7772,3617055293,3277939457,1672549767,1672552918,3151
7664,3475396323,3716746253,1672664389,1672666015,1626
7543,3394330287,3510247121,1672668036,1672670380,2344
7969,3736592744,3716273414,1672574072,1672576640,2568
7851,3976390453,3369998498,1672635732,1672636370,638
7818,3716273414,3918674986,1672539639,1672542888,3249
7563,3791115967,3760561634,1672581449,1672582785,1336
7610,3534553510,3497901842,1672548798,1672551454,2656
7597,3812176780,3760561634,1672544197,1672544449,252
7941,3280615985,3501483568,1672614073,1672616614,2541
7925,3901877072,3483949762,1672669382,1672672174,2792
7679,3509630174,3773978034,1672557920,1672559297,1377
7875,3277605882,3668898102,1672678105,1672680095,1990
7507,3520756859,3500458761,1672558388,1672560202,1814
7679,3533653428,3793871337,1672658621,1672662189,3568
7582,3247780536,3516016437,1672539118,1672539362,244
7802,3360993964,3664517356,1672653312,1672655944,2632
7756,3505362057,3520730271,1672649310,1672649541,231
7953,3931941795,3823600322,1672624104,1672627406,3302
7782,3760598102,3505477652,1672589866,1672593456,3590
7713,3307097200,3516606733,1672639393,1672642586,3193
7747,3516960534,3407954858,1672620274,1672622565,2291
7641,3485823740,3500894271,1672613564,1672615618,2054
7955,3439023335,3519654779,1672664040,1672667024,2984
7567,3792473331,3501692334,1672595640,1672598075,2435
7579,3458539365,3511332835,1672684356,1672687586,3230
7661,3360506772,3512349371,1672672086,1672673686,1600
7833,3802367797,3397418363,1672637087,1672638792,1705
7751,3451432842,3760183458,1672637615,1672640268,2653
7760,3505873261,3780788622,1672542175,1672545226,3051
7824,3793871337,3500177712,1672615944,1672618015,2071
7622,3500805881,3534313900,1672542166,1672544880,2714
7813,3512349371,3774366875,1672573881,1672574433,552
7663,3505649239,3778305740,1672635252,1672638707,3455
7625,3509453566,3903009525,1672610459,1672611434,975
7957,3412980697,3501955238,1672701576,1672703992,2416
7618,3777790718,3780788622,1672703821,1672706787,2966
7932,3711198793,3666507626,1672620522,1672622943,2421
7930,3756528686,3710112546,1672580224,1672580863,639
7930,3780503655,3827377568,1672619314,1672621242,1928
7945,3613995936,3711308224,1672535075,1672538421,3346
7654,3336751428,3756966035,1672677226,1672678247,1021
7766,3606186086,3756451663,1672606942,1672609538,2596
7769,3828365570,3600647945,1672560302,1672562674,2372
7653,3483164654,3229665776,1672654627,1672655134,507
7659,3703735129,3760294205,1672667686,1672670725,3039
7936,3713969578,3311154569,1672559121,1672562549,3428
7515,3770021824,3344019610,1672653826,1672655886,2060
7762,3466229085,3776800213,1672622476,1672625266,2790
7492,3760561634,3760267716,1672679773,1672682622,2849
7781,3383922351,3520751702,1672535703,1672538770,3067
7918,3733891182,3520190170,1672535665,1672537399,1734
7504,3778549126,3711380716,1672669355,1672669654,299
7702,3922275416,3391915886,1672535497,1672536384,887
7697,3773205565,3246596716,1672702054,1672704706,2652
7795,3520165601,3432689543,1672572626,1672574651,2025
7714,3510969660,3714488548,1672581944,1672583681,1737
7895,3903307060,3518014636,1672611661,1672612697,1036
7938,3224716315,3772359096,1672552730,1672555907,3177
7523,3512510536,3776513891,1672570808,1672571346,538
7598,3311274543,3716488385,1672534503,1672535389,886
7929,3516960534,3912262917,1672616286,1672617658,1372
7825,3412825109,3467773920,1672702159,1672704908,2749
7689,3517459919,3533280269,1672642916,1672643252,336
7870,3774298222,3534492426,1672645980,1672646321,341
7885,3511198618,3373384732,1672596308,1672597109,801
7547,3512349371,3880285638,1672574807,1672576738,1931
7820,3793338102,3733189298,1672677175,1672678617,1442
7858,3304625412,3617734118,1672622992,1672626163,3171
7509,3533653428,3514987389,1672588208,1672589213,1005
7635,3701065786,3280615985,1672686104,1672687454,1350
7515,3792288302,3509907947,1672652004,1672655235,3231
7812,3509907947,3932051427,1672548141,1672549627,1486
7940,3791115967,3922275620,1672694578,1672694825,247
7732,3701111745,3387966152,1672587570,1672589672,2102
7968,3511312803,3780788622,1672559135,1672561883,2748
7842,3770101921,3918247820,1672582583,1672586173,3590
7513,3501927421,3756966035,1672576524,1672578588,2064
7970,3519152550,3733189298,1672600900,1672604234,3334
7770,3534702203,3418534998,1672593429,1672594568,1139
7918,3880310724,3778266283,1672670496,1672673860,3364
7865,3434642576,3778780511,1672622716,1672624946,2230
7912,3770078063,3467773920,1672684261,1672685109,848
7601,3916289176,3313541986,1672552781,1672554963,2182
7875,3500199935,3518932404,1672551656,1672551726,70
7966,3509352754,3710408395,1672566565,1672566692,127
7621,3772884106,3922275416,1672680609,1672683501,2892
7899,3418534998,3774339795,1672668748,1672671281,2533
7748,3477375368,3774204963,1672582554,1672582971,417
7919,3716258994,3307512479,1672536995,1672540120,3125
7684,3517721725,3973560347,1672535040,1672537859,2819
7772,3829319703,3805347939,1672614352,1672615787,1435
7628,3715998609,3888559320,1672669229,1672672543,3314
7590,3534488837,3710067113,1672586560,1672587946,1386
7651,3880310724,3480687894,1672688673,1672691424,2751
7931,3417587765,3285400528,1672702766,1672705413,2647
7592,3312333615,3206254161,1672670818,1672671500,682
7516,3701984666,3505145247,1672559144,1672561251,2107
7496,3418728074,3823600322,1672578459,1672578688,229
7714,3515691540,3520629279,1672574748,1672577870,3122
7916,3392121505,3834257412,1672591715,1672594548,2833
7695,3774556560,3664170666,1672682518,1672685093,2575
7569,3509630174,3883312122,1672587489,1672589604,2115
7612,3917088658,3780639480,1672633421,1672634115,694
7561,3776066388,3737079798,1672571631,1672571824,193
7847,3736786443,3478194807,1672691803,1672693725,1922
7543,3519654779,3839849341,1672534518,1672536965,2447
7739,3778266283,3734828619,1672558169,1672561320,3151
7908,3932051427,3713268590,1672626549,1672628886,2337
7975,3760509236,3511271692,1672570024,1672570318,294
7774,3774466457,3776066388,1672669384,1672670485,1101
7575,3880310724,3519069599,1672678301,1672678761,460
7935,3394330287,3296471982,1672589770,1672589915,145
7868,3334033993,3520730271,1672563318,1672564438,1120
7732,3409474775,3399004969,1672566427,1672568099,1672
7860,3783779671,3792789881,1672653491,1672655990,2499
7497,3772758337,3209048907,1672601612,1672601733,121
7723,3773598056,3780914982,1672606300,1672608477,2177
7772,3533385867,3505000737,1672695683,1672699203,3520
7943,3481647420,3513201436,1672658800,1672660663,1863
7830,3883861463,3277939457,1672568559,1672568991,432
7772,3606186086,3792177074,1672535656,1672536301,645
7516,3613683164,3606186086,1672661918,1672662457,539
7582,3428674539,3783779671,1672568435,1672569291,856
7668,3826759140,3703275621,1672619276,1672620957,1681
7539,3556951786,3773664987,1672557446,1672559801,2355
7788,3399004969,3614238812,1672639605,1672641978,2373
7699,3774338212,3428006164,1672685445,1672688767,3322
7749,3405494240,3756528686,1672682338,1672684907,2569
7949,3509634629,3886298125,1672591094,1672592813,1719
7759,3822654369,3342131135,1672614049,1672615242,1193
7661,3710098970,3857349323,1672615198,1672618580,3382
7532,3394330287,3416427576,1672552947,1672554576,1629
7798,3774195321,3384951177,1672685300,1672688329,3029
7648,3484995752,3515284591,1672543941,1672545750,1809
7936,3976633198,3311845971,1672661396,1672662292,896
7840,3713208927,3289061738,1672657159,1672660525,3366
7565,3500365158,3420700674,1672651625,1672654124,2499
7784,3756528686,3922275416,1672654489,1672655341,852
7532,3312829208,3377766165,1672542803,1672543786,983
7505,3779740455,3737051610,1672579820,1672582358,2538
7521,3400804807,3228165483,1672640615,1672642488,1873
7811,3826760240,3311627628,1672533292,1672534890,1598
7940,3501601840,3607748895,1672604479,1672607679,3200
7881,3500199935,3610695419,1672593665,1672595859,2194
7658,3715339701,3302626661,1672614181,1672617523,3342
7599,3713268590,3701190899,1672691470,1672693511,2041
7568,3777790718,3297463265,1672618768,1672621044,2276
7816,3420700674,3520931254,1672652566,1672654469,1903
7917,3792177074,3227158514,1672678738,1672681651,2913
7782,3510126867,3434642576,1672653227,1672655816,2589
7615,3714962248,3733891182,1672644460,1672647332,2872
7780,3801089989,3605726278,1672544262,1672545943,1681
7722,3660493209,3412980697,1672646773,1672648872,2099
7707,3289061738,3805292782,1672613064,1672613809,745
7673,3501483568,3288764520,1672617927,1672621418,3491
7537,3710569131,3756601594,1672567528,1672570847,3319
7711,3858918246,3774268456,1672682543,1672686022,3479
7660,3202120784,3415443558,1672563442,1672565915,2473
7930,3935127663,3777443199,1672626928,1672628776,1848
7798,3774010081,3805342762,1672613818,1672614130,312
7675,3311152102,3472130842,1672564734,1672565612,878
7490,3244485293,3231056870,1672581089,1672583199,2110
7784,3715998609,3221536550,1672615536,1672616097,561
7737,3519803045,3715339701,1672647918,1672649363,1445
7712,3516606733,3683959482,1672633725,1672635338,1613
7514,3736790081,3710408395,1672580920,1672582514,1594
7689,3516716179,3667680268,1672597421,1672600510,3089
7916,3388372715,3511350608,1672645853,1672648991,3138
7800,3244173074,3710067113,1672582442,1672582580,138
7782,3234362962,3792668962,1672567049,1672567973,924
7855,3534424200,3774298222,1672555803,1672557033,1230
7572,3777477395,3279721246,1672673397,1672675404,2007
7953,3428964059,3610695419,1672632839,1672635116,2277
7907,3238712269,3370752401,1672689818,1672691743,1925
7634,3756623396,3428674539,1672531622,1672534672,3050
7865,3360743849,3514472925,1672611371,1672614402,3031
7887,3773205565,3774045700,1672598188,1672598382,194
7691,3351008918,3248507722,1672668279,1672671797,3518
7738,3774050956,3604539807,1672599761,1672600092,331
7524,3481647420,3475258557,1672703838,1672706184,2346
7543,3379256399,3716537575,1672637022,1672638786,1764
7589,3777929708,3336751428,1672531345,1672532278,933
7702,3418728074,3345207877,1672592849,1672595684,2835
7927,3424922204,3476232529,1672568229,1672569413,1184
7800,3516065852,3783206719,1672670847,1672673969,3122
7969,3780639480,3774580701,1672543577,1672545543,1966
7631,3446948848,3459030804,1672594163,1672597526,3363
7823,3791957752,3793436995,1672605365,1672608464,3099
7953,3629547065,3514472925,1672579337,1672580448,1111
7822,3890149705,3783126683,1672674847,1672677013,2166
7718,3772309150,3885897503,1672582151,1672584694,2543
7936,3420432297,3505883609,1672664452,1672666642,2190
7691,3756528686,3816454165,1672649346,1672652909,3563
7849,3534488837,3716746253,1672589705,1672590061,356
7756,3388637594,3520183192,1672620462,1672620989,527
7942,3519563836,3520376528,1672573429,1672576211,2782
7788,3228165483,3779976989,1672548418,1672550628,2210
7894,3500894271,3922275620,1672689838,1672692315,2477
7554,3755739653,3859663348,1672659153,1672662443,3290
7740,3901990690,3777776687,1672697053,1672697236,183
7811,3779218771,3624761861,1672581548,1672581992,444
7848,3614238812,3533137446,1672532993,1672533101,108
7944,3777806071,3519556068,1672554404,1672557935,3531
7713,3618873142,3202120784,1672625870,1672628619,2749
7891,3518260334,3361230905,1672698573,1672700960,2387
7754,3711571712,3703718151,1672671983,1672672291,308
7966,3505193212,3816853177,1672640611,1672642149,1538
7775,3276640712,3415546117,1672617461,1672620199,2738
7579,3234541252,3979339287,1672616477,1672617719,1242
7876,3520012395,3918584946,1672703524,1672706342,2818
7954,3228165483,3802367797,1672533217,1672533987,770
7892,3512683609,3510247121,1672557876,1672559631,1755
7955,3918674986,3415546117,1672611189,1672614151,2962
7623,3791942683,3713644518,1672573121,1672575992,2871
7708,3448855696,3500391167,1672693128,1672696454,3326
7837,3827222533,3779740455,1672575769,1672576847,1078
7748,3489545239,3505791599,1672585651,1672586201,550
7596,3774119563,3901877072,1672630719,1672631029,310
7899,3881477378,3505973226,1672682550,1672683625,1075
7764,3760893269,3519703355,1672665418,1672666952,1534
7748,3473765852,3516716179,1672703007,1672705627,2620
7651,3637008488,3713268590,1672671499,1672672576,1077
7967,3935627557,3338703270,1672609128,1672611411,2283
7868,3791957752,3493507965,1672598109,1672601022,2913
7752,3407673904,3389115045,1672626966,1672627758,792
7978,3512510536,3756528686,1672542198,1672542290,92
7661,3489545239,3895562476,1672568027,1672569155,1128
7666,3402943525,3972364603,1672537392,1672538609,1217
7974,3975287541,3925620998,1672657508,1672660092,2584
7901,3889750851,3501606184,1672642558,1672644154,1596
7883,3738274418,3505599848,1672616118,1672618717,2599
7731,3505477652,3201432789,1672639768,1672642208,2440
7720,3791657947,3833889105,1672613334,1672614714,1380
7545,3304056063,3617055293,1672613359,1672614949,1590
7628,3853018906,3883042241,1672703875,1672704367,492
7746,3378092448,3518014404,1672698090,1672700262,2172
7930,3922275416,3780974443,1672600105,1672600700,595
7968,3278365525,3930797455,1672670707,1672672780,2073
7876,3827377568,3438645253,1672642593,1672645120,2527
7873,3972709319,3734828619,1672569027,1672570909,1882
7789,3783779671,3756424865,1672616592,1672619601,3009
7816,3247428249,3360506772,1672586511,1672587491,980
7532,3760489031,3501486692,1672595577,1672596273,696
7806,3311324983,3836573197,1672698154,1672699356,1202
7787,3828624701,3883861463,1672680240,1672682238,1998
7980,3489962019,3756021689,1672653995,1672655264,1269
7519,3792883665,3703955926,1672610878,1672612379,1501
7577,3711380716,3734496778,1672598888,1672601721,2833
7975,3792844210,3496269445,1672578919,1672582095,3176
7711,3517459919,3482405588,1672552586,1672553751,1165
7876,3910886626,3501198706,1672536197,1672536951,754
7742,3839849341,3520756859,1672587798,1672588167,369
7859,3311871871,3427283336,1672588123,1672590428,2305
7779,3399052055,3291235378,1672639278,1672640124,846
7873,3336742544,3475258557,1672583865,1672585972,2107
7640,3756453423,3716900301,1672700562,1672701089,527
7750,3611150562,3505203158,1672579034,1672581086,2052
7490,3401627165,3774195321,1672614505,1672615344,839
7619,3492478793,3466229085,1672665325,1672666391,1066
7929,3392121505,3703013906,1672591925,1672593073,1148
7914,3772309166,3510126867,1672616933,1672618594,1661
7669,3801089989,3608633356,1672699065,1672700484,1419
7974,3488244966,3783083229,1672691541,1672694523,2982
7863,3783196518,3533653428,1672548909,1672550866,1957
7921,3777806071,3421836608,1672554251,1672556719,2468
7493,3533371364,3365278081,1672536858,1672537246,388
7500,3832902928,3780593036,1672550032,1672552758,2726
7609,3858918246,3249247700,1672546506,1672549324,2818
7717,3501486692,3514719601,1672569435,1672572268,2833
7665,3778780511,3280615985,1672533289,1672535968,2679
7903,3439023335,3311154569,1672673753,1672675128,1375
7982,3755436115,3757562897,1672554891,1672555414,523
7533,3516039895,3505193212,1672678866,1672679376,510
7824,3505135325,3792844210,1672536152,1672539716,3564
7554,3407725581,3760992710,1672692522,1672696063,3541
7879,3780503655,3772758337,1672538459,1672538998,539
7632,3490191091,3760893269,1672646792,1672648878,2086
7566,3501759100,3248507722,1672681554,1672683908,2354
7681,3404384505,3516016437,1672653891,1672656817,2926
7628,3716273414,3533385867,1672554345,1672555881,1536
7797,3236102733,3773598056,1672688186,1672689749,1563
7635,3415546117,3883085535,1672546467,1672548435,1968
7925,3314836094,3733189298,1672648355,1672649188,833
7546,3755739653,3428964059,1672607845,1672609574,1729
7560,3351554343,3891751546,1672547290,1672547856,566
7585,3701190899,3776338577,1672564260,1672566617,2357
7847,3912262917,3780294829,1672602740,1672605555,2815
7752,3780609808,3465202715,1672544872,1672547953,3081
7730,3811694763,3898995675,1672542850,1672545110,2260
7561,3501184421,3710344260,1672646281,1672648118,1837
7543,3247780536,3510969660,1672576435,1672579710,3275
7522,3351554343,3970117174,1672671528,1672675061,3533
7847,3853018906,3711973519,1672577216,1672580344,3128
7778,3505791599,3515125508,1672635637,1672637600,1963
7900,3683959482,3370636709,1672597278,1672599556,2278
7516,3714197325,3339907603,1672579058,1672580199,1141
7560,3664170666,3883312122,1672536254,1672539171,2917
7774,3511687358,3703871468,1672534973,1672536223,1250
7681,3298433163,3777514571,1672665490,1672665636,146
7641,3777790718,3703718151,1672589138,1672589290,152
7574,3333896808,3420432297,1672608952,1672611024,2072
7734,3512142794,3616944364,1672578971,1672579196,225
7641,3242408357,3500499542,1672701057,1672703516,2459
7486,3513080274,3520190170,1672676232,1672676962,730
7926,3277605882,3550946908,1672655033,1672656021,988
7807,3407954858,3882242815,1672597338,1672598990,1652
7660,3315583351,3773429448,1672663363,1672665491,2128
7568,3534488837,3514245078,1672692046,1672692944,898
7944,3792384220,3559110998,1672607725,1672610625,2900
7700,3610348516,3483949762,1672649512,1672651251,1739
7627,3512166013,3374559242,1672584612,1672584826,214
7907,3510969660,3222521619,1672675849,1672676321,472
7823,3400804807,3772309150,1672633923,1672634794,871
7942,3443698222,3777079686,1672595862,1672596935,1073
7970,3515151980,3500904641,1672626457,1672627385,928
7908,3714962248,3318166135,1672576487,1672579464,2977
7720,3701898991,3475258557,1672628054,1672628873,819
7719,3731106822,3316173088,1672682702,1672685062,2360
7836,3624761861,3511125626,1672670163,1672670311,148
7851,3715998609,3519069599,1672561330,1672564690,3360
7983,3774204963,3783245561,1672622002,1672625483,3481
7829,3756528686,3201848640,1672693068,1672695001,1933
7840,3710569131,3519556068,1672657828,1672661207,3379
7869,3774119563,3360743849,1672698863,1672700620,1757
7767,3385763781,3505973226,1672675392,1672678450,3058
7876,3853018906,3511271692,1672607595,1672610839,3244
7718,3736625083,3730517636,1672562462,1672563909,1447
7863,3738502357,3774268456,1672703943,1672705655,1712
7484,3520165601,3518791447,1672574036,1672577337,3301
7649,3512567240,3311152102,1672564914,1672565078,164
7740,3533827120,3284639858,1672652039,1672652332,293
7498,3280615985,3448855696,1672631513,1672632696,1183
7571,3829764737,3778341199,1672564214,1672565112,898
7497,3701178711,3756451663,1672587181,1672590277,3096
7574,3660493209,3500487333,1672584021,1672584279,258
7977,3774466457,3716197887,1672650685,1672653907,3222
7878,3773120434,3757602960,1672676501,1672677602,1101
7874,3356860407,3208844525,1672700248,1672703283,3035
7852,3757246925,3976633198,1672572582,1672574988,2406
7760,3516716179,3903307060,1672618676,1672622219,3543
7801,3311845971,3332072298,1672595563,1672598081,2518
7518,3890149705,3859525941,1672695253,1672698011,2758
7851,3517476351,3774050956,1672559266,1672560163,897
7730,3701498253,3880285638,1672690953,1672692199,1246
7523,3407954858,3737051610,1672697691,1672699729,2038
7821,3500199935,3200691026,1672564222,1672565578,1356
7812,3772578994,3501198706,1672612180,1672613109,929
7851,3716273414,3760294205,1672532968,1672533300,332
7612,3783245561,3430074045,1672569953,1672570029,76
7914,3501955238,3231056870,1672654248,1672655655,1407
7885,3520709480,3774793839,1672694245,1672696627,2382
7565,3857349323,3206254161,1672531925,1672532782,857
7590,3387966152,3511862351,1672690736,1672691606,870
7691,3533369198,3426325549,1672588296,1672588891,595
7650,3760992710,3518496488,1672552486,1672553680,1194
7762,3514472925,3778308417,1672572340,1672573293,953
7757,3882997884,3421127249,1672576704,1672580194,3490
7647,3312829208,3520030713,1672536797,1672538026,1229
7881,3280599164,3826760240,1672573031,1672574407,1376
7566,3293695955,3509907947,1672691259,1672692592,1333
7646,3916289176,3534729133,1672584021,1672585361,1340
7572,3220716272,3509453566,1672670658,1672674001,3343
7933,3391915121,3513201436,1672598496,1672600049,1553
7643,3601879040,3383661227,1672670839,1672671969,1130
7906,3813052709,3760992710,1672656505,1672658619,2114
7821,3802367797,3520709480,1672617171,1672619897,2726
7886,3770635361,3517864478,1672542910,1672545699,2789
7853,3774338212,3628819436,1672536770,1672539081,2311
7546,3731419510,3351554343,1672562774,1672563413,639
7539,3383922351,3348261553,1672643887,1672646790,2903
7698,3533653428,3279721246,1672698272,1672699977,1705
7882,3514472925,3701534009,1672641318,1672641493,175
7905,3388286531,3311274543,1672613426,1672613970,544
7613,3930797455,3512969370,1672600099,1672602032,1933
7640,3774045700,3516980378,1672654607,1672658183,3576
7740,3826633236,3683959482,1672595556,1672597161,1605
7977,3757151210,3736419952,1672601821,1672604662,2841
7493,3482405588,3817621391,1672612293,1672615315,3022
7775,3509933351,3666507626,1672573948,1672575008,1060
7685,3711370563,3229665776,1672561230,1672562753,1523
7889,3778980116,3607748895,1672533211,1672533532,321
7572,3333896808,3496051529,1672611428,1672611712,284
7917,3311648200,3780639480,1672542505,1672543765,1260
7618,3755625324,3377766165,1672547194,1672548182,988
7934,3756424865,3836573197,1672648761,1672649861,1100
7801,3533242305,3224058172,1672653877,1672655930,2053
7736,3505973226,3613683164,1672551601,1672552444,843
7552,3518163778,3812176780,1672582780,1672584661,1881
7523,3757447189,3932051427,1672694208,1672694407,199
7623,3774005526,3534553510,1672609212,1672610026,814
7946,3756021689,3918674986,1672677937,1672681084,3147
7647,3774045700,3757151210,1672555217,1672558222,3005
7858,3467773920,3777806071,1672547351,1672550348,2997
7485,3388372715,3711504540,1672647976,1672650929,2953
7642,3755511676,3812176780,1672559725,1672559936,211
7727,3792789881,3362000049,1672577347,1672579211,1864
7673,3222521619,3792032359,1672611617,1672613315,1698
7654,3823600322,3772884106,1672608627,1672608865,238
7552,3478194807,3500994774,1672550523,1672551889,1366
7649,3859525941,3891751546,1672568906,1672572341,3435
7769,3793286136,3388372715,1672625444,1672628916,3472
7848,3685187183,3519912874,1672546822,1672550215,3393
7869,3500229033,3505973226,1672605601,1672606713,1112
7908,3533280269,3244173074,1672703873,1672704698,825
7572,3777983879,3606987130,1672664018,1672667288,3270
7890,3516909237,3519803045,1672597231,1672600688,3457
7653,3716258994,3344364444,1672566719,1672567204,485
7594,3511862351,3316222192,1672681050,1672682673,1623
7885,3501486692,3496549058,1672641427,1672642563,1136
7928,3783925755,3277939457,1672574679,1672575790,1111
7629,3774268456,3388637594,1672669618,1672670110,492
7656,3791020967,3501198706,1672691207,1672693495,2288
7680,3369998498,3221536550,1672565104,1672566192,1088
7783,3756424865,3780365428,1672545133,1672545684,551
7837,3386707783,3228165483,1672553635,1672553970,335
7940,3774366875,3514987389,1672658290,1672659581,1291
7503,3244173074,3791020967,1672566617,1672566893,276
7565,3484995752,3426325549,1672536958,1672537043,85
7780,3511359172,3715974031,1672568981,1672570107,1126
7684,3606987130,3534488837,1672642381,1672645799,3418
7848,3715127362,3774127586,1672611069,1672612870,1801
7894,3510703546,3505135325,1672582239,1672584472,2233
7599,3407673904,3826415738,1672661228,1672662499,1271
7735,3505145247,3401627165,1672583080,1672584167,1087
7854,3555214688,3518496488,1672676794,1672677828,1034
7577,3756623396,3338703270,1672573526,1672576669,3143
7867,3756027749,3701863557,1672616214,1672618886,2672
7742,3800353779,3703871468,1672610186,1672613537,3351
7719,3500805881,3666506258,1672605974,1672608864,2890
7873,3348261553,3770635361,1672625152,1672628582,3430
7750,3428006164,3427283336,1672602505,1672605428,2923
7745,3475258557,3857349323,1672533124,1672535338,2214
7623,3851190615,3505869747,1672626665,1672628231,1566
7977,3711973519,3387966152,1672625619,1672626155,536
7695,3516016437,3311648200,1672628799,1672631019,2220
7779,3624761861,3390068992,1672616489,1672616609,120
7652,3518876135,3519700826,1672614469,1672617426,2957
7751,3407725581,3776066388,1672665559,1672666816,1257
7670,3505638204,3770851318,1672534499,1672535934,1435
7511,3607748895,3222521619,1672638070,1672638969,899
7762,3515860749,3485375593,1672659851,1672662886,3035
7913,3316222192,3898995675,1672634084,1672635517,1433
7901,3852391257,3760893269,1672643932,1672645234,1302
7759,3303751772,3421836608,1672655654,1672657362,1708
7812,3505362057,3917278625,1672656232,1672656983,751
7794,3365278081,3713268590,1672617114,1672617706,592
7636,3772309166,3512540951,1672630109,1672633540,3431
7716,3774339795,3882997884,1672610335,1672611271,936
7931,3467773920,3738274418,1672631002,1672633916,2914
7560,3770021824,3432689543,1672556349,1672557119,770
7841,3429856982,3760077057,1672627433,1672629464,2031
7883,3246596716,3515151980,1672656409,1672658752,2343
7884,3510380060,3772544062,1672552168,1672555742,3574
7587,3903962771,3301107849,1672676578,1672676714,136
7774,3852391257,3770021824,1672633940,1672637308,3368
7631,3792473331,3779528381,1672627667,1672631263,3596
7551,3792177074,3793086311,1672678596,1672679733,1137
7751,3490191091,3365830990,1672678138,1672680733,2595
7483,3338703270,3390068992,1672630626,1672630922,296
7858,3395152943,3373384732,1672558138,1672561063,2925
7910,3811171116,3610695419,1672571176,1672572687,1511
7910,3311718847,3793470489,1672643727,1672644702,975
7615,3242408357,3303705369,1672563660,1672566059,2399
7564,3311203656,3484995752,1672647176,1672647790,614
7491,3776948966,3760561634,1672557021,1672560345,3324
7546,3666553782,3760569731,1672599056,1672600601,1545
7696,3710067113,3714504419,1672580771,1672581408,637
7672,3342131135,3773205565,1672541542,1672541627,85
7636,3512166013,3500803339,1672577928,1672580273,2345
7753,3420432297,3922275620,1672680634,1672681311,677
7905,3777717988,3713630656,1672678806,1672679428,622
7570,3485823740,3608868877,1672657497,1672659855,2358
7717,3399911573,3778308417,1672595617,1672597201,1584
7722,3480687894,3774580701,1672651608,1672652927,1319
7903,3909606423,3783779671,1672532148,1672533072,924
7747,3826633236,3344364444,1672647062,1672649064,2002
7715,3518260334,3703889596,1672567785,1672570085,2300
7641,3318697153,3773120434,1672548171,1672550112,1941
7484,3520719611,3249401741,1672628862,1672629193,331
7768,3899204805,3511312803,1672613834,1672617046,3212
7834,3249791738,3772309166,1672575524,1672575929,405
7968,3505145247,3622054816,1672675034,1672677055,2021
7688,3792032359,3733189298,1672674371,1672674571,200
7803,3505173328,3338367113,1672532257,1672535327,3070
7593,3853018906,3770447408,1672637081,1672639614,2533
7758,3501927421,3311152102,1672695388,1672698968,3580
7960,3756930948,3921211276,1672647396,1672648251,855
7559,3779629905,3614238812,1672688224,1672688719,495
7624,3792177074,3401627165,1672570487,1672571234,747
7506,3711504540,3978115672,1672550169,1672551567,1398
7671,3291227780,3711308224,1672693933,1672696088,2155
7712,3533280269,3716488385,1672698739,1672699088,349
7489,3852391257,3533927138,1672609891,1672611612,1721
7670,3500391167,3501927421,1672613916,1672615209,1293
7751,3774556560,3783429780,1672652378,1672654484,2106
7739,3780914982,3770447408,1672689042,1672691448,2406
7841,3793436995,3512217942,1672602364,1672605503,3139
7954,3533137446,3835382117,1672584032,1672584770,738
7546,3757455053,3701898991,1672670842,1672671873,1031
7747,3730517636,3880310724,1672624863,1672625582,719
7955,3399052055,3920801189,1672589730,1672591192,1462
7499,3779629905,3800353779,1672632389,1672634436,2047
7884,3910886626,3732481297,1672623422,1672626769,3347
7735,3776066388,3379256399,1672685616,1672686776,1160
7577,3389115045,3918584946,1672620593,1672620742,149
7901,3516980378,3516514391,1672568321,1672569784,1463
7910,3550946908,3556951786,1672552738,1672553568,830
7831,3439023335,3420432297,1672606030,1672607182,1152
7886,3859525941,3880285638,1672620037,1672621020,983
7784,3703889596,3388372715,1672532962,1672536102,3140
7579,3918247820,3899371911,1672625043,1672625275,232
7865,3834257412,3716258994,1672665309,1672666202,893
7523,3757602960,3360993964,1672613404,1672614311,907
7739,3921211276,3303751772,1672578393,1672581434,3041
7869,3703223015,3249791738,1672599149,1672599872,723
7681,3701898991,3933210486,1672702904,1672705581,2677
7660,3514838220,3903009525,1672683868,1672685761,1893
7897,3511312803,3793470489,1672592850,1672593061,211
7667,3248507722,3208844525,1672692463,1672693373,910
7556,3886298125,3888559320,1672577951,1672581334,3383
7529,3739106581,3418728074,1672649653,1672651830,2177
7949,3774127586,3703871468,1672619965,1672623247,3282
7893,3930797455,3298433163,1672702342,1672702818,476
7874,3232962003,3755511676,1672532405,1672533611,1206
7574,3505869747,3851190615,1672599354,1672601699,2345
7521,3296471982,3344364444,1672644397,1672644731,334
7977,3772309166,3513201436,1672544213,1672546444,2231
7772,3365942576,3351008918,1672703632,1672705177,1545
7966,3887270940,3515151980,1672692663,1672694512,1849
7531,3244389794,3278365525,1672565176,1672567117,1941
7487,3780593036,3792902982,1672610533,1672611040,507
7650,3736229191,3828365570,1672596622,1672596928,306
7923,3388286531,3248507722,1672558352,1672561450,3098
7885,3779528381,3519601612,1672688244,1672690424,2180
7617,3855602893,3683766533,1672599917,1672601162,1245
7564,3458539365,3202120784,1672702701,1672703184,483
7858,3909331423,3774045700,1672569555,1672572330,2775
7814,3433804879,3608868877,1672675674,1672677501,1827
7977,3303705369,3519069599,1672625884,1672628335,2451
7563,3937224533,3490191091,1672624344,1672626927,2583
7669,3817621391,3779528381,1672697100,1672699427,2327
7878,3434642576,3367902229,1672598719,1672600373,1654
7838,3736790081,3703441914,1672565434,1672568558,3124
7700,3757447189,3208844525,1672533691,1672536534,2843
7961,3488244966,3925620998,1672576050,1672579180,3130
7571,3209551760,3362000049,1672655268,1672658009,2741
7700,3774339795,3883042241,1672642736,1672643869,1133
7633,3716258994,3716843669,1672544343,1672545651,1308
7910,3356860407,3505292701,1672605263,1672607248,1985
7872,3411618230,3701146057,1672581840,1672585209,3369
7884,3791657947,3855424474,1672648633,1672650159,1526
7698,3362000049,3913251733,1672555834,1672558367,2533
7762,3755881905,3318697153,1672675493,1672675852,359
7516,3510857360,3737051610,1672685551,1672687920,2369
7890,3930791338,3518260334,1672614245,1672615400,1155
7826,3774366875,3817316561,1672682866,1672683269,403
7797,3209383861,3222448362,1672667666,1672668347,681
7526,3513599775,3458539365,1672550039,1672550507,468
7604,3352603894,3505873261,1672675429,1672675591,162
7747,3278365525,3715974031,1672650183,1672653293,3110
7803,3505362057,3428006164,1672660177,1672661075,898
7729,3511359172,3311208440,1672610426,1672611427,1001
7983,3303705369,3757602960,1672686271,1672687301,1030
7862,3918584946,3313541986,1672639953,1672640140,187
7893,3501759100,3432689543,1672625984,1672628356,2372
7636,3505347134,3757562897,1672703006,1672703739,733
7607,3500199935,3516065852,1672647874,1672648223,349
7832,3505193212,3517509185,1672546370,1672547094,724
7885,3783083229,3534488837,1672668431,1672670793,2362
7516,3318166135,3387966152,1672607699,1672608989,1290
7815,3497901842,3428964059,1672593594,1672596455,2861
7546,3427219654,3505347134,1672637452,1672640092,2640
7839,3701274634,3976390453,1672550357,1672552067,1710
7814,3793753089,3756930948,1672701457,1672702180,723
7819,3779629905,3760077057,1672673591,1672676093,2502
7861,3805347939,3505000737,1672531211,1672531903,692
7791,3318166135,3424922204,1672621443,1672622995,1552
7962,3288764520,3755872268,1672636651,1672638576,1925
7643,3510380060,3520719611,1672627953,1672631505,3552
7955,3312829208,3805347939,1672616065,1672617077,1012
7534,3505193212,3710569131,1672692272,1672692946,674
7529,3793627961,3734737881,1672699749,1672700969,1220
7485,3813052709,3825229501,1672577590,1672578449,859
7545,3316222192,3517476351,1672640969,1672643779,2810
7495,3500391167,3792384220,1672635061,1672635927,866
7568,3882291183,3777806071,1672639005,1672641714,2709
7891,3513454145,3818255890,1672701187,1672702642,1455
7949,3682061100,3390068992,1672637962,1672639017,1055
7677,3510126867,3615046771,1672665385,1672666653,1268
7502,3734828619,3271938399,1672661865,1672663243,1378
7883,3924549929,3303705369,1672609670,1672612070,2400
7926,3501955238,3517476351,1672594980,1672597778,2798
7615,3716488385,3342131135,1672605549,1672608406,2857
7873,3361230905,3772309150,1672613688,1672616003,2315
7546,3624761861,3851190615,1672622541,1672624608,2067
7710,3637008488,3453729665,1672554571,1672556270,1699
7529,3338367113,3710067113,1672699472,1672702615,3143
7800,3509907947,3914290246,1672636168,1672638604,2436
7710,3378092448,3396285984,1672575387,1672577946,2559
7798,3249401741,3911245524,1672564934,1672567784,2850
7665,3510380060,3415546117,1672534492,1672538050,3558
7543,3235287260,3828624701,1672658977,1672662376,3399
7785,3509352754,3406784491,1672551267,1672553189,1922
7694,3711262377,3773465237,1672671422,1672673869,2447
7607,3352603894,3791957752,1672639551,1672640346,795
7776,3701691675,3338367113,1672617269,1672620164,2895
7524,3889232789,3360506772,1672649496,1672650543,1047
7612,3882291183,3688683847,1672690591,1672693893,3302
7832,3222448362,3703441914,1672668784,1672670730,1946
7952,3825229501,3383661227,1672615557,1672617352,1795
7833,3793627961,3228165483,1672688404,1672688988,584
7656,3518876135,3391915121,1672565369,1672568900,3531
7857,3792288302,3311152102,1672645860,1672648818,2958
7681,3777455223,3416265063,1672664556,1672666361,1805
7704,3362000049,3311324983,1672592480,1672592556,76
7745,3777120536,3757562897,1672575555,1672577117,1562
7918,3351554343,3509907947,1672651145,1672652135,990
7761,3513201436,3793627961,1672658635,1672661756,3121
7761,3480687894,3770635361,1672618267,1672621838,3571
7580,3855424474,3891751546,1672590036,1672590820,784
7756,3477649378,3534191820,1672657691,1672657992,301
7644,3911245524,3755920131,1672650329,1672651539,1210
7555,3351008918,3855000166,1672537223,1672539938,2715
7961,3760492950,3757151210,1672701897,1672703423,1526
7746,3513454145,3501198706,1672681466,1672682715,1249
7675,3901990690,3755392666,1672703149,1672704650,1501
7900,3516258476,3510244400,1672601506,1672602091,585
7907,3519803045,3475396323,1672564881,1672566840,1959
7500,3514128943,3770824086,1672634401,1672637778,3377
7835,3513599775,3713894336,1672577148,1672579260,2112
7529,3383661227,3385763781,1672556037,1672557012,975
7856,3206254161,3313564074,1672578845,1672581520,2675
7539,3780639480,3228165483,1672664384,1672665571,1187
7570,3891751546,3735733948,1672662552,1672664432,1880
7706,3311993075,3248507722,1672703107,1672704222,1115
7509,3911159965,3774466457,1672631504,1672633674,2170
7557,3223968713,3533385867,1672642172,1672643574,1402
7766,3734496778,3791020967,1672687675,1672689567,1892
7721,3534553510,3510173870,1672697306,1672698822,1516
7513,3716165213,3383922351,1672666692,1672669927,3235
7775,3500374658,3533193862,1672635901,1672636943,1042
7533,3978115672,3489545239,1672578124,1672581444,3320
7783,3770824086,3816853177,1672674160,1672677690,3530
7733,3482405588,3496269445,1672579656,1672582524,2868
7726,3882291183,3715998609,1672678195,1672679504,1309
7908,3453729665,3713630656,1672626110,1672626181,71
7960,3737079798,3501486692,1672661621,1672662740,1119
7658,3935627557,3514128943,1672660084,1672660662,578
7902,3713808837,3485823740,1672557061,1672558049,988
7854,3778305740,3510711755,1672612855,1672613551,696
7731,3293695955,3519703355,1672615646,1672618242,2596
7758,3770078063,3399433690,1672591976,1672594395,2419
7685,3501486692,3416265063,1672700857,1672702505,1648
7830,3793470489,3792473331,1672593934,1672596315,2381
7983,3301107849,3613995936,1672632730,1672634984,2254
7925,3793470489,3394539273,1672559042,1672559739,697
7941,3500060260,3334033993,1672536318,1672536665,347
7522,3714962248,3505193212,1672625383,1672627716,2333
7609,3760893269,3501184421,1672604653,1672605710,1057
7701,3512217942,3827377568,1672633300,1672634004,704
7694,3791602225,3284832486,1672678100,1672678498,398
7491,3901877072,3505702787,1672541835,1672544724,2889
7893,3773755137,3976633198,1672539894,1672541627,1733
7666,3801089989,3510126867,1672561728,1672562965,1237
7646,3755436115,3516629436,1672603616,1672604383,767
7976,3412825109,3515723720,1672686971,1672689004,2033
7807,3516065852,3610695419,1672700891,1672704034,3143
7756,3489728806,3711308224,1672660977,1672661721,744
7814,3314245084,3773950140,1672646769,1672649374,2605
7624,3701984666,3443698222,1672664878,1672666520,1642
7874,3731419510,3755392666,1672684052,1672684978,926
7933,3331845324,3909606423,1672555039,1672556699,1660
7561,3515284591,3434642576,1672655905,1672657507,1602
7882,3755436115,3337544549,1672624511,1672626774,2263
7643,3407673904,3505635228,1672602190,1672603486,1296
7884,3421836608,3903962771,1672624769,1672625477,708
7501,3777929708,3805519285,1672532815,1672534665,1850
7882,3711973519,3372883226,1672590639,1672591098,459
7782,3626156564,3315583351,1672568884,1672570371,1487
7733,3519601612,3411618230,1672643288,1672645288,2000
7580,3238712269,3465254146,1672571310,1672574369,3059
7534,3736592744,3774045700,1672621114,1672624384,3270
7919,3922337974,3737154119,1672545611,1672547662,2051
7873,3930797455,3713894336,1672624506,1672624591,85
7614,3311415018,3979339287,1672597994,1672600156,2162
7601,3711504540,3755881905,1672682611,1672685974,3363
7949,3912262917,3610348516,1672534898,1672537068,2170
7902,3773205565,3613683164,1672533756,1672536648,2892
7982,3501692334,3201848640,1672576167,1672579678,3511
7828,3828432634,3703441914,1672570776,1672574344,3568
7542,3809059934,3496051529,1672582074,1672585520,3446
7602,3637008488,3731419510,1672630542,1672630965,423
7703,3760267716,3770553384,1672675350,1672677226,1876
7973,3885897503,3770078063,1672659020,1672662160,3140
7592,3303705369,3701967560,1672665865,1672667059,1194
7882,3933210486,3979339287,1672693674,1672694472,798
7788,3493507965,3271938399,1672599701,1672601098,1397
7807,3311090974,3770447408,1672560016,1672561328,1312
7917,3972709319,3808324264,1672591332,1672593980,2648
7718,3311203656,3311203656,1672534437,1672534653,216
7893,3417970574,3895562476,1672650725,1672653434,2709
7696,3791901535,3505098372,1672690321,1672693446,3125
7767,3384951177,3533385867,1672697411,1672697480,69
7608,3555214688,3519703355,1672693171,1672695810,2639
7882,3713808837,3716900301,1672571579,1672574414,2835
7809,3756451663,3776066388,1672670940,1672672357,1417
7771,3520751702,3922275416,1672675061,1672677196,2135
7889,3534553510,3509630174,1672590791,1672592566,1775
7514,3780813786,3448855696,1672562480,1672564089,1609
7938,3776948966,3316222192,1672695359,1672698061,2702
7511,3426325549,3515125508,1672539194,1672542657,3463
7941,3533193862,3338703270,1672698673,1672699000,327
7573,3855602893,3887270940,1672606207,1672606358,151
7842,3793962300,3202120784,1672702585,1672703852,1267
7683,3772053179,3338367113,1672571700,1672572669,969
7697,3783245561,3420700674,1672632642,1672634500,1858
7812,3379589402,3311648200,1672590103,1672592202,2099
7921,3778780511,3760267716,1672575174,1672578661,3487
7511,3517721725,3801089989,1672679329,1672681586,2257
7853,3451432842,3510594211,1672547263,1672548133,870
7603,3236102733,3716165213,1672557872,1672559035,1163
7637,3511125626,3882291183,1672592814,1672593172,358
7522,3855424474,3662180254,1672690430,1672692196,1766
7676,3776338577,3757682496,1672582443,1672583688,1245
7607,3780639480,3357483218,1672639607,1672642111,2504
7674,3246596716,3736790081,1672587945,1672589196,1251
7904,3312829208,3714474557,1672597671,1672599286,1615
7717,3773950140,3901990690,1672633465,1672633937,472
7907,3416427576,3520709480,1672538495,1672539827,1332
7954,3501606184,3715998609,1672561340,1672561445,105
7688,3315583351,3710408395,1672675801,1672677916,2115
7673,3234541252,3780609808,1672557678,1672559517,1839
7960,3227158514,3774066725,1672693880,1672695850,1970
7605,3791115967,3701967560,1672580815,1672584318,3503
7674,3374559242,3514128943,1672556295,1672557618,1323
7673,3505000737,3332072298,1672543901,1672545430,1529
7491,3736419952,3811171116,1672620513,1672622668,2155
7767,3710408395,3365614305,1672534724,1672534979,255
7573,3485008994,3776338577,1672650924,1672654075,3151
7529,3711569060,3416241005,1672586367,1672589231,2864
7954,3516716179,3882997884,1672601927,1672602750,823
7808,3500805881,3773950140,1672655522,1672657025,1503
7763,3490191091,3783429780,1672673347,1672676653,3306
7817,3828432634,3304625412,1672581638,1672582175,537
7812,3337544549,3311648200,1672591813,1672592546,733
7725,3779629905,3805519285,1672534910,1672537625,2715
7490,3774050956,3792768129,1672666371,1672666992,621
7949,3296471982,3791602225,1672589844,1672590162,318
7976,3880310724,3701065786,1672585351,1672588581,3230
7834,3520730271,3815508790,1672663126,1672664584,1458
7709,3534729133,3505973226,1672563730,1672566102,2372
7967,3482405588,3773120434,1672610655,1672610826,171
7538,3519563836,3399433690,1672656299,1672657559,1260
7669,3209027249,3701146057,1672671994,1672673495,1501
7675,3379589402,3913251733,1672620339,1672623027,2688
7825,3516039895,3500904641,1672634583,1672636145,1562
7634,3533748232,3828624701,1672698058,1672699746,1688
7603,3701498253,3713808837,1672662332,1672664750,2418
7731,3792902982,3772309150,1672614715,1672617430,2715
7963,3711308224,3756462516,1672579424,1672580601,1177
7545,3311439795,3780639480,1672581936,1672582855,919
7767,3716273414,3852595551,1672671016,1672672233,1217
7833,3636867411,3505702787,1672648369,1672650208,1839
7794,3421836608,3918674986,1672621506,1672621660,154
7754,3703735129,3501927421,1672690933,1672691098,165
7872,3903307060,3783245561,1672595344,1672597220,1876
7864,3711380716,3792844210,1672594107,1672595869,1762
7863,3756453423,3772309166,1672698250,1672698780,530
7756,3778341199,3533369198,1672554737,1672554972,235
7495,3360743849,3510969660,1672691664,1672693413,1749
7889,3855602893,3791942683,1672667240,1672668751,1511
7596,3399535232,3501364586,1672681798,1672684833,3035
7730,3770553384,3760294205,1672696308,1672698892,2584
7755,3516980378,3367902229,1672552624,1672553760,1136
7926,3828624701,3391915121,1672539708,1672542850,3142
7699,3922275416,3783531004,1672625832,1672628107,2275
7965,3304625412,3716488385,1672596524,1672599167,2643
7542,3910454786,3792768129,1672666918,1672667972,1054
7832,3516223597,3774793839,1672544405,1672546967,2562
7540,3394330287,3636867411,1672663472,1672665641,2169
7543,3383661227,3339907603,1672532589,1672534700,2111
7781,3556951786,3311993075,1672570629,1672572909,2280
7721,3202120784,3412825109,1672556302,1672558180,1878
7570,3515860749,3738274418,1672636301,1672638720,2419
7797,3755739653,3559110998,1672612979,1672614127,1148
7741,3883312122,3297463265,1672665297,1672667135,1838
7505,3817316561,3757403279,1672645002,1672648269,3267
7828,3757682496,3859525941,1672648561,1672648958,397
7854,3351554343,3822654369,1672696794,1672699709,2915
7953,3519152550,3534488837,1672600903,1672602776,1873
7758,3701065786,3304056063,1672571036,1672572242,1206
7756,3828365570,3683959482,1672600320,1672600770,450
7685,3911245524,3774556560,1672646192,1672647336,1144
7889,3490191091,3783925755,1672601415,1672602872,1457
7650,3617734118,3407673904,1672695480,1672696628,1148
7539,3370752401,3344019610,1672532177,1672534175,1998
7583,3774268456,3713644518,1672694944,1672697193,2249
7957,3387674757,3826633236,1672547575,1672548384,809
7694,3518669703,3886298125,1672562429,1672565831,3402
7906,3617734118,3399052055,1672697157,1672698355,1198
7631,3510771358,3534191820,1672558526,1672561602,3076
7667,3533653428,3221899927,1672673503,1672674769,1266
7930,3915628728,3660493209,1672539683,1672539784,101
7691,3209551760,3244485293,1672602655,1672603558,903
7874,3774520233,3533827120,1672537333,1672539568,2235
7958,3859525941,3713786889,1672607092,1672607559,467
7656,3223968713,3513164386,1672688971,1672691701,2730
7521,3756601594,3701691675,1672536614,1672537420,806
7620,3520931254,3783239924,1672549245,1672551016,1771
7498,3774125065,3383661227,1672600713,1672603243,2530
7712,3277605882,3500365158,1672622949,1672625709,2760
7536,3813052709,3793627961,1672659155,1672659690,535
7877,3284639858,3407954858,1672645953,1672648720,2767
7646,3418728074,3298288268,1672673963,1672674507,544
7932,3500066230,3755739653,1672587831,1672590697,2866
7966,3378686918,3885670556,1672613659,1672617024,3365
7597,3772714862,3303751772,1672643217,1672645863,2646
7796,3887270940,3756021689,1672534576,1672537113,2537
7595,3333896808,3608868877,1672566341,1672566669,328
7688,3291227780,3835382117,1672694538,1672697346,2808
7610,3311274543,3733891182,1672540213,1672541432,1219
7583,3223789409,3378436155,1672627083,1672630335,3252
7595,3703223015,3516716179,1672669983,1672672691,2708
7541,3791657947,3511687358,1672695312,1672697709,2397
7957,3793753089,3832902928,1672639889,1672643253,3364
7614,3783239924,3606812411,1672647147,1672648717,1570
7510,3511359172,3772359096,1672585694,1672588713,3019
7648,3311152102,3399052055,1672652830,1672656257,3427
7550,3851190615,3891751546,1672694610,1672695026,416
7776,3505635228,3505173328,1672544215,1672545443,1228
7726,3703223015,3774204963,1672696026,1672699219,3193
7534,3311603601,3280964728,1672681227,1672683334,2107
7600,3229058858,3780593036,1672604089,1672607352,3263
7806,3500805881,3613995936,1672656379,1672656859,480
7679,3493507965,3406784491,1672591034,1672591854,820
7638,3501601840,3344019610,1672587072,1672589972,2900
7746,3889750851,3714504419,1672622740,1672623419,679
7626,3510244400,3511163800,1672607259,1672609452,2193
7617,3513080274,3505530961,1672564426,1672564687,261
7695,3496269445,3914290246,1672563469,1672565135,1666
7588,3315583351,3511687358,1672581968,1672582511,543
7763,3778780511,3701190899,1672688239,1672689958,1719
7566,3736592744,3209027249,1672646133,1672648096,1963
7952,3701898991,3703889596,1672573327,1672574201,874
7527,3826759140,3550946908,1672545043,1672546763,1720
7640,3816454165,3229665776,1672619409,1672620823,1414
7579,3428674539,3200198928,1672644594,1672644877,283
7666,3618045231,3244436890,1672659069,1672660951,1882
7751,3520165601,3912536808,1672663037,1672664190,1153
7751,3496269445,3481647420,1672686404,1672686627,223
7536,3703223015,3519700826,1672626668,1672628136,1468
7850,3772309166,3792668962,1672621995,1672624923,2928
7574,3925620998,3519556068,1672613701,1672616249,2548
7843,3780828689,3520888296,1672557760,1672559625,1865
7645,3550946908,3703789494,1672667657,1672668585,928
7701,3778980116,3911245524,1672567858,1672569818,1960
7888,3232962003,3817316561,1672620389,1672623861,3472
7930,3903307060,3202120784,1672566658,1672569628,2970
7899,3780914982,3480687894,1672649015,1672650936,1921
7673,3738274418,3249247700,1672581448,1672584970,3522
7738,3714821932,3852391257,1672666467,1672669337,2870
7878,3510857360,3505362057,1672659771,1672661141,1370
7649,3773598056,3516258476,1672702986,1672703794,808
7584,3914290246,3344019610,1672659401,1672660027,626
7860,3713349754,3637008488,1672532077,1672534506,2429
7721,3533025282,3520376528,1672602567,1672604186,1619
7880,3516960534,3384951177,1672578559,1672582107,3548
7815,3778108318,3770763956,1672583332,1672584451,1119
7650,3247428249,3505347134,1672651612,1672653148,1536
7879,3534313900,3510857360,1672629738,1672633156,3418
7922,3505912939,3249401741,1672659688,1672662562,2874
7873,3520030713,3370752401,1672621939,1672624870,2931
7699,3247780536,3412980697,1672603814,1672606059,2245
7648,3918056059,3715492942,1672679281,1672681037,1756
7563,3466229085,3837094550,1672552996,1672555510,2514
7597,3711569060,3229058858,1672661341,1672664635,3294
7877,3519912874,3780813786,1672574921,1672577478,2557
7568,3428674539,3710112546,1672602785,1672602895,110
7739,3284832486,3815508790,1672657157,1672660469,3312
7614,3606987130,3793086311,1672564002,1672564081,79
7783,3228165483,3774520233,1672688090,1672688935,845
7865,3815508790,3666506258,1672647926,1672651121,3195
7806,3660493209,3668005723,1672650218,1672650632,414
7649,3805347939,3520730271,1672658354,1672661284,2930
7509,3533385867,3513201436,1672576520,1672578796,2276
7964,3510244400,3384951177,1672680089,1672683181,3092
7562,3234362962,3500994774,1672702828,1672705801,2973
7528,3434642576,3301107849,1672631598,1672634870,3272
7486,3711370563,3818255890,1672695432,1672698601,3169
7781,3777936328,3760267716,1672697269,1672698538,1269
7547,3209027249,3406784491,1672696543,1672697395,852
7638,3271938399,3813052709,1672564374,1672567162,2788
7605,3304056063,3510969660,1672697282,1672698998,1716
7912,3622054816,3715189301,1672632189,1672633963,1774
7924,3776513891,3783925755,1672579510,1672582441,2931
7590,3512540951,3432689543,1672679942,1672683122,3180
7603,3500229033,3227457126,1672640262,1672641136,874
7719,3552314511,3701274634,1672566762,1672567774,1012
7847,3520165601,3291235378,1672674624,1672674720,96
7503,3475251781,3804870229,1672697252,1672698122,870
7971,3921211276,3711569060,1672634466,1672635606,1140
7533,3778780511,3428674539,1672603830,1672604681,851
7942,3201324715,3234541252,1672659043,1672662582,3539
7983,3496269445,3515394721,1672535126,1672538688,3562
7529,3613683164,3519703355,1672673501,1672675057,1556
7713,3899266183,3639847263,1672618733,1672619103,370
7740,3780639480,3489962019,1672575523,1672577630,2107
7771,3716900301,3501486692,1672620106,1672621967,1861
7587,3774268456,3500803339,1672680777,1672680997,220
7619,3792288302,3533137446,1672669218,1672672358,3140
7492,3517476351,3822654369,1672665311,1672666018,707
7543,3208844525,3937224533,1672590643,1672592088,1445
7604,3505635228,3777936328,1672612129,1672612695,566
7972,3800886801,3760561634,1672603283,1672606179,2896
7601,3229665776,3756623396,1672701980,1672704985,3005
7941,3356860407,3516514391,1672696953,1672698311,1358
7903,3827377568,3770824086,1672586666,1672587155,489
7808,3755881905,3388372715,1672630707,1672630889,182
7973,3513080274,3783245561,1672702166,1672703164,998
7901,3716746253,3711504540,1672681431,1672682585,1154
7982,3774366875,3902383721,1672633015,1672636067,3052
7795,3774520233,3520756859,1672638427,1672640776,2349
7749,3918674986,3890149705,1672609989,1672610682,693
7600,3716165213,3206254161,1672660368,1672662191,1823
7557,3853018906,3605726278,1672557889,1672559995,2106
7631,3206603608,3931941795,1672538584,1672539411,827
7634,3516606733,3779629905,1672548824,1672551366,2542
7951,3367029997,3302626661,1672628644,1672628823,179
7813,3466229085,3517476351,1672605714,1672608142,2428
7717,3390068992,3774127586,1672663978,1672665832,1854
7562,3685818092,3516039895,1672697875,1672698248,373
7801,3473765852,3826760240,1672599836,1672602880,3044
7675,3714474557,3361230905,1672545477,1672545923,446
7577,3883085535,3777477395,1672586465,1672588116,1651
7788,3792883665,3337544549,1672549973,1672551355,1382
7617,3772884106,3509453566,1672576970,1672577286,316
7521,3730517636,3819727225,1672549410,1672550416,1006
7927,3711198793,3297463265,1672655439,1672657921,2482
7906,3778341199,3760489031,1672683624,1672684092,468
7489,3415443558,3345207877,1672535259,1672535590,331
7927,3510771358,3756528686,1672601537,1672602958,1421
7755,3432689543,3428006164,1672660868,1672664103,3235
7737,3367029997,3534424200,1672556334,1672557810,1476
7922,3489545239,3774195321,1672628751,1672631134,2383
7771,3755511676,3517509185,1672531866,1672534695,2829
7839,3902383721,3443698222,1672651294,1672653078,1784
7541,3427283336,3731106822,1672639044,1672640527,1483
7725,3303751772,3774338212,1672541117,1672541970,853
7496,3443698222,3755587522,1672590218,1672590473,255
7625,3517509185,3793871337,1672661288,1672662289,1001
7928,3407725581,3365614305,1672687150,1672689857,2707
7949,3683959482,3489728806,1672634365,1672635471,1106
7977,3780593036,3511267139,1672681059,1672681349,290
7562,3734828619,3494290908,1672544826,1672546479,1653
7814,3399433690,3429690204,1672618203,1672620947,2744
7593,3931941795,3629547065,1672564195,1672565577,1382
7533,3793436995,3827626797,1672590151,1672592857,2706
7712,3776066388,3925402713,1672648414,1672648860,446
7765,3778266283,3517864478,1672595321,1672597726,2405
7829,3515723720,3813052709,1672577491,1672578630,1139
7852,3505702787,3511312803,1672610054,1672611024,970
7920,3778549126,3249791738,1672547582,1672549722,2140
7753,3378092448,3513164386,1672655790,1672658523,2733
7927,3407725581,3384951177,1672696546,1672700093,3547
7883,3384240055,3407954858,1672674056,1672674954,898
7740,3703441914,3209027249,1672679561,1672681916,2355
7818,3760489031,3520165601,1672663934,1672663998,64
7696,3882291183,3399535232,1672572119,1672575238,3119
7524,3510857360,3432689543,1672638012,1672640872,2860
7602,3829319703,3606186086,1672538484,1672540646,2162
7875,3500487333,3901877072,1672600641,1672603811,3170
7755,3852391257,3428964059,1672598085,1672600266,2181
7628,3855937514,3533369198,1672625728,1672626367,639
7913,3716168623,3618045231,1672536414,1672538219,1805
7521,3510771358,3783239924,1672591765,1672592750,985
7746,3891751546,3505599848,1672531549,1672532851,1302
7599,3485823740,3738502357,1672642023,1672644511,2488
7615,3780914982,3221899927,1672614355,1672617463,3108
7751,3515860749,3249401741,1672571483,1672573989,2506
7915,3416427576,3629547065,1672642365,1672644910,2545
7673,3514472925,3515394721,1672691942,1672692822,880
7973,3755436115,3773755137,1672678842,1672679097,255
7493,3731106822,3279721246,1672676748,1672679320,2572
7743,3605726278,3515860749,1672608776,1672612315,3539
7650,3512969370,3714962248,1672623600,1672626912,3312
7791,3291883916,3458539365,1672689245,1672691705,2460
7767,3774268456,3533927138,1672673432,1672676264,2832
7850,3811694763,3818255890,1672694980,1672695480,500
7710,3209383861,3496269445,1672669362,1672672873,3511
7589,3517459919,3914259449,1672564241,1672565947,1706
7593,3701898991,3736229191,1672655323,1672656755,1432
7579,3792253549,3518360734,1672630596,1672633142,2546
7639,3777776687,3711262377,1672635844,1672636154,310
7629,3778266283,3610695419,1672696928,1672697030,102
7660,3234362962,3701111745,1672625418,1672628381,2963
7594,3505362057,3933210486,1672563503,1672566395,2892
7787,3510173870,3512142794,1672536258,1672537725,1467
7686,3610348516,3772884106,1672542599,1672545637,3038
7786,3664517356,3311761694,1672643309,1672645694,2385
7760,3778780511,3312333615,1672569972,1672570305,333
7556,3370636709,3732481297,1672618927,1672619058,131
7958,3512683609,3773755137,1672663492,1672666844,3352
7650,3510771358,3318166135,1672566023,1672568972,2949
7882,3711198793,3805519285,1672571801,1672574730,2929
7523,3716843669,3311324983,1672654093,1672655035,942
7763,3779528381,3716273414,1672630528,1672631373,845
7588,3319752091,3716537575,1672577913,1672581449,3536
7505,3483949762,3533371364,1672653100,1672656226,3126
7673,3978115672,3394539273,1672651423,1672653350,1927
7646,3438645253,3509634629,1672642587,1672643792,1205
7579,3383661227,3922337974,1672548740,1672549260,520
7966,3307097200,3516909237,1672613046,1672613193,147
7728,3297463265,3887270940,1672572983,1672573430,447
7819,3520206212,3756601594,1672597969,1672601046,3077
7813,3783245561,3392121505,1672640227,1672641109,882
7761,3920801189,3909238838,1672563884,1672565604,1720
7601,3518669703,3715981584,1672542475,1672544199,1724
7869,3792384220,3733189298,1672699487,1672703049,3562
7751,3438645253,3773978034,1672587294,1672588482,1188
7685,3776338577,3738502357,1672566900,1672569745,2845
7752,3505638204,3489728806,1672598399,1672599017,618
7714,3890149705,3770635361,1672589889,1672592205,2316
7504,3903307060,3925620998,1672676919,1672677341,422
7503,3701534009,3836573197,1672537518,1672538840,1322
7709,3792473331,3370752401,1672611156,1672611998,842
7572,3772578994,3701995648,1672684548,1672684875,327
7849,3405494240,3777790718,1672673719,1672675154,1435
7880,3791602225,3926700506,1672551655,1672552513,858
7659,3416241005,3512567240,1672648449,1672652002,3553
7679,3780974443,3396086535,1672696655,1672697187,532
7694,3852595551,3513164386,1672556618,1672558840,2222
7843,3333896808,3517255726,1672588314,1672590820,2506
7627,3755943611,3760267716,1672665748,1672666137,389
7578,3344364444,3605726278,1672603694,1672603825,131
7847,3909331423,3760077057,1672655863,1672657012,1149
7512,3512540951,3827222533,1672673563,1672676235,2672
7767,3516039895,3777717988,1672546450,1672546632,182
7493,3515860749,3780813786,1672659920,1672662186,2266
7951,3303751772,3710408395,1672554464,1672558036,3572
7511,3511267139,3451432842,1672650091,1672650295,204
7967,3703223015,3852391257,1672608782,1672611811,3029
7711,3501184421,3889232789,1672685003,1672687323,2320
7894,3791115967,3236102733,1672655550,1672658135,2585
7703,3916289176,3311718847,1672553129,1672554139,1010
7721,3716488385,3318697153,1672618082,1672621542,3460
7710,3533025282,3513201436,1672641147,1672641482,335
7514,3361230905,3223789409,1672537077,1672537352,275
7607,3601879040,3496051529,1672532412,1672533905,1493
7794,3505362057,3519556068,1672633184,1672633873,689
7699,3773664987,3489545239,1672664725,1672666702,1977
7697,3209048907,3734828619,1672681280,1672682326,1046
7902,3513599775,3200198928,1672557625,1672559881,2256
7794,3791594391,3917088658,1672687540,1672687634,94
7500,3909331423,3399004969,1672633922,1672635286,1364
7721,3338703270,3773205565,1672695253,1672696014,761
7484,3791942683,3832902928,1672613776,1672615928,2152
7809,3249401741,3505912939,1672645092,1672647433,2341
7833,3511332835,3755587522,1672574651,1672575662,1011
7873,3296471982,3733189298,1672650509,1672653377,2868
7682,3397418363,3533369198,1672593577,1672593995,418
7900,3851190615,3634786711,1672681989,1672684794,2805
7603,3361230905,3360993964,1672611453,1672613055,1602
7868,3777806071,3339907603,1672639871,1672641205,1334
7596,3701178711,3783779671,1672560172,1672562344,2172
7561,3511267139,3505635228,1672702034,1672702543,509
7492,3311154569,3791901535,1672543796,1672544604,808
7701,3232962003,3756453423,1672628873,1672632245,3372
7552,3390068992,3287105466,1672643079,1672644853,1774
7726,3316173088,3703661585,1672658951,1672661123,2172
7952,3711571712,3378436155,1672633461,1672636321,2860
7606,3517459919,3301107849,1672599888,1672603339,3451
7692,3819727225,3505477652,1672595289,1672598282,2993
7761,3778780511,3209551760,1672660965,1672661489,524
7932,3372883226,3443698222,1672600902,1672602018,1116
7807,3367902229,3515691540,1672686052,1672688105,2053
7796,3922275620,3757447189,1672558682,1672560922,2240
7901,3302626661,3852391257,1672613168,1672613555,387
7799,3716746253,3713894336,1672627962,1672630687,2725
7658,3500578848,3367029997,1672605425,1672607789,2364
7734,3291883916,3520931254,1672587446,1672587868,422
7570,3209551760,3760489031,1672538641,1672539926,1285
7877,3453729665,3534553510,1672592544,1672593010,466
7706,3890149705,3918247820,1672672650,1672673601,951
7637,3666506258,3791115967,1672608678,1672610996,2318
7757,3391915121,3505635228,1672552869,1672556250,3381
7923,3475396323,3793962300,1672629512,1672631889,2377
7768,3389115045,3774195321,1672622054,1672622602,548
7893,3711370563,3911245524,1672607006,1672609110,2104
7785,3478194807,3793436995,1672640619,1672643305,2686
7754,3432689543,3757403279,1672686624,1672687792,1168
7796,3778266283,3510247121,1672567025,1672569470,2445
7686,3880310724,3511332835,1672545715,1672548166,2451
7707,3921211276,3887270940,1672580596,1672582386,1790
7559,3459030804,3817316561,1672644384,1672646393,2009
7942,3311439795,3735319397,1672561292,1672564376,3084
7746,3701691675,3716197887,1672693901,1672696744,2843
7645,3774556560,3229058858,1672663052,1672666332,3280
7670,3792668962,3500374658,1672599184,1672601215,2031
7865,3234541252,3918584946,1672666801,1672669608,2807
7639,3200198928,3701691675,1672651257,1672653041,1784
7711,3533095755,3760598102,1672644413,1672645680,1267
7730,3346327502,3517459919,1672636429,1672636726,297
7959,3898995675,3682061100,1672678954,1672679618,664
7807,3783705817,3352603894,1672535585,1672538243,2658
7569,3917278625,3774466457,1672635357,1672636405,1048
7500,3627937312,3779629905,1672573982,1672576474,2492
7547,3773978034,3613995936,1672664044,1672667517,3473
7565,3483949762,3701995648,1672702055,1672703204,1149
7617,3911245524,3517077106,1672605234,1672606470,1236
7646,3816853177,3910454786,1672581120,1672584531,3411
7657,3976633198,3505145247,1672642919,1672643449,530
7948,3664517356,3512720680,1672702752,1672703235,483
7544,3509933351,3774268456,1672564127,1672564602,475
7704,3904775198,3520030713,1672601474,1672604612,3138
7977,3779740455,3777936328,1672683434,1672683792,358
7703,3336751428,3903009525,1672634029,1672636427,2398
7933,3520206212,3471220483,1672554798,1672555959,1161
7695,3827222533,3339907603,1672533575,1672534438,863
7741,3885897503,3426325549,1672666848,1672669684,2836
7938,3514838220,3407673904,1672703615,1672705152,1537
7964,3778305740,3500066230,1672534814,1672534910,96
7814,3519803045,3480687894,1672606855,1672607910,1055
7927,3337544549,3773978034,1672611171,1672612845,1674
7541,3378092448,3360506772,1672612800,1672615206,2406
7861,3428964059,3518260334,1672643588,1672646574,2986
7911,3976390453,3972709319,1672537056,1672540054,2998
7554,3415443558,3249791738,1672618133,1672620806,2673
7667,3912262917,3818255890,1672691048,1672693503,2455
7911,3516980378,3716746253,1672646066,1672649211,3145
7756,3500177712,3519428855,1672671870,1672675176,3306
7588,3483164654,3783531004,1672650786,1672653157,2371
7710,3416265063,3395152943,1672546269,1672548450,2181
7690,3701065786,3780914982,1672621629,1672624029,2400
7795,3904775198,3936227020,1672595852,1672597451,1599
7741,3912262917,3501198706,1672658617,1672660934,2317
7843,3221899927,3736592744,1672538808,1672541698,2890
7877,3224058172,3811694763,1672539169,1672541945,2776
7816,3209027249,3494290908,1672651460,1672653946,2486
7863,3825229501,3311993075,1672612996,1672616119,3123
7746,3731106822,3903307060,1672573852,1672574715,863
7626,3777790718,3513164386,1672605008,1672605117,109
7757,3811694763,3711308224,1672599120,1672599825,705
7575,3615046771,3510857360,1672564024,1672567060,3036
7574,3791942683,3662180254,1672684193,1672685390,1197
7554,3774195321,3518876135,1672699833,1672700266,433
7589,3853018906,3809059934,1672665505,1672666569,1064
7698,3515723720,3703871468,1672631213,1672631362,149
7957,3510857360,3757403279,1672560785,1672562736,1951
7664,3713644518,3418728074,1672637473,1672638572,1099
7612,3611150562,3510380060,1672596833,1672598012,1179
7731,3889750851,3481647420,1672607464,1672608666,1202
7574,3779740455,3791594391,1672538919,1672541347,2428
7819,3736625083,3311154569,1672637695,1672639911,2216
7593,3465254146,3500229033,1672695995,1672696490,495
7841,3805519285,3736786443,1672682496,1672683661,1165
7870,3500805881,3513956646,1672690027,1672690530,503
7699,3229058858,3711571712,1672558513,1672558960,447
7640,3783779671,3439023335,1672627265,1672627861,596
7686,3511267139,3917278625,1672660938,1672662950,2012
7764,3770851318,3311203656,1672627279,1672628361,1082
7802,3505203158,3513454145,1672695085,1672696860,1775
7815,3516606733,3916289176,1672582564,1672582884,320
7717,3855424474,3683766533,1672570732,1672571655,923
7551,3780365428,3517255726,1672543152,1672546214,3062
7788,3755392666,3792384220,1672687704,1672691068,3364
7623,3511435497,3811171116,1672648841,1672650481,1640
7973,3222521619,3556951786,1672673315,1672675033,1718
7897,3249401741,3534488837,1672624898,1672625497,599
7949,3280615985,3777929708,1672630298,1672633771,3473
7966,3772746272,3624761861,1672644390,1672645227,837
7919,3772578994,3236102733,1672667282,1672670171,2889
7910,3755739653,3807987001,1672558175,1672558943,768
7523,3780788622,3402943525,1672560950,1672562783,1833
7814,3518014636,3533025282,1672568665,1672569319,654
7636,3776800213,3424922204,1672654833,1672656479,1646
7758,3533626375,3667680268,1672559677,1672560408,731
7781,3895562476,3703789494,1672672031,1672674750,2719
7506,3801089989,3206603608,1672535793,1672536247,454
7853,3534010629,3552314511,1672702772,1672706275,3503
7542,3806545488,3909238838,1672554397,1672556648,2251
7604,3420700674,3600647945,1672616321,1672618396,2075
7919,3711380716,3703223015,1672570777,1672573806,3029
7935,3713894336,3903009525,1672542388,1672545281,2893
7970,3485823740,3516514391,1672581446,1672583045,1599
7817,3276993580,3918056059,1672601405,1672602983,1578
7781,3465202715,3738502357,1672662682,1672663025,343
7747,3520206212,3517963492,1672564828,1672566425,1597
7767,3899266183,3311871871,1672687144,1672688609,1465
7594,3922275620,3636867411,1672581437,1672582678,1241
7659,3857349323,3505883609,1672576797,1672577710,913
7678,3312829208,3227457126,1672628635,1672630028,1393
7948,3509630174,3511332835,1672649013,1672649707,694
7692,3773755137,3311090974,1672552367,1672553037,670
7914,3666506258,3629547065,1672643439,1672645980,2541
7726,3716168623,3772053179,1672677821,1672679825,2004
7579,3559110998,3514283243,1672599961,1672601937,1976
7543,3780813786,3737154119,1672629927,1672630212,285
7660,3615046771,3552314511,1672686698,1672688002,1304
7495,3514128943,3774580701,1672547944,1672549113,1169
7967,3883551721,3772337814,1672649353,1672650723,1370
7979,3773814927,3852595551,1672664346,1672665640,1294
7858,3807987001,3777790718,1672560378,1672563667,3289
7967,3509630174,3500365158,1672672143,1672673553,1410
7924,3511125626,3755392666,1672689217,1672689919,702
7578,3465202715,3500066230,1672695953,1672699085,3132
7512,3805519285,3701984666,1672549069,1672551552,2483
7824,3604539807,3520931254,1672675860,1672677720,1860
7947,3774793839,3374559242,1672657706,1672659277,1571
7619,3972364603,3511332835,1672555192,1672555548,356
7614,3510173870,3812176780,1672567726,1672569101,1375
7697,3774125065,3519428855,1672669214,1672669834,620
7791,3736790081,3701065786,1672644286,1672645831,1545
7644,3242408357,3365278081,1672544286,1672547796,3510
7706,3505649239,3613995936,1672664137,1672665090,953
7896,3400918687,3834257412,1672615672,1672618265,2593
7613,3520756859,3407954858,1672552836,1672554022,1186
7699,3512217942,3533371364,1672546350,1672549687,3337
7878,3316173088,3613683164,1672572228,1672572437,209
7810,3533385867,3937224533,1672543385,1672544524,1139
7775,3505219850,3487171044,1672650330,1672652901,2571
7540,3280615985,3807987001,1672615060,1672617517,2457
7879,3511359172,3730517636,1672557489,1672560437,2948
7918,3402943525,3505973226,1672628418,1672630611,2193
7644,3500391167,3501927421,1672592167,1672592721,554
7779,3517077106,3374559242,1672688420,1672691852,3432
7571,3303705369,3313564074,1672579402,1672579678,276
7965,3703441914,3924549929,1672702001,1672702288,287
7852,3277669002,3772359096,1672580799,1672581365,566
7822,3772053179,3316173088,1672552462,1672552861,399
7502,3483164654,3359239884,1672571065,1672571928,863
7847,3770447408,3760561634,1672671752,1672673427,1675
7876,3911245524,3834257412,1672581376,1672583614,2238
7613,3224716315,3828432634,1672662760,1672665632,2872
7871,3336742544,3730517636,1672696077,1672699597,3520
7632,3485823740,3235635976,1672670779,1672673108,2329
7782,3476232529,3384240055,1672686440,1672686827,387
7576,3756930948,3779976989,1672684996,1672685760,764
7744,3421836608,3713808837,1672581371,1672584809,3438
7494,3770635361,3904775198,1672532104,1672533522,1418
7523,3882997884,3755872268,1672600022,1672601300,1278
7670,3395152943,3429856982,1672552155,1672555370,3215
7649,3473765852,3509634629,1672609159,1672612033,2874
7792,3889750851,3736419952,1672565202,1672566657,1455
7950,3755943611,3716273414,1672691859,1672693600,1741
7899,3882242815,3882242815,1672621472,1672624667,3195
7844,3716168623,3374559242,1672593891,1672595689,1798
7492,3903307060,3792473331,1672559840,1672562677,2837
7876,3779218771,3533137446,1672578865,1672580671,1806
7973,3519912874,3637008488,1672638388,1672639674,1286
7536,3777790718,3792032359,1672667538,1672670907,3369
7973,3409474775,3511198618,1672678236,1672681701,3465
7832,3388637594,3490191091,1672593798,1672594620,822
7584,3509604974,3247780536,1672656535,1672658555,2020
7617,3346795719,3777623166,1672676127,1672679652,3525
7716,3514472925,3777929708,1672701063,1672701231,168
7550,3703889596,3500904641,1672701146,1672703607,2461
7856,3520165601,3739106581,1672555291,1672558123,2832
7622,3314245084,3852391257,1672593081,1672594740,1659
7733,3520709480,3826633236,1672550472,1672550901,429
7851,3777514571,3360993964,1672594028,1672594663,635
7813,3715339701,3755943611,1672643519,1672644717,1198
7766,3857349323,3757161914,1672545751,1672546831,1080
7950,3757151210,3550946908,1672623599,1672626027,2428
7866,3311415018,3510594211,1672657506,1672658864,1358
7787,3405494240,3816853177,1672641621,1672644680,3059
7694,3909331423,3311993075,1672687750,1672688852,1102
7880,3514472925,3421836608,1672674926,1672678432,3506
7753,3889750851,3736229191,1672618382,1672621217,2835
7590,3475251781,3432665384,1672588853,1672590580,1727
7742,3736625083,3396086535,1672545957,1672547812,1855
7655,3387966152,3496269445,1672565369,1672566252,883
7690,3519152550,3777806071,1672690678,1672693563,2885
7528,3311154569,3760183458,1672566099,1672566199,100
7550,3485008994,3395152943,1672659945,1672661325,1380
7525,3713969578,3505193212,1672558504,1672561240,2736
7565,3475396323,3430352815,1672631872,1672634725,2853
7755,3918584946,3755392666,1672654555,1672654695,140
7590,3511170269,3832902928,1672617764,1672618612,848
7766,3801089989,3791874383,1672569119,1672569298,179
7496,3618045231,3515691540,1672627201,1672627881,680
7770,3364543015,3428964059,1672667087,1672667194,107
7577,3738274418,3291227780,1672637952,1672638366,414
7891,3227158514,3407954858,1672534460,1672536287,1827
7566,3716843669,3359239884,1672577424,1672578905,1481
7573,3483949762,3715974031,1672556647,1672557413,766
7498,3629547065,3736229191,1672564417,1672565280,863
7916,3780503655,3703955926,1672641456,1672642176,720
7895,3487171044,3772309166,1672582845,1672584352,1507
7620,3311627628,3710112546,1672570786,1672574149,3363
7955,3778266283,3481502100,1672688442,1672688869,427
7804,3827222533,3500487333,1672631484,1672633521,2037
7742,3496549058,3489728806,1672571239,1672572352,1113
7943,3333896808,3774268456,1672702545,1672702650,105
7890,3776948966,3485823740,1672693797,1672695523,1726
7814,3792177074,3760569731,1672567933,1672568844,911
7845,3475396323,3311603601,1672562387,1672564896,2509
7821,3770021824,3402943525,1672539392,1672540657,1265
7536,3351554343,3890149705,1672657545,1672657756,211
7942,3399911573,3400918687,1672622179,1672624268,2089
7700,3760492950,3351008918,1672568745,1672570601,1856
7698,3777806071,3793627961,1672565444,1672567713,2269
7672,3518669703,3201432789,1672601936,1672603354,1418
7795,3418534998,3713969578,1672669662,1672672793,3131
7770,3629935998,3224716315,1672654006,1672654186,180
7708,3209048907,3809916577,1672577966,1672581379,3413
7635,3615046771,3520190170,1672543992,1672546710,2718
7767,3895562476,3791874383,1672689137,1672692673,3536
7830,3315583351,3352603894,1672694529,1672695046,517
7638,3311871871,3776948966,1672539365,1672540906,1541
7702,3409474775,3285400528,1672581795,1672583630,1835
7861,3755042098,3776948966,1672695569,1672697409,1840
7692,3311718847,3434642576,1672618138,1672620667,2529
7965,3273500349,3710408395,1672639568,1672641377,1809
7572,3238712269,3534424200,1672597754,1672599589,1835
7705,3420700674,3518260334,1672606224,1672607842,1618
7848,3888559320,3736786443,1672561197,1672561641,444
7888,3555214688,3273500349,1672537893,1672539974,2081
7795,3777790718,3685187183,1672566566,1672568119,1553
7884,3311324983,3512683609,1672578052,1672580588,2536
7777,3247428249,3605726278,1672702392,1672703190,798
7503,3899204805,3777477395,1672655430,1672657571,2141
7961,3288764520,3774045700,1672554897,1672557016,2119
7691,3387966152,3756021689,1672663740,1672665212,1472
7778,3405494240,3303705369,1672651309,1672654136,2827
7624,3478194807,3200198928,1672640199,1672640263,64
7729,3716488385,3791997875,1672609230,1672610156,926
7925,3517476351,3715981584,1672696825,1672699567,2742
7762,3688683847,3513599775,1672589068,1672589512,444
7727,3887270940,3774466457,1672644418,1672645430,1012
7484,3518791447,3793753089,1672603292,1672605511,2219
7657,3859525941,3471220483,1672640547,1672643697,3150
7819,3756528686,3515125508,1672545467,1672548071,2604
7961,3346795719,3891751546,1672552118,1672555717,3599
7795,3613683164,3384951177,1672531226,1672534316,3090
7536,3792768129,3777079686,1672603576,1672605786,2210
7935,3346327502,3518014636,1672573992,1672575575,1583
7801,3298288268,3511163800,1672552583,1672552919,336
7674,3774045700,3791553060,1672578504,1672580574,2070
7762,3710098970,3534313900,1672584296,1672586247,1951
7741,3793871337,3409474775,1672621187,1672621574,387
7576,3509453566,3510703546,1672673152,1672673522,370
7927,3512217942,3401627165,1672621334,1672621634,300
7733,3533137446,3774520233,1672603377,1672606362,2985
7575,3516980378,3757562897,1672629610,1672631503,1893
7782,3289061738,3701274634,1672629248,1672632708,3460
7694,3505530961,3428674539,1672568509,1672569518,1009
7609,3778780511,3518260334,1672606942,1672609431,2489
7671,3534191820,3715189301,1672547057,1672548736,1679
7886,3772544062,3394539273,1672630345,1672633530,3185
7972,3271938399,3438645253,1672549759,1672552378,2619
7668,3311845971,3513201436,1672598884,1672602076,3192
7859,3360743849,3514987389,1672558657,1672561157,2500
7695,3465202715,3711370563,1672629870,1672632436,2566
7619,3910886626,3834257412,1672641867,1672642053,186
7976,3936227020,3311154569,1672562581,1672563281,700
7714,3901877072,3402943525,1672657803,1672659508,1705
7911,3432689543,3359239884,1672622714,1672625005,2291
7852,3534729133,3882242815,1672629536,1672629648,112
7597,3249791738,3793871337,1672635761,1672637056,1295
7929,3933210486,3512510536,1672699057,1672699993,936
7501,3476232529,3533810360,1672585770,1672586126,356
7591,3666457294,3516065852,1672618285,1672621440,3155
7723,3520709480,3223968713,1672649502,1672650984,1482
7809,3774268456,3390068992,1672619440,1672622175,2735
7711,3517721725,3533810360,1672611109,1672613045,1936
7812,3793962300,3914290246,1672692234,1672693944,1710
7805,3779976989,3316222192,1672584726,1672587150,2424
7951,3701498253,3774520233,1672664866,1672667010,2144
7515,3534729133,3296471982,1672539001,1672540076,1075
7775,3714962248,3733891182,1672565184,1672565725,541
7668,3760489031,3369998498,1672665796,1672669254,3458
7521,3888559320,3285400528,1672557973,1672559789,1816
7550,3516223597,3500578848,1672542934,1672546271,3337
7631,3554917400,3512142794,1672546620,1672549350,2730
7968,3517721725,3518408774,1672551088,1672553500,2412
7846,3760267716,3302626661,1672664910,1672665316,406
7627,3500994774,3859663348,1672623889,1672625868,1979
7738,3755511676,3804870229,1672633652,1672633791,139
7777,3815508790,3534702203,1672657397,1672658851,1454
7946,3701995648,3475251781,1672670527,1672672049,1522
7720,3429856982,3209048907,1672656157,1672657224,1067
7738,3518932404,3235287260,1672590816,1672591539,723
7626,3779036831,3511359172,1672633437,1672635542,2105
7533,3828365570,3511198618,1672565885,1672568661,2776
7666,3505000737,3715339701,1672619082,1672619553,471
7713,3318166135,3714197325,1672540224,1672542108,1884
7534,3512142794,3715981584,1672689496,1672692897,3401
7746,3517864478,3555214688,1672544710,1672546505,1795
7800,3311993075,3936227020,1672636092,1672639256,3164
7831,3520629279,3774125065,1672702592,1672703185,593
7738,3430504438,3534313900,1672619366,1672620227,861
7520,3520888296,3811171116,1672602062,1672603534,1472
7635,3802367797,3716900301,1672701960,1672703999,2039
7501,3920801189,3399535232,1672686449,1672688993,2544
7853,3701995648,3378092448,1672591290,1672593848,2558
7700,3703013906,3520165601,1672687891,1672689374,1483
7843,3666553782,3914290246,1672688824,1672692118,3294
7824,3807987001,3533137446,1672537865,1672538403,538
7833,3822654369,3710112546,1672665193,1672668276,3083
7515,3716197887,3756623396,1672549759,1672553119,3360
7677,3518260334,3774466457,1672531984,1672533260,1276
7941,3430504438,3520206212,1672597509,1672599943,2434
7747,3472130842,3432665384,1672539701,1672542540,2839
7871,3930797455,3505791599,1672684381,1672686431,2050
7722,3791997875,3500391167,1672613902,1672616513,2611
7942,3494290908,3792288302,1672645565,1672646449,884
7852,3715974031,3829232696,1672546394,1672549943,3549
7528,3510594211,3365614305,1672634145,1672635787,1642
7834,3517721725,3510857360,1672698282,1672700946,2664
7899,3223789409,3388637594,1672603168,1672606244,3076
7817,3770021824,3512540951,1672692328,1672695035,2707
7960,3511125626,3777443199,1672572887,1672573359,472
7546,3755511676,3277605882,1672535735,1672536020,285
7746,3466911760,3459030804,1672700842,1672704273,3431
7862,3505203158,3516716179,1672586682,1672588277,1595
7728,3515723720,3716168623,1672698890,1672701370,2480
7918,3855424474,3409474775,1672698307,1672699596,1289
7514,3512217942,3703441914,1672551644,1672553894,2250
7783,3972709319,3501606184,1672673791,1672675359,1568
7885,3312664885,3516673015,1672650865,1672651427,562
7734,3818255890,3510771358,1672543847,1672543928,81
7796,3228165483,3505145247,1672553720,1672555587,1867
7727,3683766533,3511332835,1672614442,1672616351,1909
7894,3512720680,3770447408,1672552364,1672554247,1883
7684,3774125065,3793753089,1672676868,1672678132,1264
7546,3443698222,3359239884,1672578942,1672581671,2729
7746,3774045700,3344364444,1672655881,1672659304,3423
7635,3903962771,3421836608,1672532973,1672535498,2525
7561,3776338577,3559110998,1672610881,1672611758,877
7541,3809916577,3701898991,1672612011,1672614410,2399
7625,3513599775,3509907947,1672616236,1672616302,66
7949,3783083229,3755739653,1672607242,1672609054,1812
7858,3509773875,3559110998,1672579880,1672580743,863
7783,3500229033,3516909237,1672676117,1672677210,1093
7751,3405494240,3446948848,1672552184,1672552566,382
7708,3501730685,3793962300,1672554514,1672557312,2798
7865,3755625324,3624761861,1672537095,1672538209,1114
7896,3331845324,3373384732,1672692519,1672694236,1717
7794,3780294829,3773205565,1672537830,1672541419,3589
7871,3912262917,3772578994,1672543240,1672543422,182
7817,3516514391,3715127362,1672654229,1672654812,583
7558,3666506258,3518669703,1672566948,1672568256,1308
7856,3415546117,3757403279,1672670173,1672672356,2183
7538,3791657947,3779528381,1672687630,1672688361,731
7535,3735733948,3409474775,1672661653,1672664739,3086
7972,3418534998,3714962248,1672576391,1672579251,2860
7976,3628819436,3276640712,1672550899,1672553599,2700
7669,3760183458,3772758337,1672695641,1672695996,355
7688,3755392666,3911159965,1672674422,1672675894,1472
7903,3222521619,3791594391,1672616239,1672619619,3380
7960,3287105466,3336742544,1672692548,1672692664,116
7836,3829232696,3401627165,1672599336,1672600850,1514
7911,3774366875,3713268590,1672699848,1672703222,3374
7507,3777936328,3774119563,1672681838,1672683714,1876
7554,3209027249,3490191091,1672586260,1672588747,2487
7739,3520206212,3377766165,1672602503,1672605297,2794
7911,3617055293,3505649239,1672620569,1672623743,3174
7801,3731419510,3351008918,1672550902,1672551362,460
7871,3792883665,3518014636,1672636261,1672638071,1810
7952,3501184421,3370636709,1672534566,1672536164,1598
7848,3793848402,3835382117,1672552726,1672553271,545
7632,3500458761,3500391167,1672635568,1672636840,1272
7628,3937224533,3478194807,1672638764,1672642139,3375
7784,3303705369,3433804879,1672695665,1672697313,1648
7894,3501184421,3480687894,1672540313,1672542323,2010
7954,3552314511,3370752401,1672552185,1672552644,459
7739,3311439795,3911159965,1672588058,1672589830,1772
7751,3515151980,3773814927,1672553199,1672556661,3462
7707,3284639858,3533748232,1672581767,1672583536,1769
7930,3510380060,3313564074,1672537835,1672538210,375
7544,3975287541,3517509185,1672625865,1672628119,2254
7615,3805519285,3509907947,1672669394,1672670774,1380
7724,3510937904,3510703546,1672679270,1672680625,1355
7575,3514838220,3857349323,1672689568,1672691550,1982
7550,3511267139,3388286531,1672670407,1672671735,1328
7641,3714197325,3358871377,1672547178,1672549650,2472
7952,3501198706,3827222533,1672624874,1672624963,89
7546,3223968713,3881477378,1672668552,1672671297,2745
7819,3918584946,3911245524,1672537173,1672540360,3187
7788,3970117174,3513201436,1672588979,1672592120,3141
7922,3417587765,3379589402,1672659262,1672661361,2099
7703,3517963492,3791553060,1672591378,1672592403,1025
7939,3909331423,3312664885,1672702072,1672703827,1755
7678,3972364603,3703789494,1672625661,1672628316,2655
7669,3481502100,3339907603,1672542327,1672544217,1890
7602,3404058699,3200691026,1672584320,1672586728,2408
7655,3882291183,3505904952,1672682374,1672685308,2934
7885,3757562897,3505347134,1672664292,1672666421,2129
7865,3976633198,3917088658,1672585553,1672588425,2872
7735,3227457126,3397418363,1672545713,1672547117,1404
7805,3776338577,3780914982,1672622605,1672622965,360
7628,3511271692,3780365428,1672569675,1672570942,1267
7522,3827222533,3701146057,1672593406,1672594376,970
7740,3756453423,3639847263,1672666616,1672668409,1793
7801,3533371364,3615046771,1672569452,1672572091,2639
7642,3201848640,3520931254,1672636204,1672639362,3158
7847,3514245078,3505873261,1672589796,1672590506,710
7656,3514472925,3827377568,1672666088,1672668837,2749
7505,3916289176,3792844210,1672627418,1672628897,1479
7847,3344019610,3777790718,1672617928,1672621361,3433
7561,3372883226,3500805881,1672592772,1672594543,1771
7536,3475795792,3534488837,1672646973,1672649952,2979
7938,3400918687,3793286136,1672606175,1672608391,2216
7883,3244173074,3404384505,1672681987,1672685060,3073
7674,3773664987,3505869747,1672602267,1672602498,231
7841,3510247121,3756021689,1672677413,1672679966,2553
7759,3360743849,3510126867,1672560092,1672561833,1741
7852,3756623396,3774338212,1672532359,1672534184,1825
7607,3755587522,3978115672,1672588193,1672590535,2342
7737,3778266283,3516065852,1672542133,1672545372,3239
7621,3883042241,3405494240,1672607258,1672608567,1309
7583,3520030713,3736592744,1672544698,1672546503,1805
7497,3517864478,3516980378,1672634294,1672635925,1631
7580,3513201436,3760598102,1672586305,1672587442,1137
7896,3501483568,3716197887,1672579245,1672579928,683
7654,3520012395,3822654369,1672681512,1672682813,1301
7773,3757403279,3793286136,1672592398,1672594579,2181
7634,3773205565,3518360734,1672682289,1672683588,1299
7804,3500578848,3278365525,1672549747,1672551579,1832
7661,3351008918,3772758337,1672613103,1672613223,120
7757,3701178711,3513201436,1672686844,1672687630,786
7739,3780294829,3939952128,1672676257,1672679315,3058
7637,3823600322,3772714862,1672643921,1672645562,1641
7681,3358871377,3716488385,1672614751,1672617752,3001
7747,3516016437,3792768129,1672698972,1672700424,1452
7520,3716168623,3809059934,1672665076,1672668480,3404
7540,3505530961,3793286136,1672650892,1672653259,2367
7769,3338367113,3791997875,1672583596,1672585942,2346
7608,3509773875,3903307060,1672688854,1672689046,192
7809,3512510536,3730517636,1672635187,1672635468,281
7656,3701065786,3475795792,1672551046,1672553939,2893
7654,3817621391,3478194807,1672591025,1672594508,3483
7759,3221899927,3514128943,1672669039,1672669512,473
7768,3359239884,3780788622,1672600314,1672601144,830
7683,3755042098,3770824086,1672668521,1672671608,3087
7926,3972709319,3857349323,1672693685,1672695644,1959
7957,3285400528,3715189301,1672660832,1672661951,1119
7930,3739106581,3248507722,1672638419,1672639352,933
7840,3779528381,3428006164,1672636188,1672636838,650
7639,3516673015,3703223015,1672590063,1672593476,3413
7797,3776948966,3496269445,1672540624,1672543911,3287
7539,3815508790,3234541252,1672688718,1672691318,2600
7564,3852391257,3839849341,1672642160,1672644962,2802
7497,3520931254,3736229191,1672661279,1672661613,334
7751,3365614305,3554917400,1672560791,1672564116,3325
7783,3780593036,3311324983,1672614428,1672614980,552
7662,3935127663,3534191820,1672579636,1672582263,2627
7812,3792844210,3399911573,1672574409,1672575501,1092
7900,3637008488,3773755137,1672564666,1672565988,1322
7676,3510771358,3501364586,1672645580,1672647774,2194
7483,3249791738,3738274418,1672646716,1672650292,3576
7769,3533369198,3555214688,1672568062,1672569265,1203
7806,3901990690,3711504540,1672690881,1672692714,1833
7490,3780609808,3389115045,1672657768,1672659792,2024
7515,3430504438,3930791338,1672694045,1672696312,2267
7726,3510380060,3666506258,1672649964,1672650434,470
7895,3755587522,3497901842,1672598240,1672599656,1416
7879,3520709480,3770553384,1672642923,1672644000,1077
7614,3514472925,3500994774,1672599664,1672601602,1938
7661,3359239884,3559110998,1672667674,1672668406,732
7908,3660493209,3517459919,1672589658,1672592154,2496
7978,3492478793,3756027749,1672587604,1672590488,2884
7728,3505135325,3791602225,1672584943,1672588127,3184
7563,3510771358,3793627961,1672534324,1672537014,2690
7692,3505173328,3733189298,1672548294,1672549767,1473
7936,3835382117,3509634629,1672639884,1672643208,3324
7703,3732481297,3792668962,1672602498,1672605792,3294
7971,3701498253,3401627165,1672598810,1672599110,300
7738,3517255726,3244173074,1672620393,1672623869,3476
7743,3505477652,3809916577,1672603660,1672606391,2731
7499,3509933351,3911245524,1672637931,1672638344,413
7905,3313541986,3533280269,1672570596,1672573874,3278
7712,3501601840,3517459919,1672582723,1672585077,2354
7558,3805519285,3501759100,1672567212,1672570256,3044
7951,3513080274,3918247820,1672644396,1672645324,928
7859,3518876135,3392121505,1672547079,1672550348,3269
7767,3533280269,3278365525,1672627515,1672630138,2623
7744,3477649378,3478194807,1672649122,1672652361,3239
7505,3825229501,3510380060,1672649947,1672650163,216
7541,3779218771,3404384505,1672649294,1672650584,1290
7524,3427219654,3760509236,1672607342,1672610264,2922
7758,3933210486,3776948966,1672545012,1672547998,2986
7897,3505201246,3365278081,1672546434,1672548721,2287
7611,3924549929,3514987389,1672608878,1672609121,243
7713,3714504419,3809059934,1672569119,1672570197,1078
7956,3337544549,3855602893,1672700832,1672701269,437
7571,3777929708,3825229501,1672667742,1672668229,487
7925,3606987130,3901990690,1672546937,1672550292,3355
7630,3791594391,3510380060,1672684802,1672686600,1798
7557,3770824086,3805342762,1672678918,1672681889,2971
7589,3978105277,3513956646,1672551308,1672551371,63
7509,3520706195,3520629279,1672582574,1672585701,3127
7553,3601879040,3206603608,1672640239,1672641023,784
7947,3316173088,3365942576,1672546462,1672546838,376
7568,3247780536,3783245561,1672640299,1672643640,3341
7487,3311208440,3774520233,1672568001,1672571595,3594
7609,3360993964,3421127249,1672565813,1672568254,2441
7538,3311208440,3426325549,1672582650,1672583351,701
7887,3550946908,3311993075,1672581797,1672582247,450
7773,3519803045,3519654779,1672661528,1672663530,2002
7909,3303705369,3513599775,1672570052,1672570532,480
7688,3500060260,3224058172,1672655180,1672657185,2005
7872,3399004969,3505145247,1672670873,1672673671,2798
7613,3311090974,3509773875,1672697286,1672699584,2298
7927,3412980697,3778980116,1672644382,1672645973,1591
7874,3710067113,3517459919,1672664346,1672665301,955
7627,3783239924,3505912939,1672618383,1672619745,1362
7503,3735733948,3514987389,1672575638,1672576280,642
7698,3779629905,3399911573,1672626744,1672629437,2693
7494,3296471982,3716843669,1672585844,1672588206,2362
7596,3774339795,3515860749,1672649940,1672652038,2098
7561,3714504419,3426325549,1672543944,1672545516,1572
7909,3979339287,3465254146,1672553340,1672554401,1061
7914,3511198618,3917088658,1672551024,1672553627,2603
7516,3755943611,3505904952,1672622971,1672624696,1725
7610,3229665776,3711504540,1672682607,1672683356,749
7523,3383922351,3920801189,1672619990,1672622183,2193
7556,3791553060,3520012395,1672687523,1672688398,875
7522,3777790718,3533653428,1672686924,1672689076,2152
7644,3770824086,3756966035,1672549427,1672551721,2294
7536,3774119563,3482405588,1672634643,1672634873,230
7507,3518014636,3777929708,1672660019,1672661421,1402
7912,3756027749,3424922204,1672686145,1672686708,563
7910,3374559242,3485823740,1672698352,1672700055,1703
7652,3554917400,3885670556,1672542906,1672543281,375
7797,3516980378,3394539273,1672627393,1672628073,680
7923,3817316561,3701967560,1672696957,1672697375,418
7737,3248507722,3311603601,1672597267,1672597951,684
7777,3882997884,3559110998,1672703950,1672705524,1574
7563,3501692334,3511350608,1672582840,1672584913,2073
7562,3487171044,3533626375,1672683598,1672686789,3191
7808,3713370078,3314245084,1672668274,1672670567,2293
7672,3443698222,3304056063,1672638766,1672638828,62
7673,3774119563,3711380716,1672669542,1672669659,117
7701,3791997875,3430074045,1672571690,1672573090,1400
7632,3288764520,3757447189,1672676302,1672677682,1380
7656,3520206212,3517476351,1672565704,1672568585,2881
7779,3509352754,3484995752,1672554633,1672556792,2159
7958,3772758337,3312829208,1672684003,1672685348,1345
7552,3311845971,3716746253,1672660379,1672661694,1315
7926,3890149705,3714488548,1672684140,1672687432,3292
7624,3755511676,3978105277,1672543722,1672545636,1914
7585,3505873261,3714504419,1672646152,1672648112,1960
7852,3533095755,3280964728,1672599091,1672601973,2882
7735,3514283243,3793286136,1672668781,1672672113,3332
7805,3779740455,3858918246,1672696207,1672698078,1871
7959,3516716179,3514283243,1672542144,1672544952,2808
7551,3816454165,3800886801,1672702146,1672705192,3046
7869,3511271692,3338703270,1672636668,1672636912,244
7618,3516980378,3519700826,1672642577,1672645107,2530
7615,3910454786,3304056063,1672637547,1672639855,2308
7622,3823600322,3533748232,1672594891,1672596831,1940
7832,3428674539,3428674539,1672671758,1672673135,1377
7672,3206593906,3914259449,1672642703,1672645346,2643
7633,3734496778,3910886626,1672545313,1672547487,2174
7523,3473765852,3516980378,1672594354,1672596330,1976
7517,3737079798,3505145247,1672533074,1672534437,1363
7547,3511350608,3811171116,1672533101,1672536577,3476
7761,3314245084,3512540951,1672546462,1672549569,3107
7930,3625274012,3429690204,1672630856,1672632632,1776
7585,3318166135,3510857360,1672663646,1672663748,102
7578,3505477652,3617055293,1672664699,1672667591,2892
7915,3356860407,3904408902,1672652133,1672655491,3358
7544,3395152943,3859663348,1672583216,1672585133,1917
7843,3201324715,3510771358,1672553586,1672554723,1137
7581,3713786889,3533369198,1672654440,1672655579,1139
7582,3634340855,3777929708,1672683646,1672685955,2309
7653,3380035798,3716165213,1672701248,1672704208,2960
7546,3344364444,3922275620,1672646615,1672649731,3116
7667,3903009525,3314245084,1672684569,1672684920,351
7628,3280615985,3777443199,1672664152,1672666991,2839
7664,3755798867,3418728074,1672570597,1672570753,156
7754,3773598056,3229058858,1672594713,1672597452,2739
7530,3501927421,3820354437,1672617839,1672620589,2750
7536,3780974443,3505912939,1672609778,1672612602,2824
7585,3483949762,3760267716,1672531847,1672531965,118
7810,3734828619,3716900301,1672645982,1672646816,834
7749,3512349371,3800353779,1672585240,1672587305,2065
7678,3882242815,3501759100,1672597149,1672598417,1268
7756,3898995675,3383922351,1672640532,1672641482,950
7626,3760569731,3534488837,1672603632,1672606867,3235
7926,3293695955,3792177074,1672683788,1672685625,1837
7919,3514838220,3505791599,1672626799,1672630263,3464
7732,3792384220,3227457126,1672692538,1672693703,1165
7702,3817316561,3421127249,1672657254,1672660326,3072
7807,3713969578,3617734118,1672544053,1672546206,2153
7518,3383661227,3608868877,1672676428,1672676618,190
7809,3280599164,3885670556,1672628744,1672631987,3243
7783,3736790081,3501198706,1672672331,1672674530,2199
7836,3918674986,3518496488,1672605310,1672608237,2927
7572,3832902928,3855424474,1672589797,1672590526,729
7744,3356860407,3701534009,1672641874,1672642562,688
7976,3351554343,3505477652,1672649179,1672651074,1895
7737,3555214688,3248507722,1672555197,1672555314,117
7941,3307512479,3501759100,1672586649,1672586907,258
7489,3780828689,3621497531,1672542090,1672542919,829
7968,3805347939,3510173870,1672589543,1672590000,457
7704,3518408774,3405494240,1672566677,1672569881,3204
7496,3711504540,3755739653,1672590770,1672591139,369
7893,3935127663,3357483218,1672559154,1672561084,1930
7754,3428674539,3515723720,1672620332,1672620748,416
7884,3505912939,3918584946,1672670854,1672673834,2980
7916,3400918687,3757682496,1672638347,1672640849,2502
7830,3617055293,3600647945,1672585049,1672588530,3481
7895,3500060260,3713969578,1672638543,1672639086,543
7969,3713808837,3710112546,1672532645,1672534840,2195
7798,3394539273,3415443558,1672666111,1672668947,2836
7632,3501927421,3517476351,1672630662,1672632481,1819
7795,3336742544,3509604974,1672617588,1672619619,2031
7695,3801089989,3373384732,1672618785,1672622002,3217
7518,3505883609,3311415018,1672547786,1672550641,2855
7858,3505599848,3889750851,1672592334,1672593479,1145
7793,3303751772,3738274418,1672683213,1672683953,740
7855,3911159965,3364543015,1672644403,1672647420,3017
7528,3774204963,3776513891,1672694709,1672695804,1095
7794,3978105277,3429856982,1672690712,1672692068,1356
7571,3356860407,3634340855,1672558060,1672560806,2746
7780,3201324715,3756601594,1672552566,1672553932,1366
7497,3505599848,3757447189,1672566527,1672568998,2471
7849,3936227020,3662180254,1672694364,1672697872,3508
7606,3711569060,3773978034,1672672044,1672673428,1384
7879,3516673015,3913251733,1672604839,1672608029,3190
7485,3505904952,3519703355,1672651836,1672652231,395
7622,3297463265,3773598056,1672536820,1672539689,2869
7520,3666553782,3511271692,1672639704,1672642900,3196
7606,3828432634,3336751428,1672579390,1672581294,1904
7706,3780813786,3430074045,1672676209,1672679090,2881
7982,3855602893,3511841857,1672599204,1672599531,327
7688,3711262377,3516016437,1672658031,1672660159,2128
7643,3774010081,3510771358,1672642817,1672644764,1947
7801,3417970574,3716165213,1672675163,1672676644,1481
7542,3816454165,3688683847,1672588872,1672591015,2143
7934,3500177712,3500729955,1672579699,1672581460,1761
7536,3737051610,3511312803,1672581919,1672583406,1487
7976,3756528686,3774050956,1672537467,1672539431,1964
7768,3770078063,3311603601,1672603093,1672604188,1095
7711,3760183458,3713786889,1672616031,1672616537,506
7750,3346327502,3688418210,1672609661,1672612655,2994
7584,3346327502,3792384220,1672652439,1672653376,937
7977,3688418210,3715974031,1672697964,1672698324,360
7566,3774119563,3533827120,1672635717,1672636700,983
7492,3311415018,3792177074,1672690306,1672692793,2487
7828,3627937312,3415546117,1672674569,1672677391,2822
7833,3613995936,3780593036,1672651484,1672654853,3369
7488,3922275620,3487171044,1672635549,1672636384,835
7588,3396086535,3664517356,1672541713,1672544393,2680
7944,3731106822,3209383861,1672672417,1672673964,1547
7932,3514245078,3904775198,1672625200,1672627978,2778
7774,3813052709,3201432789,1672583504,1672586219,2715
7788,3247428249,3826760240,1672647927,1672649446,1519
7791,3378092448,3633420270,1672583401,1672586025,2624
7556,3505912939,3534191820,1672652520,1672656073,3553
7639,3891751546,3828624701,1672661166,1672664749,3583
7514,3776800213,3227158514,1672630356,1672631523,1167
7831,3756453423,3500391167,1672639061,1672639328,267
7889,3710098970,3711265369,1672546102,1672548399,2297
7944,3624312512,3666507626,1672600634,1672600697,63
7800,3792032359,3713644518,1672583261,1672585275,2014
7870,3511198618,3809916577,1672638562,1672638954,392
7830,3756021689,3396086535,1672590541,1672592178,1637
7919,3534492426,3885897503,1672627085,1672629736,2651
7916,3701184889,3534488837,1672570146,1672570429,283
7778,3918247820,3756453423,1672664979,1672668134,3155
7583,3509933351,3777120536,1672636938,1672639762,2824
7491,3379256399,3505904952,1672591252,1672593499,2247
7567,3772884106,3773755137,1672594257,1672596130,1873
7826,3714474557,3416241005,1672670094,1672672470,2376
7512,3627937312,3247780536,1672656668,1672658836,2168
7665,3610348516,3817621391,1672600690,1672601663,973
7980,3489217083,3885897503,1672642637,1672643009,372
7879,3505859863,3826415738,1672605101,1672605678,577
7662,3534729133,3777929708,1672698987,1672699271,284
7771,3736625083,3668898102,1672676434,1672679587,3153
7755,3793848402,3484995752,1672683983,1672685791,1808
7490,3390068992,3772359096,1672633981,1672634663,682
7516,3501486692,3755511676,1672559481,1672561727,2246
7982,3936227020,3206603608,1672539397,1672541030,1633
7917,3488244966,3418728074,1672614338,1672615758,1420
7518,3930797455,3859525941,1672557325,1672560073,2748
7589,3314836094,3774793839,1672684289,1672687862,3573
7667,3236102733,3634995491,1672585335,1672587822,2487
7492,3756424865,3291235378,1672585757,1672586213,456
7933,3428674539,3511350608,1672655109,1672655602,493
7739,3716273414,3311154569,1672596761,1672598758,1997
7616,3433804879,3889750851,1672700322,1672702823,2501
7756,3520751702,3505702787,1672668415,1672670175,1760
7721,3367029997,3757602960,1672678046,1672681149,3103
7752,3391915121,3772053179,1672577364,1672580689,3325
7779,3792177074,3394539273,1672605523,1672608612,3089
7890,3311415018,3518932404,1672683657,1672685477,1820
7543,3607748895,3886298125,1672556954,1672559510,2556
7516,3777455223,3517255726,1672540439,1672541756,1317
7839,3701178711,3552314511,1672632637,1672634122,1485
7867,3757447189,3932051427,1672538216,1672541041,2825
7692,3372883226,3713208927,1672606006,1672608856,2850
7883,3774501422,3516980378,1672586328,1672587769,1441
7588,3231056870,3770101921,1672635483,1672638307,2824
7868,3420432297,3384951177,1672683056,1672684102,1046
7956,3289061738,3616944364,1672661987,1672664986,2999
7849,3505203158,3755511676,1672561951,1672562653,702
7551,3518876135,3490191091,1672572530,1672573916,1386
7673,3739106581,3291227780,1672633449,1672635703,2254
7759,3922275416,3701178711,1672570589,1672573439,2850
7729,3379589402,3792668962,1672604708,1672605403,695
7574,3402943525,3500374658,1672550777,1672551683,906
7677,3776800213,3385763781,1672577353,1672577988,635
7644,3710408395,3889750851,1672553127,1672553564,437
7794,3206254161,3318166135,1672683742,1672683978,236
7702,3475795792,3387674757,1672652086,1672654829,2743
7520,3313564074,3881477378,1672533111,1672534432,1321
7595,3914290246,3688418210,1672535483,1672536403,920
7781,3432665384,3899204805,1672592977,1672596546,3569
7905,3404384505,3839849341,1672548585,1672550979,2394
7822,3248507722,3882997884,1672568466,1672569742,1276
7638,3783206719,3386707783,1672666213,1672669747,3534
7684,3511312803,3516960534,1672588908,1672590533,1625
7800,3312829208,3615046771,1672660616,1672660702,86
7585,3360506772,3496269445,1672696411,1672698474,2063
7840,3201324715,3783206719,1672619383,1672621834,2451
7869,3772309150,3891751546,1672578647,1672579188,541
7578,3760893269,3793627961,1672687569,1672688812,1243
7616,3714962248,3500365158,1672616902,1672619985,3083
7948,3411618230,3516223597,1672623595,1672625115,1520
7536,3827377568,3885897503,1672657014,1672660509,3495
7691,3383661227,3774298222,1672589240,1672589447,207
7801,3505193212,3911159965,1672564601,1672567549,2948
7913,3429856982,3311439795,1672679913,1672680513,600
7959,3497901842,3780639480,1672548540,1672550602,2062
7958,3319752091,3550946908,1672541206,1672542193,987
7784,3666553782,3533193862,1672638920,1672642329,3409
7587,3277605882,3701065786,1672548467,1672550073,1606
7873,3885897503,3512683609,1672656017,1672659098,3081
7670,3852595551,3518163778,1672563715,1672565823,2108
7733,3221536550,3777120536,1672689002,1672692081,3079
7580,3734737881,3515125508,1672623080,1672624418,1338
7571,3516016437,3409474775,1672611075,1672613045,1970
7943,3774119563,3500066230,1672640689,1672643217,2528
7656,3505098372,3459030804,1672545342,1672547800,2458
7760,3855000166,3338703270,1672653862,1672655793,1931
7769,3339907603,3701498253,1672688959,1672691023,2064
7835,3519700826,3711262377,1672541619,1672543757,2138
7929,3614238812,3232962003,1672605630,1672606276,646
7958,3519654779,3421836608,1672631799,1672635352,3553
7940,3783083229,3428964059,1672561392,1672564709,3317
7791,3520756859,3904775198,1672696490,1672699810,3320
7973,3979339287,3236102733,1672604542,1672606762,2220
7499,3621497531,3777776687,1672696937,1672698069,1132
7839,3232962003,3396086535,1672637356,1672637955,599
7736,3755881905,3711198793,1672621853,1672622824,971
7647,3483164654,3793959750,1672625835,1672627223,1388
7527,3201432789,3231056870,1672583433,1672586907,3474
7876,3519428855,3208844525,1672550204,1672551008,804
7567,3774580701,3396285984,1672583869,1672587388,3519
7929,3783925755,3483949762,1672617766,1672618087,321
7593,3331845324,3760569731,1672547440,1672548665,1225
7826,3780788622,3385763781,1672597006,1672600599,3593
7873,3913251733,3246596716,1672595460,1672597314,1854
7599,3514987389,3520376528,1672628760,1672629732,972
7835,3534729133,3377766165,1672580187,1672582926,2739
7954,3249791738,3533280269,1672645269,1672646179,910
7827,3361230905,3882997884,1672611253,1672614845,3592
7691,3513956646,3701178711,1672549426,1672549815,389
7633,3774127586,3511841857,1672555964,1672556295,331
7540,3249401741,3377766165,1672624736,1672628309,3573
7816,3516258476,3818255890,1672683846,1672685260,1414
7629,3710067113,3516960534,1672618750,1672620977,2227
7948,3391915121,3520931254,1672559781,1672561896,2115
7944,3312829208,3610695419,1672589098,1672591975,2877
7960,3703735129,3511170269,1672632458,1672634598,2140
7809,3777790718,3360993964,1672584550,1672586918,2368
7677,3701691675,3424922204,1672634710,1672638088,3378
7508,3755511676,3361230905,1672583555,1672585302,1747
7592,3731419510,3489545239,1672645031,1672646315,1284
7833,3792668962,3615046771,1672577926,1672578498,572
7716,3500365158,3487171044,1672630110,1672632544,2434
7621,3201324715,3533193862,1672557558,1672557633,75
7802,3418534998,3783239924,1672601541,1672605058,3517
7521,3416241005,3772053179,1672623468,1672625150,1682
7598,3483164654,3416427576,1672588060,1672589478,1418
7490,3515691540,3515151980,1672666239,1672667663,1424
7517,3701898991,3711504540,1672577642,1672579225,1583
7671,3855602893,3716197887,1672679945,1672680508,563
7536,3916289176,3392121505,1672684916,1672688221,3305
7645,3509672210,3615046771,1672591043,1672594113,3070
7635,3511267139,3918056059,1672633856,1672634946,1090
7678,3501198706,3791657947,1672687002,1672687246,244
7757,3703889596,3534492426,1672549963,1672551012,1049
7542,3777717988,3772758337,1672590930,1672592068,1138
7850,3511163800,3755511676,1672624264,1672624385,121
7937,3828432634,3899371911,1672684481,1672685209,728
7590,3284832486,3374559242,1672610500,1672611484,984
7771,3606987130,3510173870,1672559637,1672562880,3243
7791,3778780511,3312829208,1672533905,1672536047,2142
7564,3714821932,3793962300,1672693133,1672696602,3469
7888,3505962865,3711262377,1672624380,1672626113,1733
7803,3783531004,3910454786,1672604385,1672606142,1757
7896,3770078063,3513201436,1672552674,1672555563,2889
7852,3407673904,3360506772,1672624545,1672624843,298
7525,3791553060,3610348516,1672663342,1672666724,3382
7534,3509907947,3520206212,1672632800,1672635181,2381
7922,3424922204,3791957752,1672559806,1672561717,1911
7769,3776948966,3289061738,1672535155,1672538678,3523
7613,3776338577,3505173328,1672565654,1672568058,2404
7537,3505962865,3836573197,1672610825,1672613708,2883
7647,3883861463,3285400528,1672659512,1672661350,1838
7739,3412825109,3407725581,1672686446,1672686587,141
7554,3316173088,3710098970,1672588631,1672590522,1891
7602,3556951786,3384951177,1672697906,1672698963,1057
7626,3485375593,3417970574,1672693951,1672694428,477
7817,3857349323,3666506258,1672678075,1672679056,981
7675,3417587765,3791657947,1672587591,1672587954,363
7945,3520030713,3773598056,1672569986,1672573028,3042
7652,3367029997,3420700674,1672605862,1672608519,2657
7745,3453729665,3407673904,1672548261,1672549146,885
7535,3396086535,3920801189,1672568276,1672571309,3033
7951,3888559320,3936227020,1672616002,1672617809,1807
7805,3618045231,3731106822,1672583513,1672586396,2883
7786,3378436155,3514987389,1672655045,1672658516,3471
7714,3509604974,3783925755,1672536839,1672539175,2336
7642,3716165213,3280615985,1672591303,1672594152,2849
7972,3475258557,3380035798,1672585592,1672589121,3529
7919,3760492950,3774045700,1672649517,1672651719,2202
7788,3918674986,3737154119,1672614424,1672614684,260
7916,3477649378,3922337974,1672556950,1672558189,1239
7604,3801089989,3791553060,1672641450,1672642550,1100
7780,3509933351,3888559320,1672552678,1672553869,1191
7750,3826759140,3757161914,1672636537,1672637751,1214
7539,3757447189,3852595551,1672669062,1672670616,1554
7821,3279721246,3336742544,1672591649,1672594158,2509
7554,3302626661,3307512479,1672682714,1672685676,2962
7850,3277939457,3716165213,1672551892,1672552368,476
7865,3501692334,3666457294,1672635715,1672636602,887
7813,3489962019,3395152943,1672629911,1672630488,577
7974,3757455053,3377766165,1672603540,1672604999,1459
7777,3756027749,3291235378,1672561462,1672561816,354
7865,3701967560,3858918246,1672646887,1672649371,2484
7878,3826760240,3412825109,1672635480,1672637945,2465
7766,3407954858,3304056063,1672540587,1672541441,854
7575,3234541252,3880285638,1672586816,1672590043,3227
7615,3617055293,3392121505,1672554221,1672555044,823
7643,3774010081,3379589402,1672550186,1672552384,2198
7768,3779740455,3760183458,1672622575,1672625427,2852
7782,3438645253,3976390453,1672687354,1672689222,1868
7873,3883551721,3855424474,1672651451,1672652351,900
7657,3791553060,3520931254,1672677615,1672678423,808
7889,3448855696,3935627557,1672600606,1672602586,1980
7632,3360993964,3510126867,1672537349,1672539087,1738
7659,3386707783,3777790718,1672543798,1672546619,2821
7971,3500578848,3533385867,1672588663,1672590980,2317
7628,3511687358,3918247820,1672562417,1672562824,407
7697,3736419952,3667680268,1672634303,1672635462,1159
7770,3779528381,3303751772,1672553961,1672555082,1121
7782,3713644518,3342131135,1672669116,1672671436,2320
7529,3715998609,3459030804,1672563878,1672566210,2332
7885,3505098372,3756966035,1672633045,1672633815,770
7933,3617734118,3917088658,1672679902,1672682498,2596
7501,3509453566,3624312512,1672661795,1672663295,1500
7580,3772746272,3510703546,1672553560,1672556059,2499
7618,3820354437,3792288302,1672616810,1672620263,3453
7776,3660493209,3383661227,1672539135,1672542305,3170
7689,3552314511,3304625412,1672635512,1672638169,2657
7525,3273500349,3634340855,1672625113,1672628063,2950
7614,3793959750,3489962019,1672571150,1672574462,3312
7720,3417970574,3336751428,1672638171,1672639571,1400
7861,3311324983,3500805881,1672674055,1672677046,2991
7545,3477375368,3626156564,1672583531,1672585960,2429
7607,3792789881,3710344260,1672682185,1672685620,3435
7712,3791901535,3889750851,1672531381,1672531521,140
7717,3505873261,3396285984,1672665214,1672666387,1173
7805,3899204805,3622054816,1672573105,1672573414,309
7760,3394539273,3792902982,1672645435,1672646173,738
7974,3783206719,3755392666,1672572502,1672575505,3003
7737,3755798867,3500199935,1672570727,1672572852,2125
7511,3772053179,3512217942,1672600279,1672600517,238
7825,3421127249,3780828689,1672696272,1672696778,506
7913,3774195321,3822654369,1672617117,1672617635,518
7501,3780828689,3520165601,1672535509,1672537536,2027
7888,3716835696,3229058858,1672665243,1672668225,2982
7723,3291235378,3773429448,1672625769,1672626922,1153
7825,3351008918,3505904952,1672657755,1672660808,3053
7627,3509773875,3772746272,1672703437,1672705092,1655
7863,3703441914,3899266183,1672624942,1672626878,1936
7838,3438645253,3711380716,1672635390,1672637258,1868
7932,3773465237,3559110998,1672639878,1672641762,1884
7923,3512683609,3287105466,1672560677,1672564012,3335
7543,3736790081,3510969660,1672623212,1672624023,811
7843,3683766533,3811171116,1672584686,1672585080,394
7585,3714474557,3518360734,1672625446,1672628984,3538
7850,3755625324,3973560347,1672629188,1672631274,2086
7681,3209027249,3554917400,1672589105,1672590799,1694
7526,3533137446,3533369198,1672597412,1672600504,3092
7963,3516909237,3735733948,1672588365,1672591327,2962
7714,3383661227,3772642849,1672690500,1672693878,3378
7501,3505000737,3311603601,1672561360,1672563204,1844
7543,3755436115,3682061100,1672555899,1672556514,615
7490,3209383861,3714821932,1672553941,1672555402,1461
7662,3311208440,3222521619,1672697621,1672700688,3067
7738,3349613093,3428674539,1672604529,1672607006,2477
7837,3365830990,3475396323,1672695482,1672697757,2275
7710,3301107849,3533653428,1672547247,1672548947,1700
7794,3201432789,3820354437,1672549692,1672552953,3261
7953,3805292782,3279721246,1672538663,1672540015,1352
7931,3516629436,3533242305,1672631503,1672634668,3165
7568,3244173074,3756027749,1672669363,1672671921,2558
7732,3755042098,3430352815,1672561383,1672562179,796
7750,3512567240,3500487333,1672656522,1672658453,1931
7552,3703718151,3209551760,1672558399,1672558653,254
7785,3505638204,3206254161,1672685194,1672685617,423
7952,3500904641,3280964728,1672612544,1672614085,1541
7520,3433804879,3291883916,1672650269,1672653142,2873
7567,3501198706,3738274418,1672552441,1672555977,3536
7667,3774066725,3772544062,1672551871,1672552303,432
7719,3903307060,3511332835,1672568914,1672570371,1457
7788,3737051610,3776800213,1672576990,1672578343,1353
7832,3380035798,3367902229,1672541641,1672541912,271
7664,3510594211,3505135325,1672670156,1672671192,1036
7864,3509453566,3395152943,1672585786,1672589068,3282
7725,3500805881,3516016437,1672645418,1672645609,191
7834,3792789881,3731419510,1672660367,1672661294,927
7577,3703871468,3666507626,1672674071,1672677080,3009
7587,3914259449,3783705817,1672586202,1672586807,605
7791,3336742544,3730517636,1672701467,1672703245,1778
7701,3921211276,3505912939,1672545865,1672547162,1297
7888,3244485293,3793389510,1672652113,1672652692,579
7940,3711569060,3772578994,1672559866,1672561069,1203
7624,3518791447,3511841857,1672642410,1672645131,2721
7916,3501606184,3613683164,1672543332,1672543753,421
7506,3559110998,3756424865,1672590124,1672591409,1285
7782,3779976989,3511332835,1672568048,1672569747,1699
7501,3505362057,3778308417,1672660583,1672663881,3298
7782,3512567240,3478194807,1672699908,1672702342,2434
7843,3770763956,3533827120,1672561196,1672561675,479
7926,3666457294,3903307060,1672652158,1672654011,1853
7898,3505530961,3715492942,1672597012,1672598818,1806
7787,3516258476,3500060260,1672565532,1672567440,1908
7609,3774050956,3778305740,1672577155,1672577751,596
7784,3439023335,3500229033,1672693840,1672694400,560
7628,3512510536,3800353779,1672545729,1672549117,3388
7527,3483164654,3608633356,1672569601,1672570473,872
7666,3244389794,3432689543,1672616223,1672618803,2580
7636,3396086535,3780593036,1672574645,1672574925,280
7813,3855937514,3624312512,1672646952,1672649168,2216
7956,3505912939,3890149705,1672677695,1672680710,3015
7734,3311274543,3533810360,1672561069,1672564505,3436
7782,3737079798,3510857360,1672694737,1672696109,1372
7959,3500458761,3500199935,1672623412,1672626659,3247
7673,3737051610,3936227020,1672546328,1672546455,127
7691,3209383861,3685818092,1672696382,1672698524,2142
7740,3774268456,3618873142,1672616930,1672619499,2569
7860,3404384505,3734496778,1672695951,1672698262,2311
7683,3510173870,3715189301,1672534028,1672535640,1612
7586,3206254161,3755920131,1672662944,1672666236,3292
7803,3757246925,3510969660,1672535241,1672535394,153
7835,3820354437,3791115967,1672682853,1672683796,943
7601,3808324264,3501606184,1672569804,1672571025,1221
7490,3610695419,3779036831,1672585479,1672586944,1465
7828,3249791738,3617734118,1672659850,1672662557,2707
7553,3930797455,3227457126,1672630183,1672633643,3460
7689,3516629436,3760561634,1672622423,1672623997,1574
7950,3378686918,3517459919,1672605248,1672605532,284
7526,3793848402,3701498253,1672592953,1672593037,84
7613,3774066725,3362000049,1672681014,1672682389,1375
7802,3779036831,3931941795,1672548760,1672552344,3584
7780,3438645253,3555214688,1672623192,1672624668,1476
7661,3554917400,3236102733,1672590279,1672592144,1865
7752,3467773920,3201324715,1672596097,1672596424,327
7650,3344019610,3773465237,1672699547,1672700686,1139
7884,3362000049,3516629436,1672615120,1672617496,2376
7896,3500066230,3777623166,1672670490,1672673645,3155
7734,3209551760,3208844525,1672599971,1672602282,2311
7483,3921211276,3406784491,1672588597,1672590575,1978
7887,3416427576,3473562469,1672683407,1672686071,2664
7753,3773465237,3621497531,1672584232,1672587428,3196
7734,3835382117,3412825109,1672545429,1672547997,2568
7615,3772309150,3664170666,1672687671,1672689217,1546
7628,3513956646,3783509527,1672633722,1672636808,3086
7603,3901877072,3901877072,1672571356,1672571809,453
7530,3513201436,3501601840,1672655450,1672658644,3194
7616,3416427576,3715492942,1672660656,1672664223,3567
7963,3779218771,3388637594,1672592905,1672595386,2481
7761,3512217942,3774066725,1672692160,1672692763,603
7612,3711571712,3276993580,1672573949,1672577459,3510
7615,3333896808,3360743849,1672554934,1672558298,3364
7800,3496549058,3511271692,1672616855,1672617448,593
7770,3755625324,3772642849,1672662858,1672664021,1163
7857,3516716179,3399535232,1672697255,1672700055,2800
7577,3772578994,3703718151,1672604483,1672606490,2007
7976,3206593906,3829232696,1672628342,1672629248,906
7553,3301107849,3777936328,1672691578,1672692739,1161
7585,3607748895,3666507626,1672566143,1672566773,630
7605,3664517356,3511312803,1672663893,1672664829,936
7545,3519700826,3514987389,1672541387,1672543147,1760
7898,3550946908,3776338577,1672531921,1672534205,2284
7911,3509352754,3778305740,1672694467,1672697402,2935
7794,3339907603,3304625412,1672669003,1672672598,3595
7683,3430074045,3533748232,1672555667,1672558827,3160
7957,3500458761,3303705369,1672686221,1672688550,2329
7878,3399911573,3510173870,1672685283,1672687750,2467
7826,3779976989,3516016437,1672696773,1672699067,2294
7967,3304625412,3701178711,1672671936,1672672222,286
7722,3715998609,3307512479,1672679319,1672680591,1272
7650,3715339701,3505649239,1672533426,1672536295,2869
7564,3466229085,3715998609,1672696894,1672699468,2574
7488,3378686918,3334033993,1672657121,1672658765,1644
7571,3415546117,3774268456,1672550955,1672554496,3541
7556,3421836608,3791115967,1672558438,1672561805,3367
7896,3511435497,3703013906,1672548787,1672549082,295
7689,3978105277,3519912874,1672570711,1672572601,1890
7920,3736790081,3703275621,1672638575,1672641695,3120
7538,3628819436,3500060260,1672579344,1672579471,127
7630,3396086535,3512969370,1672645470,1672646238,768
7918,3777776687,3405494240,1672546943,1672549068,2125
7700,3391261292,3427219654,1672687008,1672690519,3511
7486,3516039895,3688418210,1672545946,1672547391,1445
7856,3932051427,3234541252,1672642714,1672643300,586
7828,3614238812,3760992710,1672689720,1672691787,2067
7831,3512142794,3808324264,1672694502,1672694702,200
7696,3716168623,3889750851,1672558548,1672560728,2180
7857,3494290908,3386707783,1672630951,1672632362,1411
7553,3244485293,3732481297,1672531544,1672532618,1074
7669,3386707783,3517509185,1672590666,1672592998,2332
7896,3625274012,3924549929,1672687486,1672689334,1848
7873,3701898991,3520931254,1672643711,1672647228,3517
7761,3757403279,3716746253,1672532827,1672535906,3079
7526,3477375368,3200198928,1672579808,1672583154,3346
7972,3910886626,3755943611,1672555682,1672555961,279
7764,3496051529,3714488548,1672625563,1672626868,1305
7583,3360506772,3514283243,1672634719,1672635974,1255
7980,3773429448,3200691026,1672548828,1672551443,2615
7530,3915628728,3755511676,1672582845,1672583305,460
7613,3534424200,3793338102,1672686749,1672687048,299
7698,3505599848,3716488385,1672540878,1672541301,423
7767,3312333615,3359910781,1672673373,1672674981,1608
7771,3311439795,3512166013,1672663725,1672665652,1927
7490,3516223597,3885670556,1672689688,1672690702,1014
7530,3780365428,3793959750,1672683610,1672684470,860
7770,3783126683,3710344260,1672639184,1672641221,2037
7833,3345207877,3505638204,1672531485,1672532820,1335
7929,3428006164,3600647945,1672546019,1672548676,2657
7602,3701534009,3774119563,1672553911,1672555764,1853
7726,3833889105,3736419952,1672647708,1672650625,2917
7893,3607178184,3280599164,1672685194,1672687414,2220
7738,3467773920,3388637594,1672587617,1672589220,1603
7935,3501606184,3473562469,1672586009,1672589273,3264
7547,3774066725,3888559320,1672572318,1672574620,2302
7859,3206593906,3533810360,1672689696,1672691522,1826
7772,3826633236,3481647420,1672550882,1672553608,2726
7741,3808324264,3513599775,1672533323,1672536345,3022
7620,3779740455,3683959482,1672625685,1672627830,2145
7608,3514987389,3206603608,1672577205,1672578275,1070
7601,3505638204,3733891182,1672537396,1672540664,3268
7557,3514245078,3533748232,1672618699,1672619383,684
7959,3668898102,3234541252,1672550980,1672554026,3046
7934,3633420270,3777623166,1672662249,1672665374,3125
7877,3793470489,3713208927,1672615730,1672616839,1109
7775,3913251733,3509453566,1672639890,1672641308,1418
7614,3224058172,3773205565,1672625421,1672627726,2305
7717,3466229085,3883085535,1672634202,1672635557,1355
7974,3760569731,3780593036,1672545044,1672545540,496
7952,3391915121,3627937312,1672542018,1672543154,1136
7657,3783245561,3534313900,1672568605,1672571771,3166
7680,3777929708,3291235378,1672686596,1672688822,2226
7891,3399535232,3910454786,1672701862,1672705348,3486
7890,3715581279,3853018906,1672590772,1672592903,2131
7487,3703275621,3760267716,1672580468,1672582762,2294
7946,3311065516,3859525941,1672531826,1672531986,160
7491,3511312803,3779528381,1672694944,1672696804,1860
7891,3778780511,3273500349,1672647907,1672650940,3033
7924,3909238838,3836573197,1672555389,1672556309,920
7698,3510244400,3701691675,1672692763,1672696025,3262
7872,3249791738,3358871377,1672693404,1672694946,1542
7530,3559110998,3606987130,1672601645,1672602396,751
7730,3489545239,3516514391,1672644251,1672647252,3001
7629,3512720680,3773120434,1672543804,1672547041,3237
7521,3311761694,3417970574,1672549590,1672552296,2706
7900,3932051427,3780813786,1672676158,1672678363,2205
7765,3389115045,3365614305,1672623433,1672624481,1048
7970,3516909237,3828624701,1672628531,1672629138,607
7758,3703441914,3229058858,1672695866,1672696602,736
7867,3773664987,3500391167,1672611610,1672613472,1862
7950,3512510536,3511435497,1672538055,1672538695,640
7806,3534010629,3509352754,1672534502,1672534695,193
7521,3336742544,3716165213,1672686587,1672688746,2159
7649,3511271692,3223968713,1672566506,1672567417,911
7785,3757246925,3517509185,1672655848,1672659423,3575
7540,3293695955,3222521619,1672616871,1672619588,2717
7912,3432665384,3716488385,1672660850,1672664185,3335
7515,3617734118,3388372715,1672657922,1672658345,423
7981,3716258994,3910886626,1672671445,1672674024,2579
7889,3791957752,3515691540,1672699318,1672699608,290
7793,3760294205,3701146057,1672590712,1672592888,2176
7551,3756027749,3533280269,1672613953,1672614276,323
7759,3760183458,3500177712,1672668552,1672672089,3537
7974,3779218771,3277605882,1672672714,1672674978,2264
7503,3777623166,3505098372,1672594257,1672596686,2429
7708,3221899927,3715581279,1672577387,1672578411,1024
7562,3209027249,3793470489,1672537920,1672538362,442
7942,3931941795,3777443199,1672588157,1672589374,1217
7662,3518408774,3505873261,1672675212,1672675295,83
7815,3701984666,3715998609,1672602883,1672603816,933
7504,3716258994,3826759140,1672694943,1672698099,3156
7827,3806545488,3918247820,1672696036,1672699564,3528
7942,3280615985,3716258994,1672642216,1672642901,685
7908,3716537575,3505883609,1672553295,1672556466,3171
7879,3500729955,3937224533,1672566107,1672566987,880
7692,3512837326,3774298222,1672638231,1672639798,1567
7854,3613995936,3520030713,1672569960,1672572858,2898
7716,3755436115,3816853177,1672695165,1672697448,2283
7757,3976390453,3511435497,1672699934,1672701203,1269
7804,3829232696,3826759140,1672596208,1672597244,1036
7485,3249791738,3518163778,1672604195,1672605439,1244
7820,3816454165,3500803339,1672551458,1672553416,1958
7547,3825229501,3890149705,1672537505,1672537674,169
7801,3505883609,3777776687,1672681099,1672684105,3006
7718,3756623396,3668005723,1672589675,1672590625,950
7906,3533653428,3839849341,1672551416,1672553543,2127
7696,3703013906,3783239924,1672604741,1672605562,821
7522,3668898102,3793848402,1672549585,1672550888,1303
7814,3973560347,3238712269,1672553593,1672556680,3087
7930,3909331423,3629935998,1672644438,1672645137,699
7958,3805292782,3448855696,1672650081,1672650485,404
7571,3701967560,3513454145,1672591089,1672592515,1426
7827,3312829208,3365614305,1672616165,1672617426,1261
7945,3710067113,3882997884,1672692437,1672694841,2404
7861,3779036831,3793286136,1672681571,1672683672,2101
7909,3467773920,3533137446,1672605760,1672608478,2718
7587,3791553060,3478194807,1672648377,1672651200,2823
7521,3755872268,3311090974,1672590489,1672591765,1276
7540,3757562897,3534010629,1672650085,1672653300,3215
7737,3622054816,3627937312,1672595392,1672598490,3098
7593,3242408357,3301107849,1672657313,1672658529,1216
7650,3427219654,3432665384,1672571118,1672574470,3352
7553,3501184421,3520012395,1672698050,1672700430,2380
7532,3731419510,3249791738,1672650131,1672650622,491
7688,3510937904,3390068992,1672629144,1672630348,1204
7888,3933210486,3311718847,1672619474,1672620028,554
7509,3307512479,3505477652,1672608479,1672611438,2959
7956,3887270940,3811171116,1672579037,1672581440,2403
7700,3380035798,3829764737,1672665673,1672667120,1447
7652,3511332835,3701498253,1672604323,1672604670,347
7734,3734828619,3791874383,1672563520,1672565208,1688
7758,3501759100,3298288268,1672619507,1672620586,1079
7549,3517721725,3510247121,1672567854,1672571210,3356
7978,3756424865,3770851318,1672571293,1672573385,2092
7722,3909606423,3505883609,1672666612,1672670177,3565
7707,3520376528,3318166135,1672622656,1672622731,75
7521,3793848402,3287105466,1672693011,1672695553,2542
7535,3417061462,3500729955,1672645451,1672646228,777
7976,3511125626,3606987130,1672691364,1672693359,1995
7724,3304625412,3394539273,1672561660,1672564735,3075
7782,3559110998,3972709319,1672573027,1672575063,2036
7623,3777120536,3505973226,1672602166,1672605054,2888
7869,3622054816,3520730271,1672678234,1672680274,2040
7904,3428964059,3791657947,1672608624,1672611434,2810
7865,3238712269,3480687894,1672690802,1672693907,3105
7745,3917088658,3510126867,1672576928,1672579787,2859
7612,3666457294,3891751546,1672689779,1672692493,2714
7777,3533371364,3209048907,1672558120,1672560662,2542
7606,3505962865,3518014636,1672643138,1672644688,1550
7797,3430352815,3229665776,1672673475,1672676965,3490
7795,3617055293,3780294829,1672538267,1672541670,3403
7833,3756601594,3791020967,1672572892,1672574168,1276
7552,3510173870,3493507965,1672594711,1672596067,1356
7581,3271938399,3688418210,1672654791,1672658091,3300
7772,3360993964,3774793839,1672611832,1672614037,2205
7971,3501364586,3805519285,1672634907,1672637722,2815
7528,3478194807,3736790081,1672545030,1672546217,1187
7602,3902383721,3703871468,1672574607,1672576710,2103
7690,3899371911,3517509185,1672640983,1672644238,3255
7813,3369998498,3201432789,1672569426,1672572603,3177
7788,3711571712,3512720680,1672674322,1672674533,211
7727,3778108318,3477649378,1672663281,1672663411,130
7588,3430352815,3411618230,1672577139,1672578957,1818
7486,3336751428,3713208927,1672669236,1672672417,3181
7560,3516011407,3359239884,1672679772,1672681785,2013
7843,3757602960,3505873261,1672666198,1672668873,2675
7520,3895562476,3399433690,1672557615,1672560310,2695
7715,3534424200,3791020967,1672605954,1672608751,2797
7665,3755943611,3887270940,1672601903,1672604457,2554
7816,3273500349,3833889105,1672554955,1672557518,2563
7715,3606812411,3809059934,1672544533,1672546842,2309
7721,3514283243,3559110998,1672560517,1672562970,2453
7513,3791874383,3517476351,1672599664,1672602255,2591
7650,3629935998,3793338102,1672547613,1672549604,1991
7600,3780639480,3772884106,1672572234,1672574353,2119
7968,3277669002,3420432297,1672632144,1672634584,2440
7900,3611150562,3235287260,1672585509,1672585644,135
7579,3209383861,3244485293,1672682246,1672684437,2191
7600,3910886626,3311090974,1672555292,1672555707,415
7751,3780828689,3735733948,1672640734,1672644162,3428
7565,3515723720,3407673904,1672545880,1672548894,3014
7574,3485375593,3710408395,1672700239,1672703398,3159
7721,3683959482,3714197325,1672645423,1672646348,925
7927,3711198793,3774127586,1672618210,1672619912,1702
7575,3731106822,3438645253,1672551040,1672552100,1060
7666,3617734118,3792384220,1672698049,1672699908,1859
7909,3520931254,3480687894,1672674561,1672676077,1516
7675,3774520233,3511170269,1672574466,1672576990,2524
7675,3822654369,3357483218,1672687882,1672689461,1579
7608,3978105277,3624312512,1672534656,1672536781,2125
7546,3773205565,3312829208,1672591015,1672592133,1118
7934,3284639858,3421836608,1672547370,1672549977,2607
7907,3478194807,3978115672,1672598067,1672600393,2326
7862,3917278625,3432665384,1672592826,1672594157,1331
7861,3533280269,3311603601,1672594494,1672596689,2195
7647,3246596716,3935627557,1672661753,1672662199,446
7875,3895562476,3202120784,1672581540,1672582526,986
7761,3510247121,3710344260,1672631082,1672632008,926
7769,3443698222,3828432634,1672644482,1672645139,657
7746,3291235378,3357483218,1672699192,1672702631,3439
7741,3881477378,3365942576,1672643114,1672646709,3595
7971,3737051610,3970117174,1672604519,1672604815,296
7930,3737051610,3314836094,1672539444,1672542327,2883
7620,3477649378,3484995752,1672558480,1672558940,460
7673,3533371364,3666507626,1672688025,1672688996,971
7544,3772053179,3625274012,1672624700,1672625457,757
7702,3756528686,3514245078,1672682893,1672685159,2266
7703,3351008918,3501486692,1672605605,1672606909,1304
7693,3714488548,3246596716,1672547228,1672547399,171
7610,3774580701,3500894271,1672589657,1672592719,3062
7834,3931941795,3826415738,1672652781,1672656208,3427
7811,3489217083,3471220483,1672674671,1672675316,645
7870,3777806071,3434642576,1672692537,1672694990,2453
7832,3970117174,3701967560,1672692802,1672693667,865
7585,3365830990,3247815299,1672690422,1672690865,443
7982,3505859863,3280615985,1672672582,1672675129,2547
7490,3829764737,3780593036,1672603320,1672604152,832
7727,3475258557,3804870229,1672536617,1672537585,968
7551,3509773875,3715981584,1672629742,1672632504,2762
7870,3510173870,3500658339,1672697309,1672697889,580
7598,3418728074,3730517636,1672613895,1672614777,882
7770,3220716272,3234541252,1672686234,1672687682,1448
7682,3364543015,3519601612,1672632743,1672635659,2916
7708,3505347134,3774466457,1672544945,1672546793,1848
7771,3777120536,3770824086,1672534272,1672537174,2902
7606,3756930948,3817316561,1672642809,1672645983,3174
7622,3412980697,3365278081,1672622875,1672623086,211
7932,3703441914,3716537575,1672571700,1672573195,1495
7713,3512837326,3903962771,1672701124,1672704530,3406
7578,3232962003,3715189301,1672557203,1672559110,1907
7712,3500374658,3519428855,1672663123,1672666085,2962
7963,3819727225,3925402713,1672691104,1672691798,694
7830,3857349323,3554917400,1672667979,1672669810,1831
7661,3337544549,3345207877,1672671073,1672672307,1234
7955,3774501422,3484995752,1672592393,1672593271,878
7869,3755920131,3517721725,1672531482,1672533290,1808
7692,3514128943,3501184421,1672656045,1672657560,1515
7844,3497901842,3336742544,1672682185,1672683565,1380
7710,3827626797,3399535232,1672693574,1672696812,3238
7939,3336751428,3510703546,1672553364,1672554923,1559
7669,3887270940,3505292701,1672623199,1672626275,3076
7811,3512166013,3519803045,1672543603,1672545047,1444
7635,3284639858,3828624701,1672701088,1672701783,695
7717,3780788622,3520012395,1672576064,1672578110,2046
7713,3916289176,3770824086,1672570998,1672571500,502
7955,3534010629,3247815299,1672690009,1672692823,2814
7935,3415546117,3520751702,1672691728,1672693704,1976
7615,3714821932,3399433690,1672618248,1672620477,2229
7483,3362000049,3520751702,1672542143,1672544341,2198
7770,3298288268,3316222192,1672691423,1672691726,303
7588,3774520233,3512540951,1672648102,1672648193,91
7580,3703789494,3247815299,1672638305,1672640523,2218
7934,3805342762,3918584946,1672596958,1672597243,285
7728,3222521619,3509630174,1672688264,1672691364,3100
7751,3776948966,3733891182,1672678914,1672680042,1128
7760,3318697153,3859663348,1672561552,1672564815,3263
7932,3298288268,3701065786,1672560831,1672561187,356
7903,3836573197,3505638204,1672696720,1672698358,1638
7719,3509773875,3246596716,1672589729,1672591077,1348
7850,3772309150,3374559242,1672679817,1672683041,3224
7654,3488244966,3701863557,1672640383,1672640783,400
7507,3736229191,3516909237,1672607927,1672608710,783
7945,3760561634,3780813786,1672592265,1672593518,1253
7951,3511841857,3370752401,1672675495,1672679078,3583
7660,3466911760,3221536550,1672693783,1672694355,572
7760,3918056059,3711370563,1672561731,1672562620,889
7518,3500060260,3918247820,1672627424,1672628488,1064
7524,3344364444,3666506258,1672702088,1672703407,1319
7873,3611150562,3902278226,1672546507,1672548831,2324
7717,3711504540,3755798867,1672611224,1672612608,1384
7621,3715974031,3220716272,1672660064,1672660308,244
7604,3793338102,3931941795,1672606919,1672607083,164
7487,3364543015,3668005723,1672613208,1672614536,1328
7927,3519912874,3910886626,1672674218,1672676534,2316
7671,3519152550,3774556560,1672546566,1672549089,2523
7931,3346327502,3505135325,1672679801,1672683372,3571
7783,3286658957,3779218771,1672546835,1672548437,1602
7748,3311152102,3505962865,1672698062,1672698449,387
7976,3428006164,3757403279,1672644030,1672645939,1909
7711,3483164654,3518014404,1672571304,1672572225,921
7836,3827377568,3510594211,1672566203,1672569731,3528
7735,3909606423,3472130842,1672619198,1672621260,2062
7855,3511359172,3518260334,1672626397,1672628141,1744
7670,3208844525,3716488385,1672648531,1672650965,2434
7483,3701984666,3755739653,1672668246,1672670637,2391
7785,3365830990,3516016437,1672578669,1672580252,1583
7924,3883551721,3755739653,1672531994,1672533943,1949
7842,3505219850,3342131135,1672650797,1672653928,3131
7822,3701898991,3405494240,1672553324,1672553633,309
7485,3857349323,3904775198,1672557643,1672560904,3261
7661,3286658957,3384951177,1672698093,1672698303,210
7826,3487171044,3774520233,1672581069,1672582124,1055
7783,3519803045,3773950140,1672577414,1672577854,440
7897,3792032359,3774010081,1672593604,1672595109,1505
7770,3473765852,3515151980,1672636663,1672638899,2236
7618,3511163800,3710112546,1672667048,1672670312,3264
7591,3550946908,3481647420,1672566365,1672568200,1835
7831,3333896808,3793389510,1672576153,1672577215,1062
7891,3783239924,3301107849,1672561086,1672562001,915
7830,3514245078,3365278081,1672618970,1672621744,2774
7979,3755392666,3364543015,1672633265,1672634895,1630
7485,3791334389,3777936328,1672640136,1672641611,1475
7537,3246596716,3516606733,1672544659,1672545391,732
7864,3500374658,3533653428,1672593469,1672596703,3234
7922,3434642576,3606987130,1672551028,1672552928,1900
7672,3416265063,3777443199,1672575572,1672579084,3512
7792,3757562897,3505883609,1672572170,1672575330,3160
7772,3505292701,3624761861,1672570235,1672572554,2319
7797,3533371364,3776066388,1672638846,1672639454,608
7517,3922337974,3701691675,1672685682,1672688399,2717
7838,3608633356,3615046771,1672671554,1672672291,737
7599,3318166135,3701178711,1672603340,1672606766,3426
7543,3416241005,3533270638,1672557862,1672559740,1878
7951,3501730685,3552314511,1672605490,1672607991,2501
7496,3633420270,3518014404,1672573343,1672574467,1124
7676,3935627557,3792253549,1672639127,1672641272,2145
7752,3778980116,3472130842,1672635510,1672638607,3097
7904,3736592744,3432689543,1672592783,1672594218,1435
7750,3832902928,3417970574,1672539736,1672542615,2879
7575,3280599164,3772337814,1672691136,1672694573,3437
7929,3760561634,3513599775,1672665637,1672666560,923
7809,3793627961,3443698222,1672645888,1672645995,107
7569,3882997884,3359239884,1672593192,1672595688,2496
7864,3792177074,3793436995,1672615285,1672616059,774
7594,3683766533,3391915121,1672684678,1672687899,3221
7657,3855424474,3853018906,1672677480,1672677961,481
7543,3391915886,3777443199,1672558465,1672558655,190
7589,3519803045,3556951786,1672558340,1672561495,3155
7558,3473765852,3889750851,1672671650,1672672155,505
7974,3895562476,3316222192,1672608622,1672611329,2707
7888,3807987001,3520709480,1672602610,1672603175,565
7533,3756021689,3755436115,1672644176,1672645586,1410
7762,3778341199,3511359172,1672671700,1672674368,2668
7793,3760267716,3512217942,1672579269,1672581930,2661
7731,3273500349,3783126683,1672539205,1672539703,498
7854,3516223597,3401627165,1672690817,1672693509,2692
7906,3791874383,3331845324,1672581964,1672583201,1237
7492,3360993964,3772359096,1672588556,1672590583,2027
7657,3520931254,3613995936,1672640606,1672643284,2678
7696,3396285984,3917278625,1672562641,1672565840,3199
7602,3774010081,3510771358,1672605165,1672608573,3408
7930,3311648200,3518014636,1672683244,1672685959,2715
7556,3885897503,3514283243,1672695570,1672696437,867
7981,3616944364,3791997875,1672593415,1672595648,2233
7949,3757151210,3760893269,1672687076,1672689867,2791
7772,3703789494,3512720680,1672560936,1672563920,2984
7801,3516514391,3701967560,1672700675,1672702310,1635
7841,3476232529,3533095755,1672554078,1672555318,1240
7970,3780294829,3792789881,1672683401,1672685994,2593
7577,3221536550,3936227020,1672694775,1672697192,2417
7662,3776948966,3513454145,1672601234,1672604504,3270
7537,3714504419,3229665776,1672666547,1672667004,457
7866,3249791738,3209048907,1672647793,1672650174,2381
7530,3889232789,3757602960,1672682758,1672683901,1143
7560,3514283243,3411618230,1672666070,1672666297,227
7822,3370752401,3791874383,1672619028,1672619399,371
7681,3777079686,3760992710,1672617695,1672620448,2753
7872,3505145247,3533193862,1672604665,1672607934,3269
7608,3756453423,3365278081,1672644544,1672646638,2094
7721,3607748895,3511359172,1672671791,1672674928,3137
7724,3735319397,3910886626,1672561150,1672562432,1282
7797,3610348516,3515723720,1672559232,1672560611,1379
7491,3713786889,3286658957,1672553857,1672554276,419
7633,3519563836,3757403279,1672662938,1672663408,470
7497,3505859863,3756027749,1672688790,1672692324,3534
7512,3379256399,3510937904,1672657085,1672659366,2281
7630,3710344260,3311324983,1672620318,1672621394,1076
7918,3783509527,3857349323,1672627616,1672628461,845
7787,3500229033,3756424865,1672611573,1672614775,3202
7678,3501955238,3755798867,1672594372,1672597149,2777
7831,3711198793,3318697153,1672644890,1672645749,859
7894,3604539807,3757562897,1672561198,1672564435,3237
7521,3606812411,3716165213,1672551285,1672552517,1232
7587,3285400528,3793871337,1672563126,1672563459,333
7890,3835382117,3360993964,1672575182,1672576643,1461
7488,3351008918,3715339701,1672701780,1672702477,697
7772,3921211276,3859663348,1672602247,1672603642,1395
7597,3793286136,3925620998,1672634669,1672636766,2097
7644,3534702203,3774125065,1672562339,1672563548,1209
7514,3666457294,3882997884,1672565405,1672568459,3054
7560,3883312122,3500658339,1672639771,1672641641,1870
7937,3533193862,3778305740,1672698315,1672701022,2707
7597,3701065786,3534313900,1672687177,1672690191,3014
7855,3972364603,3388637594,1672546294,1672548394,2100
7540,3397418363,3903962771,1672584821,1672586064,1243
7624,3835382117,3713644518,1672552744,1672553706,962
7892,3880310724,3736786443,1672642963,1672644291,1328
7649,3711262377,3738274418,1672577856,1672578360,504
7741,3774127586,3511163800,1672541458,1672541890,432
7511,3714962248,3273500349,1672645332,1672647612,2280
7735,3713349754,3666506258,1672613335,1672614304,969
7752,3701178711,3780294829,1672628013,1672631525,3512
7713,3791553060,3617055293,1672648034,1672650643,2609
7759,3839849341,3770635361,1672615171,1672618183,3012
7582,3757562897,3533927138,1672541297,1672544184,2887
7677,3855937514,3755587522,1672594938,1672595553,615
7648,3373384732,3505904952,1672631511,1672633885,2374
7508,3608868877,3519563836,1672593956,1672594999,1043
7546,3774204963,3888559320,1672679914,1672681823,1909
7632,3792384220,3307512479,1672671500,1672675098,3598
7496,3755872268,3311065516,1672623856,1672625260,1404
7926,3475251781,3475258557,1672656449,1672658855,2406
7680,3514987389,3734737881,1672623053,1672624304,1251
7660,3520030713,3372883226,1672598179,1672600192,2013
7977,3756453423,3730517636,1672613123,1672615717,2594
7959,3778780511,3783239924,1672689881,1672692582,2701
7706,3715339701,3780294829,1672698744,1672700919,2175
7874,3511198618,3501606184,1672561943,1672563789,1846
7712,3779036831,3439023335,1672638162,1672638352,190
7594,3337544549,3780813786,1672682458,1672685655,3197
7626,3780503655,3792668962,1672614505,1672617858,3353
7621,3500458761,3801089989,1672589200,1672592696,3496
7780,3716537575,3374559242,1672615966,1672618916,2950
7641,3774556560,3916289176,1672557311,1672558938,1627
7860,3629935998,3926700506,1672691778,1672691909,131
7696,3427219654,3515125508,1672645072,1672648009,2937
7874,3511359172,3639847263,1672610008,1672613093,3085
7898,3505702787,3500994774,1672580701,1672582077,1376
7935,3394539273,3716835696,1672697641,1672697737,96
7614,3501692334,3510857360,1672636113,1672639382,3269
7860,3776066388,3501606184,1672669463,1672669524,61
7961,3604539807,3513454145,1672588157,1672591591,3434
7820,3505203158,3483164654,1672563429,1672565022,1593
7738,3760569731,3713349754,1672651064,1672651499,435
7656,3533827120,3318697153,1672533178,1672536106,2928
7910,3209383861,3610348516,1672628876,1672631452,2576
7791,3311845971,3757562897,1672646170,1672648012,1842
7964,3716165213,3792288302,1672655175,1672656401,1226
7666,3701146057,3716273414,1672549156,1672550114,958
7856,3701184889,3509352754,1672662533,1672664455,1922
7874,3802367797,3517963492,1672690796,1672691326,530
7721,3284639858,3312664885,1672539890,1672540979,1089
7798,3559110998,3399911573,1672538159,1672538954,795
7642,3489545239,3200198928,1672601089,1672601659,570
7655,3811694763,3783779671,1672532065,1672535249,3184
7760,3500229033,3337544549,1672605677,1672606173,496
7776,3805519285,3828365570,1672598566,1672600427,1861
7499,3887270940,3783126683,1672643542,1672646080,2538
7634,3792668962,3736419952,1672542350,1672544572,2222
7813,3286658957,3777717988,1672559390,1672559909,519
7769,3311845971,3820354437,1672584230,1672587181,2951
7534,3533827120,3453729665,1672623407,1672626687,3280
7637,3617055293,3737079798,1672538015,1672540756,2741
7949,3231056870,3331845324,1672581677,1672583237,1560
7828,3513599775,3209383861,1672613023,1672614701,1678
7649,3438645253,3827626797,1672643174,1672643752,578
7918,3713786889,3206593906,1672602412,1672604734,2322
7730,3780609808,3220716272,1672612265,1672612477,212
7895,3387674757,3918584946,1672674874,1672676745,1871
7484,3307097200,3224058172,1672565716,1672568562,2846
7772,3415443558,3773465237,1672594013,1672595432,1419
7738,3774045700,3399911573,1672669840,1672671026,1186
7510,3688683847,3783779671,1672536751,1672537447,696
7540,3311993075,3516716179,1672669894,1672671824,1930
7833,3228165483,3202120784,1672570420,1672572008,1588
7729,3519803045,3520706195,1672625593,1672628790,3197
7655,3826633236,3517255726,1672658048,1672660683,2635
7827,3555214688,3715998609,1672628345,1672629176,831
7706,3516065852,3492478793,1672682084,1672682850,766
7950,3515394721,3311648200,1672600093,1672603310,3217
7653,3505962865,3520706195,1672635820,1672637314,1494
7545,3512720680,3976390453,1672628841,1672629618,777
7619,3826633236,3818255890,1672550486,1672550727,241
7560,3500374658,3910454786,1672636963,1672637599,636
7572,3311761694,3916289176,1672624700,1672626258,1558
7718,3716258994,3822654369,1672652671,1672653931,1260
7522,3418534998,3501955238,1672609925,1672610742,817
7807,3404058699,3229665776,1672531469,1672531781,312
7677,3703735129,3855937514,1672602901,1672605119,2218
7740,3336742544,3701984666,1672604545,1672605222,677
7731,3802367797,3311718847,1672647449,1672647881,432
7806,3287105466,3882997884,1672637939,1672641093,3154
7551,3902278226,3209383861,1672610850,1672612867,2017
7577,3496269445,3610695419,1672610092,1672610444,352
7890,3304625412,3600647945,1672618470,1672620501,2031
7942,3364543015,3800353779,1672660646,1672663071,2425
7755,3772884106,3510703546,1672549581,1672552894,3313
7594,3394539273,3518932404,1672612514,1672614409,1895
7486,3912262917,3607178184,1672642703,1672644885,2182
7970,3311718847,3221536550,1672560009,1672561313,1304
7932,3334033993,3518669703,1672552439,1672553609,1170
7674,3390068992,3311603601,1672613410,1672615532,2122
7485,3783206719,3277669002,1672662662,1672664221,1559
7575,3505649239,3428674539,1672575379,1672575989,610
7972,3313541986,3391915121,1672669609,1672672832,3223
7505,3755739653,3779528381,1672687467,1672688751,1284
7890,3500199935,3505904952,1672558930,1672561660,2730
7583,3881477378,3898995675,1672685667,1672688267,2600
7972,3511170269,3520629279,1672683343,1672686313,2970
7549,3432665384,3617055293,1672664077,1672665569,1492
7517,3883312122,3756021689,1672619779,1672620399,620
7794,3501730685,3608633356,1672662283,1672665279,2996
7566,3359239884,3477649378,1672564696,1672568206,3510
7613,3365830990,3772758337,1672555376,1672558159,2783
7901,3236102733,3311627628,1672539100,1672539364,264
7944,3618873142,3221899927,1672607827,1672609774,1947
7949,3235635976,3313564074,1672606847,1672609703,2856
7630,3519912874,3426325549,1672676220,1672677146,926
7802,3331845324,3311152102,1672596931,1672598786,1855
7721,3757682496,3517255726,1672697354,1672699733,2379
7888,3634786711,3855937514,1672623965,1672627467,3502
7747,3703718151,3757812939,1672627423,1672628639,1216
7732,3760561634,3713349754,1672586561,1672589698,3137
7789,3459030804,3497901842,1672597535,1672598645,1110
7779,3792473331,3206593906,1672620874,1672621048,174
7589,3512166013,3510247121,1672653628,1672656631,3003
7756,3773205565,3664517356,1672629996,1672631237,1241
7677,3777120536,3755392666,1672553825,1672555668,1843
7507,3515723720,3519556068,1672629582,1672632350,2768
7880,3517864478,3780914982,1672694303,1672695125,822
7691,3514128943,3311718847,1672680749,1672683045,2296
7502,3760893269,3201324715,1672585231,1672585325,94
7803,3533025282,3703013906,1672543298,1672544539,1241
7915,3756453423,3793470489,1672592884,1672594444,1560
7940,3533242305,3664517356,1672605965,1672607730,1765
7838,3773465237,3511350608,1672606411,1672608395,1984
7552,3715339701,3770447408,1672663417,1672663742,325
7748,3760267716,3770447408,1672581622,1672583193,1571
7759,3304625412,3501730685,1672613904,1672617410,3506
7949,3511271692,3513454145,1672563362,1672565638,2276
7743,3774466457,3730517636,1672689985,1672691390,1405
7676,3391915886,3816454165,1672540153,1672542310,2157
7663,3617734118,3312664885,1672584284,1672584764,480
7582,3360743849,3791115967,1672633582,1672634748,1166
7833,3902383721,3519556068,1672656594,1672658634,2040
7795,3716197887,3516065852,1672556911,1672560215,3304
7676,3778266283,3276993580,1672603755,1672607211,3456
7898,3428674539,3227158514,1672695637,1672695806,169
7888,3817621391,3416265063,1672622030,1672622277,247
7526,3501955238,3791602225,1672560627,1672562351,1724
7553,3913251733,3757161914,1672667865,1672668837,972
7682,3703871468,3518014404,1672692062,1672693330,1268
7880,3773598056,3755042098,1672538398,1672541070,2672
7951,3402943525,3715981584,1672665648,1672667426,1778
7563,3716835696,3331845324,1672574782,1672575158,376
7833,3512349371,3500904641,1672596002,1672596982,980
7675,3608868877,3711370563,1672582392,1672583437,1045
7799,3809916577,3601879040,1672606445,1672609314,2869
7516,3509453566,3377766165,1672646973,1672647296,323
7558,3517864478,3338703270,1672648232,1672648515,283
7725,3534488837,3607748895,1672660762,1672661095,333
7753,3518876135,3774195321,1672694451,1672695618,1167
7663,3777806071,3932051427,1672635634,1672636942,1308
7582,3534553510,3496051529,1672576965,1672577898,933
7505,3918674986,3332072298,1672642316,1672644945,2629
7776,3778305740,3772544062,1672677424,1672677626,202
7509,3518360734,3339907603,1672616008,1672619341,3333
7820,3770101921,3304056063,1672587111,1672588813,1702
7849,3815508790,3432665384,1672550347,1672550427,80
7861,3395152943,3500177712,1672554873,1672556939,2066
7515,3976633198,3534492426,1672590657,1672593581,2924
7738,3228165483,3388286531,1672543758,1672545793,2035
7619,3772746272,3351008918,1672635111,1672636054,943
7942,3311603601,3757682496,1672531906,1672532685,779
7783,3773664987,3734737881,1672648807,1672651710,2903
7516,3660493209,3481647420,1672589515,1672591709,2194
7530,3434642576,3311152102,1672572110,1672572781,671
7939,3383661227,3826759140,1672693007,1672696127,3120
7614,3244173074,3616944364,1672671638,1672671891,253
7725,3701065786,3533137446,1672654275,1672655511,1236
7797,3534553510,3481502100,1672537311,1672537784,473
7633,3715581279,3516606733,1672627934,1672629719,1785
7823,3903962771,3780609808,1672533361,1672536639,3278
7601,3770447408,3826415738,1672549238,1672552534,3296
7604,3936227020,3701178711,1672577241,1672578482,1241
7532,3613683164,3338703270,1672669768,1672672060,2292
7819,3510711755,3851190615,1672623742,1672626980,3238
7703,3222448362,3345207877,1672589806,1672589985,179
7802,3519563836,3755943611,1672542523,1672545668,3145
7967,3367902229,3510771358,1672587529,1672590406,2877
7636,3978115672,3886298125,1672652629,1672652745,116
7956,3711380716,3756462516,1672692232,1672695732,3500
7896,3505869747,3882242815,1672673238,1672675421,2183
7686,3249401741,3248507722,1672660160,1672663376,3216
7923,3518163778,3809059934,1672697389,1672699114,1725
7922,3793871337,3489962019,1672615833,1672617051,1218
7720,3385763781,3311627628,1672560556,1672562057,1501
7517,3510771358,3914259449,1672612717,1672612966,249
7706,3244485293,3756601594,1672686279,1672689019,2740
7829,3412825109,3616944364,1672566168,1672569213,3045
7939,3917088658,3352603894,1672692306,1672694110,1804
7556,3793848402,3249401741,1672550708,1672552996,2288
7849,3313564074,3779629905,1672692447,1672693633,1186
7564,3412980697,3516223597,1672630899,1672633548,2649
7938,3515394721,3318166135,1672542978,1672545419,2441
7736,3932051427,3373384732,1672539476,1672542430,2954
7518,3534424200,3910454786,1672646652,1672648587,1935
7610,3777790718,3880285638,1672658067,1672660936,2869
7614,3899204805,3372883226,1672616640,1672618215,1575
7502,3313541986,3428964059,1672575784,1672575888,104
7579,3311154569,3716168623,1672542000,1672543115,1115
7546,3496269445,3505201246,1672604845,1672607074,2229
7822,3899204805,3378436155,1672557312,1672560880,3568
7540,3918584946,3901990690,1672660418,1672663955,3537
7692,3716165213,3783531004,1672622290,1672623231,941
7951,3716258994,3313541986,1672681926,1672684219,2293
7916,3438645253,3918584946,1672562850,1672565395,2545
7825,3514283243,3779528381,1672624603,1672627756,3153
7878,3701534009,3666553782,1672567034,1672570367,3333
7515,3800886801,3429690204,1672636758,1672637192,434
7744,3605726278,3202120784,1672652012,1672652243,231
7487,3837094550,3201324715,1672675415,1672678642,3227
7484,3512837326,3489962019,1672623834,1672624418,584
7600,3914259449,3668898102,1672553278,1672555639,2361
7508,3415546117,3714504419,1672532257,1672535621,3364
7848,3500729955,3392121505,1672597369,1672600436,3067
7690,3359239884,3497901842,1672585787,1672587647,1860
7978,3520376528,3342131135,1672536875,1672537822,947
7768,3438645253,3713644518,1672682479,1672683220,741
7761,3443698222,3791553060,1672658898,1672661537,2639
7566,3289061738,3600647945,1672667748,1672670705,2957
7534,3206254161,3826633236,1672546258,1672546508,250
7844,3224716315,3222521619,1672606617,1672608258,1641
7524,3534492426,3533095755,1672628035,1672631248,3213
7758,3280599164,3201848640,1672625599,1672629111,3512
7665,3533653428,3888559320,1672620156,1672623409,3253
7577,3816853177,3512510536,1672679777,1672680264,487
7882,3510594211,3755625324,1672562502,1672564314,1812
7774,3421836608,3289061738,1672679406,1672682743,3337
7719,3276993580,3711380716,1672569749,1672570225,476
7653,3774580701,3774010081,1672671116,1672673679,2563
7648,3783083229,3511359172,1672534673,1672537216,2543
7907,3512540951,3801089989,1672579935,1672583532,3597
7510,3500374658,3304625412,1672537645,1672538549,904
7660,3377766165,3505135325,1672617004,1672619205,2201
7571,3898995675,3791334389,1672656630,1672658059,1429
7529,3936227020,3480687894,1672532155,1672535526,3371
7836,3378686918,3760992710,1672631084,1672632965,1881
7699,3714474557,3426325549,1672606782,1672609166,2384
7570,3713644518,3778980116,1672663611,1672665364,1753
7957,3520629279,3852391257,1672573408,1672574189,781
7593,3935627557,3778980116,1672597019,1672597335,316
7543,3280615985,3291235378,1672659725,1672661793,2068
7663,3772642849,3224058172,1672575180,1672577323,2143
7941,3832902928,3918584946,1672684319,1672686913,2594
7736,3617055293,3505292701,1672595953,1672597169,1216
7624,3808324264,3779528381,1672624258,1672625951,1693
7590,3388637594,3505145247,1672639854,1672642127,2273
7860,3303705369,3855000166,1672679070,1672679795,725
7766,3402943525,3757812939,1672687388,1672688045,657
7977,3792768129,3307097200,1672656954,1672658991,2037
7854,3276993580,3304056063,1672656422,1672659075,2653
7658,3716168623,3247428249,1672654918,1672655931,1013
7930,3475258557,3755392666,1672630218,1672632129,1911
7972,3791020967,3664170666,1672702081,1672703117,1036
7867,3711308224,3783531004,1672702961,1672705104,2143
7978,3517255726,3222521619,1672596728,1672600047,3319
7726,3714488548,3370752401,1672701302,1672704443,3141
7809,3500374658,3780914982,1672659073,1672662322,3249
7508,3772714862,3302626661,1672702904,1672705205,2301
7876,3520888296,3227457126,1672615058,1672618566,3508
7927,3277669002,3973560347,1672673239,1672676082,2843
7958,3534313900,3976390453,1672532433,1672533885,1452
7659,3485008994,3715189301,1672601599,1672602844,1245
7918,3738274418,3713786889,1672673159,1672673319,160
7842,3778266283,3430074045,1672654237,1672656248,2011
7772,3247780536,3736786443,1672624137,1672625513,1376
7640,3792032359,3505962865,1672695138,1672696996,1858
7539,3235635976,3716537575,1672542866,1672546217,3351
7714,3505362057,3277605882,1672593479,1672594441,962
7746,3791594391,3711571712,1672678829,1672679947,1118
7621,3731419510,3517963492,1672625801,1672625998,197
7504,3301107849,3247428249,1672632024,1672633563,1539
7945,3805347939,3774119563,1672694403,1672694491,88
7743,3826760240,3417587765,1672586564,1672589364,2800
7809,3206603608,3791334389,1672610938,1672613019,2081
7743,3813052709,3736625083,1672688380,1672688973,593
7804,3505599848,3511312803,1672568616,1672569276,660
7693,3505219850,3777790718,1672546057,1672547621,1564
7695,3774366875,3297463265,1672545974,1672547218,1244
7537,3496269445,3715998609,1672601232,1672602238,1006
7805,3829764737,3501692334,1672675436,1672677354,1918
7601,3715339701,3973560347,1672642538,1672645812,3274
7870,3772309166,3608868877,1672615031,1672617264,2233
7695,3518791447,3666457294,1672688740,1672690628,1888
7725,3516629436,3633420270,1672692357,1672694640,2283
7675,3701178711,3976633198,1672628331,1672628648,317
7812,3701995648,3505859863,1672592141,1672592245,104
7857,3772746272,3485823740,1672607106,1672609163,2057
7644,3518014636,3914259449,1672636247,1672636943,696
7775,3703735129,3489728806,1672538387,1672540073,1686
7914,3407954858,3533810360,1672563060,1672564470,1410
7791,3859663348,3834257412,1672695807,1672698887,3080
7743,3511350608,3516980378,1672655859,1672656712,853
7573,3303751772,3533927138,1672657711,1672657950,239
7784,3432689543,3391915886,1672578005,1672578256,251
7964,3501759100,3883312122,1672660701,1672662113,1412
7784,3917278625,3776513891,1672595196,1672598676,3480
7964,3780593036,3770447408,1672604658,1672605494,836
7712,3608633356,3793848402,1672583480,1672583882,402
7948,3715339701,3249247700,1672543509,1672546421,2912
7926,3770021824,3342131135,1672574842,1672577788,2946
7911,3510594211,3756021689,1672642901,1672645711,2810
7778,3228165483,3351008918,1672624180,1672625359,1179
7497,3611150562,3201324715,1672702247,1672704994,2747
7668,3434642576,3629547065,1672534106,1672536987,2881
7692,3518260334,3805519285,1672603147,1672604838,1691
7864,3777983879,3916289176,1672662175,1672662948,773
7825,3777455223,3500729955,1672690569,1672691497,928
7866,3314836094,3483164654,1672542043,1672544616,2573
7839,3734737881,3895562476,1672687999,1672691005,3006
7773,3312829208,3735319397,1672568252,1672568861,609
7795,3304625412,3427283336,1672664320,1672667203,2883
7858,3516016437,3774119563,1672568345,1672570856,2511
7862,3756021689,3520012395,1672537881,1672538836,955
7768,3473562469,3519912874,1672584120,1672587427,3307
7679,3222448362,3313541986,1672690630,1672693311,2681
7503,3703661585,3311152102,1672664207,1672667598,3391
7847,3489728806,3246596716,1672631477,1672633578,2101
7598,3511271692,3404384505,1672660563,1672660925,362
7667,3792844210,3298433163,1672657123,1672657669,546
7871,3554917400,3755511676,1672571085,1672573073,1988
7694,3777443199,3520709480,1672581396,1672583417,2021
7589,3774204963,3827377568,1672568161,1672571167,3006
7977,3391261292,3370752401,1672564802,1672568388,3586
7888,3926700506,3713644518,1672580772,1672582044,1272
7580,3613683164,3514472925,1672564273,1672566934,2661
7825,3755587522,3770763956,1672651005,1672652227,1222
7768,3711262377,3756601594,1672563000,1672563782,782
7762,3703889596,3608868877,1672670813,1672671647,834
7744,3344364444,3936227020,1672643223,1672646441,3218
7905,3664170666,3501483568,1672608238,1672610444,2206
7688,3517721725,3510703546,1672613173,1672613290,117
7629,3303751772,3383922351,1672665573,1672665944,371
7515,3336742544,3920801189,1672652361,1672654644,2283
7895,3227457126,3505904952,1672595287,1672597437,2150
7558,3497901842,3511163800,1672677058,1672678366,1308
7558,3511841857,3902383721,1672595262,1672595600,338
7840,3365830990,3533827120,1672679006,1672680826,1820
7716,3520756859,3307512479,1672646767,1672648550,1783
7840,3473562469,3501955238,1672571422,1672572661,1239
7783,3828432634,3829319703,1672674699,1672677246,2547
7922,3345207877,3855000166,1672609735,1672613222,3487
7865,3505477652,3453729665,1672655025,1672657828,2803
7618,3922337974,3772359096,1672618757,1672621074,2317
7730,3829232696,3510244400,1672649547,1672653126,3579
7762,3373384732,3481647420,1672655028,1672657926,2898
7529,3395152943,3883042241,1672586540,1672589731,3191
7491,3662180254,3703275621,1672697685,1672700150,2465
7534,3496549058,3509453566,1672608669,1672611925,3256
7661,3517459919,3851190615,1672699287,1672700488,1201
7497,3774466457,3501692334,1672542168,1672543606,1438
7484,3783126683,3311208440,1672584321,1672587049,2728
7695,3510937904,3511687358,1672593281,1672594207,926
7855,3714821932,3519912874,1672547567,1672549166,1599
7765,3772578994,3519428855,1672639519,1672642798,3279
7593,3485008994,3921211276,1672549274,1672550903,1629
7556,3772642849,3554917400,1672651956,1672655122,3166
7932,3817621391,3701984666,1672570686,1672573049,2363
7631,3898995675,3505203158,1672567581,1672570152,2571
7546,3378686918,3284639858,1672541760,1672544612,2852
7566,3852391257,3883085535,1672532582,1672536156,3574
7889,3314245084,3904408902,1672652881,1672655410,2529
7663,3318697153,3780294829,1672627617,1672628455,838
7530,3509630174,3805292782,1672560690,1672560932,242
7534,3792668962,3710569131,1672631220,1672634786,3566
7492,3774066725,3312664885,1672542458,1672545238,2780
7833,3451432842,3622054816,1672632808,1672634600,1792
7585,3505193212,3519703355,1672654094,1672654777,683
7551,3899266183,3391915886,1672564551,1672567322,2771
7773,3500391167,3703441914,1672683310,1672686445,3135
7604,3500060260,3356860407,1672689866,1672690126,260
7749,3716900301,3380035798,1672655152,1672658738,3586
7912,3613683164,3473765852,1672572994,1672574458,1464
7948,3774127586,3755798867,1672553118,1672554138,1020
7554,3895562476,3477375368,1672578633,1672579236,603
7896,3236102733,3416427576,1672660007,1672660991,984
7647,3475795792,3336751428,1672535457,1672535613,156
7787,3970117174,3518932404,1672624918,1672625422,504
7578,3783429780,3604539807,1672652456,1672653487,1031
7827,3791602225,3760509236,1672548789,1672550299,1510
7664,3514719601,3517509185,1672677298,1672677936,638
7934,3510380060,3200691026,1672601672,1672603023,1351
7808,3716835696,3426325549,1672620424,1672621473,1049
7706,3899371911,3851190615,1672578265,1672579663,1398
7726,3249247700,3500060260,1672581641,1672583506,1865
7975,3881477378,3827626797,1672559226,1672562073,2847
7754,3889750851,3903962771,1672635082,1672635368,286
7582,3480687894,3757246925,1672573892,1672575949,2057
7541,3703955926,3312333615,1672605270,1672608088,2818
7575,3244485293,3774045700,1672701271,1672703263,1992
7773,3515151980,3520719611,1672601646,1672604612,2966
7687,3855602893,3351554343,1672534881,1672536029,1148
7939,3888559320,3915628728,1672602591,1672602725,134
7892,3415443558,3852595551,1672595146,1672595494,348
7661,3773120434,3773598056,1672596059,1672596526,467
7915,3515860749,3373384732,1672679673,1672680260,587
7668,3816853177,3344019610,1672557623,1672558901,1278
7850,3483164654,3365614305,1672595201,1672596948,1747
7857,3774125065,3520206212,1672686231,1672689722,3491
7526,3480687894,3922275620,1672576885,1672579529,2644
7533,3756966035,3711198793,1672544656,1672546715,2059
7710,3779528381,3224716315,1672600517,1672602816,2299
7750,3601879040,3358871377,1672624099,1672625204,1105
7958,3779218771,3417061462,1672618583,1672621949,3366
7818,3505203158,3783531004,1672554428,1672554720,292
7642,3711265369,3291227780,1672649257,1672650637,1380
7973,3853018906,3277669002,1672534125,1672537216,3091
7619,3783239924,3514283243,1672584661,1672584797,136
7667,3774204963,3510937904,1672693731,1672696304,2573
7969,3533270638,3801089989,1672654407,1672657610,3203
7598,3276993580,3501601840,1672593912,1672594250,338
7607,3933210486,3756966035,1672586433,1672586654,221
7892,3780974443,3732481297,1672662087,1672664944,2857
7967,3791115967,3501606184,1672641813,1672644132,2319
7734,3791997875,3713894336,1672570192,1672571935,1743
7496,3889750851,3476232529,1672632638,1672632738,100
7744,3802367797,3510244400,1672615920,1672619319,3399
7917,3921211276,3465254146,1672680633,1672681519,886
7902,3713808837,3518014636,1672562334,1672563771,1437
7655,3303751772,3701898991,1672574951,1672575068,117
7611,3311154569,3820354437,1672604519,1672605958,1439
7604,3703871468,3231056870,1672532760,1672536287,3527
7670,3773120434,3533025282,1672604744,1672605801,1057
7662,3512683609,3736790081,1672697129,1672699844,2715
7669,3756528686,3829232696,1672573087,1672573502,415
7733,3505904952,3930797455,1672596915,1672598704,1789
7642,3387674757,3505859863,1672550183,1672553063,2880
7908,3604539807,3505649239,1672564680,1672566397,1717
7810,3311274543,3793470489,1672583490,1672584354,864
7504,3736786443,3533270638,1672584780,1672585689,909
7582,3534553510,3421836608,1672534278,1672537465,3187
7556,3683959482,3918247820,1672679802,1672681587,1785
7982,3756462516,3244485293,1672624513,1672626757,2244
7633,3855424474,3280599164,1672626465,1672629241,2776
7641,3458539365,3823600322,1672668603,1672669675,1072
7742,3311152102,3882291183,1672663127,1672665299,2172
7599,3516909237,3409474775,1672539773,1672541702,1929
7699,3925620998,3606186086,1672564923,1672565276,353
7574,3711262377,3922275620,1672593536,1672595351,1815
7700,3405494240,3311274543,1672611710,1672613242,1532
7549,3515394721,3487171044,1672624968,1672626576,1608
7922,3500066230,3807987001,1672536901,1672537466,565
7495,3716168623,3826415738,1672538214,1672538753,539
7934,3737154119,3208844525,1672564731,1672565809,1078
7658,3430074045,3701534009,1672638191,1672640309,2118
7946,3683766533,3379589402,1672551330,1672552363,1033
7551,3701178711,3399911573,1672576331,1672576951,620
7530,3294803686,3520709480,1672536929,1672537311,382
7493,3500365158,3783925755,1672689991,1672692260,2269
7569,3773429448,3509933351,1672641710,1672641886,176
7941,3533095755,3756021689,1672571080,1672572145,1065
7708,3903962771,3711308224,1672624169,1672625099,930
7491,3407725581,3406784491,1672600237,1672603805,3568
7609,3223968713,3513454145,1672646141,1672647112,971
7809,3434642576,3509453566,1672550472,1672551345,873
7964,3429856982,3853018906,1672540525,1672542942,2417
7846,3715581279,3367029997,1672669275,1672671953,2678
7755,3779740455,3430074045,1672650489,1672653101,2612
7622,3501759100,3318697153,1672545639,1672547956,2317
7928,3432689543,3448855696,1672577535,1672578733,1198
7499,3512540951,3626156564,1672658511,1672660974,2463
7685,3476232529,3314836094,1672589274,1672592162,2888
7857,3909238838,3424922204,1672536582,1672539493,2911
7920,3774005526,3361230905,1672566184,1672567062,878
7711,3505883609,3511332835,1672580727,1672582811,2084
7707,3735319397,3473562469,1672608431,1672610921,2490
7521,3314245084,3500729955,1672600853,1672601463,610
7517,3500487333,3805292782,1672671951,1672673903,1952
7557,3629935998,3505702787,1672591755,1672592415,660
7662,3688683847,3755042098,1672577467,1672577749,282
7971,3920801189,3206593906,1672584960,1672587573,2613
7844,3311603601,3412980697,1672543304,1672545127,1823
7628,3773465237,3399433690,1672685564,1672686965,1401
7835,3829319703,3858918246,1672588144,1672591273,3129
7937,3779036831,3519069599,1672699658,1672702694,3036
7965,3885897503,3818255890,1672593059,1672593137,78
7981,3774050956,3509352754,1672553718,1672555958,2240
7590,3501927421,3716900301,1672676539,1672679733,3194
7965,3234541252,3820354437,1672698774,1672701240,2466
7774,3882242815,3223789409,1672586046,1672588967,2921
7538,3613995936,3505347134,1672565173,1672565972,799
7632,3607748895,3311090974,1672646812,1672647300,488
7687,3701995648,3505477652,1672691728,1672693591,1863
7627,3365830990,3223968713,1672534870,1672535991,1121
7756,3377766165,3222521619,1672626873,1672627490,617
7640,3772337814,3736786443,1672547002,1672548593,1591
7551,3776800213,3500658339,1672615282,1672617413,2131
7935,3757246925,3773978034,1672590521,1672593230,2709
7656,3514472925,3481502100,1672559997,1672560464,467
7757,3783206719,3514128943,1672552382,1672553584,1202
7724,3235287260,3886298125,1672591115,1672592093,978
7618,3895562476,3351554343,1672689741,1672691350,1609
7799,3391915886,3297463265,1672534657,1672537007,2350
7981,3209027249,3757455053,1672694697,1672697981,3284
7516,3774580701,3688683847,1672699094,1672699351,257
7800,3500458761,3518876135,1672651132,1672654282,3150
7547,3311324983,3294803686,1672625196,1672628357,3161
7653,3516514391,3349613093,1672543956,1672544081,125
7886,3776066388,3703789494,1672625903,1672626221,318
7508,3629547065,3534492426,1672661572,1672664405,2833
7594,3485008994,3668898102,1672681410,1672684438,3028
7939,3377766165,3242408357,1672664996,1672666026,1030
7664,3500894271,3227457126,1672564538,1672566763,2225
7903,3801089989,3534313900,1672579888,1672582116,2228
7693,3774580701,3312333615,1672635999,1672637619,1620
7831,3756623396,3774045700,1672627540,1672627647,107
7927,3804870229,3518260334,1672639391,1672640983,1592
7659,3701967560,3429690204,1672555171,1672556642,1471
7727,3520931254,3209551760,1672649049,1672649915,866
7523,3352603894,3229665776,1672671172,1672672309,1137
7752,3703013906,3716537575,1672639827,1672642631,2804
7956,3801089989,3429690204,1672633989,1672636853,2864
7955,3792902982,3715974031,1672645939,1672647966,2027
7601,3701863557,3489217083,1672696641,1672697956,1315
7640,3505203158,3899371911,1672545580,1672546517,937
7960,3859663348,3277605882,1672553707,1672554979,1272
7750,3714488548,3805342762,1672697781,1672700276,2495
7789,3770021824,3276993580,1672688891,1672690587,1696
7650,3242408357,3513164386,1672701068,1672702035,967
7846,3760489031,3827377568,1672664985,1672667253,2268
7518,3356860407,3713349754,1672540201,1672542676,2475
7547,3518932404,3509453566,1672615295,1672617526,2231
7973,3377766165,3369998498,1672644488,1672646849,2361
7777,3311845971,3311648200,1672634054,1672634903,849
7691,3711504540,3783925755,1672569855,1672570287,432
7771,3415546117,3976633198,1672610292,1672611601,1309
7960,3774580701,3882291183,1672583708,1672586703,2995
7597,3808324264,3772746272,1672581802,1672585090,3288
7755,3421127249,3805347939,1672695024,1672697838,2814
7918,3773978034,3772309166,1672568022,1672569346,1324
7823,3285400528,3438645253,1672583531,1672586612,3081
7794,3972709319,3780609808,1672580927,1672583254,2327
7532,3520165601,3533095755,1672695630,1672698798,3168
7919,3533810360,3505702787,1672597192,1672600638,3446
7563,3429690204,3500391167,1672626147,1672629212,3065
7838,3348261553,3713969578,1672611435,1672614321,2886
7598,3311627628,3933210486,1672547954,1672549401,1447
7847,3827222533,3716835696,1672556292,1672558472,2180
7606,3701691675,3791020967,1672611375,1672612564,1189
7776,3505145247,3779740455,1672629594,1672632492,2898
7570,3703889596,3412980697,1672613389,1672614986,1597
7651,3805342762,3710067113,1672674154,1672674255,101
7484,3370636709,3972364603,1672658349,1672661519,3170
7487,3760492950,3516716179,1672610049,1672613573,3524
7977,3484995752,3432689543,1672588670,1672590110,1440
7529,3500458761,3734737881,1672580255,1672583769,3514
7861,3513201436,3739106581,1672604310,1672605039,729
7565,3772544062,3313541986,1672646694,1672648557,1863
7908,3791115967,3311871871,1672593521,1672593667,146
7755,3756424865,3823600322,1672592377,1672595758,3381
7795,3936227020,3901990690,1672645144,1672645823,679
7697,3804870229,3397418363,1672547951,1672549971,2020
7835,3500229033,3228165483,1672698967,1672701085,2118
7731,3711504540,3756930948,1672545693,1672549201,3508
7781,3501692334,3514245078,1672595821,1672596921,1100
7680,3857349323,3757812939,1672699974,1672700042,68
7636,3397418363,3311324983,1672680928,1672682628,1700
7959,3515125508,3926700506,1672546908,1672548418,1510
7549,3711504540,3772884106,1672695179,1672697430,2251
7696,3922275620,3800886801,1672566771,1672568775,2004
7918,3500658339,3925620998,1672632779,1672635685,2906
7547,3916289176,3501730685,1672581069,1672584451,3382
7848,3975287541,3311203656,1672548479,1672550536,2057
7773,3703275621,3510969660,1672596758,1672597758,1000
7533,3760183458,3471220483,1672610421,1672613651,3230
7963,3757403279,3783083229,1672613177,1672615935,2758
7864,3922337974,3518260334,1672592532,1672592648,116
7698,3918247820,3774366875,1672587278,1672588711,1433
7910,3510594211,3386707783,1672540770,1672544156,3386
7666,3855937514,3792473331,1672651410,1672652214,804
7604,3770021824,3429856982,1672548023,1672551033,3010
7644,3505791599,3837094550,1672552086,1672555092,3006
7709,3387674757,3701995648,1672580772,1672583608,2836
7737,3518496488,3514472925,1672596608,1672597881,1273
7888,3223968713,3899266183,1672547927,1672549250,1323
7932,3828432634,3509352754,1672637260,1672638738,1478
7850,3776338577,3311627628,1672638363,1672641505,3142
7859,3519700826,3757562897,1672585074,1672587357,2283
7583,3736786443,3772544062,1672585007,1672586437,1430
7485,3793338102,3685818092,1672585260,1672585405,145
7776,3760893269,3613995936,1672566402,1672569719,3317
7711,3472130842,3829319703,1672565860,1672568955,3095
7496,3344019610,3466911760,1672551179,1672554544,3365
7582,3883042241,3922275620,1672612113,1672614058,1945
7623,3716258994,3826759140,1672604193,1672607351,3158
7782,3336751428,3206254161,1672584180,1672587515,3335
7793,3780828689,3304056063,1672577103,1672579697,2594
7706,3889750851,3412825109,1672539701,1672541192,1491
7830,3247428249,3922275620,1672642331,1672643860,1529
7799,3773664987,3234541252,1672647580,1672650225,2645
7613,3783126683,3518932404,1672544205,1672546093,1888
7487,3770101921,3756021689,1672634414,1672636230,1816
7769,3827377568,3485823740,1672540794,1672542542,1748
7614,3534492426,3734496778,1672670725,1672672142,1417
7979,3778780511,3793086311,1672546897,1672550470,3573
7854,3703955926,3793962300,1672622456,1672625152,2696
7509,3517509185,3520165601,1672659860,1672660469,609
7590,3826760240,3500805881,1672574857,1672578325,3468
7579,3715981584,3918247820,1672619475,1672621189,1714
7528,3891751546,3777936328,1672626133,1672628028,1895
7901,3777120536,3777455223,1672593629,1672593907,278
7548,3910886626,3399433690,1672690772,1672692601,1829
7903,3311065516,3776338577,1672685372,1672688267,2895
7492,3777776687,3518163778,1672686453,1672687441,988
7642,3756424865,3500199935,1672675575,1672678493,2918
7658,3493507965,3505347134,1672533559,1672534767,1208
7546,3559110998,3513080274,1672622806,1672625312,2506
7589,3349613093,3277669002,1672543448,1672546658,3210
7567,3921211276,3501184421,1672576870,1672579694,2824
7829,3939952128,3604539807,1672626071,1672627073,1002
7727,3779218771,3515125508,1672630494,1672633841,3347
7659,3780639480,3791115967,1672675579,1672675896,317
7695,3737051610,3505098372,1672593654,1672596953,3299
7928,3475258557,3733891182,1672669711,1672670999,1288
7652,3505702787,3500658339,1672694828,1672695439,611
7952,3976633198,3774005526,1672572921,1672574123,1202
7646,3922275416,3404058699,1672618560,1672619983,1423
7635,3357483218,3780294829,1672684603,1672687713,3110
7876,3428006164,3516223597,1672662814,1672666111,3297
7500,3384240055,3379256399,1672669518,1672672022,2504
7981,3715981584,3910886626,1672580005,1672581884,1879
7660,3713349754,3626156564,1672611602,1672613836,2234
7713,3801089989,3500994774,1672657027,1672658332,1305
7613,3626156564,3534729133,1672610335,1672612863,2528
7783,3514472925,3496051529,1672595697,1672596455,758
7861,3792473331,3418728074,1672568579,1672571905,3326
7569,3209383861,3420432297,1672610972,1672612381,1409
7591,3428964059,3478194807,1672642181,1672643590,1409
7940,3780503655,3731419510,1672633246,1672635647,2401
7972,3776513891,3417587765,1672691396,1672694110,2714
7897,3827377568,3516980378,1672543525,1672546980,3455
7586,3826759140,3901877072,1672607824,1672611236,3412
7909,3809484172,3518876135,1672656624,1672658427,1803
7519,3209048907,3760992710,1672622357,1672622895,538
7523,3505883609,3533193862,1672545763,1672547662,1899
7774,3703275621,3348261553,1672565573,1672568111,2538
7765,3429690204,3716258994,1672599125,1672599475,350
7933,3890149705,3336751428,1672686230,1672689047,2817
7883,3312333615,3432689543,1672569285,1672572475,3190
7515,3734737881,3899266183,1672592487,1672594474,1987
7691,3793871337,3511687358,1672596904,1672598836,1932
7726,3783429780,3883312122,1672681404,1672683114,1710
7782,3501184421,3714821932,1672655400,1672657229,1829
7777,3701184889,3921211276,1672638905,1672640629,1724
7837,3930797455,3516629436,1672645059,1672646271,1212
7828,3533369198,3903009525,1672645916,1672647770,1854
7855,3475795792,3756424865,1672687699,1672690523,2824
7830,3624312512,3621497531,1672548900,1672550887,1987
7979,3703735129,3351008918,1672673235,1672673807,572
7686,3973560347,3365614305,1672578658,1672580929,2271
7521,3500994774,3367902229,1672665243,1672665504,261
7980,3756528686,3887270940,1672666650,1672669666,3016
7539,3792384220,3516909237,1672576462,1672579677,3215
7782,3289061738,3428964059,1672643883,1672644412,529
7729,3731106822,3516223597,1672697907,1672699222,1315
7931,3898995675,3610695419,1672591242,1672594305,3063
7716,3760267716,3221899927,1672637072,1672637838,766
7647,3388372715,3773814927,1672624303,1672625396,1093
7635,3634995491,3772746272,1672641203,1672641984,781
7657,3711504540,3780828689,1672634181,1672636948,2767
7815,3511163800,3793871337,1672701028,1672703082,2054
7818,3783196518,3534191820,1672635601,1672639106,3505
7547,3473765852,3895562476,1672592806,1672595917,3111
7616,3926700506,3737051610,1672562181,1672564725,2544
7613,3293695955,3512969370,1672624432,1672627925,3493
7720,3229058858,3805292782,1672535490,1672535952,462
7931,3773664987,3391915121,1672601459,1672601643,184
7787,3918056059,3505883609,1672606355,1672608931,2576
7848,3501606184,3271938399,1672633144,1672634858,1714
7917,3229665776,3859663348,1672593090,1672595646,2556
7838,3500487333,3902383721,1672703639,1672707031,3392
7732,3505292701,3467773920,1672643850,1672644683,833
7616,3701190899,3660493209,1672651013,1672653120,2107
7641,3904775198,3770021824,1672580825,1672584278,3453
7512,3520190170,3802367797,1672698351,1672700281,1930
7714,3402943525,3505638204,1672655379,1672656806,1427
7826,3851190615,3360993964,1672597812,1672598795,983
7823,3664517356,3496051529,1672596556,1672599009,2453
7567,3811171116,3979339287,1672537423,1672540385,2962
7697,3500658339,3510937904,1672677970,1672679990,2020
7738,3224716315,3880310724,1672657691,1672660911,3220
7847,3451432842,3534702203,1672691924,1672693561,1637
7841,3231056870,3475795792,1672667752,1672669144,1392
7679,3760509236,3304056063,1672637123,1672639641,2518
7847,3358871377,3820354437,1672664115,1672666357,2242
7906,3396285984,3792384220,1672596361,1672597528,1167
7668,3703275621,3780294829,1672533751,1672534531,780
7896,3227158514,3509352754,1672656485,1672657173,688
7509,3859525941,3715189301,1672678923,1672681715,2792
7600,3780639480,3534313900,1672565827,1672566587,760
7794,3550946908,3815508790,1672597649,1672599007,1358
7649,3510711755,3501198706,1672577111,1672579153,2042
7857,3914290246,3606987130,1672569034,1672570088,1054
7603,3886298125,3396086535,1672703653,1672703761,108
7737,3518260334,3288764520,1672569387,1672569650,263
7883,3206254161,3512720680,1672606988,1672608247,1259
7528,3466229085,3517077106,1672625234,1672625460,226
7790,3621497531,3626156564,1672661982,1672665019,3037
7666,3701691675,3505201246,1672669315,1672672687,3372
7930,3757562897,3734737881,1672592698,1672593791,1093
7593,3779036831,3713894336,1672562661,1672565500,2839
7909,3701498253,3428674539,1672653253,1672656852,3599
7532,3516606733,3760294205,1672595024,1672597803,2779
7778,3505135325,3710408395,1672537771,1672539165,1394
7825,3783083229,3200198928,1672637960,1672638545,585
7857,3370752401,3480687894,1672617384,1672620127,2743
7679,3880285638,3552314511,1672620435,1672621889,1454
7576,3701065786,3760509236,1672609249,1672609813,564
7564,3500365158,3970117174,1672597298,1672599698,2400
7570,3492478793,3356860407,1672578430,1672580128,1698
7698,3280615985,3362000049,1672694589,1672697344,2755
7637,3494290908,3516716179,1672569356,1672570681,1325
7780,3500499542,3515723720,1672676637,1672678686,2049
7685,3311718847,3372883226,1672655387,1672656250,863
7638,3399004969,3773429448,1672533457,1672536022,2565
7788,3618873142,3792668962,1672585517,1672586612,1095
7947,3379256399,3713208927,1672602935,1672603740,805
7973,3777443199,3517077106,1672666716,1672669986,3270
7667,3715492942,3222448362,1672586938,1672589453,2515
7903,3774339795,3475795792,1672542546,1672542846,300
7865,3777936328,3311761694,1672700306,1672702195,1889
7706,3701065786,3703441914,1672687087,1672687178,91
7712,3514987389,3716835696,1672548964,1672550649,1685
7759,3513080274,3512837326,1672693753,1672697232,3479
7851,3852391257,3780503655,1672675510,1672675572,62
7799,3505173328,3337544549,1672700528,1672700911,383
7968,3517509185,3509907947,1672624365,1672627814,3449
7837,3318697153,3733891182,1672667633,1672669066,1433
7762,3774204963,3770824086,1672613678,1672615997,2319
7820,3297463265,3379256399,1672659881,1672662265,2384
7568,3500994774,3512720680,1672555937,1672556062,125
7660,3505869747,3792177074,1672548223,1672550582,2359
7641,3465254146,3277939457,1672698508,1672700390,1882
7965,3509352754,3475251781,1672551809,1672555224,3415
7887,3778980116,3828432634,1672543618,1672545778,2160
7925,3396086535,3409474775,1672644008,1672646744,2736
7873,3701178711,3914259449,1672624724,1672626858,2134
7589,3519703355,3625274012,1672648338,1672649958,1620
7856,3446948848,3716537575,1672552296,1672553623,1327
7858,3280615985,3887270940,1672541776,1672542904,1128
7536,3345207877,3606812411,1672615659,1672616574,915
7956,3629935998,3520719611,1672596422,1672599578,3156
7956,3497901842,3533371364,1672571592,1672572797,1205
7925,3637008488,3485823740,1672635415,1672635686,271
7520,3826759140,3899371911,1672593141,1672593717,576
7856,3913251733,3734496778,1672576986,1672579953,2967
7862,3370636709,3389115045,1672638307,1672639064,757
7962,3505904952,3296471982,1672639394,1672640793,1399
7771,3716537575,3811694763,1672571868,1672573771,1903
7758,3819727225,3904775198,1672687372,1672688547,1175
7518,3826759140,3776513891,1672564401,1672565617,1216
7895,3505973226,3485375593,1672696735,1672697863,1128
7530,3885897503,3606812411,1672584984,1672585459,475
7568,3533369198,3716258994,1672614973,1672618362,3389
7813,3342131135,3780828689,1672630353,1672630749,396
7485,3399433690,3625274012,1672677053,1672677384,331
7585,3429856982,3627937312,1672591230,1672594811,3581
7855,3618873142,3249791738,1672584532,1672587082,2550
7644,3478194807,3760569731,1672544661,1672548206,3545
7746,3621810464,3976633198,1672544606,1672545161,555
7644,3520206212,3512540951,1672537456,1672538707,1251
7698,3829232696,3515284591,1672538913,1672539124,211
7513,3465254146,3510857360,1672664788,1672666931,2143
7969,3813052709,3438645253,1672683348,1672683923,575
7925,3713894336,3311603601,1672651005,1672654104,3099
7798,3405494240,3634786711,1672554689,1672557428,2739
7530,3517864478,3446948848,1672606576,1672609682,3106
7978,3634995491,3792473331,1672655922,1672657031,1109
7768,3279721246,3772884106,1672678323,1672681656,3333
7910,3505883609,3713630656,1672591102,1672593931,2829
7636,3909238838,3703871468,1672673416,1672676523,3107
7848,3220716272,3500894271,1672583130,1672585525,2395
7941,3533810360,3520030713,1672633342,1672635264,1922
7793,3512969370,3711198793,1672561447,1672564746,3299
7835,3701274634,3510703546,1672622444,1672624071,1627
7699,3511125626,3793753089,1672690582,1672692453,1871
7871,3774298222,3458539365,1672585874,1672589313,3439
7573,3519912874,3429690204,1672587835,1672589815,1980
7938,3209027249,3855424474,1672538202,1672540647,2445
7903,3510771358,3760569731,1672568541,1672571591,3050
7628,3231056870,3815508790,1672682064,1672683307,1243
7832,3668005723,3802367797,1672650888,1672654386,3498
7692,3407673904,3390068992,1672659493,1672661557,2064
7845,3380035798,3409474775,1672583091,1672584735,1644
7698,3505193212,3887270940,1672619285,1672621844,2559
7781,3614238812,3903307060,1672581453,1672584706,3253
7564,3617734118,3247780536,1672613905,1672615225,1320
7784,3229058858,3516039895,1672697599,1672698768,1169
7886,3774125065,3715981584,1672672993,1672674528,1535
7518,3475258557,3701898991,1672592828,1672593179,351
7890,3417061462,3500177712,1672689788,1672690779,991
7666,3313564074,3629935998,1672532544,1672533268,724
7622,3774125065,3518876135,1672594644,1672595020,376
7737,3500365158,3311993075,1672567091,1672567202,111
7841,3735733948,3514128943,1672587839,1672588250,411
7865,3773755137,3515860749,1672684204,1672686491,2287
7890,3338367113,3774366875,1672554737,1672554830,93
7570,3611150562,3703735129,1672682665,1672684413,1748
7750,3209383861,3770447408,1672650278,1672652557,2279
7815,3683766533,3432689543,1672639967,1672643484,3517
7742,3244485293,3475795792,1672657865,1672660114,2249
7678,3556951786,3501606184,1672694568,1672696972,2404
7576,3757602960,3519069599,1672681590,1672683738,2148
7931,3780609808,3736790081,1672665900,1672668035,2135
7662,3629935998,3388286531,1672559712,1672562395,2683
7551,3297463265,3415546117,1672579466,1672581503,2037
7650,3313541986,3792253549,1672678486,1672679162,676
7617,3778305740,3770078063,1672540954,1672542554,1600
7664,3716258994,3701111745,1672697814,1672699227,1413
7651,3232962003,3716488385,1672621535,1672622433,898
7507,3365278081,3346795719,1672603655,1672606073,2418
7849,3514472925,3510247121,1672562794,1672563858,1064
7948,3311718847,3793627961,1672640543,1672640920,377
7782,3711308224,3304625412,1672694356,1672696005,1649
7524,3816853177,3500803339,1672640146,1672642666,2520
7697,3716537575,3224058172,1672617107,1672620636,3529
7916,3811694763,3303705369,1672636882,1672638606,1724
7820,3935127663,3505791599,1672611402,1672613871,2469
7552,3628819436,3918584946,1672555644,1672558305,2661
7805,3519152550,3475251781,1672575284,1672576567,1283
7662,3520629279,3370636709,1672700413,1672703405,2992
7934,3379589402,3383661227,1672543447,1672546660,3213
7978,3703789494,3316173088,1672622914,1672623918,1004
7490,3772884106,3618873142,1672549600,1672552891,3291
7523,3778549126,3774127586,1672632611,1672633243,632
7848,3903307060,3518260334,1672537339,1672539270,1931
7882,3426325549,3356860407,1672672372,1672673518,1146
7707,3518876135,3232962003,1672637127,1672639057,1930
7697,3336751428,3617055293,1672538876,1672540650,1774
7912,3622054816,3772642849,1672598658,1672601818,3160
7843,3342131135,3911245524,1672596156,1672598134,1978
7580,3311627628,3792789881,1672611927,1672613021,1094
7565,3918584946,3509672210,1672622392,1672625262,2870
7847,3883085535,3760267716,1672650050,1672651028,978
7922,3608868877,3318697153,1672580582,1672583258,2676
7980,3534010629,3738502357,1672564520,1672566626,2106
7719,3493507965,3858918246,1672586397,1672589229,2832
7710,3209383861,3978105277,1672690730,1672692745,2015
7861,3500391167,3518360734,1672624347,1672625735,1388
7747,3372883226,3475795792,1672640994,1672642137,1143
7618,3311203656,3505477652,1672654647,1672654756,109
7731,3520756859,3800886801,1672629336,1672630075,739
7734,3513164386,3773205565,1672546824,1672549784,2960
7547,3318697153,3774338212,1672592798,1672594792,1994
7863,3505962865,3485008994,1672544413,1672547340,2927
7540,3886298125,3443698222,1672679575,1672680753,1178
7813,3779629905,3783429780,1672654515,1672657217,2702
7840,3791997875,3636867411,1672580161,1672581095,934
7536,3922275416,3777776687,1672688392,1672689187,795
7708,3430074045,3501364586,1672542252,1672542816,564
7564,3505873261,3517077106,1672625362,1672627412,2050
7826,3701863557,3774520233,1672546815,1672547724,909
7604,3513454145,3516514391,1672636173,1672638997,2824
7498,3515151980,3311603601,1672668676,1672670025,1349
7559,3480687894,3857349323,1672636494,1672638341,1847
7578,3458539365,3421127249,1672552147,1672552590,443
7723,3791020967,3467773920,1672658051,1672658470,419
7936,3899204805,3311324983,1672548036,1672550767,2731
7872,3222448362,3518876135,1672533502,1672533899,397
7538,3930791338,3970117174,1672613699,1672615594,1895
7780,3883312122,3406784491,1672649142,1672650738,1596
7488,3509773875,3489545239,1672639510,1672642840,3330
7973,3703275621,3517476351,1672626895,1672629881,2986
7767,3773598056,3533810360,1672683771,1672685335,1564
7496,3816853177,3912536808,1672668843,1672669110,267
7900,3428674539,3610348516,1672699156,1672699684,528
7550,3760893269,3639847263,1672665063,1672666566,1503
7545,3221536550,3395152943,1672605221,1672606818,1597
7953,3505869747,3837094550,1672684286,1672687361,3075
7533,3978115672,3399433690,1672544698,1672547481,2783
7512,3772642849,3770635361,1672650761,1672651309,548
7664,3834257412,3636867411,1672652719,1672653919,1200
7782,3505883609,3792768129,1672631124,1672631216,92
7721,3361230905,3406784491,1672693268,1672695316,2048
7826,3385763781,3505912939,1672563360,1672563595,235
7528,3477649378,3501184421,1672607986,1672611483,3497
7608,3520888296,3374559242,1672637573,1672639983,2410
7644,3701984666,3777936328,1672620130,1672620723,593
7958,3760561634,3510380060,1672673540,1672675903,2363
7656,3515125508,3731419510,1672568770,1672572353,3583
7840,3520931254,3883042241,1672566075,1672569403,3328
7563,3883312122,3246596716,1672686503,1672688076,1573
7810,3313564074,3559110998,1672700799,1672701276,477
7577,3901877072,3909331423,1672605273,1672608561,3288
7819,3505201246,3534191820,1672655412,1672655892,480
7906,3777477395,3701146057,1672557721,1672558285,564
7565,3244485293,3279721246,1672642884,1672643369,485
7903,3429690204,3904775198,1672624171,1672627225,3054
7979,3509672210,3780788622,1672692820,1672694559,1739
7914,3774125065,3286658957,1672535274,1672535751,477
7591,3918056059,3533927138,1672633006,1672633067,61
7762,3311090974,3755872268,1672592777,1672594231,1454
7676,3511271692,3505873261,1672594526,1672597933,3407
7670,3666457294,3465254146,1672596647,1672598237,1590
7799,3234362962,3505347134,1672571533,1672573523,1990
7512,3505135325,3792473331,1672601856,1672603871,2015
7550,3512166013,3827222533,1672657925,1672661511,3586
7705,3777929708,3791997875,1672665552,1672668472,2920
7881,3505145247,3520756859,1672615938,1672616090,152
7696,3701498253,3451432842,1672645993,1672646367,374
7531,3973560347,3314245084,1672637855,1672639538,1683
7749,3701178711,3737079798,1672627497,1672627815,318
7587,3475251781,3828365570,1672603160,1672605982,2822
7839,3505098372,3510244400,1672608083,1672610406,2323
7818,3756601594,3488244966,1672688103,1672688581,478
7762,3338367113,3701498253,1672547560,1672550488,2928
7507,3512837326,3711569060,1672701048,1672703770,2722
7535,3520012395,3409474775,1672567025,1672569388,2363
7789,3710344260,3772337814,1672652215,1672653209,994
7667,3516465662,3826759140,1672580757,1672583851,3094
7754,3505638204,3978105277,1672571227,1672574083,2856
7813,3639847263,3777079686,1672559332,1672561264,1932
7871,3715974031,3791334389,1672609457,1672610362,905
7796,3793962300,3755872268,1672559400,1672562447,3047
7744,3910454786,3391915886,1672547021,1672548795,1774
7598,3421127249,3500060260,1672531243,1672531982,739
7800,3505347134,3922337974,1672658049,1672659813,1764
7528,3793871337,3780294829,1672643281,1672643528,247
7517,3231056870,3828365570,1672611065,1672612555,1490
7804,3369998498,3793436995,1672633715,1672635242,1527
7728,3512969370,3505702787,1672650785,1672654137,3352
7517,3511350608,3200198928,1672636244,1672639704,3460
7881,3418534998,3614238812,1672672716,1672674556,1840
7881,3384951177,3520706195,1672628803,1672629850,1047
7655,3777477395,3816853177,1672576021,1672577987,1966
7688,3701184889,3976633198,1672618801,1672620933,2132
7902,3512969370,3505135325,1672567998,1672570145,2147
7536,3378436155,3606812411,1672645140,1672647132,1992
7679,3387966152,3201848640,1672688731,1672690374,1643
7852,3613683164,3471220483,1672648335,1672651615,3280
7800,3303705369,3918056059,1672662844,1672665954,3110
7764,3978115672,3313541986,1672685038,1672688250,3212
7966,3505219850,3278365525,1672614162,1672615427,1265
7903,3496549058,3294803686,1672557258,1672559633,2375
7667,3976633198,3972364603,1672598519,1672600745,2226
7752,3829319703,3910454786,1672542686,1672543978,1292
7841,3514838220,3304625412,1672659498,1672662294,2796
7615,3780294829,3500578848,1672589983,1672590058,75
7600,3715492942,3500060260,1672591325,1672593427,2102
7506,3713894336,3774580701,1672605740,1672606605,865
7670,3885897503,3510857360,1672582932,1672584911,1979
7777,3800886801,3505219850,1672605461,1672606757,1296
7505,3312333615,3611150562,1672698296,1672698677,381
7638,3760294205,3515151980,1672659868,1672663373,3505
7729,3734496778,3510173870,1672673168,1672673757,589
7734,3434642576,3520756859,1672664061,1672667198,3137
7895,3412825109,3774580701,1672703840,1672707365,3525
7525,3715339701,3319752091,1672578244,1672578488,244
7829,3312333615,3367029997,1672566368,1672567192,824
7981,3534313900,3774005526,1672572613,1672573232,619
7691,3772642849,3855424474,1672595557,1672598568,3011
7866,3755392666,3606186086,1672598341,1672600250,1909
7675,3533095755,3716746253,1672618798,1672618873,75
7499,3793959750,3273500349,1672546433,1672548484,2051
7839,3828432634,3713808837,1672555709,1672558140,2431
7498,3791997875,3826415738,1672643367,1672644724,1357
7832,3939952128,3792768129,1672533338,1672535775,2437
7611,3520756859,3668005723,1672593361,1672593854,493
7645,3316222192,3429856982,1672659462,1672661281,1819
7546,3510969660,3378092448,1672593667,1672594798,1131
7499,3772642849,3634786711,1672605765,1672608234,2469
7865,3516039895,3910454786,1672564995,1672565855,860
7924,3516465662,3518014404,1672624555,1672626483,1928
7804,3510594211,3296471982,1672671875,1672674673,2798
7492,3505869747,3936227020,1672686425,1672689059,2634
7893,3755739653,3859525941,1672544900,1672547350,2450
7976,3617055293,3291227780,1672598927,1672599655,728
7863,3737154119,3397418363,1672639556,1672643112,3556
7707,3554917400,3500199935,1672674810,1672675894,1084
7911,3736592744,3453729665,1672560147,1672562449,2302
7925,3520888296,3497901842,1672600803,1672602605,1802
7911,3360993964,3625274012,1672703242,1672706730,3488
7881,3801089989,3394539273,1672656869,1672658686,1817
7791,3516039895,3715492942,1672557695,1672559587,1892
7926,3667680268,3415546117,1672684863,1672688035,3172
7559,3420700674,3477375368,1672635160,1672637505,2345
7916,3780813786,3770078063,1672591634,1672592270,636
7731,3501184421,3624312512,1672658575,1672661205,2630
7599,3400918687,3518014636,1672699498,1672699808,310
7501,3519912874,3777983879,1672655082,1672658316,3234
7716,3415443558,3505347134,1672607490,1672610581,3091
7681,3882997884,3500060260,1672652479,1672655021,2542
7927,3512217942,3312664885,1672591710,1672592711,1001
7764,3533095755,3364543015,1672582636,1672585995,3359
7981,3336742544,3776066388,1672629317,1672632394,3077
7581,3223968713,3220716272,1672589338,1672592079,2741
7679,3287105466,3496549058,1672547984,1672550206,2222
7526,3311324983,3429690204,1672646919,1672647650,731
7641,3512510536,3505347134,1672655318,1672656206,888
7884,3505201246,3394330287,1672623082,1672624932,1850
7505,3828365570,3513080274,1672547684,1672550357,2673
7692,3817316561,3791334389,1672680979,1672683051,2072
7861,3428674539,3394330287,1672635137,1672638224,3087
7501,3909606423,3365614305,1672604981,1672605999,1018
7908,3756453423,3420432297,1672700140,1672702665,2525
7491,3458539365,3520165601,1672612454,1672614363,1909
7787,3511687358,3710098970,1672600848,1672604067,3219
7529,3800353779,3883551721,1672672489,1672675501,3012
7684,3311152102,3827626797,1672683376,1672685241,1865
7642,3520931254,3710098970,1672585378,1672585792,414
7941,3206593906,3424922204,1672630085,1672631334,1249
7539,3852391257,3780828689,1672598442,1672598612,170
7588,3600647945,3757602960,1672539592,1672542232,2640
7617,3519556068,3791602225,1672590706,1672593673,2967
7560,3773664987,3501730685,1672685978,1672689229,3251
7511,3889750851,3682061100,1672557132,1672559277,2145
7586,3224058172,3427219654,1672615185,1672617567,2382
7801,3443698222,3818255890,1672692279,1672694112,1833
7833,3780639480,3755587522,1672564931,1672566502,1571
7952,3818255890,3483164654,1672604145,1672607690,3545
7961,3417587765,3853018906,1672557012,1672559148,2136
7936,3378092448,3400918687,1672531520,1672533662,2142
7960,3836573197,3791602225,1672675617,1672676327,710
7492,3500066230,3505193212,1672693992,1672694525,533
7698,3209048907,3511170269,1672680345,1672681078,733
7580,3779528381,3383661227,1672679899,1672681835,1936
7675,3780593036,3337544549,1672573534,1672576842,3308
7659,3772309150,3817316561,1672593280,1672594797,1517
7888,3778108318,3223789409,1672695160,1672695820,660
7921,3244389794,3511198618,1672639892,1672640821,929
7924,3505912939,3703223015,1672677523,1672678217,694
7601,3889232789,3716843669,1672660769,1672662349,1580
7523,3772746272,3517509185,1672654390,1672655616,1226
7630,3685818092,3336742544,1672597584,1672600199,2615
7843,3935627557,3732481297,1672616394,1672619306,2912
7674,3312829208,3206254161,1672677738,1672680904,3166
7764,3311627628,3793848402,1672547133,1672547266,133
7851,3378436155,3774338212,1672665762,1672666010,248
7953,3616944364,3755798867,1672643732,1672644706,974
7803,3428674539,3780828689,1672611523,1672612358,835
7606,3391915121,3303751772,1672689153,1672689903,750
7665,3519069599,3817316561,1672535356,1672537916,2560
7584,3428674539,3360743849,1672690407,1672693453,3046
7828,3345207877,3388637594,1672666603,1672668651,2048
7851,3777443199,3466911760,1672641819,1672644351,2532
7636,3683959482,3206603608,1672666499,1672667188,689
7746,3511332835,3760598102,1672537289,1672537370,81
7737,3369998498,3520719611,1672693420,1672695873,2453
7673,3420700674,3925402713,1672662139,1672664551,2412
7688,3895562476,3755436115,1672605019,1672606418,1399
7942,3757151210,3391915886,1672550619,1672552062,1443
7682,3489962019,3515284591,1672682021,1672682496,475
7891,3501483568,3480687894,1672535190,1672537190,2000
7876,3756453423,3713894336,1672575715,1672578865,3150
7599,3395152943,3515723720,1672653607,1672654217,610
7612,3412980697,3774268456,1672671525,1672673396,1871
7839,3773598056,3505098372,1672648341,1672651734,3393
7716,3889750851,3234541252,1672670403,1672673906,3503
7525,3715998609,3201432789,1672566501,1672569689,3188
7614,3473562469,3344019610,1672569826,1672571286,1460
7780,3421127249,3783245561,1672617813,1672619701,1888
7680,3519428855,3244436890,1672654028,1672656597,2569
7697,3773465237,3634995491,1672581649,1672583488,1839
7765,3629547065,3224058172,1672604866,1672605896,1030
7846,3346795719,3903009525,1672594250,1672596416,2166
7889,3791594391,3511267139,1672585733,1672587580,1847
7668,3737051610,3273500349,1672632878,1672634725,1847
7696,3818255890,3418728074,1672684287,1672687392,3105
7879,3914259449,3760598102,1672597954,1672601391,3437
7584,3388372715,3664170666,1672560731,1672561626,895
7714,3515723720,3518014636,1672558730,1672560636,1906
7757,3811694763,3489728806,1672616363,1672616826,463
7756,3513956646,3533827120,1672621419,1672622567,1148
7734,3774466457,3756453423,1672566092,1672566929,837
7489,3500578848,3791020967,1672600198,1672602705,2507
7581,3512166013,3780609808,1672584727,1672585348,621
7679,3314245084,3774520233,1672571914,1672572381,467
7884,3770851318,3500805881,1672676860,1672677549,689
7902,3793338102,3417061462,1672606503,1672609080,2577
7910,3505599848,3703661585,1672536849,1672540004,3155
7498,3780788622,3534553510,1672604157,1672605161,1004
7496,3979339287,3291227780,1672593452,1672594474,1022
7665,3512217942,3515860749,1672634084,1672636241,2157
7906,3828624701,3511163800,1672585229,1672586412,1183
7527,3358871377,3828624701,1672580517,1672583335,2818
7898,3779629905,3792253549,1672693991,1672695620,1629
7923,3806545488,3800886801,1672624839,1672626383,1544
7519,3421127249,3220716272,1672595143,1672598299,3156
7900,3516039895,3418534998,1672619859,1672621459,1600
7657,3483949762,3510703546,1672628867,1672631241,2374
7836,3505859863,3714821932,1672647081,1672649174,2093
7775,3501927421,3816454165,1672617975,1672621251,3276
7849,3823600322,3628819436,1672562611,1672565647,3036
7625,3664517356,3710344260,1672613562,1672614637,1075
7612,3921211276,3816853177,1672685001,1672687086,2085
7629,3780593036,3402943525,1672691127,1672692331,1204
7734,3367029997,3534702203,1672657700,1672658124,424
7550,3757455053,3505873261,1672649557,1672650750,1193
7860,3510937904,3510244400,1672584977,1672586704,1727
7924,3227158514,3783083229,1672533813,1672536137,2324
7664,3417061462,3826760240,1672608824,1672611138,2314
7737,3500894271,3804870229,1672685955,1672686979,1024
7630,3512217942,3311090974,1672646145,1672649152,3007
7570,3487171044,3793338102,1672660816,1672662841,2025
7882,3496269445,3902383721,1672585182,1672586479,1297
7745,3755739653,3429856982,1672627242,1672627775,533
7877,3914290246,3805292782,1672536634,1672538281,1647
7636,3834257412,3303751772,1672615679,1672616784,1105
7693,3500805881,3780639480,1672647498,1672649851,2353
7634,3772359096,3533653428,1672598662,1672599791,1129
7508,3918584946,3600647945,1672564587,1672566957,2370
7766,3735319397,3629935998,1672650530,1672653254,2724
7599,3334033993,3512837326,1672627657,1672627782,125
7651,3519654779,3500729955,1672654249,1672654915,666
7901,3466911760,3554917400,1672683594,1672686652,3058
7668,3459030804,3755042098,1672584834,1672586746,1912
7624,3791594391,3774366875,1672536319,1672537259,940
7547,3711571712,3534702203,1672575999,1672579444,3445
7529,3757403279,3200691026,1672550027,1672550301,274
7653,3550946908,3807987001,1672536718,1672538696,1978
7724,3505638204,3774520233,1672636496,1672638990,2494
7887,3417061462,3629935998,1672601045,1672603467,2422
7825,3819727225,3791553060,1672656501,1672659509,3008
7579,3318697153,3773664987,1672537369,1672538792,1423
7833,3533927138,3438645253,1672545352,1672546806,1454
7633,3496269445,3512217942,1672631722,1672633479,1757
7831,3915628728,3688683847,1672700655,1672703418,2763
7713,3839849341,3853018906,1672626219,1672627991,1772
7683,3890149705,3534702203,1672682169,1672682921,752
7822,3238712269,3836573197,1672651087,1672652456,1369
7604,3755739653,3391915886,1672665360,1672665533,173
7836,3772746272,3311993075,1672564992,1672565282,290
7631,3509352754,3501483568,1672532342,1672532633,291
7921,3438645253,3244173074,1672582024,1672584788,2764
7635,3666457294,3685818092,1672697600,1672699824,2224
7504,3466229085,3827377568,1672580934,1672583016,2082
7641,3511841857,3319752091,1672589763,1672592970,3207
7838,3901990690,3703735129,1672659593,1672661263,1670
7868,3932051427,3755881905,1672540305,1672542467,2162
7534,3407954858,3387966152,1672568870,1672569451,581
7740,3511332835,3505791599,1672558322,1672559011,689
7978,3936227020,3780639480,1672581284,1672582349,1065
7490,3713808837,3793962300,1672547296,1672550127,2831
7867,3432689543,3715127362,1672693419,1672696812,3393
7527,3774050956,3778980116,1672555926,1672558320,2394
7684,3533369198,3311090974,1672584929,1672585820,891
7544,3624312512,3516223597,1672587842,1672590046,2204
7496,3716537575,3505477652,1672652573,1672655024,2451
7619,3774066725,3774127586,1672618108,1672619623,1515
7812,3904408902,3478194807,1672579541,1672581024,1483
7928,3512349371,3714197325,1672571004,1672573482,2478
7964,3235635976,3734737881,1672611199,1672612926,1727
7728,3512683609,3311274543,1672595415,1672598153,2738
7505,3791942683,3432689543,1672611930,1672613709,1779
7483,3881477378,3501692334,1672567097,1672567959,862
7755,3604539807,3304056063,1672697996,1672700437,2441
7507,3770021824,3510173870,1672581818,1672583564,1746
7873,3668898102,3783531004,1672688090,1672689927,1837
7800,3817316561,3510771358,1672613207,1672615066,1859
7872,3716197887,3378686918,1672557487,1672557610,123
7627,3430352815,3701184889,1672632005,1672633916,1911
7594,3834257412,3510937904,1672557956,1672560494,2538
7492,3773465237,3513164386,1672603774,1672607124,3350
7968,3839849341,3466911760,1672609635,1672612914,3279
7952,3454042520,3516514391,1672547209,1672547449,240
7886,3357483218,3624312512,1672634964,1672635881,917
7830,3517077106,3367902229,1672611308,1672611696,388
7563,3819727225,3601879040,1672547980,1672548914,934
7786,3365942576,3485823740,1672582895,1672584566,1671
7705,3829232696,3500487333,1672630812,1672632470,1658
7891,3783206719,3715581279,1672533127,1672534359,1232
7587,3755943611,3773664987,1672604693,1672607268,2575
7930,3835382117,3817621391,1672547077,1672548882,1805
7736,3279721246,3517077106,1672568593,1672569334,741
7607,3713208927,3514719601,1672580471,1672581105,634
7771,3289061738,3701967560,1672650361,1672653629,3268
7935,3416265063,3277669002,1672636453,1672639641,3188
7805,3364543015,3510937904,1672546264,1672549553,3289
7919,3777514571,3511170269,1672683444,1672686319,2875
7959,3793627961,3791115967,1672620220,1672623509,3289
7566,3703013906,3493507965,1672552542,1672554483,1941
7796,3505702787,3311065516,1672544598,1672545066,468
7918,3774195321,3509604974,1672542867,1672543586,719
7612,3852391257,3629935998,1672666146,1672668653,2507
7707,3402943525,3770824086,1672552217,1672553203,986
7626,3505912939,3817621391,1672635295,1672635722,427
7739,3247815299,3932051427,1672667171,1672670708,3537
7707,3703661585,3755625324,1672616823,1672620252,3429
7686,3825229501,3402943525,1672531874,1672533875,2001
7759,3909606423,3600647945,1672654432,1672654574,142
7854,3533371364,3407673904,1672653498,1672653820,322
7676,3805347939,3509352754,1672629985,1672632678,2693
7662,3421836608,3533810360,1672630750,1672633679,2929
7675,3776513891,3773978034,1672537701,1672539635,1934
7509,3511359172,3500199935,1672584380,1672585755,1375
7856,3792253549,3715339701,1672639398,1672639685,287
7900,3731419510,3316222192,1672674172,1672675922,1750
7630,3500894271,3901877072,1672618893,1672620170,1277
7978,3610695419,3517255726,1672593211,1672594609,1398
7483,3500803339,3770078063,1672571050,1672573777,2727
7861,3520931254,3505201246,1672682478,1672683738,1260
7905,3451432842,3533095755,1672682645,1672685380,2735
7682,3500904641,3311274543,1672698285,1672698410,125
7876,3505362057,3621810464,1672535452,1672536884,1432
7800,3473562469,3517077106,1672588418,1672591952,3534
7617,3883861463,3716746253,1672635660,1672636445,785
7563,3791901535,3304056063,1672555595,1672557341,1746
7778,3829319703,3247815299,1672552250,1672555807,3557
7529,3488244966,3249401741,1672591958,1672594708,2750
7967,3519703355,3384951177,1672567488,1672570439,2951
7652,3515284591,3303751772,1672598698,1672601620,2922
7488,3412980697,3770824086,1672598579,1672601950,3371
7540,3519069599,3420432297,1672697422,1672700380,2958
7573,3770824086,3774005526,1672548064,1672550352,2288
7765,3925402713,3883042241,1672586365,1672588699,2334
7733,3385763781,3770635361,1672531564,1672534420,2856
7578,3500994774,3791602225,1672598249,1672600379,2130
7686,3615046771,3793436995,1672582754,1672585619,2865
7718,3791942683,3701065786,1672626915,1672630443,3528
7595,3466911760,3715339701,1672649595,1672652343,2748
7659,3420700674,3628819436,1672668041,1672670919,2878
7698,3511170269,3773664987,1672609355,1672612779,3424
7827,3533025282,3294803686,1672533865,1672535067,1202
7593,3229665776,3303705369,1672683832,1672686543,2711
7966,3432689543,3755511676,1672651744,1672652233,489
7516,3703735129,3815508790,1672543889,1672546167,2278
7783,3520931254,3477375368,1672619390,1672621517,2127
7495,3516065852,3780503655,1672639263,1672640272,1009
7526,3777929708,3703789494,1672622157,1672624589,2432
7590,3510937904,3404058699,1672590762,1672593658,2896
7876,3910886626,3505973226,1672603381,1672605275,1894
7753,3291227780,3713969578,1672689817,1672692090,2273
7946,3611150562,3972364603,1672605379,1672608595,3216
7776,3276993580,3780609808,1672613692,1672616167,2475
7732,3828624701,3517864478,1672563669,1672565680,2011
7687,3224058172,3473562469,1672678576,1672681653,3077
7525,3345207877,3360993964,1672698614,1672700116,1502
7570,3489962019,3637008488,1672542631,1672544093,1462
7665,3760294205,3416241005,1672616807,1672618879,2072
7554,3883312122,3666553782,1672694477,1672696429,1952
7924,3836573197,3501486692,1672631034,1672634000,2966
7619,3791602225,3755392666,1672590664,1672592557,1893
7593,3701863557,3859525941,1672649126,1672650290,1164
7933,3271938399,3311152102,1672545796,1672547316,1520
7822,3284832486,3359239884,1672633793,1672635667,1874
7802,3701274634,3791957752,1672543449,1672545876,2427
7671,3473765852,3400918687,1672677261,1672680092,2831
7609,3512349371,3667680268,1672582407,1672584859,2452
7909,3209551760,3757602960,1672533837,1672535121,1284
7901,3792473331,3223789409,1672592950,1672593155,205
7551,3454042520,3777443199,1672626131,1672627808,1677
7958,3380035798,3777443199,1672533754,1672534082,328
7576,3511862351,3773814927,1672605166,1672606359,1193
7715,3519556068,3298288268,1672617623,1672620258,2635
7610,3774005526,3621497531,1672560459,1672562542,2083
7494,3222448362,3512217942,1672547208,1672549359,2151
7602,3402943525,3600647945,1672653071,1672653744,673
7811,3420432297,3411618230,1672574969,1672577698,2729
7908,3510247121,3505292701,1672661065,1672661934,869
7659,3446948848,3904408902,1672678631,1672680627,1996
7659,3770851318,3201324715,1672659707,1672663092,3385
7716,3394330287,3489728806,1672698079,1672698684,605
7890,3517077106,3664517356,1672673015,1672675858,2843
7876,3206603608,3827222533,1672575761,1672579169,3408
7646,3802367797,3805292782,1672673246,1672674759,1513
7782,3501606184,3277939457,1672686051,1672688955,2904
7531,3777514571,3618045231,1672564150,1672566421,2271
7579,3279721246,3399433690,1672575079,1672576618,1539
7677,3792288302,3701178711,1672578063,1672579343,1280
7970,3716488385,3901990690,1672665649,1672667245,1596
7626,3519601612,3516960534,1672658317,1672659327,1010
7499,3889232789,3774520233,1672694803,1672694986,183
7883,3777120536,3399433690,1672699181,1672700428,1247
7519,3703871468,3304056063,1672578001,1672581345,3344
7719,3533810360,3505702787,1672662954,1672663067,113
7606,3734828619,3605726278,1672536834,1672537939,1105
7878,3519654779,3779528381,1672549441,1672549857,416
7922,3760077057,3510173870,1672601085,1672601623,538
7969,3889232789,3713969578,1672641286,1672642824,1538
7738,3511359172,3500365158,1672684778,1672686472,1694
7570,3399535232,3703955926,1672572509,1672574386,1877
7915,3770021824,3209027249,1672652702,1672653732,1030
7603,3770824086,3520030713,1672538128,1672540372,2244
7620,3711370563,3517864478,1672640067,1672642329,2262
7559,3883042241,3311274543,1672677338,1672679122,1784
7781,3520719611,3512217942,1672539129,1672539934,805
7950,3667680268,3481502100,1672685229,1672686698,1469
7969,3273500349,3772884106,1672688624,1672691983,3359
7934,3972709319,3517077106,1672695818,1672699335,3517
7618,3756623396,3511332835,1672577799,1672580578,2779
7492,3668898102,3481647420,1672555430,1672557166,1736
7686,3776800213,3936227020,1672564291,1672567762,3471
7958,3227457126,3519556068,1672606669,1672607087,418
7581,3779629905,3713786889,1672621648,1672623013,1365
7752,3554917400,3518496488,1672608660,1672609108,448
7548,3791115967,3520030713,1672582577,1672586129,3552
7593,3807987001,3735319397,1672591906,1672594133,2227
7976,3223789409,3930791338,1672636821,1672638819,1998
7715,3517721725,3755392666,1672612056,1672614289,2233
7867,3510380060,3828432634,1672694069,1672695136,1067
7574,3713808837,3496051529,1672647622,1672649024,1402
7537,3505193212,3473765852,1672677838,1672677955,117
7691,3312664885,3755943611,1672544456,1672547578,3122
7906,3793753089,3666457294,1672546232,1672548392,2160
7852,3454042520,3793962300,1672651282,1672651832,550
7942,3511332835,3756528686,1672611607,1672612699,1092
7592,3791942683,3519556068,1672579740,1672580112,372
7935,3505859863,3208844525,1672561764,1672564286,2522
7640,3520183192,3500177712,1672645213,1672645686,473
7902,3793627961,3605726278,1672678529,1672679786,1257
7802,3778780511,3519152550,1672559451,1672560764,1313
7512,3388637594,3791594391,1672649926,1672652691,2765
7664,3418728074,3855000166,1672680227,1672681993,1766
7878,3791115967,3773978034,1672555822,1672557370,1548
7982,3713208927,3701178711,1672583632,1672586281,2649
7927,3701534009,3406784491,1672574693,1672577240,2547
7863,3505347134,3201324715,1672655801,1672657110,1309
7826,3774466457,3516223597,1672589063,1672589293,230
7483,3891751546,3427283336,1672558215,1672560717,2502
7863,3467773920,3776066388,1672600698,1672604001,3303
7493,3776338577,3770553384,1672628289,1672630744,2455
7608,3517459919,3242408357,1672545644,1672548129,2485
7928,3930791338,3621810464,1672540255,1672543398,3143
7528,3791874383,3780788622,1672691574,1672691849,275
7899,3909606423,3520012395,1672538516,1672541521,3005
7983,3511198618,3776800213,1672575863,1672579019,3156
7670,3791334389,3397418363,1672682278,1672683998,1720
7623,3774127586,3716900301,1672632649,1672633277,628
7794,3772642849,3889750851,1672593294,1672596204,2910
7925,3348261553,3505791599,1672570044,1672573596,3552
7962,3600647945,3713808837,1672675336,1672676844,1508
7664,3932051427,3813052709,1672654196,1672654811,615
7940,3792902982,3773429448,1672671083,1672671803,720
7857,3792032359,3500487333,1672556753,1672557726,973
7925,3703871468,3505912939,1672577954,1672578078,124
7961,3346795719,3379589402,1672615831,1672618134,2303
7781,3618873142,3533025282,1672682252,1672683327,1075
7784,3780365428,3519654779,1672631294,1672633177,1883
7793,3533748232,3711973519,1672678407,1672680817,2410
7526,3407954858,3200691026,1672548654,1672548751,97
7707,3505791599,3610695419,1672566431,1672568034,1603
7745,3791901535,3304056063,1672607045,1672610162,3117
7702,3505219850,3512540951,1672674177,1672676957,2780
7603,3713349754,3777120536,1672571604,1672573282,1678
7813,3600647945,3935627557,1672534916,1672536013,1097
7848,3312333615,3715339701,1672546426,1672547725,1299
7601,3533385867,3552314511,1672561608,1672562555,947
7919,3792883665,3822654369,1672568475,1672569507,1032
7525,3857349323,3755920131,1672569171,1672572719,3548
7498,3734496778,3688683847,1672664134,1672664670,536
7939,3836573197,3391261292,1672597437,1672599208,1771
7531,3607748895,3935127663,1672609554,1672610611,1057
7912,3736790081,3714821932,1672662838,1672664394,1556
7972,3378436155,3772309150,1672593660,1672596947,3287
7529,3637008488,3780609808,1672596613,1672598380,1767
7516,3505292701,3201848640,1672622592,1672623613,1021
7893,3395152943,3518876135,1672683945,1672684080,135
7792,3732481297,3634340855,1672634979,1672635709,730
7967,3711973519,3701065786,1672630493,1672630649,156
7612,3505203158,3311648200,1672578310,1672579356,1046
7545,3793871337,3430352815,1672699132,1672699800,668
7721,3780593036,3757447189,1672669436,1672671445,2009
7724,3519912874,3311993075,1672701447,1672704527,3080
7508,3534553510,3412825109,1672681929,1672683213,1284
7819,3489545239,3924549929,1672623653,1672625153,1500
7824,3883861463,3933210486,1672685413,1672688959,3546
7871,3501364586,3387966152,1672676143,1672677467,1324
7770,3774338212,3235635976,1672688794,1672690932,2138
7711,3826633236,3420432297,1672567074,1672567707,633
7701,3390068992,3703275621,1672687338,1672687924,586
7732,3701984666,3757682496,1672701036,1672703852,2816
7524,3930797455,3852391257,1672608336,1672610195,1859
7788,3618873142,3505912939,1672583564,1672584379,815
7834,3511271692,3774268456,1672561052,1672562375,1323
7583,3473562469,3516980378,1672535835,1672536325,490
7640,3711571712,3559110998,1672562125,1672563345,1220
7714,3777514571,3337544549,1672633624,1672636041,2417
7499,3555214688,3514245078,1672544721,1672545411,690
7814,3772359096,3629547065,1672582316,1672585733,3417
7571,3512142794,3493507965,1672622491,1672622847,356
7636,3760492950,3505173328,1672568051,1672570683,2632
7756,3511125626,3666457294,1672690248,1672692635,2387
7890,3339907603,3924549929,1672681124,1672682071,947
7595,3756453423,3516629436,1672578859,1672579514,655
7903,3388286531,3791874383,1672668013,1672671575,3562
7793,3209383861,3208844525,1672667428,1672667504,76
7652,3792177074,3311274543,1672658013,1672658957,944
7766,3377766165,3415546117,1672635096,1672638342,3246
7970,3432665384,3500894271,1672555522,1672558167,2645
7888,3756462516,3756462516,1672692311,1672695067,2756
7702,3716488385,3634340855,1672625363,1672627087,1724
7745,3351008918,3515151980,1672656146,1672659525,3379
7812,3617734118,3519152550,1672610765,1672611408,643
7769,3284832486,3760077057,1672695111,1672695580,469
7763,3711569060,3289061738,1672539988,1672542978,2990
7687,3624761861,3505193212,1672646263,1672649718,3455
7909,3756453423,3501927421,1672688201,1672689537,1336
7629,3505702787,3818255890,1672591049,1672591798,749
7631,3510969660,3505635228,1672652540,1672655218,2678
7790,3889750851,3244389794,1672681709,1672682739,1030
7695,3273500349,3714474557,1672615198,1672617842,2644
7703,3778305740,3618045231,1672557699,1672559071,1372
7506,3433804879,3613995936,1672548614,1672551595,2981
7495,3481647420,3713630656,1672552679,1672554512,1833
7814,3701146057,3776800213,1672538494,1672542008,3514
7553,3912536808,3511312803,1672551458,1672555013,3555
7735,3738274418,3501759100,1672658477,1672659552,1075
7841,3534492426,3710067113,1672589527,1672590052,525
7727,3359910781,3715581279,1672536533,1672538330,1797
7606,3825229501,3519069599,1672655481,1672656852,1371
7854,3518014636,3639847263,1672668479,1672670509,2030
7700,3816853177,3505599848,1672663099,1672663207,108
7607,3482405588,3774556560,1672672355,1672674815,2460
7931,3909606423,3792902982,1672580808,1672581454,646
7577,3792883665,3402943525,1672615637,1672618637,3000
7781,3911159965,3777806071,1672609947,1672611617,1670
7539,3701863557,3516514391,1672633133,1672633269,136
7816,3338367113,3505702787,1672618664,1672620916,2252
7822,3345207877,3209551760,1672596278,1672597916,1638
7564,3311208440,3883551721,1672601961,1672604950,2989
7835,3311274543,3829232696,1672650222,1672650548,326
7580,3780914982,3293695955,1672650345,1672651398,1053
7639,3716746253,3757403279,1672633536,1672635891,2355
7974,3446948848,3221536550,1672634372,1672634596,224
7527,3774501422,3517459919,1672697217,1672699337,2120
7876,3520719611,3209551760,1672543284,1672544721,1437
7724,3930797455,3608868877,1672682322,1672682809,487
7631,3485375593,3973560347,1672540115,1672542376,2261
7798,3736625083,3231056870,1672584840,1672588027,3187
7491,3701967560,3882291183,1672613587,1672614236,649
7852,3511359172,3249247700,1672699983,1672702359,2376
7523,3388286531,3500177712,1672694022,1672696597,2575
7673,3339907603,3380035798,1672581886,1672584596,2710
7717,3509352754,3715127362,1672624206,1672625356,1150
7680,3760569731,3420432297,1672537278,1672538933,1655
7672,3516909237,3774195321,1672594991,1672595319,328
7770,3715974031,3714474557,1672599154,1672599227,73
7641,3520629279,3933210486,1672627923,1672630085,2162
7533,3438645253,3500894271,1672635449,1672636637,1188
7960,3516960534,3774366875,1672633114,1672633320,206
7952,3778780511,3757562897,1672633879,1672637448,3569
7522,3485823740,3777806071,1672576461,1672577216,755
7920,3607748895,3383922351,1672553839,1672554737,898
7628,3247428249,3517459919,1672671794,1672673807,2013
7544,3227158514,3505347134,1672649438,1672651059,1621
7506,3755625324,3774066725,1672609337,1672610896,1559
7895,3288764520,3357483218,1672567901,1672568574,673
7677,3809916577,3513201436,1672597292,1672597763,471
7980,3378686918,3882242815,1672669607,1672671368,1761
7686,3307097200,3223789409,1672650721,1672651421,700
7900,3711380716,3660493209,1672652056,1672655013,2957
7509,3510711755,3773950140,1672639084,1672641641,2557
7636,3891751546,3774127586,1672677571,1672678790,1219
7507,3637008488,3223968713,1672532408,1672534562,2154
7579,3428674539,3500458761,1672685166,1672688060,2894
7589,3518876135,3500894271,1672620025,1672621964,1939
7847,3500365158,3280964728,1672619045,1672622595,3550
7920,3973560347,3201848640,1672634354,1672636347,1993
7741,3514245078,3501606184,1672582067,1672582547,480
7643,3778980116,3516258476,1672595147,1672597939,2792
7614,3516465662,3910454786,1672589297,1672591634,2337
7966,3517476351,3755436115,1672653899,1672655255,1356
7729,3420432297,3512142794,1672628835,1672629193,358
7874,3715581279,3311274543,1672568825,1672571014,2189
7930,3918247820,3703735129,1672636423,1672638388,1965
7746,3755042098,3318697153,1672668117,1672671535,3418
7683,3302626661,3409474775,1672658098,1672660715,2617
7730,3793627961,3859663348,1672610191,1672613684,3493
7541,3510857360,3534313900,1672675544,1672677536,1992
7743,3606812411,3772746272,1672638676,1672641862,3186
7892,3518360734,3783429780,1672538959,1672541545,2586
7942,3352603894,3311208440,1672551497,1672553913,2416
7713,3634786711,3773465237,1672692658,1672693717,1059
7979,3378436155,3510594211,1672611617,1672613330,1713
7815,3516258476,3622054816,1672700727,1672702216,1489
7951,3607748895,3443698222,1672671637,1672672412,775
7567,3516016437,3477375368,1672642878,1672644903,2025
7909,3930797455,3925402713,1672636837,1672639581,2744
7909,3716273414,3755436115,1672660147,1672663014,2867
7932,3500066230,3605726278,1672548170,1672550551,2381
7798,3227158514,3367902229,1672703445,1672705033,1588
7872,3400918687,3513454145,1672588770,1672590255,1485
7940,3533927138,3513956646,1672642784,1672645616,2832
7525,3247780536,3345207877,1672695362,1672695424,62
7508,3420700674,3388372715,1672684226,1672685257,1031
7678,3793286136,3534729133,1672532763,1672536191,3428
7792,3518260334,3235635976,1672567026,1672568683,1657
7968,3701178711,3772544062,1672664859,1672667221,2362
7895,3520376528,3365278081,1672644965,1672648121,3156
7545,3534488837,3688683847,1672546718,1672548950,2232
7681,3607748895,3336742544,1672539571,1672541907,2336
7937,3220716272,3520888296,1672661603,1672662563,960
7571,3222448362,3777623166,1672626395,1672629451,3056
7827,3552314511,3505000737,1672619803,1672621416,1613
7897,3465254146,3515151980,1672632208,1672633050,842
7825,3273500349,3716900301,1672545036,1672547229,2193
7957,3634995491,3284639858,1672673125,1672675937,2812
7567,3475795792,3471220483,1672570556,1672571078,522
7656,3925620998,3505962865,1672533284,1672535797,2513
7868,3311761694,3505347134,1672676668,1672678216,1548
7681,3829319703,3618045231,1672605359,1672607555,2196
7659,3242408357,3430504438,1672657101,1672657823,722
7764,3280615985,3505873261,1672629954,1672630096,142
7552,3604539807,3397418363,1672591476,1672594736,3260
7849,3505477652,3209383861,1672689466,1672692895,3429
7615,3516606733,3773978034,1672584967,1672585451,484
7589,3505791599,3291235378,1672585524,1672587227,1703
7859,3515860749,3773205565,1672541207,1672541602,395
7865,3604539807,3509672210,1672657188,1672659212,2024
7813,3714504419,3501364586,1672564613,1672564788,175
7757,3668005723,3315583351,1672694306,1672696526,2220
7905,3793627961,3307512479,1672550780,1672552348,1568
7941,3505869747,3755739653,1672642381,1672644671,2290
7852,3813052709,3415546117,1672692764,1672694359,1595
7806,3236102733,3791997875,1672598114,1672598723,609
7717,3438645253,3311274543,1672661089,1672661570,481
7880,3206254161,3807987001,1672548147,1672551096,2949
7524,3383922351,3777514571,1672674795,1672677163,2368
7800,3510703546,3516629436,1672540402,1672541850,1448
7793,3812176780,3516258476,1672564890,1672566930,2040
7633,3716835696,3291883916,1672690937,1672691138,201
7521,3607178184,3482405588,1672586358,1672588978,2620
7646,3783925755,3534424200,1672578688,1672580010,1322
7906,3500391167,3518876135,1672615099,1672616280,1181
7612,3516716179,3757602960,1672614361,1672617500,3139
7900,3477649378,3774366875,1672622219,1672624824,2605
7741,3755587522,3716165213,1672696965,1672698186,1221
7922,3773978034,3485008994,1672616517,1672616888,371
7741,3783126683,3777776687,1672571077,1672571503,426
7669,3500458761,3716900301,1672589819,1672590545,726
7546,3516065852,3500229033,1672658259,1672661228,2969
7892,3501759100,3434642576,1672699043,1672699978,935
7805,3351008918,3922275620,1672565185,1672567483,2298
7639,3791115967,3421127249,1672596258,1672596797,539
7504,3601879040,3713644518,1672546695,1672547922,1227
7563,3278365525,3533810360,1672593481,1672594884,1403
7744,3280615985,3209048907,1672658939,1672660226,1287
7932,3511350608,3834257412,1672683024,1672683593,569
7845,3859663348,3534191820,1672564953,1672565129,176
7840,3517721725,3472130842,1672581160,1672584274,3114
7803,3311761694,3909238838,1672630487,1672631616,1129
7623,3701178711,3478194807,1672564265,1672567218,2953
7673,3793436995,3755943611,1672596808,1672600046,3238
7615,3520183192,3935627557,1672552610,1672553161,551
7750,3421127249,3710408395,1672564077,1672566512,2435
7671,3383661227,3512720680,1672685035,1672686188,1153
7596,3779528381,3337544549,1672593852,1672596932,3080
7630,3791594391,3391915121,1672538267,1672541455,3188
7546,3773598056,3482405588,1672548569,1672550496,1927
7979,3970117174,3932051427,1672682214,1672684769,2555
7944,3475251781,3533748232,1672591277,1672594302,3025
7882,3276640712,3682061100,1672601708,1672601827,119
7783,3520030713,3384951177,1672683353,1672684431,1078
7917,3639847263,3485008994,1672544563,1672546749,2186
7588,3209383861,3518014404,1672538587,1672539919,1332
7924,3711308224,3757246925,1672694091,1672696395,2304
7861,3606987130,3624761861,1672639524,1672641037,1513
7702,3483164654,3739106581,1672601311,1672604297,2986
7490,3791874383,3405494240,1672578988,1672579371,383
7725,3903307060,3791874383,1672646597,1672649056,2459
7800,3714474557,3791942683,1672586481,1672589849,3368
7650,3792384220,3364543015,1672609236,1672611206,1970
7604,3432665384,3730517636,1672580990,1672584572,3582
7823,3710344260,3249791738,1672534751,1672534846,95
7494,3417970574,3301107849,1672697539,1672697724,185
7914,3467773920,3505912939,1672662952,1672663926,974
7486,3485008994,3713894336,1672607521,1672608377,856
7933,3496051529,3736419952,1672597403,1672599667,2264
7824,3209048907,3936227020,1672629299,1672630297,998
7526,3518408774,3792768129,1672702544,1672704745,2201
7713,3336751428,3510594211,1672532761,1672536230,3469
7942,3510173870,3711973519,1672566563,1672566691,128
7697,3534729133,3859525941,1672602204,1672603962,1758
7581,3500805881,3801089989,1672535782,1672537413,1631
7617,3519703355,3220716272,1672636424,1672636690,266
7665,3533626375,3475396323,1672535413,1672538193,2780
7494,3501730685,3466229085,1672578462,1672578822,360
7675,3559110998,3780503655,1672643147,1672643231,84
7977,3518260334,3823600322,1672624137,1672625243,1106
7590,3277939457,3621810464,1672641952,1672642911,959
7801,3701498253,3518408774,1672612755,1672614514,1759
7629,3931941795,3610348516,1672649511,1672650470,959
7735,3520190170,3792789881,1672636571,1672637712,1141
7863,3303751772,3777790718,1672536926,1672540341,3415
7951,3342131135,3772714862,1672670929,1672673327,2398
7572,3756453423,3500487333,1672591248,1672591496,248
7752,3500458761,3703013906,1672577435,1672580905,3470
7598,3384951177,3713808837,1672683955,1672686400,2445
7912,3294803686,3852391257,1672697059,1672697290,231
7945,3333896808,3770635361,1672687013,1672687269,256
7957,3714197325,3935127663,1672533289,1672535846,2557
7576,3209383861,3883042241,1672669576,1672670229,653
7596,3827222533,3937224533,1672656198,1672658518,2320
7929,3520751702,3733891182,1672665612,1672665794,182
7735,3880285638,3314245084,1672536597,1672538493,1896
7887,3828432634,3756021689,1672609691,1672610227,536
7912,3513454145,3600647945,1672605438,1672607640,2202
7853,3501692334,3703955926,1672551555,1672554827,3272
7502,3318166135,3533371364,1672537026,1672539682,2656
7963,3367902229,3624761861,1672540706,1672541680,974
7788,3756021689,3921211276,1672618062,1672618848,786
7980,3811694763,3365942576,1672568455,1672569958,1503
7638,3808324264,3883551721,1672646987,1672648964,1977
7602,3417061462,3291227780,1672620218,1672621878,1660
7613,3301107849,3428674539,1672624706,1672627861,3155
7764,3510937904,3714474557,1672660514,1672661195,681
7669,3805519285,3777120536,1672633091,1672633233,142
7922,3716900301,3829232696,1672663967,1672664088,121
7667,3757562897,3201848640,1672601553,1672604458,2905
7960,3608868877,3772758337,1672687525,1672687757,232
7696,3500391167,3500994774,1672631174,1672633838,2664
7775,3911159965,3518260334,1672612018,1672613324,1306
7895,3791553060,3344364444,1672694170,1672696570,2400
7544,3711380716,3833889105,1672562542,1672563013,471
7573,3465202715,3888559320,1672541374,1672542497,1123
7944,3534010629,3505635228,1672634403,1672637967,3564
7575,3515125508,3519803045,1672610427,1672611446,1019
7833,3777623166,3294803686,1672575204,1672575476,272
7738,3713808837,3783509527,1672702604,1672703487,883
7563,3417061462,3520206212,1672623162,1672625224,2062
7915,3783531004,3832902928,1672554131,1672554229,98
7601,3701995648,3433804879,1672622874,1672624806,1932
7711,3783239924,3357483218,1672647994,1672648949,955
7705,3755872268,3465202715,1672657698,1672660517,2819
7785,3613995936,3639847263,1672603770,1672603954,184
7808,3391915121,3604539807,1672624881,1672625361,480
7834,3388372715,3480687894,1672592144,1672594180,2036
7598,3388372715,3510937904,1672546626,1672549946,3320
7542,3428964059,3756462516,1672598704,1672599008,304
7602,3489545239,3505869747,1672622727,1672625657,2930
7974,3311208440,3791553060,1672607123,1672610289,3166
7618,3755392666,3533193862,1672598381,1672600918,2537
7905,3701984666,3774298222,1672653733,1672656250,2517
7550,3901877072,3777623166,1672575463,1672575656,193
7925,3780294829,3780365428,1672546119,1672549274,3155
7813,3314245084,3555214688,1672634347,1672635525,1178
7754,3613995936,3801089989,1672633298,1672636108,2810
7697,3891751546,3666457294,1672605279,1672606259,980
7689,3510771358,3756021689,1672606761,1672610312,3551
7664,3827377568,3559110998,1672656035,1672656146,111
7724,3311324983,3338367113,1672703093,1672705986,2893
7640,3505702787,3832902928,1672567514,1672568479,965
7756,3777929708,3772758337,1672550664,1672550908,244
7877,3387674757,3224716315,1672635949,1672637128,1179
7807,3430074045,3277605882,1672619244,1672621307,2063
7573,3512142794,3774580701,1672633497,1672637036,3539
7534,3505219850,3828624701,1672573283,1672575861,2578
7821,3500066230,3910886626,1672652578,1672654516,1938
7887,3811171116,3374559242,1672581178,1672582181,1003
7577,3889750851,3407725581,1672579441,1672581983,2542
7565,3271938399,3311993075,1672537435,1672537615,180
7781,3509933351,3833889105,1672627278,1672629165,1887
7533,3370752401,3826759140,1672624704,1672627592,2888
7553,3624312512,3432665384,1672538519,1672540580,2061
7577,3513956646,3711262377,1672584474,1672584575,101
7670,3534313900,3682061100,1672557397,1672558248,851
7763,3792253549,3828365570,1672571829,1672572604,775
7969,3701967560,3316222192,1672568900,1672571382,2482
7818,3882291183,3247815299,1672647772,1672650962,3190
7803,3668898102,3348261553,1672613306,1672615543,2237
7485,3234362962,3512166013,1672675929,1672678563,2634
7485,3774050956,3365830990,1672699171,1672702589,3418
7507,3359239884,3430504438,1672587164,1672590411,3247
7971,3415443558,3505912939,1672611722,1672613658,1936
7965,3475396323,3518496488,1672581752,1672585153,3401
7563,3714821932,3493507965,1672628226,1672629529,1303
7705,3910454786,3688418210,1672657146,1672659873,2727
7488,3515860749,3772746272,1672699723,1672703064,3341
7885,3307097200,3533653428,1672563544,1672566600,3056
7937,3755392666,3489962019,1672672905,1672674508,1603
7740,3715492942,3420700674,1672670146,1672671357,1211
7954,3779528381,3802367797,1672584531,1672587747,3216
7823,3477375368,3800886801,1672562572,1672564279,1707
7749,3388372715,3400918687,1672667948,1672671007,3059
7771,3417587765,3895562476,1672616228,1672617985,1757
7691,3533280269,3793959750,1672694880,1672696484,1604
7499,3465202715,3303751772,1672654874,1672657005,2131
7814,3972709319,3533827120,1672611966,1672612186,220
7703,3772884106,3519428855,1672694621,1672698032,3411
7869,3792473331,3778305740,1672610224,1672613230,3006
7505,3407725581,3903307060,1672556780,1672558142,1362
7862,3783245561,3337544549,1672650967,1672651926,959
7651,3890149705,3715127362,1672667012,1672667191,179
7692,3736625083,3774050956,1672602356,1672605064,2708
7733,3885897503,3458539365,1672681162,1672681928,766
7574,3311415018,3610348516,1672691791,1672692459,668
7883,3338367113,3311439795,1672640035,1672640300,265
7592,3518669703,3348261553,1672673586,1672675772,2186
7683,3387966152,3385763781,1672602185,1672603552,1367
7943,3513454145,3756462516,1672619172,1672621732,2560
7780,3770635361,3778780511,1672617715,1672621144,3429
7646,3902383721,3793959750,1672537561,1672539579,2018
7621,3505635228,3791874383,1672660479,1672661152,673
7734,3513454145,3736786443,1672586863,1672587054,191
7855,3823600322,3399535232,1672699743,1672701178,1435
7651,3201848640,3779740455,1672607048,1672610224,3176
7548,3515125508,3510173870,1672626623,1672629162,2539
7587,3427283336,3855000166,1672665925,1672668575,2650
7706,3484995752,3925620998,1672548187,1672550614,2427
7885,3388372715,3780828689,1672698979,1672702143,3164
7639,3510711755,3828624701,1672637035,1672640585,3550
7927,3360506772,3713349754,1672604429,1672606172,1743
7660,3713969578,3774204963,1672633708,1672636771,3063
7847,3780503655,3660493209,1672682758,1672683832,1074
7755,3774119563,3772053179,1672623736,1672627041,3305
7609,3533927138,3777936328,1672639793,1672642057,2264
7975,3779036831,3516065852,1672561904,1672562627,723
7544,3318697153,3386707783,1672538273,1672540897,2624
7972,3490191091,3935127663,1672540014,1672541984,1970
7791,3407673904,3777455223,1672535158,1672536204,1046
7963,3737051610,3793389510,1672663372,1672664165,793
7512,3519563836,3828432634,1672612158,1672614522,2364
7832,3500805881,3534010629,1672673153,1672674436,1283
7781,3501184421,3807987001,1672592251,1672593186,935
7745,3801089989,3399004969,1672641761,1672643901,2140
7981,3510173870,3903962771,1672689948,1672693407,3459
7971,3513201436,3606186086,1672613047,1672614186,1139
7572,3606186086,3885897503,1672605546,1672608935,3389
7601,3434642576,3711370563,1672572164,1672572505,341
7569,3404058699,3979339287,1672697864,1672700641,2777
7844,3633420270,3224058172,1672703808,1672707008,3200
7849,3518260334,3791334389,1672696827,1672698892,2065
7553,3510126867,3793436995,1672627198,1672629860,2662
7498,3852595551,3534729133,1672602584,1672603274,690
7914,3517721725,3918056059,1672640517,1672641911,1394
7624,3501692334,3388286531,1672617189,1672618565,1376
7791,3515151980,3517476351,1672537407,1672537551,144
7941,3608868877,3780813786,1672570162,1672572735,2573
7783,3516514391,3500805881,1672573281,1672573621,340
7694,3756027749,3792902982,1672608726,1672609429,703
7787,3774466457,3346795719,1672554641,1672557647,3006
7833,3311648200,3715998609,1672700436,1672700913,477
7790,3818255890,3773755137,1672691771,1672692652,881
7907,3715581279,3509907947,1672643030,1672645087,2057
7632,3473765852,3780365428,1672594983,1672598235,3252
7570,3501606184,3505973226,1672606089,1672608680,2591
7724,3511687358,3910454786,1672550618,1672551636,1018
7652,3617055293,3624761861,1672607122,1672608735,1613
7659,3881477378,3276993580,1672586752,1672589534,2782
7660,3285400528,3777079686,1672670372,1672673964,3592
7542,3492478793,3756027749,1672611073,1672611501,428
7539,3780365428,3500199935,1672604688,1672606649,1961
7588,3792902982,3668898102,1672703046,1672705156,2110
7615,3791553060,3757682496,1672549709,1672550193,484
7501,3715981584,3500894271,1672599845,1672600703,858
7763,3278365525,3921211276,1672636697,1672637256,559
7522,3411618230,3358871377,1672693683,1672694925,1242
7756,3496269445,3224716315,1672604079,1672605611,1532
7788,3505347134,3386707783,1672627022,1672629374,2352
7843,3780639480,3783429780,1672575948,1672577088,1140
7725,3776513891,3731106822,1672545979,1672549566,3587
7786,3777079686,3770824086,1672534401,1672537339,2938
7969,3370636709,3772337814,1672687281,1672690428,3147
7830,3389115045,3378092448,1672666709,1672667082,373
7822,3512837326,3515691540,1672531668,1672535186,3518
7872,3834257412,3513201436,1672614645,1672614962,317
7536,3701065786,3515125508,1672615234,1672616991,1757
7789,3921211276,3770851318,1672620502,1672620637,135
7488,3606987130,3509630174,1672613696,1672615802,2106
7486,3778108318,3909331423,1672552613,1672554576,1963
7936,3773598056,3518496488,1672610227,1672610645,418
7693,3517459919,3773429448,1672640002,1672641141,1139
7940,3901990690,3520376528,1672698373,1672701237,2864
7564,3774298222,3820354437,1672610824,1672610911,87
7820,3289061738,3407954858,1672693010,1672695348,2338
7503,3519654779,3910886626,1672537727,1672540469,2742
7939,3711504540,3601879040,1672664554,1672667838,3284
7972,3512217942,3505098372,1672639830,1672643371,3541
7711,3505203158,3510380060,1672650147,1672653536,3389
7693,3660493209,3475251781,1672546316,1672549044,2728
7647,3533385867,3772053179,1672541474,1672541953,479
7524,3533385867,3770078063,1672558453,1672561223,2770
7949,3711370563,3249401741,1672561022,1672562918,1896
7715,3770078063,3713268590,1672696606,1672696874,268
7676,3756623396,3480687894,1672666631,1672667512,881
7896,3505912939,3519563836,1672694258,1672696924,2666
7711,3811171116,3513201436,1672641372,1672642960,1588
7861,3513454145,3533827120,1672537467,1672540879,3412
7695,3487171044,3688683847,1672615204,1672615957,753
7575,3511350608,3683766533,1672651484,1672652639,1155
7573,3912536808,3415443558,1672641080,1672642444,1364
7807,3459030804,3365830990,1672640060,1672643528,3468
7501,3286658957,3291227780,1672589543,1672592321,2778
7612,3793753089,3505962865,1672589961,1672590270,309
7650,3232962003,3618045231,1672611986,1672614235,2249
7556,3703013906,3778266283,1672561487,1672562575,1088
7755,3407954858,3311090974,1672629490,1672631016,1526
7577,3880310724,3510969660,1672550635,1672552136,1501
7768,3774268456,3601879040,1672547835,1672549629,1794
7537,3792032359,3386707783,1672679559,1672681027,1468
7911,3853018906,3772758337,1672592745,1672594004,1259
7644,3921211276,3616944364,1672612120,1672614450,2330
7908,3512837326,3972709319,1672549396,1672549657,261
7970,3500365158,3333896808,1672698589,1672701511,2922
7751,3477649378,3703275621,1672592561,1672595237,2676
7486,3813052709,3715981584,1672678723,1672678912,189
7626,3312333615,3244389794,1672628675,1672628932,257
7716,3471220483,3511198618,1672572461,1672574461,2000
7566,3400918687,3510247121,1672647181,1672650513,3332
7588,3805342762,3510247121,1672565087,1672565418,331
7616,3351008918,3235635976,1672657595,1672658595,1000
7736,3829232696,3975287541,1672556384,1672559864,3480
7933,3517721725,3534488837,1672584038,1672584625,587
7501,3711198793,3701995648,1672694643,1672697094,2451
7775,3628819436,3247780536,1672633093,1672633708,615
7653,3777455223,3791115967,1672682662,1672684108,1446
7948,3783196518,3533280269,1672702147,1672704731,2584
7555,3511312803,3373384732,1672550298,1672551596,1298
7968,3424922204,3713786889,1672546409,1672547645,1236
7673,3826759140,3505791599,1672702260,1672704784,2524
7485,3783196518,3836573197,1672626598,1672628886,2288
7692,3770021824,3416427576,1672604959,1672608228,3269
7589,3513599775,3820354437,1672554544,1672557235,2691
7612,3303751772,3311761694,1672672590,1672674144,1554
7549,3515691540,3406784491,1672644706,1672647073,2367
7963,3519700826,3384240055,1672621932,1672625365,3433
7636,3666507626,3760992710,1672646861,1672648393,1532
7718,3533653428,3510711755,1672576593,1672579159,2566
7744,3232962003,3443698222,1672644649,1672644783,134
7614,3477649378,3713370078,1672675726,1672677240,1514
7982,3666506258,3428006164,1672662701,1672663763,1062
7817,3296471982,3701498253,1672603801,1672605707,1906
7657,3703223015,3517509185,1672684079,1672684983,904
7639,3809059934,3490191091,1672592584,1672595663,3079
7919,3201432789,3223789409,1672547781,1672548192,411
7864,3685187183,3511350608,1672663198,1672664032,834
7772,3890149705,3791657947,1672618311,1672620799,2488
7823,3222448362,3277605882,1672615085,1672616798,1713
7951,3738274418,3883085535,1672654469,1672655655,1186
7863,3780503655,3518014404,1672627428,1672628126,698
7723,3222521619,3776800213,1672565232,1672566738,1506
7673,3626156564,3755042098,1672688548,1672691917,3369
7511,3454042520,3501927421,1672559362,1672560091,729
7733,3793848402,3443698222,1672559270,1672561372,2102
7764,3711571712,3715339701,1672643940,1672645564,1624
7935,3500805881,3509453566,1672543140,1672543580,440
7702,3370636709,3443698222,1672622743,1672625709,2966
7685,3505904952,3770078063,1672667716,1672670898,3182
7973,3792883665,3229665776,1672623677,1672625532,1855
7805,3774298222,3604539807,1672695715,1672698991,3276
7967,3899204805,3511170269,1672592057,1672594365,2308
7580,3334033993,3293695955,1672632454,1672634231,1777
7855,3416265063,3223789409,1672614203,1672615424,1221
7887,3518014636,3922275416,1672593280,1672593600,320
7583,3713208927,3392121505,1672702322,1672703395,1073
7807,3516909237,3427283336,1672575648,1672575847,199
7615,3610695419,3755436115,1672593051,1672593863,812
7548,3711973519,3517476351,1672584404,1672586235,1831
7705,3716746253,3715981584,1672534203,1672534770,567
7673,3911245524,3247428249,1672605103,1672606292,1189
7683,3777806071,3703441914,1672534358,1672537705,3347
7485,3910886626,3519428855,1672682372,1672683697,1325
7602,3666507626,3459030804,1672585839,1672588009,2170
7733,3774127586,3394539273,1672651747,1672652813,1066
7629,3715974031,3780788622,1672615925,1672617060,1135
7976,3904408902,3809484172,1672536333,1672539019,2686
7608,3859663348,3511687358,1672560154,1672562609,2455
7577,3518014404,3500805881,1672678836,1672681203,2367
7758,3533137446,3227457126,1672574285,1672575069,784
7863,3978105277,3600647945,1672631695,1672634963,3268
7826,3364543015,3829319703,1672614146,1672615441,1295
7708,3280964728,3247780536,1672598823,1672601301,2478
7932,3291227780,3510244400,1672565703,1672568953,3250
7563,3517077106,3685818092,1672574715,1672575700,985
7714,3209027249,3505649239,1672557746,1672558571,825
7974,3377766165,3415443558,1672638489,1672640243,1754
7496,3516065852,3935127663,1672640433,1672642865,2432
7555,3880285638,3505791599,1672700460,1672701950,1490
7654,3520756859,3715998609,1672552238,1672554782,2544
7775,3505219850,3501955238,1672572248,1672574712,2464
7843,3311845971,3516065852,1672609159,1672611065,1906
7527,3710098970,3511125626,1672651443,1672652346,903
7833,3517963492,3780593036,1672564598,1672565084,486
7812,3520709480,3935127663,1672552505,1672553600,1095
7761,3361230905,3891751546,1672549253,1672552780,3527
7961,3909238838,3516716179,1672548416,1672549836,1420
7858,3500365158,3296471982,1672654744,1672655762,1018
7612,3772309150,3701863557,1672593576,1672595233,1657
7885,3772578994,3396086535,1672630443,1672631512,1069
7673,3774793839,3296471982,1672567143,1672569037,1894
7898,3451432842,3505873261,1672700475,1672701848,1373
7692,3534729133,3793959750,1672632466,1672632782,316
7818,3394330287,3792253549,1672581489,1672584474,2985
7813,3917088658,3360993964,1672622476,1672625551,3075
7521,3731419510,3520719611,1672551979,1672553908,1929
7816,3922275416,3291883916,1672703405,1672705379,1974
7722,3791553060,3496051529,1672568734,1672570441,1707
7651,3611150562,3516629436,1672572537,1672575334,2797
7752,3926700506,3701863557,1672683953,1672684038,85
7597,3823600322,3359910781,1672675175,1672675787,612
7855,3417587765,3783245561,1672680406,1672680704,298
7515,3881477378,3916289176,1672630840,1672631844,1004
7878,3783239924,3511125626,1672686817,1672689954,3137
7692,3818255890,3346795719,1672652595,1672652760,165
7695,3514838220,3518163778,1672660739,1672661782,1043
7785,3668005723,3533270638,1672603551,1672606540,2989
7810,3777790718,3881477378,1672694832,1672698239,3407
7980,3736786443,3476232529,1672686025,1672686096,71
7523,3772714862,3716273414,1672661212,1672664690,3478
7968,3294803686,3792668962,1672614147,1672617470,3323
7914,3883312122,3374559242,1672653332,1672655122,1790
7738,3791115967,3909331423,1672621557,1672623295,1738
7902,3394330287,3791957752,1672679634,1672681237,1603
7972,3774119563,3792668962,1672665432,1672666407,975
7515,3477649378,3378092448,1672576690,1672576976,286
7672,3288764520,3509933351,1672540023,1672543282,3259
7899,3783429780,3511841857,1672703639,1672704921,1282
7626,3770824086,3520888296,1672581803,1672583735,1932
7736,3760561634,3278365525,1672537608,1672538385,777
7502,3357483218,3493507965,1672684173,1672687009,2836
7536,3404058699,3505000737,1672645544,1672648237,2693
7661,3882242815,3701691675,1672685847,1672688732,2885
7766,3510126867,3770763956,1672692551,1672695490,2939
7930,3286658957,3715974031,1672618028,1672620998,2970
7484,3701146057,3511271692,1672642406,1672644168,1762
7594,3805519285,3511687358,1672577064,1672577506,442
7662,3311090974,3510937904,1672595474,1672597576,2102
7956,3809484172,3666507626,1672585806,1672586274,468
7628,3510969660,3757403279,1672601618,1672604818,3200
7564,3201324715,3778108318,1672612746,1672614779,2033
7797,3244389794,3714474557,1672686294,1672689708,3414
7783,3774338212,3777806071,1672579788,1672583334,3546
7973,3932051427,3378436155,1672659211,1672661069,1858
7493,3701498253,3701498253,1672649738,1672653137,3399
7822,3518014404,3756601594,1672542909,1672543851,942
7674,3757682496,3505973226,1672670402,1672673085,2683
7716,3315583351,3512969370,1672628627,1672628839,212
7616,3800886801,3200198928,1672555275,1672557330,2055
7555,3496549058,3800886801,1672570792,1672571472,680
7666,3857349323,3284639858,1672694453,1672697219,2766
7709,3777514571,3513599775,1672545385,1672546475,1090
7572,3289061738,3505973226,1672537223,1672538452,1229
7773,3311439795,3716488385,1672572816,1672574166,1350
7642,3510857360,3555214688,1672545470,1672546209,739
7902,3815508790,3407954858,1672678151,1672681288,3137
7974,3513956646,3857349323,1672539003,1672542047,3044
7807,3511163800,3500658339,1672554675,1672556511,1836
7490,3391915886,3311154569,1672607149,1672607483,334
7975,3757602960,3516629436,1672535357,1672536034,677
7567,3736229191,3520709480,1672611876,1672612581,705
7759,3554917400,3480687894,1672568663,1672569563,900
7717,3518669703,3492478793,1672620960,1672623959,2999
7777,3501927421,3972364603,1672572144,1672574003,1859
7612,3703275621,3883042241,1672612841,1672615251,2410
7800,3443698222,3480687894,1672650809,1672651815,1006
7752,3311324983,3774127586,1672678483,1672681802,3319
7758,3512510536,3224716315,1672688573,1672691254,2681
7546,3755943611,3773814927,1672543359,1672544839,1480
7687,3837094550,3201324715,1672597942,1672600210,2268
7886,3793627961,3774119563,1672588131,1672590701,2570
7755,3505599848,3389115045,1672606054,1672606673,619
7626,3497901842,3800886801,1672539468,1672541662,2194
7838,3793086311,3404058699,1672678145,1672680779,2634
7694,3288764520,3385763781,1672572352,1672573495,1143
7548,3512510536,3715998609,1672643695,1672647117,3422
7941,3715981584,3482405588,1672613117,1672616542,3425
7581,3505791599,3715581279,1672534261,1672537406,3145
7979,3301107849,3293695955,1672622619,1672622892,273
7904,3505000737,3429690204,1672641770,1672644904,3134
7676,3236102733,3783206719,1672570218,1672572189,1971
7960,3291235378,3780828689,1672638041,1672640528,2487
7752,3773429448,3516065852,1672542385,1672544801,2416
7754,3688418210,3208844525,1672628055,1672631426,3371
7840,3513080274,3710112546,1672546919,1672548262,1343
7958,3772309166,3505362057,1672670900,1672671303,403
7880,3360506772,3859663348,1672595218,1672596880,1662
7568,3512142794,3448855696,1672600069,1672600594,525
7695,3791334389,3682061100,1672593996,1672594506,510
7503,3231056870,3505912939,1672551413,1672554224,2811
7668,3432689543,3485823740,1672566563,1672568110,1547
7528,3229665776,3624761861,1672624933,1672628175,3242
7838,3520756859,3792902982,1672631071,1672633413,2342
7863,3979339287,3710569131,1672661843,1672662690,847
7884,3792384220,3909331423,1672532970,1672534493,1523
7700,3534313900,3505859863,1672614804,1672616857,2053
7648,3458539365,3512567240,1672643547,1672644418,871
7595,3783239924,3520165601,1672632480,1672632937,457
7742,3826633236,3816853177,1672676672,1672679507,2835
7621,3890149705,3783429780,1672536238,1672536839,601
7527,3289061738,3451432842,1672598123,1672599565,1442
7805,3271938399,3513956646,1672538008,1672541204,3196
7758,3710408395,3517255726,1672583224,1672586715,3491
7879,3887270940,3889750851,1672540332,1672542592,2260
7589,3512567240,3617055293,1672604991,1672607934,2943
7937,3682061100,3773598056,1672687608,1672688209,601
7754,3518360734,3713630656,1672545770,1672547542,1772
7976,3505219850,3813052709,1672630426,1672631655,1229
7960,3637008488,3405494240,1672655355,1672658844,3489
7945,3901990690,3937224533,1672677506,1672679557,2051
7562,3311065516,3533827120,1672558133,1672560560,2427
7513,3606987130,3779976989,1672622411,1672626005,3594
7660,3365614305,3428964059,1672543150,1672546449,3299
7633,3735733948,3973560347,1672561163,1672563581,2418
7496,3760992710,3516716179,1672661287,1672664146,2859
7603,3773120434,3701184889,1672661836,1672662647,811
7564,3735319397,3817621391,1672638316,1672639647,1331
7802,3714474557,3316173088,1672682202,1672684854,2652
7858,3793338102,3978115672,1672633010,1672634541,1531
7570,3783196518,3556951786,1672672925,1672675839,2914
7624,3886298125,3518014404,1672620204,1672623237,3033
7542,3520709480,3338703270,1672562336,1672563933,1597
7910,3760492950,3774556560,1672627472,1672629267,1795
7689,3606987130,3826415738,1672688974,1672691743,2769
7545,3703013906,3701146057,1672656839,1672657989,1150
7908,3777477395,3202120784,1672609742,1672611462,1720
7780,3515284591,3201432789,1672622343,1672625535,3192
7982,3777623166,3420432297,1672699134,1672701434,2300
7540,3629547065,3513080274,1672573055,1672575061,2006
7872,3918674986,3911245524,1672574531,1672576443,1912
7792,3774366875,3827222533,1672609423,1672610745,1322
7861,3388286531,3496051529,1672678342,1672681600,3258
7959,3701534009,3889232789,1672641344,1672644853,3509
7652,3621497531,3910886626,1672643382,1672643516,134
7822,3399004969,3918056059,1672546048,1672547164,1116
7670,3311993075,3209383861,1672653818,1672654918,1100
7881,3703441914,3307512479,1672632230,1672634917,2687
7803,3279721246,3737051610,1672613778,1672615400,1622
7549,3660493209,3520709480,1672570751,1672574022,3271
7520,3311208440,3396285984,1672703471,1672706013,2542
7787,3220716272,3636867411,1672545859,1672548413,2554
7979,3396086535,3634786711,1672627859,1672629580,1721
7853,3400918687,3780503655,1672557605,1672558635,1030
7501,3487171044,3385763781,1672651869,1672655151,3282
7571,3800886801,3755739653,1672688444,1672689520,1076
7931,3520719611,3667680268,1672643606,1672643690,84
7872,3511359172,3515691540,1672537386,1672539755,2369
7774,3404058699,3777079686,1672649258,1672651477,2219
7742,3533385867,3222521619,1672551167,1672554145,2978
7486,3715339701,3935627557,1672653015,1672654720,1705
7488,3509630174,3783509527,1672536651,1672537825,1174
7548,3509634629,3516673015,1672644345,1672646962,2617
7969,3417587765,3852595551,1672638190,1672638584,394
7487,3510173870,3660493209,1672602086,1672604357,2271
7943,3517963492,3247815299,1672666944,1672668387,1443
7791,3939952128,3825229501,1672582390,1672583023,633
7639,3388286531,3664517356,1672672666,1672676024,3358
7910,3235287260,3851190615,1672631098,1672633613,2515
7499,3756027749,3713370078,1672549848,1672550023,175
7518,3808324264,3776513891,1672534990,1672538200,3210
7577,3736790081,3855424474,1672671639,1672672173,534
7931,3889232789,3411618230,1672572725,1672575069,2344
7810,3701184889,3520376528,1672601839,1672605031,3192
7634,3783531004,3505912939,1672655535,1672658901,3366
7882,3533371364,3625274012,1672686402,1672689067,2665
7748,3501955238,3715974031,1672633838,1672635543,1705
7627,3311274543,3924549929,1672650567,1672651554,987
7843,3714821932,3703889596,1672605782,1672608589,2807
7844,3406784491,3417970574,1672644891,1672645243,352
7791,3201848640,3809484172,1672594553,1672597553,3000
7652,3516606733,3220716272,1672647828,1672651353,3525
7613,3737154119,3448855696,1672542945,1672544490,1545
7793,3688418210,3515151980,1672643951,1672645414,1463
7872,3608868877,3899371911,1672664167,1672665340,1173
7564,3933210486,3319752091,1672584157,1672587495,3338
7920,3518360734,3276640712,1672611947,1672614650,2703
7760,3772309166,3511125626,1672651380,1672654395,3015
7683,3244173074,3783779671,1672554414,1672557918,3504
7629,3392121505,3288764520,1672589164,1672589809,645
7828,3465202715,3493507965,1672550260,1672550640,380
7533,3888559320,3433804879,1672550887,1672552979,2092
7879,3606987130,3505791599,1672578923,1672581451,2528
7522,3489728806,3209027249,1672631627,1672633300,1673
7669,3711571712,3716258994,1672535590,1672536025,435
7842,3703661585,3514472925,1672698362,1672701885,3523
7723,3807987001,3484995752,1672665620,1672666626,1006
7980,3778341199,3730517636,1672545397,1672548850,3453
7767,3520206212,3516980378,1672565770,1672569349,3579
7752,3465254146,3779218771,1672637584,1672639640,2056
7674,3755798867,3517077106,1672700563,1672701185,622
7553,3303705369,3446948848,1672682187,1672682561,374
7867,3792844210,3757562897,1672533895,1672535762,1867
7561,3793848402,3783239924,1672598743,1672599328,585
7885,3811694763,3710344260,1672572054,1672572783,729
7724,3791901535,3311203656,1672652968,1672654034,1066
7981,3922337974,3899204805,1672601217,1672601692,475
7666,3715127362,3357483218,1672574910,1672575773,863
7919,3519601612,3365278081,1672669599,1672672643,3044
7738,3714962248,3424922204,1672571031,1672572199,1168
7671,3617734118,3701184889,1672662296,1672665412,3116
7628,3773120434,3791334389,1672582070,1672584414,2344
7756,3757403279,3772053179,1672626258,1672627465,1207
7612,3428674539,3420700674,1672683577,1672683852,275
7483,3606987130,3394330287,1672692628,1672693268,640
7770,3475258557,3774204963,1672543063,1672543832,769
7531,3772337814,3888559320,1672575462,1672578376,2914
7527,3202120784,3483164654,1672628205,1672629904,1699
7739,3280599164,3903962771,1672543318,1672543378,60
7734,3411618230,3396285984,1672547783,1672550975,3192
7936,3780974443,3800353779,1672569900,1672572291,2391
7574,3777929708,3701534009,1672542733,1672545825,3092
7515,3624761861,3296471982,1672649002,1672649989,987
7604,3360743849,3333896808,1672567193,1672570578,3385
7736,3711370563,3345207877,1672698919,1672699497,578
7626,3711504540,3510771358,1672680495,1672682054,1559
7650,3711262377,3298433163,1672700928,1672702863,1935
7858,3760561634,3399535232,1672661588,1672662244,656
7484,3406784491,3402943525,1672574887,1672574969,82
7931,3510969660,3778341199,1672601338,1672602502,1164
7575,3202120784,3776800213,1672594354,1672595127,773
7681,3520730271,3520190170,1672672245,1672674755,2510
7646,3249247700,3500458761,1672590005,1672590239,234
7823,3416427576,3509672210,1672703604,1672705923,2319
7499,3311324983,3711198793,1672688906,1672691789,2883
7497,3534553510,3701146057,1672692619,1672693697,1078
7617,3555214688,3755739653,1672614480,1672616613,2133
7664,3826759140,3505219850,1672572706,1672575136,2430
7692,3917088658,3221899927,1672626821,1672629888,3067
7691,3780788622,3446948848,1672665311,1672666553,1242
7904,3756966035,3484995752,1672607847,1672610898,3051
7923,3201848640,3736419952,1672641407,1672642977,1570
7977,3715339701,3505883609,1672560983,1672563487,2504
7548,3772746272,3516039895,1672612015,1672614816,2801
7904,3701984666,3791594391,1672688838,1672690791,1953
7726,3816853177,3774339795,1672672927,1672676446,3519
7740,3315583351,3533653428,1672634829,1672636020,1191
7603,3520719611,3534553510,1672672630,1672673504,874
7775,3514838220,3500803339,1672629366,1672630910,1544
7542,3922337974,3903962771,1672631595,1672635117,3522
7770,3760569731,3500229033,1672576195,1672579306,3111
7621,3710098970,3209048907,1672553023,1672556121,3098
7967,3701498253,3518408774,1672549281,1672551758,2477
7769,3311090974,3487171044,1672612575,1672614586,2011
7768,3411618230,3817621391,1672537819,1672539175,1356
7805,3911245524,3516016437,1672691747,1672691999,252
7511,3520190170,3473765852,1672587531,1672587856,325
7814,3883861463,3976633198,1672666922,1672667946,1024
7495,3359239884,3359910781,1672591632,1672591837,205
7722,3779218771,3757602960,1672625710,1672629116,3406
7611,3501927421,3736229191,1672698266,1672701153,2887
7804,3756462516,3818255890,1672537401,1672539593,2192
7924,3202120784,3466229085,1672702843,1672703804,961
7814,3828365570,3515151980,1672645098,1672645907,809
7491,3510937904,3473765852,1672613177,1672615618,2441
7600,3520190170,3296471982,1672635384,1672636736,1352
7896,3817316561,3772578994,1672680838,1672683951,3113
7831,3701995648,3902383721,1672575648,1672578019,2371
7793,3477375368,3757602960,1672692216,1672694017,1801
7614,3511862351,3624312512,1672648086,1672649178,1092
7726,3291883916,3924549929,1672599944,1672601318,1374
7673,3372883226,3701498253,1672546864,1672547112,248
7972,3518791447,3639847263,1672547007,1672550508,3501
7516,3716835696,3819727225,1672562284,1672565491,3207
7770,3774556560,3882242815,1672581865,1672585327,3462
7763,3757602960,3716537575,1672624972,1672626233,1261
7961,3664517356,3533653428,1672587047,1672588899,1852
7930,3500365158,3889750851,1672616184,1672618454,2270
7769,3510711755,3625274012,1672559046,1672562150,3104
7627,3312333615,3780828689,1672533064,1672535605,2541
7777,3313541986,3500578848,1672617667,1672618155,488
7647,3391915121,3973560347,1672641818,1672644382,2564
7583,3294803686,3276640712,1672654830,1672655722,892
7662,3513599775,3235635976,1672651141,1672653631,2490
7521,3774005526,3760489031,1672585205,1672587018,1813
7504,3783531004,3346795719,1672566275,1672566818,543
7546,3432689543,3617734118,1672549923,1672550570,647
7655,3304625412,3779528381,1672631544,1672634279,2735
7763,3312664885,3618873142,1672629811,1672631024,1213
7822,3501927421,3369998498,1672577940,1672580378,2438
7654,3509352754,3349613093,1672539267,1672540156,889
7539,3559110998,3534488837,1672684079,1672685127,1048
7527,3624312512,3385763781,1672622200,1672625515,3315
7529,3773664987,3733891182,1672537786,1672538652,866
7534,3911159965,3505201246,1672569845,1672572676,2831
7808,3280599164,3779218771,1672694545,1672697916,3371
7640,3493507965,3206603608,1672532366,1672533396,1030
7596,3791657947,3755625324,1672546521,1672547661,1140
7550,3221536550,3465254146,1672605924,1672607971,2047
7640,3755587522,3800353779,1672648560,1672652080,3520
7666,3606987130,3772544062,1672672937,1672673075,138
7715,3791657947,3822654369,1672562150,1672565207,3057
7830,3780593036,3760183458,1672674967,1672675630,663
7487,3773205565,3384240055,1672577439,1672577759,320
7964,3280599164,3701995648,1672617790,1672620305,2515
7957,3336751428,3909331423,1672589844,1672590291,447
7525,3555214688,3734496778,1672532846,1672534072,1226
7655,3319752091,3777477395,1672541591,1672544521,2930
7823,3660493209,3311208440,1672698815,1672699661,846
7773,3516016437,3415546117,1672657605,1672657671,66
7764,3465254146,3791657947,1672559801,1672561309,1508
7676,3472130842,3778980116,1672660321,1672662900,2579
7879,3909331423,3774050956,1672537032,1672540081,3049
7543,3510594211,3607178184,1672545451,1672547204,1753
7615,3891751546,3390068992,1672580557,1672583157,2600
7715,3882242815,3505904952,1672566313,1672567442,1129
7667,3756623396,3827377568,1672585796,1672586592,796
7845,3836573197,3428006164,1672572939,1672573443,504
7897,3778305740,3738274418,1672657334,1672660004,2670
7798,3755872268,3311065516,1672562368,1672563607,1239
7891,3917278625,3829319703,1672598559,1672601362,2803
7945,3760492950,3488244966,1672617933,1672618553,620
7623,3412980697,3509773875,1672647303,1672648270,967
7583,3511350608,3200691026,1672592527,1672594945,2418
7591,3429856982,3402943525,1672569255,1672569705,450
7980,3513164386,3512510536,1672607078,1672607633,555
7950,3668005723,3505904952,1672621003,1672623447,2444
7981,3855937514,3735319397,1672621464,1672623924,2460
7910,3520165601,3511687358,1672596253,1672598408,2155
7757,3246596716,3399004969,1672676232,1672678182,1950
7820,3851190615,3519803045,1672588348,1672590566,2218
7643,3500365158,3882242815,1672612988,1672613589,601
7649,3791657947,3779218771,1672694432,1672697725,3293
7854,3513080274,3901990690,1672560232,1672561307,1075
7841,3716537575,3972364603,1672619848,1672620418,570
7668,3793848402,3512510536,1672605299,1672607383,2084
7681,3428006164,3303751772,1672664573,1672666737,2164
7905,3352603894,3855602893,1672689869,1672693343,3474
7592,3509453566,3733189298,1672657921,1672661143,3222
7625,3519152550,3417061462,1672674454,1672677764,3310
7792,3277605882,3222448362,1672598348,1672601295,2947
7696,3703789494,3772309166,1672572066,1672573650,1584
7882,3280964728,3926700506,1672670097,1672671608,1511
7617,3859663348,3776800213,1672686154,1672687319,1165
7823,3311871871,3534702203,1672570066,1672572352,2286
7890,3793470489,3500066230,1672540800,1672544202,3402
7640,3246596716,3773465237,1672675995,1672676904,909
7646,3501955238,3404058699,1672634121,1672635968,1847
7906,3935127663,3312664885,1672659151,1672659505,354
7580,3779629905,3244485293,1672634793,1672638297,3504
7848,3512683609,3416241005,1672581165,1672583381,2216
7885,3519069599,3812176780,1672639940,1672640521,581
7587,3777936328,3685818092,1672699042,1672701953,2911
7519,3668005723,3534492426,1672541060,1672544385,3325
7712,3231056870,3839849341,1672559454,1672561411,1957
7734,3505904952,3774045700,1672652829,1672653126,297
7540,3271938399,3688418210,1672544099,1672545872,1773
7896,3715998609,3930791338,1672548903,1672552416,3513
7702,3901877072,3887270940,1672590483,1672593137,2654
7603,3465254146,3511841857,1672674733,1672676662,1929
7959,3287105466,3756027749,1672556970,1672557369,399
7829,3772642849,3271938399,1672584103,1672587429,3326
7920,3774195321,3349613093,1672540871,1672542809,1938
7893,3360743849,3394539273,1672673923,1672677362,3439
7956,3501601840,3466229085,1672592958,1672595058,2100
7965,3736786443,3756462516,1672654338,1672654652,314
7508,3500374658,3828365570,1672655126,1672657561,2435
7523,3757403279,3629547065,1672606098,1672606949,851
7556,3701111745,3780974443,1672555347,1672558794,3447
7638,3791901535,3774127586,1672571630,1672571793,163
7892,3792902982,3550946908,1672532809,1672532913,104
7665,3311065516,3399433690,1672668364,1672669590,1226
7661,3465254146,3634786711,1672595883,1672598361,2478
7840,3917278625,3505873261,1672628147,1672630312,2165
7678,3424922204,3533193862,1672541692,1672542575,883
7903,3311648200,3774204963,1672595651,1672598375,2724
7714,3902278226,3715981584,1672662993,1672665048,2055
7921,3898995675,3517476351,1672570748,1672572508,1760
7726,3518014404,3792844210,1672660609,1672663364,2755
7543,3511862351,3208844525,1672581131,1672582364,1233
7505,3518163778,3286658957,1672690028,1672690831,803
7667,3774127586,3520165601,1672680550,1672682727,2177
7895,3813052709,3517864478,1672609623,1672611033,1410
7615,3428674539,3910454786,1672676205,1672679124,2919
7763,3792668962,3918056059,1672601983,1672602620,637
7729,3882242815,3286658957,1672558819,1672560648,1829
7738,3453729665,3973560347,1672685669,1672686050,381
7586,3816454165,3510244400,1672637789,1672641169,3380
7607,3826760240,3882997884,1672586306,1672586715,409
7571,3533827120,3500199935,1672702386,1672704072,1686
7736,3780593036,3311439795,1672532155,1672534578,2423
7571,3509933351,3246596716,1672660094,1672661942,1848
7849,3930791338,3629935998,1672550715,1672552402,1687
7525,3342131135,3360506772,1672564836,1672568341,3505
7631,3453729665,3716746253,1672640496,1672644091,3595
7535,3430504438,3311603601,1672692684,1672695766,3082
7745,3420432297,3756601594,1672591805,1672592545,740
7579,3500658339,3809916577,1672555010,1672558449,3439
7601,3515860749,3779629905,1672619442,1672620191,749
7973,3228165483,3344364444,1672666176,1672667241,1065
7953,3478194807,3816454165,1672644549,1672646938,2389
7890,3756623396,3509352754,1672537711,1672539115,1404
7575,3303705369,3808324264,1672615909,1672616478,569
7655,3473562469,3520719611,1672637577,1672640017,2440
7507,3311648200,3485008994,1672656028,1672658988,2960
7730,3895562476,3713808837,1672558680,1672561425,2745
7960,3774050956,3247815299,1672587836,1672588140,304
7916,3488244966,3811694763,1672677506,1672680697,3191
7969,3500805881,3710569131,1672672930,1672673340,410
7731,3517509185,3827222533,1672682410,1672684449,2039
7601,3780788622,3221899927,1672697230,1672697594,364
7703,3793470489,3624312512,1672590502,1672590783,281
7972,3359910781,3666506258,1672547096,1672548784,1688
7553,3519912874,3855424474,1672596869,1672597917,1048
7725,3227457126,3224058172,1672693917,1672694728,811
7782,3247815299,3509630174,1672566966,1672567208,242
7876,3931941795,3734496778,1672552221,1672552924,703
7788,3379256399,3387966152,1672614221,1672614684,463
7600,3364543015,3793086311,1672643276,1672643845,569
7680,3783245561,3713894336,1672590619,1672590912,293
7661,3277669002,3365278081,1672619432,1672621523,2091
7645,3500391167,3936227020,1672597603,1672599125,1522
7654,3793627961,3533748232,1672548621,1672551747,3126
7746,3301107849,3360506772,1672683645,1672687240,3595
7536,3774501422,3383661227,1672629974,1672632843,2869
7679,3716273414,3505292701,1672546641,1672548743,2102
7851,3616944364,3383922351,1672584401,1672586116,1715
7912,3826415738,3772337814,1672665636,1672669136,3500
7716,3713894336,3467773920,1672558535,1672561024,2489
7719,3302626661,3515284591,1672598726,1672602298,3572
7535,3311603601,3755392666,1672618816,1672620149,1333
7627,3505219850,3716746253,1672679053,1672681808,2755
7653,3715974031,3432665384,1672564912,1672566829,1917
7573,3480687894,3779976989,1672604219,1672604950,731
7863,3834257412,3249791738,1672576105,1672576747,642
7632,3793962300,3826415738,1672683128,1672684675,1547
7706,3520190170,3512567240,1672622522,1672623708,1186
7726,3334033993,3501955238,1672666262,1672669574,3312
7571,3201324715,3774793839,1672597416,1672599079,1663
7835,3853018906,3973560347,1672682111,1672685342,3231
7825,3710408395,3505000737,1672681526,1672681681,155
7851,3500803339,3515691540,1672632029,1672634785,2756
7501,3774066725,3756451663,1672655450,1672657695,2245
7830,3319752091,3399535232,1672627109,1672630457,3348
7847,3773950140,3701184889,1672668785,1672670823,2038
7829,3901877072,3716537575,1672634741,1672637055,2314
7602,3772309166,3855937514,1672691867,1672693568,1701
7728,3520888296,3501955238,1672649588,1672651621,2033
7894,3293695955,3780813786,1672615988,1672616757,769
7943,3793871337,3516258476,1672540995,1672541773,778
7540,3628819436,3304056063,1672588460,1672589980,1520
7523,3520206212,3887270940,1672533301,1672534029,728
7514,3883312122,3880310724,1672680470,1672682157,1687
7601,3512969370,3800353779,1672538240,1672541065,2825
7682,3792032359,3760598102,1672660530,1672661415,885
7892,3344019610,3520931254,1672586223,1672589436,3213
7587,3318697153,3611150562,1672571088,1672572296,1208
7618,3777477395,3390068992,1672663762,1672666668,2906
7767,3476232529,3622054816,1672603258,1672605592,2334
7817,3793286136,3511435497,1672545496,1672547408,1912
7705,3396086535,3365830990,1672565597,1672567963,2366
7593,3621810464,3338367113,1672606505,1672609096,2591
7735,3780639480,3505477652,1672590701,1672592577,1876
7874,3496549058,3512969370,1672575125,1672576475,1350
7878,3417970574,3688418210,1672539480,1672541038,1558
7534,3710408395,3811171116,1672643505,1672643977,472
7941,3511862351,3516065852,1672650842,1672654420,3578
7491,3209551760,3701534009,1672684865,1672685032,167
7745,3388286531,3514719601,1672696899,1672699381,2482
7617,3780294829,3249401741,1672651995,1672655562,3567
7588,3777079686,3513164386,1672646807,1672647328,521
7756,3890149705,3792668962,1672615381,1672618193,2812
7508,3515125508,3278365525,1672619901,1672621492,1591
7730,3415546117,3550946908,1672621047,1672621403,356
7798,3783239924,3420700674,1672689597,1672690383,786
7647,3778308417,3344364444,1672618202,1672619719,1517
7823,3710344260,3773978034,1672590083,1672591464,1381
7903,3774005526,3935127663,1672598976,1672600416,1440
7632,3688683847,3533270638,1672624920,1672625163,243
7547,3755436115,3500199935,1672612461,1672613485,1024
7620,3783239924,3307097200,1672587302,1672590894,3592
7953,3517077106,3311603601,1672583413,1672584286,873
7680,3276993580,3820354437,1672586093,1672587877,1784
7964,3511687358,3826759140,1672548847,1672550955,2108
7817,3922275620,3714197325,1672618410,1672618642,232
7486,3485008994,3500658339,1672625046,1672628109,3063
7939,3501759100,3357483218,1672558204,1672558528,324
7666,3418728074,3505973226,1672560550,1672563492,2942
7538,3792883665,3716258994,1672592303,1672595085,2782
7902,3516223597,3809916577,1672592391,1672595324,2933
7799,3475251781,3383661227,1672574091,1672577333,3242
7881,3395152943,3715974031,1672690067,1672693403,3336
7851,3711308224,3511687358,1672573711,1672574333,622
7525,3364543015,3756623396,1672565611,1672568355,2744
7694,3534488837,3302626661,1672661712,1672662878,1166
7605,3517459919,3395152943,1672661184,1672661892,708
7592,3972709319,3405494240,1672674866,1672676898,2032
7737,3777717988,3473765852,1672592414,1672594305,1891
7921,3222448362,3485823740,1672592148,1672593071,923
7661,3613995936,3760294205,1672564656,1672565324,668
7974,3336751428,3421127249,1672559988,1672560449,461
7511,3509907947,3755872268,1672693117,1672693680,563
7865,3512540951,3910886626,1672632665,1672634102,1437
7487,3909238838,3703275621,1672574470,1672575238,768
7583,3713969578,3935627557,1672619124,1672620384,1260
7546,3760992710,3518163778,1672536669,1672538780,2111
7910,3378436155,3475795792,1672545073,1672546687,1614
7549,3629547065,3917278625,1672649839,1672650989,1150
7600,3301107849,3247780536,1672646517,1672646681,164
7609,3817316561,3342131135,1672574541,1672577995,3454
7802,3554917400,3817621391,1672666825,1672669045,2220
7655,3429690204,3756930948,1672628671,1672629942,1271
7937,3783509527,3895562476,1672647434,1672649757,2323
7542,3791553060,3223789409,1672685390,1672686610,1220
7946,3505362057,3247780536,1672639528,1672640817,1289
7529,3505873261,3378092448,1672586860,1672590128,3268
7709,3882291183,3813052709,1672535266,1672538487,3221
7630,3772337814,3925620998,1672634141,1672634993,852
7591,3711571712,3500487333,1672697310,1672699951,2641
7684,3513201436,3383661227,1672635507,1672639074,3567
7793,3514472925,3500487333,1672595999,1672598375,2376
7553,3774045700,3898995675,1672541607,1672543853,2246
7554,3359239884,3912536808,1672554692,1672558182,3490
7823,3793962300,3713268590,1672632050,1672635512,3462
7510,3412825109,3666457294,1672624908,1672627165,2257
7695,3359239884,3757602960,1672679520,1672682244,2724
7598,3621497531,3918247820,1672616063,1672618331,2268
7866,3760492950,3818255890,1672583130,1672585954,2824
7710,3364543015,3772642849,1672671595,1672671904,309
7497,3364543015,3773120434,1672686199,1672688305,2106
7871,3500458761,3505219850,1672558883,1672559315,432
7615,3760598102,3516016437,1672572978,1672575587,2609
7536,3791657947,3780609808,1672626150,1672626370,220
7557,3773429448,3234362962,1672644315,1672646403,2088
7539,3493507965,3714821932,1672579604,1672581687,2083
7741,3772884106,3516258476,1672692470,1672695207,2737
7865,3516465662,3757562897,1672630734,1672632547,1813
7788,3932051427,3513454145,1672668371,1672670743,2372
7521,3915628728,3494290908,1672667972,1672670908,2936
7663,3242408357,3412980697,1672655821,1672655891,70
7795,3774793839,3939952128,1672589257,1672591149,1892
7819,3337544549,3467773920,1672652055,1672652481,426
7579,3307097200,3808324264,1672654220,1672656591,2371
7970,3777079686,3807987001,1672660961,1672663301,2340
7607,3238712269,3490191091,1672675418,1672676965,1547
7618,3826759140,3783083229,1672687364,1672688106,742
7910,3510247121,3518360734,1672633556,1672634351,795
7843,3500177712,3710067113,1672661570,1672663623,2053
7907,3883085535,3735319397,1672679994,1672680259,265
7534,3516039895,3972364603,1672534323,1672535848,1525
7649,3510126867,3516011407,1672539291,1672540399,1108
7739,3791942683,3234362962,1672669139,1672670978,1839
7905,3515151980,3757602960,1672669441,1672671465,2024
7847,3516960534,3858918246,1672606665,1672607794,1129
7714,3883312122,3501955238,1672598624,1672598906,282
7583,3776338577,3713644518,1672643188,1672646432,3244
7570,3314836094,3716258994,1672588406,1672591029,2623
7968,3505173328,3701190899,1672600236,1672602738,2502
7779,3466911760,3518014636,1672696726,1672696959,233
7606,3360743849,3505869747,1672570222,1672570662,440
7752,3783196518,3791334389,1672688705,1672690352,1647
7795,3512166013,3772758337,1672652224,1672653164,940
7809,3733189298,3777623166,1672679120,1672682584,3464
7636,3755392666,3939952128,1672541542,1672542376,834
7743,3829232696,3271938399,1672643998,1672645515,1517
7949,3510247121,3774125065,1672557428,1672559000,1572
7561,3825229501,3755392666,1672659109,1672662700,3591
7776,3664170666,3852595551,1672557519,1672558774,1255
7599,3277605882,3298288268,1672534137,1672536925,2788
7530,3666553782,3760509236,1672703156,1672703366,210
7655,3883085535,3518014404,1672666983,1672668966,1983
7652,3701498253,3793436995,1672623812,1672626399,2587
7960,3520888296,3890149705,1672605649,1672607282,1633
7529,3512166013,3737079798,1672662245,1672664674,2429
7959,3519428855,3710344260,1672541693,1672542373,680
7614,3311090974,3505347134,1672606250,1672609590,3340
7740,3773120434,3421127249,1672687779,1672689584,1805
7852,3427219654,3533385867,1672648766,1672650897,2131
7550,3346327502,3776338577,1672596653,1672596984,331
7493,3713630656,3791334389,1672659128,1672661430,2302
7646,3835382117,3660493209,1672670688,1672672531,1843
7702,3533025282,3918056059,1672698630,1672699143,513
7760,3365614305,3710098970,1672690132,1672690778,646
7567,3715581279,3883042241,1672702124,1672705151,3027
7657,3713894336,3520183192,1672682591,1672683133,542
7565,3482405588,3478194807,1672544913,1672548475,3562
7917,3242408357,3231056870,1672570392,1672573308,2916
7768,3429856982,3520012395,1672673955,1672675167,1212
7600,3387966152,3512567240,1672626057,1672628765,2708
7784,3930797455,3372883226,1672564104,1672565555,1451
7941,3792177074,3556951786,1672689173,1672689943,770
7557,3519803045,3792789881,1672564472,1672565155,683
7889,3500904641,3391915121,1672697181,1672699528,2347
7903,3372883226,3774366875,1672698506,1672700893,2387
7664,3792253549,3311152102,1672692258,1672694259,2001
7675,3801089989,3501759100,1672627105,1672628115,1010
7738,3467773920,3716168623,1672602287,1672604131,1844
7517,3220716272,3291227780,1672542467,1672545771,3304
7595,3615046771,3271938399,1672580653,1672583202,2549
7636,3287105466,3501483568,1672671207,1672674667,3460
7564,3820354437,3430352815,1672676525,1672679561,3036
7908,3514245078,3519703355,1672574305,1672576691,2386
7687,3377766165,3510244400,1672691223,1672693282,2059
7546,3666553782,3407673904,1672598976,1672599309,333
7693,3311415018,3903009525,1672671187,1672672985,1798
7892,3510857360,3391915886,1672545598,1672547802,2204
7745,3515394721,3624761861,1672613435,1672615088,1653
7812,3370636709,3417061462,1672611645,1672612189,544
7635,3714488548,3471220483,1672545930,1672549044,3114
7665,3667680268,3713349754,1672636117,1672637989,1872
7862,3369998498,3500904641,1672545593,1672546203,610
7503,3247780536,3714504419,1672640729,1672642660,1931
7696,3412980697,3380035798,1672683887,1672686867,2980
7599,3778980116,3904775198,1672634031,1672637496,3465
7749,3773755137,3804870229,1672552825,1672555347,2522
7879,3510711755,3703661585,1672565593,1672568437,2844
7904,3501692334,3714821932,1672611337,1672613957,2620
7900,3774556560,3458539365,1672698532,1672701058,2526
7491,3629547065,3774339795,1672625256,1672628778,3522
7804,3512510536,3899266183,1672577269,1672580252,2983
7960,3688683847,3384951177,1672609561,1672612606,3045
7501,3791602225,3685187183,1672597787,1672598642,855
7956,3473765852,3701184889,1672603807,1672604794,987
7786,3505193212,3902383721,1672628119,1672631468,3349
7888,3392121505,3793470489,1672561019,1672562182,1163
7663,3380035798,3378686918,1672630819,1672633982,3163
7744,3509933351,3352603894,1672651062,1672651409,347
7772,3774338212,3383922351,1672673804,1672676577,2773
7910,3633420270,3772884106,1672597798,1672600658,2860
7917,3200198928,3505173328,1672573720,1672576561,2841
7814,3701863557,3314836094,1672600734,1672601478,744
7657,3512720680,3909606423,1672632144,1672633017,873
7934,3505873261,3244436890,1672622382,1672625903,3521
7970,3701178711,3931941795,1672552180,1672553907,1727
7906,3783196518,3516716179,1672536805,1672540171,3366
7961,3388286531,3336751428,1672655248,1672655488,240
7782,3713349754,3501483568,1672593802,1672594092,290
7554,3757812939,3475258557,1672625455,1672626842,1387
7908,3793627961,3793086311,1672595665,1672597134,1469
7519,3505638204,3489962019,1672629374,1672630524,1150
7723,3925402713,3886298125,1672577837,1672578161,324
7537,3664517356,3685187183,1672590233,1672593092,2859
7581,3760492950,3853018906,1672534006,1672534531,525
7569,3925402713,3511359172,1672699502,1672702821,3319
7769,3756528686,3732481297,1672611351,1672614695,3344
7741,3402943525,3791115967,1672560748,1672564013,3265
7833,3512510536,3477375368,1672700821,1672704361,3540
7879,3914290246,3291883916,1672547207,1672549589,2382
7692,3505962865,3774338212,1672578847,1672582047,3200
7680,3757812939,3533810360,1672621562,1672622781,1219
7627,3287105466,3360993964,1672536061,1672538219,2158
7857,3913251733,3637008488,1672592410,1672595684,3274
7974,3837094550,3715581279,1672646126,1672646963,837
7770,3827377568,3501486692,1672619111,1672619473,362
7942,3937224533,3826759140,1672649059,1672650868,1809
7569,3812176780,3311065516,1672622472,1672624903,2431
7783,3756601594,3510173870,1672601679,1672602710,1031
7862,3628819436,3885670556,1672630416,1672633184,2768
7936,3512837326,3828365570,1672553457,1672556659,3202
7949,3777455223,3372883226,1672651501,1672652706,1205
7922,3607178184,3510126867,1672549346,1672551977,2631
7498,3792789881,3494290908,1672675874,1672676043,169
7574,3777120536,3972364603,1672683488,1672686728,3240
7917,3533137446,3755587522,1672627197,1672628065,868
7631,3772758337,3778266283,1672653723,1672657306,3583
7516,3774119563,3344019610,1672682566,1672683546,980
7776,3701995648,3514128943,1672646627,1672648912,2285
7662,3773950140,3482405588,1672564581,1672565440,859
7801,3367029997,3910886626,1672589257,1672591662,2405
7887,3859663348,3505883609,1672675575,1672679065,3490
7543,3738274418,3855937514,1672553509,1672554350,841
7762,3793338102,3534553510,1672548726,1672550442,1716
7773,3383661227,3792902982,1672607221,1672609478,2257
7762,3634340855,3780365428,1672652000,1672654694,2694
7549,3779976989,3501759100,1672584002,1672585407,1405
7516,3519700826,3710569131,1672551147,1672552309,1162
7763,3888559320,3222448362,1672644740,1672645166,426
7913,3827222533,3311324983,1672531522,1672534986,3464
7726,3378436155,3512510536,1672635493,1672637887,2394
7681,3716835696,3466229085,1672573392,1672576442,3050
7922,3978105277,3505145247,1672541490,1672542899,1409
7761,3534010629,3500458761,1672655420,1672655853,433
7858,3311152102,3829764737,1672668188,1672671536,3348
7716,3714488548,3774195321,1672619916,1672621998,2082
7591,3520030713,3420432297,1672667497,1672669964,2467
7516,3666553782,3518014404,1672703740,1672704747,1007
7487,3777443199,3500391167,1672547469,1672550508,3039
7698,3774005526,3930791338,1672623453,1672625011,1558
7551,3505962865,3278365525,1672698192,1672699294,1102
7643,3516629436,3311324983,1672605429,1672605945,516
7846,3467773920,3380035798,1672653270,1672655375,2105
7949,3883861463,3510173870,1672593057,1672594586,1529
7729,3701967560,3622054816,1672672385,1672674690,2305
7631,3517721725,3370752401,1672696862,1672699587,2725
7925,3296471982,3774204963,1672542723,1672544801,2078
7620,3780813786,3346795719,1672648176,1672650733,2557
7609,3716746253,3811694763,1672595971,1672596841,870
7677,3711308224,3427219654,1672565598,1672568127,2529
7538,3755943611,3284832486,1672601553,1672602343,790
7898,3755881905,3818255890,1672563517,1672565978,2461
7605,3512969370,3776338577,1672647447,1672648660,1213
7612,3791997875,3501601840,1672615345,1672618345,3000
7696,3774793839,3520888296,1672639292,1672642656,3364
7715,3625274012,3770101921,1672548391,1672551381,2990
7612,3473562469,3777079686,1672692960,1672694152,1192
7488,3626156564,3836573197,1672698234,1672698441,207
7827,3757682496,3417061462,1672614081,1672617099,3018
7958,3780788622,3222521619,1672551143,1672554018,2875
7577,3516716179,3621497531,1672660092,1672662832,2740
7717,3755436115,3780639480,1672637489,1672637899,410
7615,3711262377,3533385867,1672642303,1672642396,93
7771,3793338102,3660493209,1672630343,1672631804,1461
7748,3296471982,3711380716,1672642500,1672642963,463
7849,3500060260,3497901842,1672661108,1672661397,289
7909,3770851318,3683959482,1672663753,1672665242,1489
7779,3930797455,3514128943,1672667503,1672670517,3014
7685,3809484172,3890149705,1672580523,1672583745,3222
7781,3778780511,3783083229,1672614665,1672616957,2292
7785,3666506258,3773664987,1672571365,1672573821,2456
7803,3301107849,3755943611,1672702847,1672703572,725
7810,3516039895,3715492942,1672609915,1672610739,824
7792,3770763956,3760492950,1672548653,1672549541,888
7540,3307512479,3772337814,1672589493,1672592285,2792
7913,3509907947,3774466457,1672662079,1672663860,1781
7683,3360506772,3516039895,1672606195,1672606671,476
7508,3359910781,3733891182,1672591990,1672593046,1056
7872,3227457126,3895562476,1672623307,1672624277,970
7972,3734496778,3555214688,1672587384,1672590279,2895
7933,3835382117,3779036831,1672567364,1672567838,474
7682,3277939457,3278365525,1672539286,1672541116,1830
7806,3710067113,3509933351,1672656845,1672658174,1329
7541,3899204805,3511267139,1672640453,1672644009,3556
7840,3885897503,3278365525,1672604749,1672606900,2151
7706,3517864478,3433804879,1672623176,1672624857,1681
7689,3509352754,3778266283,1672666908,1672670284,3376
7572,3701184889,3770851318,1672579218,1672580043,825
7861,3505173328,3392121505,1672583883,1672584345,462
7485,3284639858,3365278081,1672548724,1672551071,2347
7836,3516629436,3511170269,1672686331,1672687911,1580
7493,3448855696,3361230905,1672681316,1672682255,939
7555,3714962248,3791901535,1672562855,1672564227,1372
7860,3232962003,3793627961,1672622011,1672625057,3046
7950,3979339287,3311208440,1672691709,1672695082,3373
7695,3513454145,3734737881,1672591972,1672593815,1843
7739,3772309150,3513164386,1672650278,1672652096,1818
7867,3513599775,3475251781,1672609320,1672610872,1552
7823,3776948966,3733189298,1672676233,1672677129,896
7580,3379256399,3716273414,1672595543,1672597368,1825
7845,3903009525,3826415738,1672684503,1672686224,1721
7686,3418728074,3914259449,1672569887,1672571798,1911
7601,3918056059,3757602960,1672641341,1672642580,1239
7948,3703275621,3514719601,1672585017,1672585867,850
7782,3926700506,3370636709,1672697201,1672697400,199
7783,3505347134,3773664987,1672630551,1672633364,2813
7863,3331845324,3917088658,1672570351,1672573710,3359
7876,3429856982,3634786711,1672563338,1672565305,1967
7892,3939952128,3374559242,1672578160,1672580361,2201
7887,3518876135,3201848640,1672620203,1672621337,1134
7971,3627937312,3443698222,1672640279,1672641396,1117
7678,3792768129,3780593036,1672643544,1672644396,852
7662,3432665384,3514719601,1672663040,1672665698,2658
7523,3853018906,3481502100,1672641976,1672644118,2142
7696,3296471982,3476232529,1672678958,1672679103,145
7624,3520756859,3501198706,1672659478,1672659732,254
7604,3829232696,3970117174,1672698080,1672700604,2524
7681,3500658339,3774366875,1672665188,1672667884,2696
7633,3500458761,3903962771,1672678475,1672678881,406
7697,3501198706,3451432842,1672681921,1672683508,1587
7510,3516960534,3500499542,1672612121,1672612283,162
7762,3813052709,3793470489,1672614026,1672614550,524
7594,3637008488,3280964728,1672569251,1672571344,2093
7785,3829232696,3755920131,1672561377,1672561622,245
7957,3735733948,3607178184,1672566993,1672567132,139
7492,3760294205,3394539273,1672601868,1672604392,2524
7617,3518876135,3791874383,1672623542,1672624797,1255
7499,3480687894,3791997875,1672680664,1672683763,3099
7633,3490191091,3755920131,1672656388,1672657415,1027
7497,3783779671,3399911573,1672569958,1672570865,907
7861,3823600322,3776066388,1672668989,1672672123,3134
7644,3713969578,3388637594,1672560307,1672562669,2362
7854,3500374658,3774005526,1672668611,1672670623,2012
7494,3662180254,3793338102,1672565204,1672567157,1953
7618,3716900301,3331845324,1672671511,1672675000,3489
7832,3774580701,3533193862,1672628761,1672629886,1125
7492,3515284591,3505873261,1672675948,1672676413,465
7951,3777983879,3520376528,1672672335,1672674492,2157
7801,3481647420,3976390453,1672568597,1672572104,3507
7765,3703223015,3336751428,1672582981,1672585063,2082
7732,3519912874,3512720680,1672630965,1672631064,99
7569,3505791599,3513080274,1672570934,1672573444,2510
7861,3909331423,3926700506,1672531948,1672534701,2753
7827,3791115967,3247815299,1672532732,1672536332,3600
7731,3311648200,3777120536,1672681377,1672682365,988
7691,3853018906,3298433163,1672641351,1672644026,2675
7649,3625274012,3713969578,1672703057,1672703890,833
7906,3277939457,3608868877,1672618775,1672620031,1256
7805,3500060260,3518360734,1672672839,1672673141,302
7930,3511841857,3288764520,1672644304,1672645173,869
7959,3513599775,3298288268,1672644212,1672646986,2774
7683,3792473331,3316173088,1672622833,1672624033,1200
7697,3396086535,3277669002,1672627026,1672630340,3314
7811,3401627165,3510711755,1672553603,1672554489,886
7613,3793470489,3429856982,1672604107,1672607167,3060
7891,3805519285,3777790718,1672569276,1672572334,3058
7729,3703661585,3533270638,1672657028,1672659762,2734
7556,3914259449,3772544062,1672636884,1672638423,1539
7567,3318697153,3505873261,1672535826,1672536043,217
7523,3533242305,3711504540,1672564954,1672568042,3088
7561,3711569060,3409474775,1672630052,1672632053,2001
7757,3301107849,3791874383,1672546266,1672548801,2535
7970,3519703355,3510247121,1672561687,1672564428,2741
7690,3777514571,3496269445,1672653246,1672655321,2075
7751,3519703355,3793959750,1672660575,1672661585,1010
7819,3349613093,3505869747,1672573841,1672577110,3269
7564,3209383861,3314245084,1672691131,1672692606,1475
7969,3826759140,3608633356,1672619466,1672619898,432
7532,3710067113,3404384505,1672553809,1672555738,1929
7845,3921211276,3518014404,1672628069,1672630110,2041
7648,3777079686,3889232789,1672686429,1672689100,2671
7584,3296471982,3760893269,1672682838,1672685511,2673
7961,3773205565,3359910781,1672680810,1672682733,1923
7542,3714821932,3511163800,1672548062,1672549487,1425
7584,3703718151,3284832486,1672685576,1672689155,3579
7500,3278365525,3395152943,1672626155,1672629605,3450
7695,3509907947,3701534009,1672557779,1672558186,407
7487,3682061100,3610695419,1672544413,1672545132,719
7979,3713630656,3227457126,1672631742,1672634872,3130
7795,3756966035,3829319703,1672606050,1672608762,2712
7624,3911159965,3639847263,1672641026,1672642852,1826
7651,3756424865,3607178184,1672657326,1672657544,218
7570,3519803045,3917278625,1672571923,1672572874,951
7654,3360993964,3827626797,1672540505,1672543007,2502
7800,3777776687,3855937514,1672537653,1672539253,1600
7557,3505530961,3517459919,1672577157,1672578683,1526
7945,3231056870,3883551721,1672698853,1672700829,1976
7702,3513454145,3388372715,1672616390,1672619171,2781
7790,3405494240,3710408395,1672629249,1672630655,1406
7915,3399911573,3286658957,1672550007,1672551397,1390
7948,3430352815,3776066388,1672626643,1672630086,3443
7754,3505145247,3293695955,1672564304,1672567315,3011
7713,3793753089,3439023335,1672534104,1672536149,2045
7780,3791553060,3736786443,1672592517,1672595157,2640
7733,3825229501,3509634629,1672623947,1672626195,2248
7723,3802367797,3509453566,1672648247,1672649223,976
7570,3611150562,3517077106,1672599707,1672601575,1868
7717,3903962771,3500066230,1672648972,1672652134,3162
7960,3311274543,3276993580,1672670828,1672672648,1820
7771,3505791599,3703871468,1672576344,1672576529,185
7562,3791115967,3793389510,1672540382,1672543526,3144
7569,3370636709,3399433690,1672604944,1672606009,1065
7725,3510244400,3770021824,1672540601,1672543735,3134
7626,3634786711,3783925755,1672629444,1672629600,156
7743,3792883665,3770447408,1672669848,1672671820,1972
7509,3772309166,3926700506,1672567627,1672567817,190
7703,3406784491,3346327502,1672574740,1672575427,687
7790,3773755137,3701863557,1672546846,1672548868,2022
7816,3370752401,3533810360,1672613487,1672615987,2500
7531,3715974031,3500177712,1672624466,1672627271,2805
7935,3713349754,3520756859,1672672573,1672674747,2174
7696,3774066725,3533371364,1672548015,1672551131,3116
7648,3515394721,3520012395,1672680169,1672681114,945
7837,3760569731,3774298222,1672643778,1672645277,1499
7607,3500199935,3778108318,1672670843,1672671516,673
7805,3334033993,3774195321,1672590108,1672592754,2646
7547,3890149705,3774195321,1672628464,1672631477,3013
7509,3312333615,3778308417,1672566458,1672568738,2280
7944,3372883226,3231056870,1672702387,1672704501,2114
7752,3715189301,3510711755,1672682843,1672683181,338
7642,3701498253,3318697153,1672655539,1672656521,982
7889,3776066388,3918247820,1672544549,1672546565,2016
7905,3715339701,3399911573,1672604929,1672606154,1225
7757,3760598102,3772309150,1672660772,1672662587,1815
7653,3895562476,3777983879,1672545227,1672546444,1217
7894,3716197887,3224058172,1672602461,1672604445,1984
7790,3396086535,3760183458,1672540126,1672541371,1245
7736,3973560347,3733891182,1672549116,1672551705,2589
7807,3512142794,3432689543,1672644965,1672646128,1163
7540,3505904952,3229058858,1672678165,1672679232,1067
7752,3304625412,3637008488,1672541563,1672543901,2338
7757,3533385867,3780788622,1672617498,1672619587,2089
7789,3711973519,3770021824,1672607981,1672609879,1898
7552,3885670556,3311415018,1672568250,1672569150,900
7534,3715127362,3713969578,1672562345,1672565817,3472
7652,3510771358,3477649378,1672656900,1672657085,185
7592,3755872268,3454042520,1672660384,1672662507,2123
7651,3793848402,3356860407,1672697160,1672699111,1951
7947,3628819436,3972364603,1672602638,1672605975,3337
7547,3364543015,3209027249,1672696022,1672696279,257
7637,3911245524,3311627628,1672570056,1672571976,1920
7911,3534313900,3369998498,1672552896,1672556102,3206
7536,3737154119,3209383861,1672639189,1672641665,2476
7571,3511170269,3624761861,1672639075,1672641884,2809
7888,3420700674,3314836094,1672647327,1672649828,2501
7777,3610695419,3475251781,1672630959,1672631671,712
7864,3774010081,3500805881,1672569598,1672569899,301
7659,3792789881,3628819436,1672684924,1672687308,2384
7569,3500066230,3533137446,1672639162,1672639838,676
7631,3466911760,3510703546,1672575946,1672576096,150
7875,3883551721,3509352754,1672585087,1672587847,2760
7593,3791997875,3770447408,1672647839,1672650844,3005
7590,3774204963,3519556068,1672554231,1672555875,1644
7827,3361230905,3361230905,1672679489,1672680314,825
7782,3384951177,3713786889,1672640420,1672642472,2052
7709,3373384732,3757161914,1672628712,1672628786,74
7728,3519654779,3509352754,1672558471,1672561502,3031
7497,3505292701,3756601594,1672563785,1672563849,64
7928,3886298125,3512567240,1672611861,1672612235,374
7911,3783239924,3465254146,1672699821,1672702104,2283
7760,3701967560,3514719601,1672564555,1672567339,2784
7928,3420700674,3715492942,1672660209,1672661031,822
7859,3391261292,3505883609,1672702194,1672703605,1411
7823,3793871337,3779218771,1672685881,1672688458,2577
7525,3715339701,3481647420,1672670072,1672672305,2233
7917,3853018906,3421127249,1672666978,1672667189,211
7906,3760893269,3552314511,1672674992,1672676951,1959
7724,3514987389,3666507626,1672545573,1672547612,2039
7628,3793871337,3454042520,1672550129,1672552585,2456
7883,3737154119,3505219850,1672632553,1672634854,2301
7489,3280964728,3780593036,1672604481,1672605747,1266
7739,3716488385,3715492942,1672592604,1672595835,3231
7669,3737051610,3713894336,1672686418,1672689471,3053
7852,3779740455,3780609808,1672639482,1672640646,1164
7636,3511170269,3716900301,1672659371,1672661555,2184
7625,3200198928,3703223015,1672598897,1672599758,861
7759,3500487333,3358871377,1672551837,1672554440,2603
7664,3500994774,3703661585,1672602594,1672605821,3227
7487,3859525941,3701178711,1672535105,1672535456,351
7971,3316173088,3926700506,1672700600,1672700864,264
7818,3883551721,3757403279,1672620713,1672622307,1594
7513,3518014636,3222521619,1672660738,1672662153,1415
7701,3518932404,3852595551,1672671245,1672672271,1026
7689,3510594211,3755625324,1672622722,1672624184,1462
7955,3881477378,3770851318,1672687964,1672691107,3143
7968,3509630174,3714962248,1672566541,1672567745,1204
7890,3757246925,3780788622,1672531284,1672531637,353
7533,3500803339,3606812411,1672608925,1672609764,839
7599,3234541252,3388286531,1672661890,1672665331,3441
7852,3882291183,3298433163,1672578204,1672579596,1392
7863,3206593906,3365942576,1672552356,1672552834,478
7571,3772714862,3711571712,1672620718,1672621361,643
7685,3296471982,3780609808,1672580381,1672582971,2590
7762,3510380060,3297463265,1672693948,1672696209,2261
7855,3703789494,3902278226,1672621533,1672622151,618
7960,3772578994,3793389510,1672574150,1672577405,3255
7924,3756601594,3511312803,1672623420,1672624499,1079
7794,3913251733,3837094550,1672533918,1672535115,1197
7888,3483949762,3770763956,1672698054,1672701202,3148
7623,3780788622,3783126683,1672637430,1672640151,2721
7941,3296471982,3776800213,1672604126,1672604698,572
7756,3505000737,3776338577,1672639577,1672640024,447
7650,3755625324,3713630656,1672535177,1672538750,3573
7485,3407673904,3505869747,1672609511,1672610833,1322
7684,3331845324,3774466457,1672588595,1672590980,2385
7861,3772337814,3711569060,1672558093,1672560379,2286
7816,3779218771,3516629436,1672599517,1672599877,360
7945,3514128943,3333896808,1672583898,1672584275,377
7601,3774501422,3487171044,1672562815,1672563672,857
7808,3501486692,3809916577,1672610473,1672613671,3198
7553,3773978034,3514472925,1672605210,1672605957,747
7865,3756451663,3791942683,1672690243,1672690857,614
7577,3454042520,3791334389,1672596595,1672597291,696
7790,3791020967,3432689543,1672688297,1672689279,982
7664,3518408774,3385763781,1672685958,1672687365,1407
7570,3501198706,3365830990,1672592623,1672595651,3028
7707,3209027249,3228165483,1672610553,1672611432,879
7577,3511359172,3209048907,1672608824,1672612402,3578
7936,3512837326,3715189301,1672640748,1672643031,2283
7549,3505173328,3813052709,1672591857,1672593850,1993
7726,3289061738,3518163778,1672675085,1672677670,2585
7884,3757161914,3760489031,1672532732,1672534857,2125
7897,3291227780,3834257412,1672699308,1672699936,628
7639,3760509236,3359910781,1672625708,1672626080,372
7718,3756623396,3520751702,1672551289,1672552149,860
7953,3770447408,3500805881,1672658641,1672660693,2052
7665,3534313900,3772359096,1672635882,1672638297,2415
7771,3404384505,3202120784,1672635221,1672637351,2130
7774,3774520233,3701863557,1672572058,1672574430,2372
7945,3489962019,3755739653,1672541811,1672543693,1882
7955,3360743849,3516223597,1672605636,1672608328,2692
7925,3618045231,3736419952,1672678890,1672681639,2749
7900,3520629279,3229665776,1672686664,1672688246,1582
7968,3777623166,3533626375,1672642088,1672643872,1784
7582,3206593906,3931941795,1672589321,1672592844,3523
7900,3914259449,3607748895,1672640468,1672641984,1516
7920,3505599848,3733189298,1672635664,1672638460,2796
7713,3505193212,3242408357,1672544647,1672545727,1080
7786,3434642576,3714474557,1672588068,1672591325,3257
7577,3365942576,3434642576,1672537421,1672540211,2790
7867,3510380060,3505530961,1672605483,1672608100,2617
7563,3807987001,3222521619,1672596086,1672598909,2823
7900,3774339795,3500499542,1672616635,1672617416,781
7964,3244485293,3772359096,1672563581,1672565670,2089
7777,3703955926,3397418363,1672657221,1672658945,1724
7514,3446948848,3662180254,1672641747,1672643487,1740
7878,3760294205,3607748895,1672685085,1672688277,3192
7883,3773120434,3373384732,1672614860,1672615644,784
7520,3773814927,3756966035,1672545705,1672547330,1625
7789,3911159965,3783196518,1672674416,1672675854,1438
7698,3828432634,3271938399,1672633028,1672636443,3415
7852,3783509527,3791901535,1672583698,1672585540,1842
7631,3925402713,3791901535,1672610035,1672611623,1588
7664,3509773875,3772544062,1672639903,1672641239,1336
7932,3829319703,3701863557,1672580430,1672582071,1641
7820,3209048907,3793871337,1672582388,1672585636,3248
7868,3426325549,3511170269,1672566618,1672569304,2686
7796,3710344260,3666553782,1672659728,1672660883,1155
7825,3421836608,3805292782,1672653633,1672656192,2559
7705,3710344260,3755625324,1672551564,1672552601,1037
7881,3505000737,3492478793,1672531669,1672535053,3384
7648,3713349754,3816454165,1672646654,1672646821,167
7932,3513201436,3757447189,1672664648,1672666025,1377
7782,3517721725,3616944364,1672601310,1672603533,2223
7729,3291227780,3770824086,1672597820,1672599600,1780
7941,3807987001,3356860407,1672600796,1672601095,299
7678,3534729133,3513080274,1672632257,1672633070,813
7664,3512217942,3555214688,1672702637,1672705628,2991
7809,3351554343,3520888296,1672571499,1672573508,2009
7857,3792288302,3520709480,1672635144,1672635422,278
7937,3500499542,3519700826,1672584652,1672587053,2401
7514,3772309166,3311871871,1672651483,1672652139,656
7807,3618873142,3777443199,1672653462,1672654272,810
7523,3513956646,3311203656,1672559247,1672561444,2197
7570,3703441914,3430352815,1672648334,1672650516,2182
7524,3783531004,3520190170,1672585606,1672586783,1177
7771,3811171116,3778266283,1672632708,1672634683,1975
7514,3418728074,3510247121,1672592438,1672593949,1511
7700,3505173328,3710569131,1672646295,1672647998,1703
7624,3313564074,3396086535,1672582220,1672584164,1944
7738,3514472925,3234541252,1672702540,1672703957,1417
7681,3221536550,3755625324,1672689604,1672689935,331
7653,3716168623,3512969370,1672533370,1672533792,422
7580,3458539365,3780365428,1672661144,1672662685,1541
7753,3372883226,3360743849,1672537687,1672541283,3596
7931,3286658957,3510711755,1672603812,1672606140,2328
7767,3500458761,3890149705,1672653298,1672655352,2054
7569,3505145247,3304625412,1672616888,1672617881,993
7972,3312664885,3975287541,1672546614,1672549128,2514
7709,3481502100,3534191820,1672538710,1672541194,2484
7487,3517255726,3783531004,1672691716,1672692983,1267
7542,3501184421,3510857360,1672631269,1672634693,3424
7559,3359910781,3970117174,1672691889,1672694054,2165
7849,3516980378,3416427576,1672664066,1672666435,2369
7914,3379256399,3703661585,1672593692,1672596473,2781
7813,3313564074,3617734118,1672610336,1672610975,639
7966,3483949762,3509907947,1672695537,1672696989,1452
7918,3501692334,3793470489,1672660605,1672662400,1795
7552,3511841857,3772309150,1672594367,1672597004,2637
7572,3509630174,3298288268,1672587508,1672588946,1438
7979,3519601612,3489217083,1672563125,1672565593,2468
7628,3303751772,3901877072,1672675643,1672678416,2773
7685,3883861463,3774125065,1672531573,1672533199,1626
7806,3885897503,3683959482,1672575784,1672578313,2529
7954,3701967560,3772642849,1672685264,1672687535,2271
7739,3792177074,3757151210,1672632137,1672633668,1531
7510,3222521619,3909606423,1672566830,1672568303,1473
7577,3885897503,3399433690,1672676786,1672677902,1116
7573,3716273414,3465202715,1672591549,1672593730,2181
7898,3770078063,3519152550,1672559121,1672559243,122
7842,3388372715,3418534998,1672652134,1672653577,1443
7530,3792253549,3533626375,1672577086,1672579172,2086
7646,3777806071,3493507965,1672667404,1672670808,3404
7639,3311203656,3760267716,1672567609,1672570775,3166
7886,3223789409,3772053179,1672633078,1672634694,1616
7854,3206593906,3471220483,1672557901,1672559591,1690
7686,3518496488,3606812411,1672605695,1672608456,2761
7539,3772746272,3639847263,1672531821,1672534174,2353
7965,3430352815,3793959750,1672653150,1672655897,2747
7501,3510247121,3378092448,1672693401,1672695675,2274
7559,3806545488,3888559320,1672541415,1672543337,1922
7551,3439023335,3851190615,1672661651,1672663733,2082
7587,3505638204,3932051427,1672700374,1672700719,345
7759,3622054816,3935627557,1672537609,1672540877,3268
7975,3402943525,3703735129,1672654989,1672656655,1666
7807,3901877072,3311603601,1672580985,1672581564,579
7644,3756601594,3711265369,1672590453,1672593812,3359
7783,3510173870,3774556560,1672674056,1672674443,387
7952,3973560347,3418728074,1672641071,1672643144,2073
7922,3711504540,3736592744,1672697633,1672701197,3564
7563,3516606733,3374559242,1672583862,1672584174,312
7511,3816454165,3485375593,1672649005,1672651136,2131
7811,3509634629,3783245561,1672591662,1672594464,2802
7521,3443698222,3416265063,1672549109,1672550338,1229
7734,3417587765,3858918246,1672538737,1672539865,1128
7888,3774010081,3231056870,1672695728,1672698866,3138
7764,3624312512,3660493209,1672553279,1672556275,2996
7848,3713630656,3520751702,1672546266,1672548811,2545
7558,3615046771,3666507626,1672607699,1672608248,549
7903,3501759100,3811694763,1672592973,1672593984,1011
7733,3359910781,3302626661,1672641622,1672643109,1487
7919,3816853177,3485823740,1672634822,1672637496,2674
7512,3817621391,3756528686,1672595552,1672597875,2323
7708,3501483568,3604539807,1672602270,1672603753,1483
7830,3822654369,3828365570,1672556426,1672558988,2562
7765,3448855696,3206593906,1672652092,1672653629,1537
7736,3780294829,3883861463,1672560588,1672563487,2899
7613,3891751546,3404058699,1672557532,1672559036,1504
7692,3885670556,3367902229,1672600805,1672604225,3420
7616,3776513891,3220716272,1672622919,1672626090,3171
7818,3772053179,3428964059,1672593238,1672594938,1700
7926,3494290908,3418534998,1672692233,1672692815,582
7965,3338703270,3776800213,1672590007,1672591186,1179
7859,3517721725,3777455223,1672701656,1672705240,3584
7810,3913251733,3284639858,1672555924,1672556972,1048
7826,3800353779,3489217083,1672611635,1672612758,1123
7827,3510126867,3473562469,1672636827,1672637349,522
7503,3802367797,3512540951,1672559565,1672562850,3285
7886,3520012395,3887270940,1672679354,1672682884,3530
7630,3613683164,3703661585,1672656227,1672656796,569
7810,3510173870,3519601612,1672571191,1672573029,1838
7512,3617734118,3392121505,1672610357,1672610517,160
7554,3730517636,3731419510,1672655386,1672656036,650
7687,3249247700,3757602960,1672618837,1672621659,2822
7654,3459030804,3779976989,1672555192,1672555408,216
7765,3288764520,3737079798,1672672157,1672673393,1236
7916,3756451663,3780639480,1672687680,1672690237,2557
7847,3624761861,3313541986,1672699786,1672700312,526
7724,3278365525,3229058858,1672550395,1672552507,2112
7794,3780788622,3778305740,1672608181,1672610519,2338
7563,3972709319,3516065852,1672698914,1672701083,2169
7771,3372883226,3735733948,1672631076,1672634034,2958
7968,3200198928,3883085535,1672550332,1672550698,366
7601,3978105277,3517721725,1672689616,1672690504,888
7966,3756930948,3311648200,1672695186,1672696974,1788
7568,3311152102,3973560347,1672679306,1672681887,2581
7503,3780974443,3304625412,1672586848,1672587534,686
7696,3624761861,3818255890,1672665218,1672668567,3349
7576,3209048907,3734828619,1672573298,1672576874,3576
7607,3301107849,3430074045,1672585551,1672587405,1854
7639,3735733948,3774005526,1672631325,1672632663,1338
7606,3505173328,3792844210,1672543395,1672544503,1108
7939,3601879040,3899204805,1672645888,1672647667,1779
7533,3231056870,3505098372,1672628907,1672631603,2696
7574,3485008994,3271938399,1672643519,1672644419,900
7908,3513080274,3621810464,1672617196,1672619260,2064
7821,3932051427,3667680268,1672572039,1672573441,1402
7940,3780914982,3770635361,1672641470,1672643804,2334
7955,3791901535,3783429780,1672565867,1672568363,2496
7927,3312333615,3481502100,1672691373,1672692524,1151
7939,3773429448,3534191820,1672657344,1672660792,3448
7727,3418728074,3559110998,1672678284,1672679334,1050
7487,3360506772,3813052709,1672617464,1672620739,3275
7871,3512540951,3304056063,1672635860,1672635940,80
7495,3505530961,3811171116,1672600598,1672602976,2378
7972,3909331423,3235287260,1672631572,1672631656,84
7761,3206254161,3509907947,1672537652,1672537983,331
7578,3755943611,3732481297,1672630595,1672633606,3011
7614,3711198793,3755511676,1672664059,1672664727,668
7600,3404384505,3516039895,1672548123,1672549700,1577
7489,3621810464,3509604974,1672642140,1672645437,3297
7786,3505883609,3636867411,1672583021,1672586154,3133
7911,3891751546,3500729955,1672648781,1672651381,2600
7754,3247815299,3756966035,1672569737,1672572956,3219
7499,3916289176,3534553510,1672608184,1672609320,1136
7620,3711262377,3513599775,1672691193,1672693109,1916
7783,3223968713,3394330287,1672599873,1672601437,1564
7861,3365278081,3888559320,1672647498,1672648840,1342
7820,3520706195,3520756859,1672653440,1672654288,848
7524,3760183458,3780974443,1672578139,1672580832,2693
7876,3613683164,3776513891,1672609630,1672610674,1044
7591,3777983879,3773120434,1672698830,1672702407,3577
7553,3303751772,3772714862,1672683222,1672685252,2030
7866,3812176780,3388286531,1672662216,1672665501,3285
7571,3533653428,3774298222,1672594469,1672597218,2749
7915,3247780536,3312829208,1672638239,1672638664,425
7540,3500458761,3760893269,1672576756,1672577283,527
7983,3511198618,3791334389,1672642263,1672643730,1467
7872,3827222533,3509453566,1672555150,1672557062,1912
7783,3515394721,3793753089,1672553063,1672553377,314
7912,3227457126,3515723720,1672558274,1672558665,391
7574,3626156564,3925620998,1672637306,1672637810,504
7698,3312664885,3519601612,1672633244,1672633458,214
7577,3510711755,3755872268,1672619445,1672622461,3016
7704,3809916577,3829232696,1672675147,1672678047,2900
7605,3516514391,3412825109,1672558165,1672560100,1935
7580,3222521619,3883861463,1672618140,1672619441,1301
7504,3533810360,3289061738,1672556135,1672556667,532
7960,3807987001,3200691026,1672662768,1672665411,2643
7589,3637008488,3234541252,1672646752,1672648165,1413
7773,3756528686,3505193212,1672692653,1672695873,3220
7552,3500803339,3755739653,1672668548,1672671315,2767
7644,3377766165,3311415018,1672618394,1672621076,2682
7594,3756601594,3970117174,1672593899,1672595703,1804
7527,3505649239,3416265063,1672551447,1672554687,3240
7706,3760569731,3220716272,1672680517,1672683724,3207
7803,3773814927,3791115967,1672562472,1672563040,568
7757,3428964059,3835382117,1672534752,1672535245,493
7945,3772544062,3608868877,1672685066,1672685729,663
7913,3639847263,3489545239,1672546094,1672548954,2860
7517,3311324983,3911159965,1672636953,1672637684,731
7499,3774066725,3483164654,1672644149,1672647192,3043
7929,3757455053,3756528686,1672552667,1672556167,3500
7622,3501759100,3384240055,1672670233,1672673459,3226
7935,3533748232,3755798867,1672618389,1672620058,1669
7609,3778108318,3780593036,1672666076,1672666706,630
7743,3710067113,3710067113,1672621998,1672624350,2352
7704,3930797455,3813052709,1672583229,1672584107,878
7982,3533385867,3793338102,1672673398,1672674586,1188
7896,3409474775,3488244966,1672601412,1672603421,2009
7747,3889750851,3895562476,1672694147,1672696516,2369
7770,3806545488,3510244400,1672592496,1672595447,2951
7749,3517864478,3209027249,1672661197,1672661278,81
7658,3773950140,3757455053,1672540277,1672543554,3277
7940,3520730271,3206254161,1672618599,1672621191,2592
7906,3777623166,3818255890,1672574495,1672577974,3479
7975,3357483218,3634995491,1672622977,1672624559,1582
7615,3970117174,3416241005,1672701555,1672702254,699
7680,3395152943,3776513891,1672651527,1672653041,1514
7515,3379256399,3701984666,1672588368,1672590669,2301
7831,3793286136,3387966152,1672577187,1672579191,2004
7841,3534702203,3978115672,1672688124,1672690437,2313
7693,3510247121,3511359172,1672642066,1672645187,3121
7971,3792177074,3778305740,1672674450,1672675278,828
7916,3911245524,3774066725,1672602972,1672605047,2075
7816,3349613093,3400918687,1672645019,1672646513,1494
7656,3472130842,3772714862,1672589209,1672589800,591
7782,3388372715,3760598102,1672667814,1672668856,1042
7802,3756021689,3800886801,1672587640,1672588525,885
7899,3703441914,3511862351,1672692104,1672694652,2548
7696,3826759140,3901990690,1672535298,1672535910,612
7968,3774298222,3417061462,1672649583,1672650542,959
7866,3311761694,3760893269,1672610930,1672614408,3478
7583,3613995936,3701111745,1672636129,1672637822,1693
7818,3490191091,3779036831,1672588441,1672591371,2930
7899,3859525941,3533270638,1672538845,1672540592,1747
7787,3485375593,3201324715,1672535367,1672538054,2687
7688,3284832486,3776066388,1672601265,1672603158,1893
7499,3510857360,3792844210,1672592785,1672594183,1398
7619,3909331423,3497901842,1672620935,1672622216,1281
7853,3899266183,3505599848,1672553675,1672554637,962
7790,3428964059,3715974031,1672649330,1672650814,1484
7610,3829319703,3777477395,1672695796,1672699113,3317
7535,3220716272,3774010081,1672639725,1672641630,1905
7977,3496549058,3512540951,1672691688,1672693297,1609
7524,3365278081,3519069599,1672629427,1672631871,2444
7824,3533369198,3467773920,1672629416,1672632503,3087
7857,3496051529,3518408774,1672699758,1672702555,2797
7873,3825229501,3909331423,1672676950,1672679946,2996
7881,3716835696,3882242815,1672550163,1672551391,1228
7697,3235635976,3533280269,1672565815,1672568980,3165
7535,3391261292,3780914982,1672697166,1672699191,2025
7972,3852391257,3818255890,1672613924,1672615832,1908
7722,3773814927,3515394721,1672564117,1672565605,1488
7590,3975287541,3716258994,1672685548,1672685912,364
7499,3475258557,3802367797,1672549975,1672552724,2749
7978,3402943525,3809484172,1672689828,1672690083,255
7925,3518408774,3512217942,1672603681,1672607162,3481
7927,3736229191,3816454165,1672548347,1672549594,1247
7502,3778549126,3774010081,1672554244,1672557345,3101
7870,3448855696,3792384220,1672576704,1672578531,1827
7582,3483949762,3664170666,1672534457,1672535626,1169
7972,3791553060,3703789494,1672636583,1672638934,2351
7774,3519654779,3489545239,1672595051,1672597549,2498
7518,3703955926,3783509527,1672615665,1672616486,821
7921,3777790718,3701984666,1672670350,1672672086,1736
7632,3617055293,3399052055,1672637794,1672639659,1865
7804,3716537575,3772053179,1672642441,1672643346,905
7556,3716843669,3685187183,1672567859,1672568274,415
7653,3777079686,3666507626,1672694448,1672696576,2128
7709,3519703355,3793848402,1672688056,1672688162,106
7561,3516514391,3337544549,1672542341,1672542996,655
7554,3926700506,3429856982,1672582004,1672585505,3501
7537,3755392666,3459030804,1672690458,1672692289,1831
7941,3829232696,3311761694,1672623118,1672624456,1338
7525,3512217942,3774466457,1672649812,1672649902,90
7838,3757151210,3800353779,1672662840,1672665446,2606
7828,3466911760,3634340855,1672612055,1672615515,3460
7758,3316173088,3505791599,1672590974,1672594145,3171
7927,3770763956,3918056059,1672668356,1672669209,853
7797,3793962300,3610695419,1672613649,1672616244,2595
7807,3774127586,3516980378,1672684622,1672686680,2058
7893,3925620998,3519912874,1672684183,1672687403,3220
7929,3701146057,3505145247,1672594206,1672596089,1883
7927,3349613093,3311648200,1672536811,1672539326,2515
7958,3772309150,3666457294,1672586995,1672590078,3083
7732,3519912874,3772337814,1672655349,1672658311,2962
7968,3466229085,3302626661,1672702174,1672704579,2405
7779,3811171116,3793848402,1672569941,1672572161,2220
7853,3516016437,3713786889,1672562097,1672563396,1299
7524,3760598102,3316173088,1672536490,1672538839,2349
7794,3500229033,3760992710,1672564428,1672565006,578
7537,3473765852,3316222192,1672658674,1672660650,1976
7789,3912262917,3391915121,1672534492,1672536732,2240
7514,3685187183,3465254146,1672672026,1672674410,2384
7632,3482405588,3737154119,1672585730,1672585974,244
7573,3387674757,3516909237,1672653228,1672655672,2444
7837,3666553782,3391915121,1672624463,1672625052,589
7880,3607178184,3517255726,1672556736,1672558130,1394
7692,3534702203,3703275621,1672583060,1672585966,2906
7888,3500904641,3738502357,1672586649,1672588058,1409
7639,3826415738,3404058699,1672656904,1672659561,2657
7591,3454042520,3901877072,1672542460,1672542721,261
7961,3834257412,3516629436,1672622332,1672625116,2784
7576,3731106822,3346327502,1672573510,1672576620,3110
7893,3311203656,3352603894,1672652470,1672655358,2888
7490,3505873261,3777717988,1672637047,1672637494,447
7723,3972709319,3345207877,1672599825,1672601919,2094
7503,3311648200,3358871377,1672610756,1672612985,2229
7813,3805292782,3433804879,1672623045,1672624335,1290
7620,3515394721,3338703270,1672534313,1672537612,3299
7701,3514719601,3399433690,1672546095,1672546276,181
7489,3793962300,3514472925,1672637804,1672639258,1454
7667,3666457294,3500658339,1672541612,1672545033,3421
7551,3793389510,3517864478,1672653652,1672653868,216
7831,3315583351,3392121505,1672612899,1672616362,3463
7961,3783239924,3345207877,1672633503,1672635598,2095
7499,3685187183,3234362962,1672620230,1672621440,1210
7541,3774010081,3733891182,1672624527,1672627524,2997
7750,3510173870,3895562476,1672609793,1672610171,378
7893,3666506258,3391915886,1672565330,1672566960,1630
7560,3793962300,3291883916,1672538267,1672539559,1292
7643,3514283243,3359239884,1672594401,1672596467,2066
7602,3514838220,3793436995,1672561329,1672562063,734
7571,3731419510,3976633198,1672619829,1672620831,1002
7584,3772746272,3513201436,1672628499,1672629386,887
7880,3978115672,3736625083,1672666642,1672669212,2570
7513,3772337814,3682061100,1672688329,1672691252,2923
7503,3756021689,3776513891,1672622101,1672622541,440
7624,3731419510,3346795719,1672644422,1672646610,2188
7794,3660493209,3715981584,1672559882,1672562753,2871
7971,3780609808,3554917400,1672638765,1672639197,432
7800,3701111745,3304056063,1672700181,1672700868,687
7736,3512969370,3701984666,1672683951,1672685665,1714
7822,3516673015,3556951786,1672567158,1672568881,1723
7601,3512720680,3774298222,1672625634,1672627694,2060
7564,3734737881,3501955238,1672672366,1672675879,3513
7880,3901990690,3505098372,1672693726,1672696955,3229
7528,3287105466,3510703546,1672630309,1672630845,536
7584,3505904952,3510126867,1672538683,1672540689,2006
7816,3201324715,3931941795,1672633099,1672634486,1387
7923,3737079798,3505973226,1672640849,1672641350,501
7844,3510173870,3755739653,1672573518,1672574664,1146
7780,3378092448,3234362962,1672586163,1672586289,126
7666,3793753089,3713349754,1672603657,1672606539,2882
7937,3917278625,3519152550,1672611021,1672612358,1337
7806,3489728806,3500994774,1672626622,1672627971,1349
7506,3882291183,3791997875,1672565173,1672568694,3521
7834,3898995675,3922275620,1672667160,1672668738,1578
7967,3825229501,3520165601,1672589401,1672589868,467
7968,3351554343,3918674986,1672587688,1672588215,527
7590,3783126683,3737051610,1672573057,1672575806,2749
7546,3501692334,3370636709,1672555676,1672557188,1512
7757,3714474557,3857349323,1672674639,1672676740,2101
7834,3389115045,3246596716,1672659651,1672662842,3191
7735,3276993580,3613683164,1672690137,1672692811,2674
7858,3715974031,3307097200,1672606001,1672606658,657
7563,3825229501,3222448362,1672640720,1672643394,2674
7819,3935627557,3505869747,1672554159,1672555409,1250
7545,3734737881,3534492426,1672664113,1672667512,3399
7730,3820354437,3533095755,1672690773,1672694116,3343
7957,3344019610,3510126867,1672579891,1672580700,809
7923,3516716179,3311845971,1672685517,1672686157,640
7496,3285400528,3227457126,1672586935,1672589161,2226
7574,3912536808,3606987130,1672589390,1672589556,166
7970,3348261553,3518876135,1672563626,1672566222,2596
7619,3902383721,3481502100,1672662314,1672662793,479
7612,3485375593,3716165213,1672662989,1672663688,699
7962,3311761694,3760294205,1672595467,1672596209,742
7787,3421127249,3829232696,1672669273,1672669579,306
7675,3715492942,3773978034,1672608677,1672610732,2055
7502,3472130842,3772544062,1672545438,1672548470,3032
7518,3773978034,3234362962,1672543289,1672544910,1621
7753,3429690204,3783245561,1672670615,1672673089,2474
7823,3511862351,3533748232,1672659104,1672661142,2038
7812,3777936328,3711308224,1672583881,1672586069,2188
7597,3711569060,3505203158,1672554173,1672555251,1078
7942,3505098372,3852595551,1672681724,1672684200,2476
7859,3200691026,3485008994,1672555525,1672558152,2627
7966,3701190899,3311154569,1672643778,1672647000,3222
7751,3716165213,3519428855,1672615671,1672616721,1050
7515,3519912874,3805342762,1672656000,1672658339,2339
7510,3760893269,3792883665,1672615867,1672616092,225
7812,3420432297,3776800213,1672575002,1672576721,1719
7947,3412980697,3770101921,1672608404,1672611485,3081
7932,3793627961,3467773920,1672667628,1672669070,1442
7773,3778549126,3492478793,1672618560,1672619272,712
7862,3446948848,3505859863,1672569551,1672571670,2119
7741,3639847263,3512166013,1672583584,1672585267,1683
7922,3505869747,3607178184,1672539956,1672541095,1139
7665,3791874383,3735733948,1672617815,1672621076,3261
7707,3519601612,3756451663,1672645118,1672648274,3156
7649,3357483218,3510244400,1672683742,1672686879,3137
7574,3664170666,3780914982,1672595752,1672596477,725
7824,3760893269,3365830990,1672699681,1672702591,2910
7719,3338703270,3500391167,1672676594,1672676949,355
7801,3520709480,3249247700,1672697894,1672700744,2850
7650,3774466457,3715581279,1672675038,1672675798,760
7612,3518260334,3388372715,1672555330,1672555954,624
7887,3809484172,3783206719,1672644359,1672645208,849
7556,3711571712,3427219654,1672596505,1672597162,657
7602,3367902229,3509907947,1672532272,1672533935,1663
7780,3359910781,3400804807,1672661116,1672663413,2297
7752,3606186086,3791553060,1672535071,1672536218,1147
7879,3918584946,3836573197,1672557184,1672558157,973
7893,3777929708,3411618230,1672702784,1672704594,1810
7585,3552314511,3344019610,1672555303,1672558630,3327
7661,3389115045,3222521619,1672702434,1672703594,1160
7833,3778549126,3774466457,1672581971,1672584504,2533
7718,3221536550,3246596716,1672583561,1672584520,959
7551,3473765852,3783509527,1672612939,1672614136,1197
7743,3485375593,3710344260,1672627994,1672630279,2285
7845,3778108318,3701691675,1672616500,1672618206,1706
7486,3828365570,3201848640,1672643784,1672645717,1933
7868,3756424865,3224058172,1672572842,1672574059,1217
7600,3284832486,3501184421,1672652906,1672655536,2630
7776,3509634629,3715998609,1672628058,1672631497,3439
7720,3883042241,3497901842,1672589352,1672591792,2440
7681,3514283243,3903009525,1672664844,1672665367,523
7884,3773664987,3883312122,1672675663,1672679230,3567
7920,3925402713,3517255726,1672567158,1672568858,1700
7939,3314245084,3510703546,1672574368,1672577068,2700
7593,3346327502,3793627961,1672653944,1672656398,2454
7809,3774125065,3519700826,1672696850,1672697513,663
7761,3513956646,3512969370,1672572928,1672575988,3060
7602,3289061738,3517077106,1672571938,1672572493,555
7513,3629547065,3755042098,1672676077,1672679221,3144
7500,3314245084,3756424865,1672556510,1672557022,512
7494,3361230905,3760509236,1672543206,1672543309,103
7977,3755943611,3792883665,1672608890,1672610935,2045
7874,3417587765,3793871337,1672680783,1672683535,2752
7913,3511841857,3716165213,1672551977,1672553096,1119
7813,3770447408,3777455223,1672629164,1672630069,905
7686,3485823740,3774520233,1672671291,1672673286,1995
7648,3666506258,3501486692,1672630166,1672633630,3464
7977,3513454145,3559110998,1672580299,1672583807,3508
7643,3520206212,3793753089,1672551819,1672552676,857
7791,3534313900,3617055293,1672607045,1672608842,1797
7551,3477375368,3316173088,1672563944,1672566304,2360
7871,3534492426,3554917400,1672634719,1672637118,2399
7678,3201324715,3800353779,1672642353,1672645935,3582
7503,3634786711,3924549929,1672623629,1672625163,1534
7820,3716197887,3710067113,1672638617,1672640306,1689
7537,3512720680,3792768129,1672608978,1672610624,1646
7502,3816853177,3200198928,1672558724,1672559671,947
7505,3701691675,3202120784,1672662897,1672663777,880
7610,3500894271,3429690204,1672575202,1672575670,468
7808,3496549058,3792883665,1672697599,1672698019,420
7961,3512349371,3734828619,1672684799,1672686528,1729
7731,3533242305,3901877072,1672685687,1672685968,281
7497,3666507626,3970117174,1672618423,1672619515,1092
7887,3284639858,3446948848,1672608051,1672610798,2747
7610,3293695955,3500487333,1672601661,1672603925,2264
7903,3500894271,3516629436,1672627397,1672630146,2749
7747,3348261553,3634340855,1672624994,1672625228,234
7648,3518932404,3834257412,1672566888,1672569225,2337
7845,3407673904,3773465237,1672563002,1672563648,646
7913,3336742544,3511332835,1672622955,1672624113,1158
7580,3882242815,3500060260,1672630286,1672630795,509
7645,3357483218,3703013906,1672641360,1672644225,2865
7679,3760561634,3772309150,1672559331,1672562195,2864
7860,3473562469,3617055293,1672587631,1672589077,1446
7621,3520165601,3518360734,1672537303,1672538075,772
7689,3783083229,3685818092,1672619311,1672622690,3379
7573,3388372715,3770553384,1672670934,1672671147,213
7692,3318166135,3715492942,1672686488,1672689727,3239
7867,3519601612,3757455053,1672644941,1672646618,1677
7575,3806545488,3433804879,1672543134,1672544936,1802
7696,3793871337,3703718151,1672688981,1672691498,2517
7518,3517721725,3348261553,1672605928,1672609074,3146
7665,3608868877,3288764520,1672701688,1672702251,563
7795,3776948966,3311993075,1672571150,1672572409,1259
7905,3734828619,3500177712,1672624918,1672627394,2476
7865,3365942576,3289061738,1672659987,1672660911,924
7540,3500487333,3772544062,1672601866,1672602890,1024
7942,3416427576,3791020967,1672589897,1672591824,1927
7730,3201848640,3500365158,1672694343,1672696459,2116
7800,3223789409,3520931254,1672541086,1672542146,1060
7845,3416265063,3451432842,1672702865,1672703911,1046
7825,3417587765,3501759100,1672533104,1672535021,1917
7554,3889750851,3520888296,1672618669,1672620339,1670
7754,3511359172,3780503655,1672553444,1672556872,3428
7889,3505912939,3829319703,1672568729,1672570795,2066
7648,3552314511,3660493209,1672602733,1672603225,492
7641,3777790718,3277939457,1672695997,1672696752,755
7806,3209383861,3345207877,1672541212,1672541573,361
7535,3511841857,3932051427,1672701214,1672703570,2356
7653,3920801189,3346795719,1672566231,1672567152,921
7529,3429690204,3520709480,1672665803,1672667397,1594
7728,3311603601,3489545239,1672647784,1672647960,176
7602,3520888296,3533748232,1672603022,1672606152,3130
7693,3519556068,3756021689,1672586532,1672586737,205
7563,3280599164,3370752401,1672540357,1672540757,400
7740,3501364586,3755920131,1672609960,1672610116,156
7726,3703789494,3613995936,1672675552,1672677684,2132
7852,3439023335,3247780536,1672695263,1672696410,1147
7493,3296471982,3231056870,1672589223,1672592088,2865
7778,3772359096,3701995648,1672659244,1672659781,537
7490,3224058172,3608868877,1672592724,1672594561,1837
7500,3633420270,3683959482,1672658080,1672659620,1540
7967,3755872268,3291883916,1672586638,1672587441,803
7897,3533280269,3792883665,1672573356,1672576162,2806
7819,3711380716,3513599775,1672563859,1672563930,71
7717,3500805881,3392121505,1672669755,1672670448,693
7871,3511435497,3734737881,1672701185,1672704667,3482
7763,3516465662,3715974031,1672678044,1672680215,2171
7822,3776948966,3804870229,1672692262,1672693901,1639
7821,3511312803,3703275621,1672579414,1672581100,1686
7720,3778266283,3792789881,1672564254,1672565005,751
7935,3388286531,3806545488,1672604241,1672604945,704
7883,3387966152,3760077057,1672545303,1672548019,2716
7847,3518932404,3756966035,1672643916,1672646327,2411
7625,3772758337,3791874383,1672600185,1672600682,497
7925,3501955238,3780788622,1672588559,1672589633,1074
7606,3516065852,3534488837,1672608456,1672611149,2693
7840,3303751772,3365830990,1672563830,1672564809,979
7941,3976633198,3465202715,1672698100,1672701434,3334
7798,3332072298,3247780536,1672592614,1672594262,1648
7939,3399052055,3711380716,1672543491,1672544020,529
7938,3517721725,3791594391,1672577062,1672580647,3585
7878,3736790081,3774501422,1672616026,1672619105,3079
7825,3520206212,3772359096,1672636765,1672638760,1995
7932,3710344260,3516629436,1672702818,1672705656,2838
7579,3516011407,3518791447,1672658709,1672661992,3283
7717,3978105277,3760489031,1672685446,1672685751,305
7591,3770851318,3427219654,1672565509,1672567714,2205
7827,3774125065,3512837326,1672698952,1672699841,889
7585,3760569731,3783429780,1672545008,1672545529,521
7623,3903009525,3516065852,1672665052,1672667602,2550
7784,3505000737,3783245561,1672581761,1672582864,1103
7667,3518014404,3360993964,1672622991,1672624611,1620
7643,3513454145,3510126867,1672563717,1672565184,1467
7862,3736419952,3774520233,1672702945,1672703587,642
7639,3978115672,3314836094,1672697763,1672698411,648
7898,3713630656,3701534009,1672545016,1672545687,671
7777,3500805881,3399052055,1672549557,1672550474,917
7757,3757246925,3485823740,1672583160,1672586498,3338
7711,3711380716,3662180254,1672576899,1672577680,781
7661,3500229033,3777776687,1672599453,1672599873,420
7973,3730517636,3701065786,1672587558,1672588420,862
7888,3417970574,3711504540,1672631242,1672633096,1854
7682,3314836094,3770078063,1672626266,1672627085,819
7620,3880285638,3314836094,1672641348,1672642680,1332
7772,3791115967,3533193862,1672570786,1672571453,667
7789,3829319703,3399911573,1672582586,1672586180,3594
7941,3533810360,3388637594,1672677779,1672678944,1165
7528,3736786443,3509604974,1672557637,1672560942,3305
7509,3446948848,3389115045,1672687857,1672690822,2965
7501,3516514391,3453729665,1672633515,1672636124,2609
7578,3760489031,3515151980,1672623165,1672625844,2679
7822,3534424200,3755872268,1672563207,1672563350,143
7810,3772746272,3516223597,1672569854,1672570382,528
7829,3489728806,3772337814,1672612927,1672614663,1736
7774,3792844210,3812176780,1672634928,1672636982,2054
7643,3477649378,3333896808,1672565078,1672567870,2792
7901,3756027749,3626156564,1672570795,1672570863,68
7792,3338703270,3833889105,1672552911,1672556000,3089
7744,3518876135,3774050956,1672620085,1672623562,3477
7917,3511435497,3428674539,1672632743,1672634057,1314
7607,3514719601,3882242815,1672545141,1672547942,2801
7780,3500729955,3244485293,1672658909,1672660674,1765
7796,3805347939,3780294829,1672668305,1672669862,1557
7571,3624312512,3520165601,1672550317,1672551502,1185
7706,3404384505,3492478793,1672577344,1672578979,1635
7834,3304625412,3399911573,1672542252,1672542653,401
7501,3701995648,3783239924,1672562230,1672564959,2729
7662,3774119563,3664170666,1672633293,1672636220,2927
7835,3510244400,3465202715,1672550183,1672552454,2271
7840,3311439795,3311065516,1672697715,1672698365,650
7932,3882242815,3774125065,1672641831,1672643541,1710
7598,3760294205,3383922351,1672586902,1672587815,913
7645,3757161914,3711370563,1672694979,1672695372,393
7727,3517721725,3277605882,1672573608,1672576487,2879
7549,3972364603,3285400528,1672699602,1672701677,2075
7556,3774005526,3913251733,1672636834,1672639519,2685
7494,3533193862,3367029997,1672564913,1672567047,2134
7527,3774204963,3451432842,1672613273,1672616808,3535
7928,3223789409,3311761694,1672550076,1672552363,2287
7575,3736625083,3882291183,1672631895,1672633886,1991
7583,3534191820,3550946908,1672601635,1672604604,2969
7712,3505649239,3505649239,1672660418,1672662555,2137
7650,3356860407,3500729955,1672617937,1672618078,141
7853,3664517356,3887270940,1672614129,1672616208,2079
7751,3777717988,3910454786,1672562792,1672565589,2797
7943,3731419510,3519428855,1672699217,1672702675,3458
7829,3773205565,3485008994,1672691777,1672693616,1839
7838,3829232696,3773950140,1672656631,1672657245,614
7875,3434642576,3834257412,1672566010,1672569024,3014
7869,3511359172,3333896808,1672613433,1672615127,1694
7885,3223968713,3812176780,1672623080,1672623786,706
7643,3311439795,3715127362,1672635670,1672638940,3270
7936,3772578994,3713268590,1672580352,1672582032,1680
7617,3411618230,3783925755,1672596124,1672599590,3466
7608,3291227780,3500199935,1672577339,1672578507,1168
7535,3772758337,3701274634,1672566621,1672570153,3532
7869,3307512479,3510703546,1672699657,1672702132,2475
7680,3855000166,3390068992,1672552542,1672552976,434
7798,3515125508,3432689543,1672689273,1672692226,2953
7866,3291227780,3515860749,1672624104,1672625850,1746
7962,3465254146,3513164386,1672686137,1672689586,3449
7896,3776948966,3500365158,1672561738,1672562633,895
7765,3509453566,3760489031,1672659514,1672660490,976
7563,3608633356,3390068992,1672691125,1672693153,2028
7549,3223968713,3514283243,1672583215,1672584772,1557
7779,3820354437,3510244400,1672537561,1672540060,2499
7820,3373384732,3792032359,1672626881,1672628304,1423
7618,3701178711,3703013906,1672540492,1672543499,3007
7910,3972364603,3477649378,1672654125,1672654938,813
7624,3756528686,3432689543,1672564116,1672566117,2001
7831,3519152550,3365614305,1672668474,1672668949,475
7623,3911245524,3487171044,1672687526,1672688796,1270
7598,3777983879,3780503655,1672589587,1672592379,2792
7575,3332072298,3713370078,1672549250,1672552453,3203
7534,3516016437,3500729955,1672612888,1672615948,3060
7624,3813052709,3475251781,1672543530,1672545099,1569
7824,3917278625,3779218771,1672584600,1672584882,282
7625,3829764737,3711308224,1672630661,1672630785,124
7678,3206593906,3505145247,1672609101,1672609972,871
7892,3388286531,3738502357,1672695908,1672697417,1509
7731,3505638204,3792668962,1672586782,1672588160,1378
7844,3736419952,3783925755,1672598172,1672601149,2977
7885,3505791599,3500904641,1672595057,1672597029,1972
7783,3221536550,3737051610,1672570582,1672573124,2542
7548,3773755137,3818255890,1672562064,1672562590,526
7533,3201848640,3920801189,1672644788,1672647829,3041
7808,3774793839,3500487333,1672621870,1672622506,636
7576,3772337814,3520730271,1672673421,1672675334,1913
7715,3755587522,3336751428,1672638902,1672640878,1976
7925,3200691026,3756424865,1672577589,1672579384,1795
7838,3356860407,3756930948,1672568309,1672570235,1926
7644,3533095755,3235635976,1672550995,1672553778,2783
7659,3716197887,3783245561,1672690493,1672693103,2610
7663,3501730685,3772309150,1672621601,1672624667,3066
7884,3244389794,3519700826,1672576645,1672577261,616
7930,3518669703,3777623166,1672600110,1672602698,2588
7572,3511841857,3817621391,1672575290,1672576374,1084
7714,3756601594,3711571712,1672580434,1672583780,3346
7771,3475795792,3284639858,1672659067,1672660789,1722
7675,3773429448,3793627961,1672540720,1672543525,2805
7727,3715581279,3475258557,1672580327,1672583299,2972
7746,3701995648,3473562469,1672655386,1672658970,3584
7870,3418728074,3710098970,1672679783,1672682119,2336
7495,3505962865,3777717988,1672627560,1672627732,172
7961,3778549126,3783083229,1672692636,1672695564,2928
7942,3520165601,3910886626,1672677134,1672680467,3333
7763,3827626797,3534191820,1672583842,1672585564,1722
7955,3515394721,3534424200,1672654848,1672655144,296
7719,3701111745,3607748895,1672689721,1672690995,1274
7756,3931941795,3311603601,1672577910,1672579727,1817
7751,3606812411,3755920131,1672542059,1672544595,2536
7749,3520888296,3480687894,1672575843,1672577106,1263
7826,3520730271,3774125065,1672577198,1672580018,2820
7843,3311274543,3783239924,1672536646,1672539402,2756
7823,3703871468,3774268456,1672559054,1672560334,1280
7600,3365942576,3485008994,1672556171,1672559432,3261
7789,3825229501,3772337814,1672610561,1672613924,3363
7625,3715981584,3291235378,1672628411,1672631166,2755
7553,3200691026,3792789881,1672630234,1672631082,848
7611,3853018906,3511170269,1672657542,1672659465,1923
7493,3772578994,3505145247,1672563009,1672566200,3191
7645,3778266283,3224716315,1672632303,1672635268,2965
7886,3811694763,3770635361,1672659733,1672662914,3181
7712,3311324983,3533270638,1672604878,1672605840,962
7906,3409474775,3703013906,1672686553,1672689824,3271
7793,3625274012,3334033993,1672576940,1672580348,3408
7657,3777790718,3501759100,1672642504,1672644396,1892
7602,3386707783,3777717988,1672650119,1672650254,135
7704,3703223015,3772309166,1672537648,1672539575,1927
7935,3935127663,3826415738,1672563058,1672563247,189
7887,3783083229,3778980116,1672697192,1672698486,1294
7484,3501955238,3606812411,1672594707,1672596143,1436
7828,3515723720,3430074045,1672562015,1672564864,2849
7888,3711308224,3601879040,1672616590,1672617742,1152
7913,3201432789,3755392666,1672635503,1672639023,3520
7516,3886298125,3808324264,1672585980,1672587807,1827
7605,3887270940,3716843669,1672551980,1672552184,204
7692,3378436155,3774050956,1672681066,1672682083,1017
7915,3337544549,3801089989,1672568740,1672568822,82
7528,3289061738,3520706195,1672580713,1672582093,1380
7971,3533827120,3319752091,1672623292,1672623903,611
7603,3404384505,3200691026,1672601696,1672603531,1835
7615,3493507965,3757403279,1672631741,1672635072,3331
7581,3235287260,3889750851,1672605937,1672609443,3506
7495,3770101921,3500658339,1672599709,1672600482,773
7883,3505791599,3236102733,1672693290,1672696446,3156
7876,3516016437,3975287541,1672702070,1672704155,2085
7734,3520030713,3387674757,1672536782,1672537737,955
7555,3859663348,3415546117,1672655930,1672657789,1859
7765,3624312512,3911245524,1672636070,1672637982,1912
7631,3918247820,3229058858,1672639807,1672641300,1493
7562,3756528686,3405494240,1672678749,1672681755,3006
7954,3520888296,3760893269,1672667414,1672670373,2959
7561,3660493209,3773755137,1672697423,1672700761,3338
7534,3701498253,3383661227,1672584273,1672584887,614
7900,3244173074,3359239884,1672561014,1672563553,2539
7979,3500391167,3637008488,1672552947,1672553273,326
7858,3713208927,3713786889,1672624071,1672625265,1194
7503,3855424474,3465202715,1672582376,1672584838,2462
7794,3804870229,3859663348,1672577737,1672579769,2032
7950,3311324983,3505962865,1672586161,1672588486,2325
7561,3365278081,3629547065,1672662818,1672666184,3366
7976,3716537575,3394539273,1672534158,1672536218,2060
7899,3348261553,3779740455,1672566307,1672567140,833
7650,3777790718,3882997884,1672651692,1672654906,3214
7953,3232962003,3244485293,1672599011,1672602035,3024
7701,3607178184,3756623396,1672652685,1672654068,1383
7822,3776338577,3621810464,1672556484,1672558992,2508
7541,3760294205,3760077057,1672671878,1672673618,1740
7735,3777776687,3412825109,1672624226,1672625997,1771
7798,3286658957,3911159965,1672687330,1672690288,2958
7947,3509634629,3485823740,1672571410,1672572533,1123
7733,3434642576,3880310724,1672629707,1672632127,2420
7836,3500458761,3716746253,1672696601,1672698333,1732
7903,3737079798,3756453423,1672568586,1672572186,3600
7969,3555214688,3779218771,1672537204,1672537591,387
7535,3792844210,3418728074,1672675704,1672678137,2433
7812,3738274418,3224716315,1672600048,1672601324,1276
7612,3935127663,3703223015,1672643712,1672646482,2770
7892,3792253549,3607178184,1672560735,1672561208,473
7918,3756966035,3713208927,1672678016,1672680525,2509
7819,3666457294,3909331423,1672558633,1672559824,1191
7609,3359910781,3399433690,1672567614,1672570572,2958
7711,3774556560,3511350608,1672638148,1672639600,1452
7972,3826633236,3485008994,1672559639,1672562465,2826
7762,3511435497,3379256399,1672564990,1672565458,468
7693,3773978034,3774204963,1672703105,1672706696,3591
7805,3344364444,3505000737,1672640835,1672641325,490
7752,3412980697,3399535232,1672688965,1672692150,3185
7848,3791020967,3421836608,1672540803,1672543137,2334
7739,3209383861,3312829208,1672540506,1672542114,1608
7948,3378686918,3533371364,1672567864,1672570418,2554
7756,3710569131,3792384220,1672580730,1672582293,1563
7792,3895562476,3516465662,1672645229,1672646590,1361
7684,3416241005,3618045231,1672643075,1672643588,513
7697,3667680268,3316222192,1672605265,1672607280,2015
7852,3792177074,3618873142,1672544100,1672547571,3471
7715,3520756859,3604539807,1672631158,1672634219,3061
7866,3756462516,3533385867,1672683149,1672683518,369
7640,3792668962,3311718847,1672571910,1672572902,992
7702,3312333615,3809916577,1672692225,1672693368,1143
7663,3915628728,3407673904,1672599460,1672601650,2190
7673,3713349754,3318166135,1672683505,1672686793,3288
7669,3473562469,3809484172,1672598234,1672600801,2567
7771,3311154569,3779976989,1672608713,1672610986,2273
7736,3311274543,3500060260,1672604213,1672606491,2278
7871,3710112546,3826760240,1672598893,1672600303,1410
7855,3391915121,3411618230,1672554047,1672556165,2118
7945,3291227780,3273500349,1672581663,1672584300,2637
7864,3911159965,3206603608,1672665267,1672666458,1191
7605,3516960534,3772053179,1672610338,1672612584,2246
7644,3807987001,3514838220,1672590336,1672593131,2795
7867,3930791338,3735319397,1672670810,1672671150,340
7769,3513164386,3505135325,1672570619,1672571848,1229
7797,3520709480,3516465662,1672638467,1672639172,705
7649,3777455223,3826633236,1672646194,1672649501,3307
7653,3500374658,3760992710,1672591818,1672592161,343
7892,3318697153,3533927138,1672567294,1672568693,1399
7913,3711370563,3388372715,1672649251,1672649948,697
7941,3367029997,3476232529,1672698153,1672698220,67
7645,3400918687,3890149705,1672627574,1672630843,3269
7688,3925402713,3390068992,1672533552,1672534076,524
7511,3513599775,3837094550,1672681895,1672683974,2079
7922,3883042241,3379256399,1672605548,1672607895,2347
7753,3505869747,3772642849,1672703353,1672705824,2471
7709,3626156564,3311648200,1672638299,1672639390,1091
7703,3715339701,3738274418,1672693215,1672695314,2099
7609,3501601840,3517077106,1672624630,1672625485,855
7685,3311065516,3311090974,1672683175,1672685987,2812
7657,3515284591,3809916577,1672565975,1672568218,2243
7733,3783509527,3500729955,1672596144,1672598748,2604
7965,3533193862,3511312803,1672691590,1672692095,505
7527,3465254146,3511267139,1672627202,1672629835,2633
7765,3783429780,3514838220,1672620225,1672622909,2684
7730,3556951786,3715974031,1672700595,1672701653,1058
7870,3783196518,3882997884,1672594087,1672594520,433
7572,3701065786,3829764737,1672531990,1672534261,2271
7580,3780365428,3519803045,1672678667,1672680617,1950
7930,3291883916,3802367797,1672609709,1672612125,2416
7508,3774010081,3634995491,1672596591,1672597877,1286
7722,3716843669,3384240055,1672656683,1672658184,1501
7545,3417970574,3482405588,1672675745,1672678423,2678
7569,3685818092,3518876135,1672585965,1672587484,1519
7867,3703871468,3734496778,1672614199,1672617008,2809
7662,3772544062,3318166135,1672686110,1672687462,1352
7742,3760183458,3813052709,1672555143,1672556779,1636
7793,3514719601,3505973226,1672564136,1672565750,1614
7647,3757562897,3520888296,1672561344,1672563615,2271
7597,3978105277,3899204805,1672625205,1672626624,1419
7673,3853018906,3519803045,1672569832,1672571209,1377
7871,3773978034,3760077057,1672685952,1672689327,3375
7887,3505869747,3415443558,1672590447,1672593387,2940
7532,3611150562,3736229191,1672647749,1672648595,846
7827,3668898102,3809059934,1672683172,1672685135,1963
7568,3793959750,3344019610,1672613072,1672614098,1026
7528,3780974443,3505859863,1672547596,1672550606,3010
7716,3703871468,3416427576,1672695057,1672697468,2411
7925,3711569060,3501483568,1672659003,1672661930,2927
7547,3372883226,3829232696,1672682798,1672684196,1398
7727,3715127362,3792253549,1672652216,1672655111,2895
7606,3760077057,3501692334,1672694114,1672695970,1856
7706,3904775198,3780788622,1672636900,1672639759,2859
7679,3511163800,3668005723,1672612852,1672615174,2322
7535,3378436155,3610348516,1672636177,1672637077,900
7541,3834257412,3755920131,1672602474,1672602776,302
7833,3774010081,3922275416,1672631590,1672632041,451
7628,3918584946,3359239884,1672698871,1672702392,3521
7969,3703871468,3714504419,1672645031,1672647199,2168
7782,3901990690,3792902982,1672589568,1672592105,2537
7884,3829319703,3404058699,1672604780,1672604967,187
7589,3774466457,3760893269,1672571579,1672574920,3341
7786,3500066230,3374559242,1672590820,1672592689,1869
7942,3778266283,3365278081,1672662334,1672663320,986
7767,3510244400,3500060260,1672680818,1672684344,3526
7748,3297463265,3511125626,1672645983,1672648536,2553
7693,3737079798,3500229033,1672682093,1672683055,962
7841,3858918246,3400804807,1672549863,1672552658,2795
7651,3755625324,3783429780,1672670567,1672671427,860
7740,3318697153,3515151980,1672684719,1672686126,1407
7516,3713786889,3736786443,1672643777,1672645589,1812
7536,3505219850,3415443558,1672650124,1672651368,1244
7604,3244389794,3505791599,1672652308,1672654941,2633
7545,3688683847,3404058699,1672655488,1672658942,3454
7787,3779036831,3855937514,1672569080,1672572640,3560
7847,3606812411,3533137446,1672651786,1672652670,884
7958,3711265369,3774268456,1672552529,1672555447,2918
7784,3716258994,3804870229,1672696342,1672699364,3022
7874,3394539273,3416265063,1672585085,1672585521,436
7711,3337544549,3779218771,1672557923,1672560136,2213
7769,3774125065,3776066388,1672657910,1672659685,1775
7486,3515125508,3793286136,1672582519,1672584569,2050
7807,3510711755,3512720680,1672551542,1672551884,342
7739,3500229033,3313541986,1672600247,1672602234,1987
7928,3783531004,3385763781,1672535874,1672539051,3177
7631,3514987389,3494290908,1672630181,1672633523,3342
7724,3883861463,3732481297,1672572026,1672572639,613
7786,3793086311,3779976989,1672629812,1672630581,769
7750,3533371364,3976390453,1672644095,1672647687,3592
7649,3791334389,3365278081,1672681725,1672682159,434
7694,3501730685,3622054816,1672668984,1672670318,1334
7520,3757455053,3505193212,1672567652,1672569209,1557
7963,3235287260,3352603894,1672572775,1672572846,71
7712,3516606733,3780294829,1672578114,1672578834,720
7746,3467773920,3829764737,1672548391,1672549357,966
7808,3533927138,3311718847,1672680385,1672683547,3162
7537,3396285984,3816454165,1672564155,1672566576,2421
7610,3511862351,3402943525,1672612820,1672616340,3520
7878,3200198928,3777983879,1672616700,1672616935,235
7961,3209383861,3209048907,1672562019,1672562203,184
7489,3792768129,3533137446,1672679529,1672683088,3559
7553,3307512479,3518791447,1672589689,1672593146,3457
7656,3755625324,3505904952,1672575705,1672577894,2189
7974,3501184421,3501692334,1672594141,1672597732,3591
7486,3714197325,3505135325,1672620277,1672623526,3249
7557,3519563836,3736229191,1672652806,1672655666,2860
7719,3242408357,3520183192,1672534783,1672536290,1507
7599,3501184421,3779036831,1672655535,1672656745,1210
7585,3500805881,3757602960,1672617168,1672617502,334
7715,3639847263,3910454786,1672628620,1672630121,1501
7805,3209048907,3520206212,1672573885,1672574685,800
7692,3374559242,3703718151,1672651832,1672653310,1478
7682,3427219654,3482405588,1672587489,1672590298,2809
7894,3634340855,3298433163,1672600097,1672602169,2072
7776,3511267139,3311871871,1672647458,1672648408,950
7693,3417061462,3466911760,1672541128,1672544559,3431
7875,3516465662,3899204805,1672703832,1672705342,1510
7690,3209383861,3791602225,1672695705,1672696765,1060
7895,3497901842,3791957752,1672608751,1672609006,255
7959,3662180254,3909606423,1672602548,1672604683,2135
7857,3891751546,3511271692,1672540644,1672541178,534
7902,3737079798,3365942576,1672649317,1672650284,967
7979,3713208927,3520012395,1672680030,1672681297,1267
7827,3770635361,3634786711,1672688694,1672689968,1274
7673,3713349754,3509933351,1672646039,1672648789,2750
7657,3791874383,3756601594,1672638280,1672638601,321
7580,3909331423,3910886626,1672654422,1672657247,2825
7761,3713894336,3755943611,1672679500,1672680365,865
7744,3731419510,3284832486,1672552469,1672555796,3327
7982,3378436155,3716488385,1672602763,1672603360,597
7900,3392121505,3793338102,1672552504,1672552660,156
7683,3601879040,3774339795,1672537104,1672539626,2522
7748,3391915121,3903009525,1672554406,1672557656,3250
7507,3497901842,3857349323,1672678085,1672679686,1601
7880,3316222192,3770824086,1672648425,1672652003,3578
7603,3774127586,3533280269,1672596305,1672599524,3219
7772,3666553782,3757602960,1672564521,1672567398,2877
7763,3345207877,3756966035,1672615823,1672616593,770
7622,3501692334,3757682496,1672690324,1672692265,1941
7835,3770553384,3311065516,1672600317,1672603033,2716
7841,3793962300,3244436890,1672692143,1672694133,1990
7754,3607178184,3227457126,1672563477,1672566926,3449
7668,3610348516,3517077106,1672653635,1672656315,2680
7773,3534313900,3715189301,1672697042,1672699112,2070
7606,3349613093,3780788622,1672644570,1672647374,2804
7545,3505791599,3757447189,1672548852,1672550240,1388
7914,3311439795,3516960534,1672605889,1672606907,1018
7575,3733189298,3509352754,1672660264,1672663443,3179
7676,3887270940,3618873142,1672608085,1672609501,1416
7648,3513956646,3483164654,1672591999,1672592220,221
7501,3505638204,3519556068,1672563659,1672566441,2782
7972,3451432842,3737079798,1672672780,1672675901,3121
7967,3421127249,3859663348,1672573682,1672575490,1808
7540,3362000049,3808324264,1672602431,1672605677,3246
7518,3755872268,3242408357,1672553624,1672557095,3471
7593,3936227020,3774580701,1672698171,1672701191,3020
7579,3901990690,3634786711,1672689374,1672692251,2877
7872,3505201246,3703889596,1672622673,1672625042,2369
7586,3713208927,3407954858,1672615991,1672616096,105
7681,3634786711,3500487333,1672560820,1672561039,219
7736,3407954858,3760294205,1672535129,1672535706,577
7846,3817316561,3516716179,1672620077,1672621462,1385
7677,3201848640,3778549126,1672552526,1672554302,1776
7857,3399535232,3222521619,1672677391,1672677773,382
7932,3291227780,3421127249,1672663937,1672665365,1428
7686,3755436115,3903962771,1672615318,1672617758,2440
7626,3613995936,3365614305,1672691948,1672693259,1311
7770,3755392666,3315583351,1672620573,1672622904,2331
7894,3509453566,3500578848,1672598946,1672600431,1485
7870,3776513891,3512166013,1672675740,1672677595,1855
7763,3738502357,3780503655,1672548378,1672550007,1629
7898,3837094550,3510937904,1672548827,1672549150,323
7706,3774125065,3918056059,1672673662,1672673767,105
7838,3737051610,3715492942,1672677194,1672677885,691
7519,3515125508,3755042098,1672666153,1672669448,3295
7574,3911245524,3501759100,1672681850,1672682274,424
7981,3625274012,3477649378,1672573664,1672576912,3248
7821,3703013906,3517963492,1672630582,1672631329,747
7510,3284832486,3855424474,1672693174,1672696342,3168
7703,3716273414,3757403279,1672678981,1672682253,3272
7591,3755436115,3972364603,1672567694,1672570619,2925
7716,3386707783,3514987389,1672655642,1672659085,3443
7665,3500487333,3497901842,1672554368,1672555290,922
7951,3776800213,3793753089,1672668253,1672668992,739
7785,3755392666,3512720680,1672571421,1672574456,3035
7699,3939952128,3737154119,1672584144,1672587614,3470
7881,3779528381,3755625324,1672681606,1672684707,3101
7750,3520190170,3932051427,1672573674,1672577161,3487
7615,3417587765,3318697153,1672671545,1672671670,125
7768,3513201436,3244436890,1672583790,1672585463,1673
7485,3880285638,3465254146,1672560363,1672562816,2453
7600,3389115045,3367902229,1672620899,1672622329,1430
7890,3855424474,3516980378,1672687715,1672690066,2351
7981,3346795719,3511267139,1672591670,1672594276,2606
7518,3276993580,3714474557,1672615610,1672617838,2228
7848,3755739653,3534553510,1672645075,1672646187,1112
7817,3404384505,3228165483,1672566551,1672568657,2106
7773,3311627628,3307512479,1672654039,1672657106,3067
7872,3291227780,3555214688,1672578589,1672581487,2898
7876,3816853177,3918247820,1672593691,1672595076,1385
7962,3520012395,3779976989,1672696595,1672698818,2223
7964,3755042098,3277939457,1672576409,1672578534,2125
7743,3774520233,3792473331,1672655426,1672658543,3117
7794,3770763956,3793286136,1672555927,1672557569,1642
7606,3805342762,3311627628,1672578570,1672581471,2901
7561,3244173074,3505702787,1672605978,1672606617,639
7561,3936227020,3783126683,1672561719,1672562747,1028
7552,3783531004,3432665384,1672557771,1672558368,597
7535,3817621391,3773814927,1672619256,1672622445,3189
7593,3514128943,3520719611,1672656470,1672657672,1202
7934,3533385867,3736592744,1672567898,1672569715,1817
7860,3247428249,3505219850,1672676381,1672679485,3104
7809,3505219850,3701184889,1672578615,1672579386,771
7682,3774366875,3935127663,1672656486,1672657097,611
7622,3505098372,3770553384,1672572213,1672575211,2998
7577,3511312803,3379256399,1672556535,1672556927,392
7811,3755881905,3377766165,1672670436,1672670609,173
7764,3713349754,3628819436,1672554828,1672555845,1017
7954,3772544062,3701898991,1672619672,1672621414,1742
7859,3834257412,3514283243,1672671661,1672672995,1334
7590,3514719601,3770635361,1672695592,1672697599,2007
7550,3516514391,3517721725,1672683014,1672685675,2661
7797,3489217083,3716273414,1672600372,1672603560,3188
7780,3909238838,3902278226,1672633357,1672634224,867
7658,3791657947,3516465662,1672569238,1672570923,1685
7614,3501198706,3511267139,1672611697,1672614758,3061
7589,3916289176,3520183192,1672596675,1672597554,879
7543,3510594211,3505193212,1672647028,1672649512,2484
7524,3774050956,3885670556,1672539761,1672540286,525
7710,3505869747,3511170269,1672552855,1672553034,179
7882,3505292701,3244436890,1672658487,1672658725,238
7798,3430074045,3367902229,1672647931,1672650593,2662
7611,3710112546,3518496488,1672669968,1672670545,577
7850,3209027249,3780593036,1672562112,1672564249,2137
7564,3511435497,3511332835,1672684486,1672685623,1137
7526,3855937514,3390068992,1672573673,1672576969,3296
7891,3430352815,3291227780,1672608548,1672609628,1080
7659,3242408357,3513201436,1672630463,1672631575,1112
7971,3200691026,3209027249,1672701200,1672701510,310
7764,3513599775,3533270638,1672594413,1672596872,2459
7644,3770553384,3855937514,1672588919,1672589091,172
7828,3209027249,3387966152,1672572456,1672575607,3151
7789,3816454165,3453729665,1672655786,1672657220,1434
7890,3773950140,3510703546,1672593979,1672597425,3446
7584,3432665384,3930791338,1672701211,1672703143,1932
7692,3510857360,3736625083,1672559330,1672560060,730
7901,3482405588,3629935998,1672681712,1672682812,1100
7757,3520719611,3513454145,1672602240,1672604678,2438
7735,3505203158,3660493209,1672696471,1672699338,2867
7883,3774793839,3780828689,1672702496,1672703050,554
7877,3505098372,3783779671,1672606688,1672606890,202
7791,3715189301,3835382117,1672637638,1672640405,2767
7952,3778308417,3826633236,1672662740,1672665951,3211
7684,3519152550,3826415738,1672679441,1672681682,2241
7963,3624312512,3201324715,1672567836,1672568464,628
7484,3783245561,3715127362,1672556778,1672558318,1540
7648,3555214688,3533280269,1672571620,1672572018,398
7541,3505362057,3427219654,1672679922,1672681260,1338
7821,3755625324,3823600322,1672537797,1672539136,1339
7662,3774366875,3511862351,1672579041,1672580613,1572
7937,3608633356,3610695419,1672687855,1672690460,2605
7670,3716273414,3500994774,1672694666,1672697095,2429
7768,3760183458,3520183192,1672576506,1672578342,1836
7852,3852391257,3221536550,1672613343,1672613566,223
7796,3512349371,3232962003,1672578968,1672579717,749
7736,3412825109,3520206212,1672548486,1672551873,3387
7712,3311761694,3778549126,1672627366,1672627954,588
7549,3222448362,3336751428,1672621512,1672623682,2170
7587,3917088658,3387966152,1672658041,1672660273,2232
7489,3910454786,3505869747,1672591466,1672591603,137
7512,3634786711,3777776687,1672605160,1672608206,3046
7625,3516716179,3711262377,1672660794,1672662084,1290
7830,3757562897,3703661585,1672532716,1672534252,1536
7891,3701274634,3774268456,1672556929,1672557987,1058
7817,3895562476,3516223597,1672580846,1672582071,1225
7564,3378686918,3515125508,1672571813,1672572204,391
7621,3511125626,3358871377,1672584241,1672587593,3352
7487,3208844525,3510969660,1672662692,1672665994,3302
7559,3303751772,3501364586,1672687882,1672689562,1680
7607,3454042520,3360993964,1672554781,1672556604,1823
7755,3533193862,3222448362,1672542089,1672544630,2541
7945,3772578994,3224058172,1672601373,1672603314,1941
7872,3301107849,3760598102,1672615048,1672616259,1211
7545,3509672210,3206254161,1672586078,1672587691,1613
7960,3925620998,3939952128,1672575694,1672578018,2324
7500,3809484172,3823600322,1672571824,1672575376,3552
7745,3881477378,3607178184,1672601893,1672604600,2707
7698,3895562476,3487171044,1672633135,1672633599,464
7531,3483949762,3388372715,1672639858,1672643176,3318
7931,3755920131,3515394721,1672627010,1672628902,1892
7956,3430074045,3710067113,1672702468,1672703326,858
7939,3291883916,3715581279,1672659048,1672661711,2663
7613,3634786711,3901877072,1672584225,1672586115,1890
7675,3399433690,3365830990,1672631551,1672634722,3171
7979,3303751772,3206603608,1672687216,1672690274,3058
7502,3516629436,3770635361,1672637031,1672640309,3278
7952,3298288268,3608633356,1672621743,1672623293,1550
7572,3975287541,3509773875,1672685255,1672685689,434
7513,3418534998,3346327502,1672576875,1672578651,1776
7539,3533927138,3384951177,1672558896,1672561967,3071
7895,3755872268,3416265063,1672681288,1672683932,2644
7785,3511170269,3386707783,1672557046,1672557446,400
7667,3428964059,3703735129,1672578007,1672579171,1164
7834,3755587522,3519601612,1672604322,1672607404,3082
7595,3914259449,3519556068,1672551663,1672553414,1751
7826,3505912939,3297463265,1672649786,1672651021,1235
7555,3774366875,3505869747,1672542708,1672544491,1783
7896,3755739653,3703789494,1672690336,1672692523,2187
7777,3311439795,3206603608,1672689169,1672692007,2838
7572,3757151210,3427219654,1672600005,1672600090,85
7667,3629547065,3458539365,1672544149,1672545419,1270
7583,3501759100,3417970574,1672611539,1672612015,476
7976,3416241005,3616944364,1672574039,1672576063,2024
7829,3509630174,3514987389,1672697409,1672698477,1068
7895,3359910781,3333896808,1672648048,1672649808,1760
7667,3554917400,3777477395,1672693503,1672695717,2214
7513,3826633236,3760598102,1672642500,1672645929,3429
7574,3817316561,3505638204,1672633015,1672633659,644
7545,3520756859,3430504438,1672669957,1672672708,2751
7831,3518876135,3715189301,1672583954,1672584660,706
7664,3716537575,3238712269,1672614668,1672615520,852
7800,3776800213,3915628728,1672696747,1672698587,1840
7536,3666507626,3206593906,1672662085,1672665014,2929
7890,3778341199,3311065516,1672584687,1672586550,1863
7803,3501927421,3235635976,1672632434,1672635395,2961
7485,3714821932,3777120536,1672572583,1672572910,327
7860,3791334389,3229665776,1672703937,1672707319,3382
7860,3534553510,3378436155,1672629500,1672630391,891
7505,3312333615,3772746272,1672598731,1672599996,1265
7611,3922275620,3311274543,1672648159,1672651464,3305
7674,3828365570,3777443199,1672543196,1672543281,85
7543,3889232789,3303705369,1672651022,1672651427,405
7786,3221899927,3333896808,1672701822,1672703576,1754
7621,3428964059,3812176780,1672639129,1672640949,1820
7617,3852595551,3510857360,1672544368,1672545183,815
7752,3515723720,3473765852,1672636793,1672638891,2098
7689,3735319397,3735319397,1672621606,1672622131,525
7612,3925620998,3510711755,1672678767,1672681036,2269
7685,3312664885,3312333615,1672648233,1672649398,1165
7841,3201432789,3703013906,1672695718,1672698032,2314
7668,3336751428,3430074045,1672557990,1672558843,853
7891,3756462516,3509907947,1672590500,1672590723,223
7611,3514838220,3903962771,1672532420,1672534872,2452
7765,3249401741,3515394721,1672576341,1672576443,102
7583,3519556068,3703013906,1672689049,1672689199,150
7855,3391261292,3358871377,1672578996,1672581678,2682
7638,3903009525,3475258557,1672574462,1672578056,3594
7568,3756930948,3618045231,1672586142,1672589639,3497
7958,3713268590,3500365158,1672666288,1672666617,329
7563,3812176780,3244485293,1672538456,1672539326,870
7668,3348261553,3931941795,1672666715,1672667145,430
7842,3713644518,3515151980,1672646805,1672649837,3032
7641,3318166135,3909606423,1672576430,1672578309,1879
7531,3791942683,3510594211,1672635101,1672635161,60
7790,3249791738,3714488548,1672658787,1672660536,1749
7527,3311154569,3756462516,1672679372,1672679594,222
7512,3715127362,3501927421,1672547878,1672548626,748
7514,3777455223,3520719611,1672665721,1672666275,554
7498,3837094550,3360743849,1672634715,1672635412,697
7953,3448855696,3229665776,1672677942,1672679395,1453
7597,3298288268,3805292782,1672639632,1672642437,2805
7818,3776800213,3391915121,1672641490,1672643361,1871
7699,3976633198,3511198618,1672648229,1672649890,1661
7889,3472130842,3735733948,1672621243,1672621491,248
7546,3513599775,3349613093,1672660863,1672663255,2392
7796,3380035798,3774339795,1672655426,1672658783,3357
7792,3711262377,3475396323,1672540995,1672542279,1284
7574,3388372715,3622054816,1672663661,1672666499,2838
7831,3513454145,3223789409,1672573373,1672574643,1270
7561,3346795719,3772884106,1672629540,1672630871,1331
7890,3360743849,3400804807,1672680495,1672682740,2245
7809,3778549126,3314245084,1672577337,1672577528,191
7667,3911159965,3247815299,1672630722,1672631716,994
7715,3770824086,3318697153,1672614424,1672617826,3402
7888,3417970574,3471220483,1672595309,1672595566,257
7742,3476232529,3249247700,1672698076,1672699113,1037
7848,3511170269,3805347939,1672660677,1672662977,2300
7866,3688683847,3772359096,1672663737,1672665692,1955
7728,3898995675,3899371911,1672670825,1672671225,400
7771,3701178711,3244173074,1672657937,1672658018,81
7669,3318697153,3770447408,1672615017,1672615930,913
7586,3533137446,3505173328,1672567224,1672567611,387
7806,3518014404,3234541252,1672633302,1672634812,1510
7593,3517459919,3778108318,1672661702,1672663301,1599
7609,3244389794,3903307060,1672596906,1672600231,3325
7932,3492478793,3533025282,1672550634,1672551364,730
7864,3777717988,3828624701,1672691988,1672695531,3543
7527,3793338102,3783779671,1672585592,1672586594,1002
7709,3311648200,3336751428,1672598683,1672600271,1588
7750,3711308224,3733189298,1672654306,1672654704,398
7577,3885897503,3805342762,1672674063,1672677268,3205
7818,3412825109,3930791338,1672697184,1672698080,896
7961,3760489031,3770078063,1672647122,1672649077,1955
7896,3793962300,3520888296,1672579654,1672582202,2548
7772,3732481297,3912262917,1672575430,1672575631,201
7621,3505173328,3509634629,1672544228,1672546537,2309
7726,3533385867,3774520233,1672649615,1672652137,2522
7750,3511125626,3617734118,1672635777,1672638522,2745
7557,3682061100,3783925755,1672614808,1672616601,1793
7716,3783196518,3476232529,1672648626,1672650438,1812
7848,3601879040,3510126867,1672651397,1672653698,2301
7880,3682061100,3805292782,1672637733,1672640960,3227
7740,3732481297,3710408395,1672562415,1672564678,2263
7519,3715189301,3714488548,1672588661,1672590508,1847
7775,3505649239,3791602225,1672629669,1672632949,3280
7754,3826633236,3229665776,1672593333,1672596171,2838
7618,3483949762,3772053179,1672551288,1672552593,1305
7566,3513956646,3636867411,1672686024,1672686281,257
7530,3776066388,3533095755,1672630944,1672633560,2616
7974,3774010081,3780503655,1672618304,1672619418,1114
7883,3294803686,3511687358,1672679153,1672682442,3289
7825,3515125508,3885897503,1672652464,1672654909,2445
7637,3365614305,3710112546,1672652181,1672654450,2269
7699,3407673904,3249401741,1672631677,1672633133,1456
7974,3483164654,3505530961,1672650171,1672652908,2737
7495,3505912939,3774066725,1672622074,1672624477,2403
7809,3972364603,3757246925,1672555060,1672557004,1944
7677,3774556560,3515394721,1672560310,1672561060,750
7940,3362000049,3901877072,1672571165,1672573318,2153
7571,3510703546,3514987389,1672562699,1672563265,566
7611,3296471982,3776066388,1672606009,1672606253,244
7540,3713349754,3336751428,1672644048,1672644761,713
7636,3774793839,3911159965,1672650094,1672652783,2689
7496,3610695419,3755920131,1672598594,1672601024,2430
7685,3713894336,3918674986,1672676753,1672677580,827
7550,3922275620,3520183192,1672600070,1672600358,288
7972,3780503655,3533137446,1672584471,1672584860,389
7566,3666553782,3512142794,1672551192,1672551785,593
7958,3473562469,3404384505,1672659889,1672660007,118
7770,3312664885,3221536550,1672650711,1672653285,2574
7617,3756966035,3511350608,1672563632,1672566504,2872
7632,3777443199,3370636709,1672649747,1672652292,2545
7661,3615046771,3510703546,1672546857,1672549804,2947
7923,3418728074,3520190170,1672588243,1672590196,1953
7770,3311871871,3517963492,1672653484,1672656155,2671
7622,3407673904,3500729955,1672569241,1672569439,198
7848,3312333615,3316222192,1672646162,1672648285,2123
7521,3733189298,3497901842,1672569921,1672573013,3092
7904,3793959750,3510244400,1672702481,1672705113,2632
7582,3629935998,3520888296,1672575726,1672577689,1963
7487,3780365428,3483164654,1672685675,1672685954,279
7919,3608633356,3400918687,1672659675,1672661114,1439
7719,3346795719,3608868877,1672684860,1672687919,3059
7502,3228165483,3839849341,1672598953,1672601037,2084
7651,3783779671,3772309150,1672552233,1672552409,176
7975,3516960534,3358871377,1672634407,1672635980,1573
7943,3223968713,3511435497,1672590565,1672593933,3368
7579,3757562897,3509634629,1672691985,1672693297,1312
7554,3480687894,3668898102,1672597006,1672598757,1751
7829,3733189298,3756930948,1672622964,1672623033,69
7521,3755798867,3516909237,1672642458,1672642988,530
7877,3778780511,3520629279,1672688556,1672688946,390
7530,3501730685,3701274634,1672651432,1672654395,2963
7933,3515860749,3400804807,1672572396,1672573905,1509
7773,3311154569,3801089989,1672621541,1672624316,2775
7648,3505635228,3432665384,1672598463,1672599269,806
7530,3666506258,3222448362,1672557339,1672558129,790
7752,3774338212,3890149705,1672701261,1672701322,61
7510,3637008488,3772746272,1672630507,1672632826,2319
7828,3221899927,3517963492,1672676855,1672678631,1776
7857,3774338212,3895562476,1672666457,1672667914,1457
7871,3513599775,3770101921,1672600952,1672603302,2350
7690,3770635361,3882291183,1672682600,1672683752,1152
7911,3501730685,3777776687,1672685173,1672687696,2523
7890,3209048907,3387674757,1672659223,1672660317,1094
7924,3505883609,3918247820,1672628830,1672629552,722
7895,3757403279,3731106822,1672606759,1672607418,659
7866,3889232789,3365942576,1672690157,1672691541,1384
7513,3339907603,3519703355,1672645288,1672645858,570
7605,3385763781,3221899927,1672571324,1672573163,1839
7561,3208844525,3755511676,1672674291,1672675466,1175
7555,3755872268,3825229501,1672660893,1672663680,2787
7896,3483164654,3387674757,1672586248,1672586380,132
7788,3352603894,3903962771,1672597789,1672597957,168
7600,3206593906,3774005526,1672628574,1672631469,2895
7701,3716746253,3362000049,1672532041,1672532136,95
7841,3701967560,3514472925,1672596211,1672598392,2181
7777,3756966035,3516629436,1672657548,1672660219,2671
7765,3736229191,3737051610,1672565307,1672568043,2736
7900,3501486692,3688418210,1672545074,1672546663,1589
7548,3772758337,3515394721,1672625934,1672628439,2505
7868,3611150562,3516011407,1672691838,1672692388,550
7536,3534702203,3837094550,1672656252,1672656809,557
7744,3682061100,3391261292,1672539399,1672539538,139
7700,3391915121,3774119563,1672653840,1672656401,2561
7948,3302626661,3774793839,1672569389,1672572766,3377
7485,3809484172,3716488385,1672627488,1672630942,3454
7782,3534702203,3384240055,1672698699,1672699874,1175
7746,3756528686,3936227020,1672595089,1672598665,3576
7702,3534553510,3432689543,1672580622,1672580891,269
7502,3552314511,3828624701,1672555811,1672558901,3090
7611,3701065786,3715998609,1672591053,1672592438,1385
7936,3533025282,3780609808,1672559987,1672562206,2219
7675,3500805881,3533371364,1672685839,1672686061,222
7945,3314836094,3517963492,1672566878,1672567359,481
7694,3473765852,3770101921,1672572890,1672574458,1568
7983,3500994774,3236102733,1672556170,1672557398,1228
7885,3757602960,3516716179,1672673490,1672675648,2158
7981,3827626797,3774268456,1672700876,1672701240,364
7831,3770101921,3608633356,1672565536,1672566463,927
7517,3224058172,3271938399,1672703293,1672704929,1636
7929,3667680268,3510594211,1672689617,1672692495,2878
7505,3772746272,3617055293,1672673111,1672675930,2819
7762,3880285638,3829764737,1672586442,1672587036,594
7672,3458539365,3497901842,1672636622,1672637791,1169
7784,3311845971,3311090974,1672557111,1672560566,3455
7978,3473562469,3773120434,1672556520,1672558967,2447
7556,3311152102,3715981584,1672597282,1672598408,1126
7797,3516909237,3315583351,1672648318,1672651287,2969
7978,3777514571,3733891182,1672638239,1672640971,2732
7949,3774066725,3516980378,1672637895,1672639603,1708
7784,3517077106,3792384220,1672638142,1672640898,2756
7898,3511170269,3509634629,1672608815,1672612328,3513
7902,3772544062,3703013906,1672678476,1672681600,3124
7623,3715998609,3883551721,1672531840,1672533616,1776
7558,3533371364,3853018906,1672653775,1672657230,3455
7956,3235287260,3774050956,1672600403,1672603537,3134
7651,3416427576,3514838220,1672695218,1672697925,2707
7774,3606812411,3882291183,1672574190,1672577121,2931
7711,3518932404,3346327502,1672686611,1672687218,607
7729,3428674539,3662180254,1672631089,1672632221,1132
7505,3805292782,3311324983,1672680247,1672683061,2814
7908,3606186086,3472130842,1672663000,1672664161,1161
7585,3777790718,3223789409,1672606296,1672607838,1542
7762,3851190615,3312829208,1672586864,1672589698,2834
7525,3701178711,3493507965,1672601105,1672604036,2931
7624,3378436155,3235287260,1672558227,1672561501,3274
7798,3505962865,3823600322,1672603229,1672606738,3509
7867,3737051610,3313564074,1672542618,1672545181,2563
7943,3520376528,3500229033,1672593987,1672594644,657
7570,3311648200,3394330287,1672591966,1672594749,2783
7639,3780788622,3755739653,1672658816,1672661642,2826
7494,3429856982,3760598102,1672573319,1672573585,266
7751,3756462516,3756027749,1672598952,1672599354,402
7874,3365830990,3780828689,1672542590,1672543833,1243
7767,3827222533,3917088658,1672646463,1672647642,1179
7950,3509773875,3476232529,1672554476,1672554967,491
7649,3910454786,3361230905,1672702202,1672705167,2965
7539,3755872268,3820354437,1672630441,1672632730,2289
7733,3534492426,3336751428,1672660312,1672662184,1872
7904,3715492942,3628819436,1672627850,1672629425,1575
7510,3924549929,3427219654,1672655260,1672657109,1849
7732,3512720680,3346327502,1672603045,1672603273,228
7630,3489217083,3713644518,1672684303,1672685551,1248
7935,3500066230,3793848402,1672657452,1672660758,3306
7618,3711265369,3883551721,1672595752,1672598250,2498
7850,3780828689,3307512479,1672677290,1672677368,78
7677,3515125508,3209383861,1672615419,1672616465,1046
7537,3920801189,3517459919,1672693926,1672695216,1290
7592,3668898102,3510594211,1672692182,1672694661,2479
7889,3533653428,3710067113,1672538463,1672539534,1071
7637,3701065786,3778780511,1672657925,1672659147,1222
7788,3772309150,3249247700,1672672844,1672675571,2727
7694,3517459919,3716488385,1672597988,1672598212,224
7671,3783206719,3485823740,1672668560,1672670097,1537
7870,3716165213,3621810464,1672671394,1672672877,1483
7559,3802367797,3716165213,1672622234,1672623934,1700
7932,3467773920,3336742544,1672578186,1672579315,1129
7786,3858918246,3421836608,1672608040,1672611470,3430
7587,3773755137,3411618230,1672664042,1672666539,2497
7543,3770078063,3386707783,1672573721,1672576817,3096
7816,3756021689,3773950140,1672635006,1672638456,3450
7585,3634786711,3485375593,1672676623,1672678899,2276
7981,3496051529,3829319703,1672598520,1672601935,3415
7826,3505292701,3791874383,1672598956,1672600688,1732
7620,3716835696,3777983879,1672599148,1672602147,2999
7627,3805519285,3515151980,1672532177,1672532771,594
7509,3388286531,3520376528,1672645571,1672647744,2173
7485,3636867411,3518876135,1672576421,1672578803,2382
7621,3791942683,3209048907,1672659657,1672662321,2664
7656,3534488837,3505873261,1672584917,1672586489,1572
7572,3311208440,3395152943,1672686112,1672686326,214
7790,3972709319,3227457126,1672634006,1672635253,1247
7938,3852595551,3627937312,1672672677,1672675949,3272
7493,3914259449,3910454786,1672624809,1672626844,2035
7788,3248507722,3512142794,1672571820,1672575296,3476
7488,3242408357,3397418363,1672597208,1672599827,2619
7927,3685818092,3911245524,1672536344,1672537710,1366
7947,3757812939,3755943611,1672656887,1672659194,2307
7766,3373384732,3770101921,1672669595,1672670112,517
7521,3711569060,3496051529,1672685307,1672688588,3281
7917,3791657947,3277939457,1672652958,1672653493,535
7724,3666506258,3391915121,1672595756,1672598662,2906
7605,3311603601,3832902928,1672604624,1672606238,1614
7902,3826415738,3505962865,1672549402,1672549615,213
7613,3407725581,3201324715,1672680881,1672683428,2547
7963,3793627961,3783126683,1672611752,1672613784,2032
7831,3760893269,3888559320,1672620583,1672621700,1117
7961,3489545239,3277669002,1672647589,1672648402,813
7810,3780639480,3533242305,1672594088,1672596442,2354
7903,3701111745,3473765852,1672551266,1672553429,2163
7952,3510173870,3372883226,1672631977,1672633216,1239
7842,3520183192,3792473331,1672553237,1672555405,2168
7795,3667680268,3793086311,1672531385,1672533022,1637
7728,3853018906,3388286531,1672592667,1672595900,3233
7714,3516980378,3760893269,1672626498,1672626759,261
7964,3792768129,3227457126,1672651042,1672654196,3154
7805,3396285984,3358871377,1672551018,1672553872,2854
7696,3701863557,3451432842,1672578507,1672580080,1573
7810,3505000737,3716168623,1672652434,1672655289,2855
7860,3439023335,3783239924,1672560444,1672560990,546
7696,3500060260,3701863557,1672540551,1672541199,648
7901,3713208927,3780639480,1672613834,1672616480,2646
7659,3492478793,3715998609,1672586365,1672587352,987
7819,3733891182,3818255890,1672556697,1672557094,397
7846,3512540951,3780639480,1672618441,1672621237,2796
7755,3755042098,3307512479,1672606695,1672608436,1741
7746,3756623396,3783206719,1672682471,1672683542,1071
7705,3471220483,3420432297,1672564881,1672567463,2582
7972,3755625324,3616944364,1672676681,1672677332,651
7648,3621810464,3451432842,1672605856,1672609063,3207
7798,3336751428,3396285984,1672554854,1672555004,150
7532,3534191820,3361230905,1672637791,1672640732,2941
7968,3409474775,3520931254,1672687971,1672690237,2266
7631,3505098372,3519803045,1672620784,1672623901,3117
7982,3505869747,3291227780,1672677953,1672678790,837
7520,3660493209,3791957752,1672554272,1672555131,859
7891,3800886801,3783509527,1672629777,1672631581,1804
7725,3244389794,3925402713,1672658920,1672659303,383
7800,3714821932,3855424474,1672561380,1672563496,2116
7712,3917088658,3404384505,1672540290,1672542029,1739
7624,3760077057,3409474775,1672678202,1672678523,321
7583,3516716179,3791020967,1672551206,1672552280,1074
7822,3510711755,3760267716,1672621620,1672624184,2564
7527,3520165601,3628819436,1672608298,1672608372,74
7792,3489728806,3533371364,1672701596,1672705149,3553
7928,3918056059,3518791447,1672582227,1672583897,1670
7913,3359910781,3793627961,1672648578,1672650279,1701
7745,3779629905,3793848402,1672586577,1672588615,2038
7704,3777623166,3780974443,1672697330,1672697639,309
7865,3614238812,3857349323,1672590884,1672591893,1009
7883,3857349323,3756966035,1672610475,1672613331,2856
7821,3534191820,3826633236,1672552167,1672554986,2819
7568,3770553384,3774298222,1672618140,1672621061,2921
7880,3756930948,3500229033,1672604598,1672607428,2830
7501,3783196518,3418534998,1672646853,1672650101,3248
7544,3703789494,3776800213,1672648364,1672648651,287
7565,3520756859,3703013906,1672584500,1672585197,697
7669,3772337814,3430074045,1672580542,1672581889,1347
7750,3935627557,3391261292,1672550320,1672553870,3550
7662,3779629905,3912262917,1672663432,1672664415,983
7937,3826633236,3500803339,1672660334,1672663111,2777
7897,3773429448,3291227780,1672575493,1672576517,1024
7532,3711308224,3516606733,1672675187,1672676964,1777
7624,3416265063,3829319703,1672598490,1672600203,1713
7632,3519556068,3634340855,1672656171,1672657674,1503
7848,3634786711,3533385867,1672613989,1672616814,2825
7566,3400804807,3512567240,1672553396,1672556710,3314
7627,3483164654,3792768129,1672697777,1672697985,208
7731,3770824086,3334033993,1672602750,1672606300,3550
7749,3972364603,3613995936,1672692602,1672695281,2679
7768,3533626375,3618045231,1672650924,1672653805,2881
7757,3244389794,3379589402,1672701048,1672703679,2631
7675,3618045231,3399433690,1672543709,1672544364,655
7964,3783245561,3514245078,1672583060,1672583367,307
7600,3774366875,3501198706,1672635979,1672638289,2310
7529,3732481297,3972364603,1672557289,1672559181,1892
7823,3512510536,3903307060,1672671434,1672673543,2109
7894,3855424474,3372883226,1672677025,1672677754,729
7725,3513956646,3711569060,1672586145,1672586814,669
7590,3420432297,3701984666,1672656520,1672658839,2319
7701,3351008918,3922275620,1672578399,1672581867,3468
7665,3639847263,3780788622,1672624726,1672627231,2505
7658,3311274543,3397418363,1672636406,1672637926,1520
7696,3485823740,3922275416,1672692594,1672693035,441
7727,3516980378,3501955238,1672640649,1672641343,694
7616,3930797455,3386707783,1672540774,1672541310,536
7746,3511332835,3778108318,1672661081,1672664481,3400
7833,3509604974,3807987001,1672584173,1672586540,2367
7771,3791901535,3774010081,1672638066,1672639025,959
7786,3783196518,3244173074,1672555630,1672557069,1439
7742,3701146057,3384951177,1672695387,1672696612,1225
7598,3481502100,3791997875,1672629728,1672632397,2669
7566,3716835696,3475795792,1672622354,1672624062,1708
7542,3701995648,3512683609,1672543994,1672547203,3209
7741,3660493209,3519069599,1672671002,1672673402,2400
7928,3634995491,3701111745,1672590582,1672592587,2005
7861,3773429448,3518360734,1672686879,1672688216,1337
7836,3610695419,3716746253,1672640696,1672641267,571
7866,3922275416,3465202715,1672651292,1672652257,965
7617,3533095755,3733891182,1672546649,1672547573,924
7778,3666553782,3772578994,1672552959,1672555845,2886
7531,3732481297,3772746272,1672653415,1672654223,808
7726,3534488837,3500060260,1672663250,1672663316,66
7715,3337544549,3511271692,1672546131,1672548417,2286
7619,3777929708,3882242815,1672659583,1672660963,1380
7775,3760489031,3924549929,1672604536,1672606597,2061
7562,3883312122,3917088658,1672703338,1672705401,2063
7588,3516960534,3716258994,1672553715,1672556619,2904
7626,3859663348,3429856982,1672562218,1672564586,2368
7849,3534010629,3307097200,1672599242,1672599846,604
7558,3229058858,3757447189,1672531947,1672533014,1067
7759,3501759100,3926700506,1672598119,1672598731,612
7674,3519912874,3772758337,1672698022,1672700286,2264
7898,3733189298,3223968713,1672620436,1672622607,2171
7613,3666457294,3755436115,1672674652,1672677583,2931
7600,3202120784,3510173870,1672591652,1672594291,2639
7625,3518496488,3301107849,1672599206,1672599376,170
7636,3513454145,3533626375,1672694122,1672695234,1112
7593,3606186086,3514987389,1672589711,1672592900,3189
7834,3776513891,3520706195,1672698634,1672699072,438
7512,3510173870,3518496488,1672639120,1672639607,487
7820,3367902229,3383661227,1672659604,1672661930,2326
7790,3520719611,3924549929,1672569636,1672571151,1515
7659,3756528686,3364543015,1672681858,1672684143,2285
7671,3774268456,3608868877,1672660004,1672661959,1955
7903,3978115672,3662180254,1672665271,1672666758,1487
7510,3505649239,3617734118,1672607901,1672610420,2519
7591,3430352815,3407725581,1672625982,1672626994,1012
7859,3783206719,3500066230,1672676836,1672679674,2838
7693,3284832486,3465254146,1672594444,1672595952,1508
7493,3505201246,3701898991,1672581841,1672582531,690
7785,3516909237,3774298222,1672553064,1672556360,3296
7803,3534492426,3510857360,1672703472,1672705236,1764
7941,3512349371,3739106581,1672615010,1672616547,1537
7843,3391261292,3757682496,1672632042,1672632332,290
7806,3736419952,3500365158,1672596264,1672597027,763
7662,3793848402,3852391257,1672691939,1672694652,2713
7663,3636867411,3608868877,1672540160,1672542311,2151
7887,3221536550,3427219654,1672619488,1672620488,1000
7887,3417061462,3778549126,1672579095,1672581084,1989
7911,3406784491,3757447189,1672687492,1672689590,2098
7605,3458539365,3280599164,1672614248,1672617611,3363
7526,3515723720,3777790718,1672535777,1672535962,185
7491,3433804879,3857349323,1672697044,1672699048,2004
7720,3921211276,3315583351,1672702388,1672702904,516
7637,3815508790,3496051529,1672671140,1672672083,943
7719,3291235378,3509672210,1672645224,1672646559,1335
7697,3519700826,3227457126,1672648601,1672650814,2213
7542,3520730271,3484995752,1672683265,1672685765,2500
7618,3372883226,3332072298,1672699748,1672702174,2426
7572,3783531004,3792789881,1672624754,1672625380,626
7674,3792768129,3514719601,1672532050,1672535031,2981
7845,3511267139,3415546117,1672618830,1672622319,3489
7582,3415546117,3285400528,1672649217,1672649360,143
7517,3755587522,3367029997,1672667795,1672668313,518
7733,3755739653,3783779671,1672602272,1672604650,2378
7559,3477375368,3373384732,1672596940,1672598769,1829
7550,3770447408,3533095755,1672557264,1672559390,2126
7668,3770021824,3626156564,1672670522,1672671941,1419
7726,3811694763,3509634629,1672581609,1672582159,550
7862,3501692334,3519428855,1672549973,1672551865,1892
7684,3809484172,3416427576,1672553660,1672554912,1252
7624,3534702203,3792789881,1672648693,1672651018,2325
7563,3412980697,3926700506,1672586477,1672589796,3319
7536,3791553060,3736625083,1672656436,1672657261,825
7932,3404384505,3626156564,1672594809,1672597511,2702
7656,3485008994,3400804807,1672663792,1672664415,623
7698,3937224533,3500805881,1672625823,1672626682,859
7765,3774793839,3711571712,1672686345,1672689110,2765
7485,3770851318,3236102733,1672662318,1672664181,1863
7833,3901990690,3533626375,1672531970,1672533898,1928
7927,3811694763,3792384220,1672581942,1672582338,396
7932,3760992710,3505869747,1672591772,1672592395,623
7489,3304625412,3760893269,1672553043,1672554349,1306
7687,3859525941,3760561634,1672639115,1672642441,3326
7850,3438645253,3311154569,1672699477,1672702991,3514
7824,3365830990,3735319397,1672680019,1672680795,776
7794,3779629905,3313564074,1672592150,1672595016,2866
7799,3925620998,3783196518,1672586016,1672588550,2534
7827,3792177074,3512969370,1672585731,1672588286,2555
7867,3735319397,3882242815,1672560251,1672563616,3365
7950,3756528686,3534010629,1672539393,1672542361,2968
7614,3311761694,3509352754,1672681313,1672684836,3523
7915,3247428249,3500729955,1672628098,1672628843,745
7946,3473562469,3518014404,1672561394,1672564258,2864
7862,3387966152,3778305740,1672621242,1672623187,1945
7929,3533242305,3514987389,1672598916,1672601198,2282
7665,3904408902,3886298125,1672552020,1672552379,359
7532,3313541986,3716197887,1672549622,1672551124,1502
7558,3883551721,3505599848,1672689164,1672691125,1961
7945,3792177074,3756021689,1672588236,1672591636,3400
7608,3735319397,3772758337,1672643691,1672645931,2240
7802,3774501422,3800886801,1672702491,1672705065,2574
7911,3483164654,3222521619,1672665278,1672666029,751
7637,3701691675,3458539365,1672610469,1672613123,2654
7803,3703661585,3851190615,1672596851,1672597434,583
7520,3516673015,3777079686,1672671821,1672675401,3580
7795,3505173328,3430352815,1672653876,1672655244,1368
7784,3315583351,3533371364,1672703979,1672706468,2489
7913,3779036831,3365278081,1672626059,1672628730,2671
7867,3533242305,3501730685,1672575365,1672576342,977
7707,3505347134,3833889105,1672636213,1672638778,2565
7630,3411618230,3731419510,1672611944,1672612272,328
7547,3792768129,3757602960,1672663732,1672666536,2804
7824,3701691675,3439023335,1672547852,1672549226,1374
7520,3399052055,3773598056,1672580085,1672580723,638
7869,3365278081,3533385867,1672606563,1672609731,3168
7635,3514838220,3421127249,1672641350,1672643446,2096
7494,3209027249,3931941795,1672678072,1672678538,466
7607,3223789409,3711380716,1672693238,1672695433,2195
7757,3757682496,3800886801,1672658496,1672658896,400
7982,3510969660,3315583351,1672565954,1672568291,2337
7587,3430074045,3833889105,1672582428,1672582730,302
7800,3779528381,3972709319,1672538887,1672540190,1303
7798,3505173328,3520629279,1672570538,1672571739,1201
7893,3731106822,3533626375,1672658654,1672661846,3192
7877,3232962003,3779740455,1672538794,1672541785,2991
7838,3249247700,3918247820,1672563339,1672566888,3549
7818,3505193212,3420432297,1672565701,1672568765,3064
7558,3779528381,3783925755,1672644554,1672646550,1996
7587,3501184421,3520030713,1672625308,1672625880,572
7516,3285400528,3939952128,1672564732,1672566606,1874
7626,3713349754,3370752401,1672609624,1672610452,828
7490,3518496488,3500805881,1672692562,1672693301,739
7801,3774204963,3487171044,1672586873,1672590219,3346
7601,3714504419,3774298222,1672650339,1672653933,3594
7961,3710569131,3519069599,1672657562,1672659954,2392
7713,3505292701,3534424200,1672641373,1672643931,2558
7830,3757455053,3510771358,1672626907,1672627295,388
7499,3471220483,3533193862,1672548458,1672551794,3336
7698,3755798867,3451432842,1672619569,1672619753,184
7494,3760489031,3757246925,1672551927,1672553941,2014
7849,3221536550,3910886626,1672584778,1672586879,2101
7889,3359239884,3311993075,1672681099,1672682236,1137
7659,3734496778,3668898102,1672546203,1672548537,2334
7943,3402943525,3760569731,1672652941,1672655231,2290
7680,3917278625,3711262377,1672557420,1672560382,2962
7682,3315583351,3774466457,1672539695,1672542206,2511
7604,3296471982,3512142794,1672621763,1672622347,584
7497,3273500349,3510771358,1672626412,1672629432,3020
7514,3774195321,3773120434,1672608567,1672610711,2144
7818,3715974031,3713969578,1672588496,1672590617,2121
7606,3760267716,3505193212,1672626059,1672627396,1337
7519,3430074045,3899266183,1672655067,1672655362,295
7772,3512969370,3519428855,1672671324,1672672131,807
7550,3357483218,3882997884,1672660155,1672661071,916
7687,3710408395,3809916577,1672545455,1672547566,2111
7634,3234362962,3737079798,1672687131,1672690689,3558
7574,3244436890,3839849341,1672672722,1672673209,487
7764,3714474557,3514838220,1672537534,1672540776,3242
7741,3244173074,3807987001,1672579890,1672582009,2119
7490,3613683164,3517864478,1672702871,1672704405,1534
7738,3773664987,3716197887,1672665648,1672667704,2056
7839,3475251781,3774010081,1672667610,1672669302,1692
7485,3606186086,3374559242,1672605784,1672609247,3463
7718,3618045231,3911245524,1672649712,1672652123,2411
7633,3624761861,3731106822,1672641550,1672645103,3553
7898,3667680268,3887270940,1672656390,1672657039,649
7719,3477375368,3791594391,1672613289,1672613908,619
7811,3666507626,3792668962,1672616764,1672620209,3445
7731,3855937514,3517476351,1672584179,1672586162,1983
7573,3483949762,3829319703,1672599972,1672602291,2319
7490,3298288268,3792177074,1672536123,1672538806,2683
7758,3780974443,3367029997,1672700371,1672701926,1555
7580,3511198618,3899266183,1672695232,1672698286,3054
7843,3296471982,3494290908,1672564778,1672566727,1949
7968,3925402713,3396285984,1672574045,1672575860,1815
7754,3481502100,3222448362,1672546316,1672546700,384
7553,3780365428,3792177074,1672606130,1672607528,1398
7706,3514472925,3755798867,1672701644,1672704274,2630
7685,3921211276,3618873142,1672641820,1672643567,1747
7517,3519601612,3829232696,1672544659,1672546754,2095
7624,3711262377,3780813786,1672602314,1672602841,527
7796,3313541986,3834257412,1672587436,1672589971,2535
7554,3780609808,3394330287,1672542054,1672543559,1505
7581,3774195321,3607178184,1672565068,1672567030,1962
7832,3500365158,3886298125,1672602420,1672604881,2461
7594,3624312512,3918674986,1672685657,1672687456,1799
7959,3792253549,3880310724,1672683440,1672684796,1356
7772,3359239884,3780813786,1672548769,1672551585,2816
7939,3249791738,3887270940,1672643155,1672646317,3162
7901,3249247700,3383922351,1672666734,1672667349,615
7886,3716168623,3510380060,1672576904,1672577217,313
7943,3348261553,3733891182,1672617394,1672618856,1462
7953,3271938399,3780914982,1672549467,1672550574,1107
7954,3711504540,3318166135,1672629554,1672631324,1770
7498,3432689543,3779740455,1672694558,1672695994,1436
7673,3922337974,3780788622,1672633361,1672633869,508
7981,3683959482,3384951177,1672645363,1672646923,1560
7632,3783429780,3774119563,1672535644,1672539027,3383
7540,3518360734,3511163800,1672585156,1672588200,3044
7529,3365278081,3277939457,1672622431,1672625211,2780
7929,3312333615,3780593036,1672611562,1672612373,811
7574,3518408774,3318697153,1672547906,1672550602,2696
7684,3887270940,3516960534,1672653841,1672657113,3272
7824,3852595551,3779218771,1672567434,1672567793,359
7814,3756601594,3238712269,1672625424,1672625813,389
7729,3916289176,3834257412,1672596893,1672599665,2772
7706,3534191820,3783206719,1672560393,1672563546,3153
7782,3519428855,3757812939,1672655828,1672657435,1607
7869,3485375593,3534729133,1672677889,1672678776,887
7532,3378686918,3277669002,1672577208,1672579765,2557
7843,3805519285,3333896808,1672636262,1672638721,2459
7899,3703955926,3313564074,1672694730,1672696399,1669
7579,3606812411,3244173074,1672662003,1672665380,3377
7817,3206593906,3311154569,1672632784,1672634868,2084
7883,3780609808,3348261553,1672593637,1672595486,1849
7610,3885897503,3311203656,1672662915,1672664577,1662
7609,3760267716,3793848402,1672573670,1672574683,1013
7928,3773755137,3615046771,1672638905,1672639724,819
7797,3757455053,3880285638,1672552363,1672554775,2412
7758,3484995752,3394539273,1672613072,1672614742,1670
7726,3514128943,3811694763,1672636844,1672637937,1093
7848,3793962300,3448855696,1672562619,1672565056,2437
7769,3400804807,3231056870,1672609721,1672612686,2965
7864,3399911573,3227158514,1672561426,1672562135,709
7580,3792789881,3424922204,1672698760,1672700644,1884
7561,3208844525,3496051529,1672682853,1672683018,165
7818,3559110998,3701146057,1672550169,1672553566,3397
7756,3332072298,3286658957,1672659718,1672661931,2213
7735,3513080274,3518360734,1672649140,1672649297,157
7599,3617734118,3399911573,1672626592,1672630032,3440
7983,3774268456,3760183458,1672533045,1672536073,3028
7969,3513599775,3855937514,1672567311,1672568327,1016
7692,3755872268,3400804807,1672660309,1672663392,3083
7898,3711370563,3511125626,1672598149,1672599614,1465
7729,3407954858,3286658957,1672688362,1672691510,3148
7616,3448855696,3760492950,1672659952,1672662437,2485
7542,3518360734,3516980378,1672624979,1672627843,2864
7531,3914290246,3313541986,1672675363,1672675670,307
7849,3793086311,3777120536,1672573985,1672576759,2774
7940,3774050956,3406784491,1672545605,1672547079,1474
7483,3825229501,3779629905,1672610377,1672611738,1361
7484,3311065516,3500177712,1672631951,1672634556,2605
7506,3770824086,3518014404,1672657385,1672658988,1603
7506,3509672210,3618873142,1672633424,1672636536,3112
7661,3685818092,3231056870,1672667745,1672667953,208
7711,3734828619,3839849341,1672535518,1672536488,970
7887,3511862351,3716537575,1672652188,1672654100,1912
7660,3384951177,3888559320,1672640285,1672642556,2271
7759,3760077057,3416427576,1672563538,1672565324,1786
7908,3420700674,3882291183,1672695813,1672697151,1338
7822,3420700674,3298433163,1672699410,1672701836,2426
7829,3520190170,3516909237,1672607149,1672607416,267
7912,3513164386,3662180254,1672659414,1672662653,3239
7538,3500458761,3774501422,1672571844,1672573100,1256
7791,3453729665,3383661227,1672660082,1672662870,2788
7638,3855424474,3760492950,1672577386,1672579069,1683
7490,3489545239,3509907947,1672657497,1672661048,3551
7719,3518496488,3757246925,1672673554,1672676804,3250
7512,3512720680,3209027249,1672572311,1672574849,2538
7860,3511163800,3312829208,1672695858,1672698883,3025
7760,3825229501,3755798867,1672659591,1672659693,102
7495,3520730271,3513080274,1672625931,1672627391,1460
7963,3384240055,3496269445,1672538277,1672541194,2917
7567,3915628728,3683766533,1672661097,1672663144,2047
7758,3285400528,3882291183,1672639078,1672640708,1630
7584,3430504438,3937224533,1672531547,1672533521,1974
7624,3816454165,3391261292,1672635829,1672637822,1993
7513,3388637594,3911159965,1672665681,1672667591,1910
7840,3206603608,3901877072,1672546760,1672547061,301
7895,3716537575,3703735129,1672571219,1672572475,1256
7756,3280964728,3416241005,1672591786,1672593479,1693
7524,3713808837,3518876135,1672563794,1672566765,2971
7526,3756623396,3883551721,1672682589,1672685875,3286
7932,3800353779,3475795792,1672589242,1672592114,2872
7878,3757562897,3832902928,1672532855,1672534232,1377
7496,3505638204,3757447189,1672590911,1672591624,713
7555,3533270638,3500805881,1672576046,1672577751,1705
7666,3311648200,3716746253,1672611783,1672614014,2231
7639,3793627961,3780639480,1672574347,1672577647,3300
7807,3714504419,3244389794,1672673019,1672675417,2398
7557,3772359096,3777514571,1672620077,1672622007,1930
7657,3701967560,3513164386,1672668767,1672670544,1777
7556,3244389794,3827626797,1672678561,1672679252,691
7838,3880285638,3534702203,1672647253,1672650668,3415
7810,3817621391,3701065786,1672666949,1672669291,2342
7825,3760509236,3792032359,1672611061,1672613751,2690
7689,3505098372,3760509236,1672620187,1672621808,1621
7545,3606186086,3516514391,1672637424,1672639104,1680
7649,3501601840,3756462516,1672681915,1672683494,1579
7512,3804870229,3513201436,1672624140,1672627086,2946
7839,3520165601,3475396323,1672567817,1672570836,3019
7781,3792768129,3716843669,1672543955,1672544832,877
7735,3703013906,3500177712,1672615306,1672615457,151
7933,3314836094,3882997884,1672621355,1672624607,3252
7745,3760598102,3711569060,1672641969,1672643416,1447
7568,3882997884,3285400528,1672561900,1672564390,2490
7484,3223968713,3424922204,1672685663,1672686793,1130
7928,3783429780,3739106581,1672659035,1672662489,3454
7821,3346795719,3701995648,1672563221,1672566586,3365
7523,3238712269,3851190615,1672584328,1672585741,1413
7823,3710112546,3387674757,1672582081,1672584090,2009
7854,3774268456,3756966035,1672618805,1672621379,2574
7494,3307097200,3806545488,1672549984,1672552660,2676
7522,3519601612,3760561634,1672603868,1672604510,642
7563,3201432789,3337544549,1672616257,1672617743,1486
7519,3885897503,3633420270,1672539269,1672540463,1194
7568,3772309150,3518014636,1672701585,1672703196,1611
7935,3816454165,3774339795,1672541075,1672541698,623
7748,3500805881,3331845324,1672601113,1672603758,2645
7767,3770447408,3512166013,1672624002,1672625071,1069
7611,3755511676,3829764737,1672634039,1672636150,2111
7734,3500805881,3487171044,1672661610,1672663847,2237
7641,3887270940,3409474775,1672586232,1672588555,2323
7943,3757812939,3520888296,1672654139,1672656963,2824
7878,3493507965,3760492950,1672585051,1672585681,630
7935,3490191091,3780365428,1672639261,1672639829,568
7770,3387966152,3515723720,1672659576,1672662355,2779
7817,3715974031,3514472925,1672660885,1672663885,3000
7652,3514128943,3703871468,1672687308,1672689049,1741
7885,3716537575,3770763956,1672597359,1672600731,3372
7691,3391915886,3365942576,1672681631,1672682118,487
7675,3515151980,3662180254,1672680619,1672681381,762
7917,3509630174,3517476351,1672571317,1672573678,2361
7793,3519069599,3554917400,1672569638,1672571106,1468
7802,3516011407,3617734118,1672667402,1672668757,1355
7570,3500578848,3399004969,1672657598,1672659473,1875
7621,3760294205,3716258994,1672601711,1672604891,3180
7976,3713808837,3921211276,1672653845,1672656098,2253
7580,3430352815,3519556068,1672538433,1672540541,2108
7938,3920801189,3636867411,1672614608,1672618004,3396
7960,3517476351,3370636709,1672597157,1672597573,416
7602,3509604974,3791020967,1672669562,1672671467,1905
7694,3973560347,3756453423,1672564935,1672565921,986
7907,3533385867,3501692334,1672535061,1672538271,3210
7959,3285400528,3236102733,1672595930,1672596424,494
7709,3517077106,3772758337,1672537654,1672541212,3558
7851,3420700674,3307512479,1672663969,1672664804,835
7576,3715127362,3918584946,1672644933,1672647163,2230
7651,3780294829,3336742544,1672680890,1672683584,2694
7940,3356860407,3500803339,1672671335,1672673819,2484
7926,3505000737,3805342762,1672561319,1672563133,1814
7591,3902383721,3515860749,1672533023,1672533810,787
7711,3777120536,3604539807,1672689752,1672691565,1813
7964,3773465237,3501601840,1672621424,1672622168,744
7892,3505912939,3514283243,1672563184,1672563911,727
7519,3711198793,3428006164,1672538006,1672541568,3562
7792,3777623166,3512683609,1672614129,1672614890,761
7915,3505962865,3303751772,1672675341,1672677003,1662
7743,3778308417,3359910781,1672659357,1672662411,3054
7906,3515860749,3668898102,1672580158,1672580715,557
7788,3823600322,3972709319,1672656639,1672659158,2519
7936,3359239884,3608633356,1672675793,1672677545,1752
7630,3489728806,3716197887,1672618410,1672621128,2718
7848,3713349754,3792288302,1672670647,1672672855,2208
7704,3500199935,3518163778,1672693758,1672696541,2783
7581,3714821932,3777443199,1672691236,1672691393,157
7760,3516258476,3836573197,1672604564,1672606515,1951
7964,3332072298,3500060260,1672658767,1672659804,1037
7571,3634340855,3224716315,1672633631,1672633800,169
7602,3701146057,3624312512,1672534347,1672536935,2588
7946,3735733948,3701898991,1672679652,1672682941,3289
7612,3200691026,3515151980,1672666104,1672669188,3084
7885,3505635228,3313541986,1672550307,1672550381,74
7529,3284832486,3201324715,1672664781,1672666674,1893
7542,3303705369,3939952128,1672569287,1672570388,1101
7626,3510969660,3477375368,1672603337,1672606348,3011
7886,3428674539,3400918687,1672643232,1672645783,2551
7915,3379589402,3730517636,1672689992,1672692748,2756
7537,3734737881,3701898991,1672656384,1672659907,3523
7957,3510969660,3755625324,1672594030,1672594830,800
7868,3711569060,3774005526,1672538737,1672541752,3015
7836,3352603894,3920801189,1672575727,1672576283,556
7746,3773465237,3311993075,1672560018,1672562571,2553
7745,3516716179,3511332835,1672634104,1672635571,1467
7930,3773664987,3471220483,1672618215,1672619464,1249
7899,3935627557,3501364586,1672645878,1672649380,3502
7793,3391915886,3713644518,1672584033,1672584253,220
7708,3851190615,3446948848,1672553459,1672554487,1028
7680,3429856982,3793338102,1672683782,1672686656,2874
7486,3313564074,3224058172,1672687113,1672687325,212
7837,3394330287,3911159965,1672626917,1672627555,638
7826,3514719601,3372883226,1672630229,1672633274,3045
7491,3477375368,3227158514,1672646520,1672648993,2473
7505,3533369198,3517864478,1672556267,1672559413,3146
7759,3755920131,3475258557,1672539706,1672540979,1273
7506,3501692334,3731106822,1672650603,1672650852,249
7746,3912262917,3703789494,1672585698,1672589210,3512
7500,3511332835,3898995675,1672661792,1672662874,1082
7663,3518163778,3500805881,1672631611,1672634826,3215
7738,3757151210,3891751546,1672645854,1672646845,991
7941,3855602893,3505702787,1672571396,1672572034,638
7626,3776066388,3509773875,1672557346,1672558786,1440
7729,3755625324,3484995752,1672542184,1672542383,199
7820,3220716272,3772359096,1672585472,1672586220,748
7564,3416427576,3277669002,1672691544,1672692735,1191
7719,3221899927,3247428249,1672684924,1672687733,2809
7936,3772578994,3880310724,1672659200,1672661215,2015
7586,3206254161,3922275620,1672531548,1672532214,666
7650,3500904641,3783245561,1672567248,1672567472,224
7784,3898995675,3231056870,1672648692,1672648820,128
7895,3512567240,3360743849,1672660862,1672663627,2765
7875,3520183192,3501364586,1672559909,1672563462,3553
7775,3773755137,3513956646,1672574670,1672577727,3057
7686,3511359172,3715981584,1672586524,1672587713,1189
7744,3387966152,3625274012,1672540292,1672542646,2354
7819,3512720680,3552314511,1672558982,1672559175,193
7786,3505702787,3342131135,1672588293,1672591304,3011
7665,3805347939,3370752401,1672558244,1672559018,774
7906,3917088658,3520190170,1672702676,1672703267,591
7605,3817621391,3519601612,1672634315,1672635607,1292
7634,3711504540,3514128943,1672668592,1672671702,3110
7626,3365942576,3701146057,1672700561,1672703083,2522
7788,3534313900,3806545488,1672610737,1672611244,507
7620,3773120434,3756930948,1672566896,1672567344,448
7834,3291883916,3777443199,1672604683,1672606279,1596
7504,3534191820,3829319703,1672563330,1672563876,546
7891,3227457126,3976390453,1672552055,1672552412,357
7622,3209027249,3827377568,1672615408,1672616240,832
7567,3779976989,3791942683,1672691349,1672692190,841
7890,3514838220,3312333615,1672676825,1672677385,560
7802,3820354437,3755739653,1672607536,1672610115,2579
7949,3513599775,3777455223,1672538062,1672540870,2808
7582,3931941795,3703735129,1672608083,1672610120,2037
7979,3772642849,3755881905,1672610124,1672610302,178
7647,3922275416,3433804879,1672579037,1672581703,2666
7883,3774204963,3780593036,1672628027,1672628841,814
7731,3760077057,3605726278,1672622235,1672625250,3015
7778,3519428855,3760992710,1672565610,1672568843,3233
7543,3773429448,3514283243,1672643908,1672645144,1236
7972,3755920131,3206603608,1672699080,1672701110,2030
7785,3755920131,3429690204,1672606924,1672610308,3384
7970,3298288268,3280615985,1672543548,1672543851,303
7524,3284832486,3809916577,1672666884,1672668877,1993
7491,3446948848,3429856982,1672626794,1672629698,2904
7558,3298288268,3394539273,1672631297,1672634385,3088
7904,3770021824,3429690204,1672548972,1672550699,1727
7912,3514987389,3777790718,1672696978,1672699381,2403
7742,3448855696,3559110998,1672561936,1672564659,2723
7971,3430504438,3244173074,1672575840,1672576338,498
7611,3839849341,3287105466,1672598377,1672601435,3058
7653,3772746272,3756453423,1672688358,1672689434,1076
7584,3780974443,3293695955,1672637898,1672638797,899
7782,3811694763,3426325549,1672597435,1672598727,1292
7644,3713208927,3922337974,1672534602,1672537781,3179
7551,3427219654,3757151210,1672699415,1672700166,751
7909,3774501422,3515860749,1672543758,1672544630,872
7567,3926700506,3505912939,1672651894,1672651998,104
7857,3415546117,3902383721,1672627339,1672628687,1348
7864,3627937312,3311718847,1672638695,1672641621,2926
7982,3337544549,3811694763,1672663868,1672664105,237
7798,3500066230,3715974031,1672584494,1672588019,3525
7855,3533137446,3617055293,1672683022,1672686380,3358
7965,3534313900,3737079798,1672603445,1672606283,2838
7952,3972709319,3482405588,1672537677,1672539268,1591
7883,3629547065,3505219850,1672587211,1672590067,2856
7748,3755511676,3517864478,1672639966,1672640255,289
7697,3826415738,3489217083,1672537961,1672540225,2264
7608,3316222192,3533827120,1672536689,1672538617,1928
7619,3793286136,3917088658,1672537166,1672540484,3318
7771,3918056059,3415443558,1672619053,1672619675,622
7725,3791602225,3832902928,1672615543,1672617740,2197
7562,3801089989,3716273414,1672588265,1672590137,1872
7807,3711262377,3249401741,1672534821,1672537688,2867
7602,3882997884,3760183458,1672593475,1672597042,3567
7547,3777120536,3777790718,1672703385,1672706884,3499
7485,3518791447,3733189298,1672670142,1672671741,1599
7801,3855602893,3926700506,1672646485,1672647474,989
7981,3465254146,3232962003,1672676848,1672679599,2751
7742,3828365570,3505873261,1672653762,1672656050,2288
7714,3774050956,3476232529,1672556649,1672557268,619
7730,3793436995,3903009525,1672603270,1672605052,1782
7983,3533137446,3513599775,1672589497,1672590344,847
7874,3715189301,3533385867,1672641850,1672645055,3205
7939,3628819436,3777790718,1672552014,1672553703,1689
7779,3780503655,3755739653,1672655929,1672657510,1581
7955,3516223597,3206254161,1672665656,1672667313,1657
7580,3505912939,3779036831,1672592163,1672594366,2203
7635,3427219654,3208844525,1672552841,1672555528,2687
7648,3337544549,3662180254,1672573705,1672576538,2833
7936,3600647945,3311152102,1672534542,1672536304,1762
7912,3483164654,3494290908,1672556419,1672558935,2516
7486,3778549126,3899204805,1672614307,1672616569,2262
7900,3339907603,3511312803,1672668398,1672671896,3498
7725,3770021824,3885897503,1672581985,1672583650,1665
7560,3793436995,3618045231,1672667217,1672668065,848
7833,3365614305,3485375593,1672588770,1672589513,743
7837,3298288268,3501927421,1672602731,1672603797,1066
7885,3516465662,3760267716,1672619195,1672621808,2613
7927,3774045700,3510244400,1672636273,1672637117,844
7718,3552314511,3760492950,1672624343,1672625109,766
7767,3858918246,3633420270,1672545572,1672546069,497
7644,3935127663,3417970574,1672556113,1672558926,2813
7778,3342131135,3791942683,1672641510,1672643845,2335
7660,3770447408,3891751546,1672640845,1672643086,2241
7616,3519601612,3792473331,1672659672,1672662031,2359
7498,3703735129,3791874383,1672576682,1672579177,2495
7688,3716197887,3713969578,1672600497,1672603478,2981
7866,3773664987,3513080274,1672623484,1672623688,204
7565,3882291183,3500803339,1672702172,1672705704,3532
7734,3404384505,3276640712,1672656782,1672659465,2683
7775,3883085535,3510594211,1672670973,1672673908,2935
7548,3518014404,3311627628,1672683451,1672684366,915
7769,3703661585,3512567240,1672623947,1672626173,2226
7729,3505219850,3222448362,1672534641,1672537711,3070
7540,3511687358,3780609808,1672598108,1672600118,2010
7886,3703871468,3313541986,1672582518,1672583974,1456
7515,3500805881,3505973226,1672604330,1672606991,2661
7629,3222521619,3812176780,1672640017,1672640979,962
7816,3333896808,3738274418,1672566202,1672569060,2858
7784,3359239884,3518014636,1672630356,1672633486,3130
7615,3634340855,3388637594,1672630709,1672631138,429
7624,3791942683,3311845971,1672640877,1672641120,243
7499,3715981584,3711973519,1672532260,1672532909,649
7855,3755042098,3520190170,1672554127,1672556368,2241
7549,3812176780,3505530961,1672595831,1672596133,302
7807,3780503655,3467773920,1672538753,1672542318,3565
7909,3711198793,3505635228,1672641716,1672642488,772
7801,3703735129,3511267139,1672555393,1672557994,2601
7824,3776066388,3735319397,1672542496,1672544059,1563
7740,3533827120,3511350608,1672642066,1672642692,626
7913,3428964059,3778305740,1672584259,1672586065,1806
7770,3715127362,3666506258,1672537856,1672540398,2542
7901,3701274634,3833889105,1672611178,1672613286,2108
7812,3518876135,3434642576,1672578627,1672579300,673
7605,3395152943,3973560347,1672621314,1672624567,3253
7932,3520931254,3903962771,1672644178,1672645696,1518
7933,3899371911,3221536550,1672656811,1672659574,2763
7921,3701178711,3515151980,1672622805,1672622969,164
7899,3701065786,3500374658,1672648509,1672649733,1224
7630,3345207877,3793338102,1672560979,1672561459,480
7525,3389115045,3774520233,1672636746,1672638490,1744
7907,3734828619,3772758337,1672578341,1672580543,2202
7958,3209551760,3500458761,1672637904,1672638100,196
7854,3249247700,3505135325,1672667760,1672668795,1035
7590,3756623396,3711504540,1672559092,1672562511,3419
7789,3533626375,3792384220,1672534060,1672535026,966
7488,3629935998,3774556560,1672539818,1672540134,316
7812,3367902229,3316173088,1672580674,1672580770,96
7763,3757151210,3606987130,1672599026,1672600382,1356
7625,3505599848,3432689543,1672586310,1672586921,611
7968,3791602225,3511862351,1672684947,1672686149,1202
7893,3755625324,3755436115,1672668749,1672669972,1223
7776,3501955238,3501483568,1672547909,1672550267,2358
7609,3909238838,3555214688,1672633168,1672634829,1661
7511,3277939457,3888559320,1672531945,1672533170,1225
7653,3361230905,3930797455,1672614831,1672614968,137
7791,3711198793,3701146057,1672591148,1672591214,66
7723,3500904641,3458539365,1672555273,1672557144,1871
7726,3736625083,3791901535,1672599267,1672599684,417
7643,3533927138,3912262917,1672554936,1672558503,3567
7905,3415443558,3774556560,1672574971,1672578327,3356
7827,3668898102,3505635228,1672629291,1672631127,1836
7881,3777717988,3519703355,1672670675,1672673099,2424
7597,3428674539,3881477378,1672548629,1672551836,3207
7690,3883042241,3777929708,1672556134,1672557268,1134
7630,3520751702,3489217083,1672627052,1672628670,1618
7668,3221899927,3773598056,1672644796,1672647276,2480
7915,3235287260,3228165483,1672561395,1672564361,2966
7611,3757447189,3773598056,1672669247,1672670504,1257
7534,3730517636,3430504438,1672541488,1672543270,1782
7850,3703441914,3895562476,1672622802,1672626264,3462
7546,3511312803,3351008918,1672634573,1672636523,1950
7826,3714962248,3716273414,1672578950,1672579944,994
7827,3286658957,3388637594,1672579784,1672581330,1546
7965,3791957752,3668898102,1672610422,1672613975,3553
7893,3351554343,3409474775,1672561891,1672562730,839
7640,3518791447,3792902982,1672539493,1672542642,3149
7822,3519700826,3755920131,1672667445,1672670060,2615
7892,3826760240,3367029997,1672644720,1672648179,3459
7579,3668898102,3772309150,1672688429,1672689007,578
7717,3777929708,3520165601,1672564865,1672567932,3067
7546,3756623396,3242408357,1672697297,1672700768,3471
7535,3783239924,3791657947,1672588284,1672589130,846
7689,3802367797,3852595551,1672571138,1672573869,2731
7957,3311065516,3737154119,1672578551,1672579522,971
7724,3713630656,3791874383,1672651516,1672653517,2001
7678,3509907947,3448855696,1672698164,1672700880,2716
7573,3222521619,3505203158,1672541047,1672544155,3108
7946,3757447189,3685187183,1672614194,1672614762,568
7722,3552314511,3783239924,1672631992,1672634815,2823
7847,3512349371,3500729955,1672605201,1672608798,3597
7762,3517476351,3311203656,1672666696,1672670264,3568
7741,3837094550,3511125626,1672606524,1672608109,1585
7826,3917088658,3736625083,1672594027,1672596670,2643
7721,3360506772,3420432297,1672592852,1672595565,2713
7628,3616944364,3432689543,1672638743,1672641343,2600
7909,3779629905,3519703355,1672560282,1672563430,3148
7792,3505635228,3294803686,1672532529,1672535944,3415
7624,3480687894,3711308224,1672664294,1672665215,921
7656,3774501422,3970117174,1672568326,1672571872,3546
7499,3783531004,3918674986,1672694899,1672697998,3099
7630,3500199935,3505904952,1672628024,1672631142,3118
7598,3774125065,3791957752,1672616051,1672617812,1761
7979,3520756859,3627937312,1672644276,1672645641,1365
7486,3703013906,3770635361,1672669556,1672672010,2454
7611,3430504438,3286658957,1672617875,1672618073,198
7562,3509453566,3519069599,1672608672,1672611698,3026
7536,3703275621,3511125626,1672603616,1672606499,2883
7514,3792288302,3517459919,1672694999,1672695877,878
7540,3756027749,3438645253,1672535283,1672537329,2046
7542,3490191091,3510247121,1672546977,1672547274,297
7967,3902278226,3509352754,1672669796,1672670953,1157
7810,3518876135,3918056059,1672581423,1672582489,1066
7789,3519700826,3701898991,1672535315,1672536700,1385
7810,3459030804,3399004969,1672550711,1672553805,3094
7946,3778308417,3249401741,1672617417,1672619436,2019
7666,3224716315,3780813786,1672543375,1672545254,1879
7948,3711380716,3885897503,1672587104,1672590592,3488
7545,3409474775,3520931254,1672670407,1672673279,2872
7498,3475258557,3519428855,1672640647,1672643296,2649
7847,3791553060,3666507626,1672561855,1672564946,3091
7581,3774366875,3777623166,1672542561,1672545463,2902
7492,3912536808,3829764737,1672610108,1672612841,2733
7745,3501364586,3685187183,1672675156,1672678196,3040
7920,3246596716,3776513891,1672563103,1672565197,2094
7728,3760267716,3939952128,1672535158,1672537213,2055
7898,3826760240,3793286136,1672604721,1672606502,1781
7798,3777455223,3713268590,1672656759,1672658794,2035
7542,3510247121,3430504438,1672560043,1672561840,1797
7798,3711571712,3772714862,1672654626,1672656060,1434
7932,3770021824,3511163800,1672631078,1672632849,1771
7757,3918584946,3534702203,1672547915,1672548812,897
7960,3316222192,3511170269,1672568452,1672570287,1835
7772,3975287541,3475795792,1672700470,1672702202,1732
7793,3518260334,3427283336,1672534320,1672534702,382
7714,3783925755,3519912874,1672666715,1672667270,555
7955,3516011407,3361230905,1672617370,1672619320,1950
7802,3711262377,3800353779,1672673044,1672674378,1334
7572,3229665776,3774066725,1672559298,1672560847,1549
7750,3757682496,3783705817,1672560381,1672563622,3241
7689,3804870229,3925402713,1672694525,1672694653,128
7483,3510711755,3710408395,1672650623,1672653400,2777
7725,3509604974,3399535232,1672696246,1672698606,2360
7662,3793389510,3518932404,1672555830,1672558240,2410
7515,3664170666,3774501422,1672594897,1672596082,1185
7849,3236102733,3311439795,1672659181,1672660550,1369
7778,3805342762,3760492950,1672626470,1672629568,3098
7853,3760893269,3533280269,1672598871,1672602358,3487
7491,3703871468,3774580701,1672540782,1672542197,1415
7694,3777806071,3757562897,1672699645,1672700725,1080
7751,3378436155,3667680268,1672574450,1672575631,1181
7807,3389115045,3911159965,1672577301,1672578681,1380
7564,3760893269,3760077057,1672668759,1672671914,3155
7895,3509604974,3517864478,1672684888,1672685575,687
7909,3533385867,3618873142,1672618299,1672619318,1019
7791,3703955926,3284639858,1672575923,1672578439,2516
7897,3683959482,3505173328,1672555926,1672559204,3278
7785,3755920131,3755625324,1672609167,1672611507,2340
7630,3475795792,3512217942,1672559152,1672562244,3092
7796,3511687358,3519556068,1672703738,1672705529,1791
7910,3792902982,3930797455,1672566872,1672569758,2886
7849,3800353779,3880310724,1672537288,1672538376,1088
7736,3664517356,3701498253,1672567394,1672569199,1805
7745,3823600322,3448855696,1672682231,1672684144,1913
7955,3284832486,3311993075,1672691669,1672692218,549
7572,3307512479,3783083229,1672617193,1672620630,3437
7633,3736229191,3391261292,1672536029,1672539280,3251
7699,3533242305,3760598102,1672532208,1672534154,1946
7763,3383922351,3280615985,1672541075,1672543067,1992
7842,3760077057,3311324983,1672658061,1672659358,1297
7535,3935127663,3421127249,1672683623,1672684323,700
7643,3438645253,3666457294,1672561138,1672563129,1991
7947,3662180254,3518163778,1672634702,1672636385,1683
7489,3829319703,3391915886,1672621082,1672621745,663
7880,3772714862,3511350608,1672585371,1672588711,3340
7485,3701967560,3501692334,1672629878,1672631456,1578
7664,3235287260,3291227780,1672601864,1672602965,1101
7917,3777790718,3792768129,1672689955,1672690914,959
7656,3500066230,3734828619,1672627668,1672628606,938
7962,3505219850,3451432842,1672587995,1672588495,500
7672,3800886801,3703871468,1672534632,1672536376,1744
7841,3882291183,3711198793,1672608709,1672609523,814
7556,3395152943,3917278625,1672611731,1672614644,2913
7898,3467773920,3513201436,1672664199,1672666947,2748
7563,3770447408,3774339795,1672669956,1672671545,1589
7729,3713808837,3510173870,1672660100,1672662098,1998
7981,3703955926,3514719601,1672620300,1672622945,2645
7525,3505973226,3378436155,1672648049,1672648235,186
7670,3629935998,3859663348,1672623069,1672623754,685
7866,3509352754,3776800213,1672571283,1672571844,561
7570,3633420270,3827377568,1672549610,1672550652,1042
7735,3365614305,3312333615,1672581038,1672584202,3164
7877,3633420270,3883042241,1672533765,1672537118,3353
7983,3421127249,3887270940,1672681179,1672682721,1542
7613,3857349323,3734496778,1672688229,1672688707,478
7781,3365278081,3369998498,1672597718,1672597818,100
7971,3716197887,3760267716,1672673145,1672674740,1595
7919,3494290908,3311208440,1672556529,1672556785,256
7885,3496269445,3516673015,1672532223,1672533277,1054
7518,3201324715,3392121505,1672602713,1672603234,521
7617,3311603601,3755798867,1672699723,1672703123,3400
7583,3500066230,3484995752,1672556144,1672557081,937
7658,3520206212,3533270638,1672689386,1672691226,1840
7893,3755511676,3891751546,1672695507,1672697086,1579
7903,3512142794,3714504419,1672701863,1672703721,1858
7942,3857349323,3209027249,1672582837,1672583368,531
7959,3475795792,3883861463,1672693336,1672693765,429
7643,3682061100,3733189298,1672535856,1672538986,3130
7728,3703871468,3451432842,1672549692,1672549783,91
7649,3778341199,3516039895,1672686761,1672689631,2870
7826,3734828619,3383922351,1672689221,1672690792,1571
7840,3777936328,3756462516,1672641737,1672643216,1479
7766,3249401741,3356860407,1672573860,1672574364,504
7762,3760183458,3606987130,1672629845,1672632920,3075
7873,3711504540,3346795719,1672683761,1672686113,2352
7660,3412980697,3370752401,1672631569,1672632004,435
7743,3755587522,3731419510,1672615207,1672618061,2854
7949,3911159965,3805342762,1672532488,1672534596,2108
7587,3555214688,3303705369,1672699077,1672702185,3108
7962,3384951177,3518014404,1672559382,1672559637,255
7660,3518014404,3484995752,1672672583,1672675180,2597
7790,3511350608,3345207877,1672646726,1672649236,2510
7563,3515691540,3791874383,1672632076,1672633141,1065
7668,3711370563,3291227780,1672686604,1672688630,2026
7631,3793871337,3296471982,1672699397,1672702717,3320
7747,3634786711,3770021824,1672698318,1672699581,1263
7748,3783239924,3209383861,1672668409,1672669786,1377
7499,3736790081,3311718847,1672632288,1672633144,856
7927,3276640712,3731419510,1672663898,1672664037,139
7686,3505873261,3338703270,1672556497,1672557199,702
7673,3342131135,3500066230,1672553447,1672555811,2364
7817,3223968713,3313564074,1672587425,1672589508,2083
7983,3465202715,3773465237,1672619839,1672620251,412
7622,3899266183,3685818092,1672665529,1672667995,2466
7628,3516011407,3351554343,1672532990,1672533657,667
7501,3409474775,3511198618,1672559979,1672562981,3002
7744,3516980378,3774366875,1672658517,1672661005,2488
7524,3881477378,3424922204,1672646995,1672649825,2830
7896,3734828619,3427219654,1672620065,1672621005,940
7530,3774338212,3297463265,1672577617,1672580545,2928
7538,3809484172,3515394721,1672693220,1672696251,3031
7800,3493507965,3715492942,1672552961,1672556469,3508
7626,3514838220,3221536550,1672621190,1672623575,2385
7712,3772578994,3481502100,1672533881,1672535403,1522
7553,3517509185,3396285984,1672585591,1672587673,2082
7536,3361230905,3792668962,1672574178,1672577563,3385
7656,3247815299,3827222533,1672694450,1672695721,1271
7832,3703718151,3976390453,1672638715,1672642304,3589
7680,3500658339,3701984666,1672546654,1672549789,3135
7733,3772359096,3430504438,1672672750,1672675032,2282
7736,3512217942,3637008488,1672533904,1672537258,3354
7713,3883085535,3828624701,1672630602,1672633038,2436
7708,3666553782,3716537575,1672670853,1672671549,696
7509,3271938399,3318166135,1672614146,1672617672,3526
7598,3713370078,3533369198,1672597819,1672598611,792
7799,3778980116,3819727225,1672630173,1672633041,2868
7613,3473562469,3247428249,1672605498,1672607388,1890
7702,3773664987,3780813786,1672647776,1672650292,2516
7832,3379256399,3478194807,1672631882,1672633455,1573
7696,3710098970,3518163778,1672531565,1672531874,309
7846,3496269445,3273500349,1672607718,1672608429,711
7514,3910454786,3505702787,1672619883,1672621105,1222
7830,3505145247,3774005526,1672631775,1672634983,3208
7567,3711308224,3600647945,1672699688,1672700178,490
7862,3311627628,3733189298,1672648570,1672651016,2446
7678,3783245561,3534702203,1672551710,1672553928,2218
7545,3756451663,3501759100,1672539625,1672542299,2674
7581,3514245078,3311274543,1672545938,1672546467,529
7489,3517963492,3294803686,1672551433,1672551644,211
7797,3520706195,3409474775,1672690005,1672692120,2115
7807,3501483568,3505362057,1672649377,1672652900,3523
7756,3489545239,3520756859,1672686353,1672689476,3123
7916,3606812411,3312829208,1672685875,1672687200,1325
7669,3713208927,3931941795,1672544222,1672547369,3147
7834,3311065516,3793871337,1672582220,1672584787,2567
7898,3428674539,3780639480,1672533790,1672535343,1553
7623,3714504419,3280615985,1672551803,1672554791,2988
7662,3496269445,3451432842,1672606174,1672609137,2963
7787,3783925755,3333896808,1672563008,1672564048,1040
7961,3829232696,3885670556,1672640050,1672640736,686
7983,3978105277,3291227780,1672698280,1672700001,1721
7590,3793959750,3533193862,1672611828,1672612636,808
7566,3430074045,3519069599,1672687218,1672688184,966
7579,3208844525,3791942683,1672657812,1672660163,2351
7971,3701534009,3533371364,1672538240,1672541013,2773
7810,3516258476,3293695955,1672562662,1672565824,3162
7664,3487171044,3512142794,1672606957,1672609246,2289
7966,3505530961,3534729133,1672628341,1672629829,1488
7903,3391261292,3804870229,1672643423,1672644294,871
7506,3756453423,3501364586,1672563536,1672565057,1521
7870,3505098372,3736592744,1672602442,1672602698,256
7575,3518669703,3777079686,1672620505,1672623657,3152
7773,3399911573,3220716272,1672570489,1672573686,3197
7974,3496549058,3379256399,1672632237,1672632459,222
7678,3883042241,3201432789,1672644905,1672645461,556
7534,3774501422,3757151210,1672663370,1672665568,2198
7537,3883042241,3510126867,1672662537,1672665391,2854
7740,3374559242,3533270638,1672551910,1672552185,275
7842,3519912874,3757562897,1672569830,1672571933,2103
7735,3520709480,3774204963,1672633556,1672637030,3474
7503,3701863557,3715981584,1672616538,1672619051,2513
7567,3713208927,3201848640,1672544105,1672546972,2867
7852,3755739653,3826633236,1672569155,1672570330,1175
7899,3828365570,3770101921,1672688807,1672691085,2278
7762,3791334389,3311090974,1672691726,1672691790,64
7662,3505362057,3779036831,1672605896,1672608429,2533
7796,3339907603,3533748232,1672599272,1672602253,2981
7493,3812176780,3500391167,1672690749,1672692484,1735
7493,3625274012,3277605882,1672680222,1672680872,650
7520,3736786443,3489962019,1672549213,1672549648,435
7862,3288764520,3853018906,1672590682,1672592672,1990
7924,3608868877,3755625324,1672644871,1672645964,1093
7823,3222521619,3510247121,1672699534,1672700031,497
7975,3792032359,3713969578,1672693031,1672696022,2991
7573,3760598102,3311415018,1672531751,1672531901,150
7981,3511841857,3518260334,1672609506,1672609710,204
7520,3904408902,3915628728,1672575967,1672578622,2655
7644,3809916577,3489545239,1672550988,1672553509,2521
7846,3883861463,3783245561,1672584109,1672587686,3577
7483,3811171116,3936227020,1672702512,1672705080,2568
7804,3903307060,3227158514,1672534455,1672535138,683
7589,3500803339,3517864478,1672688642,1672689111,469
7485,3418728074,3519069599,1672624035,1672626480,2445
7925,3509773875,3517963492,1672562715,1672563148,433
7974,3772309150,3710344260,1672596480,1672597913,1433
7893,3715189301,3307512479,1672691882,1672694073,2191
7640,3517721725,3496051529,1672662336,1672665885,3549
7820,3828365570,3836573197,1672645068,1672647806,2738
7696,3711380716,3757602960,1672677378,1672677542,164
7592,3512349371,3792789881,1672599460,1672600813,1353
7935,3465202715,3514719601,1672637857,1672639124,1267
7569,3311415018,3714504419,1672678114,1672679287,1173
7507,3779740455,3826633236,1672560739,1672561768,1029
7687,3772642849,3501927421,1672665926,1672668055,2129
7912,3515284591,3760267716,1672642579,1672643817,1238
7832,3512567240,3273500349,1672686116,1672687091,975
7846,3360743849,3434642576,1672623285,1672624108,823
7727,3374559242,3515125508,1672657765,1672658588,823
7741,3757682496,3519912874,1672648365,1672650202,1837
7793,3515394721,3920801189,1672572586,1672572888,302
7645,3387966152,3772884106,1672534900,1672538183,3283
7498,3505702787,3895562476,1672618836,1672622178,3342
7891,3757151210,3664517356,1672626259,1672629382,3123
7513,3701995648,3379589402,1672546382,1672547822,1440
7732,3836573197,3415546117,1672575202,1672575918,716
7607,3688418210,3228165483,1672662267,1672663099,832
7811,3533025282,3388286531,1672574100,1672576537,2437
7850,3489545239,3711370563,1672688639,1672689214,575
7706,3780813786,3783429780,1672653384,1672654677,1293
7490,3519654779,3496549058,1672656158,1672656286,128
7844,3518408774,3432689543,1672698068,1672698227,159
7679,3509604974,3514128943,1672688465,1672690764,2299
7606,3779740455,3247780536,1672648407,1672650186,1779
7923,3774339795,3922337974,1672546872,1672548580,1708
7928,3509604974,3779629905,1672619037,1672619782,745
7926,3910454786,3805519285,1672703824,1672707061,3237
7976,3520190170,3780639480,1672589772,1672590264,492
7802,3316173088,3755920131,1672678889,1672681904,3015
7488,3404384505,3734737881,1672575081,1672576570,1489
7894,3926700506,3606186086,1672535579,1672536802,1223
7635,3332072298,3505791599,1672606891,1672609058,2167
7804,3774204963,3757602960,1672672384,1672673358,974
7813,3505791599,3777806071,1672667239,1672670180,2941
7799,3791602225,3774204963,1672578574,1672580449,1875
7486,3756453423,3516980378,1672691516,1672692657,1141
7831,3783705817,3500803339,1672703519,1672703669,150
7552,3360993964,3201432789,1672567272,1672569842,2570
7713,3855602893,3937224533,1672566547,1672569406,2859
7586,3606987130,3792902982,1672609001,1672610156,1155
7509,3760489031,3390068992,1672656514,1672659707,3193
7503,3757246925,3976633198,1672647348,1672650551,3203
7517,3515151980,3277605882,1672661271,1672662285,1014
7801,3976390453,3273500349,1672622863,1672626267,3404
7746,3511312803,3922275416,1672576015,1672577864,1849
7819,3783196518,3792384220,1672691725,1672692404,679
7676,3915628728,3390068992,1672592573,1672596001,3428
7922,3711262377,3510703546,1672684398,1672686969,2571
7508,3805292782,3634995491,1672616421,1672618044,1623
7841,3534702203,3490191091,1672571347,1672573978,2631
7649,3271938399,3511435497,1672656685,1672660261,3576
7913,3383661227,3510126867,1672564154,1672566524,2370
7973,3373384732,3247780536,1672579153,1672580943,1790
7837,3505638204,3400918687,1672538145,1672541468,3323
7657,3909331423,3477375368,1672579768,1672582426,2658
7751,3776338577,3779036831,1672637573,1672639021,1448
7903,3224716315,3383661227,1672699274,1672701201,1927
7863,3826415738,3793959750,1672533311,1672536223,2912
7760,3412825109,3429856982,1672543030,1672543439,409
7737,3500658339,3628819436,1672604394,1672607437,3043
7882,3348261553,3772309166,1672617823,1672619661,1838
7643,3518932404,3416241005,1672557511,1672557655,144
7587,3772746272,3853018906,1672695606,1672698222,2616
7600,3311154569,3792032359,1672638270,1672641127,2857
7488,3519152550,3277605882,1672580780,1672582544,1764
7675,3783196518,3294803686,1672639952,1672640304,352
7893,3505869747,3792768129,1672569489,1672571597,2108
7702,3756601594,3500904641,1672647583,1672650430,2847
7763,3755872268,3829232696,1672700059,1672702727,2668
7971,3634786711,3715492942,1672653764,1672656698,2934
7516,3511350608,3418534998,1672601836,1672602512,676
7570,3364543015,3737154119,1672648244,1672650961,2717
7760,3710408395,3772359096,1672546298,1672548416,2118
7866,3387966152,3912536808,1672533118,1672533326,208
7757,3777120536,3500658339,1672624095,1672624474,379
7865,3446948848,3891751546,1672554164,1672555872,1708
7982,3772884106,3501198706,1672626576,1672628719,2143
7801,3931941795,3791657947,1672641900,1672644734,2834
7830,3314836094,3286658957,1672537866,1672540899,3033
7908,3793627961,3511350608,1672547782,1672551157,3375
7875,3224058172,3277669002,1672548071,1672549237,1166
7922,3533095755,3701184889,1672583558,1672584545,987
7896,3516629436,3773598056,1672566666,1672568128,1462
7722,3737051610,3500177712,1672616132,1672616499,367
7695,3497901842,3510703546,1672675965,1672677720,1755
7935,3827377568,3554917400,1672533306,1672534826,1520
7783,3736790081,3489962019,1672633211,1672634726,1515
7606,3760509236,3515723720,1672677087,1672677937,850
7637,3713349754,3772714862,1672602787,1672606349,3562
7983,3777806071,3519912874,1672585973,1672587345,1372
7499,3200691026,3289061738,1672556217,1672557319,1102
7614,3774556560,3387674757,1672626970,1672630022,3052
7898,3519556068,3772053179,1672589982,1672590785,803
7778,3520012395,3713644518,1672531688,1672533375,1687
7683,3703889596,3792768129,1672696998,1672699350,2352
7633,3505962865,3514838220,1672587335,1672590048,2713
7939,3777806071,3428964059,1672632544,1672634175,1631
7628,3811694763,3714504419,1672676525,1672677057,532
7980,3232962003,3399911573,1672586469,1672586604,135
7803,3757455053,3313541986,1672636456,1672638085,1629
7879,3505362057,3855937514,1672651374,1672652164,790
7703,3760569731,3756021689,1672644005,1672644266,261
7511,3280599164,3826633236,1672677975,1672679820,1845
7646,3780294829,3311845971,1672612162,1672612700,538
7864,3386707783,3311993075,1672681176,1672682232,1056
7574,3883042241,3805292782,1672700656,1672702458,1802
7604,3367902229,3770851318,1672674267,1672675849,1582
7712,3556951786,3421836608,1672545660,1672548114,2454
7683,3755436115,3826633236,1672702023,1672704642,2619
7870,3778266283,3756601594,1672568170,1672570843,2673
7838,3365830990,3774119563,1672607827,1672609986,2159
7962,3685187183,3454042520,1672662991,1672664336,1345
7784,3520030713,3234541252,1672538635,1672538904,269
7926,3736786443,3716197887,1672642312,1672643344,1032
7633,3311154569,3755042098,1672664181,1672666352,2171
7741,3805347939,3703013906,1672638168,1672641609,3441
7817,3402943525,3234362962,1672691561,1672691983,422
7899,3833889105,3428006164,1672560230,1672561992,1762
7637,3510594211,3318697153,1672540604,1672543046,2442
7971,3827377568,3365830990,1672671556,1672671969,413
7680,3737051610,3979339287,1672681226,1672684165,2939
7499,3774556560,3882291183,1672619610,1672620775,1165
7645,3515125508,3624312512,1672577851,1672580453,2602
7808,3978115672,3390068992,1672629165,1672632525,3360
7739,3513164386,3534492426,1672589282,1672590992,1710
7683,3808324264,3715581279,1672604943,1672607864,2921
7734,3780609808,3755511676,1672551103,1672553687,2584
7689,3418728074,3552314511,1672607345,1672609452,2107
7896,3685818092,3859663348,1672638726,1672642128,3402
7876,3505193212,3291235378,1672533344,1672535096,1752
7671,3307512479,3244173074,1672604987,1672606535,1548
7796,3793627961,3936227020,1672684308,1672685965,1657
7625,3978105277,3780788622,1672673565,1672674158,593
7973,3827377568,3533280269,1672592194,1672593857,1663
7774,3757812939,3415443558,1672681177,1672684733,3556
7858,3736786443,3388372715,1672608018,1672610998,2980
7651,3505869747,3516258476,1672552208,1672552491,283
7657,3286658957,3608868877,1672692071,1672694536,2465
7654,3505292701,3297463265,1672573941,1672575739,1798
7900,3711973519,3703789494,1672651540,1672651995,455
7536,3909331423,3510771358,1672617061,1672620379,3318
7690,3511841857,3791594391,1672582286,1672585036,2750
7921,3774268456,3975287541,1672595591,1672598644,3053
7740,3533242305,3701190899,1672581669,1672582143,474
7503,3511312803,3512217942,1672632862,1672633999,1137
7926,3715492942,3756424865,1672606008,1672607823,1815
7842,3238712269,3493507965,1672564143,1672565850,1707
7533,3793286136,3755587522,1672596646,1672599631,2985
7873,3818255890,3774793839,1672593832,1672596587,2755
7603,3516258476,3685818092,1672626504,1672628335,1831
7774,3356860407,3733189298,1672534485,1672537253,2768
7954,3510711755,3855000166,1672613588,1672615939,2351
7758,3760893269,3820354437,1672634715,1672637529,2814
7555,3513956646,3828624701,1672606125,1672608397,2272
7527,3533653428,3533810360,1672574220,1672575071,851
7682,3500177712,3312664885,1672694503,1672697316,2813
7945,3512720680,3627937312,1672552446,1672553044,598
7529,3730517636,3511163800,1672658686,1672660158,1472
7524,3311208440,3378686918,1672641958,1672642496,538
7597,3926700506,3932051427,1672696829,1672699819,2990
7774,3757246925,3774338212,1672672308,1672672632,324
7844,3401627165,3412825109,1672546333,1672548874,2541
7488,3209551760,3793338102,1672637043,1672638703,1660
7705,3756930948,3511841857,1672639334,1672642665,3331
7650,3760569731,3711380716,1672683128,1672683546,418
7680,3533927138,3976633198,1672696421,1672697890,1469
7730,3792253549,3715974031,1672605211,1672608435,3224
7521,3311718847,3519654779,1672622179,1672624636,2457
7940,3244389794,3736229191,1672618239,1672620866,2627
7531,3883085535,3973560347,1672693880,1672694206,326
7742,3404058699,3313541986,1672615208,1672615701,493
7868,3793627961,3898995675,1672608607,1672608892,285
7521,3534010629,3780593036,1672635288,1672635522,234
7504,3518360734,3772578994,1672638857,1672640077,1220
7659,3409474775,3904775198,1672636220,1672636591,371
7836,3397418363,3606987130,1672621028,1672622217,1189
7558,3703871468,3475258557,1672693733,1672694968,1235
7495,3773950140,3556951786,1672539286,1672541928,2642
7485,3379589402,3383661227,1672606170,1672608261,2091
7802,3365614305,3756601594,1672535475,1672536187,712
7503,3703889596,3730517636,1672668008,1672669856,1848
7903,3800353779,3887270940,1672692207,1672695401,3194
7604,3793286136,3668898102,1672582765,1672585176,2411
7781,3714962248,3939952128,1672625693,1672629140,3447
7602,3500805881,3616944364,1672554095,1672556924,2829
7686,3777514571,3459030804,1672700501,1672702966,2465
7591,3533280269,3778266283,1672702749,1672705517,2768
7711,3514128943,3520706195,1672617617,1672619929,2312
7644,3244389794,3756966035,1672613597,1672614866,1269
7819,3313541986,3608633356,1672614553,1672618028,3475
7597,3715981584,3815508790,1672666694,1672668118,1424
7536,3519654779,3701498253,1672569228,1672572694,3466
7974,3688683847,3475795792,1672693157,1672695450,2293
7920,3516039895,3827626797,1672595549,1672596341,792
7504,3358871377,3972709319,1672594401,1672596494,2093
7752,3533025282,3391915121,1672693618,1672693969,351
7635,3512166013,3513454145,1672696987,1672700039,3052
7758,3518014404,3500229033,1672631185,1672634433,3248
7886,3378436155,3348261553,1672598297,1672601292,2995
7492,3379589402,3711198793,1672534442,1672535068,626
7704,3739106581,3921211276,1672556953,1672560126,3173
7766,3311627628,3417587765,1672631543,1672634848,3305
7633,3228165483,3889232789,1672579157,1672582531,3374
7664,3925620998,3387966152,1672533457,1672534472,1015
7500,3713644518,3713630656,1672638196,1672641742,3546
7952,3501198706,3793959750,1672565573,1672567131,1558
7918,3703661585,3434642576,1672553062,1672553982,920
7918,3509634629,3232962003,1672549095,1672551227,2132
7745,3914290246,3513956646,1672544480,1672547314,2834
7726,3505135325,3238712269,1672531828,1672533659,1831
7785,3701995648,3621810464,1672602281,1672605486,3205
7812,3780914982,3793338102,1672691340,1672691735,395
7795,3500994774,3634786711,1672641799,1672643618,1819
7708,3757403279,3500458761,1672560686,1672562510,1824
7700,3793962300,3711308224,1672536240,1672538313,2073
7683,3517963492,3610695419,1672699149,1672700197,1048
7943,3384240055,3424922204,1672653279,1672655786,2507
7899,3235287260,3703735129,1672688090,1672691257,3167
7903,3501486692,3298433163,1672550792,1672554211,3419
7684,3716168623,3777455223,1672554951,1672558403,3452
7613,3805519285,3438645253,1672583505,1672585679,2174
7949,3421836608,3777623166,1672544094,1672546223,2129
7794,3500365158,3280615985,1672664261,1672664962,701
7772,3466229085,3516980378,1672536352,1672538303,1951
7850,3513164386,3458539365,1672570479,1672571802,1323
7817,3427283336,3311324983,1672623871,1672626621,2750
7913,3383661227,3834257412,1672627257,1672628027,770
7519,3618873142,3701184889,1672631377,1672633304,1927
7588,3352603894,3770447408,1672629411,1672632696,3285
7909,3501692334,3626156564,1672555147,1672557027,1880
7538,3505973226,3429856982,1672656379,1672658390,2011
7968,3533827120,3778266283,1672641967,1672642304,337
7528,3517077106,3777455223,1672654682,1672655636,954
7565,3774298222,3511271692,1672654970,1672655389,419
7918,3351554343,3715492942,1672593913,1672595464,1551
7967,3453729665,3773814927,1672641689,1672643911,2222
7870,3516011407,3703013906,1672654604,1672657098,2494
7956,3793871337,3533193862,1672644131,1672644555,424
7590,3427219654,3367902229,1672645349,1672647137,1788
7643,3501927421,3534010629,1672649456,1672650657,1201
7885,3467773920,3793470489,1672669640,1672673177,3537
7615,3703735129,3501198706,1672604545,1672606794,2249
7564,3559110998,3359910781,1672575253,1672576293,1040
7884,3716488385,3242408357,1672632894,1672633546,652
7859,3276993580,3520012395,1672594979,1672596792,1813
7525,3500066230,3809059934,1672563381,1672563546,165
7789,3903962771,3668005723,1672606617,1672609629,3012
7631,3809484172,3224058172,1672629539,1672632023,2484
7906,3711370563,3776066388,1672684480,1672684939,459
7790,3778305740,3883551721,1672694255,1672696372,2117
7880,3516258476,3937224533,1672566063,1672566616,553
7863,3793286136,3519703355,1672686143,1672687758,1615
7955,3511350608,3501364586,1672599553,1672601485,1932
7632,3391915886,3554917400,1672659995,1672661700,1705
7664,3822654369,3500229033,1672656920,1672657961,1041
7891,3512720680,3701178711,1672627059,1672629855,2796
7778,3792844210,3505791599,1672672562,1672673267,705
7879,3206254161,3736229191,1672691159,1672692840,1681
7901,3515151980,3311845971,1672569781,1672571357,1576
7744,3520183192,3510126867,1672549852,1672551672,1820
7946,3412825109,3783705817,1672639921,1672641497,1576
7980,3448855696,3755920131,1672631605,1672632268,663
7804,3229665776,3400918687,1672584206,1672587137,2931
7963,3520709480,3915628728,1672630617,1672631085,468
7648,3520030713,3780593036,1672600664,1672603171,2507
7794,3223789409,3778549126,1672636472,1672636835,363
7842,3755436115,3792902982,1672558746,1672560298,1552
7515,3222521619,3492478793,1672657608,1672659103,1495
7897,3716537575,3286658957,1672635137,1672636569,1432
7700,3899266183,3249791738,1672612886,1672613386,500
7679,3711262377,3613995936,1672689124,1672691519,2395
7515,3519563836,3289061738,1672682613,1672683185,572
7716,3505193212,3639847263,1672700999,1672704409,3410
7696,3365278081,3500803339,1672585796,1672586564,768
7651,3311090974,3485008994,1672633371,1672636733,3362
7500,3667680268,3773429448,1672570894,1672571153,259
7971,3816853177,3780788622,1672597459,1672599594,2135
7581,3925620998,3485375593,1672578950,1672580927,1977
7763,3344364444,3391915121,1672552091,1672554111,2020
7920,3922275416,3703735129,1672649329,1672651507,2178
7575,3222521619,3516011407,1672591534,1672592557,1023
7766,3209027249,3304625412,1672647483,1672649008,1525
7714,3777623166,3421836608,1672573620,1672574278,658
7542,3513164386,3505530961,1672689928,1672691080,1152
7621,3777120536,3882997884,1672703677,1672704810,1133
7766,3792902982,3515394721,1672690735,1672691144,409
7789,3756601594,3755920131,1672616756,1672617914,1158
7490,3209048907,3736790081,1672598263,1672599225,962
7850,3467773920,3236102733,1672681396,1672684451,3055
7842,3779528381,3805519285,1672582165,1672583809,1644
7681,3284832486,3858918246,1672663251,1672665051,1800
7936,3701111745,3405494240,1672597248,1672598725,1477
7501,3660493209,3336751428,1672620925,1672624305,3380
7637,3903307060,3823600322,1672675760,1672677252,1492
7856,3683766533,3362000049,1672676672,1672678236,1564
7544,3427283336,3396285984,1672694168,1672696039,1871
7778,3509604974,3791657947,1672689715,1672692888,3173
7571,3404384505,3760489031,1672624429,1672626509,2080
7911,3622054816,3515151980,1672578546,1672580054,1508
7559,3664517356,3271938399,1672614754,1672617858,3104
7782,3755872268,3613683164,1672645914,1672646156,242
7896,3311152102,3294803686,1672621805,1672624874,3069
7543,3791602225,3505292701,1672603128,1672604148,1020
7778,3284832486,3481647420,1672649036,1672652138,3102
7535,3509672210,3901990690,1672590724,1672592983,2259
7575,3472130842,3903009525,1672653941,1672655818,1877
7959,3509907947,3734496778,1672661002,1672664048,3046
7553,3975287541,3370636709,1672619389,1672621571,2182
7549,3396285984,3518408774,1672667473,1672667977,504
7749,3792768129,3773429448,1672609823,1672611599,1776
7738,3311274543,3515125508,1672619737,1672621881,2144
7638,3855424474,3477375368,1672622956,1672626056,3100
7943,3760077057,3311090974,1672647399,1672649735,2336
7627,3404384505,3903009525,1672611701,1672613009,1308
7660,3518496488,3223789409,1672655260,1672655347,87
7976,3311439795,3505347134,1672672135,1672674389,2254
7922,3930791338,3755587522,1672689960,1672692509,2549
7542,3828365570,3978105277,1672678300,1672680691,2391
7587,3628819436,3978115672,1672532642,1672533819,1177
7789,3518408774,3710098970,1672624795,1672628241,3446
7593,3770447408,3510126867,1672609672,1672612282,2610
7531,3760267716,3534702203,1672537388,1672538936,1548
7803,3777623166,3249401741,1672626205,1672628074,1869
7546,3770763956,3792253549,1672549885,1672551687,1802
7849,3533280269,3716537575,1672645372,1672645797,425
7559,3917088658,3501955238,1672620703,1672623094,2391
7721,3777717988,3360506772,1672661578,1672662559,981
7975,3736419952,3509933351,1672627427,1672629646,2219
7880,3770824086,3715581279,1672589446,1672592139,2693
7525,3277669002,3466911760,1672610272,1672612795,2523
7874,3511163800,3701984666,1672656791,1672657984,1193
7612,3389115045,3401627165,1672598249,1672601720,3471
7971,3777983879,3501955238,1672537716,1672540281,2565
7548,3736419952,3516039895,1672577554,1672577854,300
7551,3711973519,3774466457,1672646973,1672649699,2726
7629,3473765852,3244173074,1672670436,1672673145,2709
7637,3666507626,3703223015,1672634163,1672634464,301
7977,3519152550,3209048907,1672559097,1672560064,967
7735,3518408774,3512142794,1672607766,1672609010,1244
7627,3755625324,3778266283,1672576140,1672578280,2140
7624,3472130842,3701995648,1672618287,1672618672,385
7860,3510173870,3903307060,1672657872,1672660712,2840
7648,3533137446,3500805881,1672650384,1672653266,2882
7578,3505973226,3311845971,1672607352,1672607650,298
7770,3664517356,3760489031,1672612942,1672614211,1269
7930,3378436155,3520751702,1672681904,1672682670,766
7937,3793286136,3516606733,1672666545,1672667416,871
7697,3883551721,3755625324,1672587245,1672590427,3182
7748,3891751546,3396285984,1672688243,1672691360,3117
7718,3453729665,3510380060,1672635171,1672635637,466
7702,3714504419,3774366875,1672556632,1672558863,2231
7579,3713268590,3276993580,1672573823,1672574140,317
7797,3716273414,3774339795,1672598720,1672601684,2964
7679,3223789409,3518932404,1672686377,1672688696,2319
7812,3776948966,3533242305,1672701444,1672704259,2815
7932,3273500349,3454042520,1672596960,1672598370,1410
7746,3311603601,3779528381,1672532452,1672535200,2748
7567,3314836094,3278365525,1672594371,1672596527,2156
7713,3773598056,3208844525,1672643894,1672645600,1706
7893,3780365428,3613683164,1672631588,1672634717,3129
7563,3511170269,3511350608,1672667768,1672670806,3038
7713,3715581279,3780503655,1672601100,1672602681,1581
7725,3701995648,3279721246,1672536103,1672537378,1275
7898,3519428855,3432689543,1672637243,1672640785,3542
7693,3739106581,3244173074,1672638956,1672640403,1447
7900,3520706195,3606812411,1672565804,1672566822,1018
7695,3778341199,3774366875,1672652317,1672652589,272
7552,3312333615,3510594211,1672537774,1672538307,533
7869,3505477652,3703735129,1672614674,1672616893,2219
7727,3826759140,3773598056,1672598665,1672599873,1208
7874,3800886801,3500060260,1672531790,1672533867,2077
7799,3304625412,3490191091,1672688880,1672689075,195
7634,3716537575,3380035798,1672604535,1672607419,2884
7657,3711380716,3757151210,1672551263,1672553084,1821
7853,3202120784,3858918246,1672701607,1672702347,740
7696,3397418363,3734737881,1672586593,1672589273,2680
7499,3311154569,3417587765,1672652304,1672654948,2644
7931,3925402713,3318166135,1672678446,1672681386,2940
7660,3304056063,3883085535,1672560508,1672560836,328
7931,3511198618,3476232529,1672569022,1672570144,1122
7616,3518496488,3835382117,1672655958,1672657532,1574
7957,3889232789,3891751546,1672585937,1672589436,3499
7613,3713894336,3770553384,1672570757,1672573205,2448
7671,3793470489,3520190170,1672640036,1672643261,3225
7898,3505912939,3505000737,1672534066,1672537207,3141
7859,3201848640,3505904952,1672552105,1672552320,215
7844,3714504419,3221536550,1672664732,1672666955,2223
7611,3519556068,3505362057,1672589020,1672592163,3143
7554,3793848402,3284639858,1672617295,1672618668,1373
7609,3378686918,3428964059,1672658552,1672659879,1327
7608,3555214688,3666506258,1672532798,1672535808,3010
7927,3826633236,3360506772,1672688919,1672690578,1659
7614,3774268456,3618873142,1672653766,1672656354,2588
7745,3505912939,3736625083,1672556282,1672558009,1727
7507,3400918687,3533137446,1672561693,1672561951,258
7634,3714962248,3922275416,1672656939,1672659002,2063
7557,3736419952,3792253549,1672682937,1672685144,2207
7894,3342131135,3271938399,1672547803,1672550075,2272
7717,3792902982,3277939457,1672651902,1672653734,1832
7865,3244389794,3882242815,1672570654,1672571680,1026
7558,3606186086,3777120536,1672680747,1672683355,2608
7941,3417970574,3365278081,1672559643,1672561518,1875
7700,3902383721,3515394721,1672535804,1672537614,1810
7571,3466911760,3501927421,1672561606,1672564930,3324
7609,3383661227,3511841857,1672590463,1672593803,3340
7688,3716165213,3621497531,1672647051,1672648052,1001
7905,3311761694,3730517636,1672562446,1672563977,1531
7575,3780365428,3819727225,1672682434,1672684063,1629
7517,3501955238,3777079686,1672539991,1672540660,669
7978,3291883916,3639847263,1672673197,1672674929,1732
7583,3534729133,3713349754,1672562206,1672563623,1417
7858,3624312512,3429690204,1672589712,1672590798,1086
7520,3520709480,3755920131,1672674804,1672675279,475
7604,3780974443,3902278226,1672584476,1672585041,565
7651,3458539365,3311090974,1672698212,1672699682,1470
7858,3914290246,3518791447,1672613960,1672616922,2962
7825,3280615985,3380035798,1672599946,1672603357,3411
7739,3500229033,3755872268,1672641526,1672642526,1000
7936,3404058699,3736786443,1672649919,1672651775,1856
7826,3701898991,3914259449,1672630518,1672630923,405
7621,3396086535,3889232789,1672689698,1672691471,1773
7521,3200198928,3505883609,1672561147,1672562928,1781
7698,3519152550,3859663348,1672685702,1672687855,2153
7914,3249247700,3891751546,1672697309,1672699811,2502
7821,3360506772,3899266183,1672576354,1672578327,1973
7887,3312829208,3505292701,1672695754,1672699108,3354
7562,3389115045,3500199935,1672652045,1672652216,171
7673,3407673904,3738274418,1672620386,1672621067,681
7570,3760489031,3284639858,1672579936,1672582430,2494
7710,3482405588,3390068992,1672565300,1672567097,1797
7839,3311324983,3514719601,1672627106,1672627512,406
7689,3778305740,3400918687,1672574925,1672577400,2475
7928,3828365570,3221899927,1672694251,1672694588,337
7537,3701498253,3244485293,1672675443,1672675609,166
7933,3778980116,3519601612,1672539979,1672541978,1999
7959,3925402713,3617734118,1672551030,1672552253,1223
7768,3731419510,3730517636,1672617635,1672620439,2804
7672,3342131135,3512510536,1672687941,1672690111,2170
7569,3518496488,3421127249,1672641830,1672641909,79
7570,3757403279,3345207877,1672552842,1672555834,2992
7591,3296471982,3314836094,1672663879,1672666422,2543
7920,3715981584,3316173088,1672630805,1672634368,3563
7893,3338367113,3496051529,1672692370,1672693710,1340
7744,3511687358,3858918246,1672619522,1672620664,1142
7525,3610695419,3365830990,1672554256,1672556122,1866
7800,3918674986,3342131135,1672623224,1672624933,1709
7496,3617055293,3921211276,1672635031,1672637492,2461
7583,3359910781,3736419952,1672700544,1672703575,3031
7513,3511170269,3716258994,1672533046,1672534071,1025
7548,3501927421,3780914982,1672586734,1672588974,2240
7581,3714962248,3773664987,1672567368,1672570824,3456
7672,3770553384,3634995491,1672560320,1672563307,2987
7733,3685187183,3206593906,1672544004,1672546500,2496
7592,3418728074,3501601840,1672673816,1672674470,654
7612,3857349323,3500199935,1672625575,1672628429,2854
7904,3307097200,3489962019,1672578098,1672578889,791
7853,3279721246,3384951177,1672549459,1672550219,760
7552,3772758337,3489728806,1672591120,1672593351,2231
7970,3634995491,3715998609,1672574009,1672575909,1900
7932,3533748232,3600647945,1672610079,1672611735,1656
7972,3855602893,3409474775,1672698982,1672699847,865
7874,3760077057,3438645253,1672632584,1672634053,1469
7808,3332072298,3534488837,1672653721,1672654208,487
7600,3802367797,3280964728,1672690553,1672691950,1397
7635,3791334389,3625274012,1672561728,1672564864,3136
7599,3730517636,3451432842,1672686781,1672689069,2288
7952,3505477652,3792288302,1672537053,1672538924,1871
7882,3517864478,3500894271,1672697646,1672698113,467
7525,3883551721,3312829208,1672624930,1672625341,411
7934,3534191820,3606186086,1672563051,1672564743,1692
7525,3385763781,3298288268,1672636806,1672637197,391
7647,3533626375,3859663348,1672604196,1672607764,3568
7708,3716168623,3770021824,1672610015,1672613118,3103
7672,3924549929,3610348516,1672651014,1672651365,351
7927,3917088658,3533927138,1672540901,1672541176,275
7677,3247815299,3224716315,1672669599,1672670585,986
7917,3903009525,3755739653,1672621441,1672621917,476
7747,3832902928,3899266183,1672558224,1672561283,3059
7776,3913251733,3618873142,1672658057,1672660244,2187
7973,3438645253,3534424200,1672700490,1672703621,3131
7552,3519654779,3791594391,1672563863,1672565517,1654
7499,3791997875,3510857360,1672633747,1672635827,2080
7978,3979339287,3481647420,1672643547,1672645061,1514
7501,3703889596,3685818092,1672586715,1672587898,1183
7654,3822654369,3514719601,1672624615,1672626515,1900
7835,3387674757,3510771358,1672635765,1672637270,1505
7886,3311993075,3200198928,1672544066,1672544504,438
7902,3285400528,3510247121,1672638371,1672641823,3452
7601,3372883226,3311718847,1672543087,1672545223,2136
7605,3500458761,3534488837,1672625343,1672626052,709
7547,3715974031,3778266283,1672692308,1672695549,3241
7801,3518260334,3755587522,1672571466,1672574330,2864
7670,3710112546,3939952128,1672673971,1672675833,1862
7669,3778549126,3302626661,1672624724,1672626425,1701
7836,3714504419,3534010629,1672630319,1672631703,1384
7818,3783206719,3770824086,1672640040,1672643459,3419
7901,3837094550,3534702203,1672565828,1672567650,1822
7953,3792789881,3512683609,1672560124,1672561393,1269
7666,3783126683,3774195321,1672628818,1672629261,443
7539,3511271692,3481502100,1672554687,1672558132,3445
7787,3714504419,3475258557,1672673854,1672674975,1121
7497,3930797455,3779036831,1672648585,1672649336,751
7844,3514245078,3360993964,1672536686,1672539618,2932
7809,3791334389,3666553782,1672682554,1672684577,2023
7500,3664517356,3505638204,1672629470,1672631785,2315
7509,3421836608,3378436155,1672611260,1672612809,1549
7663,3701984666,3505193212,1672667657,1672667813,156
7705,3416241005,3832902928,1672600522,1672602939,2417
7957,3247815299,3836573197,1672662216,1672663008,792
7898,3351008918,3402943525,1672698834,1672699790,956
7958,3662180254,3777120536,1672637342,1672639640,2298
7923,3701178711,3518496488,1672582777,1672583463,686
7557,3318697153,3361230905,1672639758,1672641099,1341
7611,3303751772,3554917400,1672569638,1672570396,758
7797,3822654369,3518014404,1672674570,1672678021,3451
7948,3389115045,3493507965,1672545997,1672546161,164
7889,3500994774,3505201246,1672643340,1672645667,2327
7737,3776338577,3757682496,1672669546,1672671007,1461
7760,3774195321,3714962248,1672647655,1672648285,630
7655,3617734118,3512142794,1672541935,1672542688,753
7790,3517476351,3439023335,1672607994,1672610483,2489
7876,3360743849,3514838220,1672573148,1672573274,126
7636,3481502100,3792844210,1672570024,1672572121,2097
7506,3416427576,3715998609,1672627652,1672628996,1344
7957,3793470489,3783509527,1672659073,1672660836,1763
7857,3791874383,3401627165,1672668747,1672671527,2780
7978,3809059934,3516011407,1672685524,1672686298,774
7609,3881477378,3336742544,1672592384,1672594116,1732
7780,3505883609,3311439795,1672563456,1672566743,3287
7726,3624761861,3518014636,1672533042,1672535363,2321
7765,3911245524,3304056063,1672583219,1672585627,2408
7752,3777623166,3793627961,1672655508,1672657975,2467
7492,3505962865,3703789494,1672580354,1672582548,2194
7719,3793389510,3496051529,1672657870,1672659632,1762
7564,3359910781,3227158514,1672594333,1672595990,1657
7941,3509933351,3555214688,1672615868,1672618054,2186
7894,3500904641,3227457126,1672596785,1672599998,3213
7745,3816853177,3770447408,1672631964,1672635122,3158
7649,3377766165,3736625083,1672653700,1672654285,585
7641,3511332835,3777477395,1672643593,1672645736,2143
7508,3370636709,3516716179,1672666459,1672668854,2395
7530,3912536808,3512349371,1672644198,1672645116,918
7682,3801089989,3607748895,1672648605,1672649203,598
7848,3365942576,3496269445,1672559024,1672559763,739
7880,3915628728,3517864478,1672572027,1672572419,392
7579,3505638204,3828365570,1672652129,1672654210,2081
7974,3387966152,3534313900,1672691415,1672691487,72
7563,3209027249,3505649239,1672576416,1672576897,481
7740,3352603894,3805519285,1672568792,1672569247,455
7751,3333896808,3793627961,1672678969,1672679979,1010
7523,3910454786,3505859863,1672555293,1672557613,2320
7784,3902278226,3412825109,1672555886,1672559252,3366
7635,3334033993,3792177074,1672701759,1672704816,3057
7973,3404058699,3223968713,1672536416,1672536861,445
7737,3465254146,3247815299,1672619468,1672622306,2838
7939,3311718847,3606812411,1672613666,1672615818,2152
7649,3666506258,3757403279,1672666444,1672669379,2935
7780,3512540951,3288764520,1672611603,1672612951,1348
7780,3701967560,3734496778,1672665886,1672668115,2229
7548,3516065852,3515125508,1672695842,1672695989,147
7885,3490191091,3520756859,1672625869,1672627882,2013
7716,3383661227,3792288302,1672592042,1672593399,1357
7669,3223968713,3500177712,1672574418,1672576021,1603
7775,3606186086,3755587522,1672692703,1672696211,3508
7715,3429690204,3482405588,1672617854,1672618825,971
7496,3760561634,3885670556,1672620242,1672622132,1890
7685,3774010081,3792668962,1672598776,1672600313,1537
7669,3617734118,3501759100,1672545650,1672547262,1612
7971,3224716315,3232962003,1672651113,1672653789,2676
7509,3973560347,3855602893,1672683323,1672684020,697
7615,3972709319,3888559320,1672619504,1672621210,1706
7816,3346795719,3912536808,1672555846,1672556774,928
7606,3344364444,3820354437,1672659179,1672660518,1339
7961,3520756859,3825229501,1672595482,1672599044,3562
7957,3755798867,3487171044,1672576506,1672577298,792
7683,3735319397,3209027249,1672620581,1672623454,2873
7649,3285400528,3937224533,1672583204,1672584455,1251
7563,3356860407,3666553782,1672638491,1672640093,1602
7962,3636867411,3683766533,1672549650,1672551613,1963
7821,3793753089,3512683609,1672618341,1672619230,889
7659,3783509527,3837094550,1672570980,1672571455,475
7838,3512142794,3467773920,1672676113,1672677143,1030
7713,3362000049,3428964059,1672689880,1672692989,3109
7655,3774005526,3465254146,1672644822,1672645794,972
7770,3307097200,3209383861,1672686874,1672689361,2487
7848,3883312122,3772758337,1672536746,1672539397,2651
7665,3389115045,3505098372,1672579649,1672581800,2151
7860,3809916577,3772746272,1672659694,1672660971,1277
7737,3776800213,3483164654,1672664252,1672665679,1427
7642,3898995675,3238712269,1672566525,1672569971,3446
7799,3520376528,3715127362,1672584661,1672586216,1555
7866,3979339287,3418728074,1672638924,1672640501,1577
7526,3716197887,3733189298,1672613672,1672615084,1412
7715,3520190170,3715127362,1672602229,1672603806,1577
7898,3500994774,3500066230,1672668773,1672669381,608
7804,3701184889,3505791599,1672588610,1672591068,2458
7494,3917088658,3855000166,1672560587,1672561480,893
7610,3505203158,3937224533,1672670625,1672671835,1210
7650,3755436115,3779629905,1672597233,1672598338,1105
7524,3509634629,3511359172,1672568649,1672571034,2385
7955,3513599775,3811694763,1672594972,1672598402,3430
7709,3777983879,3800886801,1672695869,1672697045,1176
7665,3736229191,3833889105,1672555674,1672559244,3570
7607,3311439795,3421127249,1672541904,1672543247,1343
7726,3822654369,3224716315,1672578004,1672581137,3133
7512,3791942683,3826760240,1672639485,1672641328,1843
7710,3793871337,3351008918,1672633772,1672634517,745
7652,3280599164,3701691675,1672597231,1672600132,2901
7873,3500894271,3755587522,1672683259,1672685410,2151
7749,3399433690,3637008488,1672616653,1672617792,1139
7825,3520719611,3511687358,1672551529,1672554601,3072
7611,3505883609,3534492426,1672559793,1672563270,3477
7745,3505145247,3484995752,1672637040,1672639948,2908
7882,3777936328,3713370078,1672551682,1672551753,71
7842,3224058172,3760267716,1672624341,1672625045,704
7819,3519601612,3496051529,1672635700,1672637094,1394
7895,3774010081,3244485293,1672693635,1672694828,1193
7683,3777623166,3516223597,1672664246,1672665002,756
7935,3476232529,3832902928,1672531221,1672531846,625
7963,3349613093,3703789494,1672654885,1672657959,3074
7833,3666553782,3710067113,1672625220,1672627944,2724
7565,3370752401,3688418210,1672690523,1672693769,3246
7959,3401627165,3736786443,1672638103,1672638423,320
7711,3377766165,3683959482,1672629171,1672630097,926
7960,3756453423,3511163800,1672690370,1672691203,833
7643,3312829208,3517476351,1672577428,1672579814,2386
7903,3772359096,3895562476,1672550526,1672552760,2234
7777,3311324983,3221536550,1672543012,1672544006,994
7792,3534729133,3238712269,1672537464,1672537661,197
7829,3358871377,3755739653,1672604394,1672607758,3364
7869,3925620998,3736786443,1672694339,1672697422,3083
7954,3857349323,3826633236,1672615367,1672616191,824
7509,3899371911,3773120434,1672645747,1672646946,1199
7641,3201324715,3711370563,1672630641,1672633859,3218
7931,3714821932,3855000166,1672602933,1672606166,3233
7736,3792902982,3520931254,1672620931,1672624436,3505
7642,3514245078,3770021824,1672662981,1672666300,3319
7584,3516606733,3774501422,1672632339,1672633773,1434
7900,3284639858,3735733948,1672613034,1672614366,1332
7941,3459030804,3793871337,1672616111,1672616816,705
7552,3402943525,3801089989,1672665151,1672665384,233
7869,3223789409,3755042098,1672601592,1672603100,1508
7983,3512142794,3500729955,1672577446,1672580044,2598
7741,3313564074,3533193862,1672632669,1672632931,262
7572,3776338577,3791115967,1672634964,1672638088,3124
7673,3757812939,3711504540,1672571576,1672573912,2336
7806,3511350608,3512567240,1672636897,1672637927,1030
7765,3883861463,3779629905,1672683806,1672684300,494
7627,3311415018,3475396323,1672642180,1672642457,277
7637,3683766533,3701534009,1672631292,1672632095,803
7624,3516039895,3902278226,1672598179,1672601308,3129
7871,3298288268,3438645253,1672562053,1672562687,634
7576,3833889105,3298433163,1672601366,1672603501,2135
7809,3500066230,3714488548,1672633592,1672637183,3591
7567,3792883665,3903307060,1672598033,1672601085,3052
7778,3519563836,3793962300,1672610112,1672611083,971
7570,3399911573,3477649378,1672667510,1672669206,1696
7536,3716488385,3316222192,1672570466,1672572415,1949
7613,3520376528,3496051529,1672580371,1672580893,522
7551,3774127586,3500904641,1672679717,1672680659,942
7847,3552314511,3307097200,1672648587,1672649577,990
7881,3778980116,3439023335,1672632819,1672633716,897
7756,3634995491,3774556560,1672540927,1672543355,2428
7515,3822654369,3793962300,1672616522,1672618080,1558
7531,3512349371,3805292782,1672638698,1672640473,1775
7799,3385763781,3415443558,1672539276,1672542453,3177
7804,3889232789,3433804879,1672683722,1672686021,2299
7624,3396285984,3365614305,1672628559,1672628727,168
7936,3634786711,3500658339,1672597950,1672600337,2387
7592,3394539273,3889750851,1672649372,1672649981,609
7556,3606812411,3774520233,1672577507,1672580072,2565
7761,3421836608,3778980116,1672647554,1672651091,3537
7654,3514719601,3779629905,1672581992,1672584280,2288
7920,3701498253,3792883665,1672699388,1672700498,1110
7537,3818255890,3351554343,1672667549,1672670470,2921
7639,3519563836,3756451663,1672698905,1672700660,1755
7655,3703871468,3515125508,1672640827,1672642213,1386
7640,3501198706,3716488385,1672588899,1672589317,418
7953,3639847263,3685818092,1672670505,1672670877,372
7899,3713349754,3513956646,1672605895,1672608221,2326
7595,3802367797,3534010629,1672542041,1672543931,1890
7810,3783083229,3829232696,1672668975,1672672561,3586
7600,3288764520,3336751428,1672666430,1672668386,1956
7929,3613995936,3511359172,1672545701,1672548525,2824
7530,3373384732,3429690204,1672649786,1672652538,2752
7632,3685818092,3779740455,1672693083,1672695019,1936
7791,3311415018,3783429780,1672637405,1672639802,2397
7781,3837094550,3500729955,1672562653,1672566156,3503
7578,3715981584,3519069599,1672549912,1672551847,1935
7976,3791553060,3918584946,1672623463,1672627050,3587
7705,3386707783,3756453423,1672642704,1672645593,2889
7757,3783705817,3533369198,1672625842,1672626692,850
7781,3772746272,3352603894,1672583924,1672584259,335
7842,3513164386,3505904952,1672668957,1672669607,650
7885,3792789881,3516514391,1672701795,1672702920,1125
7519,3424922204,3313564074,1672668272,1672671692,3420
7902,3773664987,3518360734,1672658710,1672660988,2278
7936,3247815299,3365614305,1672661625,1672663897,2272
7568,3417061462,3520030713,1672641746,1672642953,1207
7647,3511198618,3809916577,1672547725,1672549195,1470
7578,3505347134,3513080274,1672655923,1672656969,1046
7607,3518408774,3505292701,1672628004,1672629459,1455
7533,3348261553,3610348516,1672630456,1672631702,1246
7668,3511862351,3501601840,1672618421,1672620636,2215
7860,3501955238,3533927138,1672685253,1672686970,1717
7773,3202120784,3280964728,1672564196,1672566043,1847
7572,3206593906,3311090974,1672629244,1672631557,2313
7823,3770021824,3277939457,1672611961,1672613546,1585
7666,3246596716,3710408395,1672605059,1672605692,633
7589,3458539365,3517459919,1672639198,1672642520,3322
7912,3399433690,3496269445,1672586156,1672588227,2071
7591,3518669703,3770078063,1672608123,1672608881,758
7490,3359910781,3505702787,1672599919,1672600312,393
7933,3701898991,3804870229,1672621559,1672625099,3540
7785,3791997875,3514987389,1672668739,1672670917,2178
7573,3496269445,3772337814,1672679093,1672681905,2812
7920,3930791338,3249401741,1672561458,1672563185,1727
7756,3772578994,3202120784,1672573905,1672576904,2999
7692,3899266183,3512567240,1672660858,1672662806,1948
7534,3512510536,3779218771,1672587623,1672588177,554
7501,3756424865,3417587765,1672658290,1672660128,1838
7754,3808324264,3360993964,1672649443,1672651986,2543
7712,3736229191,3739106581,1672573175,1672574043,868
7605,3780503655,3682061100,1672555509,1672556831,1322
7708,3342131135,3520165601,1672645165,1672648248,3083
7853,3760509236,3505098372,1672696844,1672698113,1269
7856,3483164654,3533095755,1672625053,1672625440,387
7546,3772309166,3715974031,1672632471,1672635077,2606
7719,3926700506,3276640712,1672579857,1672580805,948
7683,3446948848,3505649239,1672680650,1672684172,3522
7652,3556951786,3473765852,1672683876,1672685551,1675
7776,3624761861,3489728806,1672646719,1672649057,2338
7551,3939952128,3855000166,1672610404,1672611413,1009
7781,3510244400,3791901535,1672536241,1672539015,2774
7864,3756623396,3443698222,1672684944,1672686760,1816
7596,3517963492,3616944364,1672549964,1672550761,797
7534,3489217083,3484995752,1672559414,1672562368,2954
7726,3760992710,3318697153,1672655494,1672658692,3198
7805,3714821932,3823600322,1672703775,1672706589,2814
7533,3931941795,3509453566,1672677974,1672681524,3550
7562,3777455223,3777514571,1672656076,1672657135,1059
7841,3496549058,3756021689,1672558047,1672559895,1848
7490,3511687358,3777477395,1672644676,1672646253,1577
7890,3453729665,3701967560,1672625989,1672626516,527
7876,3793086311,3222521619,1672627373,1672627829,456
7806,3311274543,3242408357,1672562161,1672564877,2716
7762,3857349323,3417587765,1672578981,1672580248,1267
7952,3778341199,3298288268,1672561123,1672563801,2678
7539,3613683164,3311627628,1672690911,1672691222,311
7528,3533025282,3711262377,1672614632,1672617844,3212
7661,3206254161,3384951177,1672698090,1672701377,3287
7603,3701184889,3500374658,1672592090,1672593104,1014
7607,3360993964,3279721246,1672647641,1672649907,2266
7854,3828624701,3737154119,1672628152,1672629872,1720
7961,3791553060,3518260334,1672660439,1672661767,1328
7902,3811694763,3533748232,1672693946,1672697536,3590
7551,3432665384,3510711755,1672667134,1672670487,3353
7832,3311203656,3760561634,1672671163,1672672722,1559
7772,3774010081,3793627961,1672547605,1672550299,2694
7544,3316173088,3229665776,1672669002,1672671182,2180
7969,3776948966,3227158514,1672590586,1672593467,2881
7730,3512837326,3772053179,1672581022,1672584494,3472
7968,3481647420,3685818092,1672547926,1672548866,940
7938,3760489031,3613995936,1672623052,1672625261,2209
7879,3636867411,3505873261,1672607413,1672609564,2151
7680,3791115967,3730517636,1672589864,1672592921,3057
7533,3755881905,3819727225,1672542013,1672542608,595
7882,3296471982,3713208927,1672662383,1672663111,728
7496,3509352754,3688683847,1672607812,1672609384,1572
7875,3777120536,3778305740,1672615631,1672617210,1579
7929,3418534998,3501759100,1672559183,1672559835,652
7580,3291235378,3224058172,1672535022,1672535468,446
7904,3319752091,3533369198,1672590184,1672591086,902
7930,3394330287,3534010629,1672543813,1672547112,3299
7534,3772544062,3378436155,1672688836,1672691215,2379
7629,3360993964,3703789494,1672646203,1672647972,1769
7504,3880310724,3756528686,1672697897,1672701265,3368
7931,3774010081,3519700826,1672586235,1672586769,534
7708,3518932404,3685187183,1672566793,1672568590,1797
7694,3793470489,3780639480,1672652142,1672653331,1189
7639,3778549126,3716165213,1672576742,1672576953,211
7947,3407954858,3739106581,1672672233,1672675223,2990
7977,3534010629,3519152550,1672682396,1672685502,3106
7505,3756453423,3617055293,1672660046,1672660859,813
7899,3271938399,3739106581,1672632535,1672634557,2022
7592,3711265369,3778549126,1672649315,1672651136,1821
7969,3370752401,3534729133,1672615230,1672618548,3318
7659,3206254161,3235287260,1672692181,1672692749,568
7946,3511862351,3755587522,1672556111,1672558788,2677
7596,3826759140,3889750851,1672542559,1672546078,3519
7745,3501955238,3634340855,1672568743,1672569276,533
7888,3533025282,3711571712,1672661493,1672664422,2929
7965,3500060260,3714962248,1672617962,1672619045,1083
7887,3246596716,3370752401,1672665260,1672666914,1654
7937,3813052709,3713808837,1672680716,1672680892,176
7788,3932051427,3774204963,1672616450,1672618889,2439
7805,3500729955,3736419952,1672565698,1672567554,1856
7691,3345207877,3280615985,1672563835,1672564705,870
7689,3826633236,3883085535,1672667795,1672668792,997
7789,3755392666,3516716179,1672630249,1672632656,2407
7672,3815508790,3666457294,1672666730,1672668558,1828
7603,3909331423,3624761861,1672699886,1672701876,1990
7701,3465254146,3200691026,1672695034,1672698230,3196
7555,3378092448,3714488548,1672554669,1672555601,932
7753,3519069599,3791594391,1672639741,1672642845,3104
7800,3516223597,3509907947,1672674148,1672676845,2697
7960,3755739653,3509773875,1672543952,1672544441,489
7691,3772642849,3774010081,1672629869,1672632507,2638
7800,3356860407,3760267716,1672584822,1672586656,1834
7551,3703013906,3757151210,1672603503,1672607038,3535
7878,3303751772,3813052709,1672623219,1672625305,2086
7965,3388286531,3513956646,1672687272,1672688682,1410
7952,3777790718,3780914982,1672613947,1672616444,2497
7982,3777936328,3501184421,1672671314,1672674009,2695
7707,3311993075,3770763956,1672548653,1672551235,2582
7589,3610695419,3668005723,1672683332,1672685119,1787
7739,3918674986,3520719611,1672678908,1672682094,3186
7650,3883861463,3505904952,1672570722,1672573151,2429
7928,3792902982,3412980697,1672584173,1672587053,2880
7643,3311154569,3792032359,1672622524,1672625685,3161
7916,3639847263,3716258994,1672641969,1672644862,2893
7612,3520629279,3520629279,1672651919,1672652669,750
7972,3550946908,3778108318,1672573033,1672574146,1113
7883,3613683164,3791942683,1672553437,1672554568,1131
7570,3783206719,3736592744,1672573873,1672574782,909
7966,3770021824,3520751702,1672625935,1672626098,163
7645,3774195321,3828624701,1672545988,1672548287,2299
7844,3399911573,3779976989,1672560654,1672561021,367
7734,3417587765,3806545488,1672543371,1672545065,1694
7544,3481647420,3773755137,1672665932,1672668324,2392
7732,3271938399,3501483568,1672592092,1672594474,2382
7690,3509453566,3703013906,1672545538,1672545763,225
7562,3776948966,3488244966,1672635510,1672635928,418
7774,3443698222,3278365525,1672644956,1672646519,1563
7767,3390068992,3399052055,1672650182,1672651942,1760
7550,3755943611,3685818092,1672551741,1672552067,326
7697,3511359172,3666457294,1672557893,1672558802,909
7707,3791957752,3518014636,1672633070,1672635116,2046
7867,3972364603,3336742544,1672586642,1672589773,3131
7843,3776948966,3383661227,1672543228,1672544259,1031
7565,3770635361,3280599164,1672534594,1672537818,3224
7892,3417061462,3770851318,1672546200,1672548051,1851
7547,3911245524,3716197887,1672685196,1672688324,3128
7626,3703789494,3509604974,1672579445,1672580742,1297
7839,3346327502,3780813786,1672544294,1672547739,3445
7539,3318697153,3716273414,1672541241,1672543684,2443
7837,3757682496,3501198706,1672607881,1672609177,1296
7934,3703275621,3760893269,1672566412,1672569610,3198
7560,3826415738,3774005526,1672645109,1672647493,2384
7959,3519803045,3606987130,1672585761,1672586592,831
7706,3713808837,3634786711,1672638544,1672641006,2462
7515,3883551721,3899266183,1672642225,1672643743,1518
7707,3511359172,3209551760,1672540840,1672543335,2495
7719,3517255726,3246596716,1672629880,1672631434,1554
7761,3345207877,3792384220,1672534217,1672536092,1875
7584,3407954858,3780503655,1672653794,1672655268,1474
7973,3361230905,3421127249,1672632475,1672632693,218
7636,3760569731,3904408902,1672680940,1672682195,1255
7682,3519556068,3614238812,1672584844,1672585790,946
7819,3701691675,3303705369,1672657900,1672660786,2886
7752,3714488548,3660493209,1672683897,1672686739,2842
7863,3909331423,3369998498,1672689762,1672691480,1718
7693,3374559242,3607178184,1672680637,1672681927,1290
7695,3298433163,3711571712,1672655464,1672656876,1412
7725,3311415018,3512510536,1672592263,1672594663,2400
7530,3344019610,3516514391,1672663662,1672666766,3104
7591,3936227020,3715189301,1672586980,1672589793,2813
7494,3976390453,3434642576,1672698917,1672701266,2349
7642,3235635976,3713208927,1672602865,1672604320,1455
7810,3823600322,3608868877,1672602759,1672603806,1047
7848,3235287260,3772337814,1672550183,1672552239,2056
7499,3236102733,3280599164,1672603177,1672606728,3551
7548,3777623166,3358871377,1672598316,1672599840,1524
7845,3311152102,3918056059,1672600662,1672600940,278
7697,3206254161,3279721246,1672610182,1672612290,2108
7500,3716168623,3760893269,1672552016,1672555019,3003
7620,3904775198,3935627557,1672698076,1672699387,1311
7560,3505219850,3516673015,1672679957,1672680978,1021
7956,3834257412,3416241005,1672561842,1672565324,3482
7884,3429690204,3925402713,1672633886,1672634967,1081
7922,3337544549,3223789409,1672625702,1672626147,445
7520,3467773920,3793627961,1672654240,1672657281,3041
7762,3757246925,3311648200,1672651876,1672653727,1851
7787,3518360734,3703871468,1672647659,1672649809,2150
7821,3505347134,3511125626,1672661649,1672661923,274
7676,3501184421,3772053179,1672560818,1672561597,779
7730,3448855696,3451432842,1672698476,1672701519,3043
7807,3500177712,3407954858,1672577295,1672580171,2876
7794,3510969660,3511271692,1672630329,1672632647,2318
7487,3777514571,3224058172,1672590026,1672591352,1326
7956,3757562897,3346795719,1672555154,1672557972,2818
7810,3622054816,3774045700,1672672155,1672674450,2295
7965,3774339795,3793389510,1672558494,1672558692,198
7845,3481647420,3613683164,1672647910,1672650961,3051
7970,3248507722,3533827120,1672686721,1672689824,3103
7616,3633420270,3519700826,1672568680,1672570374,1694
7978,3430352815,3348261553,1672687090,1672688058,968
7648,3485823740,3738502357,1672646232,1672647110,878
7677,3828432634,3773120434,1672549794,1672552345,2551
7770,3533827120,3488244966,1672653096,1672656670,3574
7982,3519703355,3505791599,1672602856,1672604661,1805
7723,3755798867,3293695955,1672534217,1672534847,630
7497,3613995936,3792473331,1672575583,1672577795,2212
7773,3388286531,3514838220,1672654193,1672657340,3147
7561,3372883226,3730517636,1672627512,1672628065,553
7962,3512567240,3733189298,1672692870,1672693773,903
7498,3715492942,3930791338,1672619723,1672622584,2861
7859,3792253549,3311415018,1672547183,1672548331,1148
7705,3711504540,3550946908,1672587034,1672588611,1577
7889,3432689543,3511163800,1672552663,1672553554,891
7536,3509453566,3913251733,1672627673,1672628807,1134
7734,3710344260,3616944364,1672559548,1672562306,2758
7928,3277605882,3338367113,1672673613,1672676037,2424
7553,3780294829,3485823740,1672589273,1672591426,2153
7655,3774050956,3805342762,1672575854,1672577823,1969
7961,3297463265,3857349323,1672634874,1672638165,3291
7622,3480687894,3773598056,1672578569,1672580092,1523
7668,3808324264,3515723720,1672659177,1672661566,2389
7662,3417587765,3483164654,1672555102,1672558480,3378
7825,3736790081,3418534998,1672698075,1672700519,2444
7859,3770078063,3516039895,1672577892,1672580294,2402
7783,3774338212,3432689543,1672533390,1672533993,603
7709,3773465237,3514472925,1672541356,1672544371,3015
7794,3514283243,3736592744,1672543499,1672544714,1215
7896,3505347134,3505477652,1672607352,1672607642,290
7885,3287105466,3383922351,1672690856,1672691114,258
7803,3791957752,3510247121,1672621811,1672623265,1454
7772,3774195321,3601879040,1672548600,1672549607,1007
7757,3338367113,3805292782,1672616213,1672619480,3267
7871,3711370563,3500199935,1672670089,1672671569,1480
7747,3247780536,3737154119,1672646660,1672647006,346
7925,3853018906,3232962003,1672650124,1672652551,2427
7832,3613995936,3634340855,1672626418,1672626687,269
7852,3209048907,3800353779,1672640444,1672640874,430
7518,3501486692,3715974031,1672572957,1672574028,1071
7798,3311603601,3512837326,1672690674,1672694193,3519
7698,3629547065,3489545239,1672685088,1672685641,553
7589,3792384220,3516716179,1672542362,1672542939,577
7500,3793086311,3534191820,1672593409,1672593546,137
7904,3703013906,3774466457,1672638439,1672641807,3368
7864,3734828619,3716835696,1672642066,1672642221,155
7737,3822654369,3711308224,1672652049,1672653053,1004
7559,3736790081,3276993580,1672702804,1672704795,1991
7580,3898995675,3910454786,1672633961,1672636284,2323
7609,3713894336,3755739653,1672625175,1672626185,1010
7626,3755625324,3500365158,1672627662,1672630294,2632
7957,3615046771,3512720680,1672606659,1672610078,3419
7826,3627937312,3465202715,1672531973,1672534245,2272
7735,3883861463,3716746253,1672549117,1672551864,2747
7876,3774204963,3901877072,1672668404,1672670348,1944
7689,3365614305,3356860407,1672692834,1672694455,1621
7636,3855602893,3914259449,1672542832,1672545663,2831
7887,3899371911,3399004969,1672551950,1672552738,788
7846,3714962248,3755436115,1672544437,1672546961,2524
7485,3519556068,3291883916,1672653831,1672654392,561
7906,3792883665,3501364586,1672681828,1672682302,474
7551,3534488837,3634340855,1672633383,1672636363,2980
7671,3273500349,3206254161,1672680360,1672683722,3362
7624,3760992710,3880285638,1672700953,1672702653,1700
7801,3777079686,3488244966,1672639421,1672641485,2064
7901,3714197325,3918247820,1672611165,1672613310,2145
7761,3555214688,3512166013,1672546317,1672548281,1964
7878,3500458761,3776066388,1672618074,1672620870,2796
7568,3757812939,3344364444,1672616471,1672616840,369
7547,3922275620,3284639858,1672699576,1672702873,3297
7842,3716835696,3500458761,1672629108,1672631857,2749
7770,3477649378,3736419952,1672642050,1672645092,3042
7796,3606987130,3792844210,1672576831,1672580409,3578
7838,3501730685,3501927421,1672646014,1672647091,1077
7840,3898995675,3319752091,1672549970,1672550533,563
7513,3734737881,3287105466,1672588278,1672590951,2673
7515,3774125065,3517721725,1672661388,1672663883,2495
7874,3774501422,3604539807,1672684580,1672685707,1127
7528,3715974031,3791553060,1672594049,1672594522,473
7930,3477649378,3701065786,1672551119,1672554149,3030
7785,3517459919,3224058172,1672580587,1672582433,1846
7635,3711198793,3501184421,1672651941,1672654296,2355
7952,3828432634,3889232789,1672613771,1672616350,2579
7605,3390068992,3348261553,1672585539,1672588284,2745
7834,3356860407,3792032359,1672625522,1672625856,334
7675,3820354437,3430504438,1672552849,1672553356,507
7838,3716537575,3555214688,1672640730,1672641671,941
7716,3285400528,3792473331,1672656767,1672660296,3529
7565,3511435497,3714474557,1672592131,1672594283,2152
7555,3774204963,3777983879,1672611204,1672612746,1542
7823,3777929708,3777623166,1672549766,1672550946,1180
7801,3500994774,3429856982,1672636563,1672637133,570
7699,3917278625,3510247121,1672569367,1672570636,1269
7584,3682061100,3880285638,1672621753,1672622341,588
7943,3510244400,3520030713,1672595458,1672598965,3507
7591,3517509185,3852391257,1672539615,1672540173,558
7873,3227158514,3815508790,1672572801,1672575652,2851
7968,3516960534,3791901535,1672603428,1672603955,527
7840,3515284591,3501198706,1672552940,1672556269,3329
7606,3434642576,3756424865,1672696543,1672698639,2096
7808,3912536808,3756021689,1672644812,1672647070,2258
7625,3510594211,3501601840,1672635623,1672636030,407
7517,3501198706,3777790718,1672570657,1672574139,3482
7579,3515394721,3883085535,1672669942,1672671839,1897
7943,3453729665,3793627961,1672689903,1672690319,416
7676,3206254161,3407673904,1672666750,1672668832,2082
7605,3391261292,3805347939,1672584926,1672588384,3458
7731,3399535232,3832902928,1672552417,1672553438,1021
7845,3373384732,3512683609,1672665396,1672666702,1306
7853,3915628728,3311761694,1672587137,1672588241,1104
7780,3715189301,3279721246,1672599274,1672599861,587
7757,3777120536,3774268456,1672623636,1672624966,1330
7874,3793962300,3819727225,1672563348,1672565399,2051
7752,3634786711,3377766165,1672650371,1672651035,664
7668,3490191091,3926700506,1672535171,1672536314,1143
7505,3793871337,3703223015,1672639785,1672641455,1670
7811,3774520233,3757455053,1672600545,1672600733,188
7847,3913251733,3922275416,1672679899,1672680137,238
7656,3925402713,3606987130,1672561916,1672565065,3149
7543,3828365570,3904408902,1672545542,1672545992,450
7817,3500894271,3791553060,1672664088,1672665592,1504
7775,3606812411,3716843669,1672662638,1672663219,581
7588,3516011407,3365278081,1672615995,1672617811,1816
7597,3244389794,3312829208,1672547464,1672548117,653
7850,3296471982,3666506258,1672551821,1672553352,1531
7794,3703275621,3500199935,1672641652,1672641712,60
7940,3736625083,3770101921,1672630928,1672632989,2061
7935,3311208440,3404384505,1672696104,1672698680,2576
7560,3779528381,3772309166,1672545871,1672547692,1821
7534,3774050956,3277605882,1672649499,1672651735,2236
7961,3756601594,3773598056,1672677219,1672678391,1172
7492,3639847263,3418728074,1672577206,1672577343,137
7795,3939952128,3231056870,1672679948,1672682523,2575
7786,3249791738,3756451663,1672549411,1672549907,496
7851,3500803339,3489217083,1672538748,1672542109,3361
7662,3935127663,3311627628,1672692497,1672693219,722
7945,3730517636,3492478793,1672668028,1672668681,653
7914,3792789881,3756528686,1672649071,1672650726,1655
7881,3505869747,3505201246,1672567286,1672569751,2465
7651,3397418363,3339907603,1672693577,1672694584,1007
7488,3359239884,3711380716,1672559533,1672560267,734
7855,3466229085,3731419510,1672570193,1672573485,3292
7714,3500458761,3895562476,1672658914,1672662039,3125
7773,3501184421,3606186086,1672613930,1672617266,3336
7857,3901877072,3735319397,1672590227,1672591836,1609
7592,3791594391,3518014636,1672594339,1672595136,797
7900,3505635228,3737051610,1672552719,1672553127,408
7547,3415443558,3777443199,1672651924,1672652876,952
7579,3703275621,3760267716,1672619421,1672621878,2457
7684,3454042520,3760489031,1672702086,1672702220,134
7861,3505883609,3500499542,1672559780,1672561339,1559
7579,3505347134,3246596716,1672673034,1672676416,3382
7505,3510126867,3534729133,1672608241,1672609033,792
7711,3852391257,3417587765,1672644456,1672647982,3526
7818,3888559320,3779218771,1672641121,1672643440,2319
7869,3316222192,3494290908,1672668816,1672670729,1913
7684,3715981584,3420432297,1672537703,1672540694,2991
7632,3222521619,3428964059,1672533961,1672536822,2861
7793,3624761861,3517459919,1672633675,1672636615,2940
7694,3827626797,3533025282,1672679102,1672682534,3432
7605,3475251781,3777514571,1672568222,1672571303,3081
7610,3388637594,3701967560,1672534632,1672537471,2839
7616,3711380716,3926700506,1672671346,1672674243,2897
7871,3510244400,3297463265,1672677571,1672679515,1944
7873,3911245524,3667680268,1672609915,1672609980,65
7546,3883861463,3509630174,1672536693,1672539390,2697
7688,3391915121,3736592744,1672608880,1672610832,1952
7704,3922337974,3515860749,1672685055,1672688468,3413
7553,3817621391,3793389510,1672639906,1672640918,1012
7735,3513454145,3701111745,1672642483,1672643187,704
7955,3701065786,3512683609,1672684664,1672685449,785
7657,3626156564,3737051610,1672578603,1672579526,923
7571,3716843669,3711265369,1672587596,1672590074,2478
7749,3912262917,3533653428,1672635652,1672636007,355
7647,3518496488,3777623166,1672568871,1672569263,392
7870,3714504419,3316222192,1672650238,1672651006,768
7579,3512166013,3379589402,1672671595,1672672039,444
7771,3833889105,3533280269,1672573296,1672575903,2607
7771,3505219850,3365830990,1672556563,1672557956,1393
7572,3774204963,3492478793,1672545916,1672548243,2327
7540,3791901535,3244389794,1672678435,1672679886,1451
7679,3244436890,3666457294,1672670823,1672671657,834
7712,3783531004,3510969660,1672695277,1672697221,1944
7817,3780914982,3688683847,1672585832,1672586542,710
7862,3229665776,3505791599,1672629742,1672632109,2367
7746,3500994774,3533137446,1672703633,1672705124,1491
7615,3505962865,3512510536,1672586079,1672588263,2184
7748,3756451663,3774045700,1672699071,1672699224,153
7881,3472130842,3510380060,1672539848,1672541159,1311
7734,3817316561,3716537575,1672624441,1672626835,2394
7950,3428964059,3287105466,1672701218,1672703233,2015
7581,3910454786,3505883609,1672609321,1672610583,1262
7941,3206603608,3511862351,1672551892,1672553305,1413
7589,3280599164,3501730685,1672677715,1672680607,2892
7552,3416427576,3774793839,1672698900,1672700334,1434
7924,3311154569,3510380060,1672601055,1672603199,2144
7708,3334033993,3714962248,1672576500,1672576938,438
7550,3715998609,3859525941,1672593230,1672593482,252
7545,3510937904,3510244400,1672652588,1672653495,907
7545,3617055293,3855000166,1672552851,1672554817,1966
7524,3806545488,3337544549,1672579516,1672580164,648
7889,3391915886,3505292701,1672531671,1672532948,1277
7818,3453729665,3388637594,1672569537,1672570544,1007
7769,3883085535,3459030804,1672573560,1672575707,2147
7492,3516629436,3829319703,1672629883,1672631236,1353
7580,3311648200,3395152943,1672623041,1672626221,3180
7621,3734737881,3511359172,1672554208,1672555186,978
7952,3505883609,3332072298,1672617918,1672618620,702
7897,3777623166,3634340855,1672674380,1672674866,486
7781,3512166013,3939952128,1672592568,1672593111,543
7807,3501759100,3489728806,1672588685,1672590675,1990
7865,3668005723,3757161914,1672569205,1672570196,991
7819,3358871377,3793338102,1672683112,1672685626,2514
7616,3757161914,3666507626,1672615826,1672618362,2536
7582,3793470489,3804870229,1672574460,1672576828,2368
7762,3683766533,3433804879,1672534228,1672536190,1962
7520,3511267139,3311718847,1672600151,1672602387,2236
7892,3490191091,3774338212,1672691620,1672693907,2287
7872,3770851318,3773755137,1672693645,1672694200,555
7839,3505362057,3606987130,1672698833,1672700325,1492
7894,3361230905,3757602960,1672672885,1672675284,2399
7766,3359239884,3780813786,1672588792,1672589881,1089
7582,3291883916,3773120434,1672644538,1672645717,1179
7682,3736625083,3373384732,1672685509,1672685975,466
7555,3519556068,3664517356,1672547459,1672550305,2846
7698,3372883226,3509907947,1672578946,1672582365,3419
7799,3242408357,3778108318,1672553701,1672555591,1890
7766,3291227780,3224058172,1672610944,1672611196,252
7638,3505530961,3774119563,1672552888,1672555741,2853
7671,3774501422,3755511676,1672678081,1672680552,2471
7712,3289061738,3932051427,1672577206,1672578255,1049
7673,3774066725,3735319397,1672655907,1672656535,628
7576,3822654369,3249791738,1672536195,1672537398,1203
7772,3774338212,3359239884,1672628400,1672629621,1221
7485,3509634629,3390068992,1672660849,1672663082,2233
7750,3509604974,3533371364,1672588331,1672589780,1449
7848,3618045231,3311871871,1672556767,1672557842,1075
7868,3837094550,3510247121,1672556890,1672558881,1991
7663,3500803339,3307512479,1672535352,1672536407,1055
7608,3517255726,3518496488,1672581345,1672582786,1441
7897,3201848640,3777776687,1672572131,1672573759,1628
7731,3466911760,3610348516,1672616435,1672618337,1902
7900,3404384505,3822654369,1672619624,1672621608,1984
7803,3780813786,3510594211,1672589081,1672592185,3104
7647,3901990690,3760492950,1672540014,1672540784,770
7781,3783206719,3370636709,1672674878,1672677194,2316
7673,3379589402,3755625324,1672702351,1672703282,931
7483,3711262377,3899266183,1672604247,1672606789,2542
7604,3280599164,3607178184,1672575501,1672576102,601
7783,3730517636,3516606733,1672561721,1672562232,511
7949,3688683847,3428006164,1672560154,1672563229,3075
7817,3378436155,3511332835,1672641875,1672643166,1291
7794,3772053179,3277669002,1672533890,1672534043,153
7682,3918674986,3459030804,1672581141,1672583480,2339
7961,3227457126,3756424865,1672534776,1672537339,2563
7617,3792768129,3792902982,1672681873,1672685251,3378
7781,3298288268,3509604974,1672559849,1672561976,2127
7684,3772544062,3407673904,1672641901,1672642138,237
7666,3828624701,3510244400,1672553431,1672556423,2992
7646,3533270638,3399535232,1672683058,1672686161,3103
7590,3359910781,3505201246,1672564067,1672567096,3029
7844,3494290908,3511435497,1672566681,1672570200,3519
7827,3735733948,3432689543,1672623545,1672624142,597
7817,3855424474,3533385867,1672586162,1672588707,2545
7808,3432689543,3634340855,1672568322,1672570433,2111
7768,3430352815,3912536808,1672534546,1672537128,2582
7773,3716168623,3516039895,1672621932,1672623669,1737
7495,3629547065,3922275620,1672586710,1672586869,159
7513,3333896808,3421836608,1672559256,1672560992,1736
7956,3235635976,3505477652,1672645577,1672647136,1559
7904,3405494240,3666506258,1672669389,1672672258,2869
7632,3617055293,3666457294,1672608917,1672612241,3324
7520,3890149705,3406784491,1672539650,1672541817,2167
7960,3427283336,3280964728,1672547851,1672548907,1056
7649,3351008918,3477375368,1672674116,1672676444,2328
7924,3428964059,3918584946,1672609877,1672610971,1094
7889,3418728074,3492478793,1672590157,1672590449,292
7586,3533369198,3776800213,1672693153,1672694193,1040
7586,3736786443,3391915121,1672685055,1672685153,98
7863,3517459919,3716488385,1672699212,1672700913,1701
7572,3311152102,3715189301,1672665779,1672665858,79
7864,3904408902,3901877072,1672601136,1672602917,1781
7781,3453729665,3774793839,1672654713,1672656108,1395
7755,3668005723,3229665776,1672605004,1672608295,3291
7592,3836573197,3533369198,1672546200,1672547954,1754
7572,3407725581,3703013906,1672572971,1672573754,783
7539,3903307060,3392121505,1672623223,1672626453,3230
7656,3629547065,3774050956,1672701552,1672702986,1434
7528,3886298125,3515394721,1672634997,1672635341,344
7715,3432689543,3883042241,1672702381,1672703295,914
7548,3311065516,3505883609,1672646879,1672647520,641
7956,3446948848,3314245084,1672690568,1672691552,984
7974,3485375593,3467773920,1672545017,1672545163,146
7811,3826759140,3904775198,1672600884,1672603126,2242
7750,3315583351,3802367797,1672585079,1672586406,1327
7620,3501198706,3519601612,1672622433,1672625928,3495
7505,3314245084,3514283243,1672543847,1672544500,653
7553,3397418363,3312333615,1672622583,1672625704,3121
7740,3505638204,3453729665,1672659803,1672661714,1911
7688,3922275620,3336751428,1672600356,1672601193,837
7778,3481502100,3755587522,1672644562,1672645173,611
7628,3394330287,3793338102,1672594951,1672595676,725
7775,3716273414,3519601612,1672658392,1672659578,1186
7743,3791901535,3777120536,1672551016,1672552853,1837
7702,3757602960,3703955926,1672583211,1672586216,3005
7617,3626156564,3500391167,1672626007,1672628977,2970
7730,3505201246,3770553384,1672564412,1672565653,1241
7973,3701178711,3520751702,1672674126,1672677713,3587
7772,3713808837,3755625324,1672692632,1672693036,404
7807,3618873142,3311065516,1672665596,1672665847,251
7500,3621497531,3925402713,1672572684,1672575875,3191
7948,3770078063,3426325549,1672547394,1672549498,2104
7613,3839849341,3917088658,1672695655,1672696660,1005
7581,3662180254,3518014636,1672626336,1672627910,1574
7786,3701190899,3777514571,1672553800,1672557389,3589
7845,3774793839,3244173074,1672688778,1672689548,770
7628,3511163800,3756027749,1672622687,1672625401,2714
7612,3518014404,3466229085,1672592830,1672594355,1525
7802,3516673015,3859525941,1672683372,1672686031,2659
7598,3737154119,3601879040,1672683146,1672685935,2789
7794,3713969578,3505873261,1672660698,1672661964,1266
7516,3936227020,3615046771,1672674714,1672677914,3200
7678,3208844525,3703441914,1672645719,1672646087,368
7892,3667680268,3776513891,1672553488,1672556342,2854
7631,3500199935,3365614305,1672661480,1672665022,3542
7700,3774268456,3516258476,1672558205,1672561084,2879
7746,3833889105,3791020967,1672568283,1672570275,1992
7676,3791020967,3510126867,1672628079,1672630069,1990
7540,3505912939,3972709319,1672676392,1672678450,2058
7980,3800353779,3935127663,1672683361,1672686243,2882
7485,3774125065,3914259449,1672647831,1672650580,2749
7702,3513164386,3621810464,1672595771,1672595879,108
7634,3918056059,3828624701,1672534986,1672537724,2738
7533,3783509527,3792177074,1672657981,1672658575,594
7604,3931941795,3780294829,1672571294,1672572077,783
7795,3792288302,3500994774,1672647583,1672648555,972
7727,3516016437,3227158514,1672594466,1672598023,3557
7908,3662180254,3416241005,1672585059,1672585815,756
7757,3808324264,3701190899,1672697828,1672698111,283
7582,3484995752,3791957752,1672691186,1672694600,3414
7926,3432665384,3935127663,1672574433,1672576595,2162
7898,3515394721,3223968713,1672634267,1672636501,2234
7858,3505193212,3852391257,1672625706,1672626979,1273
7664,3509352754,3733891182,1672551512,1672554073,2561
7500,3802367797,3505904952,1672560833,1672564059,3226
7535,3439023335,3882242815,1672535698,1672538079,2381
7655,3711370563,3505791599,1672654698,1672657986,3288
7930,3756424865,3774066725,1672633978,1672635625,1647
7618,3770101921,3346327502,1672549662,1672551671,2009
7717,3372883226,3448855696,1672671736,1672673436,1700
7964,3311845971,3510703546,1672694478,1672697128,2650
7550,3883312122,3757682496,1672668270,1672671516,3246
7958,3791657947,3417587765,1672594619,1672595223,604
7801,3500199935,3515394721,1672627737,1672629560,1823
7823,3367029997,3805292782,1672672888,1672673875,987
7746,3511350608,3516258476,1672666974,1672670305,3331
7783,3710569131,3312333615,1672602893,1672604204,1311
7838,3774338212,3922275620,1672619166,1672620390,1224
7539,3378092448,3278365525,1672649427,1672651863,2436
7548,3516629436,3416241005,1672673669,1672674879,1210
7710,3475251781,3378436155,1672694018,1672696342,2324
7754,3760598102,3453729665,1672574107,1672576111,2004
7695,3517721725,3627937312,1672559572,1672559979,407
7708,3518014404,3477649378,1672621371,1672623551,2180
7506,3438645253,3716258994,1672614722,1672615005,283
7542,3825229501,3880285638,1672606496,1672609641,3145
7535,3247428249,3636867411,1672658196,1672661334,3138
7961,3734828619,3883312122,1672644415,1672645036,621
7722,3235287260,3701863557,1672701047,1672703858,2811
7851,3505219850,3311090974,1672677174,1672680689,3515
7764,3407954858,3511271692,1672595550,1672595698,148
7861,3307512479,3734496778,1672682623,1672682975,352
7855,3534424200,3773465237,1672685148,1672685706,558
7901,3817316561,3302626661,1672563218,1672564525,1307
7568,3634786711,3514719601,1672601553,1672603287,1734
7529,3607748895,3710098970,1672651952,1672652558,606
7628,3391915886,3629547065,1672605343,1672606910,1567
7729,3776513891,3516223597,1672666591,1672666885,294
7839,3514472925,3517077106,1672671176,1672673380,2204
7719,3509634629,3827222533,1672693585,1672695066,1481
7673,3517864478,3519700826,1672683374,1672685096,1722
7791,3520751702,3516011407,1672541223,1672542004,781
7888,3777477395,3793959750,1672668947,1672671826,2879
7657,3313564074,3505477652,1672543759,1672544879,1120
7800,3430074045,3736592744,1672572508,1672574496,1988
7928,3792668962,3311152102,1672652540,1672654986,2446
7749,3770553384,3617055293,1672698955,1672699027,72
7902,3883861463,3533242305,1672623791,1672625574,1783
7763,3417061462,3731419510,1672539913,1672542874,2961
7714,3793959750,3201324715,1672606383,1672607252,869
7572,3516629436,3500365158,1672672281,1672674535,2254
7745,3500894271,3303751772,1672699011,1672700842,1831
7626,3412980697,3333896808,1672665674,1672666330,656
7491,3973560347,3805292782,1672634790,1672635315,525
7513,3774010081,3736419952,1672662593,1672664320,1727
7519,3736790081,3505173328,1672626458,1672626532,74
7764,3311065516,3311761694,1672568334,1672568751,417
7948,3418534998,3510969660,1672684952,1672687951,2999
7573,3800886801,3626156564,1672628220,1672630667,2447
7712,3622054816,3732481297,1672684290,1672687663,3373
7746,3615046771,3429856982,1672614006,1672616704,2698
7837,3511312803,3701178711,1672653796,1672654193,397
7896,3711380716,3976633198,1672696698,1672698794,2096
7693,3311274543,3737079798,1672663936,1672667039,3103
7794,3667680268,3477649378,1672701059,1672704317,3258
7867,3490191091,3482405588,1672580045,1672580414,369
7687,3773205565,3793848402,1672681503,1672681684,181
7632,3534424200,3714488548,1672589934,1672592653,2719
7658,3800353779,3777717988,1672654516,1672654832,316
7819,3222521619,3519069599,1672639193,1672639754,561
7568,3516065852,3713969578,1672622414,1672623219,805
7945,3247815299,3489962019,1672545166,1672548500,3334
7855,3629935998,3736790081,1672596490,1672600037,3547
7791,3291235378,3774466457,1672659188,1672662348,3160
7910,3511350608,3716835696,1672702739,1672705109,2370
7803,3512683609,3853018906,1672575979,1672576417,438
7795,3889232789,3488244966,1672647084,1672650383,3299
7839,3777079686,3223968713,1672564846,1672567068,2222
7858,3703789494,3311845971,1672553835,1672557291,3456
7777,3313564074,3837094550,1672534833,1672538132,3299
7801,3736419952,3294803686,1672545324,1672548540,3216
7926,3701190899,3289061738,1672616429,1672619228,2799
7735,3819727225,3433804879,1672661621,1672662039,418
7764,3396285984,3911245524,1672611208,1672612938,1730
7962,3229058858,3430504438,1672584913,1672586705,1792
7787,3716197887,3520206212,1672680794,1672683722,2928
7641,3387674757,3683959482,1672701917,1672704317,2400
7623,3760294205,3247780536,1672693798,1672695733,1935
7749,3756424865,3883085535,1672632183,1672634966,2783
7602,3618045231,3505135325,1672680077,1672681396,1319
7871,3792844210,3428674539,1672600085,1672602224,2139
7541,3311152102,3533369198,1672589689,1672592319,2630
7562,3505702787,3852595551,1672590177,1672593099,2922
7744,3783126683,3777929708,1672588204,1672589080,876
7773,3703735129,3711973519,1672552530,1672555879,3349
7566,3511350608,3485375593,1672666005,1672667940,1935
7558,3467773920,3772337814,1672695190,1672697764,2574
7526,3505904952,3791553060,1672656446,1672659142,2696
7693,3755881905,3913251733,1672633419,1672635642,2223
7930,3791594391,3496269445,1672671658,1672672260,602
7905,3770824086,3777936328,1672677087,1672678756,1669
7955,3311065516,3311065516,1672613707,1672614714,1007
7915,3223968713,3716273414,1672540422,1672542188,1766
7969,3777776687,3227457126,1672695807,1672697003,1196
7561,3501198706,3394539273,1672681147,1672683521,2374
7599,3783126683,3979339287,1672643272,1672644912,1640
7593,3918674986,3349613093,1672700287,1672701324,1037
7669,3688418210,3514838220,1672564538,1672566039,1501
7842,3736625083,3534313900,1672591885,1672592891,1006
7849,3338703270,3505201246,1672593733,1672595307,1574
7811,3773429448,3378092448,1672699453,1672702582,3129
7806,3918674986,3430504438,1672681306,1672681369,63
7675,3608633356,3618873142,1672640013,1672641875,1862
7816,3616944364,3481502100,1672649715,1672650221,506
7847,3939952128,3792883665,1672664896,1672664957,61
7873,3520888296,3333896808,1672646462,1672650009,3547
7757,3399052055,3628819436,1672568662,1672569126,464
7948,3311324983,3760077057,1672629154,1672630996,1842
7518,3713894336,3421836608,1672553050,1672556127,3077
7535,3229665776,3416241005,1672561439,1672561910,471
7519,3533810360,3514838220,1672548195,1672548530,335
7823,3494290908,3501730685,1672552090,1672554439,2349
7614,3902383721,3760893269,1672677455,1672680090,2635
7666,3711262377,3711308224,1672595254,1672597743,2489
7981,3501730685,3713894336,1672620575,1672620837,262
7942,3737154119,3714197325,1672539727,1672542731,3004
7800,3244485293,3772578994,1672532301,1672534265,1964
7514,3533137446,3777477395,1672645527,1672647189,1662
7577,3397418363,3774338212,1672588266,1672591100,2834
7771,3885897503,3773978034,1672646168,1672646411,243
7791,3505904952,3516716179,1672645653,1672648475,2822
7593,3756424865,3284639858,1672602062,1672603588,1526
7845,3276993580,3500499542,1672611090,1672613789,2699
7924,3346795719,3483949762,1672620375,1672622472,2097
7848,3409474775,3392121505,1672647931,1672648046,115
7890,3519703355,3791553060,1672588554,1672591312,2758
7506,3511267139,3232962003,1672644644,1672647772,3128
7839,3392121505,3520719611,1672608767,1672610146,1379
7862,3774195321,3429690204,1672627964,1672628560,596
7917,3703718151,3296471982,1672626626,1672628415,1789
7654,3483164654,3509352754,1672618272,1672619332,1060
7748,3344364444,3349613093,1672609022,1672610311,1289
7484,3493507965,3624761861,1672560222,1672562211,1989
7658,3899266183,3770824086,1672540213,1672540470,257
7511,3417587765,3483949762,1672613477,1672616951,3474
7746,3505649239,3411618230,1672584155,1672584942,787
7930,3756930948,3509634629,1672558877,1672559605,728
7698,3904408902,3822654369,1672615696,1672617963,2267
7664,3756601594,3372883226,1672617566,1672618535,969
7884,3520190170,3783429780,1672658126,1672661576,3450
7853,3793871337,3454042520,1672648455,1672651857,3402
7798,3792789881,3516980378,1672657547,1672659509,1962
7674,3417587765,3779976989,1672573099,1672575190,2091
7711,3937224533,3716258994,1672540347,1672540870,523
7729,3855424474,3716168623,1672579558,1672581078,1520
7881,3303705369,3399004969,1672645099,1672647266,2167
7624,3279721246,3667680268,1672588542,1672588988,446
7566,3774556560,3757403279,1672626687,1672629820,3133
7882,3510244400,3430504438,1672636782,1672637163,381
7496,3683766533,3517255726,1672604834,1672608048,3214
7781,3520706195,3979339287,1672568048,1672569556,1508
7727,3514128943,3832902928,1672653585,1672654087,502
7752,3628819436,3552314511,1672691494,1672692004,510
7939,3387966152,3509630174,1672666393,1672669125,2732
7768,3776513891,3811171116,1672655202,1672657547,2345
7802,3407725581,3625274012,1672691082,1672691718,636
7650,3634340855,3232962003,1672694404,1672697278,2874
7891,3914290246,3338367113,1672652934,1672655290,2356
7828,3418534998,3509907947,1672686405,1672688774,2369
7488,3713268590,3505702787,1672600523,1672602014,1491
7754,3383661227,3533280269,1672669495,1672669798,303
7674,3793753089,3703889596,1672626569,1672627714,1145
7625,3666507626,3510771358,1672693642,1672695966,2324
7653,3792789881,3312829208,1672603762,1672604093,331
7801,3417970574,3629547065,1672625009,1672628538,3529
7639,3918584946,3829319703,1672688758,1672689379,621
7878,3311208440,3512540951,1672663733,1672664808,1075
7854,3618045231,3701984666,1672670003,1672670094,91
7945,3826633236,3733189298,1672623708,1672624905,1197
7775,3625274012,3516629436,1672651473,1672654560,3087
7611,3387674757,3234362962,1672586436,1672589339,2903
7717,3793436995,3882291183,1672612415,1672614199,1784
7786,3379589402,3777717988,1672696114,1672696494,380
7514,3792902982,3418728074,1672659652,1672661348,1696
7765,3227457126,3783429780,1672536848,1672537680,832
7717,3344364444,3755436115,1672635672,1672638604,2932
7700,3792473331,3510247121,1672566874,1672569145,2271
7867,3520030713,3516065852,1672637826,1672640808,2982
7672,3291227780,3772359096,1672568242,1672570725,2483
7682,3505869747,3889750851,1672552816,1672553768,952
7668,3202120784,3500391167,1672612980,1672614763,1783
7686,3792902982,3800353779,1672534418,1672534674,256
7941,3511841857,3622054816,1672642757,1672645624,2867
7676,3404058699,3780788622,1672595434,1672596028,594
7761,3903307060,3311761694,1672543260,1672546574,3314
7580,3313541986,3247428249,1672592443,1672595610,3167
7970,3416265063,3772309166,1672655257,1672657813,2556
7504,3736592744,3294803686,1672561501,1672563311,1810
7834,3359239884,3360993964,1672533300,1672535643,2343
7574,3397418363,3711504540,1672549826,1672551484,1658
7730,3483949762,3247428249,1672692735,1672695766,3031
7618,3713630656,3514987389,1672594592,1672596914,2322
7893,3770101921,3512349371,1672607752,1672608273,521
7626,3515860749,3510711755,1672561680,1672562432,752
7831,3510857360,3485375593,1672625859,1672629121,3262
7687,3634786711,3851190615,1672638362,1672640887,2525
7871,3711198793,3711569060,1672587419,1672589165,1746
7695,3505599848,3774793839,1672626128,1672626242,114
7616,3500374658,3500365158,1672633800,1672634751,951
7955,3701184889,3430504438,1672560991,1672564453,3462
7948,3714474557,3400804807,1672623045,1672624144,1099
7541,3520756859,3247428249,1672557177,1672558203,1026
7756,3434642576,3791334389,1672531637,1672532044,407
7904,3221899927,3516011407,1672585040,1672586510,1470
7726,3311274543,3910886626,1672579355,1672581389,2034
7702,3756601594,3534553510,1672693313,1672696007,2694
7946,3916289176,3513080274,1672601267,1672604539,3272
7723,3613995936,3912262917,1672562097,1672562211,114
7590,3607748895,3776800213,1672531626,1672534101,2475
7902,3858918246,3420432297,1672545825,1672548430,2605
7720,3898995675,3793627961,1672680410,1672681469,1059
7596,3451432842,3505098372,1672663926,1672665446,1520
7648,3773429448,3510771358,1672538193,1672540175,1982
7639,3311718847,3490191091,1672592918,1672596471,3553
7968,3711571712,3756623396,1672597781,1672600628,2847
7820,3755587522,3710067113,1672564113,1672566298,2185
7828,3494290908,3916289176,1672623481,1672625521,2040
7605,3515723720,3505145247,1672570757,1672571214,457
7532,3711308224,3500199935,1672664455,1672667672,3217
7494,3701967560,3770553384,1672583534,1672586175,2641
7564,3701498253,3206603608,1672699589,1672700937,1348
7729,3833889105,3922275416,1672601075,1672603220,2145
7977,3713894336,3710067113,1672672456,1672674446,1990
7664,3370752401,3772544062,1672538136,1672539990,1854
7494,3319752091,3757562897,1672626851,1672628516,1665
7940,3701274634,3220716272,1672557613,1672560343,2730
7521,3793871337,3664170666,1672696757,1672700306,3549
7784,3485823740,3533193862,1672687695,1672690273,2578
7589,3715339701,3511125626,1672542176,1672544747,2571
7963,3465202715,3777929708,1672652748,1672653603,855
7553,3416265063,3500458761,1672688236,1672690291,2055
7816,3475258557,3416265063,1672671023,1672671092,69
7698,3773465237,3852391257,1672540137,1672541438,1301
7890,3812176780,3465254146,1672563345,1672563754,409
7961,3826415738,3701498253,1672697363,1672698876,1513
7792,3710098970,3793436995,1672567461,1672570995,3534
7570,3701995648,3772053179,1672561464,1672564507,3043
7783,3774520233,3713268590,1672574388,1672575227,839
7750,3832902928,3513454145,1672691702,1672693341,1639
7730,3885897503,3791334389,1672631132,1672632914,1782
7925,3399535232,3510771358,1672560101,1672563243,3142
7603,3770851318,3443698222,1672604037,1672605912,1875
7580,3899266183,3774520233,1672693846,1672696841,2995
7526,3511687358,3622054816,1672539166,1672540025,859
7925,3399052055,3736592744,1672628495,1672631683,3188
7697,3505203158,3221536550,1672702137,1672704180,2043
7699,3783083229,3932051427,1672672688,1672674384,1696
7816,3297463265,3510594211,1672577253,1672579307,2054
7903,3344364444,3365614305,1672703432,1672703955,523
7739,3510380060,3633420270,1672672962,1672674856,1894
7967,3903307060,3509672210,1672703590,1672706841,3251
7753,3511435497,3396086535,1672631964,1672632622,658
7513,3772746272,3820354437,1672660111,1672660328,217
7494,3886298125,3880310724,1672584450,1672585756,1306
7936,3475795792,3505973226,1672598764,1672600555,1791
7959,3777443199,3621810464,1672645160,1672646524,1364
7521,3476232529,3500177712,1672677750,1672680840,3090
7553,3791115967,3236102733,1672703941,1672707152,3211
7766,3518260334,3883861463,1672559685,1672560873,1188
7521,3901990690,3901877072,1672586578,1672588859,2281
7755,3614238812,3757455053,1672663986,1672664461,475
7677,3500365158,3500365158,1672531956,1672534301,2345
7913,3505145247,3477375368,1672684207,1672684730,523
7496,3391915886,3774366875,1672601827,1672604185,2358
7597,3505904952,3201324715,1672679026,1672680204,1178
7529,3780365428,3730517636,1672640818,1672642513,1695
7571,3534553510,3617055293,1672571746,1672572283,537
7931,3367902229,3284832486,1672546837,1672547022,185
7784,3606987130,3424922204,1672617129,1672619094,1965
7664,3939952128,3792902982,1672683435,1672683591,156
7792,3778549126,3772578994,1672639213,1672640047,834
7945,3621497531,3279721246,1672559687,1672561203,1516
7798,3518496488,3296471982,1672584376,1672586284,1908
7758,3271938399,3607178184,1672664936,1672666841,1905
7849,3516223597,3315583351,1672657729,1672657994,265
7563,3505649239,3755511676,1672693036,1672693591,555
7810,3755392666,3277669002,1672662533,1672664716,2183
7504,3774339795,3516465662,1672679769,1672680576,807
7547,3307097200,3778266283,1672637192,1672638913,1721
7542,3488244966,3512217942,1672612640,1672614907,2267
7849,3778266283,3519601612,1672700395,1672702924,2529
7872,3439023335,3533827120,1672657624,1672658360,736
7687,3224716315,3301107849,1672561155,1672563119,1964
7962,3976633198,3356860407,1672666220,1672669549,3329
7530,3601879040,3520751702,1672582075,1672584744,2669
7746,3505873261,3755436115,1672604484,1672604974,490
7864,3428674539,3880285638,1672667913,1672671234,3321
7962,3921211276,3515125508,1672679891,1672681954,2063
7803,3917278625,3315583351,1672697963,1672699832,1869
7846,3701534009,3227457126,1672548973,1672549272,299
7983,3774050956,3420432297,1672579557,1672582502,2945
7589,3662180254,3915628728,1672702508,1672705466,2958
7589,3629935998,3701898991,1672639687,1672641796,2109
7821,3510857360,3285400528,1672532339,1672535115,2776
7821,3500060260,3518408774,1672677828,1672680022,2194
7841,3534492426,3805292782,1672680915,1672684408,3493
7969,3399433690,3358871377,1672551715,1672552593,878
7816,3379589402,3792902982,1672572473,1672572664,191
7957,3234362962,3510857360,1672685512,1672688166,2654
7576,3714504419,3777477395,1672612676,1672613335,659
7924,3777717988,3703441914,1672694416,1672696894,2478
7884,3510703546,3511198618,1672650986,1672652794,1808
7521,3812176780,3621497531,1672534653,1672537802,3149
7909,3232962003,3396285984,1672680964,1672683487,2523
7909,3312333615,3621810464,1672683662,1672683841,179
7586,3505203158,3352603894,1672614184,1672617040,2856
7786,3937224533,3550946908,1672576017,1672579046,3029
7720,3778980116,3515723720,1672605040,1672608460,3420
7912,3466229085,3518014636,1672557522,1672558608,1086
7904,3779629905,3421836608,1672579568,1672580445,877
7717,3715127362,3778780511,1672663712,1672665505,1793
7570,3394539273,3791957752,1672603789,1672604028,239
7822,3666553782,3516606733,1672548208,1672550641,2433
7785,3518408774,3757455053,1672585389,1672586624,1235
7804,3899204805,3206603608,1672544506,1672545270,764
7667,3505973226,3715581279,1672631798,1672635088,3290
7945,3466229085,3339907603,1672610482,1672613860,3378
7485,3608633356,3777929708,1672640071,1672642528,2457
7729,3772359096,3610695419,1672579822,1672580161,339
7557,3777717988,3412980697,1672556015,1672556961,946
7779,3891751546,3429690204,1672577211,1672577561,350
7676,3505791599,3520709480,1672564246,1672565503,1257
7602,3484995752,3808324264,1672608078,1672610915,2837
7574,3357483218,3792288302,1672613359,1672616927,3568
7566,3757403279,3511170269,1672616992,1672617146,154
7792,3318697153,3271938399,1672620708,1672623818,3110
7841,3734496778,3312829208,1672617658,1672618860,1202
7706,3510857360,3339907603,1672668993,1672670943,1950
7805,3778549126,3791901535,1672542458,1672544614,2156
7761,3777514571,3774580701,1672584529,1672586320,1791
7913,3711198793,3318697153,1672607842,1672608607,765
7593,3337544549,3399535232,1672684256,1672684930,674
7688,3776513891,3434642576,1672686646,1672688183,1537
7558,3396285984,3516629436,1672602181,1672602754,573
7585,3736625083,3296471982,1672629778,1672631991,2213
7699,3922275416,3311845971,1672605378,1672605804,426
7834,3777790718,3976633198,1672671885,1672674478,2593
7863,3384951177,3836573197,1672621309,1672623935,2626
7546,3756021689,3467773920,1672669948,1672670307,359
7922,3222521619,3621810464,1672606516,1672609533,3017
7594,3519803045,3713268590,1672684789,1672687535,2746
7701,3755943611,3703661585,1672601294,1672602840,1546
7672,3792668962,3922337974,1672650092,1672650564,472
7558,3978115672,3770824086,1672573664,1672576384,2720
7628,3778780511,3512969370,1672615201,1672616837,1636
7573,3829319703,3520931254,1672595034,1672596214,1180
7713,3852391257,3473765852,1672623575,1672626553,2978
7959,3777623166,3500199935,1672621342,1672624889,3547
7577,3338367113,3809916577,1672703186,1672705393,2207
7648,3756424865,3505173328,1672698051,1672698991,940
7922,3378092448,3510857360,1672695239,1672696717,1478
7563,3517509185,3222448362,1672689074,1672692196,3122
7641,3756930948,3516011407,1672604862,1672608308,3446
7893,3736592744,3420432297,1672614389,1672616636,2247
7705,3500458761,3517509185,1672625681,1672626072,391
7609,3477375368,3791020967,1672531722,1672534371,2649
7522,3901877072,3783245561,1672618486,1672620578,2092
7667,3311439795,3512166013,1672623297,1672626239,2942
7760,3610348516,3760267716,1672663802,1672665144,1342
7885,3793871337,3667680268,1672700447,1672701510,1063
7982,3311627628,3734828619,1672637403,1672639540,2137
7917,3337544549,3716900301,1672624172,1672626207,2035
7484,3336751428,3710067113,1672676020,1672678620,2600
7744,3394330287,3733189298,1672565208,1672566423,1215
7663,3443698222,3774005526,1672623580,1672627035,3455
7675,3917278625,3277605882,1672571168,1672571903,735
7546,3293695955,3772746272,1672701248,1672703105,1857
7702,3774005526,3774366875,1672658625,1672661676,3051
7792,3792473331,3482405588,1672602418,1672604850,2432
7673,3303751772,3505791599,1672534868,1672535837,969
7693,3235635976,3416427576,1672654559,1672657957,3398
7696,3664517356,3388637594,1672580206,1672583044,2838
7929,3715339701,3627937312,1672553478,1672556894,3416
7897,3248507722,3711571712,1672599271,1672602122,2851
7579,3760294205,3858918246,1672550755,1672553353,2598
7766,3490191091,3626156564,1672675127,1672678304,3177
7881,3378686918,3511862351,1672563095,1672565271,2176
7970,3737154119,3344019610,1672555387,1672556750,1363
7960,3247815299,3827377568,1672687593,1672688215,622
7801,3778980116,3604539807,1672679625,1672682614,2989
7777,3895562476,3701065786,1672605867,1672607034,1167
7704,3774338212,3511163800,1672668429,1672671518,3089
7485,3611150562,3715974031,1672595922,1672598259,2337
7979,3925620998,3515394721,1672627202,1672629329,2127
7683,3247428249,3520376528,1672627750,1672627967,217
7798,3757447189,3783925755,1672606382,1672609167,2785
7793,3513080274,3910454786,1672613729,1672616908,3179
7705,3409474775,3314836094,1672647986,1672650963,2977
7592,3883551721,3713969578,1672538857,1672539747,890
7832,3889750851,3933210486,1672565783,1672567828,2045
7951,3772309150,3229665776,1672609587,1672613007,3420
7790,3509672210,3792473331,1672655792,1672658704,2912
7815,3384951177,3772337814,1672563869,1672565705,1836
7612,3430504438,3972709319,1672580250,1672581376,1126
7568,3605726278,3520888296,1672662876,1672663205,329
7717,3715581279,3791334389,1672675702,1672678469,2767
7747,3809916577,3271938399,1672586257,1672587725,1468
7927,3777079686,3714962248,1672621709,1672623883,2174
7853,3852595551,3221899927,1672556893,1672560051,3158
7683,3344019610,3352603894,1672653344,1672656075,2731
7652,3772642849,3634786711,1672567298,1672570602,3304
7856,3515723720,3778341199,1672670145,1672672950,2805
7543,3776066388,3829319703,1672695100,1672697914,2814
7762,3515151980,3770635361,1672670570,1672670654,84
7768,3509907947,3783239924,1672623596,1672625589,1993
7744,3509672210,3779629905,1672655102,1672655175,73
7626,3624312512,3520030713,1672695712,1672698837,3125
7800,3519601612,3793627961,1672617843,1672619436,1593
7573,3311845971,3505635228,1672695779,1672696456,677
7811,3760077057,3475258557,1672602862,1672605810,2948
7501,3311603601,3624761861,1672647545,1672649004,1459
7774,3777790718,3774556560,1672674866,1672677895,3029
7706,3492478793,3505203158,1672655814,1672657853,2039
7549,3377766165,3626156564,1672639457,1672642110,2653
7543,3714821932,3800886801,1672640633,1672641014,381
7864,3757246925,3811694763,1672597876,1672600039,2163
7558,3509604974,3520756859,1672672085,1672674016,1931
7555,3713644518,3466229085,1672576419,1672576652,233
7804,3716165213,3685187183,1672639300,1672640322,1022
7530,3459030804,3772578994,1672674549,1672675291,742
7954,3476232529,3443698222,1672634293,1672634394,101
7671,3360993964,3420700674,1672632038,1672634750,2712
7539,3756528686,3500391167,1672568611,1672571946,3335
7686,3816454165,3889232789,1672676533,1672678126,1593
7942,3554917400,3976390453,1672634263,1672636474,2211
7483,3829232696,3312333615,1672580266,1672582443,2177
7874,3757812939,3714474557,1672673767,1672677010,3243
7927,3783531004,3291227780,1672665195,1672667466,2271
7952,3311154569,3783245561,1672589785,1672592736,2951
7855,3793959750,3511125626,1672540537,1672542352,1815
7529,3505638204,3805519285,1672585965,1672586117,152
7588,3760893269,3446948848,1672688685,1672691139,2454
7578,3417587765,3519700826,1672549670,1672549834,164
7583,3234362962,3287105466,1672593330,1672593515,185
7868,3881477378,3760492950,1672534988,1672538109,3121
7629,3757161914,3935127663,1672565192,1672566102,910
7499,3703955926,3715974031,1672590006,1672592186,2180
7665,3396086535,3826633236,1672571222,1672571616,394
7588,3505791599,3793871337,1672648452,1672651174,2722
7810,3244485293,3608868877,1672698026,1672701010,2984
7645,3776338577,3339907603,1672664344,1672666888,2544
7829,3773429448,3388286531,1672702220,1672703687,1467
7663,3601879040,3432689543,1672629141,1672632301,3160
7898,3533748232,3426325549,1672581872,1672582467,595
7954,3209027249,3756930948,1672620366,1672620868,502
7827,3774501422,3505477652,1672546218,1672547656,1438
7543,3779528381,3757562897,1672631073,1672634004,2931
7928,3520709480,3711198793,1672622092,1672622787,695
7930,3439023335,3439023335,1672613822,1672616487,2665
7885,3512683609,3833889105,1672562516,1672564260,1744
7955,3534729133,3458539365,1672621674,1672621776,102
7890,3629935998,3515860749,1672670162,1672672737,2575
7967,3500365158,3200691026,1672534739,1672537343,2604
7879,3904775198,3501483568,1672554246,1672554673,427
7788,3714197325,3501364586,1672535582,1672535948,366
7858,3716197887,3901877072,1672599228,1672602137,2909
7639,3316173088,3716488385,1672644064,1672644994,930
7651,3383922351,3331845324,1672550750,1672551391,641
7636,3755436115,3518791447,1672665066,1672667571,2505
7622,3533927138,3756021689,1672643591,1672646099,2508
7943,3783779671,3500066230,1672690979,1672692259,1280
7532,3388372715,3835382117,1672541647,1672543687,2040
7727,3613995936,3660493209,1672629694,1672629760,66
7901,3515691540,3855424474,1672665470,1672666382,912
7654,3716900301,3483164654,1672570157,1672571977,1820
7587,3976633198,3518496488,1672552316,1672553884,1568
7882,3777477395,3396086535,1672632085,1672633895,1810
7588,3776800213,3903962771,1672591405,1672593949,2544
7675,3737051610,3774501422,1672629702,1672629791,89
7530,3976390453,3774204963,1672682449,1672685508,3059
7572,3829232696,3344019610,1672644270,1672646754,2484
7968,3471220483,3517721725,1672612322,1672615414,3092
7525,3473562469,3701984666,1672655521,1672658011,2490
7659,3365830990,3513164386,1672623821,1672624857,1036
7686,3716197887,3819727225,1672658795,1672659681,886
7982,3421836608,3405494240,1672623075,1672625587,2512
7765,3359239884,3505973226,1672617459,1672618548,1089
7936,3466911760,3293695955,1672564635,1672566150,1515
7606,3688683847,3509773875,1672683183,1672683368,185
7894,3826760240,3418728074,1672585121,1672587134,2013
7522,3319752091,3517509185,1672617509,1672618508,999
7496,3683959482,3615046771,1672638417,1672641550,3133
7939,3555214688,3783206719,1672637376,1672640380,3004
7943,3772642849,3826760240,1672702067,1672704139,2072
7798,3885897503,3384951177,1672610133,1672611056,923
7805,3221899927,3360743849,1672571512,1672573079,1567
7915,3533927138,3715492942,1672630546,1672631229,683
7891,3733891182,3918056059,1672588854,1672589272,418
7745,3550946908,3734496778,1672536025,1672537055,1030
7849,3910454786,3816454165,1672669867,1672672912,3045
7782,3774268456,3777514571,1672689827,1672691672,1845
7896,3756930948,3288764520,1672583309,1672585857,2548
7623,3427283336,3206254161,1672693532,1672696701,3169
7873,3519654779,3338703270,1672616596,1672617447,851
7855,3780365428,3778108318,1672571578,1672573550,1972
7631,3701178711,3777623166,1672685029,1672685458,429
7793,3501198706,3714504419,1672570068,1672571366,1298
7941,3979339287,3519912874,1672541561,1672544050,2489
7967,3811694763,3779976989,1672668870,1672669236,366
7743,3534492426,3489728806,1672637595,1672640288,2693
7578,3520751702,3624312512,1672619504,1672621367,1863
7774,3379256399,3701995648,1672597676,1672598711,1035
7737,3287105466,3903962771,1672592184,1672592276,92
7634,3732481297,3404058699,1672630943,1672633279,2336
7679,3822654369,3373384732,1672665000,1672668183,3183
7548,3291227780,3829319703,1672647354,1672649915,2561
7649,3520190170,3516016437,1672627544,1672629048,1504
7833,3793389510,3513164386,1672594218,1672597747,3529
7649,3716746253,3805292782,1672615763,1672617121,1358
7618,3378686918,3534010629,1672698077,1672699673,1596
7864,3466911760,3757682496,1672575099,1672576926,1827
7910,3409474775,3715492942,1672562724,1672563182,458
7748,3832902928,3505883609,1672534489,1672537018,2529
7696,3713370078,3774066725,1672573022,1672573372,350
7583,3276640712,3791553060,1672626188,1672629715,3527
7672,3777776687,3294803686,1672660033,1672663110,3077
7593,3466911760,3206593906,1672534537,1672537344,2807
7605,3910454786,3520888296,1672540686,1672542968,2282
7810,3791115967,3388637594,1672536502,1672539719,3217
7929,3454042520,3772884106,1672553185,1672556155,2970
7572,3780294829,3505347134,1672699482,1672702543,3061
7611,3668898102,3475251781,1672567410,1672568159,749
7539,3421836608,3607178184,1672605003,1672607124,2121
7617,3714962248,3493507965,1672534340,1672536778,2438
7532,3302626661,3773429448,1672591421,1672591563,142
7881,3713894336,3714474557,1672554405,1672556597,2192
7760,3481647420,3755872268,1672646187,1672648121,1934
7534,3311627628,3755739653,1672534716,1672537873,3157
7794,3701995648,3629935998,1672631221,1672633093,1872
7785,3420432297,3637008488,1672532010,1672535162,3152
7943,3711262377,3793962300,1672581902,1672583646,1744
7832,3291227780,3890149705,1672532830,1672536037,3207
7940,3774520233,3500904641,1672607691,1672610471,2780
7744,3832902928,3417587765,1672677076,1672678625,1549
7916,3534191820,3772337814,1672654052,1672656985,2933
7499,3739106581,3774580701,1672531281,1672534004,2723
7659,3556951786,3736786443,1672661939,1672663874,1935
7582,3829764737,3776338577,1672603588,1672606429,2841
7961,3351008918,3774466457,1672596087,1672597468,1381
7655,3378686918,3200198928,1672616649,1672619585,2936
7788,3756462516,3778780511,1672598520,1672599147,627
7640,3858918246,3935627557,1672583109,1672584282,1173
7977,3311871871,3533653428,1672560148,1672561957,1809
7824,3359239884,3338703270,1672557969,1672558244,275
7557,3364543015,3289061738,1672622132,1672622385,253
7905,3737154119,3912262917,1672677626,1672679870,2244
7798,3399535232,3809484172,1672656807,1672659384,2577
7617,3774119563,3780609808,1672699712,1672701707,1995
7704,3307512479,3855000166,1672658927,1672662487,3560
7600,3307097200,3715189301,1672580343,1672582696,2353
7931,3703789494,3488244966,1672599955,1672601026,1071
7838,3711308224,3855937514,1672612396,1672612527,131
7650,3501486692,3608633356,1672633693,1672635438,1745
7912,3756528686,3517509185,1672619145,1672620842,1697
7727,3933210486,3837094550,1672581248,1672584431,3183
7741,3287105466,3200691026,1672571832,1672573721,1889
7898,3465202715,3887270940,1672677725,1672681047,3322
7970,3514128943,3902278226,1672615992,1672616611,619
7726,3616944364,3298288268,1672683828,1672684934,1106
7634,3855602893,3428674539,1672566211,1672568960,2749
7720,3488244966,3432689543,1672571435,1672574378,2943
7908,3227457126,3772544062,1672627553,1672628061,508
7889,3511350608,3533193862,1672670104,1672670959,855
7739,3882997884,3501601840,1672579596,1672581160,1564
7706,3472130842,3978115672,1672695694,1672697302,1608
7617,3387966152,3301107849,1672615837,1672618962,3125
7524,3405494240,3613995936,1672672938,1672674705,1767
7485,3772309150,3520376528,1672696938,1672699622,2684
7651,3378092448,3711262377,1672563247,1672564639,1392
7679,3756453423,3827377568,1672572468,1672575247,2779
7534,3505477652,3715998609,1672699399,1672700244,845
7853,3629547065,3556951786,1672688975,1672689462,487
7852,3511198618,3683959482,1672596818,1672599756,2938
7591,3760267716,3467773920,1672601843,1672602812,969
7781,3783239924,3777120536,1672642057,1672645125,3068
7955,3519428855,3779740455,1672652723,1672654069,1346
7548,3519912874,3812176780,1672697301,1672698057,756
7868,3518876135,3505530961,1672568522,1672570359,1837
7907,3899204805,3471220483,1672676899,1672680336,3437
7704,3202120784,3415443558,1672662395,1672664877,2482
7866,3772544062,3236102733,1672581227,1672584789,3562
7865,3714488548,3701691675,1672640950,1672643947,2997
7878,3755943611,3937224533,1672678420,1672679896,1476
7610,3614238812,3829764737,1672599985,1672600355,370
7525,3736625083,3517509185,1672644133,1672647558,3425
7617,3222521619,3808324264,1672676134,1672677367,1233
7746,3662180254,3801089989,1672677507,1672678791,1284
7728,3924549929,3379256399,1672671217,1672671425,208
7509,3827377568,3777717988,1672649169,1672649659,490
7890,3783083229,3756021689,1672672561,1672672711,150
7850,3772309150,3791553060,1672671688,1672674406,2718
7911,3554917400,3505883609,1672546053,1672546864,811
7566,3234362962,3391915121,1672638058,1672641331,3273
7683,3286658957,3772746272,1672586658,1672589902,3244
7546,3716843669,3388286531,1672696881,1672698221,1340
7568,3394539273,3367902229,1672540385,1672543116,2731
7494,3918247820,3220716272,1672574595,1672577710,3115
7762,3624312512,3912262917,1672650863,1672653798,2935
7542,3834257412,3500391167,1672584845,1672585422,577
7880,3399535232,3713630656,1672696608,1672697348,740
7897,3774366875,3770851318,1672578021,1672581165,3144
7936,3520165601,3505973226,1672703282,1672706692,3410
7772,3715189301,3533280269,1672577394,1672578116,722
7919,3311090974,3519563836,1672553861,1672555339,1478
7562,3500658339,3756451663,1672697786,1672699973,2187
7544,3634340855,3668005723,1672580808,1672582491,1683
7914,3496051529,3773664987,1672572601,1672574969,2368
7741,3514472925,3779740455,1672646429,1672649563,3134
7939,3937224533,3294803686,1672618227,1672619117,890
7560,3228165483,3533385867,1672606612,1672608284,1672
7914,3372883226,3791874383,1672611054,1672611509,455
7556,3624312512,3505477652,1672645133,1672648392,3259
7722,3303751772,3379256399,1672658613,1672659788,1175
7569,3703718151,3399433690,1672590734,1672592613,1879
7977,3731106822,3756930948,1672697869,1672698882,1013
7801,3418534998,3505791599,1672622723,1672622812,89
7599,3518791447,3777983879,1672559044,1672561374,2330
7621,3711571712,3780914982,1672585063,1672587051,1988
7880,3202120784,3227158514,1672594874,1672596602,1728
7610,3383922351,3713969578,1672656392,1672658760,2368
7891,3770635361,3772309150,1672657256,1672660610,3354
7667,3404384505,3703735129,1672535515,1672537806,2291
7976,3501955238,3837094550,1672617268,1672619741,2473
7851,3318697153,3360506772,1672670976,1672674228,3252
7801,3668005723,3291227780,1672673732,1672675787,2055
7642,3374559242,3407954858,1672635954,1672636572,618
7725,3500177712,3361230905,1672596541,1672597289,748
7861,3516065852,3615046771,1672679823,1672680658,835
7683,3777079686,3356860407,1672636963,1672639663,2700
7762,3716900301,3886298125,1672581481,1672583876,2395
7678,3715998609,3454042520,1672563298,1672563543,245
7874,3757447189,3773978034,1672536672,1672537691,1019
7889,3501483568,3777936328,1672554752,1672555227,475
7811,3311845971,3898995675,1672671558,1672674963,3405
7977,3501606184,3937224533,1672637500,1672638755,1255
7530,3617734118,3783509527,1672565431,1672566306,875
7487,3774045700,3757447189,1672674658,1672674758,100
7777,3399911573,3505135325,1672535613,1672538379,2766
7872,3227158514,3518932404,1672631609,1672633345,1736
7954,3616944364,3509907947,1672660220,1672663028,2808
7597,3505635228,3732481297,1672646357,1672649413,3056
7752,3400804807,3774338212,1672691746,1672695235,3489
7595,3379589402,3883042241,1672671303,1672671644,341
7524,3621810464,3500458761,1672656858,1672658974,2116
7961,3774005526,3629547065,1672660145,1672662238,2093
7575,3776800213,3791997875,1672650327,1672650823,496
7763,3402943525,3783429780,1672617005,1672617226,221
7622,3882242815,3926700506,1672645911,1672649100,3189
7845,3201324715,3510969660,1672534602,1672536935,2333
7638,3917088658,3813052709,1672536046,1672539634,3588
7696,3430352815,3710569131,1672544327,1672547384,3057
7752,3711504540,3228165483,1672624064,1672624901,837
7894,3887270940,3316222192,1672662498,1672663206,708
7755,3509453566,3902383721,1672565021,1672566110,1089
7870,3793286136,3666457294,1672652822,1672653865,1043
7614,3416427576,3793436995,1672631368,1672632984,1616
7522,3732481297,3505292701,1672575822,1672577911,2089
7940,3713644518,3518360734,1672686811,1672689665,2854
7548,3284832486,3755920131,1672680959,1672682684,1725
7494,3379256399,3930791338,1672575607,1672577261,1654
7738,3201848640,3222448362,1672677766,1672678142,376
7849,3629935998,3510247121,1672555168,1672555307,139
7564,3519601612,3448855696,1672640258,1672641533,1275
7789,3505599848,3713208927,1672664201,1672666601,2400
7514,3534492426,3505135325,1672647554,1672649856,2302
7522,3783196518,3716165213,1672642523,1672644326,1803
7671,3229058858,3311274543,1672537309,1672540233,2924
7812,3757161914,3466229085,1672540168,1672540744,576
7626,3792789881,3271938399,1672592202,1672595668,3466
7564,3774466457,3388372715,1672584981,1672586320,1339
7838,3732481297,3352603894,1672626008,1672628933,2925
7504,3853018906,3505362057,1672635387,1672638245,2858
7750,3500177712,3779528381,1672675063,1672676337,1274
7853,3389115045,3209551760,1672701417,1672703456,2039
7893,3616944364,3760509236,1672656724,1672659589,2865
7895,3365942576,3793848402,1672662522,1672665320,2798
7865,3792384220,3664170666,1672586509,1672589008,2499
7652,3433804879,3481647420,1672681714,1672684880,3166
7575,3921211276,3773598056,1672629971,1672631933,1962
7853,3294803686,3512166013,1672697968,1672698895,927
7857,3505477652,3774339795,1672549433,1672550219,786
7517,3792288302,3756623396,1672667238,1672667738,500
7683,3610348516,3513080274,1672598345,1672599616,1271
7740,3336751428,3478194807,1672599449,1672602710,3261
7941,3505145247,3911159965,1672571409,1672572377,968
7618,3606186086,3501606184,1672612727,1672614647,1920
7651,3703275621,3736229191,1672624940,1672628286,3346
7804,3234541252,3739106581,1672648816,1672649493,677
7929,3348261553,3778266283,1672548499,1672549204,705
7919,3903009525,3369998498,1672544918,1672546866,1948
7483,3770553384,3428964059,1672608612,1672609172,560
7551,3918674986,3736419952,1672531839,1672532398,559
7763,3734828619,3313541986,1672629806,1672632287,2481
7529,3432665384,3915628728,1672671132,1672672422,1290
7784,3713786889,3701898991,1672549296,1672551944,2648
7968,3839849341,3815508790,1672600265,1672602113,1848
7950,3757161914,3518014404,1672634342,1672634885,543
7665,3703871468,3244436890,1672600081,1672602544,2463
7819,3559110998,3518360734,1672567205,1672569474,2269
7799,3228165483,3756424865,1672662304,1672662549,245
7901,3500391167,3772758337,1672625034,1672626550,1516
7572,3833889105,3716488385,1672663018,1672665901,2883
7675,3819727225,3917088658,1672607457,1672608781,1324
7646,3822654369,3829232696,1672555944,1672557768,1824
7783,3901990690,3737154119,1672682910,1672684395,1485
7907,3304056063,3511841857,1672562386,1672563215,829
7484,3362000049,3770635361,1672628613,1672628942,329
7767,3520730271,3428674539,1672552776,1672555687,2911
7587,3412825109,3473765852,1672621950,1672622725,775
7664,3505859863,3800886801,1672564425,1672564923,498
7631,3883085535,3512217942,1672601975,1672605272,3297
7485,3774127586,3379256399,1672581235,1672584170,2935
7850,3823600322,3773205565,1672636163,1672636690,527
7551,3332072298,3510594211,1672596084,1672599218,3134
7645,3735733948,3304625412,1672587202,1672590271,3069
7814,3733189298,3377766165,1672650412,1672653522,3110
7952,3608868877,3496549058,1672637137,1672637942,805
7613,3390068992,3388372715,1672547499,1672548279,780
7779,3432689543,3899266183,1672605094,1672606275,1181
7713,3519601612,3518360734,1672661276,1672663188,1912
7487,3731419510,3852595551,1672647857,1672649545,1688
7661,3427219654,3465254146,1672571379,1672573405,2026
7874,3889750851,3633420270,1672627968,1672630371,2403
7930,3247815299,3910454786,1672586004,1672589405,3401
7542,3606812411,3501606184,1672601775,1672604876,3101
7962,3791553060,3791942683,1672608911,1672609781,870
7930,3731106822,3773664987,1672654943,1672655848,905
7917,3760077057,3500391167,1672540671,1672541816,1145
7671,3772642849,3610695419,1672606423,1672610014,3591
7699,3757447189,3774005526,1672647094,1672649432,2338
7656,3411618230,3208844525,1672622666,1672623589,923
7835,3518876135,3304056063,1672586887,1672590420,3533
7550,3552314511,3319752091,1672655296,1672656909,1613
7724,3505873261,3311993075,1672687334,1672688329,995
7689,3839849341,3604539807,1672660594,1672663451,2857
7794,3221899927,3755587522,1672667996,1672668265,269
7508,3509604974,3534492426,1672605814,1672607530,1716
7697,3509773875,3429690204,1672672138,1672675496,3358
7856,3715581279,3533193862,1672531391,1672532793,1402
7930,3779528381,3734737881,1672580993,1672582239,1246
7905,3297463265,3774556560,1672602266,1672602789,523
7831,3772578994,3809484172,1672617303,1672620667,3364
7516,3360743849,3421836608,1672635888,1672636670,782
7728,3364543015,3757151210,1672634745,1672637165,2420
7963,3809059934,3918247820,1672686225,1672688875,2650
7950,3701534009,3756424865,1672636021,1672636546,525
7858,3500578848,3505599848,1672661941,1672664001,2060
7507,3520888296,3918584946,1672634227,1672635388,1161
7499,3311627628,3555214688,1672545803,1672546103,300
7689,3610348516,3909606423,1672672858,1672673817,959
7703,3711308224,3805519285,1672551568,1672553747,2179
7533,3682061100,3519563836,1672650495,1672653997,3502
7969,3513599775,3244436890,1672583638,1672586296,2658
7707,3716197887,3779976989,1672648500,1672651523,3023
7521,3931941795,3703871468,1672681322,1672681577,255
7854,3481647420,3931941795,1672605411,1672608655,3244
7609,3311090974,3772758337,1672559477,1672559636,159
7712,3773950140,3760492950,1672642520,1672643020,500
7962,3760183458,3827222533,1672591055,1672591972,917
7545,3793627961,3312829208,1672594416,1672595476,1060
7617,3792032359,3505000737,1672619173,1672622249,3076
7901,3505193212,3311415018,1672627251,1672627833,582
7779,3209383861,3432689543,1672616423,1672616769,346
7927,3509604974,3520190170,1672653994,1672656602,2608
7526,3772544062,3246596716,1672615242,1672618224,2982
7500,3779976989,3337544549,1672581051,1672582712,1661
7765,3791657947,3301107849,1672533221,1672534375,1154
7493,3757455053,3730517636,1672637454,1672638868,1414
7807,3780365428,3344364444,1672578943,1672579457,514
7710,3774580701,3505791599,1672556207,1672557716,1509
7859,3778341199,3428674539,1672573654,1672575425,1771
7559,3513599775,3509933351,1672653150,1672655094,1944
7725,3793848402,3362000049,1672675187,1672676332,1145
7935,3516514391,3533369198,1672608122,1672609432,1310
7907,3520719611,3812176780,1672551725,1672553539,1814
7612,3380035798,3716835696,1672548628,1672551524,2896
7535,3518260334,3888559320,1672604662,1672605183,521
7940,3516016437,3711569060,1672590631,1672593542,2911
7978,3227158514,3975287541,1672626152,1672628818,2666
7684,3783196518,3972709319,1672643286,1672646022,2736
7850,3809916577,3817621391,1672547042,1672550630,3588
7878,3384240055,3701863557,1672674559,1672677631,3072
7746,3227158514,3716746253,1672538089,1672541033,2944
7694,3812176780,3682061100,1672615325,1672616641,1316
7686,3777776687,3386707783,1672574977,1672577874,2897
7770,3276640712,3475795792,1672629617,1672629867,250
7509,3911245524,3777120536,1672703891,1672705355,1464
7524,3859525941,3770635361,1672649826,1672650825,999
7670,3518876135,3496549058,1672625370,1672626457,1087
7735,3493507965,3505599848,1672592708,1672594040,1332
7740,3978105277,3533280269,1672581449,1672584464,3015
7655,3517509185,3520931254,1672684709,1672686732,2023
7957,3917278625,3756966035,1672626777,1672628338,1561
7755,3514245078,3715339701,1672599289,1672599950,661
7752,3805347939,3904775198,1672696353,1672697886,1533
7811,3518260334,3201432789,1672556505,1672557925,1420
7520,3505173328,3334033993,1672589130,1672590346,1216
7563,3520931254,3473765852,1672623946,1672625915,1969
7844,3738274418,3610348516,1672559915,1672563302,3387
7619,3427283336,3804870229,1672542215,1672545811,3596
7586,3701178711,3434642576,1672629608,1672632008,2400
7579,3286658957,3533371364,1672602169,1672602848,679
7703,3755798867,3511687358,1672639129,1672640836,1707
7752,3912536808,3500658339,1672686000,1672689108,3108
7564,3396086535,3287105466,1672645091,1672647210,2119
7755,3859525941,3362000049,1672667824,1672668818,994
7577,3882291183,3826760240,1672542552,1672544106,1554
7502,3318697153,3490191091,1672668929,1672669264,335
7558,3774501422,3711504540,1672697609,1672699383,1774
7924,3755587522,3552314511,1672574041,1672576034,1993
7609,3715127362,3776948966,1672550172,1672551901,1729
7533,3311324983,3533827120,1672635423,1672638358,2935
7521,3826760240,3511841857,1672701567,1672702652,1085
7720,3770824086,3415443558,1672590470,1672592088,1618
7753,3517476351,3899204805,1672542088,1672544692,2604
7912,3249791738,3774338212,1672668677,1672669177,500
7978,3514472925,3519700826,1672602531,1672605410,2879
7792,3815508790,3736592744,1672533393,1672536432,3039
7559,3777983879,3505477652,1672611291,1672614064,2773
7897,3485375593,3701274634,1672629020,1672630834,1814
7967,3817621391,3232962003,1672556845,1672557557,712
7844,3772642849,3714821932,1672585686,1672589069,3383
7748,3348261553,3778266283,1672648380,1672649618,1238
7778,3516011407,3792288302,1672684308,1672684908,600
7773,3392121505,3400918687,1672592974,1672595325,2351
7903,3618873142,3372883226,1672572695,1672574900,2205
7668,3903009525,3783206719,1672639005,1672641199,2194
7844,3910886626,3467773920,1672659981,1672663325,3344
7955,3757562897,3793470489,1672559137,1672559755,618
7644,3666457294,3501184421,1672537052,1672538729,1677
7552,3298433163,3448855696,1672631361,1672632172,811
7884,3605726278,3311090974,1672698018,1672699876,1858
7713,3235287260,3773429448,1672537253,1672538414,1161
7548,3715339701,3284832486,1672554419,1672557063,2644
7541,3390068992,3883551721,1672649486,1672651113,1627
7964,3685187183,3501927421,1672588154,1672590550,2396
7936,3662180254,3756021689,1672583537,1672585461,1924
7918,3407725581,3716746253,1672623669,1672624773,1104
7569,3793086311,3373384732,1672695111,1672697181,2070
7876,3517077106,3471220483,1672680672,1672682885,2213
7814,3417061462,3339907603,1672687216,1672687633,417
7634,3520206212,3793962300,1672603959,1672606186,2227
7961,3399433690,3516606733,1672629401,1672632625,3224
7877,3520190170,3424922204,1672691231,1672692320,1089
7563,3367029997,3505201246,1672575549,1672577428,1879
7792,3510244400,3973560347,1672561988,1672563398,1410
7954,3756027749,3500365158,1672604027,1672604136,109
7568,3314836094,3487171044,1672684901,1672687539,2638
7944,3772758337,3791594391,1672575112,1672575672,560
7666,3374559242,3774501422,1672700471,1672700769,298
7780,3933210486,3509773875,1672533644,1672534335,691
7843,3515394721,3510703546,1672532782,1672535640,2858
7832,3511862351,3520190170,1672573081,1672575059,1978
7769,3918247820,3701111745,1672552225,1672555540,3315
7770,3365942576,3770635361,1672618520,1672622027,3507
7713,3404058699,3358871377,1672615979,1672619408,3429
7834,3756027749,3715974031,1672617368,1672620968,3600
7778,3533193862,3713268590,1672628067,1672631534,3467
7757,3770447408,3512349371,1672556572,1672559619,3047
7530,3510857360,3916289176,1672576441,1672578372,1931
7877,3855424474,3517963492,1672581284,1672581507,223
7605,3312664885,3311871871,1672640551,1672642405,1854
7723,3516606733,3512969370,1672673644,1672675963,2319
7706,3715981584,3833889105,1672650743,1672651723,980
7910,3513164386,3346327502,1672592192,1672592807,615
7957,3229665776,3760893269,1672587335,1672589007,1672
7584,3828432634,3505638204,1672591376,1672593034,1658
7914,3755436115,3235635976,1672539362,1672541485,2123
7797,3755881905,3516065852,1672604486,1672605735,1249
7681,3533270638,3209551760,1672637808,1672638060,252
7892,3395152943,3291235378,1672639650,1672643157,3507
7728,3390068992,3716197887,1672557249,1672559323,2074
7734,3783196518,3760509236,1672691258,1672693868,2610
7585,3291883916,3209551760,1672588309,1672588450,141
7797,3512217942,3517721725,1672536713,1672539561,2848
7820,3397418363,3244436890,1672604245,1672606623,2378
7589,3244389794,3311203656,1672670968,1672673858,2890
7562,3391261292,3517509185,1672659117,1672660443,1326
7877,3757403279,3776066388,1672553675,1672553990,315
7757,3778108318,3201848640,1672550083,1672552729,2646
7680,3703889596,3713894336,1672601938,1672603967,2029
7880,3418728074,3505347134,1672552760,1672552908,148
7640,3429690204,3911159965,1672665480,1672669067,3587
7572,3918247820,3517077106,1672671927,1672674072,2145
7659,3471220483,3420432297,1672613836,1672614864,1028
7849,3618045231,3756451663,1672694989,1672696884,1895
7683,3777806071,3556951786,1672683578,1672685891,2313
7951,3284832486,3772746272,1672589373,1672592729,3356
7796,3439023335,3206593906,1672589675,1672590846,1171
7684,3779218771,3899371911,1672593391,1672594434,1043
7760,3500729955,3420700674,1672662572,1672664186,1614
7759,3505869747,3703661585,1672656061,1672657800,1739
7822,3505873261,3760893269,1672634308,1672637308,3000
7629,3346327502,3899266183,1672657460,1672658153,693
7638,3774125065,3922337974,1672659062,1672660215,1153
7949,3779036831,3500458761,1672580644,1672581653,1009
7720,3200198928,3773120434,1672686111,1672687374,1263
7681,3774520233,3271938399,1672639378,1672639623,245
7704,3415443558,3475251781,1672580192,1672581141,949
7704,3505135325,3518260334,1672606446,1672607972,1526
7737,3510703546,3774010081,1672609339,1672611690,2351
7698,3276993580,3276993580,1672564555,1672565888,1333
7811,3855937514,3757403279,1672564171,1672564317,146
7848,3774125065,3607178184,1672703454,1672706192,2738
7909,3395152943,3902383721,1672534907,1672537288,2381
7884,3920801189,3779528381,1672601719,1672604155,2436
7712,3910886626,3939952128,1672636039,1672639081,3042
7508,3792844210,3776066388,1672554939,1672555473,534
7563,3351008918,3426325549,1672610242,1672613176,2934
7666,3515691540,3604539807,1672572117,1672572364,247
7727,3294803686,3319752091,1672669365,1672671253,1888
7728,3903962771,3505530961,1672557740,1672558789,1049
7651,3815508790,3311871871,1672650485,1672650795,310
7589,3805292782,3249401741,1672691982,1672693935,1953
7618,3515284591,3482405588,1672692073,1672693589,1516
7499,3792668962,3500487333,1672532288,1672535334,3046
7497,3483949762,3209383861,1672571032,1672571908,876
7607,3518669703,3791901535,1672680956,1672683671,2715
7511,3780974443,3783429780,1672553292,1672554983,1691
7798,3736229191,3296471982,1672543205,1672544950,1745
7949,3229665776,3311065516,1672636942,1672639584,2642
7655,3703871468,3716197887,1672579639,1672581865,2226
7586,3378686918,3494290908,1672639129,1672640291,1162
7541,3501759100,3970117174,1672538476,1672540350,1874
7619,3384240055,3909238838,1672556645,1672557807,1162
7734,3313541986,3903307060,1672685457,1672688031,2574
7626,3477649378,3276640712,1672683054,1672684280,1226
7609,3534553510,3715974031,1672597289,1672600724,3435
7978,3505135325,3383922351,1672567643,1672569729,2086
7901,3482405588,3713349754,1672534743,1672536372,1629
7728,3883042241,3510703546,1672535919,1672537206,1287
7709,3248507722,3780788622,1672622879,1672625639,2760
7811,3755739653,3883861463,1672551590,1672552010,420
7490,3774338212,3511170269,1672543139,1672545613,2474
7492,3236102733,3244389794,1672684417,1672684740,323
7675,3482405588,3760267716,1672638552,1672640404,1852
7913,3621497531,3383922351,1672543824,1672544237,413
7778,3533137446,3792384220,1672594338,1672595229,891
7569,3291235378,3770824086,1672694707,1672695330,623
7783,3555214688,3828432634,1672643570,1672643975,405
7492,3348261553,3365830990,1672545416,1672548175,2759
7735,3773465237,3319752091,1672658206,1672660531,2325
7706,3613995936,3511862351,1672658425,1672658523,98
7833,3505530961,3501184421,1672698162,1672700908,2746
7672,3801089989,3518260334,1672616276,1672617362,1086
7931,3475396323,3505362057,1672678156,1672678671,515
7758,3756966035,3311603601,1672535233,1672535556,323
7861,3685187183,3911159965,1672624899,1672626472,1573
7842,3932051427,3533827120,1672551923,1672552795,872
7599,3926700506,3514838220,1672670217,1672673270,3053
7626,3362000049,3629547065,1672567474,1672569449,1975
7915,3373384732,3511359172,1672696944,1672699549,2605
7626,3277605882,3426325549,1672594980,1672596915,1935
7979,3361230905,3201324715,1672618192,1672619980,1788
7685,3883085535,3511687358,1672654314,1672656684,2370
7523,3511350608,3318166135,1672605861,1672606025,164
7670,3519700826,3770021824,1672623598,1672624134,536
7580,3311152102,3209048907,1672566796,1672567132,336
7908,3931941795,3757562897,1672560097,1672561845,1748
7818,3633420270,3703661585,1672694740,1672698197,3457
7574,3242408357,3467773920,1672542827,1672544580,1753
7749,3510126867,3402943525,1672552391,1672552514,123
7915,3500803339,3429856982,1672684135,1672684830,695
7916,3713208927,3311761694,1672692960,1672693513,553
7718,3404384505,3772337814,1672665022,1672668226,3204
7524,3902278226,3793470489,1672565616,1672567018,1402
7701,3501483568,3883085535,1672599725,1672602025,2300
7865,3513599775,3783925755,1672591160,1672591675,515
7791,3421836608,3757455053,1672589046,1672589497,451
7799,3616944364,3902383721,1672698772,1672699699,927
7934,3514987389,3517077106,1672569545,1672570413,868
7880,3909606423,3221899927,1672683351,1672685251,1900
7555,3484995752,3812176780,1672693207,1672694698,1491
7522,3716488385,3773120434,1672683174,1672684095,921
7981,3206593906,3773598056,1672616873,1672618127,1254
7718,3716843669,3360506772,1672654469,1672654844,375
7523,3827377568,3222521619,1672687043,1672687820,777
7977,3738502357,3793086311,1672578493,1672581336,2843
7567,3465202715,3772714862,1672618540,1672619077,537
7509,3509672210,3783206719,1672694979,1672696676,1697
7976,3770447408,3701995648,1672630075,1672633175,3100
7660,3701111745,3500177712,1672681612,1672685050,3438
7684,3284832486,3713969578,1672573478,1672576399,2921
7971,3703275621,3399004969,1672677419,1672677617,198
7523,3379256399,3200198928,1672593477,1672595371,1894
7858,3918056059,3512540951,1672673831,1672676807,2976
7611,3770101921,3688683847,1672593682,1672594274,592
7858,3688683847,3713268590,1672585920,1672586582,662
7717,3510703546,3783126683,1672545963,1672546119,156
7601,3505883609,3505649239,1672621050,1672622941,1891
7738,3895562476,3500066230,1672548556,1672549105,549
7945,3515723720,3206254161,1672537639,1672538010,371
7869,3773978034,3358871377,1672624303,1672627885,3582
7697,3412980697,3517476351,1672659671,1672660039,368
7547,3777776687,3501364586,1672617195,1672619628,2433
7629,3925620998,3713370078,1672678997,1672681281,2284
7557,3683766533,3914290246,1672591635,1672594162,2527
7628,3467773920,3229058858,1672597187,1672597487,300
7814,3828365570,3552314511,1672540675,1672542776,2101
7699,3388372715,3736419952,1672595465,1672597727,2262
7595,3636867411,3715189301,1672641078,1672641699,621
7852,3336742544,3466229085,1672575563,1672576340,777
7927,3224716315,3428674539,1672684776,1672685706,930
7792,3513080274,3627937312,1672599465,1672599549,84
7978,3756601594,3618045231,1672645481,1672647029,1548
7489,3626156564,3925402713,1672574756,1672575279,523
7648,3402943525,3483164654,1672624129,1672626289,2160
7519,3518163778,3780503655,1672543655,1672547242,3587
7585,3809484172,3716537575,1672570865,1672574445,3580
7709,3246596716,3511312803,1672702139,1672705385,3246
7899,3902383721,3777776687,1672680783,1672681061,278
7798,3234362962,3555214688,1672682792,1672683840,1048
7743,3827377568,3493507965,1672674474,1672675788,1314
7900,3783239924,3501486692,1672660107,1672660546,439
7834,3443698222,3416427576,1672536112,1672539574,3462
7706,3667680268,3625274012,1672679176,1672681161,1985
7917,3883312122,3509634629,1672582475,1672585212,2737
7914,3505477652,3792253549,1672653739,1672656936,3197
7670,3311208440,3770021824,1672541199,1672543732,2533
7538,3517864478,3519563836,1672700231,1672700822,591
7737,3496269445,3882242815,1672549723,1672552357,2634
7515,3793871337,3701146057,1672627157,1672629181,2024
7685,3346795719,3520888296,1672641420,1672643246,1826
7808,3391915886,3793436995,1672667324,1672668878,1554
7784,3555214688,3634995491,1672617100,1672619487,2387
7659,3773465237,3277939457,1672692525,1672693336,811
7592,3311208440,3716197887,1672620655,1672622131,1476
7530,3516960534,3778549126,1672644264,1672645952,1688
7715,3556951786,3756930948,1672624222,1672625012,790
7564,3367029997,3365614305,1672585238,1672586751,1513
7661,3402943525,3793962300,1672568809,1672570278,1469
7816,3517476351,3337544549,1672628848,1672629662,814
7554,3774045700,3383922351,1672640730,1672642030,1300
7633,3755920131,3556951786,1672535994,1672538198,2204
7849,3379589402,3828624701,1672610775,1672613466,2691
7849,3710408395,3516016437,1672641045,1672642318,1273
7962,3520206212,3701995648,1672649608,1672650102,494
7876,3383661227,3428674539,1672666489,1672667135,646
7770,3415546117,3617055293,1672536003,1672539461,3458
7623,3895562476,3518360734,1672658346,1672661658,3312
7527,3713208927,3518360734,1672645214,1672645702,488
7736,3505219850,3391915121,1672649327,1672652283,2956
7829,3852391257,3316173088,1672607068,1672610315,3247
7970,3793753089,3711380716,1672634220,1672636542,2322
7794,3365278081,3979339287,1672673314,1672675513,2199
7619,3520012395,3500066230,1672636543,1672637051,508
7538,3757403279,3483164654,1672638827,1672639721,894
7819,3757151210,3351554343,1672537723,1672540390,2667
7778,3793436995,3458539365,1672642852,1672646004,3152
7980,3500487333,3518876135,1672534466,1672536148,1682
7639,3909331423,3365830990,1672533626,1672534837,1211
7774,3685818092,3914290246,1672637104,1672639025,1921
7820,3778308417,3976633198,1672615262,1672616618,1356
7914,3515723720,3520629279,1672689302,1672690030,728
7812,3209551760,3756424865,1672628382,1672631130,2748
7708,3770851318,3739106581,1672582626,1672584576,1950
7918,3513599775,3827626797,1672560079,1672562642,2563
7731,3898995675,3512510536,1672692771,1672694996,2225
7625,3505000737,3793086311,1672630943,1672634058,3115
7678,3716168623,3209551760,1672678093,1672679043,950
7552,3755042098,3224058172,1672635189,1672635979,790
7713,3817316561,3428006164,1672610789,1672611228,439
7966,3311090974,3887270940,1672634221,1672635684,1463
7821,3496549058,3387674757,1672680155,1672681127,972
7889,3206603608,3421127249,1672640815,1672642744,1929
7819,3755436115,3223789409,1672606635,1672610067,3432
7556,3291883916,3229058858,1672581928,1672585097,3169
7678,3713894336,3396086535,1672531431,1672532280,849
7762,3701274634,3229058858,1672554372,1672557003,2631
7797,3780294829,3714504419,1672659224,1672660792,1568
7798,3902383721,3770851318,1672577425,1672580801,3376
7575,3891751546,3711569060,1672613423,1672613808,385
7564,3703889596,3514128943,1672544554,1672547489,2935
7724,3778266283,3314245084,1672693504,1672694210,706
7955,3606186086,3779036831,1672695449,1672696717,1268
7674,3882242815,3513454145,1672640015,1672642507,2492
7644,3362000049,3555214688,1672574112,1672575897,1785
7596,3895562476,3342131135,1672598987,1672602551,3564
7730,3807987001,3244389794,1672659328,1672661500,2172
7697,3516258476,3501692334,1672534454,1672537544,3090
7912,3855602893,3429690204,1672626414,1672627909,1495
7880,3774045700,3816454165,1672536805,1672538324,1519
7572,3773598056,3514245078,1672573274,1672576698,3424
7918,3516011407,3316222192,1672548161,1672549258,1097
7904,3978115672,3909331423,1672622823,1672625575,2752
7594,3273500349,3859663348,1672608192,1672610215,2023
7874,3899204805,3505962865,1672531831,1672534530,2699
7602,3755943611,3512540951,1672685438,1672688301,2863
7648,3918674986,3792253549,1672586184,1672589573,3389
7578,3334033993,3228165483,1672649265,1672651017,1752
7662,3235287260,3520376528,1672539324,1672540369,1045
7918,3509453566,3287105466,1672692934,1672694653,1719
7947,3509352754,3517721725,1672564394,1672564784,390
7684,3533385867,3505530961,1672680862,1672683745,2883
7794,3516606733,3247428249,1672534359,1672535620,1261
7783,3533137446,3816853177,1672556717,1672558637,1920
7912,3500658339,3805292782,1672649066,1672652438,3372
7887,3533626375,3756601594,1672564745,1672564818,73
7679,3793871337,3244389794,1672682110,1672685315,3205
7673,3509453566,3783245561,1672667759,1672671340,3581
7816,3783239924,3297463265,1672554408,1672557159,2751
7765,3346795719,3420700674,1672575460,1672578229,2769
7938,3713370078,3417587765,1672585206,1672588330,3124
7900,3736592744,3886298125,1672671555,1672674997,3442
7775,3277669002,3221899927,1672573922,1672577266,3344
7795,3774005526,3359910781,1672614529,1672616985,2456
7934,3505362057,3773755137,1672619291,1672620038,747
7913,3247428249,3397418363,1672605876,1672608812,2936
7799,3221899927,3209551760,1672606537,1672606947,410
7844,3783779671,3372883226,1672597343,1672600146,2803
7841,3777514571,3829764737,1672647667,1672649212,1545
7728,3534191820,3777717988,1672635267,1672638627,3360
7650,3287105466,3378686918,1672685283,1672687662,2379
7594,3716488385,3666506258,1672552331,1672554524,2193
7667,3776513891,3500458761,1672664314,1672667906,3592
7658,3801089989,3318166135,1672661400,1672664443,3043
7873,3760492950,3291235378,1672539830,1672539969,139
7544,3418534998,3713268590,1672668142,1672670301,2159
7754,3427283336,3519703355,1672536092,1672538805,2713
7925,3772309166,3772337814,1672700136,1672700797,661
7809,3716843669,3514472925,1672697889,1672697987,98
7732,3301107849,3533653428,1672635400,1672636160,760
7873,3511359172,3477375368,1672697396,1672698911,1515
7649,3451432842,3520165601,1672563760,1672566087,2327
7634,3311761694,3918674986,1672697352,1672698008,656
7595,3909238838,3315583351,1672574846,1672574996,150
7795,3713808837,3713630656,1672532524,1672535755,3231
7661,3387674757,3518360734,1672554181,1672555471,1290
7801,3412825109,3770078063,1672615274,1672616613,1339
7686,3284832486,3622054816,1672693435,1672694805,1370
7532,3372883226,3511841857,1672626748,1672628374,1626
7976,3271938399,3516258476,1672539784,1672541986,2202
7522,3617734118,3311845971,1672662285,1672663830,1545
7791,3608633356,3501927421,1672695381,1672695837,456
7530,3756462516,3777936328,1672641322,1672644048,2726
7750,3910454786,3471220483,1672539588,1672540942,1354
7738,3242408357,3902383721,1672615632,1672617551,1919
7616,3757562897,3780914982,1672642809,1672643937,1128
7864,3778266283,3352603894,1672639973,1672640946,973
7941,3511163800,3832902928,1672655697,1672656435,738
7520,3515151980,3361230905,1672581826,1672582322,496
7697,3793086311,3714474557,1672651972,1672655215,3243
7650,3882997884,3710408395,1672607074,1672610067,2993
7518,3430504438,3209551760,1672575036,1672576730,1694
7560,3976390453,3770763956,1672696543,1672698016,1473
7693,3209551760,3777983879,1672636687,1672637038,351
7882,3711569060,3791942683,1672679697,1672680554,857
7836,3827377568,3714488548,1672544822,1672546576,1754
7751,3633420270,3853018906,1672598617,1672601857,3240
7822,3473562469,3505292701,1672600261,1672602764,2503
7836,3755798867,3716746253,1672590968,1672593512,2544
7528,3301107849,3828432634,1672575582,1672578012,2430
7507,3458539365,3911159965,1672597618,1672600274,2656
7943,3332072298,3774338212,1672589022,1672590497,1475
7643,3793338102,3801089989,1672638477,1672640689,2212
7507,3791997875,3806545488,1672602015,1672603974,1959
7624,3520030713,3234362962,1672663390,1672664328,938
7775,3973560347,3510969660,1672643208,1672646252,3044
7748,3515284591,3793753089,1672616582,1672618802,2220
7505,3311845971,3534488837,1672568956,1672569864,908
7927,3311208440,3358871377,1672628882,1672629640,758
7887,3626156564,3774204963,1672696530,1672698489,1959
7661,3533193862,3882997884,1672565365,1672565790,425
7600,3311871871,3307512479,1672577592,1672579279,1687
7589,3224716315,3511862351,1672576106,1672579166,3060
7803,3496549058,3857349323,1672620450,1672622296,1846
7940,3500729955,3370752401,1672547644,1672548826,1182
7874,3773755137,3683766533,1672532199,1672534047,1848
7512,3500066230,3773950140,1672549427,1672551960,2533
7888,3481647420,3516011407,1672589390,1672591392,2002
7711,3534424200,3489217083,1672569024,1672571973,2949
7956,3976633198,3922337974,1672621479,1672624035,2556
7549,3383922351,3304625412,1672643515,1672645216,1701
7791,3407725581,3755920131,1672559990,1672563545,3555
7845,3882242815,3346795719,1672666147,1672669248,3101
7844,3715581279,3511198618,1672597914,1672599621,1707
7678,3793286136,3489217083,1672593713,1672594339,626
7552,3514719601,3735319397,1672533860,1672537045,3185
7847,3405494240,3774338212,1672597569,1672598042,473
7829,3515723720,3505098372,1672653975,1672655425,1450
7983,3777443199,3901990690,1672648560,1672650788,2228
7956,3912262917,3714474557,1672555811,1672557714,1903
7755,3505292701,3533193862,1672662701,1672662827,126
7652,3774125065,3713208927,1672665834,1672667182,1348
7513,3365942576,3405494240,1672610220,1672611927,1707
7955,3505362057,3501486692,1672662137,1672662784,647
7904,3780593036,3755042098,1672672512,1672675141,2629
7831,3446948848,3519556068,1672579529,1672581798,2269
7968,3501601840,3555214688,1672701313,1672701691,378
7601,3714197325,3412980697,1672655322,1672658348,3026
7677,3404058699,3816454165,1672698864,1672699285,421
7805,3291235378,3773950140,1672576088,1672577030,942
7845,3383922351,3515125508,1672582285,1672583096,811
7713,3209383861,3223968713,1672567432,1672570776,3344
7729,3777790718,3202120784,1672569897,1672570175,278
7595,3417970574,3756930948,1672556091,1672558692,2601
7695,3780503655,3613683164,1672622382,1672625207,2825
7979,3880285638,3206593906,1672699425,1672702701,3276
7812,3917088658,3889232789,1672617055,1672618542,1487
7910,3501606184,3311065516,1672584009,1672584985,976
7825,3513454145,3716258994,1672597199,1672599077,1878
7824,3519152550,3901990690,1672589130,1672589386,256
7949,3773429448,3533653428,1672634625,1672636570,1945
7954,3510126867,3351554343,1672532022,1672533983,1961
7716,3776066388,3311065516,1672589921,1672592273,2352
7518,3811171116,3660493209,1672586860,1672588097,1237
7720,3921211276,3617055293,1672601108,1672601595,487
7608,3505962865,3352603894,1672626841,1672628031,1190
7705,3828365570,3244389794,1672557699,1672561062,3363
7639,3859525941,3711973519,1672556731,1672560258,3527
7895,3713644518,3770635361,1672648441,1672649686,1245
7769,3298288268,3517864478,1672660088,1672662368,2280
7699,3713894336,3517255726,1672570886,1672574316,3430
7920,3757562897,3287105466,1672602095,1672604547,2452
7965,3660493209,3311845971,1672622746,1672625552,2806
7828,3512540951,3420432297,1672695443,1672697512,2069
7942,3710067113,3772714862,1672687123,1672690182,3059
7930,3554917400,3505347134,1672635329,1672636967,1638
7753,3534010629,3756453423,1672696391,1672697058,667
7525,3428674539,3917278625,1672686866,1672687474,608
7639,3520751702,3518014636,1672541971,1672542381,410
7933,3757403279,3710067113,1672549202,1672550530,1328
7747,3512567240,3418728074,1672541989,1672544999,3010
7965,3421836608,3209027249,1672610900,1672611921,1021
7732,3533280269,3400918687,1672606022,1672606313,291
7541,3511687358,3492478793,1672563821,1672563953,132
7694,3777079686,3780609808,1672549974,1672552634,2660
7676,3773598056,3505292701,1672666072,1672667842,1770
7808,3701146057,3883551721,1672689445,1672691926,2481
7795,3318166135,3979339287,1672688896,1672690868,1972
7548,3791942683,3904775198,1672604986,1672605297,311
7924,3415443558,3791115967,1672600468,1672601434,966
7711,3715998609,3511271692,1672667036,1672669252,2216
7765,3783429780,3802367797,1672671876,1672674096,2220
7630,3505962865,3291883916,1672569564,1672571708,2144
7634,3390068992,3533025282,1672667419,1672670014,2595
7496,3312664885,3276993580,1672574404,1672577209,2805
7748,3516629436,3297463265,1672626079,1672629615,3536
7553,3534010629,3345207877,1672573011,1672576023,3012
7739,3472130842,3446948848,1672561085,1672563154,2069
7649,3833889105,3518876135,1672623504,1672625904,2400
7507,3223968713,3336742544,1672641769,1672643827,2058
7824,3518932404,3301107849,1672588540,1672590867,2327
7720,3737051610,3777477395,1672590781,1672592008,1227
7809,3839849341,3302626661,1672546886,1672547534,648
7908,3424922204,3780828689,1672569045,1672571667,2622
7667,3512142794,3488244966,1672696169,1672699060,2891
7563,3835382117,3209551760,1672651897,1672652561,664
7585,3288764520,3777929708,1672581066,1672581498,432
7948,3895562476,3757151210,1672653618,1672654240,622
7508,3550946908,3760598102,1672680473,1672681631,1158
7643,3428674539,3713208927,1672570810,1672572725,1915
7971,3516909237,3895562476,1672539297,1672540678,1381
7689,3809484172,3352603894,1672579844,1672580341,497
7628,3510937904,3757562897,1672546515,1672547298,783
7964,3356860407,3899371911,1672595941,1672596968,1027
7732,3387966152,3770447408,1672543530,1672545916,2386
7729,3621810464,3485823740,1672673038,1672676167,3129
7694,3793338102,3443698222,1672540491,1672540566,75
7771,3533385867,3701146057,1672698241,1672700592,2351
7499,3477375368,3909331423,1672629336,1672632669,3333
7513,3378436155,3739106581,1672684053,1672686710,2657
7770,3757602960,3360743849,1672567597,1672570031,2434
7635,3918247820,3512683609,1672662832,1672665835,3003
7863,3332072298,3899266183,1672703935,1672705427,1492
7529,3208844525,3516465662,1672629677,1672631106,1429
7891,3501483568,3774580701,1672590058,1672591929,1871
7602,3701898991,3822654369,1672558600,1672559216,616
7690,3432665384,3509630174,1672608318,1672611508,3190
7542,3791874383,3701498253,1672609515,1672610259,744
7779,3485375593,3405494240,1672561012,1672561294,282
7714,3357483218,3501730685,1672582478,1672585661,3183
7746,3716273414,3703871468,1672532926,1672535802,2876
7818,3336742544,3418534998,1672690752,1672691131,379
7940,3514128943,3501730685,1672609920,1672611429,1509
7913,3473765852,3510937904,1672676339,1672678687,2348
7789,3200198928,3404384505,1672609040,1672611928,2888
7638,3816853177,3511163800,1672601058,1672601454,396
7879,3881477378,3294803686,1672568356,1672571379,3023
7794,3792288302,3428674539,1672669018,1672672293,3275
7897,3510126867,3735319397,1672599279,1672599996,717
7523,3791957752,3711198793,1672570547,1672571814,1267
7818,3926700506,3774066725,1672537847,1672538613,766
7861,3505098372,3774466457,1672687589,1672689170,1581
7523,3509773875,3930791338,1672627040,1672628008,968
7910,3206603608,3701534009,1672664498,1672666645,2147
7903,3715127362,3247780536,1672628948,1672632196,3248
7531,3497901842,3757682496,1672613014,1672616351,3337
7489,3779036831,3200691026,1672698264,1672699465,1201
7493,3511332835,3412980697,1672623695,1672627065,3370
7681,3939952128,3755042098,1672577124,1672578468,1344
7894,3296471982,3416427576,1672651434,1672652038,604
7682,3774010081,3510711755,1672586820,1672589848,3028
7855,3809916577,3710344260,1672616814,1672617489,675
7896,3608868877,3756021689,1672571631,1672573649,2018
7880,3756930948,3280615985,1672544662,1672546162,1500
7843,3348261553,3247780536,1672668973,1672671775,2802
7723,3500578848,3399433690,1672614786,1672617579,2793
7958,3930797455,3311152102,1672615231,1672618133,2902
7626,3534191820,3628819436,1672685844,1672688196,2352
7863,3773950140,3774466457,1672609458,1672612887,3429
7638,3510703546,3509933351,1672676924,1672677788,864
7599,3683959482,3773755137,1672540885,1672543750,2865
7486,3277939457,3407954858,1672541160,1672541634,474
7824,3512720680,3760267716,1672626229,1672629367,3138
7780,3904408902,3610695419,1672622222,1672625097,2875
7883,3520012395,3792768129,1672614240,1672615205,965
7597,3911245524,3622054816,1672629843,1672631552,1709
7605,3829764737,3473562469,1672569096,1672571195,2099
7521,3284832486,3774119563,1672572514,1672574815,2301
7569,3500803339,3777717988,1672556011,1672556830,819
7602,3554917400,3224058172,1672633725,1672634160,435
7823,3361230905,3713786889,1672597748,1672601056,3308
7695,3617055293,3201848640,1672690950,1672694529,3579
7921,3792668962,3533025282,1672649800,1672650748,948
7887,3412825109,3365830990,1672574034,1672576478,2444
7519,3755920131,3391261292,1672675985,1672677600,1615
7488,3303751772,3772714862,1672640767,1672642989,2222
7502,3685818092,3534488837,1672677070,1672679067,1997
7756,3730517636,3774204963,1672688952,1672691208,2256
7566,3500729955,3783245561,1672673647,1672675058,1411
7881,3420700674,3501759100,1672567835,1672568022,187
7792,3223789409,3220716272,1672607982,1672610254,2272
7528,3505599848,3755587522,1672666733,1672668059,1326
7530,3373384732,3713630656,1672695831,1672698623,2792
7803,3936227020,3780788622,1672568897,1672571187,2290
7496,3606812411,3703661585,1672562639,1672566219,3580
7542,3783083229,3804870229,1672601710,1672604861,3151
7690,3369998498,3755625324,1672573967,1672576168,2201
7625,3734496778,3816853177,1672574332,1672575623,1291
7544,3773120434,3459030804,1672626120,1672628569,2449
7936,3500458761,3688418210,1672701435,1672703546,2111
7927,3201848640,3359910781,1672638866,1672641038,2172
7970,3757682496,3683766533,1672534883,1672537237,2354
7786,3511435497,3783206719,1672591096,1672592642,1546
7486,3793436995,3772309150,1672565778,1672566498,720
7893,3533280269,3554917400,1672564884,1672567599,2715
7728,3516514391,3829319703,1672573951,1672574834,883
7981,3430352815,3515394721,1672585526,1672588110,2584
7868,3710344260,3515125508,1672546037,1672546623,586
7584,3417061462,3534191820,1672613913,1672614363,450
7709,3517077106,3311871871,1672688064,1672688792,728
7947,3421127249,3511198618,1672551578,1672551707,129
7581,3344019610,3500060260,1672607256,1672609820,2564
7515,3736419952,3533927138,1672599408,1672601175,1767
7856,3407954858,3278365525,1672600245,1672602367,2122
7613,3736592744,3883085535,1672680578,1672683565,2987
7509,3793436995,3777443199,1672689171,1672691306,2135
7520,3826415738,3890149705,1672590873,1672594173,3300
7750,3774045700,3710112546,1672591935,1672594410,2475
7592,3311208440,3351008918,1672571402,1672573268,1866
7808,3783779671,3485375593,1672659793,1672661232,1439
7516,3715581279,3611150562,1672538739,1672538859,120
7882,3505362057,3710112546,1672645819,1672647453,1634
7708,3755920131,3783705817,1672646568,1672648028,1460
7741,3701274634,3500365158,1672569652,1672572415,2763
7627,3606186086,3770447408,1672617385,1672618709,1324
7635,3533626375,3756930948,1672602182,1672605043,2861
7946,3515151980,3809484172,1672573088,1672573301,213
7780,3714504419,3626156564,1672570993,1672574088,3095
7511,3505145247,3713268590,1672548803,1672550869,2066
7785,3533193862,3827626797,1672551338,1672554403,3065
7923,3418728074,3314836094,1672694904,1672695513,609
7626,3883861463,3555214688,1672679627,1672680849,1222
7599,3760294205,3774050956,1672560543,1672562449,1906
7701,3510969660,3636867411,1672700365,1672701750,1385
7795,3739106581,3485375593,1672671277,1672671915,638
7913,3731106822,3509907947,1672641306,1672643667,2361
7948,3493507965,3349613093,1672639553,1672641602,2049
7584,3501483568,3288764520,1672635544,1672639090,3546
7504,3520376528,3520756859,1672590714,1672591055,341
7865,3770078063,3778266283,1672645886,1672647695,1809
7888,3200198928,3534729133,1672543189,1672543772,583
7921,3500391167,3805292782,1672659816,1672660045,229
7865,3783429780,3629935998,1672700261,1672701971,1710
7745,3773429448,3883312122,1672628577,1672630922,2345
7575,3247780536,3756462516,1672555995,1672557868,1873
7626,3500499542,3511359172,1672541704,1672544069,2365
7711,3500578848,3534492426,1672700055,1672700496,441
7867,3779740455,3483164654,1672679787,1672682821,3034
7782,3756453423,3512683609,1672575808,1672576100,292
7815,3378686918,3246596716,1672532309,1672535182,2873
7868,3533810360,3666457294,1672686433,1672689779,3346
7603,3473562469,3516011407,1672688936,1672690143,1207
7743,3514719601,3534010629,1672535698,1672537595,1897
7707,3505859863,3772758337,1672655755,1672658690,2935
7943,3511359172,3714488548,1672567449,1672569075,1626
7590,3909238838,3772337814,1672687833,1672690786,2953
7706,3277939457,3626156564,1672635036,1672638347,3311
7604,3783779671,3505973226,1672678236,1672680260,2024
7875,3280964728,3976633198,1672625824,1672627083,1259
7971,3779976989,3428006164,1672543133,1672545873,2740
7491,3500365158,3510244400,1672655511,1672655596,85
7705,3837094550,3365278081,1672566541,1672567136,595
7911,3792288302,3755625324,1672647495,1672649100,1605
7532,3899266183,3415546117,1672642562,1672645607,3045
7511,3234362962,3666507626,1672626966,1672629575,2609
7961,3220716272,3380035798,1672602440,1672604071,1631
7852,3812176780,3903009525,1672600586,1672601314,728
7952,3312333615,3312664885,1672617379,1672620564,3185
7836,3770101921,3975287541,1672540928,1672541356,428
7675,3608633356,3510771358,1672567351,1672569328,1977
7893,3668898102,3370636709,1672686281,1672687717,1436
7552,3476232529,3714197325,1672650407,1672652929,2522
7761,3234362962,3899266183,1672655628,1672659170,3542
7600,3783196518,3520030713,1672658380,1672660574,2194
7975,3271938399,3513599775,1672600711,1672602240,1529
7486,3701274634,3509933351,1672544389,1672545546,1157
7767,3467773920,3511841857,1672654743,1672655450,707
7624,3358871377,3903307060,1672703076,1672704840,1764
7788,3756966035,3715581279,1672566093,1672568397,2304
7621,3756601594,3629547065,1672586838,1672588555,1717
7706,3682061100,3405494240,1672695775,1672699198,3423
7892,3777079686,3756451663,1672698262,1672700808,2546
7982,3516011407,3510703546,1672648814,1672649927,1113
7701,3516065852,3921211276,1672565882,1672566665,783
7812,3760893269,3313541986,1672640594,1672643709,3115
7951,3533193862,3918247820,1672638771,1672641985,3214
7562,3793753089,3278365525,1672561226,1672564368,3142
7800,3827377568,3284832486,1672676460,1672677724,1264
7710,3407954858,3791874383,1672682938,1672684839,1901
7812,3773664987,3362000049,1672583172,1672586554,3382
7982,3407673904,3501759100,1672581543,1672582408,865
7585,3755511676,3284639858,1672697341,1672698855,1514
7652,3475795792,3412980697,1672595304,1672597071,1767
7891,3534729133,3201432789,1672585993,1672588801,2808
7899,3303751772,3416265063,1672539263,1672541886,2623
7865,3885670556,3703223015,1672609074,1672612552,3478
7658,3385763781,3316173088,1672557225,1672557418,193
7611,3903009525,3360743849,1672654935,1672655115,180
7840,3478194807,3505219850,1672678276,1672681713,3437
7932,3926700506,3606186086,1672635190,1672636552,1362
7928,3713808837,3501730685,1672582072,1672584380,2308
7847,3516629436,3826633236,1672536847,1672540075,3228
7892,3828365570,3417061462,1672588342,1672590658,2316
7914,3883551721,3428006164,1672691256,1672693441,2185
7712,3701898991,3777936328,1672635055,1672636132,1077
7542,3511350608,3318166135,1672648204,1672650048,1844
7672,3776948966,3817316561,1672550963,1672551401,438
7531,3685818092,3827626797,1672634278,1672637858,3580
7857,3286658957,3777776687,1672543338,1672544521,1183
7613,3451432842,3515691540,1672580900,1672581461,561
7521,3701274634,3500458761,1672654001,1672654780,779
7695,3346327502,3756453423,1672659494,1672661217,1723
7937,3774339795,3855602893,1672643741,1672646636,2895
7955,3783429780,3826759140,1672533971,1672534221,250
7645,3629935998,3783126683,1672691953,1672693008,1055
7744,3391915886,3777717988,1672556693,1672557394,701
7755,3510247121,3520030713,1672605265,1672606522,1257
7618,3512540951,3926700506,1672570045,1672570298,253
7707,3391915886,3332072298,1672691748,1672695148,3400
7655,3223968713,3520206212,1672540394,1672543050,2656
7782,3412825109,3909606423,1672597902,1672598017,115
7539,3511267139,3939952128,1672544140,1672545297,1157
7685,3391261292,3314245084,1672556108,1672557892,1784
7725,3733891182,3715581279,1672691660,1672694063,2403
7953,3774050956,3714962248,1672623317,1672623752,435
7909,3772884106,3505201246,1672590655,1672590923,268
7510,3613683164,3311439795,1672532112,1672532566,454
7857,3514128943,3735733948,1672671221,1672674532,3311
7704,3509630174,3510247121,1672683737,1672686362,2625
7979,3533927138,3424922204,1672557014,1672559421,2407
7814,3500458761,3904408902,1672683013,1672684988,1975
7509,3515151980,3501606184,1672599005,1672600836,1831
7568,3756528686,3634340855,1672553346,1672554889,1543
7596,3770763956,3550946908,1672580543,1672581895,1352
7721,3703871468,3621810464,1672625935,1672629239,3304
7695,3837094550,3370636709,1672584686,1672588060,3374
7497,3770447408,3533385867,1672650183,1672653691,3508
7637,3515691540,3488244966,1672532181,1672533508,1327
7606,3890149705,3885897503,1672617294,1672620249,2955
7782,3314245084,3793753089,1672672616,1672673975,1359
7847,3511862351,3778108318,1672697876,1672700190,2314
7944,3351008918,3510711755,1672652269,1672655114,2845
7963,3501759100,3248507722,1672540219,1672542827,2608
7557,3518791447,3921211276,1672626317,1672628486,2169
7665,3793753089,3416427576,1672548565,1672550598,2033
7671,3206593906,3978105277,1672615573,1672618004,2431
7877,3364543015,3246596716,1672551941,1672553708,1767
7913,3518408774,3399433690,1672648223,1672651145,2922
7703,3777477395,3533025282,1672634901,1672635429,528
7608,3394330287,3365614305,1672594844,1672597312,2468
7663,3774338212,3477375368,1672654030,1672655845,1815
7640,3937224533,3362000049,1672604216,1672606337,2121
7847,3509634629,3429856982,1672675107,1672677512,2405
7886,3511312803,3916289176,1672648586,1672651683,3097
7739,3500199935,3365942576,1672655093,1672657009,1916
7724,3505912939,3715581279,1672566349,1672568478,2129
7573,3783509527,3780813786,1672538237,1672538811,574
7606,3505201246,3901877072,1672628241,1672630660,2419
7864,3483164654,3223968713,1672565250,1672565603,353
7646,3886298125,3925402713,1672596548,1672598697,2149
7550,3716488385,3825229501,1672545839,1672548694,2855
7621,3909606423,3883042241,1672640582,1672641136,554
7691,3755625324,3976633198,1672605489,1672606015,526
7948,3510594211,3319752091,1672632944,1672636342,3398
7969,3812176780,3311203656,1672616541,1672617314,773
7917,3664170666,3793436995,1672659770,1672662346,2576
7495,3301107849,3713208927,1672678553,1672680232,1679
7645,3711380716,3432665384,1672599378,1672601676,2298
7741,3805342762,3420700674,1672644967,1672647795,2828
7897,3853018906,3703718151,1672690746,1672692346,1600
7878,3783531004,3664517356,1672645995,1672648811,2816
7632,3783206719,3774556560,1672542721,1672546239,3518
7956,3519654779,3533137446,1672683923,1672687143,3220
7725,3777806071,3505883609,1672656854,1672658169,1315
7945,3714488548,3550946908,1672685046,1672686005,959
7634,3713644518,3415546117,1672677362,1672679005,1643
7695,3505362057,3978105277,1672693938,1672696482,2544
7620,3780788622,3482405588,1672644839,1672646100,1261
7717,3249401741,3510380060,1672682593,1672683935,1342
7886,3512969370,3517077106,1672655708,1672658900,3192
7769,3714821932,3378686918,1672665167,1672666944,1777
7729,3475795792,3774066725,1672574953,1672578237,3284
7716,3904408902,3511435497,1672564172,1672567058,2886
7777,3312333615,3756453423,1672602779,1672606304,3525
7944,3510173870,3755798867,1672642042,1672645388,3346
7503,3918247820,3666553782,1672669265,1672669447,182
7528,3792032359,3510703546,1672616165,1672617162,997
7727,3613683164,3791334389,1672696563,1672699035,2472
7935,3756930948,3760569731,1672556435,1672558567,2132
7932,3852391257,3618045231,1672587448,1672587969,521
7692,3518791447,3434642576,1672578626,1672580731,2105
7908,3622054816,3383661227,1672693338,1672696626,3288
7893,3313564074,3501927421,1672600798,1672602808,2010
7619,3365614305,3816853177,1672624429,1672627633,3204
7681,3716258994,3428006164,1672539912,1672540972,1060
7598,3512720680,3303751772,1672553871,1672556663,2792
7644,3496269445,3514472925,1672581450,1672583686,2236
7853,3607178184,3296471982,1672594420,1672597374,2954
7864,3430352815,3409474775,1672579672,1672582760,3088
7708,3311648200,3716746253,1672653810,1672655221,1411
7905,3221899927,3534553510,1672687204,1672689872,2668
7933,3552314511,3516258476,1672690644,1672691751,1107
7957,3629935998,3755436115,1672560820,1672561695,875
7510,3777717988,3701111745,1672546768,1672549186,2418
7837,3780914982,3899204805,1672693637,1672696083,2446
7543,3613995936,3918247820,1672552476,1672554449,1973
7528,3736790081,3303751772,1672662854,1672664992,2138
7958,3533385867,3755739653,1672647281,1672649060,1779
7543,3818255890,3901877072,1672653834,1672654758,924
7853,3610695419,3427283336,1672574857,1672575553,696
7805,3825229501,3534702203,1672653497,1672653576,79
7515,3936227020,3714197325,1672643071,1672643382,311
7971,3713894336,3636867411,1672639252,1672642190,2938
7811,3935627557,3829764737,1672683278,1672683898,620
7830,3755739653,3338703270,1672602183,1672605351,3168
7536,3780593036,3519428855,1672584683,1672586899,2216
7905,3244173074,3520730271,1672563206,1672563444,238
7968,3756623396,3384240055,1672607243,1672608585,1342
7756,3755872268,3912262917,1672585823,1672588607,2784
7873,3827626797,3685187183,1672532670,1672533997,1327
7806,3773120434,3774045700,1672540733,1672542863,2130
7578,3208844525,3552314511,1672635339,1672637904,2565
7498,3826759140,3979339287,1672588358,1672588937,579
7929,3520719611,3805292782,1672539295,1672542001,2706
7636,3399535232,3311761694,1672690234,1672693281,3047
7596,3482405588,3206603608,1672607113,1672609862,2749
7491,3458539365,3735319397,1672649111,1672651758,2647
7883,3703718151,3899266183,1672598249,1672601272,3023
7494,3516514391,3471220483,1672640465,1672641761,1296
7862,3736229191,3703223015,1672540743,1672543586,2843
7917,3509933351,3614238812,1672657690,1672659969,2279
7760,3734496778,3232962003,1672676537,1672679674,3137
7664,3394539273,3829232696,1672675185,1672677830,2645
7565,3855424474,3780609808,1672644440,1672647105,2665
7692,3345207877,3779218771,1672677256,1672678142,886
7687,3519601612,3520706195,1672571858,1672574690,2832
7982,3792844210,3777806071,1672542530,1672545616,3086
7675,3808324264,3774298222,1672649403,1672652667,3264
7765,3792288302,3976390453,1672599408,1672602483,3075
7705,3311648200,3301107849,1672571903,1672573586,1683
7881,3774520233,3500658339,1672603553,1672603900,347
7863,3711370563,3406784491,1672560012,1672563502,3490
7685,3496269445,3399052055,1672686714,1672688500,1786
7697,3379256399,3792032359,1672571329,1672571968,639
7707,3418728074,3774010081,1672556480,1672556669,189
7946,3505362057,3773120434,1672537573,1672540115,2542
7824,3760598102,3244485293,1672609490,1672610549,1059
7798,3793086311,3783779671,1672680560,1672682426,1866
7878,3399052055,3772758337,1672659137,1672661752,2615
7976,3388637594,3313564074,1672573937,1672575900,1963
7541,3791657947,3783705817,1672533226,1672534107,881
7942,3851190615,3550946908,1672618533,1672621021,2488
7791,3777079686,3404384505,1672602265,1672605118,2853
7968,3489545239,3885670556,1672563253,1672563650,397
7877,3500805881,3221899927,1672638353,1672638929,576
7590,3490191091,3249401741,1672546049,1672547936,1887
7901,3333896808,3344364444,1672571025,1672571595,570
7751,3791115967,3701534009,1672674145,1672677257,3112
7487,3610695419,3415443558,1672533833,1672534617,784
7750,3809916577,3970117174,1672688675,1672690141,1466
7622,3616944364,3774125065,1672651331,1672653255,1924
7913,3890149705,3379589402,1672669508,1672670908,1400
7616,3736592744,3370636709,1672546262,1672548852,2590
7577,3513956646,3238712269,1672630693,1672632976,2283
7748,3855424474,3701178711,1672622860,1672626205,3345
7834,3518496488,3224716315,1672604937,1672606571,1634
7981,3500805881,3338703270,1672580816,1672582055,1239
7502,3757246925,3534010629,1672627217,1672627688,471
7685,3222521619,3389115045,1672653026,1672654553,1527
7841,3627937312,3772714862,1672632120,1672634331,2211
7521,3839849341,3516465662,1672570701,1672573473,2772
7725,3227457126,3793627961,1672632196,1672635478,3282
7935,3904775198,3683766533,1672588564,1672590468,1904
7648,3777443199,3501601840,1672629572,1672632922,3350
7930,3501759100,3859663348,1672688591,1672688904,313
7750,3780503655,3714474557,1672602778,1672603569,791
7672,3701274634,3757682496,1672581052,1672583880,2828
7656,3710098970,3621497531,1672674611,1672677207,2596
7862,3628819436,3512720680,1672600506,1672601475,969
7934,3302626661,3391915886,1672602194,1672603797,1603
7677,3792768129,3777514571,1672609482,1672610355,873
7584,3475795792,3777120536,1672609387,1672610249,862
7902,3773120434,3249247700,1672634505,1672634634,129
7805,3774580701,3903962771,1672625402,1672627930,2528
7868,3716746253,3420700674,1672618929,1672620455,1526
7819,3556951786,3903009525,1672556332,1672559312,2980
7852,3388372715,3411618230,1672532590,1672533180,590
7849,3386707783,3757455053,1672680317,1672681827,1510
7956,3434642576,3667680268,1672580538,1672580780,242
7881,3475251781,3550946908,1672696955,1672698158,1203
7718,3311274543,3889232789,1672656259,1672658102,1843
7635,3209551760,3978115672,1672532424,1672535054,2630
7670,3518669703,3518014636,1672531775,1672535131,3356
7546,3791942683,3828432634,1672641405,1672642359,954
7886,3520629279,3792473331,1672535010,1672537428,2418
7572,3774045700,3617734118,1672647313,1672647741,428
7828,3430504438,3285400528,1672686555,1672687490,935
7801,3805292782,3365614305,1672662238,1672664295,2057
7783,3770101921,3500803339,1672667308,1672667775,467
7696,3512567240,3505973226,1672570297,1672570782,485
7683,3483164654,3534492426,1672549585,1672552588,3003
7654,3372883226,3489217083,1672673305,1672676426,3121
7700,3713808837,3311993075,1672698810,1672702138,3328
7518,3711569060,3710408395,1672557323,1672559671,2348
7852,3248507722,3534424200,1672613569,1672617157,3588
7682,3280964728,3817621391,1672644660,1672645695,1035
7937,3773205565,3809484172,1672627769,1672628102,333
7966,3430504438,3443698222,1672573771,1672575078,1307
7859,3703013906,3809916577,1672665246,1672668246,3000
7591,3774520233,3793962300,1672692301,1672694818,2517
7754,3518163778,3932051427,1672597998,1672599265,1267
7530,3710067113,3736625083,1672677526,1672679982,2456
7769,3288764520,3793871337,1672552203,1672553977,1774
7978,3792253549,3779629905,1672589000,1672589147,147
7558,3701995648,3446948848,1672591021,1672593711,2690
7663,3883042241,3396285984,1672675317,1672677621,2304
7494,3735319397,3774125065,1672555901,1672558190,2289
7664,3777776687,3711504540,1672666222,1672668244,2022
7941,3489962019,3512349371,1672592280,1672592788,508
7716,3489217083,3505702787,1672563216,1672566760,3544
7742,3918247820,3349613093,1672685760,1672687575,1815
7535,3777514571,3779218771,1672562710,1672564656,1946
7619,3304625412,3209551760,1672667996,1672669543,1547
7654,3777929708,3777717988,1672688636,1672691432,2796
7784,3516011407,3512683609,1672691140,1672693308,2168
7768,3791602225,3713894336,1672552327,1672555507,3180
7814,3701995648,3379256399,1672696888,1672697292,404
7625,3755625324,3791020967,1672548699,1672552140,3441
7908,3774298222,3852595551,1672597721,1672599880,2159
7861,3473562469,3224716315,1672638697,1672639197,500
7665,3774066725,3510703546,1672620292,1672621311,1019
7800,3756623396,3685187183,1672539928,1672543432,3504
7913,3710344260,3222521619,1672678038,1672681325,3287
7554,3773814927,3475258557,1672652067,1672653000,933
7943,3770078063,3405494240,1672614819,1672615916,1097
7513,3776066388,3501601840,1672658361,1672660498,2137
7846,3505193212,3396285984,1672577117,1672578353,1236
7796,3736790081,3736625083,1672599284,1672602881,3597
7888,3791657947,3774119563,1672702300,1672702525,225
7914,3364543015,3229058858,1672535316,1672536711,1395
7778,3360743849,3516980378,1672557052,1672559250,2198
7770,3730517636,3715492942,1672667356,1672670115,2759
7556,3770078063,3298288268,1672577145,1672577438,293
7721,3514719601,3888559320,1672653424,1672656159,2735
7722,3247815299,3608633356,1672622720,1672623945,1225
7733,3500060260,3520629279,1672591864,1672592364,500
7489,3500177712,3909606423,1672547540,1672551122,3582
7665,3918674986,3319752091,1672533820,1672534009,189
7635,3930791338,3713644518,1672673247,1672675722,2475
7850,3519563836,3780294829,1672557265,1672558504,1239
7904,3613683164,3772714862,1672675609,1672678494,2885
7552,3855000166,3344364444,1672646462,1672648922,2460
7574,3520190170,3516514391,1672635434,1672635835,401
7746,3711308224,3311603601,1672550339,1672551163,824
7942,3664170666,3889750851,1672531942,1672532960,1018
7487,3688418210,3201848640,1672681706,1672684811,3105
7848,3516673015,3616944364,1672680999,1672683528,2529
7716,3378436155,3701498253,1672699574,1672702179,2605
7586,3755042098,3736419952,1672582340,1672583584,1244
7520,3733189298,3473765852,1672655663,1672658827,3164
7740,3613683164,3972709319,1672684093,1672686247,2154
7576,3922275620,3805347939,1672556058,1672557690,1632
7917,3534488837,3756623396,1672596090,1672597367,1277
7740,3713268590,3516065852,1672628769,1672630530,1761
7584,3711571712,3736229191,1672703659,1672703826,167
7706,3312664885,3780593036,1672692220,1672693478,1258
7888,3227457126,3774520233,1672584316,1672584948,632
7781,3629935998,3783083229,1672549539,1672549637,98
7931,3312829208,3978105277,1672659691,1672661120,1429
7883,3420432297,3760077057,1672600830,1672600996,166
7929,3512720680,3517963492,1672654764,1672655398,634
7566,3534010629,3935627557,1672632416,1672634480,2064
7744,3465254146,3716165213,1672596059,1672598596,2537
7727,3515125508,3780593036,1672689276,1672689622,346
7688,3793871337,3509907947,1672545686,1672548511,2825
7808,3533095755,3777443199,1672699915,1672701829,1914
7581,3909331423,3716900301,1672630772,1672632822,2050
7782,3552314511,3489962019,1672647738,1672651261,3523
7954,3291227780,3713808837,1672549843,1672550946,1103
7635,3517509185,3780503655,1672659932,1672661953,2021
7976,3791594391,3360506772,1672645063,1672646408,1345
7925,3883861463,3313564074,1672578996,1672581674,2678
7604,3733891182,3882291183,1672553193,1672553650,457
7868,3739106581,3713808837,1672552674,1672554377,1703
7917,3487171044,3360506772,1672640243,1672640617,374
7772,3221899927,3715189301,1672643563,1672645084,1521
7701,3514838220,3932051427,1672563971,1672566527,2556
7505,3500499542,3780639480,1672558508,1672558746,238
7484,3293695955,3915628728,1672547932,1672549080,1148
7770,3517459919,3514838220,1672619050,1672619925,875
7633,3757151210,3311154569,1672606586,1672607873,1287
7794,3519654779,3352603894,1672605659,1672606904,1245
7571,3851190615,3384951177,1672537670,1672540579,2909
7768,3774338212,3515860749,1672656327,1672656669,342
7591,3311203656,3513454145,1672571033,1672573170,2137
7783,3516465662,3482405588,1672633232,1672633618,386
7505,3792473331,3791594391,1672569393,1672572818,3425
7656,3451432842,3829764737,1672690344,1672692600,2256
7823,3235635976,3773429448,1672677232,1672679270,2038
7587,3533748232,3733189298,1672608941,1672610661,1720
7742,3711370563,3904408902,1672554235,1672557760,3525
7559,3515151980,3668898102,1672592344,1672595397,3053
7757,3404384505,3703889596,1672632466,1672635238,2772
7668,3913251733,3711198793,1672640637,1672642345,1708
7580,3505098372,3314836094,1672637675,1672641062,3387
7548,3533827120,3614238812,1672625788,1672627488,1700
7573,3483164654,3511332835,1672552332,1672552394,62
7602,3710098970,3833889105,1672583415,1672586643,3228
7626,3383922351,3912536808,1672703556,1672706214,2658
7803,3390068992,3883861463,1672629706,1672631532,1826
7850,3701863557,3880310724,1672533021,1672534930,1909
7934,3405494240,3520030713,1672619387,1672620111,724
7756,3448855696,3772578994,1672611469,1672615054,3585
7772,3369998498,3520888296,1672543695,1672544357,662
7762,3936227020,3703661585,1672685795,1672688868,3073
7775,3606987130,3883312122,1672683246,1672684508,1262
7903,3249791738,3554917400,1672547975,1672548261,286
7601,3399911573,3516960534,1672659462,1672661380,1918
7906,3374559242,3360506772,1672540547,1672542273,1726
7703,3701111745,3519703355,1672535664,1672537694,2030
7972,3500904641,3760492950,1672619643,1672622692,3049
7558,3520756859,3770101921,1672628315,1672629544,1229
7971,3613995936,3755739653,1672658259,1672661618,3359
7930,3972364603,3770078063,1672666903,1672667926,1023
7813,3792668962,3519700826,1672563849,1672565951,2102
7891,3380035798,3515125508,1672551169,1672552275,1106
7514,3291883916,3710098970,1672545864,1672548916,3052
7636,3235635976,3287105466,1672656733,1672657885,1152
7714,3370636709,3337544549,1672608703,1672611314,2611
7556,3505347134,3976633198,1672695639,1672698057,2418
7842,3710408395,3627937312,1672572775,1672574778,2003
7781,3715127362,3910454786,1672543929,1672544592,663
7950,3231056870,3918674986,1672646121,1672648868,2747
7955,3760893269,3600647945,1672658767,1672659562,795
7657,3783239924,3313564074,1672700766,1672704170,3404
7820,3390068992,3378436155,1672547856,1672549312,1456
7752,3394330287,3420432297,1672626381,1672629420,3039
7613,3779629905,3820354437,1672586529,1672587576,1047
7621,3622054816,3774793839,1672539570,1672542652,3082
7795,3772578994,3505869747,1672544518,1672546556,2038
7816,3311415018,3757403279,1672613578,1672613943,365
7813,3279721246,3432689543,1672648438,1672648764,326
7947,3608633356,3618045231,1672566138,1672566741,603
7862,3922337974,3760294205,1672541211,1672542695,1484
7845,3917088658,3349613093,1672635638,1672635976,338
7498,3903009525,3760992710,1672655940,1672656360,420
7563,3513164386,3920801189,1672616241,1672619072,2831
7579,3501606184,3405494240,1672590252,1672590345,93
7738,3509604974,3221899927,1672585827,1672586162,335
7495,3534492426,3485008994,1672565678,1672567976,2298
7651,3505477652,3276640712,1672648958,1672651271,2313
7705,3793962300,3817316561,1672675580,1672678558,2978
7755,3367029997,3361230905,1672564852,1672567004,2152
7507,3392121505,3515860749,1672563184,1672565500,2316
7686,3365278081,3770447408,1672627071,1672627649,578
7551,3777929708,3500374658,1672594500,1672597554,3054
7573,3703871468,3852595551,1672643722,1672646772,3050
7906,3513956646,3337544549,1672560779,1672563392,2613
7644,3607178184,3391915121,1672610286,1672611681,1395
7957,3778266283,3515284591,1672696239,1672699033,2794
7871,3774466457,3918247820,1672591803,1672594467,2664
7940,3388372715,3668898102,1672602148,1672605746,3598
7941,3501692334,3520012395,1672602520,1672602637,117
7719,3229665776,3448855696,1672697967,1672699100,1133
7621,3857349323,3774338212,1672534379,1672534719,340
7814,3703735129,3222448362,1672587484,1672590747,3263
7702,3710112546,3774045700,1672662113,1672665182,3069
7563,3736786443,3628819436,1672646942,1672648973,2031
7614,3815508790,3710344260,1672695096,1672695351,255
7817,3519654779,3685187183,1672565618,1672566122,504
7920,3471220483,3791657947,1672604922,1672606416,1494
7923,3629935998,3249401741,1672592424,1672593461,1037
7914,3739106581,3332072298,1672609910,1672611737,1827
7956,3512349371,3313541986,1672552223,1672553110,887
7741,3711198793,3777776687,1672633669,1672635445,1776
7899,3409474775,3773120434,1672591928,1672594261,2333
7790,3791997875,3606812411,1672631364,1672634681,3317
7586,3683766533,3774005526,1672652249,1672652475,226
7662,3365614305,3791020967,1672641287,1672641881,594
7646,3404384505,3890149705,1672630116,1672631910,1794
7830,3770078063,3915628728,1672691416,1672694366,2950
7851,3932051427,3774066725,1672623114,1672625023,1909
7738,3776338577,3711504540,1672637054,1672640532,3478
7945,3552314511,3402943525,1672571579,1672572158,579
7767,3716900301,3772746272,1672694341,1672695236,895
7541,3607178184,3313541986,1672596510,1672597169,659
7746,3890149705,3489728806,1672570936,1672573680,2744
7557,3510771358,3836573197,1672677744,1672679150,1406
7910,3791957752,3885897503,1672561134,1672562519,1385
7908,3827626797,3512567240,1672634043,1672637076,3033
7568,3379589402,3738274418,1672565206,1672565802,596
7796,3311627628,3791602225,1672544356,1672547020,2664
7577,3514472925,3510380060,1672648680,1672649143,463
7708,3301107849,3812176780,1672552586,1672554154,1568
7775,3496549058,3520709480,1672651009,1672652981,1972
7556,3500994774,3533827120,1672576827,1672576959,132
7961,3519069599,3280599164,1672600408,1672600745,337
7513,3534729133,3407725581,1672679856,1672682941,3085
7719,3493507965,3200691026,1672533434,1672534870,1436
7729,3417587765,3827377568,1672535232,1672536351,1119
7958,3793436995,3760992710,1672536413,1672537897,1484
7923,3497901842,3206593906,1672619066,1672622010,2944
7510,3471220483,3756027749,1672555840,1672556379,539
7798,3346795719,3516673015,1672532233,1672535495,3262
7543,3703718151,3500487333,1672590442,1672593497,3055
7693,3711569060,3489217083,1672624087,1672627516,3429
7833,3516016437,3333896808,1672653943,1672656152,2209
7845,3774466457,3515151980,1672586324,1672587231,907
7945,3703955926,3349613093,1672602684,1672604272,1588
7740,3610348516,3516223597,1672684061,1672685080,1019
7968,3701190899,3517077106,1672621714,1672621858,144
7501,3511350608,3505912939,1672540621,1672542756,2135
7690,3791957752,3668898102,1672591155,1672592050,895
7934,3428964059,3249401741,1672563847,1672564793,946
7780,3505347134,3511435497,1672610063,1672612249,2186
7950,3481647420,3314836094,1672566603,1672569829,3226
7858,3773465237,3713349754,1672576178,1672579116,2938
7846,3903307060,3777983879,1672612551,1672616049,3498
7970,3755943611,3458539365,1672581739,1672585062,3323
7822,3505173328,3517459919,1672663518,1672665719,2201
7662,3278365525,3500803339,1672607938,1672609628,1690
7761,3909238838,3816454165,1672627237,1672629742,2505
7879,3277605882,3713630656,1672577115,1672577748,633
7889,3500658339,3420432297,1672567892,1672568080,188
7889,3757682496,3713894336,1672593749,1672594969,1220
7511,3516258476,3451432842,1672574346,1672577122,2776
7666,3416265063,3279721246,1672655487,1672656586,1099
7727,3793286136,3485375593,1672618110,1672621371,3261
7665,3512567240,3485823740,1672657399,1672659390,1991
7729,3277939457,3533242305,1672545078,1672547711,2633
7523,3519152550,3701534009,1672653661,1672655648,1987
7610,3701065786,3777929708,1672571908,1672573987,2079
7623,3510937904,3792288302,1672600868,1672602290,1422
7941,3755511676,3294803686,1672581570,1672582813,1243
7761,3420700674,3777929708,1672661638,1672664948,3310
7708,3246596716,3209383861,1672550281,1672551767,1486
7807,3534553510,3917278625,1672616361,1672617028,667
7842,3736229191,3505912939,1672658797,1672661101,2304
7709,3201848640,3206603608,1672559477,1672561963,2486
7730,3511435497,3621497531,1672575955,1672577181,1226
7570,3510247121,3776338577,1672577428,1672579272,1844
7871,3518669703,3793959750,1672547841,1672549787,1946
7576,3500994774,3279721246,1672622157,1672623899,1742
7500,3755625324,3518876135,1672541672,1672541882,210
7534,3417970574,3501759100,1672702203,1672703640,1437
7970,3311718847,3287105466,1672657048,1672659579,2531
7543,3772578994,3370752401,1672567014,1672568417,1403
7922,3510126867,3774195321,1672684698,1672686270,1572
7586,3511271692,3344019610,1672586823,1672588234,1411
7608,3505530961,3515394721,1672541616,1672544843,3227
7610,3515125508,3357483218,1672665333,1672666704,1371
7571,3776066388,3428964059,1672662626,1672665988,3362
7871,3201848640,3783206719,1672685380,1672686749,1369
7747,3235287260,3930791338,1672703147,1672703716,569
7651,3284832486,3779976989,1672661308,1672664225,2917
7831,3757455053,3378686918,1672535824,1672537725,1901
7723,3509672210,3703441914,1672699946,1672701393,1447
7823,3855000166,3534313900,1672694469,1672695604,1135
7980,3701967560,3280615985,1672700271,1672702579,2308
7718,3618873142,3500229033,1672638209,1672641287,3078
7889,3432689543,3357483218,1672543846,1672544372,526
7533,3755587522,3311603601,1672695614,1672696789,1175
7772,3774268456,3714197325,1672629717,1672631926,2209
7612,3285400528,3516606733,1672620394,1672623089,2695
7981,3416427576,3714821932,1672688874,1672692305,3431
7678,3459030804,3244485293,1672679767,1672681830,2063
7496,3298433163,3829232696,1672631397,1672632172,775
7858,3515691540,3277669002,1672566210,1672567515,1305
7631,3513956646,3714197325,1672597272,1672597543,271
7651,3904775198,3615046771,1672572324,1672575242,2918
7865,3770824086,3475396323,1672617992,1672620436,2444
7655,3311154569,3483949762,1672667378,1672669333,1955
7660,3534424200,3511267139,1672627826,1672630206,2380
7889,3778108318,3774793839,1672558001,1672559987,1986
7895,3783925755,3909606423,1672618933,1672622041,3108
7828,3701065786,3738502357,1672703671,1672705525,1854
7977,3369998498,3315583351,1672605986,1672608711,2725
7895,3776066388,3732481297,1672638502,1672639276,774
7691,3816853177,3779528381,1672648552,1672650175,1623
7716,3336742544,3713894336,1672651115,1672654487,3372
7717,3882997884,3887270940,1672661536,1672665093,3557
7860,3688418210,3703718151,1672590630,1672594003,3373
7856,3395152943,3792902982,1672586127,1672588233,2106
7668,3809916577,3778549126,1672637650,1672638737,1087
7807,3783239924,3772309166,1672660064,1672662096,2032
7896,3701274634,3501486692,1672638709,1672641979,3270
7972,3792902982,3509907947,1672565241,1672565412,171
7982,3770447408,3774793839,1672673275,1672674687,1412
7675,3710408395,3311871871,1672613774,1672616407,2633
7540,3772714862,3519601612,1672620325,1672623432,3107
7677,3505649239,3514128943,1672586951,1672588590,1639
7726,3511350608,3924549929,1672566307,1672568176,1869
7570,3500994774,3501606184,1672593253,1672593663,410
7596,3409474775,3625274012,1672567865,1672571083,3218
7530,3518876135,3500904641,1672634039,1672637598,3559
7589,3337544549,3685187183,1672551650,1672551869,219
7704,3496051529,3716258994,1672696447,1672698859,2412
7619,3358871377,3533137446,1672664026,1672665456,1430
7669,3601879040,3500894271,1672640027,1672643140,3113
7796,3515151980,3516980378,1672669893,1672669977,84
7712,3533827120,3247428249,1672696469,1672699905,3436
7946,3783239924,3405494240,1672667782,1672670697,2915
7558,3512567240,3701190899,1672703877,1672704982,1105
7483,3713894336,3755625324,1672614080,1672614928,848
7853,3497901842,3736790081,1672646888,1672650274,3386
7950,3780914982,3774066725,1672681584,1672684907,3323
7708,3228165483,3336742544,1672697964,1672699137,1173
7972,3710344260,3223968713,1672549164,1672552351,3187
7656,3666506258,3978105277,1672679523,1672682935,3412
7895,3360993964,3387674757,1672604068,1672607088,3020
7958,3791553060,3201432789,1672585632,1672587768,2136
7712,3774298222,3500894271,1672568262,1672568910,648
7781,3791115967,3910886626,1672540449,1672541822,1373
7727,3500894271,3421127249,1672579666,1672582129,2463
7907,3731419510,3505859863,1672688396,1672691780,3384
7799,3516258476,3760077057,1672612122,1672614184,2062
7828,3756528686,3388372715,1672652700,1672654998,2298
7583,3899266183,3779976989,1672670103,1672673238,3135
7907,3511332835,3451432842,1672623698,1672627096,3398
7530,3666553782,3505145247,1672655009,1672655129,120
7941,3851190615,3917278625,1672596180,1672596767,587
7732,3515284591,3615046771,1672641515,1672644209,2694
7977,3493507965,3606987130,1672698471,1672699863,1392
7834,3772544062,3779976989,1672589300,1672590035,735
7957,3400918687,3509453566,1672607433,1672607677,244
7510,3480687894,3513956646,1672548204,1672550658,2454
7963,3666457294,3792668962,1672568082,1672571553,3471
7974,3976633198,3777790718,1672631954,1672632258,304
7679,3316173088,3314245084,1672560295,1672561901,1606
7747,3518496488,3500199935,1672590208,1672591690,1482
7672,3773120434,3827377568,1672599061,1672602353,3292
7735,3209048907,3344019610,1672566529,1672567974,1445
7749,3773465237,3804870229,1672541084,1672543900,2816
7665,3311090974,3770553384,1672695162,1672695688,526
7892,3918674986,3378436155,1672688594,1672689982,1388
7653,3505135325,3318697153,1672671686,1672673469,1783
7695,3756462516,3511350608,1672594018,1672595424,1406
7739,3627937312,3621810464,1672662103,1672664737,2634
7725,3703441914,3348261553,1672605761,1672607040,1279
7803,3791957752,3606186086,1672563932,1672565575,1643
7867,3703718151,3774195321,1672642975,1672645686,2711
7654,3715339701,3518408774,1672612110,1672614287,2177
7618,3816454165,3458539365,1672645579,1672646290,711
7536,3496549058,3793338102,1672598648,1672601219,2571
7754,3972364603,3516065852,1672616689,1672620150,3461
7959,3516960534,3779976989,1672595183,1672597600,2417
7857,3899266183,3736790081,1672654598,1672657666,3068
7873,3518163778,3703661585,1672591792,1672593107,1315
7720,3514283243,3492478793,1672593565,1672597058,3493
7834,3271938399,3311648200,1672649358,1672652132,2774
7625,3287105466,3774119563,1672672830,1672676419,3589
7746,3505869747,3716900301,1672691050,1672691805,755
7797,3792883665,3331845324,1672552150,1672552256,106
7513,3372883226,3244389794,1672550925,1672552350,1425
7879,3513080274,3802367797,1672669699,1672672010,2311
7910,3683959482,3438645253,1672647508,1672647883,375
7683,3760561634,3497901842,1672622579,1672625219,2640
7711,3500060260,3901990690,1672676498,1672679026,2528
7822,3774127586,3318166135,1672607051,1672608674,1623
7738,3475258557,3234362962,1672700658,1672702890,2232
7499,3618873142,3514283243,1672538714,1672540165,1451
7546,3512567240,3505203158,1672659999,1672663079,3080
7488,3756601594,3778980116,1672622935,1672623503,568
7691,3394330287,3883551721,1672664827,1672665660,833
7947,3510937904,3755739653,1672560934,1672564425,3491
7883,3482405588,3774066725,1672699436,1672702950,3514
7628,3451432842,3360743849,1672681403,1672684200,2797
7652,3818255890,3500994774,1672673894,1672676006,2112
7650,3428674539,3793627961,1672613706,1672614597,891
7815,3533193862,3783509527,1672655932,1672657839,1907
7539,3812176780,3730517636,1672618180,1672618549,369
7486,3883312122,3500729955,1672574342,1672577615,3273
7942,3774045700,3519563836,1672597072,1672600095,3023
7942,3511267139,3519563836,1672692135,1672695578,3443
7900,3713370078,3312829208,1672666346,1672668933,2587
7952,3891751546,3509672210,1672587761,1672588730,969
7966,3829319703,3701534009,1672573622,1672575552,1930
7789,3385763781,3715974031,1672642599,1672645109,2510
7633,3756453423,3220716272,1672615319,1672617964,2645
7543,3221899927,3534702203,1672618060,1672618684,624
7692,3365942576,3757161914,1672620958,1672623120,2162
7646,3701691675,3484995752,1672593435,1672595631,2196
7860,3520030713,3301107849,1672693822,1672696332,2510
7933,3390068992,3633420270,1672606485,1672606560,75
7822,3793338102,3937224533,1672586676,1672590246,3570
7932,3415546117,3773598056,1672599788,1672602874,3086
7667,3352603894,3629935998,1672636192,1672639082,2890
7879,3791901535,3206254161,1672641851,1672643505,1654
7878,3420700674,3500803339,1672577672,1672579972,2300
7819,3500060260,3701984666,1672569652,1672570626,974
7818,3505962865,3883085535,1672643179,1672645746,2567
7806,3778308417,3407673904,1672558093,1672559450,1357
7628,3484995752,3404384505,1672584008,1672586272,2264
7835,3783429780,3516258476,1672625826,1672626000,174
7572,3515723720,3701146057,1672537836,1672538399,563
7877,3200198928,3920801189,1672633153,1672635530,2377
7914,3817621391,3481502100,1672583597,1672585569,1972
7796,3793436995,3755587522,1672691344,1672694088,2744
7737,3852595551,3660493209,1672603204,1672605812,2608
7756,3505173328,3755739653,1672604805,1672605345,540
7935,3496051529,3778305740,1672609148,1672610051,903
7943,3800886801,3662180254,1672641247,1672641393,146
7547,3505599848,3391915121,1672613431,1672613994,563
7664,3778980116,3513599775,1672668833,1672670962,2129
7889,3773429448,3755943611,1672569052,1672569323,271
7600,3473562469,3936227020,1672689429,1672692994,3565
7598,3279721246,3518014636,1672677581,1672678488,907
7785,3520376528,3778108318,1672655727,1672656508,781
7579,3760569731,3757562897,1672609732,1672611889,2157
7900,3666506258,3731419510,1672634677,1672637587,2910
7657,3976633198,3973560347,1672676227,1672677666,1439
7912,3520206212,3518876135,1672609402,1672612838,3436
7922,3511359172,3701184889,1672543718,1672546154,2436
7844,3392121505,3533626375,1672533288,1672535534,2246
7965,3792473331,3501483568,1672617343,1672618927,1584
7868,3501927421,3716273414,1672550881,1672552048,1167
7810,3505530961,3510937904,1672551392,1672553748,2356
7978,3427283336,3434642576,1672616369,1672617229,860
7512,3497901842,3909606423,1672541633,1672542274,641
7821,3396285984,3501364586,1672588308,1672588982,674
7703,3511170269,3834257412,1672638343,1672640667,2324
7835,3511350608,3367029997,1672585476,1672586722,1246
7796,3716197887,3505219850,1672623316,1672623924,608
7563,3505638204,3783925755,1672543625,1672544838,1213
7972,3713630656,3777455223,1672595341,1672596002,661
7976,3666506258,3394539273,1672598081,1672600519,2438
7938,3407954858,3730517636,1672703774,1672704884,1110
7554,3311871871,3475251781,1672575847,1672576612,765
7752,3520719611,3921211276,1672671045,1672672524,1479
7881,3793389510,3509907947,1672640524,1672642162,1638
7902,3713349754,3933210486,1672674808,1672675935,1127
7538,3792902982,3811171116,1672577917,1672579971,2054
7566,3757455053,3505883609,1672694472,1672695685,1213
7841,3716273414,3514838220,1672693283,1672694594,1311
7855,3716746253,3516223597,1672537906,1672540721,2815
7570,3518496488,3783705817,1672656503,1672657868,1365
7847,3606812411,3713969578,1672536495,1672537371,876
7556,3826760240,3756453423,1672656131,1672659128,2997
7829,3516016437,3519700826,1672580987,1672581574,587
7489,3777717988,3701898991,1672539140,1672542526,3386
7719,3201848640,3828432634,1672617394,1672620221,2827
7590,3500658339,3359239884,1672540737,1672544247,3510
7523,3439023335,3778549126,1672596974,1672599063,2089
7518,3249247700,3852391257,1672594668,1672596184,1516
7802,3475396323,3711262377,1672608264,1672609880,1616
7548,3777514571,3891751546,1672570946,1672574306,3360
7623,3710344260,3738274418,1672702098,1672702525,427
7596,3607748895,3607178184,1672558899,1672562138,3239
7968,3496269445,3516514391,1672643867,1672647424,3557
7743,3701691675,3338367113,1672658081,1672660792,2711
7814,3701691675,3829232696,1672562141,1672563057,916
7864,3779740455,3200198928,1672697527,1672699674,2147
7567,3313564074,3224716315,1672616271,1672619634,3363
7931,3221899927,3757562897,1672677045,1672677226,181
7634,3711380716,3978115672,1672674977,1672678087,3110
7560,3221536550,3516514391,1672665626,1672666320,694
7841,3912536808,3935627557,1672592717,1672594543,1826
7898,3932051427,3713349754,1672608716,1672610328,1612
7809,3772714862,3757161914,1672676731,1672676797,66
7594,3910886626,3613995936,1672571853,1672575087,3234
7940,3757602960,3922337974,1672654936,1672658504,3568
7958,3701146057,3287105466,1672534228,1672534500,272
7695,3516909237,3467773920,1672562976,1672564862,1886
7845,3517459919,3533371364,1672589465,1672590171,706
7662,3311065516,3428964059,1672562347,1672565500,3153
7903,3634995491,3912262917,1672686354,1672687120,766
7881,3509604974,3715998609,1672574675,1672576334,1659
7955,3365830990,3284832486,1672611560,1672613744,2184
7915,3224716315,3488244966,1672684043,1672685769,1726
7878,3500729955,3520719611,1672683297,1672683659,362
7810,3311993075,3458539365,1672683916,1672686189,2273
7884,3791594391,3801089989,1672568387,1672570381,1994
7875,3757562897,3772359096,1672597995,1672600420,2425
7871,3791942683,3880285638,1672655542,1672658743,3201
7969,3756021689,3501955238,1672543690,1672544030,340
7534,3770101921,3383661227,1672612257,1672612692,435
7937,3735319397,3715998609,1672625185,1672627529,2344
7979,3342131135,3618045231,1672679935,1672680245,310
7528,3511312803,3206593906,1672627521,1672630128,2607
7589,3519700826,3808324264,1672700267,1672701914,1647
7905,3379589402,3836573197,1672599702,1672601115,1413
7590,3836573197,3358871377,1672595531,1672596354,823
7677,3296471982,3716165213,1672616016,1672617744,1728
7865,3778341199,3777717988,1672631872,1672632455,583
7748,3519703355,3774339795,1672617022,1672617726,704
7554,3518669703,3736229191,1672574370,1672574934,564
7978,3520376528,3516980378,1672683862,1672686889,3027
7968,3774204963,3760294205,1672569215,1672572112,2897
7584,3501927421,3284832486,1672628107,1672629470,1363
7737,3383922351,3374559242,1672572339,1672574663,2324
7551,3773950140,3501364586,1672603101,1672604206,1105
7581,3639847263,3792768129,1672554672,1672555010,338
7890,3513164386,3701190899,1672585836,1672588582,2746
7797,3383661227,3826759140,1672585818,1672587299,1481
7790,3774045700,3247780536,1672630559,1672632141,1582
7853,3505530961,3518496488,1672569363,1672571974,2611
7854,3515860749,3731419510,1672644584,1672646897,2313
7674,3826760240,3808324264,1672664137,1672667689,3552
7857,3715189301,3510247121,1672641901,1672644745,2844
7823,3520629279,3517864478,1672557145,1672558394,1249
7543,3513454145,3480687894,1672661443,1672664561,3118
7602,3311154569,3482405588,1672549393,1672551821,2428
7504,3780593036,3805292782,1672570550,1672573753,3203
7636,3318697153,3501606184,1672633589,1672634407,818
7957,3377766165,3345207877,1672598831,1672599005,174
7720,3607748895,3475396323,1672687467,1672690268,2801
7776,3519703355,3519703355,1672683585,1672686648,3063
7511,3625274012,3516011407,1672554775,1672554959,184
7941,3438645253,3791942683,1672631137,1672634067,2930
7959,3311845971,3311761694,1672569433,1672571086,1653
7817,3733189298,3510703546,1672656332,1672659537,3205
7775,3370636709,3477375368,1672585005,1672587383,2378
7898,3703718151,3533280269,1672578662,1672580038,1376
7770,3396086535,3220716272,1672593491,1672594094,603
7594,3757151210,3208844525,1672698609,1672702179,3570
7516,3552314511,3500177712,1672604821,1672606777,1956
7503,3757682496,3925402713,1672564638,1672566652,2014
7620,3760183458,3791334389,1672669387,1672672428,3041
7631,3478194807,3453729665,1672579837,1672580780,943
7648,3634786711,3223968713,1672648381,1672648958,577
7540,3855602893,3311718847,1672635705,1672638243,2538
7555,3513164386,3772544062,1672617930,1672620571,2641
7878,3223968713,3613683164,1672701175,1672702317,1142
7647,3755625324,3432665384,1672697715,1672698671,956
7824,3533242305,3772714862,1672618216,1672619971,1755
7881,3925620998,3247428249,1672540913,1672543071,2158
7959,3912536808,3512349371,1672567931,1672570468,2537
7497,3736790081,3756424865,1672557624,1672558426,802
7551,3291227780,3774520233,1672652060,1672652841,781
7924,3826415738,3485375593,1672550625,1672551305,680
7691,3756462516,3534729133,1672569597,1672569663,66
7752,3701863557,3855602893,1672592860,1672594204,1344
7910,3512720680,3925402713,1672554139,1672555550,1411
7804,3273500349,3518260334,1672682340,1672685031,2691
7538,3420432297,3509453566,1672534747,1672537457,2710
7949,3852595551,3770101921,1672609138,1672612204,3066
7629,3917088658,3710098970,1672623790,1672626299,2509
7724,3284639858,3512567240,1672693371,1672696146,2775
7686,3770101921,3407954858,1672691187,1672694402,3215
7568,3895562476,3311415018,1672615805,1672616598,793
7867,3221899927,3895562476,1672557539,1672560508,2969
7763,3388637594,3485008994,1672684008,1672684577,569
7533,3780828689,3901877072,1672663439,1672663739,300
7966,3730517636,3618873142,1672649111,1672649733,622
7498,3783779671,3519803045,1672611208,1672611530,322
7615,3511687358,3776338577,1672624630,1672627861,3231
7603,3778308417,3770021824,1672560902,1672563035,2133
7846,3519556068,3778266283,1672699840,1672701008,1168
7907,3515723720,3223968713,1672658820,1672659739,919
7744,3829319703,3516960534,1672692568,1672694489,1921
7851,3890149705,3421127249,1672655543,1672656570,1027
7562,3344364444,3519654779,1672567933,1672571414,3481
7692,3773598056,3235635976,1672661373,1672663516,2143
7563,3701498253,3628819436,1672586399,1672587895,1496
7883,3731419510,3808324264,1672630223,1672630583,360
7911,3277939457,3614238812,1672608257,1672610591,2334
7922,3625274012,3511163800,1672599636,1672602169,2533
7873,3774580701,3792883665,1672694831,1672696175,1344
7839,3433804879,3501483568,1672571407,1672574176,2769
7887,3710112546,3373384732,1672610153,1672610723,570
7784,3770447408,3739106581,1672553693,1672556282,2589
7491,3471220483,3247815299,1672578586,1672580879,2293
7712,3235287260,3736592744,1672673875,1672674240,365
7756,3610348516,3518014404,1672551616,1672554335,2719
7523,3533810360,3318697153,1672581760,1672582811,1051
7553,3777929708,3399433690,1672650417,1672651794,1377
7564,3412825109,3816853177,1672574754,1672576925,2171
7757,3202120784,3311154569,1672538765,1672542027,3262
7496,3757562897,3418534998,1672616181,1672618036,1855
7778,3406784491,3792288302,1672681092,1672681316,224
7890,3465202715,3682061100,1672557666,1672561131,3465
7723,3885897503,3404384505,1672643298,1672644896,1598
7641,3334033993,3482405588,1672568405,1672571758,3353
7669,3614238812,3505904952,1672591653,1672594198,2545
7636,3505873261,3664170666,1672680014,1672681719,1705
7882,3736790081,3465254146,1672593429,1672596124,2695
7601,3891751546,3505135325,1672619237,1672619559,322
7550,3755881905,3420700674,1672564787,1672566992,2205
7604,3735319397,3774366875,1672559763,1672560402,639
7702,3622054816,3505912939,1672540054,1672541286,1232
7490,3792902982,3783925755,1672670514,1672671064,550
7721,3772337814,3776513891,1672555248,1672556397,1149
7954,3489962019,3791942683,1672594353,1672595358,1005
7963,3885670556,3416241005,1672676946,1672679319,2373
7677,3348261553,3772337814,1672544818,1672545648,830
7808,3512540951,3316173088,1672547014,1672547091,77
7514,3311761694,3703789494,1672655380,1672658209,2829
7561,3778308417,3935127663,1672598666,1672599585,919
7913,3338703270,3384951177,1672603628,1672605380,1752
7489,3783083229,3500229033,1672552105,1672553703,1598
7495,3513201436,3816454165,1672641778,1672645324,3546
7813,3629935998,3716165213,1672611859,1672613636,1777
7742,3600647945,3399911573,1672565960,1672566703,743
7581,3731419510,3284639858,1672578275,1672579707,1432
7787,3395152943,3520730271,1672684621,1672686100,1479
7962,3248507722,3533810360,1672621486,1672622097,611
7692,3683766533,3337544549,1672565953,1672566394,441
7892,3511271692,3291883916,1672647150,1672649990,2840
7532,3510969660,3519556068,1672594544,1672594718,174
7781,3520756859,3783239924,1672590555,1672592419,1864
7511,3416265063,3889750851,1672539642,1672541782,2140
7765,3921211276,3417061462,1672563525,1672566090,2565
7735,3202120784,3817316561,1672557577,1672559056,1479
7591,3783196518,3509604974,1672607234,1672609331,2097
7663,3918674986,3880310724,1672647349,1672650820,3471
7776,3613995936,3711973519,1672585790,1672588453,2663
7679,3703735129,3606186086,1672594587,1672595172,585
7764,3517255726,3683959482,1672593847,1672596179,2332
7642,3518014636,3793286136,1672540946,1672543774,2828
7534,3512567240,3400918687,1672654689,1672657482,2793
7647,3617055293,3730517636,1672594628,1672596926,2298
7907,3760992710,3533095755,1672643893,1672645119,1226
7565,3511312803,3302626661,1672555083,1672555675,592
7696,3384240055,3517721725,1672622031,1672622246,215
7822,3518791447,3477649378,1672643915,1672645526,1611
7565,3716537575,3930791338,1672595727,1672597870,2143
7975,3224716315,3792668962,1672624983,1672628392,3409
7856,3510969660,3311603601,1672675417,1672678724,3307
7542,3716273414,3505599848,1672681447,1672682334,887
7621,3618873142,3289061738,1672624465,1672626891,2426
7682,3783083229,3280964728,1672571719,1672571783,64
7680,3777790718,3701691675,1672538252,1672538972,720
7561,3311090974,3756966035,1672700667,1672702696,2029
7867,3520190170,3501759100,1672557300,1672559532,2232
7713,3500229033,3731419510,1672682608,1672683141,533
7752,3516716179,3346795719,1672700640,1672700725,85
7530,3890149705,3360743849,1672560698,1672561318,620
7728,3777983879,3311152102,1672648489,1672649782,1293
7598,3621497531,3533385867,1672689448,1672690128,680
7710,3779218771,3505219850,1672645142,1672647029,1887
7872,3760183458,3516258476,1672656133,1672656375,242
7515,3293695955,3825229501,1672677836,1672679634,1798
7527,3757562897,3370752401,1672578618,1672579980,1362
7889,3510247121,3475258557,1672627028,1672627270,242
7555,3505203158,3201432789,1672540290,1672541475,1185
7716,3880310724,3780639480,1672555245,1672558675,3430
7792,3615046771,3304056063,1672565013,1672566583,1570
7751,3428674539,3496051529,1672645983,1672648092,2109
7814,3500229033,3615046771,1672655415,1672656593,1178
7613,3737051610,3739106581,1672682064,1672683541,1477
7732,3827377568,3883042241,1672542680,1672545091,2411
7547,3772884106,3424922204,1672632891,1672634676,1785
7954,3703013906,3533385867,1672572617,1672576145,3528
7548,3666553782,3511435497,1672630725,1672634191,3466
7747,3451432842,3489545239,1672584273,1672585599,1326
7822,3776513891,3514987389,1672664304,1672666850,2546
7554,3662180254,3772337814,1672552847,1672554237,1390
7520,3777776687,3624312512,1672533570,1672533693,123
7639,3516716179,3428674539,1672658326,1672658934,608
7885,3935127663,3757602960,1672683130,1672686446,3316
7686,3885670556,3918056059,1672664605,1672665501,896
7655,3344364444,3357483218,1672655208,1672655579,371
7769,3500060260,3711569060,1672689197,1672691365,2168
7676,3793962300,3734496778,1672580863,1672582537,1674
7509,3273500349,3926700506,1672577070,1672579577,2507
7970,3736592744,3710344260,1672676488,1672676652,164
7839,3823600322,3931941795,1672663023,1672666623,3600
7551,3380035798,3428964059,1672608207,1672610009,1802
7491,3755798867,3774125065,1672619498,1672620450,952
7847,3774556560,3755587522,1672641457,1672643841,2384
7800,3732481297,3701863557,1672654349,1672655962,1613
7732,3534191820,3475258557,1672584246,1672586715,2469
7772,3481647420,3756027749,1672675745,1672677289,1544
7907,3511359172,3289061738,1672635035,1672635726,691
7688,3496269445,3778108318,1672604262,1672606382,2120
7852,3826415738,3701534009,1672619642,1672621741,2099
7701,3625274012,3512142794,1672586922,1672587036,114
7497,3512720680,3451432842,1672649058,1672649709,651
7647,3616944364,3757447189,1672626266,1672628725,2459
7741,3417970574,3416241005,1672647201,1672649986,2785
7525,3344019610,3518669703,1672611467,1672614585,3118
7789,3826760240,3512567240,1672543617,1672546784,3167
7608,3715492942,3701534009,1672691737,1672694533,2796
7823,3711370563,3379256399,1672579523,1672580230,707
7834,3715189301,3773978034,1672576509,1672578043,1534
7781,3889232789,3716488385,1672626789,1672629188,2399
7542,3512349371,3516065852,1672579677,1672582446,2769
7701,3318697153,3516016437,1672638635,1672640802,2167
7764,3883551721,3512969370,1672619048,1672621267,2219
7823,3834257412,3291235378,1672554281,1672557162,2881
7494,3615046771,3421836608,1672677940,1672678562,622
7594,3244389794,3428964059,1672694386,1672696527,2141
7851,3701274634,3783509527,1672598283,1672601127,2844
7612,3505201246,3755872268,1672657954,1672660958,3004
7775,3760561634,3533810360,1672536830,1672538783,1953
7498,3311152102,3882997884,1672551386,1672553124,1738
7874,3493507965,3229665776,1672542752,1672544444,1692
7686,3465202715,3736786443,1672604744,1672605573,829
7714,3791874383,3475795792,1672679758,1672680303,545
7929,3244436890,3337544549,1672672132,1672675085,2953
7501,3520376528,3819727225,1672660124,1672662506,2382
7800,3836573197,3512510536,1672676864,1672679966,3102
7848,3770447408,3777806071,1672597817,1672599175,1358
7495,3791874383,3515284591,1672554720,1672556706,1986
7643,3716165213,3772884106,1672692459,1672694467,2008
7809,3395152943,3772359096,1672651684,1672654373,2689
7817,3311154569,3344364444,1672585106,1672585300,194
7670,3367029997,3427219654,1672639483,1672641147,1664
7686,3359239884,3492478793,1672681986,1672685287,3301
7946,3520376528,3979339287,1672591391,1672591796,405
7598,3780609808,3534424200,1672535526,1672538662,3136
7489,3739106581,3424922204,1672662693,1672664428,1735
7850,3778266283,3819727225,1672543187,1672545268,2081
7573,3806545488,3247428249,1672604119,1672607516,3397
7540,3806545488,3357483218,1672559875,1672561203,1328
7613,3772544062,3510247121,1672685130,1672687598,2468
7752,3234541252,3626156564,1672536260,1672538351,2091
7545,3883042241,3604539807,1672664257,1672667738,3481
7727,3624312512,3480687894,1672687491,1672689708,2217
7619,3713969578,3505477652,1672669458,1672670138,680
7715,3770851318,3774580701,1672678866,1672680945,2079
7849,3755436115,3500374658,1672531858,1672534337,2479
7663,3555214688,3713349754,1672585153,1672586894,1741
7851,3855602893,3316173088,1672650250,1672650667,417
7930,3510247121,3639847263,1672637323,1672640543,3220
7685,3451432842,3384240055,1672635004,1672636225,1221
7897,3859663348,3791997875,1672537529,1672539833,2304
7703,3417061462,3736625083,1672654605,1672657968,3363
7773,3428006164,3911245524,1672648956,1672649194,238
7860,3514838220,3511435497,1672580214,1672583633,3419
7564,3370752401,3685818092,1672570237,1672570882,645
7918,3780294829,3736790081,1672597809,1672601304,3495
7504,3500499542,3812176780,1672574457,1672576157,1700
7752,3757161914,3485823740,1672685744,1672688002,2258
7767,3710067113,3510126867,1672660109,1672663411,3302
7503,3238712269,3778305740,1672629838,1672633063,3225
7767,3518932404,3360993964,1672560587,1672562608,2021
7917,3835382117,3337544549,1672688213,1672689738,1525
7638,3519556068,3820354437,1672566665,1672567069,404
7711,3757602960,3311065516,1672557457,1672558071,614
7927,3783206719,3348261553,1672615138,1672616844,1706
7923,3776066388,3360506772,1672611990,1672613238,1248
7720,3820354437,3416427576,1672680401,1672681949,1548
7974,3713268590,3822654369,1672680387,1672683202,2815
7775,3209383861,3516223597,1672647879,1672651052,3173
7843,3791334389,3805347939,1672543934,1672547080,3146
7536,3534488837,3277669002,1672613951,1672614499,548
7697,3682061100,3505292701,1672551398,1672554190,2792
7578,3701178711,3505201246,1672655460,1672657072,1612
7772,3514987389,3777717988,1672625534,1672626061,527
7750,3406784491,3416265063,1672682117,1672684830,2713
7800,3518408774,3783239924,1672657097,1672658968,1871
7531,3827222533,3510594211,1672629738,1672631164,1426
7659,3710344260,3666457294,1672616360,1672617893,1533
7557,3713644518,3514987389,1672633035,1672633624,589
7848,3520012395,3505599848,1672590844,1672593948,3104
7970,3783206719,3559110998,1672600705,1672600994,289
7628,3505883609,3628819436,1672647917,1672649417,1500
7831,3778780511,3349613093,1672538825,1672542026,3201
7526,3373384732,3611150562,1672623891,1672625622,1731
7918,3509453566,3415546117,1672605237,1672606293,1056
7875,3812176780,3777790718,1672661402,1672661852,450
7873,3791334389,3515723720,1672588999,1672589306,307
7973,3520165601,3533280269,1672591712,1672594405,2693
7976,3774050956,3701146057,1672537884,1672539244,1360
7546,3360993964,3500729955,1672578814,1672579138,324
7881,3490191091,3417061462,1672563366,1672564923,1557
7741,3760561634,3858918246,1672673567,1672675561,1994
7892,3757151210,3307512479,1672644298,1672645623,1325
7620,3757161914,3501184421,1672612052,1672614231,2179
7613,3772544062,3827222533,1672576290,1672578937,2647
7568,3533280269,3459030804,1672662917,1672664224,1307
7929,3859525941,3817316561,1672560275,1672561578,1303
7950,3518496488,3756453423,1672536652,1672539139,2487
7671,3711308224,3296471982,1672549093,1672552584,3491
7672,3276640712,3688418210,1672552770,1672553498,728
7662,3556951786,3936227020,1672569105,1672570222,1117
7936,3485823740,3715189301,1672600809,1672603000,2191
7607,3757602960,3613995936,1672536952,1672538164,1212
7726,3222448362,3400804807,1672562214,1672564961,2747
7669,3777443199,3500374658,1672575424,1672578379,2955
7953,3533748232,3793470489,1672685248,1672686129,881
7681,3811171116,3780609808,1672622606,1672624558,1952
7676,3387966152,3519912874,1672531865,1672534711,2846
7679,3780788622,3505173328,1672543698,1672544681,983
7819,3505635228,3855000166,1672701916,1672704080,2164
7779,3505362057,3760267716,1672562674,1672563752,1078
7886,3688683847,3333896808,1672531280,1672532799,1519
7916,3505477652,3501927421,1672574400,1672576588,2188
7827,3777776687,3805292782,1672540914,1672543200,2286
7650,3520165601,3510380060,1672552594,1672555619,3025
7629,3430352815,3496051529,1672533420,1672536334,2914
7747,3736786443,3792032359,1672670949,1672671707,758
7849,3279721246,3715974031,1672631001,1672632220,1219
7633,3303705369,3783925755,1672614850,1672615059,209
7818,3716835696,3388286531,1672578489,1672578680,191
7750,3247815299,3778549126,1672691948,1672692448,500
7922,3624312512,3501759100,1672556302,1672559592,3290
7643,3458539365,3703871468,1672547078,1672548390,1312
7962,3516716179,3331845324,1672628680,1672629137,457
7793,3809484172,3533927138,1672610717,1672613400,2683
7516,3409474775,3904775198,1672666612,1672669115,2503
7624,3513080274,3509634629,1672535899,1672538773,2874
7913,3917278625,3770635361,1672642625,1672643340,715
7876,3811694763,3813052709,1672693931,1672695668,1737
7632,3401627165,3454042520,1672570170,1672570885,715
7604,3883861463,3396285984,1672630120,1672630896,776
7927,3807987001,3776948966,1672647910,1672651276,3366
7616,3500487333,3509352754,1672640103,1672643017,2914
7903,3518014404,3520629279,1672686499,1672686938,439
7706,3307512479,3434642576,1672663456,1672666809,3353
7517,3701190899,3779976989,1672691535,1672693330,1795
7636,3391261292,3489962019,1672607898,1672609528,1630
7638,3756601594,3774298222,1672654148,1672655367,1219
7832,3297463265,3715581279,1672582454,1672584311,1857
7677,3513454145,3851190615,1672611510,1672611736,226
7570,3490191091,3912262917,1672601149,1672602208,1059
7836,3485823740,3757403279,1672640900,1672641004,104
7878,3772884106,3432689543,1672638404,1672639353,949
7645,3774520233,3511435497,1672697750,1672698686,936
7646,3509453566,3512837326,1672681757,1672683079,1322
7555,3780974443,3770021824,1672569213,1672571817,2604
7492,3792844210,3912262917,1672698324,1672699497,1173
7900,3823600322,3333896808,1672678075,1672679772,1697
7954,3792844210,3307512479,1672668953,1672671286,2333
7694,3518163778,3716168623,1672645340,1672647818,2478
7861,3516909237,3710067113,1672544841,1672548382,3541
7921,3773465237,3235635976,1672644878,1672646807,1929
7829,3859663348,3711569060,1672674402,1672677515,3113
7745,3319752091,3428964059,1672650750,1672654018,3268
7645,3489962019,3755881905,1672650509,1672651134,625
7780,3223968713,3360506772,1672604765,1672608352,3587
7853,3471220483,3777936328,1672628157,1672629531,1374
7493,3516629436,3500994774,1672682953,1672686423,3470
7819,3904408902,3715998609,1672681555,1672683531,1976
7636,3701111745,3636867411,1672555807,1672557933,2126
7747,3533242305,3519912874,1672628562,1672630405,1843
7779,3853018906,3611150562,1672597052,1672599725,2673
7776,3778308417,3511350608,1672565012,1672566663,1651
7699,3770553384,3559110998,1672642114,1672645487,3373
7645,3515691540,3513956646,1672612051,1672615391,3340
7792,3533827120,3802367797,1672700045,1672703548,3503
7897,3711198793,3780788622,1672671910,1672673636,1726
7564,3501483568,3430074045,1672580244,1672583707,3463
7682,3209383861,3510937904,1672587977,1672589693,1716
7867,3505873261,3399433690,1672596373,1672596731,358
7559,3511267139,3511332835,1672598716,1672601940,3224
7940,3500365158,3793436995,1672703188,1672704191,1003
7766,3427283336,3776066388,1672656155,1672658964,2809
7637,3703871468,3516039895,1672533475,1672534588,1113
7928,3713268590,3201848640,1672539118,1672541799,2681
7888,3637008488,3500994774,1672609166,1672609549,383
7541,3703013906,3791901535,1672562244,1672563925,1681
7547,3837094550,3533748232,1672662544,1672664416,1872
7691,3791020967,3505362057,1672628680,1672632135,3455
7928,3501198706,3534424200,1672655707,1672659079,3372
7663,3516011407,3617055293,1672688029,1672689305,1276
7856,3509933351,3778266283,1672572507,1672575808,3301
7649,3511862351,3520165601,1672644798,1672645449,651
7896,3664170666,3801089989,1672568227,1672569838,1611
7840,3701190899,3278365525,1672609114,1672609323,209
7809,3284832486,3515394721,1672587402,1672589941,2539
7581,3514283243,3288764520,1672689674,1672690331,657
7936,3201432789,3757602960,1672682687,1672686102,3415
7800,3783779671,3792032359,1672677049,1672680177,3128
7928,3774793839,3979339287,1672532128,1672535278,3150
7921,3904775198,3780914982,1672636077,1672636756,679
7726,3777936328,3383922351,1672699649,1672700863,1214
7871,3311203656,3314245084,1672589583,1672590393,810
7749,3505635228,3701178711,1672531674,1672534274,2600
7835,3610348516,3826633236,1672615620,1672617563,1943
7539,3534702203,3701691675,1672576043,1672579265,3222
7980,3715189301,3224716315,1672631672,1672633369,1697
7602,3466229085,3312829208,1672602942,1672604856,1914
7528,3715339701,3513599775,1672573849,1672576931,3082
7640,3770021824,3777936328,1672601013,1672601191,178
7742,3352603894,3935127663,1672628421,1672630317,1896
7504,3279721246,3298288268,1672536484,1672539316,2832
7973,3800886801,3935627557,1672640971,1672643441,2470
7540,3606186086,3379256399,1672652816,1672655978,3162
7483,3404058699,3932051427,1672677358,1672677425,67
7888,3777983879,3512567240,1672695358,1672698099,2741
7520,3935127663,3701146057,1672619238,1672619740,502
7510,3703275621,3757562897,1672546984,1672550083,3099
7647,3701190899,3516223597,1672566379,1672569483,3104
7630,3912536808,3757403279,1672572267,1672574458,2191
7772,3534492426,3791997875,1672667532,1672670238,2706
7817,3451432842,3783239924,1672659097,1672659337,240
7725,3760183458,3918674986,1672577918,1672581171,3253
7896,3859525941,3703223015,1672603140,1672604943,1803
7794,3519556068,3910454786,1672665811,1672666384,573
7896,3930797455,3501692334,1672574660,1672575460,800
7797,3390068992,3734737881,1672638016,1672639795,1779
7942,3387966152,3772053179,1672598486,1672599665,1179
7553,3516909237,3930797455,1672698371,1672699883,1512
7664,3276993580,3500066230,1672690592,1672692812,2220
7586,3783429780,3755920131,1672674039,1672677293,3254
7904,3304056063,3911245524,1672616609,1672618952,2343
7838,3505873261,3418728074,1672568653,1672569035,382
7803,3421836608,3732481297,1672607114,1672607468,354
7667,3430074045,3394539273,1672533225,1672536675,3450
7751,3755392666,3736790081,1672618875,1672622106,3231
7757,3703735129,3835382117,1672632643,1672634355,1712
7851,3291235378,3760294205,1672574278,1672577636,3358
7755,3533193862,3701691675,1672596819,1672598879,2060
7922,3304625412,3774204963,1672627734,1672630631,2897
7679,3377766165,3918056059,1672679611,1672681602,1991
7785,3901990690,3344019610,1672680596,1672684066,3470
7919,3390068992,3711571712,1672546347,1672547139,792
7552,3898995675,3883312122,1672543604,1672544696,1092
7628,3500729955,3510771358,1672551695,1672551775,80
7878,3298433163,3505859863,1672692037,1672693754,1717
7808,3400804807,3511267139,1672616720,1672620186,3466
7845,3703223015,3277669002,1672669935,1672672786,2851
7929,3683766533,3406784491,1672552498,1672552576,78
7690,3242408357,3406784491,1672672008,1672673449,1441
7845,3432689543,3346795719,1672637991,1672640528,2537
7754,3793627961,3510771358,1672701304,1672704436,3132
7703,3311415018,3510969660,1672555832,1672556106,274
7902,3711571712,3501927421,1672539299,1672541631,2332
7981,3534492426,3303751772,1672558460,1672560443,1983
7810,3485375593,3496051529,1672597898,1672600353,2455
7553,3713268590,3780503655,1672627048,1672628731,1683
7783,3890149705,3519069599,1672613961,1672616019,2058
7972,3791334389,3316173088,1672609103,1672609452,349
7799,3792288302,3835382117,1672590468,1672594067,3599
7514,3311154569,3550946908,1672675963,1672677020,1057
7492,3433804879,3485375593,1672672225,1672674508,2283
7848,3500177712,3912536808,1672591898,1672593224,1326
7816,3518014404,3511841857,1672675045,1672675840,795
7750,3518496488,3757455053,1672683711,1672684406,695
7886,3516039895,3976390453,1672613729,1672616879,3150
7939,3501730685,3510247121,1672549659,1672550474,815
7519,3773429448,3802367797,1672548566,1672550948,2382
7690,3224058172,3979339287,1672599410,1672600429,1019
7711,3608868877,3533810360,1672678983,1672680689,1706
7972,3511841857,3730517636,1672547037,1672547933,896
7660,3777806071,3791594391,1672536482,1672539987,3505
7600,3756966035,3391261292,1672687028,1672690326,3298
7755,3918584946,3774556560,1672678972,1672681227,2255
7608,3711973519,3756021689,1672591942,1672592421,479
7577,3505219850,3736229191,1672671505,1672672716,1211
7629,3311090974,3809916577,1672681766,1672683523,1757
7648,3513201436,3710067113,1672664142,1672664367,225
7493,3791553060,3443698222,1672662722,1672663515,793
7947,3387966152,3606186086,1672542236,1672543694,1458
7690,3701984666,3500499542,1672579778,1672581844,2066
7779,3311274543,3899266183,1672542251,1672544556,2305
7757,3534702203,3755943611,1672590402,1672592022,1620
7810,3791997875,3333896808,1672562728,1672564356,1628
7974,3770763956,3519069599,1672568280,1672569863,1583
7976,3284832486,3812176780,1672636016,1672639331,3315
7496,3510703546,3500894271,1672682608,1672685073,2465
7781,3304056063,3370752401,1672573283,1672574785,1502
7609,3277669002,3519069599,1672645418,1672648509,3091
7805,3776338577,3791874383,1672563194,1672566767,3573
7759,3279721246,3760267716,1672654665,1672657540,2875
7804,3489217083,3518260334,1672598031,1672601473,3442
7834,3755881905,3791594391,1672569356,1672572764,3408
7900,3773755137,3714821932,1672693093,1672696381,3288
7789,3516606733,3206593906,1672534711,1672537828,3117
7534,3736790081,3774204963,1672543234,1672543479,245
7633,3833889105,3534424200,1672658027,1672658609,582
7911,3713786889,3344019610,1672693277,1672694482,1205
7580,3935627557,3334033993,1672606826,1672608634,1808
7649,3515860749,3383922351,1672639804,1672641333,1529
7975,3489217083,3777717988,1672665888,1672668644,2756
7890,3489545239,3716843669,1672674374,1672676161,1787
7785,3420432297,3416265063,1672614165,1672615025,860
7744,3755881905,3715189301,1672552914,1672554018,1104
7753,3778108318,3715339701,1672635533,1672638920,3387
7750,3312829208,3802367797,1672593407,1672594429,1022
7873,3625274012,3703889596,1672571693,1672575080,3387
7660,3832902928,3511359172,1672539918,1672540230,312
7553,3624312512,3387966152,1672551164,1672553090,1926
7927,3922275416,3276993580,1672563992,1672564953,961
7510,3791942683,3772309166,1672626597,1672628094,1497
7835,3500487333,3222448362,1672552638,1672553258,620
7695,3777717988,3736790081,1672654332,1672656660,2328
7891,3519654779,3391915121,1672685733,1672686472,739
7761,3509352754,3206593906,1672660287,1672663158,2871
7571,3701190899,3780639480,1672592556,1672594207,1651
7847,3772309150,3400804807,1672671123,1672674292,3169
7716,3792473331,3505649239,1672578439,1672581230,2791
7807,3774556560,3685818092,1672645617,1672648074,2457
7700,3505201246,3736790081,1672548445,1672551079,2634
7754,3777514571,3236102733,1672590396,1672591658,1262
7897,3901877072,3783083229,1672560883,1672563626,2743
7740,3313541986,3476232529,1672564125,1672567261,3136
7525,3288764520,3388372715,1672667395,1672668260,865
7796,3496051529,3829319703,1672608690,1672610092,1402
7810,3505635228,3311871871,1672625826,1672626268,442
7559,3792844210,3883042241,1672586259,1672587791,1532
7489,3311274543,3369998498,1672597600,1672599274,1674
7912,3760598102,3501606184,1672627086,1672627150,64
7915,3351008918,3400918687,1672691879,1672695169,3290
7702,3783126683,3520165601,1672629577,1672632864,3287
7750,3533025282,3505193212,1672553174,1672554590,1416
7954,3404058699,3520756859,1672570665,1672572155,1490
7690,3664170666,3298288268,1672657527,1672659275,1748
7506,3911245524,3348261553,1672543069,1672544517,1448
7856,3776513891,3621497531,1672671344,1672672504,1160
7618,3520183192,3249247700,1672607428,1672608322,894
7826,3433804879,3373384732,1672533679,1672536827,3148
7775,3500365158,3369998498,1672586946,1672588543,1597
7930,3500391167,3755739653,1672686757,1672687104,347
7528,3421836608,3518360734,1672633190,1672634383,1193
7645,3505145247,3345207877,1672597459,1672599090,1631
7610,3774366875,3773814927,1672677074,1672680610,3536
7900,3622054816,3739106581,1672659943,1672660921,978
7701,3772337814,3500904641,1672547377,1672548665,1288
7760,3792789881,3783196518,1672567931,1672570277,2346
7511,3287105466,3509933351,1672607446,1672607985,539
7975,3344364444,3505791599,1672620139,1672620913,774
7640,3615046771,3458539365,1672557921,1672558983,1062
7850,3483949762,3755436115,1672665086,1672666229,1143
7813,3714488548,3407954858,1672533902,1672536196,2294
7738,3715339701,3901990690,1672627977,1672630997,3020
7970,3774339795,3311648200,1672694103,1672697209,3106
7594,3520206212,3809059934,1672691902,1672693435,1533
7707,3715189301,3387966152,1672531225,1672533440,2215
7792,3517963492,3815508790,1672563704,1672565033,1329
7968,3465202715,3791115967,1672695040,1672696154,1114
7750,3533385867,3407954858,1672567911,1672570488,2577
7546,3311627628,3519601612,1672566088,1672569361,3273
7789,3206593906,3311761694,1672632169,1672634549,2380
7588,3703718151,3505702787,1672590210,1672593022,2812
7739,3666553782,3505000737,1672597010,1672597886,876
7868,3484995752,3756453423,1672683097,1672683628,531
7847,3614238812,3770553384,1672686913,1672687555,642
7550,3826759140,3613995936,1672661677,1672661897,220
7966,3229058858,3703275621,1672658324,1672661062,2738
7910,3314836094,3760509236,1672552012,1672554033,2021
7510,3807987001,3391261292,1672654475,1672655141,666
7633,3792177074,3777120536,1672549753,1672552694,2941
7914,3783531004,3703661585,1672676366,1672677356,990
7858,3348261553,3209048907,1672575185,1672575471,286
7792,3360743849,3711262377,1672672864,1672675101,2237
7701,3777455223,3904408902,1672674641,1672677365,2724
7777,3755042098,3505791599,1672621383,1672622952,1569
7520,3773205565,3760992710,1672590654,1672593451,2797
7764,3918056059,3756601594,1672542804,1672545261,2457
7757,3485823740,3202120784,1672648946,1672652103,3157
7485,3880285638,3367029997,1672603545,1672605064,1519
7627,3248507722,3756623396,1672674349,1672676756,2407
7645,3703955926,3421836608,1672666798,1672668920,2122
7956,3247780536,3311845971,1672536266,1672537258,992
7664,3713644518,3828365570,1672571560,1672575133,3573
7680,3518163778,3713630656,1672615110,1672618393,3283
7506,3514987389,3858918246,1672559881,1672560852,971
7575,3518408774,3518408774,1672690488,1672693459,2971
7832,3881477378,3511841857,1672665431,1672666294,863
7834,3792288302,3221536550,1672650242,1672653211,2969
7547,3685818092,3911245524,1672574139,1672575100,961
7595,3303705369,3485008994,1672685122,1672688040,2918
7715,3505173328,3351554343,1672585367,1672588274,2907
7652,3520030713,3772053179,1672540593,1672543285,2692
7895,3703275621,3783925755,1672536959,1672540300,3341
7778,3601879040,3756601594,1672614168,1672615829,1661
7884,3374559242,3518260334,1672697493,1672699874,2381
7924,3234541252,3774556560,1672689298,1672689970,672
7589,3307097200,3244436890,1672628054,1672628830,776
7976,3711265369,3793962300,1672545978,1672547511,1533
7961,3792902982,3780813786,1672658228,1672660373,2145
7859,3244485293,3379589402,1672676627,1672677463,836
7513,3247815299,3518260334,1672688954,1672691389,2435
7922,3466229085,3511841857,1672581173,1672584494,3321
7822,3805342762,3937224533,1672568578,1672569454,876
7503,3404384505,3505638204,1672574478,1672577745,3267
7650,3826415738,3533025282,1672698312,1672700081,1769
7565,3736229191,3520030713,1672610228,1672612998,2770
7627,3490191091,3311761694,1672642415,1672644712,2297
7795,3279721246,3774298222,1672654585,1672656838,2253
7614,3779976989,3417970574,1672613706,1672614943,1237
7756,3780294829,3234362962,1672666600,1672668805,2205
7900,3475258557,3361230905,1672643876,1672646300,2424
7652,3805347939,3512969370,1672542751,1672542865,114
7615,3515691540,3512720680,1672552909,1672554173,1264
7595,3510937904,3284832486,1672598416,1672599761,1345
7735,3757602960,3278365525,1672692516,1672693900,1384
7857,3909238838,3555214688,1672565557,1672568771,3214
7842,3780828689,3399052055,1672587716,1672590866,3150
7552,3511862351,3716273414,1672603436,1672604847,1411
7896,3925402713,3511312803,1672639555,1672640412,857
7575,3855602893,3516039895,1672631349,1672634469,3120
7519,3344019610,3480687894,1672534244,1672536563,2319
7611,3505702787,3666506258,1672682211,1672684768,2557
7483,3512969370,3792177074,1672568949,1672570106,1157
7798,3428006164,3513164386,1672649184,1672651093,1909
7890,3533371364,3511841857,1672593450,1672594511,1061
7574,3417587765,3791020967,1672615509,1672615668,159
7689,3736790081,3880285638,1672642209,1672643383,1174
7555,3517077106,3510594211,1672582798,1672585557,2759
7630,3533280269,3297463265,1672583842,1672585985,2143
7498,3360506772,3792902982,1672685396,1672685648,252
7732,3234362962,3314836094,1672619206,1672621332,2126
7814,3505635228,3316173088,1672686191,1672686262,71
7899,3607748895,3625274012,1672595787,1672596333,546
7543,3509630174,3634340855,1672531585,1672532791,1206
7492,3757455053,3935627557,1672645283,1672647551,2268
7720,3379589402,3344364444,1672531214,1672532668,1454
7713,3511170269,3925620998,1672532565,1672535944,3379
7978,3509907947,3500365158,1672703035,1672705683,2648
7560,3701146057,3777929708,1672543780,1672545497,1717
7612,3715492942,3500994774,1672632235,1672634813,2578
7906,3520756859,3276993580,1672681850,1672682911,1061
7972,3505193212,3783509527,1672691467,1672694603,3136
7631,3406784491,3520012395,1672572984,1672573320,336
7644,3937224533,3505869747,1672625797,1672628320,2523
7916,3515723720,3235635976,1672596646,1672597154,508
7763,3773429448,3510380060,1672636214,1672639120,2906
7706,3608868877,3827626797,1672666737,1672667453,716
7844,3826633236,3820354437,1672616185,1672618317,2132
7609,3715981584,3515394721,1672625814,1672626823,1009
7910,3793962300,3391915121,1672609138,1672612629,3491
7592,3666553782,3633420270,1672619339,1672621202,1863
7642,3808324264,3346795719,1672550755,1672551493,738
7560,3933210486,3793627961,1672596298,1672598619,2321
7690,3817621391,3421127249,1672670231,1672671021,790
7758,3286658957,3512166013,1672669790,1672671436,1646
7870,3776066388,3418728074,1672616530,1672617313,783
7571,3855424474,3516629436,1672606720,1672609843,3123
7613,3932051427,3617734118,1672609249,1672610188,939
7898,3517963492,3703955926,1672682211,1672682568,357
7838,3465254146,3914290246,1672615880,1672617284,1404
7612,3610348516,3391261292,1672692266,1672692424,158
7712,3516258476,3832902928,1672531437,1672532034,597
7521,3415443558,3776513891,1672596609,1672597142,533
7621,3388286531,3488244966,1672660073,1672663321,3248
7677,3496051529,3280599164,1672617652,1672618148,496
7509,3505201246,3773755137,1672622401,1672622806,405
7764,3973560347,3756966035,1672671343,1672672026,683
7634,3779218771,3809484172,1672628596,1672630831,2235
7544,3731106822,3629935998,1672701051,1672704365,3314
7620,3629547065,3925620998,1672540974,1672543983,3009
7796,3703013906,3374559242,1672656627,1672659921,3294
7734,3613995936,3901990690,1672640304,1672643296,2992
7612,3222448362,3399535232,1672641886,1672644624,2738
7977,3756601594,3916289176,1672646090,1672648976,2886
7595,3925402713,3738502357,1672635588,1672638759,3171
7625,3505791599,3518669703,1672604199,1672607173,2974
7825,3367902229,3279721246,1672698573,1672700783,2210
7496,3439023335,3703223015,1672605192,1672607488,2296
7504,3902383721,3836573197,1672577518,1672579982,2464
7937,3432665384,3451432842,1672653175,1672656573,3398
7780,3910454786,3513599775,1672590538,1672591881,1343
7571,3519703355,3793436995,1672620553,1672621547,994
7739,3828365570,3772714862,1672617243,1672618164,921
7899,3703223015,3756462516,1672566651,1672570068,3417
7742,3813052709,3201432789,1672689145,1672690253,1108
7934,3780294829,3514472925,1672576322,1672578813,2491
7630,3359239884,3733189298,1672570861,1672572831,1970
7501,3280964728,3701995648,1672656519,1672658249,1730
7543,3777929708,3801089989,1672624781,1672627998,3217
7958,3777623166,3304056063,1672696032,1672699461,3429
7812,3412825109,3434642576,1672570250,1672573407,3157
7883,3534010629,3388372715,1672533692,1672536886,3194
7936,3400918687,3774580701,1672546568,1672549627,3059
7557,3517255726,3235287260,1672638516,1672640430,1914
7637,3494290908,3319752091,1672698580,1672700077,1497
7522,3793962300,3247780536,1672533461,1672536705,3244
7530,3515284591,3889750851,1672683176,1672685862,2686
7916,3710408395,3716537575,1672604204,1672607267,3063
7622,3489217083,3735733948,1672574918,1672577406,2488
7525,3411618230,3731106822,1672680708,1672681106,398
7844,3402943525,3827377568,1672566432,1672568194,1762
7733,3428674539,3915628728,1672638656,1672641086,2430
7660,3634786711,3311154569,1672623689,1672627083,3394
7982,3666506258,3390068992,1672595996,1672599142,3146
7723,3412825109,3737051610,1672689558,1672690074,516
7614,3556951786,3511125626,1672602500,1672604990,2490
7902,3466911760,3429856982,1672588723,1672591062,2339
7960,3500487333,3701190899,1672623099,1672626635,3536
7888,3772337814,3352603894,1672672697,1672675777,3080
7744,3344364444,3307097200,1672703355,1672705410,2055
7793,3407725581,3711571712,1672576291,1672578534,2243
7760,3304056063,3208844525,1672601507,1672602870,1363
7943,3359910781,3777079686,1672660182,1672660458,276
7871,3512837326,3434642576,1672584218,1672585289,1071
7857,3493507965,3533025282,1672562636,1672563683,1047
7750,3510247121,3715981584,1672540930,1672543182,2252
7954,3792789881,3500658339,1672541643,1672544610,2967
7755,3351008918,3209383861,1672678735,1672680104,1369
7812,3710408395,3777936328,1672537368,1672539630,2262
7516,3520165601,3755511676,1672693851,1672694577,726
7796,3533025282,3760183458,1672550003,1672550415,412
7505,3201324715,3836573197,1672611636,1672611945,309
7830,3374559242,3736790081,1672653139,1672654753,1614
7824,3774010081,3454042520,1672581451,1672581624,173
7683,3514283243,3783196518,1672535598,1672538591,2993
7766,3783705817,3304056063,1672558240,1672558533,293
7572,3400918687,3783531004,1672610034,1672613194,3160
7899,3839849341,3404384505,1672547209,1672548752,1543
7768,3311603601,3518408774,1672624721,1672627842,3121
7935,3812176780,3533280269,1672702709,1672705872,3163
7704,3247428249,3898995675,1672532938,1672534693,1755
7568,3291883916,3517077106,1672654048,1672654545,497
7543,3793962300,3484995752,1672549493,1672550000,507
7521,3778980116,3496549058,1672697404,1672697616,212
7595,3738274418,3713644518,1672634513,1672636196,1683
7497,3515151980,3520629279,1672580680,1672582840,2160
7638,3534553510,3505962865,1672621164,1672621534,370
7938,3552314511,3509672210,1672620694,1672623660,2966
7614,3770447408,3510380060,1672603202,1672603370,168
7542,3773978034,3511687358,1672689586,1672690668,1082
7873,3816454165,3714197325,1672672292,1672673374,1082
7803,3755392666,3701190899,1672673012,1672673973,961
7487,3757151210,3304056063,1672552385,1672553856,1471
7769,3805519285,3287105466,1672684317,1672684623,306
7925,3480687894,3515394721,1672578539,1672578690,151
7807,3793436995,3513599775,1672618284,1672618744,460
7718,3520706195,3701184889,1672609905,1672613401,3496
7799,3365278081,3520751702,1672536441,1672536756,315
7681,3391915121,3284832486,1672558543,1672561945,3402
7879,3855000166,3421836608,1672607273,1672609571,2298
7719,3271938399,3534191820,1672636205,1672638129,1924
7634,3703441914,3510937904,1672694751,1672697782,3031
7778,3760893269,3904775198,1672542253,1672544007,1754
7579,3515860749,3668898102,1672622666,1672623735,1069
7502,3629547065,3513454145,1672541247,1672541633,386
7844,3634340855,3338367113,1672664280,1672667271,2991
7886,3513164386,3501606184,1672624562,1672624733,171
7636,3760294205,3302626661,1672646558,1672646895,337
7677,3505135325,3446948848,1672661903,1672665232,3329
7711,3428006164,3518876135,1672691991,1672694840,2849
7831,3509672210,3710098970,1672702670,1672704249,1579
7650,3478194807,3772714862,1672598674,1672598930,256
7896,3515125508,3755872268,1672642112,1672643588,1476
7713,3490191091,3774501422,1672576603,1672578261,1658
7917,3338367113,3278365525,1672697486,1672699747,2261
7952,3473765852,3792883665,1672569954,1672570117,163
7831,3618045231,3481647420,1672659661,1672660918,1257
7826,3505173328,3478194807,1672588987,1672592567,3580
7797,3802367797,3515394721,1672680448,1672683110,2662
7652,3515394721,3791874383,1672616220,1672619632,3412
7778,3500391167,3201432789,1672618729,1672621945,3216
7601,3792384220,3361230905,1672572134,1672574007,1873
7835,3792768129,3713786889,1672644118,1672645539,1421
7908,3716835696,3364543015,1672630862,1672633789,2927
7878,3793959750,3517255726,1672672910,1672673331,421
7822,3713349754,3716900301,1672676530,1672678120,1590
7642,3773664987,3206593906,1672532228,1672534284,2056
7503,3685187183,3732481297,1672648867,1672652126,3259
7666,3714474557,3710344260,1672703739,1672704390,651
7778,3791602225,3815508790,1672604782,1672606025,1243
7957,3791874383,3511687358,1672607176,1672609562,2386
7509,3701065786,3451432842,1672532373,1672532642,269
7908,3757602960,3826415738,1672587762,1672590811,3049
7527,3885897503,3510937904,1672701422,1672704281,2859
7811,3773465237,3520756859,1672586158,1672587170,1012
7586,3755042098,3222448362,1672636534,1672639401,2867
7961,3716537575,3792844210,1672681190,1672684605,3415
7882,3793338102,3316173088,1672675836,1672677789,1953
7653,3918584946,3760561634,1672660134,1672661891,1757
7714,3791602225,3511862351,1672682781,1672686184,3403
7754,3519563836,3505702787,1672670438,1672671253,815
7519,3500658339,3533371364,1672588447,1672590421,1974
7558,3518876135,3829764737,1672604061,1672606611,2550
7583,3917088658,3816853177,1672667737,1672670982,3245
7717,3500365158,3791594391,1672606591,1672610143,3552
7575,3278365525,3512166013,1672661705,1672663405,1700
7935,3610695419,3465202715,1672685839,1672686293,454
7859,3500374658,3774045700,1672575496,1672577391,1895
7643,3715998609,3501184421,1672620778,1672621083,305
7491,3505599848,3378436155,1672654816,1672656486,1670
7484,3710112546,3229665776,1672647162,1672650499,3337
7842,3556951786,3851190615,1672603825,1672604832,1007
7678,3774366875,3200691026,1672561454,1672561568,114
7956,3618045231,3201432789,1672669099,1672672545,3446
7938,3793962300,3773978034,1672679855,1672680219,364
7937,3777929708,3815508790,1672671234,1672673562,2328
7703,3604539807,3713969578,1672661851,1672664752,2901
7518,3904408902,3515151980,1672599006,1672602569,3563
7725,3453729665,3918584946,1672564828,1672567407,2579
7818,3232962003,3625274012,1672536400,1672539012,2612
7644,3756623396,3385763781,1672561213,1672562426,1213
7610,3362000049,3312333615,1672624870,1672628180,3310
7794,3755881905,3793848402,1672620242,1672622232,1990
7737,3735733948,3430504438,1672684523,1672685141,618
7537,3703871468,3534488837,1672584178,1672586685,2507
7687,3701178711,3416241005,1672652672,1672654406,1734
7645,3206593906,3534313900,1672569202,1672570048,846
7767,3755625324,3924549929,1672663040,1672663103,63
7586,3509907947,3802367797,1672568027,1672570168,2141
7889,3512683609,3755042098,1672585070,1672585362,292
7548,3701534009,3688683847,1672666726,1672669083,2357
7498,3209383861,3733891182,1672680625,1672680934,309
7911,3778780511,3737051610,1672696187,1672698974,2787
7580,3778980116,3513956646,1672533462,1672536380,2918
7636,3516223597,3756966035,1672537575,1672540378,2803
7592,3505859863,3520376528,1672609757,1672613263,3506
7710,3855424474,3793962300,1672659326,1672659570,244
7628,3505347134,3500658339,1672596007,1672599126,3119
7598,3624761861,3736229191,1672623706,1672626449,2743
7486,3667680268,3288764520,1672635034,1672637796,2762
7678,3301107849,3779036831,1672592967,1672593543,576
7507,3859525941,3774268456,1672697479,1672699526,2047
7556,3739106581,3757562897,1672596568,1672599326,2758
7597,3828624701,3889232789,1672560991,1672562985,1994
7610,3774520233,3520012395,1672606622,1672608298,1676
7797,3701863557,3314245084,1672654023,1672655868,1845
7547,3513164386,3533280269,1672664942,1672665719,777
7826,3773978034,3512349371,1672645636,1672646824,1188
7674,3792384220,3519069599,1672684161,1672684277,116
7959,3220716272,3511271692,1672621627,1672622292,665
7642,3512217942,3756451663,1672687136,1672690591,3455
7931,3533626375,3517077106,1672621667,1672623906,2239
7641,3314245084,3820354437,1672536786,1672537948,1162
7729,3800886801,3715127362,1672692315,1672695778,3463
7927,3417061462,3903962771,1672647011,1672647855,844
7566,3367902229,3388286531,1672676750,1672678327,1577
7590,3818255890,3780593036,1672579564,1672580971,1407
7959,3780294829,3852391257,1672683428,1672684262,834
7919,3624312512,3501184421,1672623377,1672624322,945
7590,3511687358,3500894271,1672548902,1672551751,2849
7937,3201324715,3755920131,1672591316,1672593183,1867
7884,3701995648,3311090974,1672540075,1672543353,3278
7536,3755739653,3978115672,1672629381,1672631715,2334
7757,3475396323,3791020967,1672635735,1672638263,2528
7797,3397418363,3277669002,1672683011,1672686387,3376
7587,3972709319,3779976989,1672669795,1672671726,1931
7519,3783206719,3930791338,1672623883,1672626547,2664
7864,3277939457,3346795719,1672533928,1672534915,987
7601,3489962019,3453729665,1672564708,1672565657,949
7518,3701146057,3783245561,1672532814,1672533017,203
7839,3805347939,3774125065,1672626947,1672627276,329
7775,3731106822,3667680268,1672623888,1672623948,60
7821,3430352815,3489545239,1672642139,1672644523,2384
7853,3713969578,3636867411,1672614287,1672617667,3380
7982,3755436115,3783509527,1672572039,1672574410,2371
7593,3505638204,3703275621,1672612564,1672615523,2959
7706,3607178184,3399004969,1672620015,1672621990,1975
7593,3459030804,3319752091,1672537606,1672540829,3223
7531,3793959750,3770635361,1672622526,1672622771,245
7512,3359239884,3336742544,1672636877,1672637744,867
7930,3459030804,3792253549,1672638254,1672639791,1537
7776,3791115967,3208844525,1672543464,1672543813,349
7745,3369998498,3815508790,1672585203,1672586001,798
7744,3311208440,3914259449,1672601819,1672602278,459
7830,3390068992,3701184889,1672656925,1672660228,3303
7511,3509907947,3518496488,1672636649,1672638761,2112
7529,3552314511,3972709319,1672642125,1672643206,1081
7499,3482405588,3392121505,1672548829,1672551681,2852
7587,3412825109,3505292701,1672660453,1672661264,811
7571,3519601612,3519556068,1672674535,1672675446,911
7540,3278365525,3222521619,1672659899,1672661309,1410
7697,3396285984,3404058699,1672538664,1672538783,119
7861,3819727225,3793086311,1672617340,1672617547,207
7656,3757403279,3792789881,1672685588,1672686458,870
7531,3379589402,3296471982,1672687610,1672689256,1646
7933,3312333615,3519803045,1672541908,1672544673,2765
7842,3685818092,3516258476,1672650568,1672650781,213
7766,3466911760,3391261292,1672552696,1672553055,359
7816,3606186086,3783779671,1672662323,1672663286,963
7504,3855424474,3710408395,1672562430,1672564451,2021
7918,3634340855,3664170666,1672695947,1672698519,2572
7967,3976633198,3792473331,1672552633,1672554689,2056
7554,3296471982,3772309150,1672625327,1672626668,1341
7655,3284832486,3825229501,1672559095,1672561130,2035
7692,3903962771,3429690204,1672632422,1672633903,1481
7542,3828365570,3792384220,1672644186,1672647531,3345
7610,3520719611,3805292782,1672608402,1672610366,1964
7634,3882242815,3827626797,1672703576,1672706399,2823
7859,3307097200,3518932404,1672575701,1672577543,1842
7568,3337544549,3935127663,1672684605,1672685530,925
7948,3482405588,3514245078,1672607417,1672608803,1386
7689,3505145247,3911245524,1672663845,1672667304,3459
7524,3533095755,3903962771,1672657125,1672659483,2358
7701,3701065786,3517864478,1672623538,1672626569,3031
7869,3783206719,3500199935,1672633256,1672634114,858
7596,3472130842,3756462516,1672619832,1672622746,2914
7847,3412980697,3533369198,1672667910,1672670525,2615
7800,3390068992,3476232529,1672700148,1672700453,305
7873,3388637594,3917278625,1672668119,1672669701,1582
7915,3805342762,3685187183,1672673709,1672677178,3469
7679,3918674986,3731106822,1672556912,1672558023,1111
7697,3772053179,3918674986,1672624166,1672624609,443
7866,3701995648,3519654779,1672539600,1672542747,3147
7828,3716168623,3930791338,1672692443,1672692585,142
7735,3714474557,3278365525,1672703354,1672704148,794
7707,3391915121,3501364586,1672565989,1672566225,236
7752,3396086535,3512720680,1672678553,1672680315,1762
7553,3793436995,3426325549,1672673719,1672675126,1407
7792,3710098970,3666553782,1672654759,1672656985,2226
7608,3365278081,3365830990,1672671125,1672671866,741
7952,3818255890,3737154119,1672592830,1672593145,315
7605,3701065786,3770447408,1672698588,1672701331,2743
7719,3313564074,3475251781,1672616348,1672618402,2054
7508,3701184889,3783779671,1672645069,1672646606,1537
7645,3360993964,3778308417,1672598803,1672601973,3170
7827,3713969578,3512166013,1672625811,1672626625,814
7567,3362000049,3826759140,1672615512,1672617818,2306
7876,3298288268,3249791738,1672660082,1672661864,1782
7779,3774298222,3519700826,1672701570,1672702369,799
7510,3634340855,3516606733,1672577015,1672580242,3227
7854,3500374658,3505702787,1672693777,1672694175,398
7743,3346795719,3756462516,1672672406,1672675720,3314
7633,3520719611,3855937514,1672617186,1672619058,1872
7606,3626156564,3249791738,1672547808,1672549699,1891
7484,3501483568,3760992710,1672596233,1672599400,3167
7780,3514128943,3688683847,1672697532,1672700815,3283
7887,3791020967,3476232529,1672553063,1672553874,811
7888,3409474775,3774466457,1672611277,1672612256,979
7925,3384240055,3811694763,1672560599,1672562976,2377
7498,3755392666,3428006164,1672633777,1672633941,164
7863,3247815299,3736229191,1672558539,1672560953,2414
7661,3510380060,3757161914,1672688978,1672689132,154
7558,3666553782,3770553384,1672653475,1672656240,2765
7900,3388372715,3515125508,1672545478,1672546256,778
7849,3756930948,3426325549,1672561680,1672564026,2346
7544,3458539365,3519700826,1672624666,1672627259,2593
7654,3511862351,3510173870,1672674444,1672676020,1576
7504,3510969660,3511435497,1672689687,1672690708,1021
7923,3777776687,3520719611,1672552192,1672554772,2580
7576,3815508790,3610695419,1672585312,1672588685,3373
7811,3399004969,3236102733,1672614323,1672616726,2403
7800,3757812939,3505883609,1672668953,1672669101,148
7888,3793753089,3936227020,1672651343,1672652165,822
7823,3760267716,3666507626,1672557868,1672561086,3218
7709,3760569731,3881477378,1672680250,1672681951,1701
7531,3359910781,3228165483,1672656023,1672659185,3162
7928,3516465662,3533371364,1672618928,1672619581,653
7966,3756966035,3701984666,1672625481,1672626740,1259
7829,3519152550,3515151980,1672563000,1672565748,2748
7585,3885670556,3772359096,1672581190,1672582512,1322
7763,3509672210,3855424474,1672600532,1672600672,140
7640,3516065852,3772053179,1672641696,1672644390,2694
7962,3851190615,3505362057,1672566083,1672567574,1491
7662,3510247121,3533385867,1672561683,1672563016,1333
7847,3713644518,3760561634,1672556227,1672557436,1209
7949,3280964728,3344019610,1672539355,1672542093,2738
7817,3284639858,3201432789,1672601342,1672603303,1961
7935,3829232696,3703223015,1672644508,1672646483,1975
7691,3792844210,3935127663,1672643906,1672647283,3377
7822,3792384220,3512567240,1672556755,1672558788,2033
7884,3917088658,3627937312,1672686102,1672687348,1246
7728,3926700506,3385763781,1672679364,1672680857,1493
7733,3815508790,3881477378,1672684140,1672685726,1586
7721,3336751428,3520030713,1672687262,1672688005,743
7856,3734496778,3710067113,1672538445,1672541157,2712
7515,3517077106,3780294829,1672598936,1672602514,3578
7598,3477375368,3975287541,1672653785,1672655176,1391
7789,3757246925,3388286531,1672698516,1672701971,3455
7841,3883861463,3606812411,1672571799,1672572564,765
7905,3778305740,3760598102,1672644202,1672645004,802
7667,3411618230,3505973226,1672703929,1672707394,3465
7652,3505000737,3629547065,1672699449,1672700889,1440
7974,3791957752,3505193212,1672582566,1672584350,1784
7737,3730517636,3611150562,1672613023,1672615716,2693
7960,3636867411,3734737881,1672652694,1672653529,835
7579,3713370078,3533653428,1672679822,1672682560,2738
7524,3827626797,3514987389,1672669877,1672673217,3340
7813,3394539273,3734737881,1672576740,1672577657,917
7908,3904775198,3384951177,1672694002,1672696147,2145
7521,3757455053,3510969660,1672621831,1672623536,1705
7974,3778305740,3755881905,1672567453,1672569945,2492
7706,3416427576,3701190899,1672552519,1672554703,2184
7910,3629935998,3773465237,1672632158,1672634172,2014
7528,3392121505,3481502100,1672617690,1672619249,1559
7659,3386707783,3701146057,1672584869,1672587948,3079
7927,3509933351,3516514391,1672588525,1672591671,3146
7578,3774298222,3380035798,1672552491,1672553498,1007
7519,3756451663,3505477652,1672700552,1672703413,2861
7711,3792288302,3276993580,1672635404,1672637232,1828
7943,3895562476,3791602225,1672610875,1672612317,1442
7620,3780914982,3701967560,1672572860,1672576450,3590
7804,3520719611,3703441914,1672685945,1672686473,528
7602,3715974031,3533385867,1672622154,1672623165,1011
7798,3777776687,3516514391,1672647267,1672647762,495
7910,3228165483,3701274634,1672662657,1672662886,229
7710,3417970574,3511271692,1672569416,1672571133,1717
7526,3235287260,3776066388,1672675085,1672678547,3462
7760,3505912939,3505530961,1672536119,1672537340,1221
7879,3793286136,3517509185,1672611765,1672613584,1819
7836,3780503655,3755587522,1672600511,1672600814,303
7501,3777929708,3533280269,1672617153,1672618768,1615
7831,3518360734,3902383721,1672686553,1672689853,3300
7815,3512969370,3911159965,1672578607,1672579375,768
7923,3481647420,3520629279,1672649329,1672651852,2523
7601,3736229191,3519428855,1672667395,1672668025,630
7695,3918584946,3920801189,1672696818,1672697909,1091
7816,3277669002,3772337814,1672698199,1672700792,2593
7731,3434642576,3516039895,1672697696,1672700974,3278
7844,3703013906,3505883609,1672564069,1672564981,912
7777,3924549929,3314836094,1672635854,1672637792,1938
7872,3311871871,3760893269,1672643842,1672647074,3232
7675,3231056870,3244485293,1672699498,1672701018,1520
7848,3770447408,3223789409,1672671285,1672674092,2807
7698,3809484172,3516629436,1672657868,1672661345,3477
7622,3222521619,3501184421,1672531292,1672532127,835
7805,3480687894,3973560347,1672592574,1672593773,1199
7849,3394539273,3377766165,1672645469,1672647762,2293
7908,3780639480,3516514391,1672657663,1672660977,3314
7729,3777790718,3716746253,1672666801,1672669663,2862
7523,3710408395,3601879040,1672536851,1672537872,1021
7755,3715998609,3505135325,1672665289,1672667768,2479
7865,3716835696,3815508790,1672611272,1672614392,3120
7900,3791020967,3792768129,1672541780,1672544548,2768
7822,3520629279,3509604974,1672555447,1672556180,733
7944,3783705817,3606987130,1672566676,1672569300,2624
7862,3417970574,3311993075,1672582636,1672583661,1025
7566,3311761694,3733891182,1672628528,1672629624,1096
7499,3291227780,3615046771,1672624612,1672627712,3100
7778,3510711755,3517476351,1672572508,1672574521,2013
7621,3513080274,3780593036,1672614995,1672617609,2614
7544,3715189301,3201324715,1672625441,1672627605,2164
7780,3294803686,3777455223,1672564935,1672568109,3174
7712,3668005723,3242408357,1672563442,1672566586,3144
7841,3509672210,3373384732,1672680585,1672680804,219
7645,3331845324,3898995675,1672673529,1672675262,1733
7560,3701184889,3716197887,1672543224,1672545159,1935
7887,3433804879,3519654779,1672610032,1672612951,2919
7951,3774298222,3533385867,1672581498,1672581593,95
7854,3755042098,3791594391,1672612669,1672613729,1060
7524,3276993580,3206254161,1672548242,1672550381,2139
7784,3916289176,3710569131,1672661365,1672664471,3106
7634,3505904952,3701498253,1672598850,1672601557,2707
7847,3621810464,3902383721,1672533658,1672537019,3361
7641,3711262377,3360993964,1672635721,1672636116,395
7556,3206254161,3509630174,1672625936,1672629334,3398
7742,3339907603,3534424200,1672660164,1672661387,1223
7655,3346795719,3200691026,1672628294,1672628388,94
7765,3828624701,3975287541,1672579719,1672580090,371
7662,3915628728,3500177712,1672624142,1672627198,3056
7820,3516514391,3607178184,1672681559,1672682953,1394
7770,3556951786,3792253549,1672671236,1672674409,3173
7659,3247780536,3342131135,1672621796,1672621945,149
7608,3311090974,3733189298,1672670436,1672671982,1546
7717,3285400528,3242408357,1672633731,1672633971,240
7830,3430352815,3311324983,1672659664,1672660012,348
7786,3791874383,3311648200,1672611324,1672612148,824
7750,3475258557,3518014404,1672543160,1672544807,1647
7900,3298433163,3774366875,1672641435,1672643460,2025
7551,3883085535,3489962019,1672686971,1672690508,3537
7668,3427219654,3399911573,1672561562,1672563809,2247
7514,3606186086,3500578848,1672669489,1672669599,110
7599,3519428855,3772309150,1672540925,1672542827,1902
7818,3760183458,3710344260,1672698655,1672700402,1747
7799,3634340855,3760492950,1672538098,1672540282,2184
7799,3611150562,3490191091,1672617517,1672617785,268
7706,3405494240,3715189301,1672682201,1672682968,767
7654,3477375368,3607748895,1672629763,1672631866,2103
7550,3713808837,3882291183,1672668017,1672669504,1487
7530,3711569060,3639847263,1672582527,1672583147,620
7871,3855000166,3389115045,1672671726,1672674040,2314
7506,3711262377,3792253549,1672670304,1672671774,1470
7880,3466229085,3302626661,1672647592,1672649714,2122
7682,3346795719,3793627961,1672565641,1672568986,3345
7589,3518163778,3703718151,1672702130,1672705698,3568
7839,3773120434,3222448362,1672652705,1672654067,1362
7865,3855424474,3777936328,1672556937,1672558201,1264
7976,3473765852,3710098970,1672609109,1672611851,2742
7933,3773950140,3711308224,1672687639,1672689544,1905
7871,3616944364,3500066230,1672652493,1672655319,2826
7503,3855602893,3826633236,1672562135,1672562842,707
7816,3487171044,3316173088,1672627508,1672629630,2122
7748,3362000049,3505702787,1672647273,1672647798,525
7877,3774125065,3755798867,1672643036,1672643419,383
7639,3617055293,3836573197,1672653909,1672656113,2204
7561,3757161914,3534010629,1672631014,1672633435,2421
7718,3776338577,3792253549,1672562734,1672563510,776
7918,3780639480,3416265063,1672653806,1672657255,3449
7707,3916289176,3973560347,1672548150,1672549926,1776
7660,3417970574,3361230905,1672568505,1672572035,3530
7818,3400804807,3518014636,1672683467,1672683740,273
7650,3365278081,3518791447,1672678454,1672681242,2788
7708,3518876135,3224716315,1672665024,1672667814,2790
7808,3770021824,3711308224,1672536440,1672536647,207
7668,3791553060,3511271692,1672559887,1672563014,3127
7848,3365614305,3935627557,1672600609,1672603838,3229
7650,3346795719,3855000166,1672550070,1672550689,619
7817,3311718847,3311274543,1672633469,1672636583,3114
7586,3515860749,3779629905,1672550581,1672551879,1298
7682,3776800213,3505145247,1672534636,1672536287,1651
7942,3473765852,3534424200,1672550057,1672553247,3190
7618,3510969660,3710408395,1672654886,1672657472,2586
7603,3379256399,3780593036,1672537699,1672538378,679
7642,3473765852,3903009525,1672590340,1672593759,3419
7588,3227457126,3344019610,1672655423,1672656845,1422
7923,3291235378,3552314511,1672575210,1672576259,1049
7978,3391261292,3534313900,1672607993,1672611442,3449
7978,3220716272,3662180254,1672534258,1672536027,1769
7943,3509933351,3802367797,1672683752,1672684644,892
7680,3235635976,3760992710,1672616858,1672619357,2499
7824,3809059934,3358871377,1672656416,1672658285,1869
7955,3515125508,3783206719,1672702495,1672705013,2518
7489,3505702787,3516465662,1672647790,1672649412,1622
7803,3402943525,3783925755,1672616822,1672617321,499
7969,3881477378,3701190899,1672587674,1672589035,1361
7814,3701274634,3734496778,1672663087,1672666402,3315
7944,3756453423,3666507626,1672613135,1672615276,2141
7753,3466911760,3280615985,1672547313,1672549084,1771
7741,3500994774,3921211276,1672541839,1672543236,1397
7934,3793871337,3386707783,1672663512,1672664348,836
7898,3451432842,3446948848,1672657389,1672657983,594
7698,3711370563,3407725581,1672639839,1672640203,364
7787,3500365158,3515125508,1672630530,1672634088,3558
7798,3311203656,3716273414,1672574337,1672575145,808
7873,3772053179,3517864478,1672562775,1672563979,1204
7682,3293695955,3294803686,1672677892,1672679525,1633
7840,3356860407,3932051427,1672618328,1672621612,3284
7529,3828432634,3485008994,1672676431,1672676573,142
7683,3334033993,3489962019,1672682582,1672685295,2713
7791,3505973226,3777790718,1672689110,1672689809,699
7494,3396086535,3206593906,1672587488,1672589434,1946
7570,3783126683,3683766533,1672610192,1672611523,1331
7735,3777443199,3378092448,1672594484,1672597367,2883
7491,3774195321,3793286136,1672692767,1672692890,123
7497,3710098970,3601879040,1672702921,1672703709,788
7863,3930791338,3331845324,1672698791,1672699208,417
7979,3774298222,3802367797,1672675167,1672678420,3253
7717,3201432789,3773429448,1672584683,1672584812,129
7825,3515691540,3512349371,1672596023,1672596549,526
7663,3756027749,3517864478,1672615787,1672619265,3478
7832,3500391167,3811694763,1672597144,1672599970,2826
7820,3465254146,3780914982,1672552113,1672552665,552
7520,3756021689,3311627628,1672688150,1672690052,1902
7645,3703441914,3388372715,1672608169,1672609217,1048
7495,3346795719,3778780511,1672603000,1672603871,871
7554,3387966152,3791115967,1672621026,1672621291,265
7816,3223968713,3710112546,1672547352,1672550677,3325
7600,3774466457,3400804807,1672603345,1672603716,371
7850,3448855696,3716843669,1672679809,1672683350,3541
7687,3473765852,3881477378,1672538202,1672539026,824
7688,3978115672,3715998609,1672559191,1672561550,2359
7792,3774580701,3713630656,1672696323,1672696977,654
7722,3837094550,3783779671,1672594397,1672595858,1461
7806,3925620998,3505292701,1672649947,1672651137,1190
7949,3898995675,3386707783,1672553890,1672555856,1966
7791,3396086535,3792032359,1672535448,1672536274,826
7737,3200691026,3774204963,1672676543,1672676904,361
7960,3737051610,3774005526,1672561878,1672563834,1956
7826,3976390453,3774338212,1672698623,1672698803,180
7542,3501364586,3774268456,1672569793,1672571517,1724
7752,3494290908,3922337974,1672691501,1672692560,1059
7535,3772714862,3774520233,1672583334,1672586592,3258
7684,3554917400,3501955238,1672581252,1672583390,2138
7570,3883312122,3483164654,1672603684,1672606403,2719
7592,3777790718,3735733948,1672535017,1672535919,902
7509,3757246925,3518014636,1672650424,1672653810,3386
7830,3772309150,3904408902,1672641538,1672641826,288
7569,3812176780,3399911573,1672564968,1672565830,862
7702,3405494240,3511350608,1672627655,1672629276,1621
7673,3607178184,3910454786,1672583680,1672585191,1511
7892,3515691540,3780365428,1672605956,1672609077,3121
7734,3500458761,3755042098,1672580026,1672582746,2720
7517,3501606184,3772359096,1672675363,1672675815,452
7534,3519803045,3234362962,1672637334,1672638234,900
7894,3534191820,3885897503,1672620409,1672621342,933
7981,3516673015,3533385867,1672687358,1672688862,1504
7624,3711571712,3505477652,1672567219,1672569196,1977
7958,3505635228,3296471982,1672553728,1672556241,2513
7932,3777776687,3517255726,1672630595,1672631013,418
7903,3453729665,3792032359,1672618951,1672620438,1487
7737,3497901842,3736625083,1672662773,1672663526,753
7899,3858918246,3244389794,1672588750,1672590186,1436
7498,3756021689,3777717988,1672602811,1672604393,1582
7491,3484995752,3933210486,1672690957,1672693822,2865
7875,3737154119,3485008994,1672647091,1672649563,2472
7749,3206593906,3772337814,1672593289,1672596874,3585
7703,3783925755,3515125508,1672667117,1672668086,969
7633,3511267139,3625274012,1672538892,1672540081,1189
7719,3333896808,3454042520,1672612852,1672615298,2446
7725,3514719601,3777079686,1672568325,1672571618,3293
7920,3534191820,3517255726,1672687846,1672690441,2595
7733,3434642576,3703789494,1672637574,1672638931,1357
7695,3346795719,3510247121,1672599897,1672602215,2318
7818,3475396323,3805347939,1672692873,1672694266,1393
7687,3779528381,3510126867,1672687337,1672690927,3590
7689,3811171116,3515723720,1672548235,1672551201,2966
7567,3500803339,3417061462,1672572347,1672575392,3045
7852,3701274634,3634786711,1672664349,1672664966,617
7507,3510126867,3774066725,1672593030,1672593773,743
7902,3244436890,3783239924,1672560369,1672562483,2114
7845,3387966152,3780914982,1672628311,1672628617,306
7616,3505962865,3829232696,1672642077,1672643375,1298
7810,3534010629,3617055293,1672573949,1672575688,1739
7763,3904775198,3793389510,1672618017,1672621089,3072
7754,3520012395,3826415738,1672531601,1672534399,2798
7573,3510380060,3883312122,1672587512,1672589148,1636
7937,3976390453,3501364586,1672550032,1672551828,1796
7675,3633420270,3533653428,1672652230,1672653866,1636
7922,3738274418,3552314511,1672620912,1672621215,303
7523,3760267716,3349613093,1672697417,1672699596,2179
7767,3614238812,3387674757,1672624989,1672628319,3330
7873,3360506772,3932051427,1672639108,1672641100,1992
7846,3715127362,3883551721,1672626098,1672627769,1671
7669,3512510536,3777623166,1672610089,1672613296,3207
7960,3755042098,3611150562,1672632194,1672632742,548
7501,3404384505,3883312122,1672675518,1672677068,1550
7554,3777477395,3514838220,1672668584,1672670399,1815
7547,3885670556,3800353779,1672678217,1672679320,1103
7818,3756966035,3734828619,1672608895,1672609972,1077
7750,3823600322,3369998498,1672681766,1672683771,2005
7963,3249247700,3664170666,1672697188,1672698661,1473
7702,3311439795,3304056063,1672661583,1672665036,3453
7933,3917278625,3512217942,1672623017,1672626450,3433
7850,3520012395,3816853177,1672586020,1672587485,1465
7851,3489217083,3384951177,1672559555,1672560189,634
7938,3514987389,3818255890,1672688679,1672690388,1709
7961,3475251781,3792253549,1672617719,1672620841,3122
7896,3773465237,3311603601,1672551281,1672553370,2089
7886,3618873142,3512349371,1672593353,1672594170,817
7702,3737079798,3301107849,1672667016,1672667679,663
7605,3316173088,3534702203,1672698326,1672701745,3419
7711,3500060260,3716835696,1672641298,1672642560,1262
7840,3827626797,3716273414,1672637408,1672639358,1950
7677,3511687358,3629547065,1672558713,1672561441,2728
7867,3711973519,3517255726,1672557883,1672561150,3267
7790,3518496488,3703735129,1672659109,1672659819,710
7499,3534729133,3515151980,1672683992,1672685283,1291
7507,3318166135,3400918687,1672542188,1672544109,1921
7566,3791602225,3829764737,1672568490,1672570734,2244
7740,3356860407,3346795719,1672678272,1672678404,132
7582,3760267716,3357483218,1672554014,1672555795,1781
7652,3505859863,3242408357,1672694690,1672698156,3466
7596,3516011407,3286658957,1672554944,1672558294,3350
7824,3391261292,3360743849,1672565289,1672568330,3041
7953,3367902229,3516065852,1672597448,1672600627,3179
7566,3756966035,3715581279,1672645480,1672646449,969
7910,3480687894,3899371911,1672531553,1672534203,2650
7843,3772746272,3683766533,1672667835,1672668458,623
7868,3513956646,3244485293,1672563982,1672564073,91
7933,3533242305,3407725581,1672639426,1672642949,3523
7955,3505193212,3792768129,1672541309,1672543124,1815
7595,3802367797,3516606733,1672624249,1672624702,453
7601,3733189298,3312333615,1672636252,1672636922,670
7557,3488244966,3912536808,1672547500,1672547709,209
7531,3774045700,3973560347,1672690122,1672692071,1949
7799,3291235378,3756027749,1672684989,1672685229,240
7762,3791553060,3713786889,1672630489,1672631403,914
7645,3285400528,3714474557,1672679732,1672682735,3003
7679,3701967560,3500805881,1672699716,1672701460,1744
7812,3510711755,3622054816,1672592153,1672595633,3480
7561,3774339795,3755872268,1672629312,1672629653,341
7782,3517077106,3345207877,1672538111,1672539142,1031
7896,3514283243,3500177712,1672574990,1672575680,690
7878,3481502100,3783196518,1672564276,1672567332,3056
7622,3800886801,3280599164,1672659988,1672662100,2112
7795,3311203656,3505201246,1672610344,1672613606,3262
7670,3664517356,3701184889,1672684983,1672685272,289
7908,3770763956,3280964728,1672622826,1672625320,2494
7490,3774066725,3416265063,1672585246,1672587465,2219
7528,3501601840,3519703355,1672583263,1672585145,1882
7561,3756424865,3520165601,1672553163,1672554345,1182
7820,3311648200,3779629905,1672550582,1672552276,1694
7498,3533025282,3912536808,1672595696,1672598117,2421
7671,3710112546,3899371911,1672697222,1672700593,3371
7913,3636867411,3488244966,1672673448,1672675723,2275
7702,3432665384,3416265063,1672650652,1672652248,1596
7650,3935627557,3501955238,1672658076,1672659626,1550
7619,3500391167,3667680268,1672655401,1672656909,1508
7866,3316173088,3512567240,1672694604,1672695272,668
7867,3809059934,3505859863,1672597151,1672598635,1484
7512,3500374658,3618873142,1672546596,1672548183,1587
7563,3209551760,3510247121,1672644887,1672648180,3293
7845,3664170666,3513599775,1672609584,1672612647,3063
7907,3918584946,3496549058,1672588674,1672590626,1952
7483,3514245078,3475795792,1672551893,1672553148,1255
7800,3738274418,3388372715,1672565848,1672568211,2363
7576,3500904641,3311065516,1672577964,1672578127,163
7489,3780365428,3451432842,1672672190,1672672854,664
7722,3937224533,3505173328,1672633516,1672635831,2315
7586,3505530961,3361230905,1672562769,1672563904,1135
7570,3520888296,3778305740,1672644854,1672646276,1422
7982,3734737881,3515860749,1672700940,1672704300,3360
7904,3418728074,3360743849,1672543354,1672544601,1247
7759,3770021824,3710344260,1672639851,1672641263,1412
7655,3777790718,3755625324,1672549886,1672550191,305
7936,3822654369,3734737881,1672659651,1672661532,1881
7582,3778108318,3417970574,1672702154,1672704674,2520
7515,3484995752,3760509236,1672597505,1672599785,2280
7924,3817621391,3303751772,1672662751,1672665339,2588
7771,3344364444,3510969660,1672536621,1672539393,2772
7652,3925620998,3505362057,1672566346,1672569886,3540
7547,3912536808,3519654779,1672683494,1672685030,1536
7759,3883042241,3889232789,1672607954,1672611224,3270
7513,3221536550,3512142794,1672687014,1672690102,3088
7750,3505912939,3770635361,1672545422,1672545704,282
7573,3520931254,3372883226,1672558862,1672560066,1204
7657,3404384505,3809484172,1672699777,1672700986,1209
7736,3475251781,3666507626,1672602945,1672604523,1578
7952,3859663348,3399535232,1672616344,1672617640,1296
7574,3918247820,3519654779,1672580705,1672583197,2492
7573,3313541986,3378686918,1672585345,1672587465,2120
7844,3387966152,3913251733,1672590726,1672592478,1752
7502,3428674539,3792384220,1672608155,1672609707,1552
7611,3924549929,3827222533,1672593958,1672595590,1632
7505,3513599775,3903009525,1672597081,1672597559,478
7795,3732481297,3520730271,1672634626,1672638142,3516
7823,3793753089,3756462516,1672617305,1672620656,3351
7812,3760992710,3459030804,1672562758,1672565681,2923
7622,3780609808,3336751428,1672555250,1672558419,3169
7894,3636867411,3344019610,1672607570,1672609379,1809
7622,3512510536,3713208927,1672573221,1672573426,205
7649,3509773875,3664170666,1672570555,1672573799,3244
7957,3223968713,3482405588,1672658667,1672661991,3324
7823,3249401741,3734496778,1672640926,1672642693,1767
7717,3430504438,3791957752,1672665964,1672667256,1292
7980,3519069599,3760492950,1672677356,1672679625,2269
7866,3484995752,3378686918,1672548552,1672548994,442
7866,3319752091,3370636709,1672675281,1672676538,1257
7506,3501486692,3249791738,1672580186,1672581612,1426
7509,3209551760,3533385867,1672636252,1672639361,3109
7632,3925620998,3512217942,1672693040,1672695270,2230
7911,3703718151,3755587522,1672622680,1672623901,1221
7534,3604539807,3890149705,1672538639,1672539542,903
7978,3825229501,3552314511,1672662093,1672663190,1097
7626,3439023335,3510711755,1672630402,1672633218,2816
7803,3346795719,3837094550,1672700289,1672702910,2621
7531,3505635228,3338367113,1672691843,1672693161,1318
7919,3501730685,3780503655,1672633854,1672635317,1463
7700,3228165483,3913251733,1672649719,1672650027,308
7923,3714488548,3517963492,1672674933,1672677496,2563
7745,3710067113,3925402713,1672638738,1672642180,3442
7860,3760294205,3857349323,1672580742,1672582843,2101
7629,3755625324,3714488548,1672678612,1672681918,3306
7573,3433804879,3792789881,1672627042,1672628765,1723
7680,3493507965,3311090974,1672634623,1672638200,3577
7533,3783206719,3922275620,1672667334,1672670076,2742
7823,3770447408,3533193862,1672696561,1672696696,135
7972,3416265063,3805292782,1672566448,1672567737,1289
7845,3773755137,3777079686,1672661758,1672665210,3452
7817,3793627961,3311871871,1672688954,1672691534,2580
7558,3519428855,3918674986,1672645076,1672647027,1951
7499,3242408357,3978105277,1672599271,1672602357,3086
7779,3512349371,3911159965,1672547679,1672551124,3445
7755,3534488837,3313541986,1672563425,1672566373,2948
7933,3510703546,3605726278,1672535523,1672537308,1785
7924,3505599848,3500374658,1672687433,1672690813,3380
7858,3606812411,3715339701,1672688423,1672690912,2489
7500,3701111745,3701967560,1672647731,1672650577,2846
7927,3793848402,3617055293,1672637937,1672639176,1239
7883,3428006164,3476232529,1672551217,1672551493,276
7713,3391915121,3472130842,1672700445,1672701488,1043
7523,3931941795,3511435497,1672597177,1672597483,306
7496,3291227780,3206603608,1672565977,1672566240,263
7692,3511125626,3918247820,1672566197,1672567621,1424
7858,3614238812,3793470489,1672585571,1672587720,2149
7533,3715127362,3494290908,1672578034,1672579242,1208
7816,3533827120,3277605882,1672601708,1672603261,1553
7670,3505883609,3505145247,1672617867,1672618188,321
7751,3534702203,3937224533,1672677188,1672677443,255
7873,3780503655,3780639480,1672568580,1672569087,507
7791,3772642849,3633420270,1672591526,1672593177,1651
7866,3475795792,3516629436,1672669663,1672673217,3554
7789,3716537575,3917088658,1672536953,1672539677,2724
7697,3467773920,3783196518,1672607121,1672609155,2034
7747,3776513891,3805347939,1672677421,1672680115,2694
7901,3792384220,3303705369,1672549496,1672550768,1272
7652,3284639858,3757403279,1672551408,1672552165,757
7945,3835382117,3351008918,1672611780,1672611975,195
7573,3701065786,3639847263,1672699091,1672701637,2546
7577,3925402713,3304625412,1672587033,1672587638,605
7847,3287105466,3922337974,1672682258,1672685446,3188
7908,3770763956,3458539365,1672612619,1672615216,2597
7895,3374559242,3516065852,1672699906,1672702076,2170
7861,3793286136,3629935998,1672635221,1672637171,1950
7617,3791020967,3220716272,1672550799,1672551471,672
7728,3601879040,3518408774,1672542303,1672543466,1163
7582,3701146057,3828365570,1672600293,1672602226,1933
7944,3716900301,3417587765,1672677768,1672678192,424
7580,3715339701,3773598056,1672661229,1672664364,3135
7967,3898995675,3392121505,1672591687,1672593201,1514
7554,3792768129,3520012395,1672542750,1672545591,2841
7629,3518014636,3825229501,1672695305,1672698504,3199
7865,3903009525,3512166013,1672698587,1672698978,391
7589,3773814927,3922275620,1672650190,1672652368,2178
7618,3770447408,3922337974,1672604013,1672604654,641
7488,3383922351,3518163778,1672580056,1672581617,1561
7601,3247780536,3627937312,1672594883,1672595843,960
7721,3407725581,3313541986,1672591716,1672593369,1653
7826,3370636709,3756966035,1672657463,1672660696,3233
7678,3793286136,3511170269,1672629895,1672631168,1273
7847,3501184421,3783245561,1672621822,1672622807,985
7877,3760489031,3772746272,1672695598,1672697486,1888
7884,3917088658,3822654369,1672555825,1672558028,2203
7802,3409474775,3489217083,1672579254,1672579740,486
7893,3756528686,3792902982,1672567393,1672570135,2742
7900,3792473331,3880310724,1672667434,1672669309,1875
7845,3533371364,3533025282,1672622067,1672623891,1824
7560,3509672210,3209027249,1672536772,1672539399,2627
7542,3372883226,3972709319,1672547337,1672550348,3011
7662,3780974443,3716746253,1672633659,1672634865,1206
7490,3465202715,3916289176,1672567580,1672568240,660
7837,3421836608,3736229191,1672543952,1672547476,3524
7515,3756601594,3913251733,1672567486,1672570850,3364
7750,3505859863,3400918687,1672585364,1672587009,1645
7543,3780914982,3378686918,1672571731,1672571973,242
7550,3903962771,3477649378,1672590261,1672593102,2841
7768,3701184889,3792844210,1672691070,1672692904,1834
7970,3855424474,3770763956,1672702677,1672703220,543
7786,3520030713,3509604974,1672620195,1672622511,2316
7524,3511267139,3701498253,1672656675,1672659631,2956
7954,3516716179,3475258557,1672677678,1672678539,861
7610,3510969660,3826415738,1672690368,1672692211,1843
7659,3206593906,3904408902,1672563413,1672564227,814
7682,3516606733,3390068992,1672572468,1672575573,3105
7976,3297463265,3791334389,1672559159,1672561834,2675
7913,3937224533,3770851318,1672614952,1672615240,288
7958,3667680268,3406784491,1672558922,1672559048,126
7920,3737079798,3780593036,1672597480,1672600484,3004
7516,3825229501,3889750851,1672644563,1672647066,2503
7694,3760569731,3701534009,1672702608,1672702959,351
7949,3756021689,3755881905,1672604008,1672605626,1618
7981,3774010081,3482405588,1672600611,1672604082,3471
7908,3739106581,3301107849,1672699996,1672700182,186
7721,3713370078,3783925755,1672591640,1672592061,421
7587,3206603608,3520030713,1672639825,1672641470,1645
7500,3777623166,3783509527,1672562566,1672563454,888
7545,3509352754,3277939457,1672601010,1672604098,3088
7727,3336751428,3510771358,1672587482,1672589298,1816
7623,3736625083,3279721246,1672584283,1672586553,2270
7891,3806545488,3276993580,1672628191,1672629513,1322
7503,3384240055,3451432842,1672582963,1672586094,3131
7923,3280615985,3458539365,1672545093,1672547363,2270
7597,3777929708,3505912939,1672571704,1672572670,966
7958,3773755137,3349613093,1672610522,1672611432,910
7932,3206254161,3352603894,1672685003,1672686726,1723
7649,3244173074,3500994774,1672700812,1672703721,2909
7829,3714488548,3229058858,1672591175,1672591755,580
7794,3291235378,3307097200,1672548923,1672552075,3152
7920,3756966035,3516065852,1672562837,1672566084,3247
7978,3618873142,3514128943,1672630450,1672630699,249
7700,3311324983,3970117174,1672532622,1672534284,1662
7977,3683959482,3399535232,1672643181,1672645504,2323
7744,3417061462,3208844525,1672689624,1672690422,798
7891,3715339701,3931941795,1672539753,1672540141,388
7693,3228165483,3716258994,1672695909,1672699230,3321
7620,3399004969,3475258557,1672540810,1672541231,421
7633,3703223015,3621497531,1672668066,1672671404,3338
7939,3792032359,3298433163,1672614870,1672616586,1716
7624,3734828619,3778308417,1672593348,1672594722,1374
7575,3780639480,3760489031,1672702462,1672703446,984
7624,3806545488,3221536550,1672583183,1672586091,2908
7764,3534492426,3517963492,1672551738,1672555305,3567
7619,3774005526,3859663348,1672685901,1672688242,2341
7785,3666553782,3311090974,1672536470,1672536832,362
7943,3778980116,3514245078,1672598777,1672599016,239
7834,3791997875,3492478793,1672542037,1672544816,2779
7967,3433804879,3716273414,1672568430,1672571804,3374
7945,3713808837,3511170269,1672640038,1672640270,232
7486,3500229033,3777983879,1672639512,1672640849,1337
7761,3365942576,3811694763,1672613228,1672615425,2197
7724,3234541252,3666457294,1672541426,1672544179,2753
7979,3770635361,3512837326,1672534229,1672536329,2100
7551,3312333615,3816853177,1672634563,1672638045,3482
7769,3356860407,3780974443,1672673530,1672675447,1917
7602,3505702787,3791553060,1672610066,1672612077,2011
7575,3370752401,3505873261,1672562192,1672563252,1060
7523,3505000737,3852595551,1672653271,1672655312,2041
7580,3731419510,3805519285,1672694314,1672697701,3387
7643,3779629905,3859525941,1672688674,1672689541,867
7677,3793086311,3487171044,1672570926,1672572374,1448
7956,3780294829,3519803045,1672576128,1672576717,589
7961,3534488837,3313564074,1672567297,1672567864,567
7885,3716537575,3757562897,1672667589,1672667700,111
7626,3832902928,3816853177,1672572237,1672572697,460
7509,3481647420,3791901535,1672622884,1672626288,3404
7746,3778341199,3770553384,1672636535,1672637019,484
7802,3816454165,3710067113,1672675408,1672678025,2617
7649,3399004969,3936227020,1672579340,1672580428,1088
7720,3513956646,3500458761,1672670961,1672671634,673
7900,3500391167,3511198618,1672641148,1672641871,723
7858,3734737881,3475795792,1672691702,1672692176,474
7846,3793871337,3311203656,1672638492,1672640031,1539
7757,3976633198,3473765852,1672554805,1672556674,1869
7491,3735319397,3511125626,1672662251,1672664355,2104
7948,3443698222,3903009525,1672629983,1672631638,1655
7526,3244485293,3783429780,1672686224,1672687800,1576
7924,3512969370,3534492426,1672547856,1672550324,2468
7924,3783083229,3334033993,1672545561,1672547532,1971
7628,3392121505,3229665776,1672587695,1672590237,2542
7532,3520183192,3783429780,1672627164,1672628598,1434
7682,3792789881,3773598056,1672698102,1672699269,1167
7826,3201432789,3316173088,1672598293,1672598541,248
7894,3792032359,3772053179,1672554558,1672555033,475
7590,3518791447,3757812939,1672613531,1672616579,3048
7499,3628819436,3606987130,1672574679,1672574845,166
7559,3792384220,3792789881,1672654032,1672654421,389
7824,3316173088,3512510536,1672532350,1672532782,432
7495,3770763956,3899266183,1672566988,1672570179,3191
7590,3303705369,3509907947,1672632906,1672635843,2937
7831,3291883916,3792384220,1672540798,1672543349,2551
7693,3399433690,3505201246,1672570548,1672573152,2604
7950,3519152550,3883042241,1672597721,1672599956,2235
7913,3476232529,3711504540,1672554001,1672556844,2843
7755,3514838220,3378686918,1672635124,1672638696,3572
7521,3773429448,3481502100,1672591154,1672593382,2228
7980,3613683164,3509933351,1672638363,1672639458,1095
7617,3973560347,3616944364,1672647354,1672647700,346
7933,3621497531,3713644518,1672578258,1672580242,1984
7722,3516606733,3976390453,1672655556,1672657093,1537
7949,3736419952,3534191820,1672608892,1672610782,1890
7842,3703889596,3889750851,1672594963,1672595359,396
7959,3418728074,3734737881,1672628148,1672630078,1930
7739,3701190899,3701984666,1672610515,1672613270,2755
7519,3287105466,3236102733,1672621758,1672624638,2880
7671,3496269445,3480687894,1672614119,1672615103,984
7824,3617734118,3757812939,1672604416,1672607268,2852
7790,3773978034,3805342762,1672698124,1672701661,3537
7876,3732481297,3475795792,1672620464,1672621575,1111
7623,3407725581,3770851318,1672654769,1672655154,385
7584,3756027749,3716843669,1672661456,1672663230,1774
7550,3710569131,3513599775,1672592528,1672592864,336
7947,3703013906,3394330287,1672597909,1672599369,1460
7760,3417587765,3701274634,1672658307,1672660314,2007
7839,3229665776,3711973519,1672609274,1672610864,1590
7838,3278365525,3396086535,1672548753,1672550715,1962
7825,3209383861,3772359096,1672636699,1672637159,460
7951,3738502357,3703871468,1672574894,1672575443,549
7652,3515691540,3755436115,1672681789,1672682646,857
7653,3415546117,3277669002,1672637515,1672637645,130
7958,3533827120,3296471982,1672534718,1672537562,2844
7779,3516223597,3825229501,1672577569,1672579445,1876
7901,3407673904,3365278081,1672632023,1672633959,1936
7918,3311845971,3505912939,1672671469,1672673259,1790
7845,3713370078,3516258476,1672644328,1672647389,3061
7838,3337544549,3318166135,1672642997,1672645890,2893
7978,3505362057,3772337814,1672668441,1672670601,2160
7959,3516960534,3608633356,1672677025,1672680465,3440
7711,3625274012,3806545488,1672539198,1672539372,174
7737,3534191820,3514987389,1672647962,1672651183,3221
7633,3773814927,3209551760,1672665122,1672667127,2005
7923,3757602960,3391261292,1672599695,1672601252,1557
7559,3601879040,3881477378,1672659128,1672660868,1740
7721,3533927138,3313564074,1672652028,1672655247,3219
7696,3857349323,3776513891,1672662818,1672664618,1800
7670,3701111745,3516016437,1672611778,1672613008,1230
7539,3972709319,3505000737,1672651604,1672654764,3160
7627,3613683164,3418728074,1672678523,1672679501,978
7712,3380035798,3714821932,1672666918,1672668207,1289
7720,3837094550,3512217942,1672676529,1672678259,1730
7931,3380035798,3711262377,1672564243,1672567478,3235
7638,3783429780,3779629905,1672586050,1672586733,683
7726,3520719611,3416427576,1672580441,1672581825,1384
7904,3777983879,3430074045,1672669879,1672673307,3428
7569,3760489031,3735733948,1672703152,1672705137,1985
7647,3519563836,3701995648,1672606478,1672609898,3420
7485,3200691026,3800886801,1672657503,1672660803,3300
7835,3976390453,3311627628,1672701994,1672704525,2531
7615,3505477652,3513164386,1672611388,1672613871,2483
7693,3791115967,3833889105,1672538994,1672540146,1152
7957,3512217942,3701184889,1672555010,1672556269,1259
7960,3511332835,3755511676,1672558689,1672560139,1450
7643,3534553510,3418728074,1672571029,1672572095,1066
7920,3701178711,3416265063,1672558834,1672562066,3232
7859,3701691675,3433804879,1672667816,1672669942,2126
7784,3773950140,3234362962,1672539433,1672540502,1069
7700,3518876135,3828624701,1672668057,1672670024,1967
7958,3484995752,3770635361,1672560367,1672563781,3414
7815,3618045231,3304625412,1672632577,1672633181,604
7901,3777790718,3760598102,1672594410,1672594852,442
7638,3911159965,3311718847,1672531861,1672532803,942
7598,3318166135,3516629436,1672552960,1672556238,3278
7678,3666553782,3757562897,1672556822,1672559432,2610
7856,3710408395,3792177074,1672680999,1672681114,115
7955,3279721246,3280599164,1672698028,1672701469,3441
7567,3516065852,3467773920,1672656634,1672658445,1811
7660,3505201246,3912262917,1672620131,1672623464,3333
7782,3827222533,3505649239,1672640169,1672641023,854
7961,3515691540,3513454145,1672563015,1672566578,3563
7889,3716900301,3367029997,1672642805,1672645219,2414
7784,3825229501,3284832486,1672553589,1672554119,530
7849,3855424474,3778308417,1672642130,1672642203,73
7959,3774338212,3404384505,1672533482,1672534778,1296
7892,3757161914,3533270638,1672573357,1672576617,3260
7579,3732481297,3519803045,1672573770,1672577282,3512
7801,3417587765,3770635361,1672657236,1672659921,2685
7582,3885670556,3922275620,1672652575,1672655927,3352
7608,3311871871,3777936328,1672557480,1672561029,3549
7946,3806545488,3534010629,1672626927,1672629048,2121
7802,3466911760,3397418363,1672686597,1672689823,3226
7975,3519152550,3715127362,1672619823,1672621122,1299
7772,3776948966,3774005526,1672616308,1672617743,1435
7681,3756462516,3776066388,1672564648,1672566894,2246
7837,3552314511,3280964728,1672577329,1672579119,1790
7887,3627937312,3634340855,1672637208,1672638236,1028
7891,3519428855,3792789881,1672560694,1672561290,596
7570,3424922204,3792902982,1672640164,1672643064,2900
7770,3614238812,3307512479,1672647722,1672650577,2855
7777,3395152943,3633420270,1672533406,1672533767,361
7515,3318697153,3760992710,1672584766,1672587725,2959
7899,3715127362,3636867411,1672655326,1672658379,3053
7808,3448855696,3533242305,1672700621,1672702663,2042
7818,3519556068,3606987130,1672555951,1672558517,2566
7658,3626156564,3501483568,1672682139,1672684278,2139
7720,3970117174,3314836094,1672536137,1672539424,3287
7553,3760294205,3500199935,1672630602,1672631790,1188
7855,3909606423,3519601612,1672584042,1672586355,2313
7761,3338367113,3311065516,1672613202,1672613959,757
7846,3516514391,3734828619,1672593350,1672596943,3593
7766,3774119563,3780503655,1672618488,1672620254,1766
7913,3510703546,3773429448,1672634196,1672637504,3308
7892,3610348516,3505201246,1672698306,1672699840,1534
7590,3733891182,3430504438,1672596675,1672599665,2990
7551,3559110998,3922275416,1672663684,1672665738,2054
7636,3839849341,3885670556,1672567144,1672569028,1884
7616,3736592744,3714962248,1672686464,1672687079,615
7528,3519912874,3774005526,1672675846,1672677692,1846
7876,3352603894,3485008994,1672624724,1672627229,2505
7855,3288764520,3918056059,1672653219,1672656794,3575
7601,3332072298,3792768129,1672556782,1672558669,1887
7845,3778108318,3801089989,1672610042,1672612074,2032
7596,3616944364,3472130842,1672560288,1672563749,3461
7899,3513454145,3881477378,1672701438,1672704051,2613
7644,3774366875,3711569060,1672682733,1672683836,1103
7547,3776338577,3793871337,1672617482,1672618406,924
7856,3778308417,3922337974,1672582236,1672583081,845
7665,3477375368,3755943611,1672585502,1672589089,3587
7692,3755042098,3760267716,1672548328,1672550824,2496
7855,3773755137,3514245078,1672648880,1672651587,2707
7836,3715339701,3509352754,1672660932,1672663038,2106
7882,3417587765,3606812411,1672541071,1672544468,3397
7738,3510857360,3475251781,1672649568,1672650243,675
7936,3534424200,3510771358,1672552408,1672554728,2320
7830,3311208440,3793959750,1672645585,1672649183,3598
7747,3713786889,3291235378,1672684815,1672686666,1851
7865,3428006164,3925402713,1672576006,1672576994,988
7617,3917088658,3802367797,1672537880,1672538175,295
7821,3311439795,3533927138,1672659222,1672661221,1999
7815,3805519285,3344364444,1672538679,1672541832,3153
7893,3516673015,3772578994,1672543848,1672546872,3024
7649,3285400528,3280599164,1672610339,1672611810,1471
7937,3467773920,3760183458,1672693419,1672696932,3513
7692,3617734118,3902383721,1672580955,1672584236,3281
7565,3246596716,3701184889,1672656880,1672660165,3285
7574,3774204963,3334033993,1672683647,1672685485,1838
7752,3662180254,3224058172,1672598206,1672599883,1677
7822,3336742544,3516629436,1672631617,1672634594,2977
7744,3406784491,3816853177,1672667799,1672669192,1393
7698,3816454165,3774298222,1672540583,1672543677,3094
7801,3792768129,3773950140,1672543926,1672547115,3189
7843,3311603601,3732481297,1672558928,1672561338,2410
7551,3883085535,3713786889,1672597792,1672598696,904
7774,3780609808,3714504419,1672587849,1672590198,2349
7601,3296471982,3512349371,1672552470,1672553481,1011
7784,3512837326,3935627557,1672703246,1672704372,1126
7652,3713370078,3777790718,1672673584,1672673756,172
7806,3792844210,3760489031,1672605894,1672608869,2975
7670,3807987001,3505973226,1672670850,1672671535,685
7783,3418728074,3899266183,1672656425,1672658326,1901
7617,3485375593,3636867411,1672641982,1672645308,3326
7544,3922275416,3664170666,1672680726,1672680953,227
7921,3500499542,3628819436,1672658753,1672661266,2513
7925,3501927421,3430074045,1672651693,1672653679,1986
7609,3930797455,3774005526,1672547164,1672549515,2351
7740,3512720680,3909238838,1672617018,1672618309,1291
7781,3917088658,3770553384,1672662423,1672662636,213
7519,3792473331,3311761694,1672658425,1672659969,1544
7966,3378436155,3418728074,1672630686,1672632290,1604
7589,3311718847,3852391257,1672537367,1672538216,849
7566,3760561634,3783509527,1672686779,1672689701,2922
7826,3357483218,3668898102,1672607200,1672607375,175
7687,3394330287,3829232696,1672587368,1672588303,935
7533,3833889105,3737051610,1672548033,1672548249,216
7942,3312333615,3400918687,1672648168,1672651214,3046
7721,3922337974,3500458761,1672558134,1672559498,1364
7830,3510173870,3517963492,1672579781,1672580151,370
7703,3229665776,3703661585,1672557470,1672557546,76
7590,3467773920,3760598102,1672687451,1672689680,2229
7704,3516065852,3777929708,1672628566,1672631807,3241
7484,3286658957,3429856982,1672585061,1672588544,3483
7737,3511170269,3624312512,1672666941,1672669351,2410
7943,3792253549,3791942683,1672621758,1672623308,1550
7948,3922275620,3760267716,1672553262,1672554768,1506
7868,3793389510,3703223015,1672582012,1672583382,1370
7874,3757682496,3556951786,1672621998,1672624062,2064
7614,3682061100,3510247121,1672541190,1672543545,2355
7891,3411618230,3716843669,1672609378,1672610683,1305
7776,3383922351,3976390453,1672681604,1672682905,1301
7724,3634786711,3780593036,1672684438,1672686468,2030
7607,3510173870,3313541986,1672611849,1672614487,2638
7642,3774501422,3820354437,1672579282,1672580799,1517
7874,3365830990,3711569060,1672675290,1672677432,2142
7931,3421127249,3883042241,1672585800,1672586907,1107
7637,3513201436,3777790718,1672607549,1672610949,3400
7668,3465202715,3312829208,1672615860,1672618623,2763
7961,3772309150,3858918246,1672666091,1672669328,3237
7772,3505791599,3466229085,1672592171,1672593535,1364
7798,3399535232,3377766165,1672694020,1672697164,3144
7601,3511687358,3618045231,1672536632,1672537276,644
7492,3734737881,3349613093,1672567526,1672569206,1680
7776,3773205565,3487171044,1672641196,1672641611,415
7587,3882291183,3273500349,1672661162,1672664158,2996
7504,3370636709,3514245078,1672572949,1672574968,2019
7697,3713630656,3601879040,1672620534,1672620899,365
7794,3298433163,3516606733,1672586395,1672588949,2554
7964,3776800213,3351554343,1672598950,1672601037,2087
7560,3756021689,3773814927,1672571153,1672573096,1943
7845,3475396323,3703735129,1672700146,1672701204,1058
7959,3783126683,3624761861,1672580997,1672583559,2562
7725,3360743849,3930791338,1672615598,1672615784,186
7896,3791020967,3731419510,1672604569,1672606629,2060
7672,3512837326,3664517356,1672631406,1672632101,695
7960,3792473331,3922275620,1672558399,1672561104,2705
7761,3715127362,3285400528,1672688725,1672689028,303
7747,3715492942,3703223015,1672532563,1672533326,763
7728,3286658957,3780828689,1672666049,1672667310,1261
7540,3516065852,3613995936,1672546162,1672547430,1268
7775,3520719611,3683959482,1672574995,1672577877,2882
7538,3793470489,3501364586,1672686243,1672689152,2909
7527,3319752091,3346795719,1672615400,1672617401,2001
7575,3793753089,3755587522,1672681773,1672684641,2868
7519,3397418363,3834257412,1672547245,1672549964,2719
7629,3885670556,3736419952,1672539303,1672539936,633
7530,3774204963,3234541252,1672566560,1672569082,2522
7777,3904408902,3976633198,1672673221,1672673526,305
7658,3448855696,3914259449,1672634999,1672635083,84
7667,3451432842,3533810360,1672581300,1672582809,1509
7961,3774127586,3979339287,1672643284,1672645151,1867
7583,3387674757,3433804879,1672643966,1672644274,308
7622,3910886626,3613683164,1672584709,1672586845,2136
7748,3396086535,3311274543,1672687285,1672688876,1591
7577,3776948966,3780593036,1672687895,1672689530,1635
7489,3505883609,3783509527,1672555861,1672558337,2476
7708,3359239884,3484995752,1672643192,1672645068,1876
7861,3520183192,3389115045,1672646147,1672649345,3198
7899,3887270940,3793470489,1672684731,1672687191,2460
7745,3772544062,3244436890,1672670543,1672670817,274
7861,3688418210,3485008994,1672690292,1672692933,2641
7982,3760509236,3859525941,1672668171,1672670685,2514
7787,3903962771,3520709480,1672561450,1672561826,376
7583,3776948966,3792253549,1672639871,1672642933,3062
7499,3701184889,3777929708,1672541089,1672542351,1262
7566,3518260334,3925620998,1672606257,1672609589,3332
7826,3519601612,3898995675,1672539167,1672541060,1893
7907,3703013906,3755436115,1672634816,1672636922,2106
7567,3828365570,3828365570,1672613310,1672615693,2383
7629,3373384732,3534313900,1672544110,1672546863,2753
7831,3206593906,3222521619,1672673192,1672674519,1327
7689,3550946908,3778266283,1672610600,1672613435,2835
7672,3711262377,3828624701,1672689954,1672691948,1994
7616,3316222192,3520206212,1672613599,1672614875,1276
7686,3206603608,3777477395,1672550168,1672550273,105
7538,3703013906,3512720680,1672657467,1672657817,350
7501,3885670556,3501606184,1672585719,1672586551,832
7827,3513956646,3351008918,1672638951,1672640411,1460
7663,3806545488,3519912874,1672598633,1672600057,1424
7749,3511163800,3380035798,1672577482,1672579304,1822
7554,3511163800,3701146057,1672593486,1672595496,2010
7506,3346327502,3937224533,1672537431,1672538255,824
7810,3359910781,3851190615,1672658505,1672659216,711
7874,3556951786,3933210486,1672700792,1672703415,2623
7580,3500994774,3391915886,1672627393,1672629571,2178
7880,3664517356,3399004969,1672629530,1672631241,1711
7858,3509907947,3662180254,1672675481,1672675784,303
7556,3429856982,3776948966,1672554941,1672556711,1770
7802,3816454165,3511170269,1672648832,1672649527,695
7688,3291883916,3512166013,1672690192,1672692273,2081
7866,3518163778,3770553384,1672639061,1672641889,2828
7709,3772642849,3773465237,1672696883,1672699831,2948
7804,3334033993,3500994774,1672634622,1672634945,323
7977,3476232529,3389115045,1672575023,1672577311,2288
7655,3772053179,3829319703,1672699753,1672703131,3378
7744,3362000049,3710569131,1672574986,1672575868,882
7682,3621497531,3235635976,1672551855,1672552302,447
7492,3935627557,3732481297,1672577387,1672580459,3072
7709,3828624701,3229058858,1672670898,1672671316,418
7953,3760077057,3931941795,1672662869,1672662939,70
7975,3791874383,3385763781,1672610050,1672613493,3443
7799,3773755137,3533193862,1672593379,1672595851,2472
7673,3501486692,3711973519,1672544816,1672546773,1957
7498,3774066725,3332072298,1672681793,1672681938,145
7711,3926700506,3732481297,1672557042,1672560284,3242
7611,3454042520,3777623166,1672606002,1672606779,777
7711,3501198706,3972709319,1672651566,1672652170,604
7702,3760294205,3735733948,1672657881,1672660193,2312
7505,3755511676,3412825109,1672685753,1672686354,601
7573,3487171044,3882291183,1672622674,1672623182,508
7679,3510937904,3813052709,1672546031,1672548939,2908
7608,3222448362,3346795719,1672616796,1672618926,2130
7702,3520730271,3791594391,1672575013,1672576701,1688
7960,3780788622,3777717988,1672536416,1672539440,3024
7581,3484995752,3903307060,1672660824,1672663187,2363
7898,3604539807,3783779671,1672629984,1672633316,3332
7667,3221899927,3365942576,1672623158,1672625032,1874
7543,3773664987,3302626661,1672552540,1672555888,3348
7700,3774501422,3399004969,1672679390,1672679880,490
7910,3415443558,3286658957,1672665030,1672666133,1103
7743,3883312122,3774338212,1672548265,1672548598,333
7930,3711370563,3732481297,1672603914,1672604513,599
7548,3359239884,3917088658,1672634898,1672636604,1706
7771,3825229501,3909238838,1672665367,1672668932,3565
7973,3713349754,3885670556,1672565634,1672567395,1761
7958,3855602893,3716168623,1672553952,1672556682,2730
7484,3828432634,3780788622,1672605750,1672606189,439
7586,3778780511,3918674986,1672672191,1672674387,2196
7537,3517721725,3607748895,1672703571,1672704355,784
7635,3778549126,3716197887,1672690857,1672694336,3479
7489,3755436115,3483164654,1672687603,1672689113,1510
7679,3891751546,3361230905,1672645501,1672648316,2815
7958,3448855696,3473765852,1672670851,1672671697,846
7680,3776513891,3231056870,1672607593,1672609106,1513
7732,3792032359,3760992710,1672675917,1672677889,1972
7744,3510969660,3882242815,1672653100,1672653605,505
7875,3777120536,3777120536,1672658532,1672661646,3114
7592,3485008994,3473765852,1672657775,1672661188,3413
7814,3792668962,3736790081,1672635537,1672638118,2581
7820,3628819436,3418728074,1672539331,1672541605,2274
7675,3383661227,3378092448,1672593771,1672596298,2527
7968,3511332835,3500894271,1672544951,1672548360,3409
7729,3533270638,3511435497,1672612817,1672614993,2176
7830,3227457126,3935627557,1672597963,1672601110,3147
7506,3249791738,3428674539,1672593612,1672594215,603
7747,3304625412,3517077106,1672539080,1672542612,3532
7620,3518360734,3407725581,1672654073,1672656720,2647
7716,3713644518,3247815299,1672615421,1672615706,285
7871,3972709319,3480687894,1672655153,1672657470,2317
7516,3247780536,3307512479,1672688904,1672690117,1213
7753,3466911760,3756462516,1672583081,1672584780,1699
7850,3791874383,3501198706,1672600956,1672603284,2328
7735,3772309150,3791657947,1672669437,1672670144,707
7836,3622054816,3505203158,1672568733,1672569478,745
7662,3516065852,3505912939,1672654890,1672656037,1147
7858,3774580701,3516673015,1672665624,1672666411,787
7559,3710569131,3313541986,1672594559,1672597006,2447
7755,3811694763,3774793839,1672621381,1672621449,68
7972,3899204805,3367029997,1672681201,1672681343,142
7729,3715581279,3772359096,1672657291,1672658460,1169
7597,3779218771,3510173870,1672567755,1672570500,2745
7902,3757403279,3518791447,1672636607,1672638362,1755
7747,3606987130,3513599775,1672534815,1672537136,2321
7760,3518669703,3776800213,1672639937,1672642202,2265
7771,3772053179,3513164386,1672699523,1672700126,603
7522,3827222533,3756021689,1672671088,1672673464,2376
7756,3629935998,3889750851,1672647415,1672649562,2147
7923,3475795792,3315583351,1672695406,1672697881,2475
7660,3757447189,3533193862,1672605888,1672608984,3096
7493,3501601840,3227457126,1672619599,1672619683,84
7865,3778266283,3827626797,1672536996,1672539718,2722
7956,3235287260,3736790081,1672535129,1672536639,1510
7555,3703735129,3710408395,1672671650,1672673905,2255
7954,3711265369,3816454165,1672570092,1672571299,1207
7551,3475258557,3510937904,1672568501,1672570035,1534
7921,3512683609,3898995675,1672590511,1672590871,360
7887,3823600322,3701691675,1672593857,1672596488,2631
7529,3510937904,3483949762,1672678676,1672679004,328
7542,3783429780,3857349323,1672594966,1672597432,2466
7832,3247780536,3345207877,1672570199,1672570615,416
7607,3716537575,3367902229,1672535095,1672537047,1952
7505,3921211276,3484995752,1672559738,1672561257,1519
7892,3703275621,3505201246,1672559553,1672561388,1835
7553,3550946908,3373384732,1672588959,1672589970,1011
7778,3711308224,3779976989,1672545109,1672548230,3121
7604,3774010081,3485823740,1672568261,1672571396,3135
7762,3511271692,3701111745,1672667248,1672667886,638
7495,3208844525,3248507722,1672578450,1672579845,1395
7930,3793848402,3793848402,1672541057,1672542056,999
7968,3242408357,3757562897,1672568872,1672570789,1917
7695,3500805881,3600647945,1672676719,1672678330,1611
7910,3783429780,3780813786,1672626861,1672628616,1755
7859,3511271692,3826759140,1672576586,1672578811,2225
7808,3703889596,3825229501,1672601307,1672602350,1043
7933,3520012395,3880285638,1672567673,1672568732,1059
7959,3516980378,3519912874,1672602802,1672606290,3488
7831,3311203656,3367029997,1672571452,1672572953,1501
7844,3613995936,3228165483,1672636169,1672638602,2433
7793,3773978034,3427283336,1672587734,1672588132,398
7709,3559110998,3756966035,1672665896,1672667470,1574
7729,3664170666,3512217942,1672640887,1672640955,68
7489,3736790081,3500365158,1672646251,1672648173,1922
7643,3489545239,3399004969,1672667472,1672668800,1328
7869,3833889105,3427283336,1672694558,1672694620,62
7502,3378092448,3493507965,1672703341,1672704798,1457
7643,3222448362,3703013906,1672622225,1672623823,1598
7738,3238712269,3711262377,1672594974,1672597308,2334
7960,3604539807,3510937904,1672578022,1672579801,1779
7773,3930797455,3774556560,1672621432,1672622173,741
7556,3412980697,3533025282,1672607850,1672609011,1161
7621,3533025282,3514472925,1672595177,1672595790,613
7891,3809484172,3792288302,1672680350,1672680811,461
7846,3497901842,3475795792,1672574167,1672577204,3037
7832,3826760240,3805347939,1672538820,1672541484,2664
7489,3779218771,3774119563,1672559625,1672561150,1525
7801,3776066388,3774793839,1672555999,1672556326,327
7637,3534702203,3778549126,1672560904,1672563995,3091
7708,3713644518,3244389794,1672546644,1672549750,3106
7649,3851190615,3516909237,1672594312,1672595676,1364
7970,3223968713,3756453423,1672595226,1672597775,2549
7961,3520030713,3509352754,1672560793,1672561006,213
7846,3736786443,3365278081,1672546800,1672548300,1500
7945,3519700826,3760509236,1672547973,1672549424,1451
7973,3713349754,3276993580,1672682951,1672683839,888
7868,3520030713,3703223015,1672572519,1672575265,2746
7814,3511125626,3511350608,1672599193,1672600851,1658
7805,3780974443,3835382117,1672670557,1672671338,781
7959,3755739653,3416265063,1672655003,1672655347,344
7895,3505347134,3475251781,1672678344,1672681757,3413
7782,3312333615,3534488837,1672648581,1672649116,535
7788,3710112546,3520706195,1672621328,1672624619,3291
7972,3886298125,3505904952,1672645823,1672648754,2931
7844,3301107849,3829232696,1672702771,1672704582,1811
7807,3937224533,3242408357,1672563875,1672566748,2873
7543,3516016437,3770635361,1672624548,1672625640,1092
7644,3244436890,3500729955,1672608531,1672611010,2479
7828,3533095755,3391915886,1672587337,1672590144,2807
7772,3668005723,3311324983,1672558396,1672558867,471
7746,3475795792,3660493209,1672599565,1672603100,3535
7658,3209383861,3911159965,1672623800,1672624348,548
7652,3505347134,3501184421,1672652587,1672652773,186
7675,3791657947,3534702203,1672531670,1672533143,1473
7972,3520719611,3634340855,1672663189,1672663828,639
7632,3774119563,3360743849,1672692205,1672692671,466
7952,3682061100,3438645253,1672610146,1672612966,2820
7712,3621497531,3514283243,1672545843,1672548900,3057
7872,3505135325,3777120536,1672576411,1672577883,1472
7826,3601879040,3534010629,1672548651,1672549235,584
7558,3284832486,3888559320,1672660297,1672663835,3538
7619,3500994774,3533748232,1672676665,1672676845,180
7823,3932051427,3922275620,1672582661,1672585367,2706
7760,3421127249,3279721246,1672565634,1672565702,68
7973,3918674986,3701995648,1672617586,1672620098,2512
7898,3369998498,3311152102,1672549248,1672549872,624
7655,3783245561,3903307060,1672614833,1672618381,3548
7664,3779528381,3277669002,1672622160,1672623494,1334
7622,3405494240,3313564074,1672676386,1672678922,2536
7836,3221899927,3379589402,1672598246,1672599077,831
7587,3511350608,3297463265,1672611379,1672611682,303
7606,3386707783,3221536550,1672550301,1672551490,1189
7968,3736592744,3223789409,1672586580,1672588230,1650
7776,3882291183,3288764520,1672643670,1672645527,1857
7826,3791942683,3298433163,1672549715,1672550468,753
7886,3383661227,3607748895,1672544465,1672545207,742
7610,3298433163,3519700826,1672671662,1672674452,2790
7888,3714962248,3223968713,1672666399,1672668813,2414
7854,3826415738,3501606184,1672571714,1672572144,430
7645,3755798867,3412980697,1672674030,1672675783,1753
7861,3459030804,3516223597,1672681134,1672682676,1542
7927,3756027749,3500904641,1672591634,1672592161,527
7675,3755042098,3516629436,1672675158,1672678528,3370
7631,3773120434,3757455053,1672547004,1672547712,708
7586,3505873261,3206593906,1672655944,1672659418,3474
7903,3731106822,3783196518,1672580059,1672582602,2543
7876,3825229501,3473765852,1672576659,1672579962,3303
7558,3835382117,3311845971,1672569821,1672570374,553
7729,3703955926,3701178711,1672636941,1672637725,784
7669,3922275416,3738274418,1672548347,1672551160,2813
7855,3208844525,3221536550,1672564825,1672567716,2891
7571,3710569131,3731419510,1672531355,1672531683,328
7920,3633420270,3477649378,1672669014,1672672534,3520
7929,3339907603,3662180254,1672617898,1672617977,79
7709,3318697153,3979339287,1672685816,1672687911,2095
7604,3399052055,3518791447,1672608608,1672609397,789
7519,3311324983,3312829208,1672544200,1672545347,1147
7629,3475251781,3903009525,1672626218,1672626749,531
7934,3777514571,3774268456,1672577585,1672579654,2069
7878,3559110998,3520012395,1672575639,1672575718,79
7538,3520709480,3976633198,1672690244,1672693492,3248
7786,3756601594,3512969370,1672646193,1672646986,793
7979,3791997875,3505193212,1672630582,1672632819,2237
7624,3500805881,3515860749,1672558494,1672559997,1503
7594,3401627165,3778341199,1672701048,1672702681,1633
7573,3776338577,3432689543,1672568883,1672569712,829
7674,3755920131,3910454786,1672676995,1672677716,721
7565,3822654369,3501486692,1672603983,1672605985,2002
7765,3777717988,3511271692,1672571244,1672573884,2640
7923,3388637594,3501483568,1672560766,1672561222,456
7526,3770021824,3221899927,1672536081,1672536821,740
7876,3505638204,3760489031,1672634746,1672635578,832
7955,3489728806,3512837326,1672611423,1672614666,3243
7954,3224716315,3883042241,1672674549,1672675971,1422
7796,3277669002,3412825109,1672642442,1672643245,803
7879,3304625412,3888559320,1672559860,1672561066,1206
7737,3701498253,3231056870,1672625892,1672627189,1297
7765,3701065786,3496269445,1672702235,1672702782,547
7667,3443698222,3939952128,1672618652,1672620368,1716
7719,3514719601,3475795792,1672637191,1672639465,2274
7708,3372883226,3777120536,1672532504,1672534111,1607
7629,3485375593,3826760240,1672677847,1672679455,1608
7661,3505135325,3514987389,1672635044,1672636213,1169
7981,3332072298,3711262377,1672624024,1672626895,2871
7979,3407725581,3710344260,1672683949,1672684759,810
7936,3778549126,3628819436,1672597695,1672601175,3480
7494,3534010629,3668898102,1672606903,1672608677,1774
7978,3318697153,3505599848,1672680288,1672681640,1352
7969,3345207877,3505869747,1672636222,1672638661,2439
7760,3682061100,3515151980,1672615551,1672618888,3337
7506,3349613093,3285400528,1672616493,1672619847,3354
7918,3903009525,3510857360,1672594078,1672595744,1666
7879,3287105466,3231056870,1672542668,1672543576,908
7661,3774339795,3298433163,1672620957,1672621068,111
7602,3886298125,3518014636,1672615322,1672618152,2830
7723,3454042520,3793086311,1672610935,1672611478,543
7635,3511435497,3280599164,1672541914,1672543797,1883
7873,3516258476,3510969660,1672637593,1672639261,1668
7684,3206593906,3505912939,1672667081,1672670192,3111
7728,3331845324,3416265063,1672647050,1672650066,3016
7726,3514472925,3426325549,1672571122,1672573951,2829
7647,3505599848,3628819436,1672621220,1672623468,2248
7727,3518932404,3311603601,1672644591,1672644652,61
7874,3291227780,3200691026,1672559222,1672559409,187
7603,3777455223,3533653428,1672650204,1672652171,1967
7877,3476232529,3311152102,1672638759,1672639179,420
7965,3774195321,3520376528,1672647398,1672650631,3233
7594,3288764520,3756451663,1672667334,1672668495,1161
7930,3774045700,3338703270,1672544382,1672546068,1686
7785,3311152102,3459030804,1672645151,1672648650,3499
7638,3756027749,3918247820,1672658814,1672661413,2599
7847,3889750851,3402943525,1672545770,1672548495,2725
7884,3829764737,3682061100,1672595832,1672597090,1258
7807,3922337974,3735319397,1672651035,1672651129,94
7534,3517864478,3291235378,1672602262,1672603790,1528
7832,3533025282,3516514391,1672665650,1672666950,1300
7623,3716900301,3500177712,1672582084,1672585270,3186
7638,3757682496,3716197887,1672615239,1672615942,703
7954,3772758337,3489545239,1672580309,1672583320,3011
7711,3778341199,3519069599,1672589907,1672592780,2873
7933,3922275416,3783239924,1672654361,1672656750,2389
7756,3613995936,3520730271,1672701654,1672703442,1788
7489,3668898102,3518014636,1672669421,1672669498,77
7912,3500805881,3412825109,1672536509,1672537773,1264
7799,3780828689,3519803045,1672632500,1672635196,2696
7536,3827222533,3501730685,1672568020,1672570292,2272
7962,3443698222,3713630656,1672549467,1672551420,1953
7682,3825229501,3500894271,1672631527,1672631823,296
7809,3711265369,3626156564,1672659949,1672663029,3080
7666,3716537575,3351554343,1672621719,1672623348,1629
7769,3791942683,3714474557,1672618702,1672619645,943
7651,3713630656,3772337814,1672569499,1672571081,1582
7580,3511862351,3807987001,1672674191,1672675124,933
7584,3701967560,3703889596,1672623039,1672623413,374
7739,3711973519,3918584946,1672652936,1672655464,2528
7804,3935627557,3615046771,1672575753,1672578739,2986
7483,3406784491,3201324715,1672673643,1672676733,3090
7800,3534488837,3772309166,1672610524,1672613674,3150
7555,3509604974,3500994774,1672585478,1672587693,2215
7773,3755798867,3829764737,1672561403,1672563838,2435
7517,3756027749,3756601594,1672666677,1672670039,3362
7822,3311871871,3883085535,1672642448,1672645169,2721
7759,3714504419,3513454145,1672660397,1672662870,2473
7940,3713208927,3736229191,1672597061,1672599872,2811
7607,3629935998,3817621391,1672625452,1672627854,2402
7701,3904408902,3475396323,1672588552,1672591787,3235
7519,3792902982,3755511676,1672547681,1672549623,1942
7711,3755739653,3760561634,1672662705,1672665819,3114
7718,3276640712,3713630656,1672558786,1672560674,1888
7506,3770763956,3500803339,1672586986,1672589051,2065
7948,3683766533,3202120784,1672648724,1672650994,2270
7821,3512142794,3451432842,1672699417,1672701043,1626
7663,3826415738,3715492942,1672697132,1672699662,2530
7739,3358871377,3756930948,1672650732,1672650808,76
7660,3510380060,3391261292,1672596988,1672600074,3086
7902,3552314511,3629547065,1672643217,1672646689,3472
7981,3378686918,3837094550,1672665436,1672667147,1711
7732,3391915121,3713786889,1672638327,1672640393,2066
7739,3244436890,3510969660,1672598334,1672599456,1122
7952,3791594391,3512567240,1672557362,1672559216,1854
7608,3760267716,3481647420,1672546395,1672548157,1762
7723,3291235378,3421836608,1672603884,1672606367,2483
7659,3344019610,3624761861,1672675202,1672675956,754
7660,3509933351,3812176780,1672694740,1672696825,2085
7878,3277669002,3505098372,1672612233,1672615274,3041
7645,3778780511,3703223015,1672676727,1672678377,1650
7524,3394539273,3774520233,1672593843,1672595209,1366
7943,3249791738,3359910781,1672652588,1672654520,1932
7974,3757455053,3772309166,1672581897,1672585169,3272
7589,3513599775,3373384732,1672594305,1672595910,1605
7516,3688418210,3417587765,1672619570,1672620896,1326
7917,3829232696,3512142794,1672698966,1672700413,1447
7690,3552314511,3777717988,1672626533,1672628860,2327
7604,3271938399,3933210486,1672540877,1672543682,2805
7911,3520190170,3509634629,1672610969,1672613060,2091
7793,3935127663,3772746272,1672625891,1672626806,915
7556,3555214688,3511862351,1672615711,1672616929,1218
7765,3772309150,3618873142,1672642571,1672645968,3397
7974,3221899927,3489217083,1672703597,1672706875,3278
7727,3517721725,3703871468,1672673667,1672676885,3218
7746,3402943525,3477375368,1672588108,1672591082,2974
7663,3533369198,3621810464,1672601671,1672604826,3155
7788,3501759100,3200691026,1672588255,1672589212,957
7646,3501364586,3915628728,1672548967,1672549918,951
7644,3703275621,3473765852,1672666655,1672669454,2799
7952,3357483218,3480687894,1672559162,1672561463,2301
7613,3517459919,3801089989,1672602612,1672604361,1749
7684,3520030713,3429856982,1672601829,1672603978,2149
7582,3792288302,3757455053,1672605907,1672606327,420
7631,3773664987,3399004969,1672574475,1672577654,3179
7526,3701111745,3244389794,1672600716,1672603864,3148
7608,3715974031,3904775198,1672616781,1672617260,479
7967,3421836608,3714504419,1672555168,1672556735,1567
7909,3318697153,3755625324,1672681625,1672682718,1093
7484,3512969370,3510857360,1672676222,1672677486,1264
7879,3770635361,3316173088,1672539316,1672539839,523
7741,3388372715,3606186086,1672674176,1672675300,1124
7892,3773120434,3904408902,1672654628,1672654836,208
7781,3791594391,3833889105,1672534788,1672537035,2247
7889,3520629279,3511267139,1672556534,1672557739,1205
7802,3909606423,3307097200,1672613298,1672615416,2118
7621,3793470489,3357483218,1672644183,1672647724,3541
7718,3405494240,3756528686,1672677673,1672678847,1174
7929,3701190899,3242408357,1672688835,1672690175,1340
7753,3516016437,3533827120,1672582686,1672585977,3291
7957,3533927138,3607178184,1672611083,1672612302,1219
7568,3624312512,3519912874,1672649166,1672651445,2279
7560,3755798867,3801089989,1672557269,1672560850,3581
7564,3513080274,3666457294,1672616007,1672618926,2919
7641,3511687358,3409474775,1672635307,1672636415,1108
7830,3779629905,3349613093,1672593844,1672596586,2742
7678,3975287541,3514128943,1672559153,1672561530,2377
7549,3311203656,3711265369,1672577369,1672578187,818
7580,3917278625,3510247121,1672673338,1672676605,3267
7969,3510937904,3510857360,1672540427,1672540557,130
7739,3516016437,3519803045,1672653334,1672656160,2826
7671,3778980116,3513599775,1672655828,1672656688,860
7828,3777936328,3222448362,1672675429,1672676520,1091
7684,3492478793,3711571712,1672562011,1672564931,2920
7570,3710344260,3760077057,1672700163,1672702256,2093
7490,3783196518,3621497531,1672606526,1672606790,264
7660,3519703355,3793086311,1672696119,1672696273,154
7879,3533242305,3780365428,1672656656,1672657849,1193
7983,3415546117,3517963492,1672653731,1672656554,2823
7597,3418534998,3774066725,1672684469,1672687156,2687
7895,3311603601,3755739653,1672559572,1672559776,204
7553,3370752401,3780788622,1672660259,1672662138,1879
7931,3664517356,3494290908,1672634782,1672635283,501
7948,3500229033,3477375368,1672647893,1672648959,1066
7875,3286658957,3517459919,1672559817,1672563089,3272
7585,3880285638,3791957752,1672538432,1672538857,425
7567,3909331423,3618045231,1672612640,1672613874,1234
7825,3825229501,3703789494,1672656230,1672659071,2841
7641,3855602893,3505193212,1672656681,1672658978,2297
7928,3379589402,3780828689,1672584482,1672586571,2089
7898,3804870229,3510703546,1672621090,1672623378,2288
7849,3465202715,3703735129,1672639633,1672640134,501
7663,3406784491,3772642849,1672584327,1672586410,2083
7751,3428674539,3918247820,1672574504,1672577105,2601
7935,3510244400,3731106822,1672669760,1672670506,746
7498,3493507965,3367029997,1672561356,1672563324,1968
7966,3509604974,3711504540,1672664540,1672667944,3404
7682,3772309150,3780294829,1672652715,1672654979,2264
7716,3710344260,3505201246,1672570402,1672573843,3441
7503,3533137446,3200198928,1672559700,1672561526,1826
7893,3783239924,3338367113,1672641906,1672645222,3316
7937,3533095755,3711569060,1672561570,1672564948,3378
7895,3779976989,3500894271,1672627029,1672628999,1970
7726,3710067113,3520030713,1672663840,1672664797,957
7894,3926700506,3273500349,1672541934,1672544965,3031
7811,3280599164,3628819436,1672559796,1672560992,1196
7773,3756601594,3520629279,1672617952,1672619797,1845
7519,3913251733,3777120536,1672627622,1672629317,1695
7662,3780503655,3311090974,1672532318,1672535002,2684
7863,3902278226,3276640712,1672588165,1672589394,1229
7498,3510711755,3606812411,1672663894,1672664788,894
7588,3701995648,3512510536,1672556605,1672558060,1455
7732,3391915886,3501955238,1672678680,1672679445,765
7609,3380035798,3880285638,1672574008,1672576681,2673
7546,3279721246,3792384220,1672567333,1672568962,1629
7783,3287105466,3770824086,1672695646,1672696555,909
7636,3533095755,3701184889,1672557063,1672557238,175
7612,3701111745,3280964728,1672637578,1672640810,3232
7806,3737079798,3755587522,1672630868,1672632787,1919
7873,3791553060,3396086535,1672555165,1672557511,2346
7538,3778266283,3823600322,1672637667,1672640613,2946
7938,3209383861,3714197325,1672591326,1672594404,3078
7950,3417587765,3224716315,1672681911,1672684454,2543
7697,3918674986,3716746253,1672670127,1672671058,931
7898,3808324264,3606812411,1672673703,1672675384,1681
7645,3505477652,3828365570,1672616822,1672618266,1444
7944,3636867411,3394330287,1672593992,1672594795,803
7891,3711504540,3380035798,1672552872,1672554004,1132
7728,3520730271,3517963492,1672681847,1672683589,1742
7660,3533193862,3519152550,1672684262,1672686449,2187
7851,3776066388,3805342762,1672580780,1672581124,344
7848,3855424474,3511170269,1672610436,1672611759,1323
7627,3791594391,3688418210,1672670357,1672673641,3284
7976,3513599775,3618045231,1672570985,1672572231,1246
7842,3817621391,3500458761,1672696023,1672696431,408
7715,3756528686,3429856982,1672662949,1672665944,2995
7965,3534424200,3710408395,1672659427,1672660349,922
7830,3837094550,3606987130,1672674100,1672676326,2226
7959,3472130842,3377766165,1672596637,1672599007,2370
7851,3895562476,3430504438,1672654761,1672656298,1537
7921,3338367113,3388372715,1672564103,1672566799,2696
7582,3311274543,3827626797,1672551399,1672553201,1802
7949,3501184421,3505135325,1672585609,1672586443,834
7967,3471220483,3291883916,1672547497,1672549427,1930
7613,3791657947,3910886626,1672702695,1672705080,2385
7764,3510173870,3514838220,1672538427,1672541197,2770
7719,3778108318,3756027749,1672584114,1672586195,2081
7872,3496051529,3318166135,1672670939,1672671864,925
7840,3500894271,3534488837,1672562983,1672565141,2158
7752,3774366875,3476232529,1672584552,1672586392,1840
7491,3501759100,3701498253,1672604736,1672606381,1645
7560,3303751772,3559110998,1672622781,1672625594,2813
7507,3500994774,3533626375,1672593855,1672594296,441
7912,3370636709,3206254161,1672606708,1672608117,1409
7858,3710067113,3484995752,1672695811,1672697539,1728
7969,3774793839,3475396323,1672595685,1672598502,2817
7828,3783429780,3783196518,1672630280,1672633561,3281
7550,3637008488,3221536550,1672649332,1672649747,415
7533,3496051529,3516223597,1672657406,1672659466,2060
7582,3760267716,3497901842,1672534851,1672536300,1449
7838,3294803686,3519069599,1672554806,1672557113,2307
7623,3780503655,3519703355,1672582356,1672585402,3046
7903,3505883609,3783126683,1672620228,1672623044,2816
7588,3298288268,3755392666,1672587020,1672587545,525
7777,3399911573,3939952128,1672689942,1672691755,1813
7580,3756623396,3475251781,1672665070,1672666957,1887
7938,3509453566,3432689543,1672545728,1672545962,234
7912,3760489031,3518496488,1672639525,1672640665,1140
7792,3370636709,3791553060,1672634233,1672634372,139
7633,3933210486,3533137446,1672561284,1672562685,1401
7815,3426325549,3910454786,1672625879,1672626790,911
7981,3756462516,3755943611,1672601641,1672605172,3531
7582,3776338577,3737079798,1672692599,1672696002,3403
7839,3416427576,3519912874,1672643104,1672646635,3531
7601,3703871468,3710344260,1672632946,1672634669,1723
7508,3534702203,3895562476,1672687704,1672689189,1485
7798,3774066725,3365614305,1672573854,1672575578,1724
7893,3852595551,3505962865,1672692839,1672693886,1047
7522,3774127586,3534488837,1672678585,1672679579,994
7935,3924549929,3277605882,1672607067,1672608511,1444
7547,3616944364,3520165601,1672543470,1672545083,1613
7942,3520165601,3404058699,1672559579,1672561290,1711
7778,3420432297,3516016437,1672572212,1672572637,425
7607,3701498253,3518932404,1672557676,1672558340,664
7548,3518932404,3772642849,1672685912,1672686625,713
7923,3683959482,3459030804,1672690438,1672691995,1557
7541,3514719601,3776800213,1672577272,1672578981,1709
7818,3429856982,3701146057,1672650117,1672652581,2464
7788,3227457126,3825229501,1672617032,1672618548,1516
7942,3607178184,3280599164,1672641727,1672642163,436
7702,3520719611,3757151210,1672549472,1672549853,381
7803,3513454145,3770447408,1672601407,1672601676,269
7929,3451432842,3972364603,1672614701,1672617514,2813
7571,3774125065,3939952128,1672639226,1672640876,1650
7748,3755436115,3466229085,1672672398,1672675252,2854
7875,3391915121,3228165483,1672558448,1672561613,3165
7887,3783239924,3518791447,1672538772,1672540172,1400
7749,3701184889,3770851318,1672582969,1672586222,3253
7679,3489217083,3348261553,1672684493,1672684721,228
7847,3505530961,3793470489,1672589895,1672592015,2120
7888,3774520233,3701146057,1672572740,1672574372,1632
7539,3407673904,3755625324,1672681635,1672683099,1464
7724,3359239884,3515151980,1672655116,1672656070,954
7885,3880285638,3660493209,1672698355,1672700260,1905
7511,3370752401,3383661227,1672568519,1672571261,2742
7745,3783126683,3711265369,1672661803,1672663029,1226
7868,3533270638,3710408395,1672670044,1672670517,473
7652,3512349371,3792177074,1672615721,1672616839,1118
7918,3622054816,3519556068,1672564563,1672565552,989
7520,3515723720,3284639858,1672635514,1672637065,1551
7808,3311152102,3533369198,1672567260,1672568241,981
7786,3466911760,3466229085,1672576059,1672578257,2198
7971,3224716315,3826633236,1672673641,1672676465,2824
7593,3777717988,3388372715,1672582501,1672583083,582
7575,3976633198,3815508790,1672602671,1672605510,2839
7622,3389115045,3774125065,1672545138,1672547234,2096
7487,3624761861,3518791447,1672535434,1672535818,384
7794,3909331423,3501955238,1672607844,1672611083,3239
7836,3313564074,3783509527,1672552058,1672554652,2594
7942,3284832486,3826760240,1672577058,1672578552,1494
7637,3802367797,3421127249,1672703479,1672703759,280
7669,3855602893,3312664885,1672664402,1672666536,2134
7606,3206254161,3534702203,1672675943,1672677899,1956
7642,3970117174,3760509236,1672703176,1672704638,1462
7753,3302626661,3833889105,1672655720,1672655873,153
7532,3791901535,3392121505,1672696364,1672698797,2433
7963,3662180254,3791602225,1672590487,1672593204,2717
7545,3511170269,3505649239,1672556028,1672557505,1477
7687,3666457294,3716165213,1672663372,1672663508,136
7505,3618045231,3520756859,1672596031,1672598588,2557
7978,3554917400,3711569060,1672538975,1672539580,605
7819,3891751546,3683959482,1672663312,1672665495,2183
7802,3668005723,3637008488,1672671572,1672674683,3111
7679,3713268590,3932051427,1672552681,1672553700,1019
7919,3432665384,3804870229,1672623743,1672626453,2710
7968,3710344260,3804870229,1672586438,1672587646,1208
7741,3822654369,3858918246,1672675667,1672676282,615
7877,3520183192,3760561634,1672589868,1672591018,1150
7690,3512567240,3618045231,1672621758,1672623471,1713
7761,3407725581,3779036831,1672634924,1672635803,879
7667,3755872268,3516716179,1672542658,1672544181,1523
7626,3500365158,3774339795,1672548967,1672551198,2231
7520,3391915121,3338367113,1672551357,1672554157,2800
7857,3703718151,3716273414,1672595347,1672596540,1193
7971,3285400528,3760893269,1672647882,1672651130,3248
7532,3615046771,3496549058,1672534428,1672535235,807
7644,3818255890,3921211276,1672595613,1672595867,254
7830,3756021689,3826759140,1672639674,1672641327,1653
7670,3731106822,3505635228,1672679662,1672681472,1810
7814,3514838220,3520730271,1672564013,1672564420,407
7887,3780294829,3501759100,1672686695,1672690266,3571
7508,3358871377,3512142794,1672551420,1672552572,1152
7533,3304056063,3773814927,1672697610,1672700672,3062
7539,3500578848,3755872268,1672543786,1672546664,2878
7660,3760893269,3516039895,1672589717,1672591087,1370
7654,3509933351,3634340855,1672565038,1672566202,1164
7857,3429690204,3783925755,1672665968,1672669486,3518
7657,3316222192,3710569131,1672576020,1672577467,1447
7672,3925620998,3313564074,1672669301,1672671827,2526
7797,3362000049,3311208440,1672646181,1672648586,2405
7721,3519556068,3710408395,1672561177,1672563390,2213
7589,3791942683,3903009525,1672657086,1672659490,2404
7890,3200198928,3501730685,1672650388,1672651843,1455
7966,3385763781,3716168623,1672592984,1672594734,1750
7893,3394330287,3510173870,1672572072,1672572274,202
7909,3779218771,3731106822,1672686025,1672686818,793
7888,3501927421,3614238812,1672548994,1672549428,434
7657,3234362962,3387674757,1672550334,1672553293,2959
7809,3933210486,3249247700,1672531722,1672533879,2157
7896,3406784491,3509630174,1672682076,1672684426,2350
7822,3711198793,3533827120,1672579169,1672582710,3541
7581,3399433690,3500229033,1672661078,1672661343,265
7600,3715981584,3232962003,1672568289,1672570866,2577
7675,3889232789,3792288302,1672589153,1672589923,770
7629,3369998498,3715981584,1672661483,1672662572,1089
7897,3378092448,3857349323,1672598369,1672599652,1283
7811,3914259449,3886298125,1672548084,1672549699,1615
7595,3755943611,3520030713,1672586657,1672587074,417
7625,3792384220,3516039895,1672543540,1672544281,741
7706,3778266283,3516980378,1672624440,1672627864,3424
7688,3756462516,3518496488,1672557789,1672558487,698
7803,3509630174,3855602893,1672620313,1672622284,1971
7590,3399004969,3369998498,1672670711,1672673136,2425
7975,3777477395,3780914982,1672582864,1672584254,1390
7974,3606812411,3783705817,1672601184,1672603689,2505
7494,3779218771,3500499542,1672699000,1672700813,1813
7618,3512969370,3621810464,1672561285,1672561634,349
7506,3793753089,3903962771,1672596589,1672599086,2497
7497,3613683164,3736229191,1672585696,1672588002,2306
7633,3711198793,3500658339,1672549917,1672550264,347
7633,3249247700,3559110998,1672695091,1672696907,1816
7676,3424922204,3716197887,1672632690,1672635543,2853
7863,3770851318,3783531004,1672559376,1672562283,2907
7950,3914259449,3770635361,1672674940,1672675854,914
7959,3517963492,3516011407,1672596689,1672596794,105
7665,3755920131,3783126683,1672591938,1672595268,3330
7865,3519556068,3429690204,1672699268,1672701451,2183
7516,3289061738,3433804879,1672537934,1672539638,1704
7607,3839849341,3234362962,1672690292,1672692824,2532
7683,3804870229,3827222533,1672534207,1672536880,2673
7556,3793470489,3909238838,1672597056,1672599186,2130
7724,3336751428,3772642849,1672604449,1672605165,716
7763,3206603608,3477649378,1672651993,1672654943,2950
7516,3427283336,3683766533,1672658108,1672660435,2327
7645,3515125508,3370636709,1672546077,1672546249,172
7800,3780365428,3465202715,1672534543,1672535276,733
7667,3429690204,3629547065,1672633129,1672634861,1732
7925,3351008918,3420432297,1672564880,1672566906,2026
7582,3509907947,3606186086,1672664578,1672667243,2665
7945,3513956646,3779036831,1672544171,1672546949,2778
7607,3760569731,3512510536,1672658081,1672660363,2282
7678,3473765852,3533193862,1672589477,1672590362,885
7590,3378092448,3338367113,1672560227,1672560398,171
7659,3713349754,3757151210,1672585037,1672586802,1765
7631,3501730685,3443698222,1672685437,1672688987,3550
7766,3516909237,3793436995,1672635829,1672638390,2561
7549,3314245084,3201848640,1672693120,1672696144,3024
7894,3509352754,3509352754,1672590318,1672593410,3092
7552,3311324983,3883085535,1672589815,1672590379,564
7962,3533626375,3800886801,1672564949,1672567258,2309
7554,3713208927,3513080274,1672610862,1672614170,3308
7675,3855424474,3935627557,1672668656,1672670765,2109
7971,3922275620,3391261292,1672558434,1672560576,2142
7648,3780914982,3202120784,1672566156,1672568336,2180
7881,3710067113,3777443199,1672575790,1672577713,1923
7659,3916289176,3533025282,1672551600,1672554843,3243
7832,3793753089,3475795792,1672621916,1672623836,1920
7618,3914259449,3793338102,1672691493,1672692230,737
7727,3760294205,3773598056,1672682458,1672684896,2438
7826,3756453423,3895562476,1672612153,1672613420,1267
7649,3500199935,3500578848,1672679199,1672679905,706
7773,3817316561,3505173328,1672580623,1672582045,1422
7656,3924549929,3428964059,1672577417,1672577510,93
7658,3773664987,3808324264,1672594341,1672597858,3517
7961,3755872268,3625274012,1672580443,1672582021,1578
7526,3356860407,3505203158,1672586445,1672589334,2889
7948,3756462516,3972709319,1672636096,1672636693,597
7725,3855424474,3772309150,1672597328,1672599654,2326
7645,3917088658,3880285638,1672640266,1672642516,2250
7912,3500904641,3409474775,1672540727,1672541401,674
7806,3388372715,3378092448,1672553188,1672554626,1438
7657,3772714862,3882242815,1672653815,1672654732,917
7908,3731419510,3311090974,1672633755,1672636691,2936
7702,3774005526,3388286531,1672642452,1672642742,290
7490,3839849341,3220716272,1672658801,1672660952,2151
7684,3555214688,3448855696,1672601158,1672604262,3104
7574,3405494240,3664170666,1672699522,1672702454,2932
7882,3774339795,3777477395,1672638419,1672641271,2852
7710,3513956646,3364543015,1672587146,1672590324,3178
7982,3349613093,3520730271,1672582434,1672583488,1054
7833,3312829208,3511435497,1672638649,1672639185,536
7617,3774045700,3311324983,1672665509,1672668990,3481
7641,3859663348,3608633356,1672683277,1672685259,1982
7982,3227457126,3772544062,1672620955,1672623206,2251
7791,3735733948,3409474775,1672684389,1672687079,2690
7640,3800886801,3311761694,1672638549,1672638834,285
7944,3514283243,3394539273,1672590759,1672594243,3484
7682,3773755137,3736229191,1672623578,1672626732,3154
7871,3231056870,3755587522,1672647620,1672649917,2297
7982,3509352754,3505599848,1672556829,1672560031,3202
7948,3384951177,3883861463,1672698419,1672698567,148
7780,3713630656,3783705817,1672684221,1672687557,3336
7551,3826415738,3430074045,1672542924,1672545671,2747
7982,3352603894,3713786889,1672677242,1672679097,1855
7953,3792668962,3349613093,1672642826,1672644607,1781
7939,3516465662,3221536550,1672671789,1672671931,142
7940,3420432297,3200691026,1672587002,1672590567,3565
7695,3418534998,3500374658,1672630207,1672632970,2763
7681,3318697153,3501184421,1672665502,1672668413,2911
7681,3477375368,3801089989,1672681832,1672685204,3372
7673,3556951786,3288764520,1672692042,1672692846,804
7722,3519428855,3497901842,1672629224,1672631027,1803
7743,3901877072,3711308224,1672631026,1672632280,1254
7900,3505869747,3345207877,1672574974,1672575060,86
7940,3517721725,3904408902,1672552558,1672552705,147
7802,3755587522,3778266283,1672696337,1672699435,3098
7775,3360506772,3793753089,1672638952,1672640859,1907
7884,3384951177,3512217942,1672531753,1672532642,889
7805,3715339701,3501955238,1672611729,1672615117,3388
7630,3607178184,3555214688,1672632734,1672633204,470
7627,3778108318,3778308417,1672565448,1672567647,2199
7526,3412825109,3510969660,1672545290,1672548200,2910
7616,3610348516,3639847263,1672621515,1672624399,2884
7524,3911245524,3607178184,1672593437,1672595263,1826
7577,3701146057,3760492950,1672557951,1672559023,1072
7779,3316173088,3601879040,1672683959,1672685122,1163
7500,3367902229,3889232789,1672672010,1672674437,2427
7633,3776800213,3311603601,1672625219,1672626591,1372
7484,3685187183,3304056063,1672627026,1672627502,476
7671,3446948848,3386707783,1672658069,1672661376,3307
7634,3778108318,3475258557,1672663387,1672664955,1568
7920,3683959482,3485375593,1672570942,1672573298,2356
7533,3668005723,3666507626,1672634887,1672636636,1749
7707,3839849341,3289061738,1672580265,1672581787,1522
7850,3737154119,3666457294,1672691299,1672693181,1882
7739,3617055293,3293695955,1672659242,1672660342,1100
7841,3756424865,3244173074,1672638451,1672641513,3062
7821,3501198706,3301107849,1672634880,1672636684,1804
7827,3533927138,3703223015,1672543209,1672543700,491
7567,3416265063,3505201246,1672547945,1672551122,3177
7721,3737154119,3688683847,1672531484,1672532850,1366
7885,3516011407,3777929708,1672635297,1672636229,932
7809,3223789409,3777790718,1672619128,1672620697,1569
7863,3364543015,3407954858,1672600040,1672601845,1805
7936,3858918246,3331845324,1672537358,1672537543,185
7849,3293695955,3511350608,1672552358,1672554110,1752
7547,3793962300,3500060260,1672544816,1672545134,318
7969,3311648200,3514472925,1672537893,1672541345,3452
7943,3777477395,3777477395,1672584098,1672584313,215
7708,3628819436,3611150562,1672657726,1672658958,1232
7649,3505347134,3396285984,1672700401,1672701941,1540
7824,3360743849,3791657947,1672645022,1672645309,287
7706,3520730271,3509773875,1672675335,1672677524,2189
7734,3519601612,3932051427,1672650001,1672651817,1816
7640,3710112546,3420700674,1672581692,1672583285,1593
7946,3351008918,3772337814,1672574180,1672574372,192
7623,3668005723,3701863557,1672703694,1672706098,2404
7581,3429856982,3312829208,1672556106,1672556674,568
7601,3793286136,3701111745,1672563603,1672565789,2186
7579,3703275621,3505292701,1672694538,1672694751,213
7944,3388372715,3756027749,1672612657,1672613105,448
7692,3209048907,3206254161,1672606625,1672609022,2397
7692,3415546117,3809059934,1672577651,1672580071,2420
7573,3304056063,3339907603,1672532783,1672533350,567
7717,3852595551,3516716179,1672643249,1672645950,2701
7858,3520165601,3505791599,1672694149,1672696484,2335
7892,3438645253,3374559242,1672660570,1672663029,2459
7908,3608868877,3513956646,1672615290,1672618154,2864
7768,3760992710,3518014404,1672532600,1672534401,1801
7780,3703223015,3715981584,1672600031,1672601439,1408
7602,3287105466,3505873261,1672552522,1672553592,1070
7490,3783239924,3311415018,1672662463,1672664519,2056
7622,3737079798,3899371911,1672657033,1672659041,2008
7549,3473562469,3288764520,1672667217,1672669237,2020
7573,3780365428,3298433163,1672653763,1672656365,2602
7759,3311845971,3510247121,1672566657,1672567301,644
7706,3484995752,3774501422,1672613333,1672616821,3488
7863,3791553060,3714821932,1672560199,1672561522,1323
7638,3505135325,3284832486,1672593324,1672594671,1347
7834,3918247820,3792177074,1672652417,1672655028,2611
7926,3701274634,3481502100,1672623587,1672626047,2460
7855,3774066725,3736786443,1672685009,1672687415,2406
7713,3711265369,3899204805,1672584708,1672584806,98
7722,3420432297,3513956646,1672643817,1672644609,792
7759,3448855696,3915628728,1672669332,1672671612,2280
7725,3760992710,3912536808,1672669139,1672672538,3399
7487,3757447189,3515125508,1672585567,1672588390,2823
7577,3489217083,3500805881,1672633375,1672636786,3411
7934,3770447408,3793338102,1672695334,1672697687,2353
7837,3711973519,3518163778,1672570143,1672572981,2838
7833,3481502100,3911159965,1672653199,1672654036,837
7639,3513599775,3776513891,1672614081,1672617019,2938
7669,3774520233,3760509236,1672543373,1672544640,1267
7661,3475396323,3287105466,1672637992,1672641303,3311
7666,3514719601,3516065852,1672547545,1672550010,2465
7753,3509773875,3683766533,1672650342,1672650803,461
7555,3910454786,3701184889,1672600480,1672603355,2875
7546,3921211276,3518876135,1672604470,1672607886,3416
7909,3206593906,3792844210,1672688047,1672689120,1073
7886,3332072298,3917278625,1672568547,1672571331,2784
7856,3534553510,3774268456,1672630353,1672630510,157
7738,3478194807,3519428855,1672623721,1672627013,3292
7499,3918247820,3473562469,1672553472,1672554809,1337
7818,3412980697,3395152943,1672681479,1672683314,1835
7942,3716258994,3520730271,1672655168,1672657577,2409
7486,3792288302,3505201246,1672610372,1672613452,3080
7856,3633420270,3231056870,1672601090,1672603370,2280
7838,3280599164,3430504438,1672615704,1672618639,2935
7766,3334033993,3601879040,1672626628,1672628883,2255
7798,3500229033,3500060260,1672645212,1672646611,1399
7587,3519703355,3389115045,1672680673,1672682656,1983
7961,3555214688,3370752401,1672681036,1672683955,2919
7486,3713370078,3286658957,1672534073,1672534539,466
7786,3611150562,3519556068,1672641202,1672643769,2567
7707,3246596716,3731419510,1672556336,1672558901,2565
7895,3773978034,3512510536,1672577691,1672579636,1945
7944,3716746253,3778266283,1672688959,1672690402,1443
7501,3701065786,3279721246,1672567781,1672567980,199
7962,3510173870,3433804879,1672534511,1672537106,2595
7679,3533025282,3333896808,1672676247,1672679350,3103
7908,3901877072,3711265369,1672609073,1672611571,2498
7672,3505962865,3703871468,1672559237,1672560092,855
7814,3484995752,3227457126,1672587163,1672589488,2325
7523,3760569731,3715998609,1672570440,1672571508,1068
7904,3311203656,3411618230,1672558032,1672559733,1701
7930,3777790718,3615046771,1672616041,1672616329,288
7725,3606987130,3421836608,1672589274,1672590619,1345
7875,3512720680,3512837326,1672570814,1672573131,2317
7628,3715981584,3760509236,1672619541,1672619947,406
7799,3976390453,3337544549,1672679808,1672681214,1406
7792,3922275620,3809916577,1672579612,1672582553,2941
7539,3501759100,3405494240,1672614369,1672614980,611
7729,3777929708,3902278226,1672652953,1672655119,2166
7485,3287105466,3511841857,1672703593,1672704801,1208
7838,3779629905,3922337974,1672609938,1672612875,2937
7898,3400918687,3780813786,1672682409,1672683953,1544
7721,3346327502,3922275620,1672643128,1672645035,1907
7524,3369998498,3668005723,1672554664,1672556299,1635
7544,3774125065,3715189301,1672697900,1672701135,3235
7934,3488244966,3713894336,1672632476,1672634864,2388
7601,3418728074,3793389510,1672590957,1672591235,278
7701,3416427576,3510126867,1672556875,1672558091,1216
7894,3760492950,3776066388,1672612833,1672613410,577
7595,3760561634,3777983879,1672563585,1672567109,3524
7708,3483164654,3713349754,1672566638,1672567888,1250
7518,3520206212,3510969660,1672538937,1672541087,2150
7620,3731419510,3378092448,1672681226,1672682593,1367
7564,3511198618,3482405588,1672637069,1672637438,369
7765,3777079686,3780914982,1672703556,1672704359,803
7520,3930791338,3373384732,1672639552,1672642237,2685
7766,3500805881,3756453423,1672605938,1672609389,3451
7656,3714504419,3760598102,1672571954,1672572160,206
7639,3777929708,3735733948,1672570371,1672573428,3057
7932,3883085535,3779218771,1672593496,1672595182,1686
7814,3516011407,3760893269,1672694851,1672696089,1238
7852,3510857360,3277605882,1672580360,1672582665,2305
7795,3858918246,3772884106,1672605388,1672607359,1971
7805,3774268456,3793389510,1672640760,1672642100,1340
7508,3770021824,3232962003,1672698409,1672699973,1564
7584,3438645253,3284639858,1672607338,1672610662,3324
7695,3793871337,3756453423,1672660000,1672663306,3306
7680,3221899927,3770553384,1672645893,1672647996,2103
7795,3391261292,3223968713,1672611775,1672612248,473
7692,3713370078,3737079798,1672653001,1672655561,2560
7682,3736419952,3772714862,1672547853,1672550924,3071
7686,3773429448,3777929708,1672573797,1672576999,3202
7714,3818255890,3701534009,1672593460,1672596144,2684
7890,3604539807,3280599164,1672658468,1672660953,2485
7574,3209048907,3311152102,1672661434,1672664424,2990
7707,3481647420,3533626375,1672656150,1672656707,557
7983,3509604974,3780639480,1672562998,1672564004,1006
7659,3792768129,3386707783,1672648998,1672649477,479
7814,3703441914,3755798867,1672667746,1672671293,3547
7864,3817316561,3298288268,1672680856,1672681417,561
7865,3936227020,3518791447,1672675489,1672677603,2114
7519,3249247700,3711265369,1672674517,1672674727,210
7756,3736229191,3512166013,1672544160,1672545288,1128
7765,3315583351,3346795719,1672593212,1672593346,134
7915,3311090974,3249791738,1672546532,1672547567,1035
7878,3715189301,3336742544,1672544345,1672547722,3377
7485,3853018906,3394330287,1672679596,1672681261,1665
7491,3514245078,3770851318,1672566995,1672570397,3402
7899,3736625083,3899371911,1672578600,1672581385,2785
7749,3827626797,3783083229,1672532520,1672534968,2448
7563,3778108318,3351554343,1672598414,1672599005,591
7530,3394330287,3420700674,1672558564,1672559610,1046
7565,3916289176,3621810464,1672687983,1672689761,1778
7714,3480687894,3511350608,1672600377,1672601235,858
7972,3805292782,3666507626,1672632247,1672633871,1624
7591,3280964728,3492478793,1672694949,1672697910,2961
7863,3780503655,3757602960,1672582502,1672583856,1354
7641,3898995675,3383922351,1672557248,1672558885,1637
7495,3629547065,3756930948,1672576875,1672579671,2796
7706,3378092448,3311993075,1672625867,1672626396,529
7600,3760294205,3818255890,1672681317,1672684002,2685
7661,3703441914,3920801189,1672580889,1672582033,1144
7570,3520206212,3772578994,1672565153,1672565902,749
7707,3978115672,3791874383,1672650048,1672652415,2367
7688,3829319703,3311152102,1672614413,1672617191,2778
7772,3701178711,3516514391,1672580161,1672581603,1442
7804,3379256399,3914259449,1672561020,1672564158,3138
7535,3316222192,3715127362,1672646825,1672650377,3552
7613,3791942683,3855602893,1672562407,1672564686,2279
7814,3757246925,3922275620,1672651588,1672652291,703
7513,3819727225,3886298125,1672567949,1672568594,645
7654,3904408902,3778980116,1672584592,1672584949,357
7524,3793338102,3519654779,1672674638,1672677021,2383
7851,3701274634,3822654369,1672570263,1672571416,1153
7930,3903962771,3505193212,1672665668,1672666677,1009
7965,3606812411,3519700826,1672688091,1672689885,1794
7867,3488244966,3429690204,1672630114,1672633553,3439
7851,3807987001,3511163800,1672613817,1672615278,1461
7712,3271938399,3296471982,1672624273,1672625457,1184
7661,3311993075,3920801189,1672638020,1672641244,3224
7796,3496051529,3519428855,1672575533,1672575806,273
7620,3770824086,3505649239,1672566071,1672568015,1944
7552,3367029997,3922275620,1672660735,1672661736,1001
7667,3701190899,3701274634,1672552651,1672554451,1800
7869,3805519285,3978115672,1672633567,1672636446,2879
7706,3738274418,3512837326,1672701810,1672702461,651
7810,3518791447,3779218771,1672623167,1672626227,3060
7650,3513454145,3793436995,1672633900,1672636300,2400
7857,3793848402,3607748895,1672687962,1672688813,851
7978,3780609808,3793286136,1672678193,1672680186,1993
7617,3518408774,3351008918,1672637232,1672640513,3281
7496,3365614305,3505859863,1672693113,1672695133,2020
7812,3234362962,3772359096,1672605162,1672605443,281
7878,3972709319,3518932404,1672673776,1672676065,2289
7602,3779629905,3520730271,1672535928,1672537845,1917
7935,3716258994,3760893269,1672653967,1672654208,241
7626,3514838220,3802367797,1672676549,1672678065,1516
7581,3629935998,3858918246,1672537361,1672540294,2933
7705,3777717988,3510711755,1672583492,1672584379,887
7878,3339907603,3518876135,1672689626,1672690288,662
7865,3446948848,3890149705,1672700678,1672702410,1732
7792,3922275416,3780974443,1672664673,1672665445,772
7547,3318697153,3755798867,1672587553,1672587666,113
7732,3899266183,3713644518,1672663238,1672666624,3386
7637,3208844525,3772337814,1672653441,1672656323,2882
7635,3714474557,3505883609,1672582067,1672584826,2759
7537,3715981584,3228165483,1672571292,1672571999,707
7846,3511435497,3618045231,1672557015,1672559200,2185
7890,3389115045,3432665384,1672649554,1672652133,2579
7484,3634786711,3755739653,1672615941,1672617041,1100
7735,3277605882,3756966035,1672664038,1672665322,1284
7597,3388637594,3624312512,1672533752,1672536446,2694
7813,3757161914,3319752091,1672583403,1672584470,1067
7858,3518932404,3379589402,1672625346,1672627197,1851
7922,3316173088,3829764737,1672570617,1672573045,2428
7636,3760267716,3935127663,1672556862,1672560164,3302
7821,3202120784,3828432634,1672580225,1672580667,442
7612,3247815299,3520719611,1672563994,1672565161,1167
7947,3516980378,3713644518,1672621852,1672625437,3585
7777,3533653428,3501364586,1672574445,1672575467,1022
7743,3760183458,3391915886,1672698530,1672701634,3104
7738,3533137446,3311065516,1672622583,1672626167,3584
7820,3780974443,3711265369,1672617643,1672621196,3553
7623,3756451663,3887270940,1672676030,1672676286,256
7651,3511350608,3500805881,1672635284,1672636387,1103
7551,3433804879,3209383861,1672696556,1672699497,2941
7797,3624312512,3221899927,1672657578,1672659864,2286
7866,3773465237,3713644518,1672581299,1672584095,2796
7767,3826760240,3817316561,1672645906,1672648869,2963
7948,3407725581,3472130842,1672579140,1672580693,1553
7560,3505791599,3500060260,1672541038,1672541360,322
7794,3291235378,3516980378,1672597060,1672597676,616
7564,3757455053,3772884106,1672613604,1672614497,893
7754,3633420270,3770763956,1672695313,1672697612,2299
7866,3222521619,3356860407,1672539758,1672542028,2270
7608,3880310724,3811171116,1672607988,1672608397,409
7777,3772578994,3735319397,1672599531,1672602482,2951
7531,3791874383,3738502357,1672534906,1672538059,3153
7765,3400804807,3613683164,1672562220,1672563690,1470
7484,3481502100,3760509236,1672623306,1672623683,377
7702,3882242815,3383922351,1672693006,1672694289,1283
7939,3756453423,3289061738,1672559222,1672560253,1031
7666,3780813786,3777806071,1672632874,1672635268,2394
7799,3510969660,3501364586,1672694075,1672696833,2758
7503,3505145247,3311415018,1672683266,1672683691,425
7921,3936227020,3760598102,1672558035,1672561095,3060
7497,3390068992,3777936328,1672603744,1672604864,1120
7640,3509453566,3249401741,1672622518,1672622758,240
7889,3701146057,3757602960,1672678888,1672680477,1589
7832,3430074045,3783509527,1672598628,1672600489,1861
7958,3311203656,3711973519,1672607032,1672608588,1556
7839,3475251781,3666553782,1672652786,1672654440,1654
7828,3713370078,3826760240,1672638276,1672639927,1651
7495,3519152550,3780503655,1672595485,1672597012,1527
7861,3777790718,3621810464,1672577688,1672580258,2570
7909,3738502357,3511435497,1672699366,1672701471,2105
7908,3533827120,3412825109,1672616596,1672618680,2084
7624,3890149705,3311871871,1672595417,1672595857,440
7895,3710067113,3622054816,1672572863,1672575006,2143
7539,3505000737,3780365428,1672693249,1672694753,1504
7841,3791942683,3505347134,1672531942,1672534645,2703
7891,3666553782,3926700506,1672675298,1672675987,689
7933,3361230905,3773429448,1672655483,1672658468,2985
7804,3235287260,3515284591,1672631855,1672632440,585
7860,3883085535,3236102733,1672609535,1672611483,1948
7730,3519703355,3760569731,1672611693,1672613442,1749
7924,3777806071,3533810360,1672561049,1672562234,1185
7761,3774195321,3284639858,1672578201,1672581432,3231
7788,3701498253,3459030804,1672551153,1672554249,3096
7641,3510126867,3344019610,1672693339,1672696151,2812
7609,3829232696,3418728074,1672549280,1672551130,1850
7604,3792844210,3505203158,1672665728,1672667981,2253
7568,3760569731,3513201436,1672623062,1672626168,3106
7852,3345207877,3827377568,1672681710,1672682611,901
7632,3770447408,3883042241,1672661213,1672664584,3371
7981,3365942576,3791115967,1672565804,1672566665,861
7823,3903009525,3701146057,1672589457,1672590159,702
7761,3716537575,3901990690,1672616741,1672619197,2456
7971,3518876135,3932051427,1672560046,1672561204,1158
7931,3714474557,3815508790,1672601117,1672604048,2931
7561,3733189298,3889232789,1672557853,1672559173,1320
7794,3427219654,3816853177,1672649458,1672651917,2459
7725,3534553510,3734828619,1672666311,1672667261,950
7773,3823600322,3244436890,1672647672,1672650676,3004
7796,3757161914,3485823740,1672611187,1672614267,3080
7517,3778549126,3914259449,1672575022,1672577242,2220
7950,3518932404,3819727225,1672581811,1672584439,2628
7582,3516465662,3397418363,1672539816,1672542237,2421
7512,3829319703,3701146057,1672600141,1672601691,1550
7972,3512349371,3465254146,1672531295,1672534064,2769
7639,3293695955,3624761861,1672609974,1672612523,2549
7907,3808324264,3396285984,1672588328,1672591176,2848
7527,3780365428,3517255726,1672573351,1672574914,1563
7907,3501184421,3505599848,1672540836,1672541306,470
7496,3973560347,3514472925,1672687815,1672688765,950
7507,3792473331,3915628728,1672548996,1672550112,1116
7931,3364543015,3505883609,1672554128,1672557417,3289
7542,3333896808,3511163800,1672636028,1672639484,3456
7824,3512540951,3902383721,1672622388,1672622747,359
7495,3779218771,3311065516,1672657909,1672658157,248
7741,3311627628,3629935998,1672533721,1672535014,1293
7493,3932051427,3533810360,1672622156,1672622817,661
7800,3736419952,3273500349,1672568924,1672571933,3009
7493,3510703546,3377766165,1672540037,1672540298,261
7929,3792768129,3483949762,1672606110,1672606647,537
7568,3772359096,3404384505,1672554779,1672555946,1167
7639,3757562897,3318697153,1672573148,1672576369,3221
7924,3489728806,3755872268,1672681552,1672684065,2513
7717,3516258476,3518014636,1672651598,1672652509,911
7929,3701984666,3731419510,1672531402,1672532335,933
7598,3792768129,3812176780,1672558677,1672560392,1715
7583,3512166013,3501486692,1672657849,1672659202,1353
7735,3505530961,3311993075,1672600448,1672603701,3253
7983,3304625412,3935127663,1672624624,1672627754,3130
7937,3666457294,3777806071,1672687933,1672690283,2350
7773,3774339795,3618873142,1672547899,1672548963,1064
7839,3427219654,3713370078,1672687687,1672690791,3104
7500,3505883609,3713349754,1672624818,1672626192,1374
7807,3429856982,3858918246,1672641538,1672643110,1572
7621,3774339795,3757403279,1672631106,1672632817,1711
7542,3778549126,3514128943,1672678896,1672680864,1968
7580,3303705369,3514719601,1672581337,1672581909,572
7566,3828432634,3417587765,1672676796,1672677981,1185
7573,3667680268,3809916577,1672593341,1672593518,177
7869,3206254161,3515284591,1672672336,1672674918,2582
7800,3229665776,3711504540,1672591902,1672594956,3054
7571,3755392666,3791334389,1672618366,1672619070,704
7618,3316222192,3829319703,1672559263,1672561170,1907
7654,3911159965,3793959750,1672587258,1672590541,3283
7567,3519803045,3773978034,1672567982,1672571020,3038
7697,3248507722,3633420270,1672672773,1672674994,2221
7702,3736592744,3510937904,1672619442,1672622523,3081
7664,3293695955,3774127586,1672592888,1672594519,1631
7761,3291883916,3624761861,1672670279,1672671739,1460
7810,3500458761,3703789494,1672651807,1672652063,256
7591,3493507965,3512720680,1672552119,1672555028,2909
7887,3774501422,3756930948,1672573469,1672575588,2119
7866,3774195321,3600647945,1672679885,1672682643,2758
7833,3510247121,3777455223,1672539128,1672542246,3118
7971,3792473331,3513201436,1672563754,1672564140,386
7832,3760489031,3550946908,1672635607,1672637724,2117
7576,3834257412,3520629279,1672535105,1672535980,875
7782,3348261553,3770635361,1672643965,1672645551,1586
7564,3494290908,3501759100,1672600515,1672602285,1770
7564,3714488548,3912262917,1672575328,1672575542,214
7491,3770635361,3418728074,1672568824,1672571950,3126
7666,3826415738,3505962865,1672656628,1672658979,2351
7495,3518260334,3776800213,1672669890,1672672247,2357
7764,3772578994,3505638204,1672699975,1672700974,999
7852,3714197325,3505362057,1672681639,1672682023,384
7713,3773664987,3701184889,1672610954,1672614027,3073
7791,3428674539,3399052055,1672673340,1672675424,2084
7890,3516065852,3533193862,1672610490,1672614061,3571
7567,3701065786,3922275416,1672555805,1672556093,288
7618,3625274012,3428674539,1672692715,1672695817,3102
7775,3505193212,3972709319,1672585651,1672586354,703
7975,3783196518,3701111745,1672566607,1672566929,322
7828,3773429448,3517963492,1672693572,1672694478,906
7969,3710098970,3793848402,1672548511,1672549756,1245
7880,3600647945,3776513891,1672648188,1672650941,2753
7639,3277939457,3517255726,1672629504,1672629603,99
7760,3757161914,3404058699,1672631000,1672634589,3589
7756,3852595551,3922275620,1672557217,1672558678,1461
7635,3973560347,3509352754,1672597617,1672599359,1742
7881,3711571712,3606186086,1672562611,1672564171,1560
7777,3510126867,3222448362,1672541088,1672543005,1917
7839,3731106822,3918674986,1672574625,1672577316,2691
7857,3792384220,3501601840,1672695922,1672698873,2951
7485,3510857360,3716258994,1672567948,1672568174,226
7860,3438645253,3235635976,1672627151,1672628138,987
7698,3772642849,3757562897,1672664109,1672666173,2064
7744,3514472925,3520706195,1672604744,1672605328,584
7710,3516011407,3793470489,1672631466,1672635050,3584
7672,3311203656,3496269445,1672596625,1672599021,2396
7562,3688418210,3489728806,1672557338,1672558839,1501
7963,3756424865,3899266183,1672619741,1672622581,2840
7808,3313564074,3772359096,1672609126,1672610169,1043
7827,3516514391,3772758337,1672583593,1672584687,1094
7934,3206593906,3629547065,1672542336,1672543743,1407
7672,3622054816,3509630174,1672696339,1672697698,1359
7841,3276640712,3401627165,1672577860,1672578827,967
7547,3201432789,3832902928,1672645842,1672646888,1046
7547,3516258476,3703789494,1672563444,1672564650,1206
7787,3779218771,3432689543,1672645726,1672646323,597
7944,3667680268,3664170666,1672631701,1672634881,3180
7959,3286658957,3209383861,1672545045,1672546654,1609
7808,3711569060,3200691026,1672576118,1672576907,789
7779,3311761694,3614238812,1672597501,1672597666,165
7910,3736229191,3978115672,1672592037,1672595420,3383
7724,3629547065,3238712269,1672647458,1672647556,98
7595,3855000166,3231056870,1672666864,1672669592,2728
7918,3271938399,3780914982,1672602620,1672603182,562
7912,3516673015,3757246925,1672619126,1672620351,1225
7954,3344019610,3209027249,1672680802,1672684358,3556
7772,3910886626,3520719611,1672595168,1672597537,2369
7750,3755920131,3783196518,1672652578,1672654198,1620
7494,3356860407,3973560347,1672630619,1672634052,3433
7902,3828624701,3779218771,1672580799,1672583020,2221
7690,3519069599,3482405588,1672653179,1672656492,3313
7892,3773814927,3777623166,1672550793,1672552370,1577
7596,3505193212,3311603601,1672555450,1672556974,1524
7910,3711973519,3519556068,1672641847,1672642102,255
7533,3510247121,3311154569,1672699701,1672702728,3027
7690,3289061738,3713786889,1672689382,1672690256,874
7913,3519556068,3714962248,1672595683,1672599274,3591
7945,3424922204,3904775198,1672628836,1672630304,1468
7724,3760569731,3805292782,1672536709,1672537562,853
7720,3802367797,3475396323,1672587065,1672590321,3256
7566,3379589402,3828432634,1672577588,1672580538,2950
7695,3755392666,3533270638,1672695147,1672695444,297
7684,3772578994,3713370078,1672562503,1672563630,1127
7722,3793848402,3511862351,1672562132,1672565411,3279
7762,3516716179,3921211276,1672584828,1672586284,1456
7774,3520709480,3533371364,1672698431,1672699037,606
7625,3711262377,3793436995,1672533479,1672534074,595
7941,3352603894,3701863557,1672544642,1672547631,2989
7622,3716900301,3311761694,1672683767,1672686836,3069
7935,3755739653,3429856982,1672584695,1672585827,1132
7838,3914259449,3505649239,1672651280,1672654149,2869
7520,3399052055,3662180254,1672688567,1672690189,1622
7743,3773598056,3777514571,1672550344,1672550627,283
7562,3662180254,3303751772,1672531439,1672534299,2860
7558,3438645253,3515691540,1672675133,1672678450,3317
7594,3311324983,3505477652,1672591078,1672592020,942
7722,3512217942,3777120536,1672588963,1672591772,2809
7865,3778780511,3773755137,1672633965,1672635125,1160
7584,3899204805,3488244966,1672638635,1672642114,3479
7752,3636867411,3883312122,1672634150,1672636506,2356
7544,3832902928,3510247121,1672623623,1672624258,635
7914,3773950140,3885670556,1672559394,1672560758,1364
7895,3303751772,3513599775,1672595178,1672597576,2398
7807,3200198928,3505912939,1672594912,1672595746,834
7806,3978115672,3378686918,1672554050,1672555191,1141
7492,3519700826,3805519285,1672634977,1672635665,688
7649,3234362962,3703013906,1672702696,1672704203,1507
7531,3510380060,3346795719,1672615865,1672618956,3091
7896,3415443558,3778780511,1672677433,1672678366,933
7797,3770851318,3387674757,1672583911,1672585458,1547
7813,3881477378,3711308224,1672606024,1672607121,1097
7590,3415546117,3755392666,1672688049,1672690236,2187
7714,3778549126,3711370563,1672617491,1672620661,3170
7672,3812176780,3804870229,1672637789,1672638602,813
7533,3711504540,3713808837,1672659686,1672661810,2124
7681,3356860407,3904408902,1672663905,1672665407,1502
7966,3208844525,3303751772,1672607942,1672608726,784
7713,3289061738,3736419952,1672573270,1672574599,1329
7930,3778549126,3855424474,1672640820,1672641722,902
7880,3760509236,3500374658,1672695986,1672697672,1686
7845,3402943525,3516629436,1672622086,1672624402,2316
7519,3760294205,3511862351,1672563738,1672564896,1158
7588,3731419510,3773978034,1672552051,1672554601,2550
7619,3859663348,3760492950,1672641188,1672642070,882
7812,3505219850,3713208927,1672567588,1672568607,1019
7927,3244389794,3760509236,1672589157,1672590950,1793
7647,3857349323,3735319397,1672562268,1672563258,990
7861,3465254146,3311208440,1672605455,1672609011,3556
7649,3710569131,3791942683,1672564166,1672566792,2626
7641,3505702787,3701190899,1672610052,1672611218,1166
7797,3792384220,3809916577,1672675412,1672676383,971
7763,3505477652,3716168623,1672670382,1672673551,3169
7484,3518163778,3701065786,1672546651,1672550210,3559
7957,3772578994,3516673015,1672610583,1672614167,3584
7625,3501601840,3500177712,1672590129,1672591110,981
7837,3533280269,3826415738,1672637499,1672638009,510
7675,3446948848,3713786889,1672535229,1672537270,2041
7879,3534191820,3773664987,1672608811,1672611570,2759
7715,3533137446,3779976989,1672666867,1672670423,3556
7934,3311324983,3714474557,1672680452,1672681729,1277
7977,3716746253,3757562897,1672577831,1672580558,2727
7883,3446948848,3298433163,1672554230,1672554569,339
7780,3715981584,3418728074,1672536120,1672536277,157
7754,3714962248,3792789881,1672540260,1672541907,1647
7736,3733189298,3773755137,1672660530,1672661725,1195
7873,3505883609,3637008488,1672649748,1672652612,2864
7648,3710344260,3533653428,1672586220,1672587191,971
7617,3910886626,3311871871,1672544990,1672545199,209
7671,3311845971,3783126683,1672547146,1672548369,1223
7542,3800886801,3286658957,1672607173,1672610270,3097
7656,3473765852,3622054816,1672594343,1672594629,286
7804,3716746253,3912536808,1672545002,1672546987,1985
7873,3716843669,3276993580,1672669957,1672671590,1633
7734,3935627557,3777455223,1672583754,1672584865,1111
7792,3931941795,3918674986,1672629527,1672632716,3189
7854,3972364603,3518932404,1672552866,1672553991,1125
7894,3512510536,3756966035,1672559108,1672561759,2651
7735,3791594391,3780294829,1672540527,1672541058,531
7833,3626156564,3500904641,1672536277,1672537978,1701
7677,3496051529,3755881905,1672633810,1672636160,2350
7688,3514472925,3800353779,1672682394,1672685821,3427
7726,3516629436,3778308417,1672611042,1672613160,2118
7547,3773950140,3634995491,1672587699,1672588337,638
7861,3512510536,3439023335,1672598951,1672600611,1660
7847,3827626797,3513599775,1672629766,1672632956,3190
7980,3418534998,3311090974,1672578855,1672580232,1377
7951,3793959750,3313564074,1672586400,1672587445,1045
7916,3505791599,3915628728,1672583784,1672585265,1481
7893,3481502100,3606812411,1672552417,1672553877,1460
7900,3377766165,3509604974,1672629384,1672630780,1396
7972,3510937904,3883085535,1672603697,1672604465,768
7777,3500658339,3496269445,1672578263,1672579544,1281
7717,3318697153,3511163800,1672574227,1672577242,3015
7826,3716165213,3731419510,1672624178,1672625884,1706
7749,3505362057,3756462516,1672569582,1672572907,3325
7573,3332072298,3914259449,1672671289,1672671703,414
7912,3760992710,3307097200,1672641704,1672643164,1460
7802,3774339795,3881477378,1672619131,1672621884,2753
7516,3755920131,3223789409,1672681462,1672682400,938
7841,3859663348,3937224533,1672584012,1672586972,2960
7875,3911245524,3458539365,1672698144,1672699697,1553
7883,3516065852,3777790718,1672614490,1672616236,1746
7675,3518496488,3352603894,1672686286,1672689811,3525
7982,3714962248,3516016437,1672642710,1672643498,788
7848,3737154119,3478194807,1672668714,1672671029,2315
7891,3510937904,3534313900,1672559744,1672562067,2323
7688,3554917400,3418534998,1672580205,1672581103,898
7871,3236102733,3791553060,1672694141,1672696733,2592
7595,3773598056,3311993075,1672650617,1672652909,2292
7693,3809484172,3912262917,1672590470,1672591472,1002
7906,3858918246,3711308224,1672583488,1672584446,958
7515,3513956646,3509630174,1672572698,1672573384,686
7638,3701111745,3777983879,1672680221,1672681121,900
7675,3755042098,3513080274,1672540528,1672541540,1012
7912,3780813786,3516606733,1672614007,1672614748,741
7910,3793338102,3388286531,1672645687,1672649180,3493
7763,3384951177,3485375593,1672694666,1672697361,2695
7928,3458539365,3777120536,1672689543,1672692376,2833
7835,3417970574,3774066725,1672535821,1672538998,3177
7674,3736790081,3515125508,1672564899,1672567831,2932
7841,3780828689,3735319397,1672703784,1672705653,1869
7486,3311208440,3284832486,1672564737,1672567596,2859
7965,3777929708,3773598056,1672679297,1672681481,2184
7884,3516016437,3710344260,1672567116,1672569732,2616
7777,3475396323,3777936328,1672590076,1672592377,2301
7546,3297463265,3304056063,1672535013,1672535454,441
7769,3773755137,3774066725,1672555124,1672557436,2312
7718,3733189298,3417587765,1672547358,1672548349,991
7866,3777443199,3809059934,1672621138,1672622549,1411
7650,3516716179,3509672210,1672596048,1672598492,2444
7889,3249791738,3399052055,1672531741,1672533280,1539
7578,3388286531,3880285638,1672654436,1672657606,3170
7950,3904408902,3755872268,1672591493,1672591572,79
7732,3291883916,3516065852,1672621225,1672622288,1063
7545,3774556560,3420432297,1672557724,1672561285,3561
7813,3311648200,3517077106,1672650306,1672652731,2425
7649,3772309150,3221899927,1672557520,1672560983,3463
7922,3512349371,3505530961,1672661639,1672664263,2624
7513,3772309150,3416265063,1672623934,1672624570,636
7913,3415443558,3890149705,1672538932,1672539759,827
7619,3851190615,3732481297,1672643535,1672646125,2590
7668,3757151210,3356860407,1672643782,1672645587,1805
7666,3815508790,3701178711,1672551527,1672553085,1558
7567,3200198928,3714488548,1672626312,1672628445,2133
7488,3755943611,3379256399,1672658927,1672662150,3223
7520,3755739653,3519563836,1672648279,1672648507,228
7580,3297463265,3511312803,1672676574,1672677977,1403
7625,3454042520,3774050956,1672649446,1672651341,1895
7798,3352603894,3434642576,1672660072,1672660424,352
7746,3501198706,3492478793,1672599263,1672602238,2975
7711,3448855696,3500994774,1672670956,1672673766,2810
7488,3716273414,3391915886,1672561148,1672564161,3013
7551,3482405588,3931941795,1672652647,1672653740,1093
7938,3755042098,3459030804,1672533792,1672535025,1233
7560,3344364444,3533242305,1672654223,1672655933,1710
7695,3820354437,3618873142,1672571945,1672573156,1211
7549,3688418210,3627937312,1672605400,1672605536,136
7618,3284639858,3637008488,1672597559,1672600141,2582
7583,3520756859,3505973226,1672571013,1672573306,2293
7659,3770078063,3918056059,1672685750,1672688791,3041
7591,3517864478,3428674539,1672616920,1672618373,1453
7770,3608633356,3518932404,1672654696,1672656182,1486
7692,3701065786,3756453423,1672557904,1672559677,1773
7887,3711262377,3533653428,1672691997,1672694318,2321
7633,3778780511,3779036831,1672703797,1672705340,1543
7713,3209383861,3390068992,1672696804,1672699331,2527
7607,3311648200,3385763781,1672618140,1672618676,536
7931,3772309166,3827222533,1672681932,1672684220,2288
7553,3833889105,3501730685,1672584584,1672587542,2958
7969,3783196518,3777120536,1672670935,1672673250,2315
7953,3472130842,3792789881,1672661930,1672663102,1172
7765,3505635228,3200691026,1672641683,1672644500,2817
7682,3520012395,3715981584,1672634055,1672635245,1190
7669,3701111745,3607178184,1672586453,1672589730,3277
7812,3517459919,3903307060,1672625036,1672628324,3288
7623,3736229191,3311627628,1672689727,1672692471,2744
7919,3501184421,3793470489,1672536894,1672537547,653
7591,3755392666,3465202715,1672663400,1672666327,2927
7778,3520730271,3488244966,1672540697,1672543264,2567
7864,3513164386,3606987130,1672616352,1672616763,411
7973,3757602960,3922275416,1672650488,1672650610,122
7918,3791901535,3711308224,1672655028,1672656672,1644
7761,3200691026,3756930948,1672558742,1672561387,2645
7888,3404058699,3891751546,1672654358,1672657687,3329
7684,3222521619,3509630174,1672700090,1672703301,3211
7825,3404384505,3890149705,1672629387,1672632477,3090
7561,3284832486,3513599775,1672688452,1672690122,1670
7880,3505203158,3774045700,1672585607,1672588069,2462
7579,3443698222,3903009525,1672642812,1672645076,2264
7902,3505173328,3518932404,1672536537,1672537217,680
7564,3505702787,3829319703,1672637914,1672639426,1512
7782,3227457126,3510594211,1672699214,1672701671,2457
7717,3496269445,3411618230,1672684608,1672687615,3007
7710,3519601612,3912262917,1672632905,1672635463,2558
7967,3737051610,3637008488,1672624634,1672628138,3504
7532,3611150562,3713208927,1672575862,1672578539,2677
7902,3778780511,3883861463,1672549197,1672549813,616
7729,3534729133,3201848640,1672668598,1672670252,1654
7831,3201848640,3370752401,1672569599,1672571646,2047
7804,3780974443,3760893269,1672543060,1672546580,3520
7553,3613683164,3509604974,1672546088,1672546698,610
7876,3520629279,3311203656,1672586186,1672587820,1634
7743,3713370078,3520376528,1672557683,1672561182,3499
7516,3415443558,3500658339,1672561601,1672564112,2511
7831,3780294829,3918674986,1672628466,1672631339,2873
7500,3424922204,3421836608,1672669317,1672670565,1248
7972,3774520233,3738502357,1672699527,1672700633,1106
7976,3505869747,3315583351,1672593178,1672595988,2810
7763,3418728074,3405494240,1672583548,1672586417,2869
7489,3715492942,3755943611,1672650622,1672652688,2066
7769,3811171116,3221899927,1672640004,1672643420,3416
7521,3228165483,3485375593,1672698507,1672701874,3367
7767,3512217942,3379589402,1672545044,1672547178,2134
7979,3822654369,3716165213,1672623554,1672624940,1386
7753,3791602225,3500060260,1672531416,1672532747,1331
7561,3783705817,3904408902,1672638814,1672638965,151
7760,3510771358,3505869747,1672599761,1672602856,3095
7945,3505702787,3914290246,1672625888,1672628929,3041
7885,3909331423,3394539273,1672660183,1672663726,3543
7698,3481502100,3737154119,1672603934,1672606516,2582
7638,3493507965,3533371364,1672598873,1672600173,1300
7610,3244173074,3606812411,1672629871,1672631219,1348
7524,3311439795,3512969370,1672616400,1672616608,208
7880,3284832486,3362000049,1672666821,1672669976,3155
7806,3855424474,3714488548,1672600551,1672602269,1718
7565,3501198706,3855937514,1672621301,1672623688,2387
7808,3899371911,3733891182,1672566304,1672566423,119
7653,3601879040,3311761694,1672609099,1672612331,3232
7792,3277605882,3688418210,1672654714,1672656916,2202
7508,3755511676,3399004969,1672635066,1672637109,2043
7857,3780974443,3416265063,1672701491,1672703422,1931
7495,3313541986,3737154119,1672606579,1672610055,3476
7684,3513956646,3715492942,1672644476,1672645456,980
7816,3373384732,3757682496,1672634550,1672635753,1203
7754,3501483568,3925402713,1672548136,1672551261,3125
7888,3755392666,3703789494,1672620589,1672623065,2476
7635,3519703355,3209383861,1672532355,1672534812,2457
7725,3510173870,3711973519,1672634041,1672636503,2462
7794,3734496778,3777806071,1672651061,1672653342,2281
7900,3467773920,3404058699,1672650454,1672652334,1880
7625,3780294829,3493507965,1672556577,1672559048,2471
7638,3701184889,3244173074,1672648320,1672648570,250
7767,3713786889,3701995648,1672658862,1672662352,3490
7490,3496549058,3608633356,1672552332,1672555441,3109
7552,3979339287,3755798867,1672658992,1672662554,3562
7651,3473765852,3303751772,1672644241,1672646989,2748
7839,3473765852,3779036831,1672652142,1672653106,964
7859,3736790081,3364543015,1672559566,1672562640,3074
7869,3839849341,3378436155,1672596800,1672599577,2777
7678,3516016437,3713370078,1672552118,1672552208,90
7508,3914259449,3518260334,1672690182,1672692255,2073
7595,3552314511,3391261292,1672577901,1672579010,1109
7695,3280599164,3483949762,1672533876,1672534379,503
7921,3516960534,3385763781,1672688935,1672689633,698
7709,3420432297,3418728074,1672692055,1672693890,1835
7656,3291235378,3779740455,1672618627,1672618728,101
7617,3311603601,3345207877,1672589348,1672590596,1248
7954,3367902229,3610348516,1672653865,1672654090,225
7761,3600647945,3755920131,1672571946,1672573761,1815
7562,3517255726,3901990690,1672624828,1672627319,2491
7710,3367902229,3314836094,1672535966,1672538854,2888
7623,3714962248,3780365428,1672598717,1672599217,500
7539,3505791599,3201848640,1672577403,1672578409,1006
7572,3979339287,3757246925,1672680141,1672680314,173
7548,3235635976,3312333615,1672683796,1672687222,3426
7727,3817316561,3770635361,1672673113,1672674088,975
7551,3359239884,3755625324,1672611372,1672612613,1241
7659,3311065516,3711973519,1672594650,1672597763,3113
7769,3791115967,3770101921,1672615928,1672617594,1666
7548,3808324264,3488244966,1672565394,1672568309,2915
7557,3284639858,3514719601,1672572720,1672574825,2105
7731,3515691540,3755436115,1672585612,1672587213,1601
7493,3793753089,3734496778,1672699799,1672701684,1885
7553,3465254146,3793286136,1672572581,1672574603,2022
7701,3774125065,3611150562,1672659249,1672661047,1798
7643,3617055293,3552314511,1672556624,1672557386,762
7791,3505145247,3736786443,1672689286,1672690169,883
7821,3774366875,3859525941,1672537133,1672538500,1367
7526,3716488385,3518791447,1672628869,1672631783,2914
7523,3703955926,3793470489,1672665989,1672668674,2685
7940,3716273414,3244485293,1672562444,1672565141,2697
7754,3224716315,3510173870,1672630069,1672633010,2941
7540,3471220483,3478194807,1672576908,1672579725,2817
7541,3501601840,3500177712,1672593123,1672595985,2862
7536,3760077057,3731419510,1672703140,1672703608,468
7505,3391915121,3501184421,1672547408,1672550497,3089
7956,3738502357,3446948848,1672542885,1672546072,3187
7627,3703275621,3774268456,1672585915,1672588418,2503
7863,3736229191,3209027249,1672697839,1672700857,3018
7781,3510857360,3783779671,1672532384,1672535599,3215
7533,3904775198,3826760240,1672671248,1672671541,293
7869,3509907947,3500391167,1672561739,1672563834,2095
7932,3513080274,3512683609,1672635410,1672637985,2575
7736,3278365525,3311627628,1672614837,1672618365,3528
7755,3937224533,3780593036,1672553997,1672554515,518
7879,3703718151,3855424474,1672536370,1672538824,2454
7779,3701984666,3517864478,1672532087,1672533513,1426
7920,3811694763,3800886801,1672624033,1672627591,3558
7613,3939952128,3466911760,1672662956,1672666218,3262
7636,3236102733,3448855696,1672602561,1672604104,1543
7639,3891751546,3509604974,1672562035,1672564249,2214
7578,3430074045,3882997884,1672624261,1672624376,115
7676,3311065516,3427219654,1672635291,1672636230,939
7554,3202120784,3520756859,1672553114,1672556109,2995
7808,3703789494,3622054816,1672657736,1672660225,2489
7643,3976390453,3439023335,1672571123,1672573947,2824
7894,3303751772,3400804807,1672595252,1672598617,3365
7847,3232962003,3394539273,1672646493,1672649996,3503
7856,3467773920,3515394721,1672567065,1672570300,3235
7708,3703789494,3932051427,1672638388,1672641436,3048
7737,3774204963,3453729665,1672677237,1672677687,450
7764,3515284591,3883861463,1672531887,1672535220,3333
7676,3887270940,3365942576,1672649790,1672651604,1814
7952,3836573197,3432689543,1672664078,1672666271,2193
7526,3404384505,3757161914,1672682990,1672684322,1332
7534,3757246925,3828432634,1672661034,1672662411,1377
7523,3774520233,3485008994,1672552476,1672554729,2253
7786,3510126867,3715492942,1672664704,1672665364,660
7682,3513201436,3610348516,1672654719,1672656753,2034
7910,3701498253,3220716272,1672675451,1672676343,892
7886,3792668962,3774556560,1672665932,1672667765,1833
7779,3859663348,3756453423,1672535693,1672536579,886
7927,3432665384,3520376528,1672629424,1672632965,3541
7650,3774556560,3793286136,1672594096,1672595816,1720
7530,3711571712,3418534998,1672643934,1672647109,3175
7681,3505791599,3774580701,1672700003,1672702361,2358
7797,3883551721,3715127362,1672675864,1672676243,379
7620,3805342762,3362000049,1672630231,1672632628,2397
7555,3668005723,3774204963,1672556216,1672557837,1621
7507,3481647420,3554917400,1672570617,1672572055,1438
7920,3701498253,3516960534,1672583011,1672584083,1072
7965,3805342762,3500894271,1672660863,1672661489,626
7760,3518932404,3411618230,1672681921,1672685409,3488
7518,3772359096,3430074045,1672531561,1672533759,2198
7526,3682061100,3394539273,1672619147,1672620936,1789
7869,3501759100,3520888296,1672561334,1672561833,499
7727,3780813786,3703789494,1672558164,1672559563,1399
7662,3757151210,3883085535,1672681599,1672684576,2977
7882,3311603601,3516465662,1672680664,1672681884,1220
7698,3356860407,3902383721,1672620755,1672621154,399
7723,3780974443,3755739653,1672553466,1672556835,3369
7619,3466229085,3711504540,1672569184,1672570019,835
7616,3235287260,3500578848,1672682380,1672683893,1513
7794,3783206719,3344019610,1672555068,1672557063,1995
7820,3755587522,3616944364,1672651752,1672654155,2403
7842,3756966035,3427283336,1672552314,1672552488,174
7897,3774005526,3534424200,1672632047,1672635378,3331
7584,3533280269,3511862351,1672539661,1672542517,2856
7803,3229058858,3279721246,1672602353,1672603956,1603
7528,3511435497,3533653428,1672681408,1672683388,1980
7564,3859525941,3973560347,1672699480,1672701379,1899
7710,3828432634,3500365158,1672567940,1672569325,1385
7713,3773429448,3778980116,1672688340,1672688545,205
7699,3774520233,3760077057,1672627280,1672630027,2747
7816,3811171116,3624312512,1672673957,1672675198,1241
7870,3513080274,3760509236,1672657177,1672660727,3550
7672,3516258476,3490191091,1672630784,1672634066,3282
7829,3222521619,3519556068,1672691902,1672694191,2289
7698,3714821932,3978115672,1672668853,1672670679,1826
7625,3509352754,3510594211,1672665179,1672665575,396
7915,3516716179,3519912874,1672605236,1672607941,2705
7657,3288764520,3732481297,1672595850,1672597137,1287
7572,3367029997,3519069599,1672600279,1672603618,3339
7776,3780914982,3774556560,1672587412,1672587534,122
7552,3509630174,3505219850,1672565978,1672566899,921
7728,3716537575,3770763956,1672537204,1672537598,394
7508,3772544062,3711504540,1672693805,1672696543,2738
7843,3365830990,3760183458,1672674352,1672677118,2766
7883,3426325549,3510771358,1672651602,1672654460,2858
7903,3918056059,3815508790,1672606146,1672607427,1281
7797,3417970574,3756451663,1672595439,1672597721,2282
7775,3516039895,3505791599,1672654856,1672655724,868
7630,3516016437,3628819436,1672650142,1672653538,3396
7845,3713349754,3882997884,1672599995,1672600329,334
7882,3426325549,3518496488,1672539756,1672542862,3106
7790,3774204963,3311761694,1672589467,1672590115,648
7554,3307097200,3278365525,1672671052,1672672848,1796
7644,3312333615,3770101921,1672546172,1672547805,1633
7971,3828432634,3774119563,1672629054,1672631893,2839
7945,3772746272,3311208440,1672556908,1672559696,2788
7670,3351008918,3453729665,1672694350,1672696331,1981
7514,3311627628,3500458761,1672675724,1672676541,817
7643,3416427576,3385763781,1672620856,1672623208,2352
7730,3915628728,3519601612,1672567028,1672568990,1962
7892,3501955238,3701863557,1672647541,1672647816,275
7905,3834257412,3392121505,1672631627,1672632495,868
7819,3311871871,3520012395,1672601274,1672602568,1294
7578,3516514391,3516909237,1672674427,1672674819,392
7697,3473562469,3772359096,1672702593,1672704922,2329
7758,3235287260,3496549058,1672624631,1672625111,480
7950,3615046771,3792883665,1672537493,1672540524,3031
7551,3517077106,3520629279,1672626542,1672628012,1470
7976,3714504419,3617734118,1672630516,1672630911,395
7601,3432689543,3791957752,1672649461,1672651104,1643
7752,3792177074,3396086535,1672644487,1672647925,3438
7972,3757151210,3757682496,1672666843,1672670024,3181
7809,3703013906,3826633236,1672589945,1672590180,235
7615,3477649378,3791657947,1672564604,1672567625,3021
7819,3509672210,3736592744,1672547391,1672548115,724
7786,3428006164,3715581279,1672603481,1672605346,1865
7548,3703013906,3756021689,1672637601,1672639346,1745
7916,3774204963,3882291183,1672643675,1672644420,745
7781,3914259449,3777936328,1672600337,1672600424,87
7673,3555214688,3249401741,1672583460,1672584621,1161
7570,3513080274,3497901842,1672584608,1672585807,1199
7595,3910886626,3780813786,1672688569,1672691839,3270
7914,3713349754,3757562897,1672535296,1672538213,2917
7494,3882291183,3851190615,1672548019,1672550054,2035
7904,3518876135,3520190170,1672641416,1672643592,2176
7541,3293695955,3756462516,1672588144,1672590115,1971
7680,3500894271,3685187183,1672575027,1672576899,1872
7646,3780503655,3501955238,1672598966,1672600297,1331
7569,3520719611,3394539273,1672589267,1672589480,213
7492,3357483218,3713969578,1672584455,1672584570,115
7864,3716258994,3772053179,1672637246,1672638663,1417
7818,3716197887,3362000049,1672539570,1672540170,600
7866,3220716272,3772714862,1672611627,1672612964,1337
7764,3500177712,3701863557,1672554350,1672556725,2375
7780,3903962771,3925402713,1672603380,1672603462,82
7958,3385763781,3311415018,1672565836,1672567168,1332
7565,3909606423,3555214688,1672607989,1672608345,356
7881,3420432297,3970117174,1672587256,1672588835,1579
7918,3533137446,3634340855,1672625171,1672627963,2792
7918,3813052709,3978115672,1672615300,1672615702,402
7842,3682061100,3816454165,1672607756,1672609224,1468
7567,3492478793,3242408357,1672559258,1672560085,827
7504,3783196518,3716488385,1672649102,1672651651,2549
7692,3505098372,3404058699,1672583382,1672583755,373
7863,3359910781,3378686918,1672702198,1672704493,2295
7613,3924549929,3607178184,1672678640,1672681826,3186
7851,3500060260,3533827120,1672615506,1672617420,1914
7799,3231056870,3816454165,1672619341,1672622579,3238
7622,3662180254,3311845971,1672537083,1672537524,441
7651,3509634629,3716843669,1672622914,1672625514,2600
7945,3520206212,3273500349,1672597072,1672598509,1437
7683,3760077057,3773465237,1672547633,1672548000,367
7610,3391915886,3518163778,1672687286,1672689975,2689
7917,3418728074,3520206212,1672667389,1672667756,367
7944,3429856982,3902383721,1672598681,1672601095,2414
7819,3634340855,3477375368,1672692123,1672693957,1834
7620,3804870229,3342131135,1672653958,1672656663,2705
7754,3556951786,3606186086,1672603345,1672606463,3118
7823,3701995648,3500658339,1672542923,1672544863,1940
7737,3792032359,3809059934,1672692474,1672694722,2248
7725,3773664987,3774338212,1672569429,1672572232,2803
7769,3511332835,3311154569,1672638371,1672638736,365
7745,3792288302,3331845324,1672683861,1672686797,2936
7870,3924549929,3772337814,1672555497,1672558238,2741
7900,3774127586,3494290908,1672610897,1672612605,1708
7707,3387674757,3688418210,1672616016,1672616206,190
7605,3778108318,3777717988,1672576402,1672576548,146
7961,3716537575,3501927421,1672659683,1672662418,2735
7932,3367902229,3505219850,1672669944,1672671479,1535
7600,3489217083,3512567240,1672632917,1672635393,2476
7519,3685187183,3774045700,1672611063,1672614448,3385
7791,3932051427,3236102733,1672549250,1672551855,2605
7934,3757682496,3737154119,1672628591,1672630015,1424
7898,3518496488,3979339287,1672701413,1672702354,941
7509,3404384505,3883312122,1672612387,1672613525,1138
7752,3515125508,3472130842,1672703600,1672706187,2587
7859,3899266183,3711308224,1672594703,1672597603,2900
7846,3520376528,3512567240,1672598304,1672600365,2061
7851,3710344260,3505635228,1672663490,1672663834,344
7722,3710098970,3344019610,1672607165,1672608699,1534
7919,3793086311,3512837326,1672617154,1672620409,3255
7658,3716168623,3520751702,1672677829,1672678073,244
7699,3757403279,3351554343,1672663842,1672666151,2309
7720,3886298125,3715492942,1672577524,1672579987,2463
7563,3778108318,3793086311,1672564256,1672564425,169
7837,3407954858,3291227780,1672634858,1672636649,1791
7881,3500060260,3483164654,1672578209,1672578585,376
7855,3501927421,3505904952,1672644416,1672644501,85
7901,3976390453,3792789881,1672572361,1672573188,827
7966,3244389794,3416427576,1672607221,1672609258,2037
7978,3716165213,3828365570,1672567377,1672570381,3004
7886,3500199935,3902383721,1672573946,1672574555,609
7537,3501483568,3277939457,1672578965,1672581999,3034
7795,3755392666,3801089989,1672596044,1672596925,881
7609,3314245084,3351008918,1672596189,1672598120,1931
7624,3811694763,3505859863,1672555157,1672556745,1588
7833,3311627628,3793962300,1672602595,1672603427,832
7706,3298433163,3311065516,1672693635,1672694153,518
7791,3311603601,3973560347,1672616487,1672619505,3018
7742,3734737881,3509907947,1672678957,1672680428,1471
7837,3511312803,3715998609,1672634823,1672637949,3126
7722,3774045700,3280964728,1672552431,1672555324,2893
7928,3608868877,3736592744,1672548632,1672551196,2564
7592,3683766533,3791115967,1672545829,1672547092,1263
7590,3510594211,3809484172,1672613070,1672616449,3379
7498,3280615985,3703789494,1672597528,1672600430,2902
7538,3477649378,3827377568,1672683660,1672683769,109
7690,3738502357,3822654369,1672567997,1672568398,401
7674,3416265063,3918056059,1672613885,1672616867,2982
7596,3904408902,3227158514,1672643837,1672646284,2447
7755,3855602893,3501198706,1672611251,1672614648,3397
7722,3248507722,3791594391,1672647355,1672650478,3123
7694,3277669002,3365942576,1672587177,1672590503,3326
7895,3517963492,3229665776,1672699072,1672701163,2091
7673,3285400528,3394330287,1672552803,1672555525,2722
7788,3733189298,3229665776,1672571210,1672573463,2253
7688,3297463265,3779036831,1672642152,1672643875,1723
7499,3774501422,3500803339,1672587893,1672589390,1497
7728,3518496488,3358871377,1672548817,1672550488,1671
7517,3518876135,3701967560,1672604796,1672606489,1693
7528,3236102733,3716900301,1672563864,1672564620,756
7822,3714197325,3773664987,1672620268,1672622200,1932
7790,3428964059,3703013906,1672676697,1672679222,2525
7791,3811171116,3715581279,1672610321,1672611782,1461
7721,3519563836,3519428855,1672566532,1672567472,940
7721,3713268590,3793338102,1672574695,1672575246,551
7556,3466229085,3714821932,1672560268,1672562686,2418
7950,3792789881,3420700674,1672570429,1672572928,2499
7812,3489962019,3783509527,1672584841,1672584980,139
7536,3832902928,3534191820,1672561910,1672563030,1120
7598,3935627557,3534010629,1672562875,1672564616,1741
7601,3552314511,3311845971,1672626655,1672630099,3444
7908,3793753089,3922275620,1672586947,1672588240,1293
7873,3291883916,3772746272,1672532600,1672534224,1624
7597,3714197325,3933210486,1672696170,1672697128,958
7966,3701863557,3756623396,1672693424,1672693680,256
7876,3487171044,3857349323,1672537124,1672540162,3038
7609,3772758337,3501486692,1672681224,1672683510,2286
7651,3509907947,3755587522,1672696160,1672699399,3239
7859,3918674986,3615046771,1672669035,1672671728,2693
7590,3206254161,3783429780,1672635454,1672637157,1703
7928,3517721725,3360993964,1672659660,1672662189,2529
7653,3970117174,3627937312,1672539373,1672540841,1468
7802,3516465662,3855937514,1672702641,1672704960,2319
7516,3731419510,3778780511,1672535132,1672535821,689
7783,3342131135,3779976989,1672682887,1672682969,82
7664,3615046771,3976390453,1672658905,1672659752,847
7593,3802367797,3780914982,1672546812,1672548803,1991
7566,3793959750,3756601594,1672699812,1672701748,1936
7824,3610695419,3909606423,1672608343,1672611488,3145
7703,3396086535,3883551721,1672573542,1672576778,3236
7693,3373384732,3774298222,1672562230,1672565218,2988
7671,3778108318,3780974443,1672572986,1672574977,1991
7649,3234541252,3780593036,1672701279,1672704560,3281
7485,3514472925,3515125508,1672703859,1672704965,1106
7704,3209027249,3312664885,1672651757,1672652954,1197
7694,3519803045,3416265063,1672684021,1672685809,1788
7697,3417061462,3792288302,1672637076,1672638158,1082
7909,3505635228,3621810464,1672649848,1672652043,2195
7665,3489962019,3533653428,1672557734,1672560839,3105
7862,3779740455,3903009525,1672695061,1672697583,2522
7931,3714197325,3500066230,1672562525,1672563875,1350
7709,3509933351,3520183192,1672572675,1672573618,943
7845,3247780536,3888559320,1672624911,1672625984,1073
7524,3760598102,3389115045,1672589057,1672589585,528
7600,3201848640,3416427576,1672542923,1672546261,3338
7701,3367029997,3816853177,1672638036,1672639290,1254
7776,3289061738,3756966035,1672678896,1672682493,3597
7817,3518791447,3972709319,1672550617,1672552779,2162
7740,3418728074,3362000049,1672634368,1672635016,648
7483,3701691675,3311761694,1672689388,1672691729,2341
7835,3229665776,3534492426,1672553033,1672554349,1316
7713,3701111745,3399535232,1672572169,1672575476,3307
7555,3500904641,3510703546,1672646210,1672646635,425
7719,3517963492,3972709319,1672542783,1672544723,1940
7518,3891751546,3703789494,1672654592,1672657204,2612
7969,3294803686,3511862351,1672677213,1672678801,1588
7573,3473562469,3909238838,1672628766,1672630943,2177
7948,3899266183,3882997884,1672656976,1672657275,299
7669,3516039895,3311415018,1672629627,1672632484,2857
7887,3510247121,3757682496,1672553457,1672555376,1919
7935,3505347134,3500060260,1672572614,1672575014,2400
7782,3483164654,3713370078,1672571898,1672574382,2484
7486,3917088658,3520629279,1672668108,1672671353,3245
7561,3509634629,3459030804,1672553897,1672556478,2581
7622,3365942576,3886298125,1672700826,1672701302,476
7631,3501692334,3918056059,1672570336,1672572971,2635
7516,3852391257,3716843669,1672598624,1672600341,1717
7813,3360506772,3472130842,1672625887,1672626161,274
7713,3757562897,3298288268,1672600896,1672603931,3035
7490,3505638204,3772758337,1672701474,1672702280,806
7523,3710112546,3616944364,1672656996,1672659722,2726
7901,3715581279,3511312803,1672672945,1672676325,3380
7905,3286658957,3757151210,1672571669,1672574280,2611
7904,3400804807,3682061100,1672702680,1672704475,1795
7528,3516223597,3518932404,1672683046,1672684881,1835
7693,3711571712,3311439795,1672619515,1672619596,81
7877,3627937312,3914290246,1672698151,1672701488,3337
7493,3520206212,3373384732,1672699168,1672701899,2731
7729,3402943525,3510969660,1672534941,1672536024,1083
7977,3606987130,3501483568,1672631544,1672632372,828
7605,3711504540,3271938399,1672670445,1672673840,3395
7694,3898995675,3478194807,1672609444,1672609628,184
7535,3420700674,3776800213,1672658621,1672661520,2899
7743,3505000737,3220716272,1672553669,1672556392,2723
7629,3778980116,3500391167,1672602327,1672603793,1466
7934,3713644518,3779528381,1672568699,1672569726,1027
7829,3516980378,3792789881,1672543160,1672543225,65
7813,3418534998,3201324715,1672559429,1672561859,2430
7524,3736625083,3770078063,1672640110,1672642133,2023
7628,3404058699,3511350608,1672645022,1672647919,2897
7739,3478194807,3429856982,1672574297,1672577702,3405
7533,3505599848,3273500349,1672631018,1672633397,2379
7650,3509352754,3316173088,1672679990,1672681158,1168
7964,3772642849,3510247121,1672572143,1672574389,2246
7615,3772309150,3384240055,1672703995,1672706633,2638
7971,3713969578,3485823740,1672682371,1672683372,1001
7863,3703718151,3783925755,1672635633,1672637679,2046
7694,3772053179,3783429780,1672587834,1672589980,2146
7559,3509352754,3817316561,1672646676,1672648992,2316
7913,3809059934,3793389510,1672682114,1672685520,3406
7893,3511125626,3715581279,1672542237,1672543678,1441
7739,3701178711,3417061462,1672572128,1672572943,815
7615,3519654779,3284832486,1672647499,1672650797,3298
7927,3247780536,3915628728,1672701748,1672705009,3261
7625,3489728806,3222448362,1672651327,1672654070,2743
7552,3813052709,3660493209,1672682211,1672684037,1826
7736,3756453423,3760569731,1672548740,1672550292,1552
7694,3777776687,3372883226,1672540244,1672541475,1231
7832,3716843669,3336742544,1672702277,1672705314,3037
7934,3416241005,3737079798,1672591882,1672594243,2361
7893,3533193862,3313564074,1672569351,1672570935,1584
7746,3622054816,3682061100,1672697658,1672700048,2390
7485,3685187183,3391915886,1672642827,1672643127,300
7502,3208844525,3774520233,1672656804,1672657584,780
7531,3517077106,3221536550,1672568590,1672569974,1384
7546,3772642849,3432665384,1672603146,1672606381,3235
7528,3774580701,3735733948,1672635215,1672636279,1064
7833,3714821932,3481502100,1672665341,1672667702,2361
7624,3713630656,3313541986,1672611127,1672612179,1052
7758,3374559242,3777455223,1672614485,1672616330,1845
7786,3516223597,3510771358,1672665928,1672667135,1207
7616,3227158514,3777806071,1672632410,1672635006,2596
7514,3886298125,3737154119,1672596124,1672596257,133
7740,3883312122,3475396323,1672621531,1672623995,2464
7948,3793338102,3384240055,1672585266,1672586301,1035
7792,3533927138,3426325549,1672560913,1672561507,594
7779,3757447189,3519601612,1672566027,1672566473,446
7761,3783126683,3713969578,1672639556,1672641028,1472
7648,3737051610,3515860749,1672623327,1672625626,2299
7726,3755920131,3791020967,1672654368,1672656452,2084
7934,3793753089,3713808837,1672592796,1672593500,704
7622,3404384505,3606812411,1672647485,1672649563,2078
7634,3364543015,3828624701,1672678584,1672681797,3213
7866,3817621391,3755392666,1672567360,1672568387,1027
7867,3703275621,3534729133,1672657075,1672660556,3481
7833,3505193212,3613683164,1672598596,1672598902,306
7659,3400918687,3607748895,1672606687,1672607686,999
7502,3774127586,3792473331,1672590058,1672592193,2135
7685,3229665776,3505201246,1672557954,1672558652,698
7792,3811171116,3492478793,1672690831,1672693942,3111
7749,3409474775,3734828619,1672568569,1672570520,1951
7884,3735733948,3533626375,1672582968,1672583569,601
7643,3770635361,3519563836,1672676999,1672679028,2029
7503,3515125508,3806545488,1672567072,1672569151,2079
7932,3473765852,3852391257,1672540624,1672540827,203
7968,3755625324,3236102733,1672688258,1672691597,3339
7494,3276993580,3666553782,1672601597,1672602385,788
7642,3334033993,3853018906,1672578837,1672581637,2800
7541,3911159965,3515284591,1672623454,1672624767,1313
7817,3883551721,3829764737,1672569972,1672570136,164
7935,3518360734,3755511676,1672650224,1672651799,1575
7519,3515691540,3399535232,1672645117,1672645417,300
7847,3760561634,3360506772,1672583924,1672584547,623
7699,3606186086,3417061462,1672598822,1672602271,3449
7826,3755739653,3755587522,1672595624,1672598343,2719
7938,3501730685,3519803045,1672544920,1672546868,1948
7845,3886298125,3818255890,1672588068,1672590425,2357
7750,3933210486,3517459919,1672533397,1672536937,3540
7609,3783196518,3805347939,1672687722,1672690238,2516
7721,3394539273,3777983879,1672599367,1672601500,2133
7795,3513956646,3755881905,1672556194,1672559489,3295
7962,3711262377,3534702203,1672568183,1672569207,1024
7541,3760077057,3223968713,1672650103,1672650947,844
7948,3337544549,3701995648,1672675934,1672678951,3017
7515,3316222192,3287105466,1672692875,1672693081,206
7621,3736625083,3616944364,1672613203,1672614040,837
7822,3714821932,3426325549,1672551424,1672552488,1064
7627,3475258557,3517077106,1672666309,1672668880,2571
7922,3514987389,3509630174,1672681856,1672683265,1409
7546,3505859863,3777717988,1672619997,1672620648,651
7912,3406784491,3427219654,1672560022,1672561015,993
7803,3510937904,3511435497,1672541700,1672542976,1276
7674,3501486692,3826759140,1672624938,1672625887,949
7687,3714821932,3209048907,1672572238,1672573805,1567
7493,3249247700,3909331423,1672565196,1672566588,1392
7955,3515860749,3386707783,1672639463,1672641892,2429
7854,3755920131,3286658957,1672685078,1672687290,2212
7558,3791657947,3732481297,1672635762,1672638109,2347
7494,3778108318,3757812939,1672629653,1672632999,3346
7590,3791115967,3731419510,1672574917,1672577151,2234
7775,3780639480,3277939457,1672538439,1672538545,106
7853,3859663348,3224058172,1672615803,1672618087,2284
7803,3731419510,3516016437,1672602001,1672603896,1895
7941,3534313900,3773755137,1672553813,1672554190,377
7826,3311439795,3318166135,1672617268,1672617944,676
7916,3512166013,3688418210,1672582927,1672584381,1454
7925,3512217942,3793086311,1672628905,1672630428,1523
7721,3703275621,3519563836,1672548806,1672551010,2204
7874,3666553782,3477649378,1672613819,1672615978,2159
7608,3776800213,3710067113,1672618075,1672618353,278
7742,3755943611,3773664987,1672653426,1672653807,381
7980,3511198618,3757455053,1672536775,1672537658,883
7822,3791997875,3519912874,1672557818,1672560303,2485
7858,3922275416,3345207877,1672664404,1672667013,2609
7683,3520376528,3816454165,1672532046,1672532315,269
7878,3606186086,3776800213,1672560505,1672563316,2811
7611,3312664885,3713208927,1672618465,1672619582,1117
7583,3887270940,3505962865,1672664496,1672667075,2579
7705,3520206212,3664517356,1672641154,1672642086,932
7512,3512217942,3715492942,1672703610,1672706011,2401
7830,3277669002,3780609808,1672656790,1672656975,185
7688,3777929708,3395152943,1672571026,1672574616,3590
7921,3416265063,3315583351,1672700272,1672701841,1569
7912,3757447189,3220716272,1672542469,1672543569,1100
7610,3756424865,3489545239,1672604890,1672605840,950
7575,3828432634,3516960534,1672622694,1672624345,1651
7803,3772642849,3509604974,1672699749,1672703121,3372
7837,3827377568,3555214688,1672537491,1672540808,3317
7562,3688683847,3903307060,1672682653,1672683756,1103
7916,3512720680,3826759140,1672652496,1672653275,779
7907,3337544549,3666457294,1672652425,1672654894,2469
7917,3510126867,3510969660,1672555891,1672558697,2806
7856,3818255890,3703275621,1672639192,1672639556,364
7588,3716843669,3783126683,1672623972,1672627486,3514
7867,3772642849,3475396323,1672654566,1672657152,2586
7983,3511163800,3783705817,1672642129,1672644751,2622
7800,3318166135,3378686918,1672620870,1672624369,3499
7817,3364543015,3714488548,1672686527,1672686784,257
7575,3500658339,3519601612,1672694033,1672695299,1266
7934,3701146057,3520931254,1672583584,1672586062,2478
7552,3384240055,3500391167,1672586937,1672587625,688
7979,3899204805,3918674986,1672641445,1672643724,2279
7621,3972364603,3248507722,1672621307,1672621436,129
7937,3618045231,3883861463,1672580328,1672582293,1965
7840,3710569131,3336742544,1672677017,1672677540,523
7736,3713370078,3520376528,1672531689,1672533239,1550
7944,3629547065,3510937904,1672563680,1672565169,1489
7936,3534729133,3773429448,1672606475,1672607395,920
7772,3801089989,3511687358,1672701192,1672702896,1704
7939,3314245084,3760598102,1672580536,1672582469,1933
7699,3910886626,3800886801,1672627011,1672630525,3514
7677,3520751702,3770824086,1672599155,1672599507,352
7932,3757161914,3505145247,1672668797,1672670606,1809
7890,3820354437,3312829208,1672607405,1672608474,1069
7842,3880285638,3515691540,1672549737,1672551910,2173
7608,3420432297,3793627961,1672640728,1672642886,2158
7824,3770763956,3716843669,1672696110,1672696386,276
7805,3783245561,3374559242,1672638659,1672640915,2256
7750,3510857360,3711262377,1672617372,1672618833,1461
7798,3827626797,3774050956,1672625896,1672628269,2373
7656,3520931254,3500499542,1672686758,1672689056,2298
7642,3391915886,3778780511,1672638408,1672639169,761
7734,3417587765,3298433163,1672661488,1672663425,1937
7815,3925620998,3613683164,1672576278,1672579051,2773
7955,3505201246,3936227020,1672671345,1672673210,1865
7773,3501927421,3509933351,1672565526,1672567185,1659
7724,3911245524,3793086311,1672694558,1672696921,2363
7726,3914259449,3774195321,1672629966,1672630658,692
7642,3338367113,3221536550,1672542709,1672544956,2247
7589,3780974443,3493507965,1672542131,1672542981,850
7782,3500199935,3713894336,1672635390,1672635621,231
7816,3801089989,3662180254,1672600412,1672601866,1454
7774,3389115045,3937224533,1672628270,1672628689,419
7530,3514987389,3248507722,1672623037,1672624819,1782
7769,3407673904,3481647420,1672609283,1672610985,1702
7965,3372883226,3737051610,1672630925,1672631516,591
7487,3792668962,3826415738,1672561776,1672564095,2319
7582,3902383721,3501486692,1672696552,1672699212,2660
7746,3224058172,3314836094,1672588496,1672590493,1997
7894,3511271692,3780365428,1672625982,1672628332,2350
7639,3318166135,3793389510,1672666210,1672668156,1946
7633,3757151210,3780365428,1672677764,1672678721,957
7616,3516980378,3513080274,1672595302,1672597408,2106
7728,3836573197,3513599775,1672608282,1672610873,2591
7972,3815508790,3519912874,1672658162,1672660771,2609
7494,3433804879,3505912939,1672537424,1672538670,1246
7715,3344364444,3910454786,1672632704,1672635718,3014
7835,3618045231,3683766533,1672683877,1672685284,1407
7855,3778980116,3701984666,1672563657,1672565179,1522
7938,3443698222,3800353779,1672584389,1672585018,629
7968,3505904952,3774366875,1672534904,1672536916,2012
7709,3505599848,3636867411,1672696461,1672696687,226
7794,3388372715,3505203158,1672697115,1672699050,1935
7688,3516673015,3511350608,1672598425,1672601161,2736
7848,3206593906,3511687358,1672597621,1672599093,1472
7809,3770553384,3489962019,1672640087,1672640455,368
7861,3475251781,3505292701,1672695587,1672698553,2966
7563,3779740455,3514472925,1672581281,1672583347,2066
7879,3505635228,3783705817,1672635929,1672637535,1606
7601,3387966152,3512969370,1672617693,1672621043,3350
7723,3489962019,3888559320,1672665805,1672667085,1280
7850,3791942683,3976633198,1672691316,1672694815,3499
7803,3533280269,3902278226,1672691672,1672693849,2177
7838,3736786443,3793470489,1672651698,1672651953,255
7586,3520756859,3511125626,1672553879,1672556733,2854
7780,3500391167,3757682496,1672606355,1672607585,1230
7713,3534488837,3278365525,1672586621,1672586854,233
7616,3399004969,3685818092,1672615591,1672617356,1765
7627,3715998609,3791901535,1672676028,1672679604,3576
7806,3634786711,3439023335,1672690216,1672692907,2691
7966,3500391167,3757403279,1672621252,1672623016,1764
7827,3701274634,3387674757,1672675015,1672677437,2422
7715,3515860749,3517255726,1672565592,1672565941,349
7727,3418728074,3703871468,1672590394,1672592423,2029
7777,3512837326,3703789494,1672546536,1672550108,3572
7902,3517077106,3407673904,1672560162,1672560482,320
7738,3475251781,3857349323,1672586133,1672587394,1261
7784,3388372715,3280964728,1672632645,1672634812,2167
7647,3500066230,3757682496,1672667751,1672668785,1034
7728,3518360734,3391261292,1672621241,1672624042,2801
7937,3774066725,3917088658,1672652277,1672655192,2915
7708,3244436890,3224058172,1672641308,1672642369,1061
7939,3760569731,3407673904,1672643868,1672645306,1438
7714,3438645253,3512720680,1672601448,1672604932,3484
7920,3505599848,3715981584,1672700710,1672703354,2644
7889,3978105277,3467773920,1672636587,1672637819,1232
7751,3518496488,3477375368,1672587391,1672589426,2035
7836,3517963492,3757447189,1672628244,1672630711,2467
7939,3318697153,3351008918,1672650336,1672652708,2372
7745,3774298222,3533270638,1672615192,1672617927,2735
7581,3497901842,3792668962,1672636888,1672637865,977
7880,3780503655,3249401741,1672644182,1672647062,2880
7648,3809916577,3778266283,1672658870,1672661937,3067
7738,3242408357,3793086311,1672613795,1672614854,1059
7785,3515723720,3773978034,1672603742,1672606835,3093
7662,3780914982,3888559320,1672681105,1672683551,2446
7765,3501692334,3520165601,1672671516,1672671581,65
7739,3451432842,3713786889,1672691566,1672694128,2562
7518,3772337814,3912536808,1672631807,1672632961,1154
7803,3284832486,3793753089,1672653211,1672656286,3075
7511,3533371364,3701863557,1672611825,1672613825,2000
7744,3513599775,3604539807,1672576875,1672578523,1648
7920,3512969370,3931941795,1672618581,1672621825,3244
7552,3314245084,3501730685,1672687508,1672690891,3383
7599,3783531004,3978105277,1672535675,1672539200,3525
7974,3518408774,3209551760,1672656510,1672656652,142
7868,3485823740,3533242305,1672679150,1672682393,3243
7574,3517721725,3345207877,1672560403,1672562122,1719
7654,3770078063,3828365570,1672660957,1672662323,1366
7913,3613995936,3608633356,1672632128,1672634744,2616
7660,3793753089,3294803686,1672558827,1672562214,3387
7807,3201848640,3778108318,1672532847,1672534206,1359
7615,3922337974,3483949762,1672535792,1672537598,1806
7536,3488244966,3516065852,1672543239,1672544285,1046
7858,3791997875,3500994774,1672552032,1672552994,962
7698,3385763781,3773978034,1672582092,1672583032,940
7653,3500060260,3405494240,1672671665,1672674658,2993
7514,3791594391,3345207877,1672609760,1672611501,1741
7651,3511687358,3793436995,1672653734,1672654442,708
7670,3387966152,3779218771,1672627367,1672628402,1035
7496,3914259449,3501184421,1672592870,1672595587,2717
7824,3505477652,3505201246,1672651840,1672653103,1263
7742,3311154569,3779528381,1672553756,1672554032,276
7564,3417061462,3703223015,1672667982,1672668563,581
7788,3777514571,3519803045,1672613903,1672615676,1773
7548,3909331423,3475795792,1672601147,1672604528,3381
7520,3791594391,3773465237,1672697603,1672697762,159
7916,3858918246,3756451663,1672589367,1672590971,1604
7793,3858918246,3515151980,1672639762,1672641971,2209
7982,3627937312,3711370563,1672643941,1672646815,2874
7734,3826633236,3911245524,1672595077,1672595489,412
7866,3293695955,3556951786,1672646050,1672646595,545
7845,3395152943,3316222192,1672653728,1672654582,854
7680,3505203158,3500894271,1672654390,1672657964,3574
7678,3432665384,3760267716,1672673998,1672676349,2351
7493,3377766165,3206593906,1672601300,1672602670,1370
7955,3739106581,3736790081,1672691747,1672694616,2869
7967,3822654369,3924549929,1672601969,1672605455,3486
7970,3533748232,3637008488,1672597990,1672598553,563
7561,3510771358,3792902982,1672541008,1672541284,276
7853,3318697153,3500066230,1672697435,1672697962,527
7652,3208844525,3473765852,1672617266,1672619261,1995
7648,3792032359,3511332835,1672542370,1672542764,394
7779,3791594391,3904408902,1672632377,1672635410,3033
7589,3710067113,3711265369,1672565969,1672569215,3246
7864,3903307060,3774501422,1672567402,1672569557,2155
7866,3372883226,3492478793,1672581643,1672583728,2085
7669,3505203158,3912262917,1672532278,1672533340,1062
7680,3733891182,3533927138,1672692788,1672694086,1298
7885,3370752401,3518669703,1672610146,1672613173,3027
7723,3714821932,3773429448,1672540239,1672540353,114
7540,3298433163,3235635976,1672640584,1672641683,1099
7930,3519803045,3756966035,1672615941,1672619319,3378
7641,3484995752,3518876135,1672553453,1672554724,1271
7677,3490191091,3514283243,1672601832,1672601935,103
7930,3446948848,3517509185,1672648068,1672649468,1400
7689,3770635361,3903009525,1672604759,1672607199,2440
7627,3514719601,3736786443,1672601368,1672603989,2621
7824,3703223015,3311152102,1672673387,1672676289,2902
7937,3614238812,3519428855,1672703047,1672704707,1660
7861,3899266183,3772714862,1672636050,1672636534,484
7654,3415546117,3755881905,1672601971,1672603712,1741
7872,3383922351,3633420270,1672624803,1672625007,204
7960,3510380060,3774010081,1672558533,1672561202,2669
7945,3481647420,3501730685,1672690333,1672692535,2202
7513,3666457294,3703735129,1672632172,1672635344,3172
7602,3755943611,3505599848,1672582563,1672586081,3518
7788,3446948848,3345207877,1672571747,1672575080,3333
7935,3200198928,3773429448,1672593135,1672594002,867
7915,3396086535,3777079686,1672642780,1672643362,582
7940,3801089989,3500803339,1672626788,1672629388,2600
7718,3416241005,3606987130,1672616914,1672618842,1928
7666,3554917400,3755739653,1672686621,1672687831,1210
7743,3833889105,3793848402,1672647392,1672649306,1914
7792,3304625412,3666506258,1672631706,1672634083,2377
7876,3345207877,3351554343,1672612039,1672614815,2776
7896,3774580701,3509453566,1672672332,1672674791,2459
7516,3757161914,3404384505,1672673676,1672677044,3368
7558,3666457294,3714962248,1672566155,1672568045,1890
7916,3501486692,3809916577,1672652496,1672653003,507
7488,3520706195,3399052055,1672669042,1672671308,2266
7553,3480687894,3459030804,1672701771,1672702544,773
7641,3774338212,3711504540,1672535979,1672536242,263
7839,3516980378,3365278081,1672600185,1672602848,2663
7914,3516716179,3791657947,1672617524,1672617695,171
7784,3406784491,3774195321,1672583621,1672585414,1793
7806,3505530961,3378436155,1672634288,1672637421,3133
7627,3249401741,3360743849,1672668758,1672671135,2377
7729,3667680268,3760267716,1672536094,1672538798,2704
7491,3774556560,3780914982,1672546055,1672546278,223
7880,3234541252,3500060260,1672665227,1672665877,650
7692,3451432842,3511435497,1672561750,1672564706,2956
7767,3505599848,3713786889,1672649367,1672651903,2536
7721,3517476351,3514719601,1672541021,1672541448,427
7555,3312829208,3485823740,1672561753,1672564962,3209
7677,3738274418,3779528381,1672546161,1672547078,917
7905,3391261292,3772337814,1672648805,1672648929,124
7894,3660493209,3554917400,1672630804,1672631013,209
7953,3926700506,3284639858,1672536075,1672536719,644
7585,3406784491,3247780536,1672602090,1672604732,2642
7631,3629547065,3774010081,1672590097,1672592308,2211
7535,3397418363,3378092448,1672671621,1672675016,3395
7639,3247815299,3346795719,1672679213,1672682688,3475
7659,3826633236,3518014636,1672677431,1672679394,1963
7550,3500499542,3779976989,1672631544,1672634746,3202
7641,3837094550,3221899927,1672589517,1672590998,1481
7712,3489545239,3534191820,1672577631,1672580696,3065
7622,3701984666,3756623396,1672541875,1672542350,475
7792,3777790718,3360993964,1672544990,1672547043,2053
7530,3904775198,3277605882,1672565490,1672565655,165
7870,3500578848,3668005723,1672628508,1672629824,1316
7904,3365830990,3736592744,1672561829,1672565345,3516
7863,3779740455,3427219654,1672643044,1672644567,1523
7711,3930797455,3738274418,1672584931,1672588416,3485
7810,3807987001,3336742544,1672679629,1672683201,3572
7807,3515125508,3780593036,1672613816,1672615633,1817
7681,3703871468,3201432789,1672634848,1672636337,1489
7944,3482405588,3412825109,1672557053,1672560097,3044
7690,3311154569,3405494240,1672554140,1672555194,1054
7858,3793286136,3402943525,1672664797,1672667940,3143
7750,3513454145,3514245078,1672631912,1672633280,1368
7920,3412825109,3757403279,1672576100,1672578641,2541
7538,3483164654,3485375593,1672596026,1672597580,1554
7727,3912536808,3519556068,1672627066,1672627136,70
7666,3882997884,3390068992,1672628750,1672632330,3580
7720,3710098970,3716843669,1672695048,1672695613,565
7729,3770021824,3520012395,1672626795,1672627375,580
7722,3918674986,3666506258,1672563919,1672564945,1026
7766,3634995491,3209383861,1672659264,1672662474,3210
7722,3701995648,3229058858,1672691063,1672692186,1123
7757,3976390453,3223789409,1672596920,1672598770,1850
7635,3517864478,3358871377,1672643366,1672645445,2079
7752,3515723720,3776800213,1672554827,1672555068,241
7623,3979339287,3429856982,1672565976,1672568310,2334
7649,3783196518,3791997875,1672565176,1672565536,360
7831,3384951177,3716746253,1672560042,1672562250,2208
7533,3336742544,3772544062,1672606414,1672609082,2668
7850,3713208927,3889750851,1672703144,1672703781,637
7494,3518163778,3826759140,1672701213,1672702569,1356
7494,3917088658,3438645253,1672693659,1672693796,137
7844,3516673015,3318697153,1672593877,1672596873,2996
7627,3608868877,3855602893,1672664907,1672666903,1996
7837,3902383721,3511350608,1672606145,1672608576,2431
7592,3809059934,3772359096,1672599280,1672602571,3291
7540,3533653428,3780365428,1672634546,1672635336,790
7721,3791602225,3756462516,1672568453,1672569317,864
7670,3711504540,3349613093,1672655481,1672657074,1593
7874,3505869747,3774125065,1672677739,1672679212,1473
7729,3811171116,3318697153,1672613174,1672616579,3405
7827,3757403279,3280615985,1672538134,1672538979,845
7810,3505869747,3501486692,1672582281,1672585275,2994
7664,3710569131,3383922351,1672645550,1672646334,784
7591,3805342762,3792789881,1672641165,1672641894,729
7799,3485008994,3780914982,1672621263,1672623021,1758
7739,3224058172,3302626661,1672593234,1672595509,2275
7822,3200691026,3783196518,1672641462,1672642704,1242
7603,3367029997,3664170666,1672670626,1672673398,2772
7493,3755739653,3512837326,1672655355,1672656785,1430
7505,3755798867,3238712269,1672641756,1672642416,660
7878,3812176780,3378436155,1672601235,1672604251,3016
7487,3209383861,3716258994,1672678995,1672681083,2088
7734,3513201436,3249791738,1672661171,1672661279,108
7708,3505635228,3311415018,1672555023,1672557706,2683
7621,3772884106,3791901535,1672700978,1672702731,1753
7828,3914259449,3922337974,1672558968,1672561067,2099
7661,3516909237,3776338577,1672674332,1672674572,240
7504,3276640712,3224716315,1672581912,1672584638,2726
7653,3489545239,3515394721,1672695060,1672698488,3428
7907,3829319703,3493507965,1672600329,1672600455,126
7653,3512683609,3518014636,1672623673,1672625152,1479
7666,3471220483,3291235378,1672640940,1672644412,3472
7966,3417587765,3500803339,1672607852,1672611302,3450
7526,3939952128,3280615985,1672532572,1672535665,3093
7797,3732481297,3372883226,1672675137,1672676272,1135
7496,3616944364,3516223597,1672609551,1672610385,834
7580,3485375593,3314245084,1672598073,1672599807,1734
7751,3384240055,3616944364,1672624058,1672624900,842
7780,3513080274,3917088658,1672602646,1672604576,1930
7615,3772309166,3415546117,1672697587,1672698751,1164
7861,3835382117,3770763956,1672577160,1672580078,2918
7975,3755920131,3359239884,1672607665,1672609178,1513
7946,3710408395,3760893269,1672565069,1672565837,768
7655,3756966035,3774580701,1672684231,1672685592,1361
7804,3773120434,3770824086,1672583176,1672585721,2545
7613,3311718847,3311090974,1672536333,1672536543,210
7778,3477649378,3513201436,1672563040,1672566626,3586
7798,3505873261,3756451663,1672573332,1672573661,329
7808,3780639480,3636867411,1672684999,1672685922,923
7947,3514245078,3777477395,1672670950,1672674358,3408
7894,3774501422,3731106822,1672647039,1672649582,2543
7764,3417587765,3780609808,1672657850,1672658133,283
7662,3756623396,3608633356,1672694667,1672696479,1812
7546,3518014404,3809059934,1672582540,1672584500,1960
7722,3365614305,3439023335,1672585927,1672587636,1709
7803,3500729955,3760077057,1672640337,1672640482,145
7730,3515691540,3533270638,1672697150,1672697725,575
7624,3509453566,3714962248,1672651276,1672652911,1635
7861,3533626375,3515125508,1672692037,1672692409,372
7746,3477649378,3800886801,1672546167,1672546488,321
7504,3509453566,3639847263,1672615019,1672616797,1778
7909,3227158514,3703889596,1672539009,1672541897,2888
7531,3760598102,3248507722,1672628482,1672631411,2929
7952,3909331423,3711308224,1672548923,1672552030,3107
7516,3715189301,3512720680,1672640700,1672641226,526
7931,3772746272,3510244400,1672689204,1672692373,3169
7492,3880285638,3780593036,1672575707,1672578834,3127
7887,3793959750,3770763956,1672693547,1672694544,997
7970,3701184889,3396285984,1672663803,1672665426,1623
7832,3487171044,3819727225,1672542180,1672544450,2270
7889,3362000049,3783509527,1672537754,1672541022,3268
7960,3809916577,3716746253,1672678122,1672681381,3259
7908,3793389510,3978115672,1672531904,1672532299,395
7558,3332072298,3417587765,1672541302,1672544860,3558
7935,3358871377,3247780536,1672594882,1672596508,1626
7545,3716488385,3534729133,1672599953,1672602739,2786
7531,3285400528,3489217083,1672547785,1672548982,1197
7594,3391261292,3793962300,1672540345,1672542024,1679
7931,3806545488,3666507626,1672571656,1672572838,1182
7761,3360743849,3738274418,1672531963,1672533713,1750
7496,3458539365,3520376528,1672655463,1672656224,761
7969,3615046771,3432689543,1672583428,1672584384,956
7829,3792902982,3279721246,1672575279,1672576761,1482
7918,3755625324,3533137446,1672612797,1672615168,2371
7563,3519654779,3716537575,1672634565,1672635910,1345
7553,3517459919,3626156564,1672546347,1672547907,1560
7818,3518876135,3756453423,1672626568,1672628649,2081
7883,3774366875,3556951786,1672531492,1672532151,659
7631,3777079686,3497901842,1672661697,1672663240,1543
7898,3882997884,3483949762,1672702150,1672703978,1828
7650,3716746253,3701065786,1672558759,1672560707,1948
7935,3533927138,3937224533,1672655247,1672657378,2131
7532,3392121505,3805342762,1672580741,1672581747,1006
7734,3518260334,3276640712,1672676098,1672677693,1595
7865,3777079686,3404384505,1672559031,1672562117,3086
7593,3920801189,3607178184,1672555224,1672558023,2799
7608,3231056870,3481502100,1672584965,1672587163,2198
7533,3397418363,3711569060,1672618063,1672621238,3175
7794,3902278226,3303751772,1672699263,1672702270,3007
7925,3238712269,3774050956,1672674437,1672676896,2459
7773,3713644518,3756462516,1672659582,1672660049,467
7752,3773814927,3516223597,1672676266,1672678936,2670
7491,3904408902,3332072298,1672645567,1672648682,3115
7773,3478194807,3779528381,1672683103,1672684097,994
7615,3774339795,3819727225,1672569999,1672572307,2308
7725,3783245561,3314836094,1672552113,1672553850,1737
7711,3792177074,3915628728,1672693729,1672694750,1021
7691,3826633236,3209027249,1672588220,1672591410,3190
7654,3737079798,3756528686,1672626065,1672626156,91
7506,3415546117,3519152550,1672609690,1672610285,595
7794,3899204805,3346327502,1672598387,1672601081,2694
7602,3311761694,3509630174,1672662019,1672663949,1930
7611,3613683164,3520751702,1672598183,1672600477,2294
7618,3430504438,3715981584,1672597205,1672598916,1711
7613,3713644518,3921211276,1672547108,1672549455,2347
7684,3826759140,3311324983,1672604750,1672605523,773
7652,3454042520,3774010081,1672595962,1672597306,1344
7965,3701863557,3777120536,1672541479,1672543865,2386
7917,3404384505,3914259449,1672581617,1672583097,1480
7886,3777455223,3979339287,1672533873,1672534824,951
7908,3809484172,3515151980,1672684830,1672686932,2102
7685,3828624701,3516514391,1672591689,1672591837,148
7969,3505883609,3773664987,1672615928,1672616358,430
7771,3770447408,3910886626,1672532359,1672534776,2417
7554,3774268456,3501759100,1672642559,1672643096,537
7669,3405494240,3791594391,1672678194,1672680854,2660
7820,3311203656,3314836094,1672641060,1672643696,2636
7860,3484995752,3922337974,1672671569,1672674215,2646
7605,3777079686,3516223597,1672543979,1672545876,1897
7679,3500805881,3505193212,1672657668,1672659352,1684
7832,3755872268,3489962019,1672679700,1672682073,2373
7892,3716168623,3221899927,1672550165,1672552591,2426
7648,3517509185,3855937514,1672555462,1672556061,599
7859,3512510536,3511125626,1672543965,1672545112,1147
7959,3516065852,3412825109,1672631775,1672633142,1367
7885,3483949762,3736790081,1672668192,1672668782,590
7843,3777936328,3976390453,1672673549,1672673951,402
7968,3209027249,3755798867,1672690689,1672691016,327
7678,3688418210,3505859863,1672614057,1672614833,776
7657,3512969370,3448855696,1672554960,1672557490,2530
7912,3791602225,3806545488,1672663212,1672665848,2636
7808,3627937312,3453729665,1672621177,1672622252,1075
7706,3411618230,3291235378,1672568374,1672571055,2681
7544,3662180254,3736786443,1672668524,1672671516,2992
7615,3826759140,3516039895,1672630616,1672631082,466
7826,3519563836,3387966152,1672677466,1672679179,1713
7688,3778980116,3774125065,1672600590,1672604146,3556
7919,3760077057,3388286531,1672549686,1672551244,1558
7488,3360506772,3383661227,1672689682,1672692966,3284
7595,3826759140,3342131135,1672599373,1672599604,231
7560,3770851318,3777806071,1672703443,1672705037,1594
7549,3801089989,3783509527,1672590550,1672591715,1165
7668,3829319703,3937224533,1672571587,1672571680,93
7558,3510711755,3510703546,1672688952,1672691782,2830
7679,3519556068,3792177074,1672614395,1672615871,1476
7921,3518408774,3780294829,1672602741,1672603972,1231
7938,3311648200,3733189298,1672620526,1672623365,2839
7606,3777443199,3517077106,1672670795,1672674053,3258
7741,3516258476,3533626375,1672668550,1672669265,715
7801,3500578848,3247428249,1672634664,1672637081,2417
7775,3780914982,3701065786,1672587531,1672589452,1921
7760,3793338102,3466911760,1672635693,1672636952,1259
7568,3777079686,3932051427,1672538686,1672539622,936
7567,3383922351,3791334389,1672656295,1672659314,3019
7806,3976633198,3516716179,1672564799,1672564885,86
7974,3520190170,3392121505,1672576315,1672578679,2364
7621,3520931254,3701065786,1672571315,1672573513,2198
7817,3244485293,3885670556,1672664957,1672668471,3514
7913,3666457294,3716258994,1672644267,1672644580,313
7914,3885670556,3516011407,1672584592,1672587814,3222
7719,3481647420,3501198706,1672612729,1672615868,3139
7759,3836573197,3501364586,1672583233,1672585285,2052
7747,3432689543,3520190170,1672586855,1672590101,3246
7640,3714821932,3774268456,1672577355,1672579048,1693
7702,3201432789,3311208440,1672597999,1672600374,2375
7530,3280599164,3901877072,1672594981,1672595349,368
7758,3715974031,3276640712,1672549779,1672551111,1332
7869,3711308224,3604539807,1672573029,1672573369,340
7578,3533242305,3756462516,1672571311,1672573555,2244
7702,3811171116,3629935998,1672565851,1672568927,3076
7663,3918584946,3407954858,1672601380,1672602475,1095
7559,3351008918,3827377568,1672534236,1672537336,3100
7601,3475251781,3291235378,1672693898,1672696424,2526
7596,3510247121,3208844525,1672535480,1672538046,2566
7769,3713808837,3970117174,1672594610,1672595300,690
7554,3607178184,3791115967,1672660687,1672663688,3001
7896,3534313900,3711370563,1672582906,1672583635,729
7644,3404384505,3792902982,1672619489,1672620841,1352
7854,3339907603,3736625083,1672555228,1672558031,2803
7603,3429690204,3516011407,1672623182,1672625354,2172
7527,3757151210,3534702203,1672571589,1672573750,2161
7543,3607178184,3490191091,1672591862,1672593864,2002
7927,3415546117,3887270940,1672543572,1672545861,2289
7894,3517077106,3633420270,1672572117,1672574275,2158
7805,3805292782,3859525941,1672627936,1672628500,564
7534,3757151210,3733189298,1672635255,1672638258,3003
7501,3710408395,3465254146,1672602372,1672605506,3134
7685,3780294829,3228165483,1672588193,1672589128,935
7589,3832902928,3735733948,1672558976,1672560397,1421
7509,3883861463,3637008488,1672643113,1672646526,3413
7732,3480687894,3772053179,1672679780,1672680435,655
7578,3510937904,3918584946,1672650925,1672652771,1846
7531,3833889105,3778341199,1672606555,1672609183,2628
7678,3735319397,3222521619,1672644617,1672647460,2843
7527,3501601840,3517509185,1672658165,1672659500,1335
7863,3475396323,3605726278,1672647377,1672649517,2140
7572,3774005526,3552314511,1672650886,1672652575,1689
7801,3516960534,3736592744,1672598200,1672598593,393
7731,3852595551,3500066230,1672697590,1672698971,1381
7552,3916289176,3909331423,1672664072,1672666638,2566
7957,3772714862,3606812411,1672558123,1672560778,2655
7764,3711504540,3517476351,1672633751,1672636216,2465
7918,3715339701,3520709480,1672693353,1672696089,2736
7655,3277605882,3291235378,1672598175,1672601050,2875
7609,3426325549,3201432789,1672590640,1672592007,1367
7916,3629935998,3711198793,1672669190,1672671716,2526
7567,3703013906,3517963492,1672631419,1672632460,1041
7845,3617734118,3604539807,1672649276,1672652674,3398
7534,3755943611,3911245524,1672631137,1672632148,1011
7875,3500487333,3714474557,1672642051,1672644405,2354
7706,3513599775,3770021824,1672538226,1672541580,3354
7826,3311439795,3533095755,1672614273,1672615250,977
7549,3793962300,3514128943,1672534866,1672538427,3561
7719,3303705369,3397418363,1672613285,1672616636,3351
7763,3701534009,3806545488,1672568502,1672570869,2367
7779,3701995648,3774125065,1672687354,1672687756,402
7631,3228165483,3505791599,1672555743,1672558170,2427
7960,3703889596,3505219850,1672560146,1672562915,2769
7846,3683959482,3448855696,1672621950,1672622429,479
7539,3465254146,3505173328,1672590692,1672591891,1199
7705,3685818092,3501184421,1672670092,1672673665,3573
7697,3925620998,3772578994,1672592806,1672596095,3289
7581,3313541986,3774066725,1672650703,1672653063,2360
7830,3427283336,3412825109,1672688328,1672688821,493
7899,3715974031,3770553384,1672673863,1672674217,354
7593,3737051610,3606186086,1672614616,1672617794,3178
7961,3359239884,3505638204,1672579254,1672581760,2506
7539,3618873142,3711265369,1672590001,1672591797,1796
7689,3779976989,3833889105,1672665853,1672667410,1557
7538,3773755137,3901990690,1672547177,1672550575,3398
7628,3512969370,3235287260,1672605539,1672608787,3248
7728,3505219850,3519428855,1672640581,1672644077,3496
7771,3511198618,3509630174,1672576919,1672579449,2530
7610,3716746253,3716273414,1672597206,1672599656,2450
7978,3534313900,3417061462,1672692479,1672693220,741
7616,3520751702,3386707783,1672565683,1672567682,1999
7862,3770553384,3380035798,1672591285,1672594008,2723
7878,3291227780,3910454786,1672655066,1672656990,1924
7878,3801089989,3978105277,1672569667,1672573013,3346
7860,3703955926,3793436995,1672573312,1672575165,1853
7788,3298433163,3802367797,1672580724,1672582051,1327
7725,3780365428,3391261292,1672621191,1672622351,1160
7679,3339907603,3512217942,1672551458,1672553273,1815
7731,3420700674,3776948966,1672571321,1672573033,1712
7777,3418534998,3516980378,1672672378,1672675470,3092
7559,3606812411,3314836094,1672533573,1672536557,2984
7760,3365830990,3791115967,1672585583,1672586654,1071
7813,3311718847,3519556068,1672532106,1672534149,2043
7608,3280615985,3716165213,1672691987,1672693867,1880
7715,3476232529,3932051427,1672699826,1672700763,937
7631,3202120784,3711504540,1672689461,1672692824,3363
7668,3780914982,3701065786,1672532030,1672532229,199
7921,3500458761,3285400528,1672608383,1672610840,2457
7873,3509630174,3311090974,1672644680,1672646054,1374
7770,3331845324,3509933351,1672622056,1672624204,2148
7892,3505173328,3909331423,1672640401,1672643043,2642
7942,3755587522,3472130842,1672651571,1672652258,687
7839,3518669703,3757161914,1672620262,1672620414,152
7495,3515394721,3703013906,1672689608,1672692579,2971
7929,3533193862,3978115672,1672553245,1672555834,2589
7906,3501486692,3899266183,1672544604,1672545058,454
7839,3757403279,3973560347,1672618959,1672620665,1706
7750,3920801189,3519428855,1672594700,1672595129,429
7806,3505362057,3805347939,1672673165,1672673482,317
7609,3417587765,3701691675,1672586587,1672589822,3235
7542,3851190615,3616944364,1672658103,1672659958,1855
7870,3489217083,3701995648,1672579337,1672581541,2204
7768,3513201436,3516960534,1672622641,1672625026,2385
7959,3465202715,3365614305,1672653845,1672655738,1893
7684,3519069599,3505599848,1672636952,1672638027,1075
7689,3511198618,3791957752,1672547382,1672547825,443
7569,3817621391,3316173088,1672578715,1672579614,899
7603,3331845324,3852595551,1672611842,1672614024,2182
7790,3411618230,3608868877,1672542837,1672543533,696
7711,3512510536,3515125508,1672697493,1672701031,3538
7948,3533193862,3888559320,1672700787,1672703384,2597
7890,3735319397,3755872268,1672635973,1672638276,2303
7804,3772746272,3816853177,1672543919,1672543979,60
7738,3383661227,3512142794,1672652705,1672652935,230
7579,3783779671,3820354437,1672551909,1672555201,3292
7492,3714474557,3774050956,1672660761,1672661490,729
7770,3918674986,3505859863,1672579204,1672580211,1007
7760,3500904641,3714197325,1672615739,1672618333,2594
7837,3760489031,3837094550,1672701564,1672701640,76
7737,3793962300,3882291183,1672602744,1672603663,919
7854,3417587765,3783429780,1672639044,1672640635,1591
7953,3715981584,3415546117,1672677881,1672678264,383
7770,3505599848,3501364586,1672573137,1672576638,3501
7810,3336751428,3610348516,1672640272,1672642438,2166
7679,3429856982,3703661585,1672535338,1672538789,3451
7829,3307512479,3516980378,1672606295,1672607624,1329
7749,3520931254,3855000166,1672592159,1672594684,2525
7804,3235635976,3736229191,1672540250,1672540824,574
7918,3519803045,3209551760,1672591256,1672594240,2984
7946,3932051427,3793338102,1672559135,1672560256,1121
7685,3805519285,3517476351,1672542626,1672545652,3026
7906,3517864478,3757455053,1672637105,1672637509,404
7820,3716537575,3924549929,1672638539,1672640089,1550
7581,3284639858,3417587765,1672558438,1672559390,952
7713,3277669002,3756021689,1672662976,1672663268,292
7879,3903307060,3627937312,1672570093,1672571531,1438
7732,3496269445,3616944364,1672686907,1672689152,2245
7906,3666457294,3703441914,1672657338,1672657702,364
7564,3601879040,3314836094,1672620783,1672623953,3170
7640,3482405588,3319752091,1672539747,1672540512,765
7632,3774501422,3289061738,1672563325,1672563875,550
7834,3703718151,3518014404,1672543469,1672543822,353
7851,3792253549,3780365428,1672650588,1672652619,2031
7954,3533385867,3792473331,1672663997,1672667254,3257
7867,3432665384,3516960534,1672585294,1672588509,3215
7607,3920801189,3855937514,1672561277,1672563874,2597
7612,3736625083,3793286136,1672674690,1672676945,2255
7497,3777120536,3922337974,1672668530,1672670535,2005
7877,3314245084,3883551721,1672594310,1672597535,3225
7883,3284639858,3510380060,1672655454,1672658515,3061
7587,3244389794,3755881905,1672679360,1672682849,3489
7842,3517721725,3311761694,1672556619,1672559907,3288
7753,3715127362,3511332835,1672679688,1672679794,106
7887,3779629905,3793959750,1672576626,1672577661,1035
7706,3428006164,3513080274,1672649528,1672652745,3217
7678,3903307060,3501364586,1672546061,1672546938,877
7526,3383661227,3505859863,1672647222,1672649844,2622
7815,3500391167,3793338102,1672540174,1672542545,2371
7591,3774010081,3534702203,1672626823,1672627189,366
7904,3405494240,3516514391,1672603498,1672604235,737
7506,3518932404,3511359172,1672629433,1672631399,1966
7875,3917278625,3201324715,1672592799,1672594635,1836
7551,3757455053,3509604974,1672556662,1672558327,1665
7491,3500177712,3202120784,1672643914,1672644202,288
7801,3515860749,3293695955,1672660734,1672663728,2994
7648,3514283243,3783705817,1672607367,1672610733,3366
7712,3480687894,3223789409,1672563424,1672564706,1282
7522,3621810464,3770021824,1672681733,1672684508,2775
7653,3509907947,3510247121,1672578343,1672578760,417
7840,3509773875,3489217083,1672536272,1672538708,2436
7820,3792844210,3666507626,1672583800,1672587123,3323
7732,3773120434,3367902229,1672629491,1672630570,1079
7517,3701146057,3881477378,1672681120,1672683776,2656
7668,3467773920,3825229501,1672593174,1672593614,440
7790,3793086311,3772884106,1672568179,1672569161,982
7645,3685818092,3703661585,1672604510,1672605615,1105
7825,3534010629,3826415738,1672544201,1672547297,3096
7887,3517077106,3760569731,1672599216,1672600412,1196
7723,3791334389,3755625324,1672651400,1672652671,1271
7725,3755436115,3501606184,1672559393,1672560049,656
7563,3713644518,3248507722,1672613502,1672614610,1108
7844,3713644518,3756424865,1672556449,1672558587,2138
7732,3716537575,3772642849,1672559775,1672562157,2382
7739,3852595551,3774338212,1672670429,1672671671,1242
7644,3277939457,3500499542,1672597979,1672600825,2846
7660,3851190615,3777983879,1672561362,1672562364,1002
7565,3505173328,3516960534,1672674574,1672674986,412
7866,3501601840,3607748895,1672703396,1672705281,1885
7741,3496051529,3713786889,1672676452,1672678434,1982
7632,3391915121,3555214688,1672621486,1672621935,449
7982,3978115672,3756021689,1672632247,1672633447,1200
7831,3510244400,3500458761,1672662593,1672663408,815
7702,3534729133,3639847263,1672536029,1672537423,1394
7592,3757682496,3828432634,1672684121,1672685608,1487
7861,3793086311,3778341199,1672643728,1672646983,3255
7929,3811694763,3505599848,1672589339,1672590077,738
7548,3607748895,3501483568,1672682558,1672685646,3088
7735,3903307060,3417061462,1672578640,1672581933,3293
7537,3511435497,3209027249,1672561033,1672564630,3597
7545,3384240055,3917278625,1672663761,1672664998,1237
7871,3420700674,3231056870,1672662932,1672664514,1582
7718,3772642849,3791874383,1672554987,1672557787,2800
7626,3715189301,3518669703,1672664454,1672664742,288
7521,3703223015,3505635228,1672544473,1672545781,1308
7887,3517864478,3359239884,1672665615,1672669033,3418
7818,3505859863,3710408395,1672569340,1672572130,2790
7907,3819727225,3304056063,1672612743,1672614508,1765
7799,3734828619,3519601612,1672608215,1672610207,1992
7656,3533242305,3209048907,1672574039,1672574829,790
7560,3512349371,3608868877,1672681623,1672682577,954
7787,3715127362,3505873261,1672569060,1672569763,703
7531,3280964728,3311871871,1672630741,1672633683,2942
7603,3791657947,3629935998,1672669979,1672672617,2638
7853,3533927138,3825229501,1672659100,1672662328,3228
7726,3855000166,3501927421,1672693784,1672695438,1654
7846,3512837326,3792668962,1672586512,1672587753,1241
7853,3774010081,3515284591,1672551462,1672552720,1258
7513,3208844525,3418534998,1672550303,1672551524,1221
7732,3415546117,3485823740,1672578610,1672580076,1466
7896,3331845324,3315583351,1672600940,1672602534,1594
7532,3621497531,3910886626,1672630179,1672632671,2492
7555,3776800213,3792902982,1672589127,1672589468,341
7615,3772337814,3391261292,1672566090,1672569049,2959
7605,3835382117,3407673904,1672582468,1672585326,2858
7863,3855424474,3918056059,1672615180,1672617448,2268
7822,3757455053,3777477395,1672583443,1672584097,654
7639,3359910781,3756528686,1672553587,1672554496,909
7650,3412825109,3516065852,1672534319,1672535217,898
7734,3501606184,3533810360,1672662853,1672662993,140
7503,3774005526,3711265369,1672551462,1672552373,911
7684,3511198618,3519912874,1672687459,1672688806,1347
7791,3311993075,3516465662,1672670212,1672671622,1410
7956,3518669703,3316222192,1672593010,1672596107,3097
7567,3359910781,3416427576,1672543939,1672546277,2338
7525,3515394721,3755739653,1672677768,1672678778,1010
7945,3701534009,3518163778,1672700772,1672703945,3173
7519,3802367797,3760294205,1672683412,1672684410,998
7638,3344364444,3518791447,1672663793,1672666686,2893
7704,3774556560,3505912939,1672694693,1672696761,2068
7923,3780294829,3618045231,1672550026,1672551729,1703
7788,3478194807,3823600322,1672567996,1672569194,1198
7929,3517864478,3914259449,1672674319,1672675954,1635
7753,3426325549,3755511676,1672659899,1672660555,656
7491,3715981584,3280599164,1672532805,1672533930,1125
7930,3772746272,3703718151,1672584435,1672585596,1161
7858,3426325549,3713630656,1672535947,1672539026,3079
7564,3811694763,3311648200,1672532005,1672535375,3370
7558,3223789409,3311648200,1672590411,1672593289,2878
7732,3613995936,3331845324,1672547730,1672550877,3147
7902,3780609808,3716165213,1672682188,1672682701,513
7892,3773950140,3307097200,1672685716,1672686277,561
7826,3731106822,3311603601,1672531841,1672533845,2004
7865,3221536550,3346795719,1672583192,1672584809,1617
7510,3227158514,3791602225,1672681570,1672682768,1198
7667,3520719611,3755739653,1672680115,1672682646,2531
7551,3770078063,3792473331,1672634120,1672635195,1075
7823,3772359096,3857349323,1672550513,1672551482,969
7518,3501955238,3517963492,1672591734,1672595007,3273
7529,3701178711,3899266183,1672689615,1672691447,1832
7903,3520012395,3972709319,1672628000,1672628094,94
7588,3318166135,3715981584,1672631358,1672633453,2095
7685,3514472925,3360993964,1672558714,1672560233,1519
7769,3510173870,3930797455,1672602427,1672602877,450
7486,3511125626,3780365428,1672542260,1672543750,1490
7975,3855602893,3937224533,1672692573,1672695213,2640
7670,3791942683,3710344260,1672600757,1672603962,3205
7567,3716843669,3385763781,1672642234,1672645660,3426
7545,3505649239,3348261553,1672693343,1672694231,888
7487,3852391257,3311718847,1672601572,1672602677,1105
7936,3701984666,3511435497,1672562647,1672565697,3050
7555,3918584946,3513164386,1672670524,1672673748,3224
7746,3359910781,3533927138,1672597824,1672599330,1506
7842,3811171116,3489962019,1672583048,1672584819,1771
7964,3518360734,3773205565,1672590411,1672592168,1757
7919,3903009525,3912262917,1672647021,1672647776,755
7856,3426325549,3466911760,1672561446,1672562028,582
7512,3501730685,3925620998,1672669304,1672670408,1104
7743,3221899927,3703441914,1672664417,1672667456,3039
7507,3400804807,3714474557,1672671135,1672674380,3245
7604,3703661585,3209551760,1672679388,1672679980,592
7505,3500803339,3777936328,1672592094,1672595198,3104
7770,3922337974,3885897503,1672542467,1672543055,588
7614,3903962771,3420700674,1672697106,1672698045,939
7614,3416265063,3519700826,1672602445,1672604342,1897
7801,3805292782,3774501422,1672572945,1672574663,1718
7703,3760077057,3500458761,1672696704,1672699443,2739
7557,3472130842,3760183458,1672605220,1672606532,1312
7917,3318697153,3731419510,1672534432,1672534510,78
7688,3839849341,3922337974,1672677573,1672679996,2423
7880,3783925755,3448855696,1672576255,1672579599,3344
7652,3737079798,3519556068,1672645248,1672647651,2403
7635,3713349754,3713349754,1672702700,1672705787,3087
7785,3883861463,3823600322,1672552495,1672552701,206
7736,3510703546,3777079686,1672623464,1672624742,1278
7759,3234541252,3512166013,1672565302,1672568763,3461
7587,3500499542,3467773920,1672606871,1672609957,3086
7824,3703223015,3607178184,1672587785,1672591180,3395
7632,3359910781,3756623396,1672577013,1672578551,1538
7768,3472130842,3773950140,1672543346,1672545773,2427
7622,3605726278,3774520233,1672571995,1672572685,690
7979,3924549929,3757682496,1672646882,1672648403,1521
7758,3757403279,3793338102,1672617828,1672620917,3089
7611,3367902229,3318166135,1672542301,1672542970,669
7920,3791334389,3451432842,1672628336,1672629861,1525
7637,3387966152,3311439795,1672652624,1672653646,1022
7505,3518014404,3792384220,1672697980,1672700137,2157
7643,3716165213,3516465662,1672556754,1672557506,752
7933,3760489031,3608633356,1672553127,1672555341,2214
7867,3559110998,3780609808,1672625411,1672626622,1211
7797,3901877072,3500458761,1672641810,1672642395,585
7627,3703013906,3311324983,1672595507,1672596586,1079
7500,3489217083,3209027249,1672638389,1672639940,1551
7710,3505203158,3918056059,1672584675,1672585587,912
7637,3510126867,3473765852,1672683081,1672685718,2637
7850,3886298125,3666507626,1672547372,1672550140,2768
7816,3244436890,3500458761,1672642828,1672645188,2360
7796,3823600322,3713894336,1672601152,1672603341,2189
7780,3774010081,3756027749,1672607288,1672607579,291
7555,3512217942,3244485293,1672564726,1672566270,1544
7607,3517077106,3500803339,1672558265,1672558480,215
7792,3773755137,3701863557,1672550801,1672552686,1885
7530,3392121505,3483949762,1672565633,1672567610,1977
7959,3713644518,3836573197,1672548105,1672548547,442
7855,3501730685,3315583351,1672644149,1672646524,2375
7659,3855602893,3318166135,1672532791,1672534208,1417
7680,3807987001,3458539365,1672606086,1672608812,2726
7509,3773978034,3505098372,1672642736,1672645740,3004
7810,3604539807,3400804807,1672586108,1672587330,1222
7858,3505912939,3380035798,1672672706,1672674272,1566
7857,3311154569,3667680268,1672661979,1672665330,3351
7788,3731106822,3780365428,1672565708,1672566571,863
7695,3713644518,3776338577,1672592200,1672595588,3388
7540,3489217083,3774268456,1672630782,1672633226,2444
7920,3792768129,3756623396,1672673080,1672675733,2653
7601,3772884106,3937224533,1672658818,1672661486,2668
7583,3510937904,3517721725,1672620892,1672621448,556
7682,3770553384,3517476351,1672677896,1672680166,2270
7742,3703275621,3412980697,1672541061,1672541894,833
7811,3777983879,3755872268,1672664117,1672664776,659
7755,3757455053,3629935998,1672578073,1672579626,1553
7720,3399911573,3380035798,1672583580,1672584522,942
7979,3918247820,3757403279,1672537733,1672540981,3248
7520,3827626797,3791334389,1672581354,1672583404,2050
7491,3802367797,3813052709,1672576154,1672576491,337
7672,3773755137,3777790718,1672673910,1672676625,2715
7601,3221536550,3496269445,1672626147,1672626997,850
7588,3757246925,3774338212,1672635478,1672635819,341
7632,3716165213,3501759100,1672592425,1672593316,891
7573,3291227780,3792789881,1672599851,1672601949,2098
7514,3505203158,3492478793,1672540551,1672541692,1141
7903,3520751702,3534191820,1672654665,1672656892,2227
7789,3792032359,3489217083,1672692062,1672694853,2791
7498,3855000166,3611150562,1672656175,1672657637,1462
7833,3533369198,3515284591,1672554977,1672557086,2109
7848,3772544062,3519803045,1672677509,1672680722,3213
7711,3418728074,3415546117,1672592820,1672593312,492
7730,3417970574,3755920131,1672701476,1672703180,1704
7840,3779036831,3774195321,1672534957,1672537448,2491
7836,3510711755,3511841857,1672701231,1672701496,265
7865,3935127663,3883551721,1672583999,1672585158,1159
7960,3519563836,3733891182,1672631517,1672633886,2369
7721,3516514391,3534488837,1672688166,1672688981,815
7609,3774580701,3446948848,1672616293,1672616363,70
7544,3518014636,3622054816,1672635716,1672638142,2426
7634,3634786711,3662180254,1672676491,1672679092,2601
7635,3533270638,3392121505,1672665180,1672666108,928
7718,3881477378,3312333615,1672600258,1672603083,2825
7714,3815508790,3301107849,1672581825,1672583138,1313
7559,3505859863,3303751772,1672663071,1672666225,3154
7878,3755798867,3792384220,1672680750,1672682498,1748
7947,3505477652,3428674539,1672572619,1672574819,2200
7812,3249401741,3780974443,1672563544,1672566474,2930
7636,3755739653,3776800213,1672696559,1672697162,603
7688,3533137446,3736786443,1672574198,1672575749,1551
7834,3716835696,3711262377,1672649948,1672652523,2575
7976,3780813786,3760893269,1672677365,1672677433,68
7909,3519803045,3513454145,1672653056,1672654738,1682
7829,3298433163,3512720680,1672606583,1672609818,3235
7749,3346327502,3770447408,1672601924,1672603633,1709
7979,3518260334,3517721725,1672610632,1672611753,1121
7751,3482405588,3883861463,1672626330,1672629315,2985
7745,3520376528,3500365158,1672652825,1672654667,1842
7903,3520756859,3780639480,1672550630,1672553443,2813
7734,3516673015,3774339795,1672625831,1672628740,2909
7891,3891751546,3776513891,1672698354,1672701115,2761
7590,3613995936,3714821932,1672534637,1672538094,3457
7965,3344364444,3512969370,1672602752,1672602954,202
7930,3318166135,3380035798,1672610588,1672613372,2784
7712,3485375593,3331845324,1672685729,1672688249,2520
7639,3534191820,3511350608,1672573801,1672575279,1478
7826,3713268590,3416241005,1672552969,1672554511,1542
7827,3715339701,3509773875,1672689016,1672690020,1004
7688,3859663348,3793959750,1672582656,1672585154,2498
7720,3517255726,3774045700,1672641842,1672642655,813
7612,3755436115,3383922351,1672621362,1672623399,2037
7719,3792768129,3411618230,1672536486,1672539603,3117
7709,3793286136,3883551721,1672590129,1672593537,3408
7891,3756623396,3826759140,1672675321,1672677470,2149
7646,3505362057,3883312122,1672697840,1672700376,2536
7800,3666506258,3716197887,1672572310,1672572651,341
7755,3338703270,3311154569,1672532906,1672534143,1237
7724,3972709319,3760294205,1672601615,1672602562,947
7511,3915628728,3774127586,1672637205,1672637630,425
7577,3774366875,3883042241,1672642407,1672645389,2982
7866,3412825109,3512567240,1672659691,1672662354,2663
7546,3515723720,3505638204,1672568921,1672569467,546
7582,3855000166,3417587765,1672581552,1672583726,2174
7633,3533369198,3756453423,1672656971,1672657184,213
7839,3805519285,3701498253,1672656448,1672656906,458
7585,3500199935,3505912939,1672674309,1672674453,144
7622,3883312122,3666553782,1672673159,1672676143,2984
7557,3826633236,3685818092,1672671406,1672674850,3444
7510,3399052055,3777120536,1672539789,1672542465,2676
7594,3791901535,3311648200,1672607376,1672610877,3501
7608,3231056870,3519700826,1672658527,1672659276,749
7868,3701534009,3710098970,1672671367,1672672835,1468
7535,3489217083,3501483568,1672698394,1672699202,808
7760,3930797455,3534702203,1672595780,1672595955,175
7935,3206603608,3348261553,1672638278,1672640061,1783
7592,3811171116,3793436995,1672624531,1672627656,3125
7690,3407673904,3407673904,1672638642,1672640585,1943
7707,3711569060,3438645253,1672531921,1672533024,1103
7589,3517721725,3517509185,1672703777,1672706736,2959
7738,3935627557,3622054816,1672546900,1672547496,596
7576,3520756859,3816454165,1672579919,1672580638,719
7963,3770824086,3518360734,1672608731,1672611274,2543
7879,3778780511,3628819436,1672691488,1672694892,3404
7919,3314836094,3505912939,1672595844,1672598645,2801
7798,3465254146,3772309150,1672696542,1672699163,2621
7800,3505145247,3512969370,1672666134,1672666943,809
7486,3780294829,3387674757,1672586034,1672588898,2864
7590,3688683847,3501927421,1672551502,1672553820,2318
7591,3404058699,3899266183,1672635241,1672638750,3509
7606,3501606184,3757161914,1672585457,1672585784,327
7514,3500199935,3501364586,1672546614,1672549793,3179
7933,3500578848,3443698222,1672541173,1672542905,1732
7676,3922275416,3477375368,1672647530,1672648124,594
7938,3384951177,3509933351,1672678450,1672681741,3291
7785,3711198793,3792032359,1672560599,1672562818,2219
7911,3715974031,3223789409,1672702425,1672704620,2195
7789,3774268456,3298288268,1672678710,1672681547,2837
7774,3397418363,3430352815,1672627050,1672629934,2884
7699,3716537575,3713786889,1672681396,1672681865,469
7751,3939952128,3533748232,1672634983,1672635853,870
7899,3624761861,3714474557,1672666802,1672667147,345
7534,3520190170,3280615985,1672671090,1672671773,683
7779,3703789494,3418534998,1672665675,1672666414,739
7979,3666507626,3624312512,1672549998,1672551507,1509
7530,3711569060,3885670556,1672568951,1672570676,1725
7574,3730517636,3515691540,1672666972,1672667155,183
7690,3518014636,3534492426,1672700339,1672703570,3231
7971,3509634629,3514283243,1672638084,1672638585,501
7846,3714474557,3336742544,1672577820,1672580573,2753
7764,3331845324,3402943525,1672640153,1672642641,2488
7682,3518791447,3346327502,1672543853,1672546666,2813
7607,3607748895,3778266283,1672564609,1672564734,125
7498,3417970574,3610348516,1672676314,1672677282,968
7680,3889232789,3701146057,1672556368,1672559157,2789
7873,3807987001,3334033993,1672562115,1672564093,1978
7744,3613995936,3770101921,1672636162,1672639128,2966
7780,3400804807,3208844525,1672564889,1672568288,3399
7971,3533242305,3701898991,1672610274,1672613427,3153
7703,3516909237,3316173088,1672600079,1672600405,326
7579,3714488548,3774580701,1672691905,1672693075,1170
7860,3791901535,3792384220,1672538050,1672538846,796
7780,3755798867,3520730271,1672694480,1672695382,902
7615,3277939457,3703889596,1672543731,1672546182,2451
7544,3774045700,3534553510,1672655434,1672656445,1011
7539,3311761694,3774127586,1672678401,1672681581,3180
7819,3770078063,3509672210,1672646645,1672648887,2242
7620,3412980697,3285400528,1672548635,1672550171,1536
7529,3820354437,3517255726,1672641361,1672642241,880
7573,3510247121,3736790081,1672550190,1672552814,2624
7893,3505145247,3711569060,1672621211,1672624666,3455
7777,3518876135,3288764520,1672692652,1672693761,1109
7501,3399052055,3471220483,1672630190,1672632519,2329
7511,3430074045,3777455223,1672668958,1672672007,3049
7797,3518791447,3208844525,1672549616,1672553123,3507
7958,3914290246,3312829208,1672548469,1672549953,1484
7972,3505098372,3778780511,1672582458,1672584535,2077
7573,3201432789,3352603894,1672584606,1672585239,633
7869,3912262917,3249401741,1672557072,1672557459,387
7815,3716488385,3284832486,1672605101,1672607989,2888
7962,3885897503,3515860749,1672659989,1672663569,3580
7821,3757403279,3512567240,1672674857,1672675179,322
7668,3278365525,3858918246,1672675004,1672676965,1961
7600,3889232789,3776800213,1672570848,1672571645,797
7596,3516606733,3716197887,1672606769,1672610363,3594
7516,3711265369,3716197887,1672674401,1672676485,2084
7777,3373384732,3978105277,1672661871,1672663929,2058
7726,3519069599,3757403279,1672675556,1672676723,1167
7613,3244485293,3701498253,1672607844,1672609218,1374
7844,3202120784,3516465662,1672567395,1672570605,3210
7770,3733891182,3924549929,1672584641,1672585443,802
7720,3516673015,3492478793,1672543955,1672547156,3201
7506,3783126683,3520206212,1672681013,1672683015,2002
7746,3505362057,3490191091,1672547609,1672547919,310
7867,3715339701,3509773875,1672694085,1672696272,2187
7949,3756601594,3735733948,1672581140,1672584068,2928
7628,3899204805,3613683164,1672635515,1672636967,1452
7529,3773664987,3736592744,1672547913,1672551143,3230
7917,3770763956,3903009525,1672676444,1672678626,2182
7549,3379589402,3832902928,1672570791,1672573838,3047
7816,3439023335,3378686918,1672633539,1672636490,2951
7616,3533137446,3209383861,1672632170,1672633612,1442
7813,3342131135,3483164654,1672693166,1672693590,424
7828,3713644518,3496269445,1672698782,1672699250,468
7669,3716843669,3772758337,1672546193,1672547362,1169
7548,3777983879,3510711755,1672622427,1672622530,103
7653,3793627961,3480687894,1672545503,1672546437,934
7791,3791334389,3361230905,1672665049,1672666901,1852
7916,3757447189,3501486692,1672659798,1672662099,2301
7688,3512540951,3757602960,1672577048,1672579387,2339
7542,3737154119,3779036831,1672574694,1672575420,726
7747,3818255890,3774466457,1672597854,1672600070,2216
7758,3760294205,3505635228,1672582742,1672583489,747
7694,3634786711,3901877072,1672684889,1672686922,2033
7569,3918056059,3249401741,1672602224,1672603637,1413
7854,3881477378,3756021689,1672641663,1672642006,343
7707,3501601840,3715127362,1672627222,1672628643,1421
7572,3780609808,3757161914,1672545051,1672547167,2116
7529,3500391167,3629935998,1672549203,1672549792,589
7675,3511125626,3711262377,1672653010,1672655150,2140
7488,3222448362,3291227780,1672535529,1672537207,1678
7976,3515284591,3886298125,1672680553,1672682886,2333
7614,3757562897,3388637594,1672616143,1672619144,3001
7530,3471220483,3416427576,1672677801,1672680824,3023
7877,3777079686,3520376528,1672600460,1672603572,3112
7541,3714474557,3783925755,1672615354,1672615796,442
7970,3774005526,3777790718,1672674050,1672675718,1668
7521,3289061738,3811171116,1672636093,1672639628,3535
7922,3773429448,3509352754,1672558053,1672558624,571
7490,3801089989,3284639858,1672648376,1672648678,302
7714,3924549929,3889232789,1672578630,1672582161,3531
7857,3206593906,3936227020,1672683668,1672685098,1430
7770,3471220483,3772309166,1672554352,1672554813,461
7981,3232962003,3311203656,1672632733,1672635053,2320
7947,3610695419,3511170269,1672639220,1672642122,2902
7789,3391915886,3534424200,1672693471,1672694958,1487
7534,3773120434,3311871871,1672628473,1672630709,2236
7572,3386707783,3285400528,1672664525,1672668001,3476
7512,3715189301,3511435497,1672541260,1672541576,316
7591,3344364444,3601879040,1672577561,1672577772,211
7848,3760561634,3510247121,1672675760,1672676593,833
7516,3805292782,3793959750,1672599001,1672600054,1053
7677,3475795792,3221899927,1672666402,1672668979,2577
7867,3713370078,3517864478,1672532966,1672536136,3170
7506,3514719601,3776800213,1672587119,1672589395,2276
7547,3792768129,3387674757,1672651116,1672651442,326
7800,3776948966,3512349371,1672662825,1672665753,2928
7865,3783196518,3757562897,1672642576,1672643572,996
7942,3636867411,3420700674,1672623690,1672626773,3083
7699,3505869747,3227158514,1672680125,1672683498,3373
7618,3519428855,3778341199,1672638522,1672641363,2841
7942,3770101921,3734496778,1672533788,1672534919,1131
7698,3855000166,3755920131,1672701856,1672704180,2324
7818,3910886626,3505098372,1672649247,1672650919,1672
7836,3970117174,3285400528,1672667424,1672669220,1796
7970,3882997884,3607178184,1672635067,1672635756,689
7794,3792768129,3313564074,1672569463,1672572711,3248
7646,3439023335,3439023335,1672688566,1672691237,2671
7813,3835382117,3756966035,1672589897,1672589978,81
7964,3633420270,3344019610,1672689859,1672691866,2007
7747,3783083229,3701274634,1672531203,1672532232,1029
7926,3505219850,3801089989,1672565427,1672567917,2490
7968,3882997884,3778305740,1672679241,1672681926,2685
7828,3889750851,3473562469,1672563105,1672566189,3084
7762,3402943525,3926700506,1672573007,1672573762,755
7909,3517255726,3976390453,1672553936,1672555609,1673
7853,3793871337,3685818092,1672649580,1672650324,744
7619,3791594391,3779976989,1672631186,1672633293,2107
7488,3394330287,3516011407,1672535733,1672536835,1102
7730,3760492950,3533371364,1672579459,1672581238,1779
7695,3514838220,3773978034,1672703910,1672706351,2441
7683,3475258557,3716843669,1672617262,1672617446,184
7980,3714504419,3500994774,1672617753,1672618946,1193
7665,3314245084,3627937312,1672683201,1672684796,1595
7555,3811171116,3972364603,1672586009,1672588195,2186
7848,3510380060,3533095755,1672603621,1672604929,1308
7513,3511350608,3701274634,1672543608,1672546290,2682
7963,3770021824,3716168623,1672659763,1672662946,3183
7891,3227158514,3828624701,1672634105,1672634626,521
7785,3606987130,3510244400,1672632346,1672635791,3445
7961,3792768129,3412980697,1672668820,1672670361,1541
7525,3519556068,3379256399,1672618119,1672619874,1755
7710,3629547065,3833889105,1672654329,1672655908,1579
7886,3711569060,3223789409,1672702494,1672703595,1101
7610,3426325549,3615046771,1672675680,1672678604,2924
7905,3792032359,3336751428,1672670413,1672673030,2617
7890,3518360734,3446948848,1672698109,1672701594,3485
7589,3778980116,3777717988,1672661101,1672663117,2016
7565,3505201246,3448855696,1672557225,1672559241,2016
7965,3235287260,3517963492,1672609358,1672610420,1062
7672,3857349323,3889750851,1672620315,1672621567,1252
7652,3772642849,3607748895,1672582452,1672585427,2975
7527,3291883916,3428006164,1672559659,1672561794,2135
7801,3318697153,3311993075,1672674138,1672676452,2314
7951,3280964728,3918674986,1672540879,1672542574,1695
7555,3737051610,3533827120,1672550076,1672551847,1771
7724,3777514571,3405494240,1672549614,1672552985,3371
7835,3757161914,3386707783,1672657923,1672658957,1034
7857,3533280269,3716488385,1672676674,1672677522,848
7660,3791594391,3800353779,1672647385,1672647966,581
7562,3756462516,3637008488,1672644441,1672647444,3003
7838,3448855696,3496549058,1672585918,1672587743,1825
7736,3505599848,3776948966,1672567907,1672568718,811
7939,3318697153,3489217083,1672635309,1672638100,2791
7558,3516716179,3432689543,1672581554,1672584832,3278
7590,3311761694,3791657947,1672675759,1672677281,1522
7684,3346327502,3904775198,1672666978,1672669043,2065
7566,3802367797,3791901535,1672702995,1672706427,3432
7716,3777477395,3978115672,1672571251,1672572783,1532
7630,3772714862,3909238838,1672610717,1672610796,79
7803,3556951786,3668005723,1672669790,1672673333,3543
7971,3311871871,3757812939,1672682004,1672685351,3347
7757,3501730685,3716900301,1672589611,1672591563,1952
7616,3891751546,3792384220,1672569729,1672572561,2832
7697,3791942683,3901877072,1672663902,1672664002,100
7545,3307097200,3518932404,1672664316,1672665128,812
7506,3224058172,3820354437,1672687636,1672687950,314
7625,3829232696,3378092448,1672689949,1672690938,989
7627,3812176780,3505219850,1672678202,1672681007,2805
7487,3976390453,3515723720,1672671685,1672672457,772
7613,3715492942,3364543015,1672540713,1672542116,1403
7518,3534313900,3311274543,1672549037,1672550639,1602
7973,3783245561,3773814927,1672695685,1672699282,3597
7968,3533626375,3472130842,1672600773,1672603181,2408
7796,3509630174,3791602225,1672540290,1672541785,1495
7518,3779218771,3887270940,1672567162,1672567590,428
7745,3827377568,3777120536,1672536261,1672538781,2520
7868,3777514571,3757161914,1672661320,1672663450,2130
7727,3883861463,3351008918,1672574506,1672575730,1224
7705,3534424200,3533385867,1672594245,1672596127,1882
7902,3778308417,3918247820,1672684981,1672687943,2962
7585,3429690204,3685187183,1672678603,1672680016,1413
7717,3772544062,3600647945,1672685198,1672686888,1690
7681,3978105277,3515723720,1672648126,1672648665,539
7483,3244436890,3311324983,1672666161,1672669552,3391
7736,3886298125,3774125065,1672582649,1672585967,3318
7818,3421127249,3816454165,1672687805,1672691148,3343
7955,3518669703,3488244966,1672636062,1672638603,2541
7856,3910454786,3400804807,1672556429,1672556565,136
7877,3889750851,3837094550,1672619721,1672622145,2424
7712,3922275620,3918584946,1672602835,1672603081,246
7750,3519803045,3235287260,1672682249,1672683301,1052
7952,3417587765,3311603601,1672645612,1672648302,2690
7742,3736790081,3369998498,1672534483,1672536894,2411
7484,3792768129,3774338212,1672618028,1672621400,3372
7784,3500994774,3792253549,1672665028,1672668346,3318
7756,3604539807,3770078063,1672571088,1672573415,2327
7823,3628819436,3737154119,1672569228,1672571306,2078
7769,3976390453,3755392666,1672535019,1672538192,3173
7706,3311415018,3466911760,1672677085,1672679896,2811
7645,3416241005,3634786711,1672699048,1672700653,1605
7640,3273500349,3505173328,1672680558,1672682486,1928
7642,3688418210,3298433163,1672692596,1672694019,1423
7749,3286658957,3429856982,1672557609,1672560477,2868
7854,3427283336,3703718151,1672668673,1672671510,2837
7793,3387674757,3505638204,1672583796,1672584856,1060
7676,3303751772,3802367797,1672639891,1672643044,3153
7806,3778341199,3778308417,1672579391,1672582150,2759
7897,3779218771,3780503655,1672567339,1672568903,1564
7584,3391261292,3533193862,1672691416,1672694244,2828
7589,3387674757,3780609808,1672620774,1672624298,3524
7693,3360743849,3886298125,1672596296,1672598335,2039
7729,3837094550,3411618230,1672567095,1672569650,2555
7878,3334033993,3792288302,1672583195,1672586186,2991
7544,3629935998,3520376528,1672620915,1672623927,3012
7534,3624312512,3277939457,1672589799,1672592357,2558
7975,3446948848,3534191820,1672593119,1672594884,1765
7543,3627937312,3716258994,1672557547,1672560877,3330
7797,3517255726,3505859863,1672612937,1672615764,2827
7708,3779629905,3311208440,1672656079,1672659010,2931
7542,3505649239,3505219850,1672660137,1672660294,157
7877,3811694763,3415443558,1672615416,1672617584,2168
7962,3373384732,3404384505,1672661628,1672664671,3043
7598,3780503655,3783779671,1672549408,1672551608,2200
7873,3293695955,3511862351,1672662444,1672664164,1720
7683,3716746253,3711262377,1672662807,1672662926,119
7804,3917088658,3926700506,1672657502,1672657966,464
7936,3756528686,3520751702,1672534405,1672536773,2368
7969,3755587522,3406784491,1672609641,1672610537,896
7924,3520888296,3505135325,1672597639,1672600696,3057
7703,3515125508,3733189298,1672548818,1672550234,1416
7737,3402943525,3792768129,1672588525,1672591307,2782
7701,3512540951,3490191091,1672553805,1672557133,3328
7732,3511125626,3519912874,1672635472,1672638919,3447
7887,3209027249,3891751546,1672553149,1672556588,3439
7906,3859525941,3313541986,1672549711,1672551057,1346
7574,3428006164,3901990690,1672697887,1672699469,1582
7774,3779629905,3559110998,1672570558,1672573457,2899
7889,3805342762,3276640712,1672616240,1672618444,2204
7937,3716273414,3513164386,1672622346,1672623445,1099
7515,3510173870,3501606184,1672661545,1672662711,1166
7857,3736786443,3351008918,1672649697,1672650171,474
7815,3515723720,3898995675,1672549732,1672552562,2830
7957,3493507965,3855000166,1672624754,1672627620,2866
7693,3778308417,3808324264,1672621233,1672622591,1358
7741,3559110998,3505362057,1672700366,1672701372,1006
7653,3780593036,3835382117,1672598075,1672600438,2363
7684,3409474775,3396086535,1672593864,1672595931,2067
7934,3516011407,3778980116,1672698170,1672699251,1081
7880,3714821932,3833889105,1672576583,1672579794,3211
7884,3416265063,3374559242,1672648011,1672649922,1911
7516,3772359096,3475396323,1672539151,1672542059,2908
7637,3972709319,3773429448,1672615535,1672615972,437
7550,3792883665,3736229191,1672701385,1672704013,2628
7643,3428674539,3772359096,1672678449,1672678550,101
7828,3418728074,3738274418,1672643414,1672645134,1720
7817,3703735129,3454042520,1672660273,1672660975,702
7833,3488244966,3391261292,1672691398,1672691768,370
7542,3389115045,3429690204,1672676592,1672676655,63
7705,3559110998,3760077057,1672548871,1672549981,1110
7505,3494290908,3489545239,1672676857,1672679751,2894
7802,3756453423,3500499542,1672576603,1672580140,3537
7932,3501927421,3855937514,1672577596,1672578448,852
7759,3505145247,3514245078,1672535326,1672535871,545
7569,3778266283,3777806071,1672700258,1672701369,1111
7643,3756027749,3432665384,1672637737,1672639113,1376
7758,3737079798,3518014404,1672550856,1672554216,3360
7910,3516065852,3534729133,1672586829,1672588255,1426
7812,3756027749,3885897503,1672573010,1672573448,438
7913,3512510536,3516223597,1672534143,1672537674,3531
7713,3505635228,3770851318,1672633190,1672633979,789
7490,3915628728,3792789881,1672573306,1672573603,297
7654,3379256399,3772309150,1672593568,1672593674,106
7843,3489217083,3513080274,1672678346,1672680614,2268
7794,3760492950,3509773875,1672659562,1672660414,852
7769,3430504438,3882997884,1672546966,1672548070,1104
7825,3711504540,3505883609,1672685264,1672687953,2689
7977,3509630174,3378686918,1672683878,1672686332,2454
7514,3505962865,3634786711,1672694707,1672697558,2851
7619,3333896808,3774066725,1672661576,1672663534,1958
7602,3318697153,3701995648,1672673422,1672675418,1996
7627,3516465662,3773978034,1672614906,1672615884,978
7548,3235287260,3783531004,1672672049,1672674272,2223
7767,3617055293,3774066725,1672693071,1672693153,82
7780,3737079798,3922275620,1672687321,1672689224,1903
7924,3475396323,3512166013,1672601610,1672603092,1482
7807,3710067113,3760992710,1672593541,1672596678,3137
7912,3298433163,3288764520,1672593123,1672595268,2145
7484,3311845971,3201324715,1672557054,1672559256,2202
7636,3221899927,3735733948,1672667947,1672668369,422
7839,3792902982,3909238838,1672649096,1672650967,1871
7723,3501759100,3533927138,1672650901,1672651861,960
7736,3311203656,3519912874,1672632509,1672634707,2198
7496,3200691026,3520165601,1672648213,1672648398,185
7951,3394539273,3739106581,1672576884,1672579402,2518
7755,3280599164,3703441914,1672598768,1672601049,2281
7974,3224716315,3417061462,1672676934,1672680100,3166
7788,3534492426,3494290908,1672644980,1672648233,3253
7497,3976633198,3828365570,1672580356,1672581344,988
7534,3755511676,3533371364,1672557649,1672560946,3297
7573,3505702787,3774793839,1672652135,1672652966,831
7588,3777514571,3935127663,1672676250,1672678362,2112
7688,3396086535,3316173088,1672547220,1672549742,2522
7578,3296471982,3501483568,1672563437,1672564968,1531
7905,3736786443,3911245524,1672680382,1672680897,515
7915,3364543015,3711262377,1672676852,1672680439,3587
7926,3409474775,3412980697,1672549025,1672551454,2429
7535,3791997875,3311324983,1672574653,1672575142,489
7927,3454042520,3518791447,1672576034,1672577257,1223
7817,3778549126,3513599775,1672537343,1672539214,1871
7732,3360506772,3828365570,1672697897,1672699159,1262
7581,3738502357,3360743849,1672627346,1672628997,1651
7645,3715127362,3429856982,1672695079,1672695322,243
7590,3756462516,3516258476,1672573966,1672577512,3546
7959,3465254146,3809484172,1672652934,1672654083,1149
7723,3351008918,3792384220,1672572778,1672576297,3519
7887,3519069599,3388637594,1672555537,1672559136,3599
7976,3736229191,3510711755,1672698488,1672700043,1555
7536,3773978034,3710569131,1672662528,1672663205,677
7601,3520706195,3710408395,1672574901,1672576985,2084
7682,3500994774,3391915886,1672674495,1672675214,719
7905,3471220483,3458539365,1672568233,1672570360,2127
7814,3519556068,3512510536,1672627866,1672628578,712
7888,3685818092,3755872268,1672646152,1672646832,680
7832,3716537575,3280615985,1672594880,1672598327,3447
7600,3701967560,3627937312,1672638938,1672641695,2757
7880,3303705369,3778980116,1672659682,1672662622,2940
7752,3714474557,3791602225,1672568195,1672570039,1844
7561,3773205565,3487171044,1672562918,1672563048,130
7808,3736419952,3247815299,1672628381,1672628970,589
7540,3608633356,3826759140,1672652024,1672654788,2764
7943,3909331423,3757455053,1672681380,1672681811,431
7623,3519703355,3779629905,1672557041,1672558474,1433
7830,3608868877,3805519285,1672563326,1672564306,980
7868,3311090974,3816454165,1672544276,1672547488,3212
7823,3703441914,3516909237,1672628624,1672630452,1828
7608,3886298125,3338367113,1672607103,1672607894,791
7682,3930797455,3920801189,1672689226,1672690308,1082
7541,3710408395,3338703270,1672695155,1672698678,3523
7534,3512349371,3234362962,1672535694,1672538147,2453
7842,3755392666,3666507626,1672677118,1672677961,843
7613,3534729133,3628819436,1672539182,1672542280,3098
7682,3516011407,3772758337,1672583271,1672586860,3589
7644,3975287541,3837094550,1672615020,1672615844,824
7763,3432689543,3518014636,1672639408,1672642607,3199
7495,3510937904,3774366875,1672626490,1672627845,1355
7609,3517459919,3517077106,1672609965,1672610966,1001
7850,3433804879,3777623166,1672620105,1672622181,2076
7883,3351008918,3716537575,1672598635,1672599903,1268
7742,3559110998,3627937312,1672636512,1672639719,3207
7920,3755943611,3391915121,1672695756,1672696856,1100
7673,3817316561,3483164654,1672569148,1672570809,1661
7931,3685818092,3715339701,1672663912,1672664609,697
7851,3710408395,3314836094,1672565910,1672569336,3426
7958,3515860749,3822654369,1672573755,1672573870,115
7929,3236102733,3925620998,1672604855,1672606770,1915
7646,3791657947,3716900301,1672665752,1672667909,2157
7746,3972364603,3666553782,1672542671,1672545274,2603
7590,3666457294,3319752091,1672534582,1672537673,3091
7691,3515860749,3801089989,1672646573,1672649823,3250
7486,3515691540,3510126867,1672666296,1672669043,2747
7494,3417587765,3802367797,1672551934,1672555214,3280
7801,3715581279,3412825109,1672692724,1672693116,392
7531,3634995491,3517509185,1672569705,1672572489,2784
7547,3711380716,3313564074,1672628788,1672629234,446
7818,3244436890,3715189301,1672555333,1672555761,428
7951,3757447189,3804870229,1672651392,1672653375,1983
7774,3772642849,3738502357,1672657429,1672657800,371
7916,3331845324,3773465237,1672582956,1672583518,562
7528,3336742544,3815508790,1672686152,1672689505,3353
7788,3780813786,3293695955,1672621516,1672622737,1221
7785,3388637594,3701995648,1672667310,1672667707,397
7538,3777443199,3420432297,1672558625,1672558882,257
7768,3703735129,3534488837,1672569372,1672571606,2234
7884,3624761861,3772746272,1672535564,1672538101,2537
7928,3805347939,3520629279,1672666548,1672669068,2520
7612,3516016437,3515723720,1672540738,1672543300,2562
7911,3622054816,3755587522,1672580626,1672583760,3134
7602,3858918246,3760992710,1672536740,1672538078,1338
7655,3473765852,3756451663,1672562864,1672565343,2479
7588,3617055293,3909238838,1672576443,1672579378,2935
7898,3510703546,3917278625,1672551248,1672553838,2590
7852,3311274543,3487171044,1672665090,1672665918,828
7772,3935127663,3911245524,1672573637,1672575595,1958
7879,3701274634,3714821932,1672585335,1672585425,90
7908,3792288302,3365942576,1672549468,1672552526,3058
7604,3710112546,3731419510,1672631050,1672633102,2052
7582,3316222192,3909606423,1672610567,1672611716,1149
7783,3978115672,3610695419,1672537150,1672537386,236
7541,3433804879,3209027249,1672578702,1672579910,1208
7941,3399004969,3930791338,1672654382,1672656747,2365
7811,3834257412,3519654779,1672691649,1672694874,3225
7788,3760569731,3519803045,1672535602,1672536507,905
7626,3518496488,3757682496,1672693305,1672696147,2842
7706,3772714862,3416427576,1672677808,1672679922,2114
7863,3713808837,3520751702,1672576368,1672577484,1116
7982,3922337974,3511271692,1672677174,1672677644,470
7852,3903307060,3711973519,1672692648,1672694433,1785
7967,3774501422,3516909237,1672662978,1672665382,2404
7524,3316173088,3516629436,1672570655,1672573025,2370
7892,3634786711,3500894271,1672566764,1672569711,2947
7912,3930791338,3710098970,1672577969,1672580102,2133
7942,3505000737,3780503655,1672538530,1672541064,2534
7542,3774050956,3930791338,1672597315,1672599688,2373
7560,3760992710,3420700674,1672545865,1672545981,116
7955,3472130842,3776338577,1672703886,1672707389,3503
7752,3701691675,3387674757,1672601698,1672602651,953
7854,3505638204,3760992710,1672668250,1672671550,3300
7558,3515394721,3383922351,1672622812,1672624896,2084
7832,3500578848,3352603894,1672617323,1672617913,590
7803,3776800213,3778266283,1672572395,1672575567,3172
7951,3918056059,3427219654,1672639513,1672641081,1568
7490,3914290246,3711973519,1672554839,1672555280,441
7786,3792789881,3246596716,1672702318,1672704497,2179
7561,3505193212,3772758337,1672645695,1672646828,1133
7714,3682061100,3703871468,1672695370,1672697506,2136
7628,3925402713,3399433690,1672590489,1672593523,3034
7818,3533927138,3901877072,1672569888,1672570408,520
7687,3533095755,3519152550,1672619702,1672622418,2716
7953,3600647945,3285400528,1672552731,1672554086,1355
7565,3500658339,3248507722,1672632509,1672635045,2536
7871,3777623166,3757151210,1672679659,1672680042,383
7967,3505702787,3224716315,1672646746,1672649360,2614
7922,3608633356,3451432842,1672585425,1672585686,261
7492,3774580701,3772714862,1672584108,1672584379,271
7936,3756462516,3888559320,1672692157,1672693368,1211
7719,3249401741,3505912939,1672647577,1672648412,835
7590,3533626375,3505203158,1672574069,1672576220,2151
7941,3311324983,3773814927,1672653676,1672656488,2812
7517,3297463265,3505098372,1672655087,1672658379,3292
7916,3757562897,3287105466,1672648936,1672651297,2361
7935,3610348516,3516039895,1672608005,1672609577,1572
7626,3778980116,3511125626,1672580838,1672584279,3441
7519,3533280269,3714504419,1672565069,1672565299,230
7925,3311274543,3826759140,1672569202,1672571200,1998
7807,3505193212,3315583351,1672695589,1672699070,3481
7631,3559110998,3391261292,1672577725,1672579241,1516
7783,3778266283,3311871871,1672587114,1672590020,2906
7569,3801089989,3209551760,1672589597,1672592674,3077
7545,3701534009,3510244400,1672585549,1672588270,2721
7958,3514719601,3918674986,1672606974,1672610488,3514
7736,3534702203,3828365570,1672690008,1672693329,3321
7483,3247815299,3296471982,1672618730,1672619373,643
7522,3519152550,3512510536,1672560386,1672562091,1705
7963,3520165601,3518669703,1672624935,1672626259,1324
7517,3826759140,3399004969,1672633650,1672634404,754
7628,3774520233,3492478793,1672660887,1672661195,308
7484,3533137446,3533095755,1672594650,1672595089,439
7848,3716488385,3533653428,1672574842,1672576302,1460
7821,3247815299,3533193862,1672646642,1672650143,3501
7680,3773465237,3509933351,1672549503,1672551683,2180
7600,3518496488,3427283336,1672555723,1672555942,219
7644,3755042098,3453729665,1672663722,1672666715,2993
7654,3501759100,3311415018,1672615349,1672616780,1431
7495,3379589402,3703735129,1672593582,1672594554,972
7934,3909238838,3755798867,1672554321,1672557095,2774
7820,3520629279,3703661585,1672676791,1672678026,1235
7806,3311871871,3791901535,1672545324,1672547297,1973
7573,3397418363,3779629905,1672667772,1672669331,1559
7618,3935127663,3774466457,1672663820,1672664615,795
7625,3772309166,3418728074,1672599198,1672601568,2370
7508,3601879040,3613995936,1672557248,1672558541,1293
7769,3936227020,3484995752,1672557483,1672559966,2483
7763,3501486692,3737051610,1672604310,1672606329,2019
7918,3774066725,3332072298,1672702689,1672704101,1412
7729,3415443558,3510126867,1672577146,1672580451,3305
7921,3505859863,3247428249,1672664379,1672665324,945
7832,3426325549,3793627961,1672616442,1672619982,3540
7937,3401627165,3412980697,1672684356,1672684568,212
7835,3621810464,3713370078,1672674141,1672675611,1470
7746,3636867411,3714488548,1672548858,1672550418,1560
7688,3772053179,3853018906,1672537597,1672538992,1395
7803,3899266183,3409474775,1672557002,1672557104,102
7552,3756966035,3434642576,1672650350,1672653023,2673
7586,3733189298,3780294829,1672579644,1672580534,890
7969,3714474557,3826759140,1672538173,1672540216,2043
7516,3555214688,3500499542,1672688990,1672692162,3172
7879,3481647420,3770635361,1672571658,1672572094,436
7653,3519556068,3391261292,1672701243,1672703911,2668
7733,3777776687,3388637594,1672699383,1672701732,2349
7733,3607748895,3510937904,1672618020,1672618161,141
7573,3703735129,3793848402,1672665593,1672666465,872
7643,3774005526,3311761694,1672659231,1672662026,2795
7726,3534553510,3559110998,1672695634,1672696569,935
7595,3520030713,3701146057,1672640830,1672643966,3136
7731,3417970574,3516039895,1672554743,1672555461,718
7853,3277939457,3533280269,1672598240,1672599282,1042
7795,3828624701,3500658339,1672553778,1672556041,2263
7682,3477649378,3409474775,1672593865,1672594459,594
7668,3701184889,3312333615,1672642220,1672645054,2834
7851,3405494240,3606186086,1672542469,1672545790,3321
7640,3509453566,3913251733,1672532039,1672532861,822
7551,3777477395,3510594211,1672680586,1672683315,2729
7820,3918674986,3483949762,1672634129,1672635346,1217
7882,3756424865,3736419952,1672535322,1672536745,1423
7546,3518360734,3773664987,1672609838,1672611415,1577
7636,3710098970,3979339287,1672690054,1672692536,2482
7725,3666553782,3480687894,1672624853,1672626629,1776
7943,3756424865,3711198793,1672639179,1672641308,2129
7965,3505859863,3703223015,1672610516,1672612587,2071
7512,3621810464,3833889105,1672695824,1672698020,2196
7688,3480687894,3716835696,1672550941,1672551459,518
7950,3716900301,3500578848,1672615982,1672616450,468
7495,3515125508,3331845324,1672693038,1672693366,328
7832,3791115967,3793389510,1672588464,1672591717,3253
7700,3713644518,3857349323,1672668051,1672670496,2445
7614,3313564074,3244485293,1672580035,1672582597,2562
7594,3443698222,3519912874,1672657469,1672660013,2544
7653,3637008488,3935627557,1672682241,1672685235,2994
7930,3396086535,3882291183,1672689260,1672692600,3340
7936,3918056059,3509933351,1672675674,1672679235,3561
7601,3930791338,3427219654,1672685409,1672685810,401
7832,3313564074,3835382117,1672665905,1672666777,872
7905,3500729955,3505912939,1672563359,1672566336,2977
7854,3713349754,3793338102,1672645065,1672645790,725
7518,3420700674,3756451663,1672582505,1672584508,2003
7799,3899371911,3976633198,1672670716,1672673984,3268
7934,3287105466,3311627628,1672567146,1672567969,823
7574,3853018906,3826760240,1672556968,1672560119,3151
7876,3774268456,3277669002,1672578907,1672582330,3423
7737,3407954858,3346327502,1672536700,1672537056,356
7540,3311274543,3385763781,1672617227,1672619096,1869
7699,3234362962,3972364603,1672539237,1672540321,1084
7861,3901877072,3756027749,1672619384,1672622058,2674
7723,3738274418,3815508790,1672628416,1672629263,847
7864,3662180254,3898995675,1672623140,1672626450,3310
7545,3815508790,3365278081,1672614630,1672617970,3340
7730,3518163778,3397418363,1672543291,1672545292,2001
7585,3359239884,3774520233,1672606408,1672609960,3552
7787,3387966152,3829232696,1672647593,1672647700,107
7797,3244485293,3500729955,1672533280,1672533497,217
7722,3667680268,3604539807,1672629058,1672631364,2306
7700,3922275620,3287105466,1672648635,1672651406,2771
7588,3501955238,3500658339,1672664236,1672666346,2110
7538,3500229033,3755920131,1672697456,1672699670,2214
7920,3780503655,3489728806,1672605845,1672606612,767
7746,3513164386,3513164386,1672676365,1672679523,3158
7605,3793286136,3886298125,1672664159,1672665780,1621
7891,3777514571,3889232789,1672566902,1672568226,1324
7794,3337544549,3778980116,1672642475,1672644294,1819
7859,3779629905,3772337814,1672667117,1672668676,1559
7732,3772714862,3418728074,1672636102,1672637067,965
7937,3311718847,3533025282,1672540568,1672542082,1514
7677,3200198928,3628819436,1672629753,1672632035,2282
7574,3500066230,3777120536,1672583403,1672585671,2268
7886,3249247700,3227158514,1672546269,1672547282,1013
7729,3512567240,3365942576,1672559190,1672561978,2788
7771,3805347939,3792032359,1672681768,1672683761,1993
7729,3914259449,3774501422,1672576414,1672579323,2909
7763,3925620998,3284832486,1672597332,1672597417,85
7943,3606812411,3882997884,1672688239,1672690684,2445
7638,3311439795,3610695419,1672565827,1672569279,3452
7945,3701995648,3315583351,1672692798,1672693124,326
7696,3756021689,3311090974,1672628201,1672629003,802
7811,3701898991,3851190615,1672621289,1672623654,2365
7833,3511359172,3739106581,1672676298,1672678219,1921
7769,3513599775,3200198928,1672700287,1672701255,968
7768,3760893269,3737154119,1672556022,1672557423,1401
7623,3792253549,3780914982,1672606354,1672606544,190
7726,3779976989,3520183192,1672531241,1672533467,2226
7580,3533626375,3710569131,1672626841,1672629417,2576
7629,3487171044,3505098372,1672624476,1672627840,3364
7488,3383922351,3713208927,1672608534,1672609934,1400
7708,3505873261,3925620998,1672609633,1672609781,148
7501,3312829208,3888559320,1672645417,1672646303,886
7652,3248507722,3805292782,1672637208,1672640285,3077
7881,3372883226,3701898991,1672540263,1672541903,1640
7492,3311090974,3357483218,1672681905,1672683330,1425
7745,3313564074,3617055293,1672574828,1672575363,535
7621,3519803045,3244485293,1672685467,1672688142,2675
7680,3406784491,3611150562,1672683274,1672684154,880
7883,3915628728,3711571712,1672542632,1672545934,3302
7571,3513454145,3975287541,1672649981,1672652533,2552
7487,3711262377,3415546117,1672635841,1672638078,2237
7745,3397418363,3559110998,1672573063,1672574185,1122
7679,3365942576,3777717988,1672636902,1672636998,96
7550,3490191091,3500391167,1672688850,1672691056,2206
7904,3701111745,3820354437,1672695203,1672696330,1127
7661,3416241005,3451432842,1672703132,1672704822,1690
7717,3716746253,3777936328,1672680433,1672682872,2439
7629,3520756859,3939952128,1672684390,1672687519,3129
7951,3500391167,3501759100,1672610703,1672611870,1167
7799,3534553510,3716537575,1672660742,1672663670,2928
7953,3711308224,3701146057,1672701106,1672702576,1470
7695,3351008918,3682061100,1672647661,1672650379,2718
7496,3485008994,3533280269,1672558930,1672561804,2874
7757,3812176780,3903307060,1672643804,1672646192,2388
7815,3209551760,3336751428,1672532971,1672535031,2060
7958,3427283336,3505873261,1672565269,1672567886,2617
7749,3359239884,3511332835,1672546370,1672546631,261
7514,3920801189,3890149705,1672607882,1672608481,599
7680,3510771358,3793753089,1672616470,1672616767,297
7503,3772758337,3777806071,1672625533,1672626135,602
7692,3377766165,3611150562,1672562456,1672565575,3119
7724,3434642576,3711571712,1672600841,1672603680,2839
7767,3701184889,3773465237,1672659853,1672661294,1441
7850,3973560347,3701691675,1672569693,1672572170,2477
7695,3302626661,3511267139,1672653209,1672653539,330
7797,3201848640,3791957752,1672626498,1672628315,1817
7877,3346327502,3518408774,1672614979,1672615715,736
7646,3519563836,3910454786,1672678444,1672678542,98
7721,3534191820,3234362962,1672646473,1672648918,2445
7877,3430352815,3793848402,1672692492,1672695508,3016
7638,3222448362,3909606423,1672693733,1672695799,2066
7623,3757682496,3389115045,1672627574,1672630356,2782
7763,3778980116,3505702787,1672590392,1672593271,2879
7702,3605726278,3511841857,1672539633,1672539806,173
7897,3514987389,3500994774,1672676598,1672679093,2495
7775,3909331423,3501927421,1672693230,1672696219,2989
7981,3304625412,3805519285,1672624314,1672625952,1638
7889,3339907603,3313541986,1672587967,1672590516,2549
7516,3512217942,3660493209,1672647072,1672648341,1269
7967,3505219850,3518360734,1672581903,1672583833,1930
7920,3834257412,3615046771,1672700523,1672703663,3140
7607,3500803339,3783705817,1672608461,1672609029,568
7940,3509773875,3533827120,1672698508,1672701324,2816
7654,3883312122,3770101921,1672665468,1672668848,3380
7670,3825229501,3518163778,1672634814,1672636738,1924
7671,3783239924,3828432634,1672599727,1672601551,1824
7811,3774268456,3734496778,1672566416,1672568081,1665
7868,3716835696,3501486692,1672689010,1672689306,296
7771,3703889596,3512540951,1672586229,1672589651,3422
7506,3399433690,3778980116,1672571098,1672573306,2208
7779,3373384732,3481502100,1672699398,1672700724,1326
7934,3733891182,3713349754,1672547276,1672547745,469
7537,3334033993,3666506258,1672694550,1672695092,542
7696,3714197325,3497901842,1672642442,1672645375,2933
7935,3512683609,3511350608,1672553472,1672555692,2220
7643,3711370563,3209027249,1672559595,1672561800,2205
7981,3511687358,3209027249,1672556369,1672559118,2749
7686,3807987001,3732481297,1672599555,1672602274,2719
7978,3711265369,3791657947,1672607349,1672608492,1143
7950,3827626797,3792177074,1672557736,1672557919,183
7768,3505477652,3512837326,1672577180,1672579556,2376
7559,3755392666,3276640712,1672587089,1672589674,2585
7771,3451432842,3773598056,1672590396,1672591037,641
7745,3510969660,3421836608,1672689309,1672692437,3128
7862,3777443199,3307097200,1672643094,1672644258,1164
7756,3793871337,3518360734,1672652312,1672652378,66
7562,3372883226,3279721246,1672616282,1672619152,2870
7842,3512166013,3608868877,1672666887,1672670079,3192
7803,3614238812,3888559320,1672605714,1672609033,3319
7826,3901877072,3770763956,1672565408,1672566572,1164
7817,3825229501,3904775198,1672700510,1672701269,759
7793,3514987389,3737051610,1672651044,1672654438,3394
7950,3772758337,3378092448,1672634535,1672634712,177
7825,3352603894,3516223597,1672637496,1672641022,3526
7569,3206254161,3760569731,1672681559,1672684106,2547
7617,3791020967,3232962003,1672660602,1672661687,1085
7636,3453729665,3424922204,1672534489,1672536393,1904
7557,3427219654,3756451663,1672672304,1672672886,582
7790,3312664885,3791602225,1672534096,1672534840,744
7853,3512567240,3918247820,1672609309,1672610801,1492
7565,3501184421,3600647945,1672615367,1672616042,675
7882,3389115045,3367029997,1672655223,1672655516,293
7980,3777477395,3515860749,1672626020,1672627139,1119
7557,3383922351,3772642849,1672630757,1672633792,3035
7522,3713786889,3636867411,1672686685,1672688705,2020
7576,3733189298,3516465662,1672584713,1672586810,2097
7487,3760561634,3774005526,1672564182,1672565929,1747
7506,3280599164,3509672210,1672656263,1672657232,969
7833,3774119563,3514128943,1672593807,1672595354,1547
7792,3242408357,3370636709,1672654016,1672656189,2173
7651,3978105277,3918674986,1672538411,1672541307,2896
7506,3505883609,3779036831,1672695176,1672697163,1987
7754,3518496488,3534492426,1672628842,1672631870,3028
7971,3489545239,3514245078,1672643477,1672645595,2118
7631,3394330287,3793959750,1672566961,1672570253,3292
7511,3837094550,3780503655,1672560355,1672562373,2018
7695,3427219654,3516065852,1672614433,1672615720,1287
7808,3517721725,3735733948,1672682144,1672685188,3044
7609,3978105277,3489962019,1672616692,1672619811,3119
7672,3887270940,3555214688,1672536831,1672539383,2552
7531,3808324264,3791602225,1672658032,1672658957,925
7720,3396285984,3534488837,1672601253,1672603436,2183
7890,3515151980,3420700674,1672595729,1672597488,1759
7777,3890149705,3772544062,1672668399,1672670928,2529
7932,3412825109,3534424200,1672588547,1672592023,3476
7633,3510380060,3314245084,1672663310,1672664983,1673
7564,3701146057,3500805881,1672603345,1672605401,2056
7692,3201848640,3776800213,1672645296,1672647892,2596
7510,3634995491,3685187183,1672554627,1672554960,333
7636,3492478793,3792032359,1672563293,1672564229,936
7967,3517721725,3780813786,1672631440,1672632837,1397
7733,3500499542,3515151980,1672585837,1672589225,3388
7864,3668005723,3500658339,1672570050,1672571121,1071
7566,3289061738,3365942576,1672552740,1672556252,3512
7693,3533025282,3349613093,1672660572,1672663200,2628
7527,3883312122,3291227780,1672590537,1672593751,3214
7841,3666507626,3520751702,1672669203,1672670011,808
7510,3311993075,3520012395,1672648452,1672651506,3054
7593,3489217083,3922275416,1672700498,1672703681,3183
7876,3520719611,3711973519,1672534157,1672536497,2340
7916,3505869747,3510771358,1672612064,1672613783,1719
7822,3756451663,3246596716,1672689611,1672690532,921
7913,3516673015,3823600322,1672694174,1672697033,2859
7535,3280599164,3731419510,1672620823,1672621321,498
7499,3883861463,3336751428,1672624077,1672627181,3104
7763,3736592744,3284639858,1672652612,1672653908,1296
7855,3926700506,3511687358,1672596787,1672598088,1301
7740,3736786443,3932051427,1672656445,1672658954,2509
7914,3511267139,3777717988,1672656449,1672658003,1554
7584,3358871377,3760077057,1672684260,1672686762,2502
7579,3703735129,3701111745,1672671144,1672671319,175
7763,3520709480,3853018906,1672533253,1672533826,573
7491,3809059934,3713894336,1672610140,1672613716,3576
7649,3618045231,3713808837,1672643842,1672644349,507
7564,3773755137,3633420270,1672567469,1672570333,2864
7648,3519803045,3426325549,1672628277,1672631782,3505
7979,3351554343,3716843669,1672700068,1672701549,1481
7967,3345207877,3278365525,1672694939,1672697116,2177
7762,3406784491,3448855696,1672671656,1672671813,157
7626,3792844210,3388637594,1672605821,1672607432,1611
7907,3772746272,3388372715,1672630773,1672631130,357
7553,3473765852,3533653428,1672539402,1672541634,2232
7753,3852391257,3776948966,1672630750,1672632061,1311
7847,3475258557,3757447189,1672618309,1672621195,2886
7763,3533385867,3617734118,1672538500,1672539466,966
7593,3384240055,3783126683,1672655974,1672659215,3241
7821,3792253549,3533270638,1672602572,1672605905,3333
7891,3828365570,3385763781,1672563566,1672566635,3069
7863,3760569731,3715339701,1672600922,1672603494,2572
7698,3614238812,3770763956,1672671883,1672674995,3112
7508,3297463265,3770635361,1672552257,1672553681,1424
7760,3777477395,3420432297,1672650401,1672653627,3226
7727,3701898991,3342131135,1672637607,1672640563,2956
7938,3703223015,3792177074,1672583605,1672585115,1510
7824,3397418363,3774119563,1672588250,1672589024,774
7500,3770553384,3500066230,1672565566,1672568249,2683
7915,3716900301,3505883609,1672552183,1672554366,2183
7541,3520756859,3200198928,1672600543,1672601401,858
7652,3791874383,3770635361,1672654466,1672656205,1739
7915,3383922351,3520709480,1672628626,1672632177,3551
7595,3345207877,3395152943,1672700582,1672701318,736
7502,3513956646,3701863557,1672612034,1672614100,2066
7563,3899266183,3517077106,1672635170,1672637666,2496
7951,3918584946,3885897503,1672561633,1672562299,666
7743,3791020967,3291883916,1672676454,1672679650,3196
7745,3809916577,3221899927,1672586762,1672588883,2121
7506,3514283243,3512720680,1672645433,1672648402,2969
7799,3222521619,3880285638,1672671714,1672672251,537
7791,3757161914,3501759100,1672702380,1672704850,2470
7740,3685818092,3710098970,1672577503,1672579957,2454
7906,3520709480,3777120536,1672607952,1672611547,3595
7578,3500729955,3701111745,1672552145,1672553895,1750
7850,3426325549,3533827120,1672554711,1672557614,2903
7658,3505962865,3903009525,1672671030,1672671942,912
7528,3688683847,3428674539,1672533702,1672535497,1795
7882,3379256399,3901990690,1672588159,1672590743,2584
7670,3396086535,3779976989,1672631158,1672631958,800
7555,3600647945,3501483568,1672540156,1672540481,325
7911,3516606733,3625274012,1672606419,1672608943,2524
7650,3617734118,3512540951,1672557883,1672559938,2055
7530,3909606423,3311648200,1672572244,1672575677,3433
7764,3792902982,3756453423,1672577145,1672578961,1816
7769,3914290246,3500994774,1672652120,1672655260,3140
7915,3812176780,3513201436,1672643251,1672644455,1204
7774,3666507626,3399004969,1672559698,1672562764,3066
7734,3505000737,3792844210,1672681275,1672681541,266
7492,3291883916,3534729133,1672638399,1672639257,858
7543,3520165601,3518669703,1672700039,1672700889,850
7881,3811694763,3421127249,1672639764,1672640108,344
7495,3829319703,3311603601,1672563372,1672563583,211
7549,3311648200,3505193212,1672619164,1672622077,2913
7980,3755625324,3407673904,1672559770,1672561277,1507
7621,3500229033,3716258994,1672664436,1672664811,375
7597,3533270638,3475251781,1672569577,1672570003,426
7736,3703955926,3601879040,1672546733,1672548725,1992
7571,3518876135,3315583351,1672683273,1672685943,2670
7783,3774298222,3500894271,1672551511,1672552679,1168
7502,3505859863,3516258476,1672647731,1672648677,946
7924,3880310724,3802367797,1672585751,1672585852,101
7848,3466911760,3520709480,1672680335,1672682448,2113
7785,3703889596,3357483218,1672575954,1672576769,815
7678,3505638204,3793848402,1672544148,1672547296,3148
7582,3505883609,3511312803,1672615898,1672618344,2446
7711,3559110998,3626156564,1672619630,1672619793,163
7564,3351008918,3379589402,1672562646,1672566139,3493
7951,3249247700,3683959482,1672591177,1672593400,2223
7539,3384951177,3534553510,1672549168,1672552752,3584
7733,3793436995,3513201436,1672630764,1672633944,3180
7615,3512969370,3662180254,1672579439,1672580236,797
7737,3361230905,3273500349,1672700401,1672700673,272
7791,3511125626,3533095755,1672615736,1672616158,422
7855,3512683609,3917088658,1672634056,1672636413,2357
7689,3774298222,3475258557,1672604617,1672607205,2588
7607,3505362057,3412825109,1672654293,1672655743,1450
7649,3772578994,3737051610,1672679082,1672680560,1478
7579,3224058172,3979339287,1672601397,1672603611,2214
7859,3501198706,3930797455,1672626853,1672626929,76
7880,3500994774,3880310724,1672617650,1672620157,2507
7800,3519069599,3970117174,1672544437,1672547309,2872
7884,3501364586,3715339701,1672701328,1672703050,1722
7912,3519069599,3206593906,1672632884,1672634356,1472
7836,3772309150,3776800213,1672602614,1672605649,3035
7753,3922275416,3412825109,1672655843,1672658104,2261
7505,3500365158,3805347939,1672558223,1672558786,563
7790,3518408774,3473562469,1672581379,1672583729,2350
7596,3519428855,3629547065,1672696084,1672696324,240
7744,3351008918,3701691675,1672670546,1672670981,435
7928,3246596716,3715581279,1672558988,1672559665,677
7942,3618873142,3519563836,1672571079,1672574157,3078
7710,3839849341,3352603894,1672600789,1672604351,3562
7762,3734737881,3510173870,1672662803,1672664575,1772
7776,3446948848,3501759100,1672671678,1672672006,328
7941,3883042241,3478194807,1672597803,1672600990,3187
7920,3909606423,3714488548,1672613880,1672614182,302
7767,3733189298,3711265369,1672613352,1672614361,1009
7809,3774268456,3291227780,1672586438,1672587782,1344
7652,3685818092,3249791738,1672607384,1672609294,1910
7920,3517864478,3774793839,1672631931,1672633440,1509
7556,3777477395,3793848402,1672589876,1672590565,689
7654,3783196518,3791874383,1672648959,1672650848,1889
7538,3668005723,3227457126,1672599705,1672603244,3539
7940,3783429780,3229665776,1672594740,1672598225,3485
7728,3534729133,3244173074,1672589575,1672590193,618
7858,3792844210,3360993964,1672574060,1672577102,3042
7611,3793962300,3626156564,1672586733,1672587213,480
7859,3412825109,3757562897,1672590795,1672591699,904
7575,3701691675,3516223597,1672657046,1672659243,2197
7600,3792789881,3484995752,1672634394,1672634621,227
7596,3533810360,3755436115,1672576996,1672579039,2043
7717,3365614305,3883861463,1672540297,1672540808,511
7853,3280964728,3660493209,1672618307,1672619163,856
7784,3311439795,3365830990,1672595948,1672598382,2434
7916,3466911760,3711262377,1672636936,1672637484,548
7955,3852391257,3518014404,1672541604,1672544132,2528
7887,3356860407,3401627165,1672653719,1672653811,92
7982,3485008994,3887270940,1672695250,1672698293,3043
7857,3238712269,3629935998,1672589235,1672589949,714
7827,3276993580,3404058699,1672533342,1672533884,542
7593,3902278226,3918584946,1672584584,1672585137,553
7763,3515691540,3534553510,1672655442,1672656204,762
7760,3365278081,3666553782,1672703969,1672706142,2173
7686,3857349323,3519601612,1672633996,1672635388,1392
7509,3500803339,3500499542,1672541359,1672542578,1219
7585,3276640712,3249401741,1672641771,1672644311,2540
7652,3534191820,3232962003,1672655259,1672656705,1446
7708,3492478793,3412980697,1672621916,1672624280,2364
7730,3774045700,3617734118,1672609952,1672613300,3348
7961,3500805881,3713786889,1672652450,1672654475,2025
7645,3304625412,3516909237,1672574446,1672577802,3356
7543,3774125065,3918247820,1672609831,1672612814,2983
7493,3510594211,3505635228,1672655170,1672658598,3428
7602,3805347939,3278365525,1672681431,1672681680,249
7944,3783531004,3760267716,1672618343,1672618525,182
7830,3517255726,3513201436,1672622883,1672626421,3538
7888,3235287260,3710112546,1672621113,1672621587,474
7496,3520206212,3685187183,1672618837,1672619982,1145
7630,3778549126,3813052709,1672656685,1672659671,2986
7897,3284832486,3229058858,1672531737,1672532660,923
7596,3882242815,3514283243,1672643122,1672644523,1401
7880,3311324983,3716197887,1672588098,1672591156,3058
7600,3364543015,3331845324,1672682973,1672683268,295
7625,3600647945,3828432634,1672696159,1672696910,751
7877,3386707783,3247780536,1672641838,1672643436,1598
7961,3773950140,3778308417,1672632975,1672634424,1449
7806,3514283243,3516716179,1672695681,1672697160,1479
7668,3505530961,3606812411,1672667980,1672670420,2440
7687,3520730271,3780828689,1672696213,1672699184,2971
7799,3778108318,3882997884,1672640058,1672642486,2428
7584,3773664987,3683959482,1672700069,1672702277,2208
7748,3496269445,3512142794,1672680469,1672681481,1012
7644,3359239884,3783779671,1672602604,1672604493,1889
7793,3208844525,3509453566,1672554374,1672556122,1748
7803,3289061738,3820354437,1672671563,1672672997,1434
7716,3800886801,3365830990,1672620526,1672623148,2622
7645,3756930948,3811171116,1672630624,1672632481,1857
7902,3533193862,3280964728,1672666596,1672667035,439
7524,3311648200,3514128943,1672644864,1672647495,2631
7679,3716273414,3209383861,1672620146,1672623662,3516
7524,3816853177,3760992710,1672634995,1672637352,2357
7676,3511435497,3519556068,1672594247,1672596728,2481
7911,3780788622,3552314511,1672588736,1672588916,180
7722,3533095755,3757161914,1672602855,1672606402,3547
7551,3774066725,3809484172,1672591552,1672593906,2354
7606,3311439795,3473765852,1672608112,1672609636,1524
7843,3734737881,3494290908,1672645356,1672646183,827
7713,3209383861,3760893269,1672679951,1672681134,1183
7952,3200691026,3883042241,1672650727,1672653879,3152
7570,3757161914,3855937514,1672560856,1672562065,1209
7808,3534313900,3475258557,1672650226,1672650862,636
7681,3783196518,3716197887,1672627904,1672631407,3503
7733,3685818092,3515860749,1672692782,1672693594,812
7916,3208844525,3889750851,1672540367,1672540475,108
7626,3485823740,3518932404,1672659626,1672661654,2028
7664,3889232789,3359239884,1672643402,1672644764,1362
7782,3715492942,3922337974,1672551309,1672552314,1005
7575,3604539807,3296471982,1672617796,1672619252,1456
7811,3882291183,3370636709,1672602238,1672603115,877
7981,3517864478,3475251781,1672600193,1672602437,2244
7804,3402943525,3399535232,1672663019,1672665395,2376
7767,3855424474,3478194807,1672645436,1672648153,2717
7505,3517509185,3776800213,1672637369,1672637457,88
7633,3685818092,3291235378,1672687253,1672690013,2760
7604,3514245078,3477375368,1672666599,1672667700,1101
7559,3311761694,3411618230,1672637492,1672639891,2399
7795,3511198618,3235635976,1672609742,1672613049,3307
7660,3311761694,3783509527,1672577583,1672579887,2304
7523,3817316561,3756528686,1672636126,1672636614,488
7699,3716488385,3501730685,1672651965,1672654533,2568
7655,3519563836,3209027249,1672601025,1672604254,3229
7959,3448855696,3505638204,1672600054,1672600834,780
7870,3278365525,3825229501,1672553805,1672554825,1020
7490,3399433690,3774338212,1672641779,1672643018,1239
7583,3710112546,3793470489,1672697402,1672700707,3305
7621,3833889105,3757447189,1672577393,1672580718,3325
7665,3432689543,3885897503,1672579136,1672582698,3562
7784,3777717988,3511271692,1672572459,1672573076,617
7500,3388637594,3760294205,1672587608,1672588266,658
7875,3911245524,3668005723,1672592437,1672593654,1217
7662,3664517356,3511271692,1672642038,1672644297,2259
7720,3379256399,3917278625,1672632920,1672634335,1415
7885,3229665776,3505203158,1672664294,1672667294,3000
7578,3801089989,3713349754,1672677168,1672679722,2554
7780,3483164654,3713644518,1672539851,1672539928,77
7553,3518876135,3293695955,1672631586,1672633959,2373
7878,3418534998,3783083229,1672637401,1672638294,893
7883,3304056063,3311603601,1672585901,1672587214,1313
7784,3783083229,3496269445,1672620159,1672623460,3301
7761,3604539807,3533810360,1672576247,1672578708,2461
7844,3389115045,3311993075,1672591588,1672593646,2058
7487,3827377568,3714821932,1672680855,1672683478,2623
7654,3280964728,3510857360,1672565547,1672568449,2902
7784,3359239884,3901990690,1672580283,1672582121,1838
7909,3783531004,3715189301,1672678762,1672680514,1752
7551,3936227020,3311603601,1672531919,1672533377,1458
7615,3473765852,3791901535,1672586711,1672589140,2429
7739,3791901535,3359910781,1672537075,1672539837,2762
7581,3734496778,3711262377,1672628618,1672630752,2134
7764,3519601612,3513164386,1672671547,1672674408,2861
7709,3774005526,3715339701,1672692063,1672693616,1553
7947,3805292782,3418534998,1672591880,1672592983,1103
7961,3489545239,3397418363,1672542214,1672544108,1894
7850,3773429448,3336742544,1672600305,1672602099,1794
7496,3666553782,3776800213,1672533803,1672536838,3035
7975,3475795792,3518791447,1672559999,1672560089,90
7900,3778266283,3483949762,1672653727,1672654833,1106
7818,3851190615,3512142794,1672658659,1672659126,467
7646,3793470489,3379589402,1672556172,1672559569,3397
7895,3429856982,3430074045,1672588999,1672591701,2702
7645,3511198618,3703275621,1672679274,1672682190,2916
7614,3311993075,3791874383,1672676015,1672677615,1600
7911,3294803686,3703013906,1672592408,1672595269,2861
7901,3901990690,3774339795,1672695349,1672695974,625
7937,3937224533,3500391167,1672665875,1672667154,1279
7536,3756027749,3774010081,1672563232,1672565366,2134
7857,3903307060,3625274012,1672634222,1672636960,2738
7521,3756462516,3515394721,1672573463,1672576166,2703
7649,3915628728,3451432842,1672611383,1672613789,2406
7669,3757447189,3221899927,1672634615,1672638062,3447
7818,3716746253,3621810464,1672556401,1672557145,744
7751,3235635976,3500499542,1672567822,1672569112,1290
7652,3488244966,3773120434,1672683010,1672684845,1835
7780,3509933351,3757812939,1672539809,1672541932,2123
7636,3505135325,3604539807,1672578628,1672582180,3552
7509,3420432297,3703275621,1672542768,1672544797,2029
7652,3825229501,3806545488,1672603099,1672603313,214
7560,3421127249,3800353779,1672695442,1672697768,2326
7597,3756424865,3500805881,1672588178,1672591397,3219
7542,3312829208,3396086535,1672630142,1672631790,1648
7580,3421836608,3417061462,1672695640,1672696811,1171
7912,3501601840,3516606733,1672567948,1672569251,1303
7551,3314836094,3713208927,1672700739,1672704331,3592
7976,3399911573,3520756859,1672570101,1672572246,2145
7833,3505292701,3518260334,1672560060,1672561140,1080
7702,3703735129,3832902928,1672657037,1672660505,3468
7609,3430074045,3514719601,1672593092,1672594314,1222
7517,3918584946,3855424474,1672663515,1672663723,208
7788,3513164386,3361230905,1672697378,1672699104,1726
7500,3783126683,3244485293,1672654124,1672655815,1691
7778,3611150562,3373384732,1672688317,1672691624,3307
7505,3454042520,3555214688,1672635174,1672635969,795
7814,3791901535,3685818092,1672543632,1672545038,1406
7713,3307097200,3716537575,1672699923,1672700858,935
7723,3703275621,3297463265,1672630796,1672632747,1951
7865,3284639858,3517476351,1672568673,1672570217,1544
7556,3446948848,3505193212,1672651606,1672655067,3461
7545,3404384505,3505219850,1672605160,1672607602,2442
7843,3828624701,3412980697,1672663567,1672663961,394
7750,3534488837,3711973519,1672695384,1672697573,2189
7612,3914259449,3346327502,1672534958,1672537492,2534
7678,3804870229,3811171116,1672591416,1672591978,562
7877,3514128943,3774066725,1672670192,1672670760,568
7928,3851190615,3888559320,1672626065,1672628409,2344
7718,3412825109,3312664885,1672567919,1672570184,2265
7915,3533810360,3914259449,1672678545,1672679666,1121
7882,3772884106,3415546117,1672644614,1672648006,3392
7860,3792032359,3883085535,1672591432,1672594101,2669
7952,3703661585,3533137446,1672555819,1672556351,532
7504,3664170666,3783705817,1672557377,1672559500,2123
7717,3832902928,3808324264,1672647112,1672649680,2568
7597,3714474557,3380035798,1672680415,1672681000,585
7865,3805519285,3755739653,1672697719,1672699445,1726
7676,3514128943,3972709319,1672557424,1672559641,2217
7696,3668898102,3715998609,1672676250,1672676933,683
