cell_site,calling,called,startdate,enddate,duration
3622,3686523546,3713768950,1672636253,1672638066,1813
3691,3367509761,3240994288,1672589039,1672591473,2434
3579,3511317276,3625174002,1672608228,1672608728,500
3436,3501786419,3505266860,1672619329,1672620703,1374
3878,3480490124,3850911686,1672545788,1672547998,2210
3823,3245232284,3533929349,1672608157,1672611544,3387
3820,3285204083,3935399379,1672544448,1672546221,1773
3540,3311098437,3415833929,1672638058,1672639419,1361
3866,3408498208,3534566651,1672700702,1672700868,166
3832,3520322124,3801645328,1672611519,1672612930,1411
3517,3970603231,3613338363,1672651495,1672653384,1889
3506,3514419100,3803389195,1672611841,1672613261,1420
3643,3701107228,3835422146,1672641808,1672642296,488
3466,3398198430,3431502855,1672533016,1672533615,599
3800,3825881598,3467988782,1672555112,1672558246,3134
3809,3732131656,3792538417,1672655490,1672657722,2232
3506,3829864515,3974674109,1672604486,1672607091,2605
3797,3779425804,3513081354,1672606610,1672609038,2428
3748,3505402439,3497808662,1672587187,1672587423,236
3774,3627368399,3778597171,1672638858,1672642228,3370
3660,3227799827,3435116799,1672625522,1672625910,388
3461,3714678331,3780322355,1672569279,1672571070,1791
3718,3777694660,3201676087,1672551505,1672552458,953
3440,3554825448,3520560590,1672534616,1672535093,477
3565,3520873221,3778899160,1672579969,1672581363,1394
3712,3412968120,3615737355,1672571030,1672574555,3525
3897,3349856820,3288762795,1672607486,1672609956,2470
3819,3514308235,3512282789,1672673484,1672673806,322
3582,3500703304,3715545685,1672637509,1672639464,1955
3561,3713979100,3710008361,1672677675,1672678785,1110
3691,3516321888,3620292035,1672611980,1672615014,3034
3663,3505228454,3622357348,1672635746,1672637923,2177
3525,3517991730,3701136026,1672589373,1672592046,2673
3635,3244004456,3534764451,1672686568,1672688425,1857
3790,3661903000,3383138270,1672695867,1672698989,3122
3538,3500072204,3390660440,1672619452,1672620706,1254
3552,3618489670,3755848152,1672625675,1672628225,2550
3889,3935399379,3284947372,1672649408,1672652000,2592
3903,3225631197,3703798634,1672537885,1672540120,2235
3588,3713691388,3316800320,1672697783,1672698182,399
3481,3760640999,3834960360,1672613479,1672615462,1983
3502,3791128487,3853629553,1672531226,1672532018,792
3859,3925979970,3608232640,1672610364,1672612809,2445
3781,3410600350,3514275974,1672564248,1672566439,2191
3575,3509366311,3757294769,1672546212,1672547185,973
3602,3364378127,3777694660,1672577265,1672577548,283
3437,3447672935,3519077659,1672550584,1672552218,1634
3787,3225636215,3711097754,1672536389,1672539748,3359
3578,3780209375,3511732493,1672612127,1672615457,3330
3549,3760694096,3520639768,1672606624,1672610158,3534
3592,3783615982,3770704999,1672646566,1672646667,101
3846,3398198430,3497808662,1672605411,1672608340,2929
3461,3246370118,3513410578,1672646211,1672649180,2969
3715,3625174002,3516444201,1672699101,1672699472,371
3448,3774641380,3510818674,1672593308,1672593601,293
3917,3280268483,3372223551,1672604767,1672606889,2122
3817,3551389192,3225636215,1672651750,1672652208,458
3672,3520873221,3755230952,1672637084,1672639664,2580
3550,3734451191,3415833929,1672575999,1672579487,3488
3744,3926643445,3533188828,1672620142,1672620569,427
3516,3812369928,3311498666,1672612234,1672613807,1573
3837,3509756823,3300229945,1672594396,1672595131,735
3703,3714120857,3279475486,1672702218,1672705315,3097
3811,3811075491,3614740489,1672654704,1672655392,688
3448,3755915206,3288762795,1672553600,1672555184,1584
3472,3280054198,3713691388,1672553029,1672554474,1445
3748,3304155815,3515439826,1672539867,1672541112,1245
3861,3500347447,3500044458,1672550020,1672550716,696
3543,3500613493,3401496246,1672672459,1672673077,618
3690,3777330107,3372223551,1672677894,1672679857,1963
3910,3512379024,3733363628,1672638430,1672639319,889
3847,3760924079,3779854934,1672544763,1672546313,1550
3794,3887243870,3454277788,1672560105,1672561613,1508
3428,3739911441,3516703758,1672535076,1672536328,1252
3455,3520639768,3505179890,1672575453,1672576668,1215
3919,3892304880,3970558632,1672675120,1672677458,2338
3658,3703798634,3793583656,1672542535,1672544486,1951
3484,3823084403,3512502036,1672609955,1672611581,1626
3755,3927403123,3515525630,1672651523,1672652220,697
3751,3757332128,3334993594,1672553785,1672555649,1864
3449,3285204083,3792949946,1672549970,1672553092,3122
3590,3357864626,3299125059,1672676392,1672678220,1828
3564,3777147510,3638660068,1672660860,1672662333,1473
3627,3279473441,3513296868,1672624839,1672625555,716
3503,3824641227,3491684096,1672561712,1672562251,539
3470,3825881598,3384068080,1672623812,1672626946,3134
3622,3510919821,3512722110,1672577686,1672580402,2716
3898,3779738691,3780115155,1672695683,1672697793,2110
3653,3684523966,3755230952,1672697131,1672698404,1273
3531,3472068734,3715400486,1672600355,1672601539,1184
3871,3757193551,3776831527,1672639715,1672639844,129
3840,3714827719,3852533643,1672612520,1672615031,2511
3442,3783373154,3807212280,1672564718,1672567452,2734
3843,3834631333,3935487534,1672689125,1672692643,3518
3817,3791753345,3920625129,1672600511,1672600608,97
3725,3403370192,3285204083,1672533748,1672535502,1754
3502,3783169442,3533368789,1672657142,1672660569,3427
3472,3703433819,3760645796,1672554396,1672557741,3345
3879,3971806004,3756385685,1672603754,1672604533,779
3535,3337362061,3451726367,1672596115,1672599555,3440
3879,3509366311,3661903000,1672667575,1672669004,1429
3862,3270056120,3900276517,1672546238,1672547871,1633
3849,3774718695,3447672935,1672534220,1672534391,171
3696,3884596900,3776034743,1672560648,1672563303,2655
3668,3491469603,3791693821,1672541788,1672543032,1244
3885,3551389192,3770438122,1672535844,1672537893,2049
3583,3244004456,3519446663,1672648556,1672651388,2832
3850,3776559988,3970198861,1672647576,1672650593,3017
3871,3793935736,3780253901,1672643397,1672645265,1868
3693,3293835352,3703433819,1672681718,1672684808,3090
3439,3515890966,3613206049,1672654537,1672655406,869
3534,3513410578,3431460073,1672534519,1672535292,773
3645,3853629553,3970909253,1672592707,1672594068,1361
3853,3501567772,3773033649,1672590759,1672590877,118
3559,3774733620,3399518841,1672651616,1672653302,1686
3501,3500613459,3304155815,1672548186,1672549134,948
3607,3347446226,3500672156,1672598685,1672599941,1256
3526,3416987084,3414275042,1672606036,1672608819,2783
3522,3757193307,3777814504,1672586047,1672587493,1446
3497,3389634034,3408430195,1672586981,1672590202,3221
3504,3270042456,3462158237,1672617567,1672618521,954
3882,3559731671,3241790910,1672533544,1672534242,698
3745,3777037426,3272096759,1672546640,1672547220,580
3671,3885157459,3780834916,1672676087,1672679686,3599
3860,3770296583,3404025196,1672594359,1672594618,259
3809,3518561777,3481640525,1672664776,1672665249,473
3548,3357289672,3755848152,1672688387,1672690110,1723
3486,3500841914,3513295938,1672676004,1672678053,2049
3761,3714827719,3777330107,1672645157,1672647224,2067
3667,3500857494,3680810086,1672655854,1672657018,1164
3703,3239617320,3714670620,1672541536,1672542301,765
3866,3240994288,3305722859,1672662094,1672664831,2737
3721,3793883863,3853629553,1672680692,1672681543,851
3835,3783550022,3436257398,1672668343,1672670185,1842
3446,3230135532,3431502855,1672623041,1672626569,3528
3627,3491469603,3689114185,1672619784,1672621885,2101
3675,3311420950,3902861231,1672586179,1672589376,3197
3820,3613206049,3241790910,1672681247,1672682625,1378
3465,3246370118,3778640261,1672581074,1672584257,3183
3448,3384068080,3792949946,1672663110,1672663710,600
3785,3714670620,3556969573,1672555322,1672556047,725
3550,3370068529,3815250107,1672533105,1672535570,2465
3775,3829864515,3533004959,1672567781,1672569446,1665
3702,3855583256,3791796585,1672648682,1672650862,2180
3915,3777694660,3206837348,1672586435,1672589112,2677
3538,3779786641,3201676087,1672610307,1672611275,968
3817,3514512367,3777037426,1672694627,1672696385,1758
3879,3780909839,3715707380,1672557042,1672557701,659
3588,3520416075,3517881647,1672685438,1672686318,880
3784,3518194482,3280268483,1672699832,1672701971,2139
3921,3514703118,3777814504,1672631822,1672634127,2305
3553,3783136330,3600876425,1672582862,1672583505,643
3917,3791753345,3519909393,1672695893,1672698913,3020
3919,3791246640,3793883863,1672627275,1672629415,2140
3910,3463740710,3829864515,1672639120,1672639525,405
3620,3701664364,3793883863,1672558764,1672562115,3351
3782,3774031303,3814305099,1672562054,1672565024,2970
3680,3731646673,3518229776,1672563465,1672563598,133
3759,3783928182,3343132529,1672669826,1672671476,1650
3899,3515525630,3300818269,1672533133,1672535068,1935
3668,3274831810,3783147088,1672579068,1672582242,3174
3850,3510642075,3923220461,1672576269,1672576817,548
3598,3500777439,3730071479,1672657117,1672658688,1571
3449,3734915241,3791436104,1672695173,1672696592,1419
3719,3373089838,3688796737,1672536685,1672540116,3431
3531,3201629017,3431502855,1672662387,1672662828,441
3562,3792020993,3808136029,1672652249,1672652999,750
3641,3291933594,3635169815,1672638183,1672641168,2985
3571,3711218296,3760362417,1672693990,1672696040,2050
3854,3240994288,3367971170,1672678536,1672681490,2954
3598,3660063072,3711077927,1672657483,1672660851,3368
3661,3856606678,3512383699,1672587059,1672587459,400
3694,3792538417,3783340788,1672645929,1672647899,1970
3642,3447672935,3224811762,1672681048,1672682397,1349
3867,3481640525,3779656423,1672590009,1672591349,1340
3804,3701136026,3617116290,1672685140,1672687794,2654
3700,3514324011,3497808662,1672688266,1672689725,1459
3649,3400763927,3915162005,1672601029,1672601507,478
3572,3774718695,3899326793,1672597086,1672600680,3594
3553,3626499450,3756385685,1672554765,1672557919,3154
3786,3778640261,3459681410,1672628771,1672631448,2677
3694,3770676872,3372223551,1672692003,1672694402,2399
3622,3829822608,3773902805,1672541121,1672541303,182
3752,3505634634,3774907131,1672615798,1672617067,1269
3480,3701322924,3703798634,1672598196,1672598524,328
3800,3802932312,3334993594,1672663550,1672666922,3372
3465,3505283390,3398731252,1672543354,1672545322,1968
3536,3791246640,3509756823,1672592232,1672594225,1993
3654,3902625986,3630353876,1672650003,1672650726,723
3709,3783433404,3803517637,1672577531,1672581021,3490
3675,3935913584,3792274796,1672632448,1672633531,1083
3775,3713589994,3415833929,1672645248,1672645418,170
3801,3500044458,3450969839,1672681069,1672684004,2935
3660,3520416075,3604867757,1672643902,1672645010,1108
3680,3755158925,3510837901,1672675200,1672675653,453
3761,3416987084,3490029863,1672547782,1672548705,923
3893,3791128487,3853629553,1672610084,1672611514,1430
3662,3852533643,3770676872,1672623488,1672626953,3465
3457,3774641380,3710562338,1672699775,1672700710,935
3569,3517600136,3437286517,1672687676,1672689635,1959
3618,3974674109,3386758279,1672666147,1672667132,985
3693,3515890966,3685816610,1672555859,1672556565,706
3465,3500857494,3510642075,1672659798,1672660099,301
3755,3770676872,3311420950,1672603172,1672605391,2219
3832,3499217428,3534357694,1672556478,1672558643,2165
3919,3711812325,3855583256,1672651163,1672651628,465
3690,3514956366,3450969839,1672579694,1672582138,2444
3484,3972083617,3490214516,1672550883,1672551021,138
3702,3510818674,3512379024,1672593235,1672595262,2027
3783,3972192593,3408498208,1672683379,1672684999,1620
3521,3271454397,3770146716,1672694201,1672694743,542
3565,3500949309,3448633776,1672652698,1672654919,2221
3746,3554944414,3334951866,1672645787,1672646035,248
3594,3631090677,3370068529,1672602064,1672604417,2353
3715,3500857494,3513296868,1672651017,1672653987,2970
3434,3630353876,3246370118,1672537392,1672540261,2869
3890,3557046880,3770146716,1672609375,1672612185,2810
3755,3273981374,3337322736,1672639068,1672639826,758
3784,3438489358,3516489668,1672678536,1672679587,1051
3733,3739895284,3230135532,1672545375,1672548276,2901
3862,3755404116,3395201292,1672701764,1672703139,1375
3786,3493017654,3755158925,1672597704,1672600091,2387
3432,3291933594,3770296583,1672536897,1672540154,3257
3600,3520657891,3511288998,1672603821,1672604908,1087
3918,3897435944,3412006598,1672606694,1672609954,3260
3650,3279339278,3889780657,1672542491,1672543664,1173
3918,3780712350,3226511603,1672535259,1672537350,2091
3454,3777189898,3517222913,1672623042,1672623839,797
3604,3733558985,3777037426,1672547840,1672548138,298
3478,3373028638,3452016771,1672590236,1672591162,926
3845,3312998540,3701136026,1672651374,1672654124,2750
3563,3938389661,3272716462,1672646075,1672647941,1866
3469,3435167810,3511732493,1672620084,1672621220,1136
3691,3501121099,3414275042,1672692527,1672693564,1037
3576,3533079336,3793883863,1672541166,1672542434,1268
3523,3505847380,3516703758,1672601324,1672601430,106
3722,3511442562,3608232640,1672692851,1672693924,1073
3700,3713517039,3701322924,1672616302,1672619512,3210
3668,3792014516,3311498666,1672539710,1672542190,2480
3749,3905899155,3512502036,1672538182,1672539112,930
3735,3716963089,3714067076,1672575035,1672578215,3180
3849,3276217799,3300979975,1672532635,1672533003,368
3724,3710562338,3714233826,1672570543,1672570632,89
3885,3921648519,3834960360,1672683624,1672685933,2309
3855,3347419520,3511288998,1672551280,1672552191,911
3599,3336627643,3448633776,1672608167,1672611586,3419
3555,3791106564,3625463628,1672569587,1672570755,1168
3753,3459681410,3452016771,1672553102,1672556597,3495
3863,3818575661,3501457103,1672628052,1672628169,117
3531,3516298579,3684523966,1672550325,1672553257,2932
3527,3515401243,3792546035,1672618443,1672620071,1628
3773,3300818269,3608922867,1672542703,1672545749,3046
3734,3408498208,3757332128,1672550821,1672554292,3471
3571,3554944414,3554944414,1672649136,1672649226,90
3816,3276348699,3384068080,1672644253,1672645667,1414
3569,3451691949,3500737582,1672556486,1672556998,512
3536,3421877923,3639050419,1672627699,1672627985,286
3710,3520355798,3551399764,1672570022,1672572920,2898
3728,3970627281,3612689556,1672536478,1672538232,1754
3813,3899786664,3394401087,1672628876,1672629932,1056
3858,3710489491,3514285803,1672621777,1672624019,2242
3722,3505228454,3520181148,1672656763,1672657923,1160
3742,3334974375,3559731671,1672589551,1672592410,2859
3847,3710315160,3500737582,1672535968,1672538910,2942
3577,3625463628,3760362417,1672651214,1672652468,1254
3476,3272096759,3338083680,1672640525,1672640712,187
3465,3890739241,3689114185,1672547492,1672548027,535
3777,3488686442,3791436104,1672685284,1672687135,1851
3881,3793418209,3230868435,1672671466,1672672082,616
3514,3414275042,3793418209,1672608113,1672609571,1458
3841,3460719322,3511601997,1672702570,1672705110,2540
3463,3421877923,3900945856,1672572892,1672573060,168
3591,3811040565,3510642075,1672611882,1672612592,710
3549,3783136330,3557046880,1672582796,1672583390,594
3561,3200308999,3510767239,1672562481,1672564428,1947
3794,3505154885,3755065949,1672703397,1672704440,1043
3564,3783433404,3554944414,1672551436,1672553671,2235
3536,3779646172,3760651515,1672556349,1672557011,662
3547,3398198430,3773033649,1672581700,1672582717,1017
3525,3783136330,3505179890,1672616250,1672618908,2658
3555,3660063072,3773902805,1672636476,1672637443,967
3593,3839245934,3975717896,1672588900,1672589940,1040
3697,3462158237,3668414677,1672601150,1672601307,157
3895,3733363628,3757383891,1672579511,1672581591,2080
3873,3755992176,3715974659,1672556283,1672559450,3167
3538,3500857494,3892304880,1672601232,1672604339,3107
3884,3688220326,3511024016,1672551470,1672554110,2640
3434,3533228966,3512830734,1672565078,1672566024,946
3637,3688490530,3517172354,1672619424,1672621441,2017
3569,3534764451,3487875183,1672607383,1672609501,2118
3764,3715086894,3514956366,1672533515,1672535604,2089
3430,3927165965,3512392431,1672567261,1672570718,3457
3570,3208957949,3783520186,1672584980,1672586596,1616
3853,3285204083,3760040019,1672534655,1672535582,927
3575,3792389522,3500302272,1672641725,1672643908,2183
3837,3200543880,3783163143,1672678400,1672681754,3354
3647,3823084403,3779639983,1672615489,1672618516,3027
3647,3505521218,3288224595,1672615458,1672618595,3137
3642,3459681410,3756127300,1672593918,1672597217,3299
3685,3667427125,3736705719,1672671730,1672674047,2317
3683,3716963089,3605221116,1672597610,1672598854,1244
3849,3509764635,3311049964,1672700396,1672703187,2791
3618,3515439826,3776117322,1672607684,1672610999,3315
3549,3279339278,3520991398,1672687990,1672690079,2089
3721,3399472693,3612689556,1672643796,1672644749,953
3571,3931627862,3533929349,1672672110,1672673474,1364
3804,3366423342,3770704999,1672605554,1672606542,988
3729,3812534508,3737972328,1672611586,1672612444,858
3896,3793922324,3225636215,1672592211,1672593765,1554
3773,3394297564,3511150845,1672542777,1672544927,2150
3875,3343132529,3779613523,1672561399,1672563242,1843
3877,3299125059,3757863420,1672565841,1672567147,1306
3664,3209526819,3755233658,1672683015,1672683245,230
3883,3384068080,3831586487,1672654265,1672655087,822
3802,3289817992,3379143440,1672560194,1672560314,120
3694,3793175445,3701136026,1672572916,1672575847,2931
3570,3274831810,3501567772,1672700739,1672704098,3359
3771,3783928182,3512882178,1672549470,1672551517,2047
3623,3239617320,3500915908,1672620226,1672621802,1576
3649,3783340788,3793922324,1672662563,1672663847,1284
3765,3403370192,3920497528,1672592647,1672595844,3197
3835,3839245934,3739895284,1672576471,1672578796,2325
3919,3760263530,3226511603,1672697216,1672698249,1033
3649,3401793306,3446533960,1672560408,1672561331,923
3822,3491684096,3773913680,1672654677,1672654743,66
3476,3926643445,3512830734,1672675918,1672678998,3080
3787,3783771827,3510964997,1672689848,1672691613,1765
3726,3469254160,3710315160,1672571910,1672573689,1779
3849,3511791953,3977352557,1672685869,1672687497,1628
3756,3923420131,3607768197,1672606292,1672608193,1901
3801,3760040019,3792014516,1672579928,1672581296,1368
3731,3791753345,3390660440,1672668070,1672670963,2893
3695,3299781901,3500317969,1672645815,1672648546,2731
3610,3730071479,3513296868,1672695716,1672697608,1892
3737,3398198430,3760645796,1672677852,1672680518,2666
3437,3351866415,3456430614,1672605238,1672605823,585
3483,3338390596,3451691949,1672571663,1672572780,1117
3885,3680843171,3392520516,1672615165,1672618661,3496
3758,3505634634,3299781901,1672635728,1672638828,3100
3722,3791106564,3533747868,1672695037,1672695132,95
3568,3779738691,3835422146,1672676998,1672677527,529
3573,3935487534,3514334067,1672598341,1672600476,2135
3750,3505847380,3446533960,1672664858,1672666743,1885
3899,3452016771,3714120857,1672551618,1672555177,3559
3709,3756625818,3631479562,1672584335,1672586437,2102
3811,3774290799,3534543776,1672613148,1672614145,997
3445,3227799827,3792274796,1672611887,1672613708,1821
3839,3505888598,3826238375,1672557546,1672560379,2833
3508,3739911441,3367509761,1672673006,1672676381,3375
3747,3711006062,3755992176,1672638062,1672639700,1638
3522,3611055563,3500777439,1672639840,1672642083,2243
3579,3621461051,3533649454,1672598092,1672598794,702
3600,3669146016,3825881598,1672595211,1672598552,3341
3888,3701664364,3401793306,1672549795,1672551823,2028
3617,3401793306,3626499450,1672563667,1672564712,1045
3435,3520639768,3240394404,1672573818,1672575504,1686
3852,3512379024,3284947372,1672532067,1672533829,1762
3579,3778640261,3461119815,1672653865,1672655725,1860
3848,3609113156,3710008361,1672602505,1672604339,1834
3497,3757075324,3369708250,1672650938,1672653053,2115
3622,3512502036,3714120857,1672536329,1672538090,1761
3450,3902760230,3906536154,1672535315,1672536155,840
3794,3505847380,3357689359,1672568461,1672570518,2057
3451,3621184108,3885537225,1672599516,1672600359,843
3618,3248058676,3802932312,1672675083,1672675223,140
3882,3701107228,3408498208,1672551373,1672553444,2071
3574,3491469603,3418448389,1672578324,1672579648,1324
3544,3714678331,3703433819,1672652741,1672654341,1600
3675,3280054198,3360616538,1672588204,1672591381,3177
3806,3200308999,3293835352,1672691573,1672693830,2257
3501,3202804048,3230135532,1672622089,1672623981,1892
3497,3780209375,3667427125,1672567827,1672571068,3241
3866,3236499444,3500915908,1672582998,1672586024,3026
3662,3520322124,3925979970,1672620240,1672623067,2827
3786,3904569677,3711097754,1672655409,1672656395,986
3516,3284947372,3824215187,1672599984,1672601172,1188
3724,3793935736,3236354255,1672557561,1672558217,656
3492,3713784974,3791106564,1672659557,1672663149,3592
3471,3533188828,3450286949,1672599831,1672603058,3227
3581,3276217799,3480490124,1672699632,1672702177,2545
3852,3534126409,3904412440,1672650370,1672652109,1739
3640,3510028805,3713829743,1672683212,1672685072,1860
3634,3756746867,3230868435,1672562310,1672563040,730
3852,3970909253,3688490530,1672695369,1672697188,1819
3485,3661903000,3512958459,1672535557,1672538253,2696
3546,3711853996,3680810086,1672628564,1672630070,1506
3783,3773939399,3398731252,1672587246,1672588806,1560
3845,3472312341,3303410628,1672585109,1672587265,2156
3693,3554186380,3403370192,1672675619,1672676698,1079
3806,3389634034,3501281016,1672671873,1672672356,483
3581,3279242917,3383138270,1672676622,1672677576,954
3574,3519850727,3412006598,1672609930,1672612487,2557
3784,3449333754,3660887799,1672576764,1672577763,999
3829,3807212280,3792525861,1672568079,1672568227,148
3506,3410160376,3436025562,1672625661,1672628208,2547
3736,3774907131,3488763230,1672687389,1672690121,2732
3718,3231713082,3607882826,1672537454,1672540764,3310
3629,3737147209,3440107959,1672687155,1672688957,1802
3432,3271454397,3316800320,1672652751,1672653684,933
3827,3510767239,3343132529,1672691940,1672694934,2994
3541,3711097754,3294747828,1672627585,1672629880,2295
3813,3620292035,3511442562,1672690695,1672692184,1489
3900,3462636434,3689114185,1672629151,1672630601,1450
3459,3710315160,3382733096,1672577797,1672581123,3326
3757,3902861231,3518653080,1672560962,1672562814,1852
3511,3977148669,3897435944,1672638056,1672639855,1799
3695,3774243020,3701322924,1672660375,1672662025,1650
3688,3303410628,3404025196,1672659245,1672661897,2652
3572,3770520359,3755496114,1672599683,1672602854,3171
3625,3779438325,3272716462,1672600001,1672601744,1743
3714,3710735406,3618176292,1672543902,1672544853,951
3559,3899326793,3513041785,1672551553,1672551791,238
3901,3512830734,3853629553,1672584231,1672586651,2420
3673,3437286517,3446533960,1672645131,1672648594,3463
3621,3450286949,3885155975,1672639876,1672642396,2520
3441,3431460073,3733558985,1672630637,1672630917,280
3787,3533747868,3633735593,1672679332,1672679708,376
3886,3617304541,3401793306,1672650980,1672653162,2182
3497,3791693821,3472068734,1672593589,1672596149,2560
3571,3834963772,3283144118,1672653732,1672655454,1722
3752,3715974659,3236458894,1672694873,1672695518,645
3906,3554186380,3450286949,1672667152,1672669118,1966
3895,3778926763,3492546679,1672660248,1672662533,2285
3493,3760924079,3518561777,1672591762,1672593388,1626
3459,3304155815,3440107959,1672590573,1672591127,554
3704,3783136330,3902760230,1672595717,1672596664,947
3438,3713979100,3500672156,1672619596,1672619733,137
3471,3979802715,3770146716,1672702769,1672703936,1167
3715,3510818674,3311098437,1672649343,1672652695,3352
3870,3933894942,3428725843,1672697141,1672699021,1880
3627,3202141727,3246370118,1672694155,1672694613,458
3743,3715086894,3624297844,1672572630,1672573195,565
3570,3401793306,3280054198,1672623823,1672626880,3057
3764,3421385957,3685681577,1672627927,1672630524,2597
3451,3760651515,3777624586,1672617635,1672620052,2417
3882,3779938251,3505402439,1672660388,1672661978,1590
3560,3435167810,3505663516,1672572767,1672573543,776
3900,3456430614,3770468980,1672613846,1672616289,2443
3429,3472312341,3515401243,1672550006,1672552698,2692
3578,3774243020,3370227921,1672686054,1672688223,2169
3774,3627368399,3773121782,1672584573,1672587626,3053
3645,3774790271,3972083617,1672645206,1672646200,994
3599,3757863420,3757700712,1672602279,1672604514,2235
3610,3515466096,3470454332,1672555996,1672557300,1304
3890,3500709774,3897376951,1672566123,1672569293,3170
3763,3893912331,3480100311,1672612649,1672615361,2712
3549,3512282789,3552824113,1672581127,1672583965,2838
3830,3225029895,3780834916,1672561988,1672563076,1088
3576,3716272919,3396980894,1672532348,1672535878,3530
3430,3661447322,3519077659,1672617284,1672618571,1287
3580,3793868716,3889780657,1672630231,1672631143,912
3707,3773939399,3274831810,1672643064,1672644929,1865
3783,3829864515,3800257590,1672665147,1672667073,1926
3553,3773939399,3316798920,1672589141,1672590907,1766
3902,3299781901,3354144091,1672619691,1672620647,956
3747,3514971533,3512337405,1672668254,1672671016,2762
3628,3398198430,3791106564,1672668856,1672671807,2951
3616,3533747868,3777189898,1672585614,1672588362,2748
3531,3518561777,3385323994,1672549815,1672553371,3556
3853,3518653080,3490214516,1672696667,1672698909,2242
3440,3500442734,3770236215,1672614951,1672615029,78
3762,3488763230,3505283390,1672697465,1672699946,2481
3715,3288224595,3713768950,1672644508,1672647458,2950
3426,3859868849,3791613604,1672614132,1672616408,2276
3913,3701322924,3770704999,1672630330,1672631822,1492
3920,3852533643,3755573472,1672624370,1672625184,814
3855,3923420131,3793583656,1672606505,1672609552,3047
3469,3505847380,3492959689,1672593043,1672595046,2003
3545,3338083680,3715443333,1672543740,1672545053,1313
3751,3451691949,3509893027,1672632013,1672633087,1074
3635,3293835352,3760040019,1672657400,1672659156,1756
3432,3336627643,3791796585,1672672550,1672675350,2800
3777,3240394404,3970198861,1672659031,1672660377,1346
3529,3373028638,3399472693,1672626443,1672627277,834
3862,3492959689,3793743698,1672695243,1672697966,2723
3522,3409114719,3935487534,1672654884,1672656191,1307
3545,3505228454,3716110860,1672566743,1672568029,1286
3815,3304155815,3774178201,1672666229,1672668944,2715
3525,3757323954,3856606678,1672634056,1672636404,2348
3425,3440137407,3240994288,1672637693,1672640148,2455
3785,3685816610,3604589802,1672566523,1672566704,181
3689,3850911686,3773027597,1672674183,1672676958,2775
3812,3823084403,3500915665,1672576760,1672579639,2879
3474,3505663516,3505923418,1672609105,1672611100,1995
3664,3387594369,3519446663,1672535306,1672535980,674
3752,3938389661,3225631197,1672536524,1672538222,1698
3543,3316800320,3783771827,1672672472,1672673826,1354
3840,3930242012,3773939399,1672609851,1672610714,863
3689,3392943173,3703139663,1672683901,1672687249,3348
3822,3520873221,3893912331,1672681083,1672682405,1322
3910,3927403123,3519416013,1672665427,1672667036,1609
3853,3479851674,3501121099,1672662554,1672663872,1318
3572,3308760650,3513360004,1672685286,1672686068,782
3674,3363162590,3783641602,1672629662,1672632861,3199
3479,3800257590,3715400486,1672583985,1672584941,956
3706,3703433819,3814305099,1672619678,1672620219,541
3441,3231494505,3505437712,1672561728,1672563601,1873
3667,3760362417,3812534508,1672537895,1672540079,2184
3548,3272030610,3772078494,1672573387,1672573891,504
3585,3783520186,3770676872,1672569742,1672572909,3167
3615,3701664364,3779639983,1672581509,1672584565,3056
3740,3201676087,3276003502,1672608374,1672608707,333
3548,3904412440,3632814465,1672630784,1672631034,250
3643,3914691363,3927599181,1672656991,1672657664,673
3439,3793407963,3338083680,1672666619,1672669626,3007
3812,3492959689,3774705415,1672553853,1672556027,2174
3487,3852533643,3617489344,1672696319,1672697759,1440
3867,3734915241,3639050419,1672633391,1672635690,2299
3803,3893912331,3392520516,1672592912,1672595831,2919
3470,3739154408,3519077659,1672641666,1672644600,2934
3574,3475349791,3774876004,1672633570,1672636782,3212
3492,3519651506,3716628503,1672637354,1672637766,412
3441,3505923418,3480100311,1672599934,1672600743,809
3683,3613416045,3289817992,1672589275,1672590917,1642
3432,3774031303,3501786419,1672645202,1672646870,1668
3531,3780872464,3480726047,1672604006,1672606240,2234
3842,3817813340,3349856820,1672549085,1672551854,2769
3841,3376467719,3783928182,1672701535,1672704295,2760
3746,3316800320,3519446663,1672590513,1672591833,1320
3582,3519028898,3492959689,1672578331,1672581919,3588
3813,3682133690,3793935736,1672549648,1672549861,213
3703,3551399764,3609659642,1672669905,1672673313,3408
3902,3611055563,3779656423,1672701216,1672704524,3308
3683,3714827719,3812534508,1672647220,1672648130,910
3616,3885155975,3906536154,1672585915,1672588613,2698
3500,3760721303,3513410578,1672582401,1672585448,3047
3672,3240394404,3711734586,1672701083,1672702991,1908
3824,3713517039,3757863420,1672533267,1672536491,3224
3548,3303410628,3770438122,1672655683,1672656065,382
3667,3716963089,3452016771,1672556608,1672558529,1921
3631,3783373154,3760694096,1672652964,1672653043,79
3426,3714067076,3897456874,1672671730,1672673717,1987
3811,3608922867,3773332082,1672607944,1672610108,2164
3597,3755065949,3783163143,1672541723,1672543098,1375
3909,3386758279,3293835352,1672654782,1672655700,918
3549,3517222913,3773027597,1672626385,1672629643,3258
3738,3909094917,3497671225,1672588017,1672591261,3244
3913,3928511283,3760694096,1672700781,1672702721,1940
3769,3793883863,3859868849,1672592501,1672592973,472
3445,3510818674,3411688875,1672702575,1672704173,1598
3437,3760364383,3619922891,1672613109,1672613208,99
3700,3685816610,3607768197,1672695626,1672696788,1162
3714,3905899155,3631479562,1672580500,1672581916,1416
3476,3300229945,3734915241,1672601924,1672603416,1492
3840,3357289672,3409114719,1672683733,1672684839,1106
3617,3772078494,3713163045,1672609534,1672609717,183
3786,3899326793,3203538212,1672594728,1672598247,3519
3606,3376467719,3930242012,1672564817,1672566609,1792
3669,3711218296,3518653080,1672554940,1672558264,3324
3852,3520873221,3779613523,1672531901,1672533965,2064
3836,3206837348,3757700712,1672549046,1672549138,92
3699,3703433819,3760362417,1672679293,1672680997,1704
3635,3232208416,3360616538,1672570016,1672573513,3497
3845,3534764451,3818575661,1672603262,1672603750,488
3884,3897435944,3513410578,1672662195,1672663935,1740
3568,3780909839,3608922867,1672679483,1672681153,1670
3527,3514703118,3225029895,1672538877,1672542297,3420
3827,3612689556,3793583656,1672590033,1672591795,1762
3845,3713829743,3436025562,1672667319,1672667940,621
3544,3469254160,3495911207,1672646845,1672650091,3246
3551,3817813340,3376467719,1672690554,1672693902,3348
3573,3414049538,3909094917,1672563282,1672565038,1756
3436,3505283390,3977148669,1672640823,1672641196,373
3902,3519028898,3609113156,1672584006,1672587364,3358
3885,3825881598,3520322124,1672555500,1672557405,1905
3431,3622665543,3227799827,1672574725,1672577808,3083
3602,3736231757,3780769110,1672542195,1672545052,2857
3773,3738026330,3904867554,1672656548,1672656982,434
3687,3404025196,3519446663,1672532190,1672534794,2604
3637,3783373154,3897134762,1672567234,1672568342,1108
3584,3408430195,3517697722,1672582097,1672584942,2845
3868,3609881958,3757383891,1672588097,1672590029,1932
3800,3736231757,3500109249,1672625416,1672626771,1355
3675,3613899351,3715619259,1672666761,1672667861,1100
3715,3760263530,3289114629,1672691704,1672692668,964
3838,3372223551,3505266860,1672593984,1672596841,2857
3631,3488763230,3779738691,1672687091,1672690421,3330
3752,3410600350,3505154885,1672656749,1672659125,2376
3568,3272030610,3685816610,1672655725,1672657215,1490
3571,3923754072,3739661856,1672684274,1672687512,3238
3494,3935913584,3760694096,1672573220,1672573986,766
3873,3791436104,3347446226,1672693531,1672695715,2184
3481,3909094917,3713561276,1672566280,1672566673,393
3567,3921648519,3501525100,1672634215,1672637261,3046
3587,3756474459,3552824113,1672541649,1672544995,3346
3719,3979802715,3885155975,1672694751,1672697958,3207
3716,3462158237,3824641227,1672683739,1672686650,2911
3698,3739911441,3516321888,1672566161,1672569658,3497
3465,3970627281,3710735406,1672544306,1672546655,2349
3598,3227799827,3773009828,1672606598,1672609606,3008
3557,3517288083,3208957949,1672576323,1672577083,760
3527,3774290799,3510964997,1672665138,1672667507,2369
3682,3773124276,3500317969,1672663552,1672665844,2292
3573,3715086894,3554186380,1672695753,1672697488,1735
3803,3780834916,3938389661,1672637021,1672639330,2309
3711,3379143440,3520560590,1672600839,1672601121,282
3885,3760924079,3383138270,1672547463,1672548295,832
3521,3836241528,3850911686,1672601534,1672601651,117
3645,3716110860,3533274994,1672636247,1672637206,959
3478,3780209375,3533079336,1672607761,1672608445,684
3425,3517222913,3514308235,1672679678,1672681027,1349
3559,3225636215,3664943873,1672666952,1672670463,3511
3868,3774178201,3777147510,1672665488,1672667423,1935
3506,3551389192,3505847380,1672663487,1672667002,3515
3589,3701664364,3369708250,1672703479,1672704821,1342
3698,3449639012,3534566651,1672695428,1672695723,295
3604,3773735484,3756625818,1672613697,1672614719,1022
3840,3701664364,3660887799,1672630593,1672633777,3184
3560,3500208903,3509756823,1672643565,1672646748,3183
3738,3533004959,3241790910,1672549462,1672552244,2782
3915,3757332128,3783433404,1672629529,1672632856,3327
3886,3500341755,3505283390,1672533435,1672533573,138
3699,3773837847,3384068080,1672643414,1672645555,2141
3884,3710735406,3928511283,1672686369,1672688462,2093
3628,3238288884,3811075491,1672568930,1672569631,701
3571,3380130228,3330340793,1672606186,1672608748,2562
3797,3396726504,3240994288,1672575851,1672579116,3265
3459,3516489668,3777091903,1672640073,1672642474,2401
3778,3609881958,3825881598,1672624307,1672627552,3245
3893,3632814465,3500498112,1672673462,1672675273,1811
3620,3703433819,3246370118,1672557046,1672560173,3127
3552,3780769110,3511843593,1672626011,1672628761,2750
3918,3209526819,3308760650,1672590157,1672590408,251
3799,3401496246,3716272919,1672614709,1672617750,3041
3758,3633735593,3774733620,1672627881,1672629943,2062
3680,3372223551,3401940259,1672609029,1672609160,131
3732,3232208416,3519416013,1672656943,1672659312,2369
3781,3632814465,3793868716,1672560216,1672562307,2091
3610,3972192593,3414049538,1672569960,1672570265,305
3727,3779656423,3299781901,1672575413,1672577490,2077
3757,3245232284,3711077927,1672603021,1672605447,2426
3485,3792505974,3401793306,1672613784,1672616779,2995
3678,3514741348,3803389195,1672603803,1672605330,1527
3824,3501121099,3755915206,1672545212,1672546780,1568
3851,3613338363,3791046864,1672675214,1672675682,468
3896,3733558985,3792525861,1672609580,1672612743,3163
3737,3513041785,3288224595,1672561976,1672564252,2276
3529,3779438325,3970198861,1672595487,1672597387,1900
3568,3511791953,3710735406,1672681526,1672683914,2388
3798,3519077659,3778134418,1672693072,1672694059,987
3653,3920898925,3309314379,1672615108,1672615811,703
3707,3772765746,3928511283,1672565917,1672568094,2177
3464,3800257590,3970198861,1672549195,1672549823,628
3841,3316800320,3701373490,1672698573,1672699973,1400
3908,3780115155,3711000597,1672606084,1672608328,2244
3688,3710048469,3778040015,1672643666,1672646698,3032
3793,3505434346,3710496785,1672541233,1672543969,2736
3461,3395201292,3792014516,1672676880,1672679660,2780
3604,3384068080,3714067076,1672572062,1672574625,2563
3808,3510554314,3514308235,1672640831,1672644017,3186
3640,3777147510,3501525100,1672690566,1672693588,3022
3870,3399472693,3510187271,1672551472,1672552370,898
3547,3710496785,3276003502,1672671693,1672672971,1278
3877,3396726504,3512379024,1672631012,1672632277,1265
3490,3920898925,3811075491,1672607750,1672610678,2928
3576,3360069849,3770468980,1672685192,1672687204,2012
3480,3449333754,3710735406,1672610333,1672613552,3219
3504,3773902805,3716272919,1672698253,1672700673,2420
3918,3757332128,3519818818,1672643785,1672646162,2377
3589,3315279093,3556969573,1672547956,1672550657,2701
3443,3298151889,3935913584,1672677168,1672680174,3006
3562,3773332082,3755915206,1672637929,1672640350,2421
3580,3509366311,3517590837,1672546397,1672548270,1873
3854,3776559988,3459681410,1672648834,1672651399,2565
3561,3519909393,3276003502,1672697956,1672701496,3540
3471,3613581796,3791128487,1672569707,1672571486,1779
3833,3500737582,3516489668,1672565731,1672569269,3538
3495,3715707380,3831586487,1672681720,1672682044,324
3621,3760040019,3714233826,1672569440,1672572423,2983
3817,3513041785,3228888030,1672632362,1672634142,1780
3811,3315279093,3384068080,1672562618,1672563423,805
3763,3710315160,3777240360,1672682877,1672686449,3572
3434,3517697722,3714666884,1672698380,1672701313,2933
3504,3710496785,3516903528,1672612990,1672614963,1973
3794,3478114114,3683113954,1672634768,1672636090,1322
3693,3783520186,3513345163,1672672101,1672674818,2717
3651,3451691949,3772236797,1672698603,1672701400,2797
3801,3500604680,3757332128,1672600127,1672603615,3488
3807,3533188828,3505923418,1672598384,1672601738,3354
3538,3783136330,3436025562,1672582615,1672585295,2680
3660,3447514821,3224968597,1672555135,1672557964,2829
3922,3511843593,3774790271,1672681194,1672683387,2193
3737,3519850727,3665998641,1672535004,1672537196,2192
3650,3276217799,3488686442,1672643517,1672644664,1147
3854,3511843593,3505807416,1672597793,1672601140,3347
3744,3500703304,3760040019,1672539592,1672542280,2688
3508,3613206049,3701424609,1672670122,1672672904,2782
3904,3756704774,3284932450,1672671027,1672673890,2863
3439,3891672228,3979802715,1672565938,1672567449,1511
3885,3661447322,3492959689,1672701303,1672703094,1791
3466,3713768950,3756385685,1672687473,1672688293,820
3657,3793407963,3336339664,1672658304,1672659128,824
3680,3760694096,3778926763,1672666827,1672668403,1576
3573,3510837901,3803517637,1672650937,1672653943,3006
3473,3925979970,3928719932,1672615010,1672617931,2921
3511,3667673649,3514308235,1672672403,1672673395,992
3651,3393063657,3311085279,1672572234,1672575721,3487
3438,3792801638,3701322924,1672598970,1672600705,1735
3506,3755737419,3716272919,1672572996,1672574261,1265
3615,3520657891,3615688740,1672610102,1672611945,1843
3456,3793583656,3716272919,1672570963,1672572832,1869
3512,3932478321,3710008361,1672632287,1672635076,2789
3872,3451691949,3510818674,1672636848,1672639624,2776
3701,3292147449,3276348699,1672669929,1672671221,1292
3687,3337322736,3288762795,1672626866,1672627849,983
3753,3803389195,3274906650,1672632203,1672632745,542
3742,3456430614,3512946768,1672664102,1672666321,2219
3899,3714128600,3777037426,1672662814,1672662956,142
3470,3500208903,3513295938,1672564581,1672567157,2576
3465,3513041785,3933894942,1672622950,1672623472,522
3579,3739661856,3859868849,1672546653,1672548794,2141
3591,3686227677,3300511067,1672555982,1672557121,1139
3470,3831586487,3220031931,1672546984,1672549818,2834
3617,3689114185,3500613493,1672609178,1672609943,765
3848,3534764451,3714185969,1672562965,1672564416,1451
3626,3505434346,3760694096,1672639990,1672643017,3027
3561,3815250107,3505923418,1672545514,1672545951,437
3693,3396726504,3312998540,1672590280,1672593532,3252
3436,3300979975,3777779869,1672595389,1672596464,1075
3821,3515559913,3414275042,1672650664,1672652040,1376
3850,3490029863,3638660068,1672675448,1672677537,2089
3463,3614740489,3300818269,1672680778,1672681481,703
3487,3431502855,3200543880,1672648314,1672650753,2439
3911,3533649454,3714827719,1672645418,1672645999,581
3705,3715974659,3500827202,1672608163,1672611659,3496
3822,3500709774,3371455553,1672662764,1672666292,3528
3858,3520560590,3402697190,1672656055,1672659582,3527
3435,3791796585,3777814504,1672610642,1672613797,3155
3833,3511843593,3360813161,1672552274,1672555345,3071
3728,3371455553,3428027649,1672676192,1672677661,1469
3821,3479851674,3347446226,1672550628,1672552827,2199
3424,3685681577,3459681410,1672607724,1672611053,3329
3870,3231494505,3224330592,1672614775,1672617313,2538
3840,3770624662,3755233658,1672641222,1672643201,1979
3628,3505807416,3927403123,1672602874,1672605979,3105
3741,3755915206,3517358573,1672594389,1672595625,1236
3683,3437286517,3513327337,1672613177,1672613594,417
3469,3330340793,3715619259,1672624822,1672627453,2631
3535,3734451191,3225636215,1672545373,1672547369,1996
3709,3617304541,3488686442,1672578987,1672580336,1349
3648,3516513251,3773027597,1672651637,1672651843,206
3546,3284932450,3510798825,1672684883,1672687906,3023
3600,3773033649,3511601997,1672560981,1672562124,1143
3624,3780769110,3520416075,1672616416,1672619440,3024
3899,3516741440,3299125059,1672682101,1672683444,1343
3729,3439673892,3716628503,1672578045,1672578988,943
3688,3739661856,3713561276,1672647655,1672650453,2798
3510,3711919537,3716110860,1672539787,1672541858,2071
3482,3713561276,3757193551,1672537453,1672540586,3133
3867,3230868435,3713829743,1672588948,1672590668,1720
3708,3773332082,3409114719,1672615969,1672619200,3231
3531,3200543880,3387594369,1672679799,1672680290,491
3881,3556969573,3701882224,1672674533,1672676937,2404
3913,3923754072,3513360004,1672649215,1672650394,1179
3754,3770146716,3435116799,1672552267,1672554408,2141
3590,3519818818,3392836218,1672685997,1672686869,872
3872,3779438325,3231494505,1672649007,1672650270,1263
3797,3241790910,3611055563,1672617471,1672618301,830
3458,3276003502,3511024016,1672558055,1672560496,2441
3462,3225029895,3520416075,1672697430,1672697733,303
3858,3684523966,3793969543,1672668693,1672671125,2432
3678,3815392801,3505198734,1672586345,1672588878,2533
3813,3739911441,3380767040,1672630988,1672633198,2210
3586,3773913680,3408430195,1672630193,1672632651,2458
3469,3793883863,3714120857,1672645888,1672648140,2252
3428,3501567772,3517358573,1672654387,1672654544,157
3605,3926643445,3480100311,1672557956,1672560423,2467
3766,3923420131,3316798920,1672561093,1672564527,3434
3870,3354144091,3514246749,1672690302,1672691724,1422
3841,3713979100,3520639768,1672607466,1672608191,725
3600,3505634634,3501215099,1672577674,1672578122,448
3818,3793935736,3501384020,1672686646,1672690033,3387
3892,3436257398,3481640525,1672637999,1672638401,402
3789,3777091903,3620292035,1672590298,1672593004,2706
3697,3515466096,3520355798,1672636091,1672639411,3320
3714,3714128600,3512502036,1672625329,1672628854,3525
3811,3756789525,3622665543,1672701360,1672704116,2756
3873,3500613493,3410160376,1672579982,1672583162,3180
3597,3760364383,3829864515,1672629942,1672630907,965
3812,3224968597,3485540729,1672660546,1672660985,439
3497,3898314440,3513018485,1672623817,1672627162,3345
3559,3557046880,3518194482,1672694382,1672695680,1298
3473,3777240360,3605221116,1672590514,1672591320,806
3516,3366423342,3554944414,1672665915,1672667170,1255
3752,3792489602,3349856820,1672700387,1672702973,2586
3823,3513065217,3783340788,1672554985,1672556396,1411
3659,3410538749,3534764451,1672564329,1672565857,1528
3618,3518561777,3774243020,1672542415,1672545262,2847
3603,3710315160,3514275974,1672686206,1672686563,357
3785,3451726367,3791693821,1672584136,1672584549,413
3483,3289114629,3205923620,1672649031,1672649361,330
3871,3850911686,3519909393,1672569708,1672571871,2163
3594,3205923620,3737147209,1672663190,1672663377,187
3865,3551376095,3701322924,1672585020,1672587642,2622
3765,3351696332,3773939399,1672653830,1672655659,1829
3568,3533423872,3276348699,1672591664,1672593942,2278
3709,3336627643,3491684096,1672624267,1672624705,438
3751,3685681577,3455018347,1672560592,1672561570,978
3768,3335694356,3737147209,1672682819,1672683071,252
3668,3737112297,3513081354,1672599493,1672602496,3003
3429,3808136029,3517590837,1672540631,1672542908,2277
3838,3773033649,3833217041,1672548942,1672549644,702
3568,3791753345,3774790271,1672637916,1672638857,941
3638,3778597171,3519909393,1672557387,1672558007,620
3909,3783520186,3224811762,1672663664,1672666545,2881
3450,3661583097,3511791953,1672564732,1672567970,3238
3585,3701107228,3511601997,1672605748,1672606766,1018
3857,3631479562,3392836218,1672639796,1672642969,3173
3461,3280268483,3431502855,1672543142,1672544839,1697
3479,3630353876,3390660440,1672686483,1672686991,508
3734,3276348699,3360069849,1672541605,1672541832,227
3749,3205923620,3480100311,1672585687,1672589278,3591
3467,3713691388,3519077659,1672593233,1672595078,1845
3601,3734118023,3779656423,1672608648,1672610309,1661
3872,3607768197,3834963772,1672574136,1672575477,1341
3786,3534179433,3371455553,1672699563,1672700012,449
3874,3631479562,3793418209,1672544113,1672544703,590
3742,3303410628,3755158925,1672676845,1672676999,154
3764,3412006598,3773033649,1672576862,1672580329,3467
3710,3630353876,3668533536,1672605298,1672606990,1692
3574,3520560590,3202141727,1672701902,1672704183,2281
3678,3511732493,3689114185,1672670099,1672670973,874
3859,3296462324,3392836218,1672659038,1672660057,1019
3531,3783147088,3772391882,1672582711,1672583868,1157
3868,3773837847,3817813340,1672572315,1672574116,1801
3450,3921648519,3500915908,1672573994,1672576826,2832
3907,3505521218,3615087943,1672587824,1672589303,1479
3913,3497671225,3402697190,1672543919,1672546231,2312
3766,3472068734,3760924079,1672682219,1672685547,3328
3770,3638660068,3475349791,1672556183,1672558788,2605
3911,3296462324,3519416013,1672626179,1672629277,3098
3577,3615087943,3733363628,1672697310,1672700133,2823
3632,3716679950,3520991398,1672600497,1672603041,2544
3734,3410160376,3928719932,1672609065,1672611765,2700
3748,3777189898,3501567772,1672542256,1672544164,1908
3644,3493017654,3780253901,1672624973,1672626441,1468
3533,3315279093,3493017654,1672648418,1672648558,140
3556,3835422146,3823084403,1672559794,1672559910,116
3526,3770468980,3245232284,1672576458,1672576729,271
3835,3667427125,3631479562,1672651429,1672652303,874
3717,3970603231,3509893027,1672608151,1672611553,3402
3825,3897134762,3626499450,1672538427,1672540520,2093
3544,3923754072,3814305099,1672680929,1672684312,3383
3701,3713911104,3279242917,1672699896,1672700871,975
3431,3276003502,3807212280,1672606465,1672609283,2818
3547,3783340788,3701107228,1672606100,1672607765,1665
3676,3757193551,3834960360,1672582887,1672586331,3444
3600,3500703304,3732584121,1672661978,1672662137,159
3515,3367509761,3312998540,1672576094,1672577886,1792
3432,3713911104,3511024016,1672698320,1672700263,1943
3600,3488763230,3890739241,1672665723,1672668961,3238
3740,3424660806,3517172354,1672625502,1672626126,624
3638,3497671225,3613338363,1672671977,1672672367,390
3909,3739154408,3293835352,1672692086,1672694539,2453
3561,3710854064,3714678331,1672554302,1672555348,1046
3467,3925979970,3667673649,1672603191,1672606283,3092
3455,3417679834,3773902805,1672577175,1672580099,2924
3768,3780712350,3516741440,1672636101,1672636401,300
3555,3756625818,3456430614,1672700842,1672702384,1542
3679,3608855425,3380767040,1672554146,1672554657,511
3667,3519087371,3793743698,1672614542,1672616448,1906
3857,3791441520,3895285664,1672660564,1672662730,2166
3514,3240994288,3701424609,1672692933,1672694549,1616
3706,3609933747,3703396825,1672661817,1672662915,1098
3674,3371455553,3779465522,1672702631,1672704057,1426
3806,3927403123,3306175858,1672592837,1672594642,1805
3441,3517991730,3793407963,1672602302,1672604668,2366
3510,3270056120,3774605761,1672637408,1672639120,1712
3884,3778597171,3638660068,1672561593,1672561722,129
3854,3446533960,3533090502,1672620427,1672622251,1824
3807,3773572967,3772236797,1672533364,1672535764,2400
3625,3774876004,3772391882,1672671389,1672673553,2164
3706,3485540729,3512282789,1672597280,1672599752,2472
3700,3396980894,3447672935,1672630974,1672631931,957
3609,3514275974,3757348722,1672571639,1672572460,821
3758,3398198430,3714128600,1672541808,1672542115,307
3805,3783373154,3715443333,1672627063,1672629870,2807
3689,3227799827,3923220461,1672538422,1672540359,1937
3447,3716272919,3311498666,1672561963,1672565147,3184
3801,3927599181,3604867757,1672617309,1672620046,2737
3476,3617392620,3557046880,1672648442,1672651292,2850
3676,3380130228,3512282789,1672543838,1672545335,1497
3649,3773913680,3701247948,1672644914,1672646110,1196
3766,3457960571,3731646673,1672606924,1672609367,2443
3538,3505521218,3733558985,1672664582,1672664644,62
3664,3792274796,3369708250,1672671754,1672672853,1099
3592,3500072204,3890739241,1672636448,1672637899,1451
3676,3783373154,3778899160,1672627164,1672627374,210
3509,3760364383,3791128487,1672599575,1672599911,336
3757,3488763230,3713561276,1672660082,1672661277,1195
3900,3770624662,3756625818,1672596645,1672599723,3078
3497,3272030610,3335694356,1672701489,1672702296,807
3636,3424660806,3773121782,1672574969,1672575339,370
3577,3292147449,3533929349,1672589445,1672591294,1849
3608,3341893384,3895285664,1672667661,1672669159,1498
3719,3511005395,3440137407,1672574913,1672574987,74
3521,3236458894,3770146716,1672557222,1672557404,182
3687,3505923418,3792072681,1672606200,1672607540,1340
3534,3200308999,3783340788,1672600156,1672603555,3399
3733,3280054198,3514971533,1672545851,1672545917,66
3675,3615939504,3715127070,1672565449,1672567237,1788
3834,3203538212,3807212280,1672616393,1672619073,2680
3781,3552824113,3714067076,1672597614,1672601199,3585
3809,3408430195,3760640999,1672639867,1672640005,138
3525,3488686442,3715385401,1672624904,1672625782,878
3805,3511843593,3891672228,1672688895,1672689748,853
3458,3513410578,3311049964,1672671141,1672671224,83
3480,3609933747,3448633776,1672562830,1672565988,3158
3711,3534357694,3513296868,1672539094,1672540555,1461
3807,3448875382,3737972328,1672615320,1672615551,231
3782,3450969839,3379143440,1672641031,1672642255,1224
3548,3971806004,3735374579,1672591081,1672593765,2684
3443,3970198861,3248058676,1672631865,1672634924,3059
3472,3511843593,3756474459,1672677764,1672680039,2275
3464,3791441520,3774733620,1672606913,1672609132,2219
3585,3815392801,3783340788,1672678535,1672678626,91
3858,3510641433,3604589802,1672640784,1672642135,1351
3767,3793922324,3780834916,1672636119,1672637158,1039
3616,3226511603,3338390596,1672693414,1672696087,2673
3498,3776559988,3203538212,1672672108,1672675128,3020
3911,3632814465,3203538212,1672639242,1672640753,1511
3451,3415833929,3304155815,1672625029,1672625441,412
3826,3852686295,3279473441,1672596449,1672597623,1174
3769,3835985172,3400763927,1672605674,1672607138,1464
3634,3773902805,3900276517,1672532866,1672534603,1737
3486,3825881598,3454277788,1672631415,1672634327,2912
3918,3772765746,3615115210,1672617861,1672620429,2568
3878,3780571086,3783373154,1672581616,1672583531,1915
3781,3401940259,3839245934,1672553442,1672556867,3425
3880,3412006598,3711000597,1672566176,1672568481,2305
3559,3519850727,3667673649,1672552576,1672554466,1890
3679,3500109249,3714120857,1672652605,1672655572,2967
3496,3472068734,3357289672,1672630869,1672634272,3403
3733,3884596900,3772078494,1672637205,1672640512,3307
3848,3513345163,3780909839,1672664281,1672666429,2148
3451,3394401087,3756789525,1672693061,1672695696,2635
3854,3834963772,3292147449,1672549952,1672550302,350
3764,3396726504,3533294425,1672588150,1672588446,296
3695,3518561777,3779438325,1672590948,1672593041,2093
3747,3497095254,3205985903,1672561213,1672562569,1356
3694,3513081354,3701005527,1672535953,1672537327,1374
3853,3935399379,3755496114,1672649390,1672649554,164
3852,3203538212,3452016771,1672555780,1672558623,2843
3791,3534829213,3733363628,1672667440,1672670982,3542
3503,3930242012,3201800997,1672643166,1672643470,304
3678,3244004456,3360616538,1672591288,1672592334,1046
3821,3779465522,3773033649,1672536161,1672537994,1833
3654,3517697722,3667673649,1672613909,1672616933,3024
3572,3283770991,3509366311,1672647181,1672647861,680
3734,3274906650,3513853403,1672575576,1672578215,2639
3789,3760094385,3513041785,1672661624,1672661729,105
3467,3501384020,3715086894,1672690307,1672693232,2925
3562,3296462324,3288762795,1672685177,1672686942,1765
3583,3505923418,3617304541,1672674542,1672674622,80
3531,3367111751,3757700712,1672671957,1672672684,727
3870,3439673892,3773902805,1672656977,1672657649,672
3439,3773902805,3715707380,1672703801,1672706690,2889
3765,3703139663,3619922891,1672574354,1672576973,2619
3889,3203538212,3505888598,1672545173,1672545566,393
3799,3792489602,3821054646,1672652141,1672653295,1154
3718,3897376951,3665998641,1672692052,1672695051,2999
3664,3909094917,3246370118,1672571679,1672574234,2555
3583,3534543776,3772078494,1672568209,1672571612,3403
3858,3280054198,3833217041,1672572276,1672572873,597
3801,3515466096,3615737355,1672630005,1672631567,1562
3489,3780322355,3900945856,1672637943,1672641065,3122
3777,3513065217,3791246640,1672581338,1672584220,2882
3824,3514285803,3270056120,1672600564,1672603807,3243
3480,3226024417,3932478321,1672666741,1672667517,776
3517,3793315718,3703348097,1672579204,1672581157,1953
3848,3360069849,3288224595,1672686725,1672689255,2530
3484,3516321888,3510798825,1672653697,1672656754,3057
3580,3774876004,3757863420,1672552638,1672554083,1445
3770,3711077927,3311098437,1672615699,1672617986,2287
3663,3783433404,3819767045,1672672846,1672674216,1370
3753,3715854030,3825881598,1672538051,1672541631,3580
3492,3472312341,3510767239,1672689157,1672692153,2996
3472,3371455553,3513296868,1672665283,1672667282,1999
3635,3284932450,3609113156,1672604105,1672605248,1143
3688,3618354185,3559458968,1672550963,1672553853,2890
3443,3383138270,3479851674,1672694841,1672695221,380
3736,3824641227,3401793306,1672692381,1672694173,1792
3515,3791128487,3777779869,1672547120,1672547454,334
3851,3858172636,3448633776,1672540881,1672540965,84
3442,3774290799,3852686295,1672598305,1672599201,896
3577,3972192593,3610358027,1672602097,1672604515,2418
3546,3711218296,3779613523,1672656016,1672658201,2185
3734,3935487534,3272030610,1672571114,1672571902,788
3702,3534566651,3315279093,1672637969,1672638089,120
3649,3792949946,3755230952,1672622337,1672624651,2314
3547,3515890966,3757318448,1672605114,1672606712,1598
3540,3533274994,3669146016,1672649956,1672651780,1824
3561,3499217428,3505437712,1672601743,1672603886,2143
3486,3852533643,3304155815,1672603864,1672607129,3265
3550,3701424609,3609933747,1672639465,1672640077,612
3646,3902760230,3680843171,1672597696,1672599198,1502
3509,3780680950,3500208903,1672679841,1672681654,1813
3458,3519087371,3833217041,1672568287,1672569574,1287
3793,3780209375,3715986185,1672638825,1672639947,1122
3497,3897435944,3714067076,1672600376,1672601601,1225
3636,3395201292,3447672935,1672661255,1672661969,714
3571,3715385401,3510767239,1672682365,1672683141,776
3880,3716628503,3852533643,1672549825,1672552165,2340
3901,3774290799,3710854064,1672681671,1672683728,2057
3881,3770146716,3621461051,1672550245,1672550641,396
3874,3511843593,3711000597,1672570548,1672570836,288
3776,3715400486,3300229945,1672603082,1672604252,1170
3490,3977148669,3760040019,1672583340,1672585328,1988
3463,3791106564,3451326054,1672684242,1672686426,2184
3611,3737972328,3511317276,1672583674,1672583777,103
3579,3617489344,3408430195,1672610826,1672610947,121
3760,3890739241,3515559913,1672571716,1672573567,1851
3830,3770296583,3505888598,1672561654,1672562273,619
3686,3770438122,3604589802,1672565632,1672568240,2608
3455,3271752081,3533188828,1672664005,1672666855,2850
3466,3774155692,3713784974,1672666048,1672668742,2694
3510,3418448389,3512800570,1672608362,1672610252,1890
3495,3770296583,3776084820,1672560888,1672563311,2423
3448,3927165965,3226024417,1672675906,1672678724,2818
3770,3372223551,3244004456,1672679950,1672680454,504
3856,3773939399,3487875183,1672682987,1672685978,2991
3711,3511442562,3793935736,1672566177,1672568584,2407
3683,3923220461,3404025196,1672556156,1672557997,1841
3553,3777240360,3615115210,1672534132,1672536800,2668
3675,3974674109,3551389192,1672682148,1672683340,1192
3805,3511024016,3438489358,1672562892,1672565252,2360
3511,3205923620,3509756823,1672668279,1672669970,1691
3876,3756746867,3533649454,1672632293,1672633963,1670
3637,3399518841,3885157459,1672668615,1672670329,1714
3895,3792546035,3520873221,1672663600,1672664398,798
3498,3309314379,3772765746,1672598283,1672598559,276
3728,3557046880,3618697021,1672543587,1672544294,707
3645,3776244398,3792505974,1672628817,1672629465,648
3775,3276003502,3900276517,1672545936,1672549124,3188
3616,3305336154,3279473441,1672628866,1672629614,748
3705,3505198734,3500709774,1672601884,1672603060,1176
3832,3755992176,3505634634,1672571823,1672574213,2390
3654,3515402792,3930242012,1672644455,1672646493,2038
3806,3399472693,3620292035,1672625866,1672627162,1296
3557,3533368789,3934064792,1672600293,1672602689,2396
3903,3780209375,3509366311,1672625185,1672625398,213
3919,3890739241,3923420131,1672591483,1672592860,1377
3430,3534829213,3279473441,1672614704,1672618022,3318
3716,3516513251,3448875382,1672584329,1672587325,2996
3843,3347419520,3516298579,1672537504,1672538404,900
3514,3755848152,3608922867,1672606526,1672606589,63
3599,3736705719,3292147449,1672686074,1672688198,2124
3617,3617392620,3710562338,1672647302,1672649504,2202
3803,3780680950,3852533643,1672686915,1672689183,2268
3523,3803389195,3760651515,1672699590,1672701038,1448
3643,3311049964,3756385685,1672554919,1672558042,3123
3922,3392943173,3511317276,1672621338,1672624357,3019
3622,3777189898,3500442734,1672588676,1672588905,229
3554,3505111292,3755756564,1672622028,1672625558,3530
3484,3505847380,3716679950,1672577064,1672577617,553
3917,3791106564,3618697021,1672625261,1672628064,2803
3472,3757700712,3551399764,1672580084,1672581429,1345
3494,3514956366,3760364383,1672639830,1672642108,2278
3867,3294703680,3618176292,1672562647,1672565218,2571
3520,3770236215,3701664364,1672645962,1672648173,2211
3729,3933894942,3441348818,1672699196,1672701457,2261
3510,3517697722,3351696332,1672594528,1672596784,2256
3744,3300818269,3229822507,1672554488,1672556482,1994
3882,3739911441,3783801141,1672607301,1672610095,2794
3471,3206837348,3714185969,1672693148,1672693576,428
3684,3760924079,3515439826,1672629457,1672630766,1309
3620,3300229945,3774790271,1672536411,1672537477,1066
3443,3231494505,3500302272,1672663088,1672664957,1869
3536,3517462308,3384068080,1672624988,1672625839,851
3594,3770468980,3518194482,1672567126,1672568342,1216
3478,3716963089,3367111751,1672574405,1672576546,2141
3910,3859868849,3921648519,1672605783,1672608658,2875
3783,3360813161,3713829743,1672569061,1672570400,1339
3448,3791436104,3778899160,1672682735,1672686159,3424
3558,3499217428,3386758279,1672635190,1672636056,866
3558,3757903168,3792014516,1672551432,1672552956,1524
3630,3779639983,3520639768,1672537906,1672540595,2689
3533,3279339278,3510837901,1672605729,1672606679,950
3763,3516741440,3510798825,1672642880,1672643800,920
3725,3757294769,3661583097,1672645402,1672648694,3292
3682,3505995057,3710562338,1672601874,1672603951,2077
3822,3497808662,3777037426,1672680310,1672682377,2067
3897,3448875382,3534175249,1672630043,1672631526,1483
3788,3938503547,3512337405,1672591946,1672595364,3418
3432,3469254160,3270042456,1672611438,1672614979,3541
3709,3620292035,3970909253,1672540900,1672542572,1672
3500,3512379024,3620292035,1672559457,1672562425,2968
3891,3500044458,3755158925,1672599498,1672599868,370
3853,3520639768,3638204468,1672633064,1672636357,3293
3650,3604589802,3770704999,1672543977,1672545488,1511
3821,3300818269,3292147449,1672617689,1672618298,609
3738,3341893384,3791246640,1672536662,1672537350,688
3463,3703139663,3887243870,1672646032,1672648436,2404
3566,3518229776,3755496114,1672614380,1672617150,2770
3590,3371455553,3780472203,1672584175,1672586182,2007
3856,3710048469,3505634634,1672618511,1672620434,1923
3828,3783163143,3462273042,1672652770,1672653557,787
3466,3500498112,3435116799,1672619269,1672622628,3359
3616,3793781065,3757700712,1672536969,1672540328,3359
3485,3480991549,3897376951,1672633390,1672636307,2917
3677,3513360004,3618354185,1672551107,1672554414,3307
3738,3621790707,3914691363,1672620395,1672623354,2959
3622,3792505974,3902760230,1672558028,1672560604,2576
3486,3516703758,3202804048,1672649645,1672651780,2135
3846,3367509761,3803389195,1672544198,1672547108,2910
3509,3615115210,3513296868,1672604843,1672606746,1903
3464,3777779869,3500317969,1672638954,1672639768,814
3637,3779532653,3792801638,1672661127,1672663236,2109
3613,3774907131,3228888030,1672541225,1672542605,1380
3602,3710315160,3533228966,1672680197,1672681295,1098
3744,3393063657,3760263530,1672659367,1672661890,2523
3734,3791106564,3760263530,1672552462,1672554791,2329
3683,3885157459,3757383891,1672606820,1672609952,3132
3728,3367111751,3711853996,1672690479,1672691298,819
3918,3826238375,3819767045,1672684596,1672687714,3118
3613,3735374579,3792274796,1672662738,1672665779,3041
3761,3225631197,3392520516,1672648916,1672652193,3277
3628,3410538749,3518229776,1672643580,1672646483,2903
3882,3604867757,3935399379,1672657930,1672659529,1599
3787,3834631333,3777184389,1672631699,1672633432,1733
3517,3335694356,3238288884,1672674463,1672676042,1579
3680,3779892400,3739911441,1672685995,1672688518,2523
3791,3613206049,3792505974,1672676039,1672676492,453
3813,3774031303,3500613493,1672552824,1672555980,3156
3862,3311420950,3783641602,1672597143,1672597707,564
3739,3778667336,3755222916,1672607437,1672610552,3115
3767,3505154885,3783801141,1672595102,1672596461,1359
3694,3811075491,3793407963,1672636878,1672639332,2454
3784,3905196766,3783340788,1672620849,1672622019,1170
3766,3664943873,3688220326,1672698329,1672700735,2406
3774,3927599181,3615087943,1672595142,1672597119,1977
3682,3710854064,3774178201,1672623031,1672625385,2354
3745,3311498666,3777779869,1672667722,1672668715,993
3588,3760263530,3333403880,1672552197,1672555308,3111
3909,3834963772,3500109249,1672575708,1672576559,851
3765,3756625818,3303410628,1672643916,1672644272,356
3862,3715707380,3514956366,1672664023,1672665231,1208
3510,3274831810,3792505974,1672554302,1672555062,760
3907,3779465522,3791046864,1672633427,1672634143,716
3505,3520764926,3701664364,1672673334,1672673466,132
3653,3402385957,3755404116,1672581684,1672583593,1909
3550,3500613493,3516741440,1672632896,1672633281,385
3557,3357689359,3398731252,1672631095,1672631605,510
3460,3517697722,3701247948,1672630494,1672631900,1406
3895,3533423872,3711734586,1672594884,1672597345,2461
3788,3701373490,3401496246,1672569214,1672569700,486
3903,3801645328,3779938251,1672559325,1672561890,2565
3478,3757903168,3776084820,1672695504,1672697216,1712
3604,3517288083,3513853403,1672696692,1672699543,2851
3512,3772765746,3202141727,1672637471,1672639555,2084
3554,3533747868,3793418209,1672571026,1672574589,3563
3732,3793922324,3551399764,1672665782,1672667893,2111
3560,3610358027,3793883863,1672586781,1672588771,1990
3639,3226511603,3774243020,1672532873,1672535679,2806
3626,3246370118,3972083617,1672632370,1672634799,2429
3697,3294703680,3431460073,1672581054,1672584611,3557
3659,3776117322,3311049964,1672609096,1672612208,3112
3856,3923754072,3760721303,1672654232,1672655688,1456
3439,3757193307,3770624662,1672545854,1672547676,1822
3687,3779301501,3792389522,1672678362,1672681701,3339
3594,3500613459,3533294425,1672645175,1672645867,692
3643,3755158925,3755848152,1672536713,1672538933,2220
3760,3713768950,3885121158,1672638853,1672640665,1812
3473,3778040015,3780769110,1672634741,1672634845,104
3920,3624297844,3411515369,1672685333,1672686999,1666
3876,3274906650,3306412634,1672552949,1672553627,678
3431,3716628503,3520873221,1672685726,1672688193,2467
3759,3778040015,3776084820,1672598275,1672601815,3540
3898,3773572967,3438078818,1672631459,1672632292,833
3816,3513041785,3360616538,1672638620,1672641903,3283
3846,3505437712,3518194482,1672603377,1672604090,713
3638,3460719322,3515402792,1672635278,1672638455,3177
3893,3895285664,3783433404,1672650891,1672652840,1949
3830,3401793306,3510964997,1672603827,1672605939,2112
3662,3517881647,3793883863,1672560096,1672560808,712
3591,3501281016,3390660440,1672677424,1672680840,3416
3474,3374183227,3349856820,1672612802,1672615994,3192
3906,3229974066,3505228454,1672680470,1672682116,1646
3608,3977148669,3770520359,1672594516,1672597240,2724
3773,3773124276,3500341755,1672584551,1672586734,2183
3915,3803389195,3505434346,1672581954,1672585394,3440
3700,3417679834,3760040019,1672643193,1672644739,1546
3665,3520322124,3372223551,1672566682,1672567694,1012
3667,3972083617,3387594369,1672569450,1672572301,2851
3439,3279242917,3312998540,1672677298,1672679652,2354
3759,3201676087,3938503547,1672540702,1672543694,2992
3467,3533423872,3792274796,1672698954,1672700835,1881
3474,3533294425,3802932312,1672535630,1672536203,573
3748,3309314379,3791693821,1672676388,1672676579,191
3837,3779425804,3757318448,1672536537,1672537251,714
3868,3760040019,3703396825,1672703233,1672705698,2465
3787,3519850727,3270056120,1672702352,1672703838,1486
3596,3630353876,3554186380,1672578679,1672581424,2745
3542,3511005395,3289114629,1672680827,1672681626,799
3554,3500442734,3610870949,1672613805,1672616299,2494
3881,3902861231,3636329663,1672583613,1672584294,681
3604,3292147449,3451691949,1672650678,1672653035,2357
3495,3500703304,3780253901,1672690662,1672693538,2876
3444,3512800570,3970198861,1672565158,1672565610,452
3791,3505663516,3760842815,1672656906,1672658351,1445
3816,3533294425,3514334067,1672558574,1672561738,3164
3764,3399518841,3334974375,1672702450,1672705873,3423
3507,3791753345,3410538749,1672606712,1672608820,2108
3644,3500525825,3935399379,1672576633,1672577490,857
3561,3609659642,3310125159,1672614635,1672616611,1976
3635,3760094385,3774733620,1672666786,1672667545,759
3434,3853629553,3920625129,1672632749,1672635216,2467
3782,3357689359,3510642075,1672646950,1672648908,1958
3657,3792072681,3386758279,1672656857,1672657789,932
3462,3792538417,3685816610,1672674695,1672674959,264
3425,3424445495,3974674109,1672640099,1672640807,708
3829,3793743698,3931627862,1672662053,1672663088,1035
3830,3399472693,3714666884,1672614511,1672617802,3291
3723,3714666884,3661447322,1672631833,1672634238,2405
3911,3271454397,3713911104,1672661555,1672664288,2733
3612,3774031303,3315703693,1672652863,1672656065,3202
3751,3770146716,3783169442,1672541947,1672544832,2885
3901,3711637255,3505434346,1672597684,1672598656,972
3672,3411515369,3520560590,1672643085,1672643170,85
3468,3780834916,3349739136,1672650393,1672652809,2416
3488,3608232640,3392836218,1672655879,1672659055,3176
3726,3783615982,3615115210,1672574792,1672575029,237
3761,3925979970,3685816610,1672632760,1672635748,2988
3584,3315703693,3774907131,1672610800,1672612648,1848
3629,3711218296,3283770991,1672698928,1672699728,800
3592,3244004456,3660887799,1672685413,1672685531,118
3607,3732131656,3311098437,1672615954,1672616904,950
3613,3783433404,3514741348,1672603135,1672604307,1172
3479,3505437712,3276269264,1672565933,1672567132,1199
3750,3774178201,3450286949,1672663755,1672666564,2809
3721,3209526819,3376467719,1672535541,1672537852,2311
3897,3905196766,3893912331,1672654144,1672654455,311
3569,3783163143,3520764926,1672678150,1672679516,1366
3618,3703396825,3510818674,1672578326,1672579453,1127
3449,3357289672,3488763230,1672550933,1672552032,1099
3559,3902760230,3534829213,1672584953,1672586246,1293
3434,3270697740,3920625129,1672657617,1672660186,2569
3848,3402385957,3201676087,1672578070,1672581069,2999
3681,3421385957,3370227921,1672690944,1672694322,3378
3592,3224811762,3920497528,1672538520,1672540893,2373
3902,3812534508,3500613459,1672605712,1672607424,1712
3767,3715127070,3303410628,1672610761,1672612288,1527
3798,3505437712,3701884158,1672625390,1672628169,2779
3885,3513296868,3505437712,1672649512,1672650215,703
3476,3715385401,3773572967,1672692851,1672695157,2306
3847,3311498666,3780115155,1672541250,1672544024,2774
3907,3909094917,3760364383,1672533053,1672535653,2600
3710,3774718695,3776084820,1672669777,1672671108,1331
3659,3333403880,3451691949,1672592961,1672595424,2463
3803,3773121782,3608855425,1672630621,1672633949,3328
3645,3357864626,3622357348,1672660845,1672661349,504
3646,3715707380,3514324011,1672592888,1672596240,3352
3664,3792072681,3451326054,1672609083,1672609666,583
3888,3205985903,3783433404,1672635153,1672635832,679
3716,3622357348,3343132529,1672571511,1672574485,2974
3648,3392520516,3774641380,1672631348,1672631826,478
3775,3514956366,3283144118,1672678109,1672678602,493
3543,3783433404,3932478321,1672601957,1672603873,1916
3451,3701107228,3780115155,1672575914,1672577591,1677
3702,3891672228,3715986185,1672581338,1672582671,1333
3829,3738026330,3916490839,1672668950,1672671410,2460
3572,3500347447,3501457103,1672537796,1672538515,719
3799,3615939504,3774718695,1672671589,1672672617,1028
3464,3449639012,3701247948,1672578875,1672580082,1207
3655,3239617320,3280054198,1672703438,1672703871,433
3774,3226024417,3446533960,1672560495,1672560911,416
3916,3491684096,3774907131,1672594617,1672596036,1419
3487,3534543776,3514512367,1672569060,1672569501,441
3702,3357864626,3510837901,1672575063,1672577949,2886
3813,3777091903,3510641433,1672612693,1672612926,233
3910,3480100311,3730071479,1672559152,1672559771,619
3636,3357864626,3713163045,1672541513,1672542158,645
3733,3334974375,3773009828,1672601239,1672604839,3600
3523,3366423342,3500341755,1672543558,1672546080,2522
3852,3294703680,3402697190,1672577010,1672577473,463
3611,3792489602,3808136029,1672562937,1672565183,2246
3900,3773009828,3711853996,1672683238,1672683534,296
3584,3757318448,3755404116,1672641896,1672643398,1502
3824,3755573472,3683113954,1672657674,1672658696,1022
3519,3970558632,3274906650,1672572698,1672575761,3063
3579,3776559988,3802932312,1672702165,1672702689,524
3552,3225636215,3533004959,1672573862,1672574405,543
3429,3755915206,3447672935,1672676146,1672677608,1462
3862,3492546679,3418448389,1672623176,1672624956,1780
3793,3299781901,3778899160,1672654677,1672655985,1308
3491,3710489491,3272030610,1672615063,1672617915,2852
3603,3622357348,3803517637,1672607497,1672609122,1625
3652,3431460073,3624297844,1672533748,1672534743,995
3479,3510187271,3701107228,1672546418,1672549592,3174
3908,3779646172,3448875382,1672697137,1672697545,408
3450,3300511067,3480726047,1672623813,1672626309,2496
3861,3449333754,3485540729,1672678340,1672680096,1756
3627,3792801638,3757332128,1672613365,1672614168,803
3453,3904412440,3783641602,1672554767,1672555911,1144
3591,3757075324,3296462324,1672690608,1672692316,1708
3911,3926643445,3380767040,1672539273,1672540380,1107
3708,3923220461,3757075324,1672639099,1672639326,227
3501,3760364383,3774290799,1672534955,1672536421,1466
3482,3774907131,3517600136,1672550908,1672554333,3425
3881,3510499038,3777147510,1672570584,1672573873,3289
3425,3227799827,3738026330,1672592198,1672593598,1400
3648,3609113156,3505283390,1672612335,1672615176,2841
3491,3459681410,3755344363,1672625845,1672628204,2359
3434,3777485931,3737147209,1672549964,1672551175,1211
3799,3519909393,3511024016,1672558609,1672558878,269
3497,3715986185,3500777439,1672634275,1672635713,1438
3859,3715385401,3514246749,1672639703,1672641484,1781
3803,3793922324,3859868849,1672692816,1672696055,3239
3773,3970558632,3792389522,1672600110,1672603395,3285
3773,3305722859,3885537225,1672675437,1672678449,3012
3830,3625463628,3401496246,1672637777,1672638743,966
3587,3715707380,3711077927,1672629210,1672630567,1357
3461,3684523966,3551376095,1672544935,1672546238,1303
3438,3270697740,3783919913,1672601217,1672603091,1874
3704,3850911686,3272096759,1672580380,1672583221,2841
3529,3533294425,3617116290,1672550820,1672551738,918
3470,3627368399,3491469603,1672633992,1672634209,217
3579,3711000597,3202804048,1672554139,1672556978,2839
3559,3554825448,3349856820,1672681622,1672682914,1292
3434,3895285664,3513295938,1672585728,1672588927,3199
3864,3793175445,3467988782,1672651862,1672651959,97
3875,3859868849,3231494505,1672556772,1672558654,1882
3844,3713517039,3780769110,1672570733,1672572995,2262
3617,3368283077,3305336154,1672701473,1672703276,1803
3776,3779465522,3792014516,1672690867,1672693050,2183
3885,3373028638,3977148669,1672698006,1672699605,1599
3484,3664943873,3779656423,1672588363,1672590188,1825
3766,3779892400,3408498208,1672614036,1672615952,1916
3507,3757700712,3515559913,1672565489,1672568954,3465
3682,3226024417,3289114629,1672671639,1672673951,2312
3802,3362641275,3559458968,1672602255,1672603860,1605
3788,3505634634,3510028805,1672584082,1672585261,1179
3860,3778667336,3284932450,1672565898,1672568186,2288
3476,3770236215,3241790910,1672533925,1672534433,508
3821,3228888030,3730071479,1672598046,1672600716,2670
3792,3685681577,3665998641,1672670372,1672672409,2037
3623,3394401087,3334951866,1672532719,1672536134,3415
3699,3792389522,3615737355,1672677631,1672681137,3506
3808,3815392801,3710854064,1672658133,1672658983,850
3808,3783641602,3776518452,1672617595,1672618756,1161
3751,3490029863,3398198430,1672626503,1672627395,892
3641,3505198734,3703383853,1672570848,1672571353,505
3871,3244004456,3270056120,1672556324,1672556754,430
3439,3923420131,3893912331,1672672892,1672674077,1185
3501,3514703118,3380767040,1672635886,1672635990,104
3481,3511288998,3505888598,1672551041,1672551780,739
3581,3777624586,3793935736,1672587051,1672587871,820
3568,3713784974,3731646673,1672537187,1672539766,2579
3627,3452016771,3755233658,1672666092,1672667148,1056
3441,3333918941,3739661856,1672653687,1672655855,2168
3706,3773009828,3225029895,1672543527,1672547077,3550
3878,3360069849,3512800570,1672648785,1672649368,583
3865,3780427126,3517172354,1672606069,1672607327,1258
3655,3519282716,3713691388,1672683256,1672683647,391
3828,3488686442,3462158237,1672631319,1672632661,1342
3853,3783771827,3454277788,1672694458,1672697371,2913
3673,3336339664,3209481722,1672553665,1672555028,1363
3602,3447672935,3501384020,1672699634,1672702784,3150
3830,3229822507,3505111292,1672643447,1672644815,1368
3807,3293835352,3509366311,1672621095,1672622039,944
3781,3701322924,3760640999,1672699479,1672700124,645
3453,3852686295,3505521218,1672557672,1672560273,2601
3912,3371455553,3299125059,1672578183,1672581022,2839
3647,3416987084,3533004959,1672663983,1672665590,1607
3808,3236354255,3338083680,1672542330,1672542492,162
3689,3492546679,3783550022,1672617768,1672620127,2359
3610,3800257590,3885121158,1672536170,1672536962,792
3678,3448633776,3909094917,1672619742,1672622754,3012
3909,3792801638,3931627862,1672602743,1672603165,422
3600,3685681577,3421385957,1672532730,1672533829,1099
3430,3791436104,3514741348,1672601024,1672604203,3179
3755,3379143440,3201629017,1672614224,1672616676,2452
3708,3533004959,3462158237,1672544794,1672548013,3219
3787,3685816610,3760362417,1672589816,1672592837,3021
3575,3711919537,3760645796,1672667413,1672669045,1632
3673,3779438325,3284947372,1672631807,1672632092,285
3518,3800257590,3283144118,1672619027,1672621126,2099
3459,3311049964,3703383853,1672576418,1672576615,197
3861,3512499658,3516321888,1672657104,1672657392,288
3652,3970627281,3715385401,1672672917,1672673038,121
3907,3513081354,3661447322,1672607549,1672609969,2420
3691,3270056120,3780209375,1672619313,1672621658,2345
3778,3858172636,3450969839,1672606348,1672609682,3334
3437,3294703680,3417679834,1672582831,1672584923,2092
3596,3631479562,3972192593,1672591007,1672592546,1539
3512,3834960360,3780834916,1672657242,1672660028,2786
3482,3315279093,3715986185,1672601083,1672601296,213
3501,3610870949,3311098437,1672542638,1672542698,60
3833,3517358573,3932478321,1672648540,1672651879,3339
3752,3774733620,3534764451,1672682761,1672685384,2623
3588,3241914067,3380130228,1672651795,1672654304,2509
3686,3819767045,3755065949,1672610856,1672612180,1324
3615,3780338697,3791246640,1672697966,1672698123,157
3693,3396980894,3240394404,1672630704,1672631149,445
3608,3357864626,3970198861,1672648414,1672648652,238
3621,3631090677,3520560590,1672664832,1672667191,2359
3488,3853629553,3607882826,1672659024,1672661563,2539
3806,3615113018,3315703693,1672648166,1672651425,3259
3815,3408498208,3505481368,1672535847,1672538933,3086
3593,3300511067,3349739136,1672638860,1672639006,146
3570,3505481368,3703348097,1672565596,1672568486,2890
3733,3201676087,3448875382,1672589348,1672592328,2980
3711,3510818674,3556969573,1672632582,1672635949,3367
3444,3773009828,3621790707,1672694885,1672697160,2275
3581,3777814504,3780427126,1672619975,1672621053,1078
3662,3623266256,3311098437,1672543643,1672544590,947
3788,3777624586,3617392620,1672577433,1672579139,1706
3448,3920625129,3479851674,1672578848,1672581070,2222
3637,3777147510,3630353876,1672597175,1672598169,994
3788,3511601997,3497095254,1672615897,1672619188,3291
3892,3625174002,3511732493,1672680752,1672684338,3586
3623,3755404116,3783928182,1672651725,1672655018,3293
3575,3501525100,3334951866,1672569678,1672571743,2065
3780,3735374579,3815392801,1672577496,1672578650,1154
3833,3520639768,3685681577,1672654711,1672657156,2445
3832,3501525100,3701664364,1672604194,1672606619,2425
3444,3239617320,3410160376,1672597545,1672600717,3172
3769,3500072204,3731646673,1672650360,1672650488,128
3703,3928511283,3614740489,1672566706,1672569956,3250
3804,3779438325,3824641227,1672532260,1672532858,598
3808,3389634034,3780209375,1672535164,1672538551,3387
3446,3236499444,3511791953,1672575215,1672575546,331
3760,3979802715,3713691388,1672616669,1672618226,1557
3903,3520115090,3934064792,1672698346,1672700087,1741
3768,3780338697,3511791953,1672700126,1672700743,617
3765,3501567772,3202804048,1672654825,1672655744,919
3668,3779786641,3510767239,1672686028,1672689095,3067
3744,3615115210,3517887477,1672699986,1672701654,1668
3835,3519282716,3392943173,1672566066,1672569142,3076
3863,3893912331,3615113018,1672694330,1672697343,3013
3640,3447672935,3279339278,1672619356,1672622903,3547
3612,3385323994,3500109249,1672543550,1672546228,2678
3908,3701247948,3450969839,1672573404,1672575842,2438
3642,3284947372,3366423342,1672621362,1672622565,1203
3724,3511883730,3755222916,1672615061,1672616318,1257
3714,3246370118,3533929349,1672685120,1672688293,3173
3460,3716272919,3971806004,1672581396,1672584824,3428
3796,3791046864,3928511283,1672578921,1672581581,2660
3902,3770296583,3779656423,1672541671,1672542171,500
3484,3438078818,3431460073,1672595992,1672598490,2498
3712,3441703884,3780427126,1672586023,1672587189,1166
3752,3938389661,3556969573,1672633944,1672636413,2469
3917,3309314379,3470454332,1672563942,1672564060,118
3775,3500498112,3350095157,1672643844,1672644111,267
3584,3236499444,3511288998,1672614635,1672617948,3313
3831,3308760650,3773033649,1672594406,1672597616,3210
3466,3511288998,3895285664,1672667694,1672670148,2454
3741,3414275042,3770624662,1672571372,1672573928,2556
3914,3780209375,3791441520,1672657398,1672659417,2019
3426,3710735406,3404025196,1672606704,1672609436,2732
3919,3511288998,3608922867,1672634208,1672635454,1246
3816,3609113156,3505283390,1672688641,1672690988,2347
3672,3833217041,3925979970,1672688415,1672690105,1690
3821,3773735484,3615737355,1672587206,1672587594,388
3778,3793740407,3791246640,1672610764,1672612697,1933
3865,3428027649,3510641433,1672643941,1672645302,1361
3803,3923754072,3497671225,1672566939,1672568476,1537
3792,3505521218,3756746867,1672570025,1672573027,3002
3540,3757294769,3438078818,1672622786,1672622895,109
3648,3774876004,3774718695,1672573177,1672576440,3263
3863,3349739136,3887243870,1672531334,1672533036,1702
3669,3533929349,3505995057,1672633996,1672635185,1189
3857,3463849738,3774733620,1672532487,1672532635,148
3645,3703433819,3534175249,1672650293,1672652315,2022
3574,3518561777,3793868716,1672593817,1672596964,3147
3796,3552824113,3757193307,1672652092,1672654606,2514
3670,3392943173,3533368789,1672633469,1672636555,3086
3426,3897376951,3770468980,1672686639,1672689054,2415
3527,3500613459,3621184108,1672684643,1672685344,701
3843,3225029895,3457960571,1672678279,1672678650,371
3531,3931627862,3757383891,1672605661,1672607043,1382
3551,3270697740,3793175445,1672560691,1672564275,3584
3807,3201676087,3777694660,1672534563,1672535269,706
3642,3283144118,3462636434,1672658289,1672660843,2554
3919,3311098437,3368283077,1672662161,1672663866,1705
3505,3500841914,3311498666,1672558902,1672561417,2515
3613,3384068080,3364378127,1672569454,1672572103,2649
3780,3715127070,3755222916,1672680220,1672682892,2672
3479,3632814465,3610870949,1672673812,1672675299,1487
3501,3437286517,3495911207,1672662603,1672663577,974
3584,3625174002,3299443125,1672614194,1672615326,1132
3762,3772765746,3607882826,1672668091,1672668466,375
3867,3736231757,3793781065,1672594332,1672595253,921
3675,3515525630,3607882826,1672574169,1672575294,1125
3915,3288762795,3472068734,1672555747,1672558138,2391
3910,3511442562,3800257590,1672585738,1672587645,1907
3784,3715986185,3513545422,1672646781,1672649289,2508
3678,3402697190,3930242012,1672666697,1672667675,978
3488,3559731671,3505283390,1672548827,1672551374,2547
3651,3304155815,3351696332,1672612393,1672615653,3260
3537,3683113954,3615688740,1672611177,1672612887,1710
3723,3970558632,3288224595,1672643463,1672645982,2519
3864,3501215099,3791046864,1672671145,1672673462,2317
3751,3511732493,3715443333,1672596969,1672597412,443
3552,3701005527,3892304880,1672627886,1672631247,3361
3806,3783147088,3779892400,1672654635,1672655857,1222
3621,3834631333,3515559913,1672692032,1672693283,1251
3711,3463740710,3859868849,1672660403,1672663512,3109
3798,3513327337,3487875183,1672549098,1672550612,1514
3807,3511601997,3701664364,1672575463,1672577125,1662
3877,3710048469,3821054646,1672620308,1672623264,2956
3877,3534126409,3516444201,1672547470,1672547689,219
3512,3513041785,3284932450,1672696905,1672697185,280
3725,3279242917,3279242917,1672617611,1672620862,3251
3676,3773735484,3972083617,1672632565,1672634758,2193
3779,3229822507,3514275974,1672614294,1672617021,2727
3766,3227799827,3906536154,1672573480,1672575998,2518
3745,3500317969,3793969543,1672610381,1672613666,3285
3887,3369708250,3343132529,1672640565,1672640819,254
3690,3756625818,3399472693,1672615673,1672617095,1422
3684,3615688740,3511732493,1672562875,1672563503,628
3877,3451726367,3756746867,1672653610,1672655162,1552
3475,3609113156,3513081354,1672640368,1672643280,2912
3656,3475349791,3514275974,1672569035,1672570541,1506
3514,3760040019,3443357683,1672577146,1672577381,235
3657,3513081354,3500737582,1672676198,1672676579,381
3697,3441348818,3402697190,1672553139,1672556572,3433
3687,3517222913,3930242012,1672663790,1672665727,1937
3485,3418448389,3780322355,1672666967,1672668908,1941
3638,3773124276,3713979100,1672687243,1672689464,2221
3556,3906536154,3305336154,1672582279,1672583880,1601
3556,3230135532,3626499450,1672650055,1672653603,3548
3774,3701664364,3520764926,1672678718,1672679827,1109
3503,3230135532,3618697021,1672644108,1672647088,2980
3800,3715986185,3755737419,1672654740,1672656979,2239
3481,3885537225,3459681410,1672638361,1672641576,3215
3518,3773913680,3400763927,1672539718,1672542756,3038
3847,3774790271,3279473441,1672666111,1672667091,980
3721,3792745809,3831586487,1672695629,1672697781,2152
3703,3714678331,3533090502,1672678167,1672679093,926
3726,3925979970,3859868849,1672624265,1672624677,412
3655,3505402439,3713300120,1672663455,1672666871,3416
3492,3904412440,3396726504,1672603354,1672605396,2042
3844,3885537225,3814305099,1672641917,1672644885,2968
3591,3412006598,3927403123,1672570850,1672572380,1530
3731,3755344363,3319167958,1672638430,1672639088,658
3691,3778667336,3638204468,1672678331,1672680450,2119
3488,3240994288,3667427125,1672605711,1672607179,1468
3515,3736705719,3779639983,1672549543,1672552830,3287
3782,3245232284,3551389192,1672673914,1672674004,90
3875,3776117322,3772765746,1672613961,1672616268,2307
3442,3238288884,3852686295,1672552994,1672553411,417
3726,3520181148,3552824113,1672661836,1672664982,3146
3593,3305336154,3815250107,1672670456,1672670842,386
3794,3396980894,3755756564,1672653243,1672655151,1908
3707,3304155815,3711734586,1672584789,1672586340,1551
3792,3410600350,3773572967,1672536083,1672539114,3031
3597,3491469603,3661447322,1672639222,1672642697,3475
3904,3792389522,3777814504,1672553236,1672555492,2256
3555,3807212280,3500044458,1672666639,1672669874,3235
3921,3283770991,3510641433,1672666782,1672668572,1790
3622,3424660806,3755532873,1672625804,1672628646,2842
3910,3661583097,3510919821,1672572142,1672575715,3573
3699,3421877923,3533004959,1672569669,1672571067,1398
3905,3664943873,3701884158,1672675325,1672676988,1663
3580,3979802715,3701884158,1672633498,1672634312,814
3485,3715086894,3715400486,1672629318,1672632494,3176
3873,3516321888,3689697817,1672664246,1672666123,1877
3582,3517222913,3778597171,1672658059,1672658898,839
3501,3343132529,3501121099,1672587611,1672587729,118
3577,3375449013,3276269264,1672638264,1672641744,3480
3910,3372223551,3515402792,1672663175,1672665586,2411
3434,3839245934,3517288083,1672541018,1672541816,798
3470,3612689556,3661447322,1672694566,1672695220,654
3428,3370068529,3500703304,1672580629,1672583090,2461
3637,3714233826,3713911104,1672615448,1672617965,2517
3706,3380130228,3462158237,1672600487,1672603000,2513
3488,3461119815,3517590837,1672677371,1672677888,517
3527,3220031931,3889780657,1672607889,1672610062,2173
3767,3780427126,3885157459,1672597514,1672598826,1312
3595,3779301501,3793868716,1672608581,1672610751,2170
3921,3778640261,3715400486,1672532042,1672535390,3348
3453,3360616538,3334951866,1672601571,1672604538,2967
3789,3814677862,3556969573,1672629794,1672631746,1952
3753,3791753345,3284932450,1672700478,1672703157,2679
3894,3667427125,3534126409,1672646027,1672649234,3207
3663,3777189898,3773009828,1672595867,1672597340,1473
3770,3534829213,3279339278,1672669385,1672672067,2682
3471,3792020993,3935487534,1672671602,1672673425,1823
3704,3713829743,3209526819,1672701547,1672704649,3102
3809,3500613493,3808136029,1672563443,1672566820,3377
3669,3514741348,3279475486,1672553101,1672554907,1806
3792,3513018485,3515401243,1672560043,1672562688,2645
3531,3202141727,3450969839,1672614584,1672616906,2322
3792,3534126409,3414275042,1672647854,1672649278,1424
3550,3228888030,3783433404,1672598265,1672598914,649
3616,3463740710,3638204468,1672651930,1672653979,2049
3498,3479851674,3511005395,1672637494,1672638886,1392
3520,3552824113,3926643445,1672626362,1672627419,1057
3590,3783340788,3360616538,1672665844,1672667791,1947
3829,3516444201,3520560590,1672615979,1672616965,986
3514,3554825448,3437286517,1672674028,1672674683,655
3663,3757700712,3338390596,1672534435,1672534997,562
3428,3812369928,3511732493,1672531858,1672532187,329
3782,3202141727,3713979100,1672548841,1672550398,1557
3468,3336339664,3519850727,1672567869,1672569322,1453
3490,3410160376,3274906650,1672540718,1672540883,165
3906,3272096759,3517600136,1672560854,1672563670,2816
3665,3783641602,3516489668,1672586792,1672588737,1945
3838,3932478321,3367971170,1672653760,1672654448,688
3793,3437286517,3819767045,1672607671,1672610412,2741
3899,3979802715,3604589802,1672643957,1672646619,2662
3715,3774290799,3711812325,1672587896,1672589557,1661
3885,3516741440,3291933594,1672614385,1672617549,3164
3908,3227799827,3738026330,1672585541,1672586293,752
3671,3351696332,3811075491,1672656844,1672659704,2860
3842,3914691363,3713911104,1672595029,1672597262,2233
3480,3276003502,3276217799,1672619802,1672622285,2483
3609,3703139663,3288762795,1672682296,1672684946,2650
3850,3291933594,3885121158,1672533019,1672535064,2045
3651,3923754072,3777184389,1672547817,1672549211,1394
3547,3450969839,3300229945,1672594534,1672597752,3218
3790,3480490124,3501786419,1672581964,1672582495,531
3507,3713941638,3457960571,1672620229,1672620535,306
3750,3737147209,3462636434,1672626964,1672627635,671
3497,3777485931,3701322924,1672596845,1672599426,2581
3720,3519651506,3513545422,1672615402,1672618172,2770
3885,3773124276,3389634034,1672624463,1672624916,453
3858,3500841914,3818575661,1672613126,1672614639,1513
3710,3333403880,3505847380,1672673492,1672676010,2518
3434,3487875183,3500672156,1672695053,1672695731,678
3743,3511843593,3232208416,1672604324,1672604612,288
3672,3396980894,3343816795,1672638697,1672640796,2099
3505,3783163143,3330340793,1672574798,1672575768,970
3455,3288224595,3514956366,1672562541,1672563032,491
3686,3533228966,3402697190,1672654794,1672655158,364
3880,3514741348,3923754072,1672609396,1672609457,61
3607,3400763927,3276003502,1672619150,1672622292,3142
3492,3480100311,3274906650,1672615864,1672617255,1391
3626,3839245934,3441703884,1672690610,1672690968,358
3671,3779465522,3308760650,1672613357,1672613826,469
3695,3289114629,3760094385,1672566460,1672569122,2662
3736,3435116799,3248058676,1672596696,1672598498,1802
3459,3783641602,3236354255,1672678335,1672678678,343
3546,3615688740,3638660068,1672645792,1672649006,3214
3890,3337362061,3932478321,1672606750,1672610134,3384
3480,3515890966,3780472203,1672562239,1672562749,510
3816,3710008361,3774155692,1672557146,1672560588,3442
3762,3226178937,3401793306,1672578532,1672581190,2658
3871,3533929349,3505888598,1672532470,1672533238,768
3564,3625463628,3611055563,1672659394,1672662548,3154
3584,3534566651,3858172636,1672573816,1672576274,2458
3910,3760924079,3800257590,1672567449,1672569023,1574
3628,3387594369,3938389661,1672703702,1672704870,1168
3572,3225029895,3914691363,1672554087,1672557038,2951
3876,3905196766,3615113018,1672619490,1672621233,1743
3600,3626499450,3714128600,1672586749,1672587478,729
3649,3713300120,3519850727,1672646049,1672646301,252
3620,3611055563,3376467719,1672575615,1672578983,3368
3424,3500604680,3615688740,1672702914,1672706433,3519
3687,3814305099,3505228454,1672632681,1672635511,2830
3838,3607768197,3912891315,1672595545,1672596112,567
3638,3418448389,3304971369,1672624763,1672628064,3301
3746,3921648519,3520578796,1672691370,1672694859,3489
3714,3815250107,3519909393,1672682985,1672685578,2593
3682,3515525630,3774605761,1672601106,1672603206,2100
3794,3505198734,3509366311,1672560075,1672562327,2252
3875,3684523966,3621461051,1672646119,1672646662,543
3692,3934064792,3818575661,1672647668,1672648715,1047
3464,3778640261,3779613523,1672575742,1672576039,297
3758,3755737419,3760640999,1672642052,1672642177,125
3913,3390660440,3780909839,1672690845,1672693874,3029
3504,3517600136,3802932312,1672569505,1672572742,3237
3764,3500613459,3779938251,1672611557,1672613590,2033
3735,3774155692,3834631333,1672572685,1672573727,1042
3434,3440107959,3780115155,1672599968,1672600105,137
3727,3514308235,3500915908,1672661665,1672664649,2984
3543,3514275974,3272030610,1672573503,1672574765,1262
3841,3500737582,3270697740,1672536469,1672537095,626
3866,3774705415,3500841914,1672655943,1672656749,806
3764,3773939399,3334974375,1672590309,1672591820,1511
3796,3779892400,3897134762,1672623146,1672625237,2091
3789,3357289672,3817428320,1672575329,1672578911,3582
3566,3892304880,3408498208,1672674962,1672675621,659
3894,3236499444,3935399379,1672692102,1672693138,1036
3762,3343816795,3400763927,1672580960,1672583400,2440
3639,3201676087,3737972328,1672603294,1672606612,3318
3593,3779301501,3470454332,1672662252,1672665502,3250
3767,3625174002,3306412634,1672544875,1672548064,3189
3803,3834960360,3904412440,1672601982,1672604493,2511
3623,3519818818,3492959689,1672591972,1672592509,537
3443,3617116290,3246370118,1672684231,1672685395,1164
3842,3824641227,3552824113,1672686035,1672688532,2497
3654,3510919821,3208957949,1672623078,1672625066,1988
3540,3711853996,3280268483,1672575656,1672576612,956
3521,3623266256,3511791953,1672685872,1672687201,1329
3571,3289817992,3927165965,1672588146,1672591373,3227
3729,3369708250,3661447322,1672686074,1672688929,2855
3631,3793868716,3394401087,1672570140,1672573223,3083
3863,3730071479,3517358573,1672659392,1672662864,3472
3552,3800257590,3934064792,1672556336,1672558467,2131
3649,3401496246,3783615982,1672584224,1672587274,3050
3922,3512830734,3534764451,1672549254,1672551426,2172
3914,3304155815,3778667336,1672560233,1672560753,520
3548,3512946768,3515439826,1672624844,1672625586,742
3617,3713561276,3401793306,1672531806,1672531935,129
3453,3904867554,3240994288,1672639953,1672640508,555
3742,3920898925,3703348097,1672607445,1672609755,2310
3704,3410538749,3755222916,1672667290,1672669259,1969
3574,3684523966,3229822507,1672634060,1672634202,142
3557,3807212280,3431502855,1672645605,1672648738,3133
3467,3755532873,3363162590,1672577331,1672578606,1275
3650,3311085279,3626499450,1672539580,1672539663,83
3900,3773902805,3817813340,1672580300,1672582140,1840
3688,3755222916,3505154885,1672542280,1672544962,2682
3796,3667427125,3791106564,1672629927,1672631106,1179
3832,3737147209,3203538212,1672598194,1672600555,2361
3801,3497095254,3935487534,1672559617,1672559982,365
3746,3311098437,3755158925,1672679730,1672682583,2853
3480,3517737088,3513081354,1672636950,1672640480,3530
3547,3311098437,3887243870,1672609299,1672612471,3172
3518,3791246640,3617116290,1672605572,1672608035,2463
3755,3226178937,3300511067,1672693237,1672696090,2853
3917,3755233658,3276348699,1672563898,1672565738,1840
3560,3319167958,3624297844,1672684276,1672684652,376
3831,3505923418,3780909839,1672689187,1672691584,2397
3681,3970558632,3451726367,1672616591,1672617244,653
3666,3505923418,3791613604,1672639819,1672641226,1407
3606,3733558985,3780834916,1672679634,1672681177,1543
3594,3343816795,3615737355,1672559180,1672559480,300
3449,3449333754,3803517637,1672556708,1672558475,1767
3857,3772391882,3774733620,1672598420,1672598858,438
3893,3533274994,3230135532,1672603924,1672604793,869
3782,3772236797,3780769110,1672636352,1672639426,3074
3479,3554944414,3757323954,1672618831,1672621988,3157
3693,3780834916,3755065949,1672678901,1672680634,1733
3670,3756746867,3618697021,1672604189,1672606910,2721
3559,3619922891,3817813340,1672575007,1672576747,1740
3742,3716679950,3779646172,1672556749,1672558667,1918
3559,3347419520,3815250107,1672689986,1672692385,2399
3585,3398731252,3791613604,1672625807,1672626252,445
3427,3519909393,3467779445,1672689954,1672692084,2130
3705,3711218296,3308760650,1672550311,1672551166,855
3627,3284932450,3271454397,1672697321,1672698225,904
3701,3935487534,3780427126,1672588496,1672588912,416
3921,3501786419,3898314440,1672583311,1672584928,1617
3578,3500949309,3514703118,1672598326,1672599507,1181
3767,3341893384,3360813161,1672583788,1672586938,3150
3540,3448633776,3512499658,1672554611,1672558143,3532
3529,3417191856,3300229945,1672596441,1672598171,1730
3621,3514703118,3351866415,1672605204,1672608406,3202
3815,3783550022,3421385957,1672698836,1672700493,1657
3735,3205985903,3310039260,1672613052,1672614340,1288
3683,3757075324,3906536154,1672612930,1672615220,2290
3462,3319167958,3660887799,1672650215,1672651879,1664
3664,3737112297,3777330107,1672575511,1672576856,1345
3483,3773902805,3779425804,1672563751,1672564832,1081
3574,3515439826,3552824113,1672556127,1672558026,1899
3838,3500208903,3469254160,1672537582,1672541075,3493
3567,3239617320,3227799827,1672643364,1672644169,805
3880,3776117322,3500827202,1672551006,1672551559,553
3572,3515525630,3520764926,1672701139,1672701682,543
3717,3463849738,3613899351,1672557696,1672560830,3134
3428,3357864626,3239617320,1672549952,1672551113,1161
3634,3338390596,3904867554,1672662944,1672666482,3538
3585,3509366311,3347419520,1672552122,1672554481,2359
3821,3607768197,3715974659,1672696366,1672698567,2201
3635,3808136029,3770468980,1672622069,1672623617,1548
3686,3613416045,3636329663,1672675476,1672677196,1720
3457,3559458968,3622665543,1672679866,1672682649,2783
3555,3518565331,3516903528,1672641512,1672643305,1793
3436,3665998641,3239617320,1672632802,1672633362,560
3448,3513410578,3438489358,1672534863,1672536438,1575
3882,3514512367,3519142371,1672542004,1672545501,3497
3604,3792389522,3783340788,1672667949,1672668859,910
3849,3367111751,3904867554,1672597666,1672599523,1857
3762,3511288998,3403370192,1672596242,1672597064,822
3846,3760362417,3360069849,1672556175,1672559663,3488
3768,3244004456,3514703118,1672628996,1672632502,3506
3627,3511843593,3225631197,1672597741,1672599431,1690
3866,3783801141,3512800570,1672672427,1672673196,769
3619,3367509761,3611055563,1672558584,1672559967,1383
3683,3480726047,3780909839,1672653063,1672654131,1068
3427,3510641433,3533274994,1672548064,1672550232,2168
3576,3971806004,3905899155,1672614955,1672617670,2715
3521,3626499450,3514308235,1672639020,1672639431,411
3830,3349856820,3783169442,1672591383,1672594626,3243
3459,3893912331,3800257590,1672561136,1672562737,1601
3810,3757903168,3478114114,1672625119,1672626843,1724
3876,3622357348,3714120857,1672544038,1672544364,326
3841,3613416045,3780571086,1672665153,1672667200,2047
3481,3612689556,3735374579,1672618940,1672620991,2051
3870,3774178201,3469254160,1672559815,1672562400,2585
3852,3500857494,3520560590,1672577827,1672580617,2790
3883,3505178849,3777814504,1672695326,1672695897,571
3644,3510642075,3757323954,1672606243,1672606790,547
3673,3778134418,3509893027,1672591546,1672592911,1365
3859,3801645328,3793743698,1672601180,1672603526,2346
3469,3639050419,3509756823,1672688998,1672690884,1886
3670,3760263530,3776084820,1672674545,1672675283,738
3597,3299125059,3306175858,1672542333,1672545597,3264
3879,3396726504,3885537225,1672630067,1672631912,1845
3723,3416987084,3624297844,1672642134,1672644192,2058
3834,3296462324,3311498666,1672549570,1672552497,2927
3425,3533294425,3410600350,1672641904,1672642287,383
3879,3777485931,3815392801,1672698045,1672701290,3245
3865,3279242917,3792949946,1672560933,1672561857,924
3518,3390660440,3408430195,1672611828,1672612280,452
3581,3773837847,3518653080,1672648108,1672651212,3104
3533,3660063072,3516298579,1672587156,1672590625,3469
3896,3783801141,3305336154,1672537307,1672539710,2403
3768,3517881647,3505888598,1672609338,1672610618,1280
3848,3236499444,3509893027,1672639644,1672640254,610
3642,3298151889,3714233826,1672617061,1672619124,2063
3700,3441703884,3688490530,1672611818,1672613899,2081
3919,3505663516,3517687662,1672641608,1672643065,1457
3807,3519446663,3609881958,1672643588,1672643804,216
3501,3638660068,3209526819,1672692716,1672693447,731
3801,3777091903,3701373490,1672674526,1672676454,1928
3722,3856606678,3354144091,1672701533,1672703433,1900
3597,3776034743,3779301501,1672644522,1672647988,3466
3788,3793868716,3202804048,1672584756,1672587712,2956
3561,3392943173,3284932450,1672564740,1672566635,1895
3787,3533004959,3920497528,1672642099,1672644778,2679
3545,3615115210,3774705415,1672651105,1672651689,584
3869,3505178849,3979802715,1672642523,1672643787,1264
3852,3375449013,3737112297,1672558029,1672560581,2552
3535,3554944414,3226511603,1672699514,1672701667,2153
3455,3517358573,3349739136,1672587958,1672589350,1392
3546,3515401243,3517600136,1672553439,1672553840,401
3772,3438489358,3245232284,1672543338,1672545970,2632
3529,3935399379,3793935736,1672696278,1672697888,1610
3569,3791106564,3472068734,1672689377,1672691849,2472
3811,3515890966,3621184108,1672656162,1672656770,608
3467,3518229776,3428027649,1672623564,1672624327,763
3633,3608922867,3505154885,1672689065,1672689132,67
3889,3853629553,3885155975,1672576202,1672577849,1647
3621,3533228966,3510641433,1672588662,1672589281,619
3479,3783340788,3516513251,1672637819,1672638987,1168
3694,3431460073,3512337405,1672575175,1672576797,1622
3506,3713941638,3200308999,1672681594,1672682863,1269
3472,3819767045,3308760650,1672532846,1672534840,1994
3785,3715974659,3398731252,1672653049,1672655578,2529
3424,3203538212,3338390596,1672597612,1672600398,2786
3721,3357289672,3208452238,1672646769,1672647207,438
3801,3500347447,3925979970,1672698750,1672700849,2099
3705,3783550022,3615939504,1672664161,1672665004,843
3833,3311498666,3534175249,1672559357,1672562029,2672
3805,3777779869,3818575661,1672531877,1672534760,2883
3483,3633735593,3505634634,1672645046,1672645303,257
3634,3379143440,3383138270,1672627403,1672630379,2976
3543,3380767040,3791613604,1672564878,1672566644,1766
3512,3246370118,3625174002,1672637339,1672637697,358
3580,3447514821,3703433819,1672616374,1672618419,2045
3541,3369708250,3510837901,1672553061,1672554480,1419
3563,3534566651,3713691388,1672597024,1672600277,3253
3872,3438078818,3756385685,1672537298,1672537723,425
3483,3780322355,3511791953,1672541692,1672543019,1327
3481,3505888598,3534175249,1672577978,1672579800,1822
3462,3373028638,3773027597,1672698555,1672700442,1887
3873,3205985903,3776244398,1672552245,1672552511,266
3503,3512379024,3835422146,1672651869,1672654266,2397
3891,3773939399,3410538749,1672683861,1672684021,160
3665,3360616538,3770704999,1672653601,1672656565,2964
3827,3533090502,3783433404,1672567795,1672569542,1747
3543,3780909839,3360069849,1672531933,1672534080,2147
3918,3619922891,3778134418,1672604627,1672606920,2293
3911,3772078494,3791436104,1672616114,1672619473,3359
3692,3660063072,3852533643,1672591693,1672593653,1960
3428,3928719932,3885155975,1672555536,1672558731,3195
3522,3975717896,3779786641,1672667548,1672668770,1222
3884,3701424609,3505995057,1672610895,1672613750,2855
3583,3517697722,3395201292,1672590577,1672593387,2810
3780,3711218296,3451691949,1672618135,1672621513,3378
3801,3904569677,3500672156,1672536926,1672538696,1770
3637,3447672935,3829822608,1672535824,1672539265,3441
3700,3631479562,3412968120,1672629943,1672632343,2400
3452,3880926355,3783169442,1672630760,1672633857,3097
3534,3499217428,3897376951,1672642434,1672642851,417
3465,3533423872,3488763230,1672587166,1672589794,2628
3548,3755065949,3701882224,1672548881,1672551738,2857
3483,3533929349,3514818819,1672633351,1672633550,199
3611,3505402439,3892304880,1672604370,1672604748,378
3532,3457960571,3501281016,1672599513,1672600918,1405
3852,3449333754,3824215187,1672642275,1672645093,2818
3797,3276003502,3351866415,1672614889,1672616653,1764
3520,3713829743,3831586487,1672600427,1672603556,3129
3701,3701322924,3316800320,1672668064,1672671003,2939
3542,3897134762,3776117322,1672605042,1672606921,1879
3836,3497671225,3792538417,1672665043,1672667492,2449
3438,3823084403,3770438122,1672559087,1672561331,2244
3686,3308760650,3835422146,1672643268,1672644448,1180
3651,3714233826,3382733096,1672543698,1672546149,2451
3695,3514419100,3774876004,1672685260,1672686119,859
3630,3777240360,3367111751,1672589617,1672592242,2625
3535,3715385401,3414049538,1672651184,1672651970,786
3908,3516298579,3703798634,1672695834,1672698334,2500
3770,3509483172,3755737419,1672586388,1672588562,2174
3562,3440107959,3201676087,1672538561,1672540126,1565
3798,3685681577,3800257590,1672642914,1672644862,1948
3549,3400069268,3701322924,1672643001,1672643391,390
3472,3347419520,3517697722,1672642610,1672644174,1564
3813,3367509761,3347419520,1672617715,1672619127,1412
3838,3490214516,3505807416,1672606634,1672609656,3022
3625,3351866415,3739661856,1672546969,1672549536,2567
3661,3900276517,3897435944,1672629014,1672631998,2984
3769,3716272919,3623266256,1672583449,1672586542,3093
3824,3793969543,3288224595,1672584061,1672587513,3452
3665,3500317969,3884596900,1672631223,1672633109,1886
3748,3513018485,3770146716,1672649189,1672652262,3073
3526,3514703118,3559731671,1672695337,1672695945,608
3589,3713691388,3389634034,1672631592,1672631865,273
3649,3336627643,3520764926,1672604732,1672607779,3047
3693,3236499444,3660063072,1672562156,1672562749,593
3867,3715086894,3337322736,1672650838,1672651077,239
3803,3520657891,3510642075,1672634828,1672636234,1406
3663,3533747868,3904412440,1672581363,1672582274,911
3717,3636329663,3414049538,1672693675,1672695928,2253
3810,3363162590,3970558632,1672579160,1672580700,1540
3866,3604867757,3492546679,1672584266,1672585785,1519
3891,3773913680,3401793306,1672597919,1672600867,2948
3523,3512379024,3367971170,1672548187,1672550131,1944
3579,3410600350,3230135532,1672608468,1672611408,2940
3669,3757075324,3716110860,1672627094,1672629710,2616
3490,3512379024,3431502855,1672544165,1672547196,3031
3490,3779438325,3505178849,1672660812,1672662450,1638
3429,3480100311,3366423342,1672609462,1672612840,3378
3504,3889780657,3783520186,1672548002,1672550246,2244
3691,3970558632,3513041785,1672556306,1672559581,3275
3757,3817428320,3887243870,1672610611,1672610826,215
3690,3793868716,3713784974,1672612636,1672615356,2720
3899,3517590837,3334993594,1672675616,1672678680,3064
3685,3367971170,3714666884,1672694470,1672696610,2140
3714,3713911104,3248058676,1672550256,1672553019,2763
3441,3667673649,3516903528,1672651228,1672654667,3439
3430,3610870949,3703798634,1672686362,1672688443,2081
3814,3520322124,3935913584,1672575628,1672577770,2142
3819,3931627862,3667673649,1672656586,1672657651,1065
3811,3490214516,3974674109,1672547085,1672548630,1545
3495,3520764926,3514741348,1672536451,1672537947,1496
3597,3779425804,3367509761,1672620944,1672622377,1433
3922,3315279093,3667673649,1672666303,1672668983,2680
3689,3710489491,3855583256,1672661906,1672663145,1239
3623,3680810086,3533188828,1672685059,1672686054,995
3639,3895285664,3330340793,1672656479,1672657840,1361
3642,3510642075,3710854064,1672650604,1672654013,3409
3582,3734118023,3490029863,1672611098,1672614273,3175
3442,3452016771,3760640999,1672626074,1672629386,3312
3562,3776034743,3404025196,1672560705,1672563995,3290
3553,3835422146,3510767239,1672659939,1672660479,540
3803,3710854064,3779646172,1672623504,1672626947,3443
3717,3783163143,3520355798,1672541269,1672543823,2554
3507,3441348818,3520639768,1672641552,1672641965,413
3564,3615688740,3979784676,1672630270,1672632200,1930
3585,3757700712,3772391882,1672656867,1672657073,206
3438,3703348097,3732584121,1672692477,1672693579,1102
3486,3711077927,3276348699,1672580675,1672582996,2321
3656,3783373154,3757332128,1672614958,1672617350,2392
3845,3621184108,3229974066,1672674106,1672675382,1276
3836,3613416045,3510919821,1672634089,1672634163,74
3647,3793740407,3513295938,1672600237,1672603837,3600
3774,3299443125,3756746867,1672626355,1672629159,2804
3800,3500109249,3778040015,1672606776,1672609735,2959
3530,3428725843,3710496785,1672537264,1672539504,2240
3801,3369708250,3668747074,1672567928,1672568048,120
3662,3310039260,3800257590,1672564380,1672566691,2311
3502,3517697722,3367509761,1672670929,1672672346,1417
3438,3279339278,3773332082,1672617576,1672619869,2293
3635,3556969573,3757294769,1672559148,1672560081,933
3723,3414940786,3755532873,1672684241,1672687512,3271
3640,3454277788,3777694660,1672642212,1672645416,3204
3856,3445206685,3779738691,1672694439,1672697809,3370
3746,3372223551,3621184108,1672537481,1672537844,363
3825,3514419100,3231494505,1672675821,1672676865,1044
3762,3716272919,3774790271,1672627293,1672629882,2589
3913,3272030610,3792538417,1672571103,1672571590,487
3899,3779465522,3779938251,1672671832,1672675340,3508
3749,3972192593,3714120857,1672681233,1672682946,1713
3912,3431460073,3713784974,1672545759,1672547913,2154
3911,3713979100,3399518841,1672673377,1672674354,977
3785,3380767040,3513065217,1672604012,1672604419,407
3779,3792072681,3394401087,1672692843,1672695237,2394
3473,3755573472,3899786664,1672670139,1672672698,2559
3717,3668533536,3802932312,1672589495,1672592543,3048
3605,3357864626,3279473441,1672617183,1672620112,2929
3877,3703139663,3335694356,1672675835,1672678623,2788
3597,3909094917,3770468980,1672594340,1672595996,1656
3607,3716963089,3517590837,1672542728,1672543122,394
3558,3272030610,3299781901,1672624886,1672626510,1624
3534,3783801141,3826238375,1672680607,1672684011,3404
3902,3511843593,3774790271,1672643796,1672646991,3195
3681,3792274796,3631090677,1672670770,1672672157,1387
3478,3515439826,3232208416,1672540427,1672542163,1736
3448,3852686295,3384068080,1672620967,1672623809,2842
3680,3490029863,3200543880,1672629821,1672631635,1814
3804,3835985172,3512379024,1672532291,1672534632,2341
3547,3812534508,3783771827,1672663744,1672665873,2129
3795,3713911104,3701823816,1672634905,1672635947,1042
3659,3914691363,3495911207,1672662633,1672663687,1054
3559,3289114629,3898314440,1672559987,1672562266,2279
3785,3617489344,3519446663,1672664357,1672664899,542
3814,3552824113,3783615982,1672700628,1672702048,1420
3747,3714678331,3505402439,1672677461,1672678467,1006
3681,3793583656,3447514821,1672587395,1672588166,771
3676,3451326054,3500442734,1672605017,1672607065,2048
3577,3276003502,3817428320,1672562719,1672564773,2054
3477,3276217799,3772765746,1672686522,1672689594,3072
3621,3688490530,3829822608,1672567091,1672567816,725
3503,3780571086,3500613493,1672590860,1672594182,3322
3645,3792538417,3701424609,1672686362,1672688397,2035
3899,3408498208,3440107959,1672629545,1672632262,2717
3723,3457960571,3513018485,1672680574,1672683190,2616
3547,3703433819,3608232640,1672604127,1672604696,569
3585,3780209375,3783615982,1672634422,1672636422,2000
3534,3414275042,3512337405,1672564440,1672565783,1343
3465,3793315718,3512800570,1672611001,1672614313,3312
3734,3618697021,3505178849,1672670645,1672670859,214
3455,3491469603,3360616538,1672619939,1672621992,2053
3601,3777189898,3457960571,1672547391,1672549977,2586
3736,3310039260,3739895284,1672535082,1672535929,847
3831,3610358027,3970909253,1672689718,1672691388,1670
3611,3756474459,3713589994,1672533001,1672533101,100
3510,3617489344,3500915908,1672637273,1672640158,2885
3755,3200308999,3505995057,1672532300,1672534838,2538
3590,3439673892,3688220326,1672610982,1672613358,2376
3749,3472312341,3791046864,1672653530,1672656557,3027
3754,3714827719,3777184389,1672632646,1672634954,2308
3607,3938389661,3515439826,1672537131,1672540122,2991
3686,3770146716,3380767040,1672618381,1672619008,627
3787,3351696332,3418448389,1672699237,1672702111,2874
3835,3319167958,3279475486,1672532287,1672534177,1890
3637,3608855425,3298151889,1672613856,1672615673,1817
3613,3604589802,3373089838,1672563077,1672564092,1015
3914,3533090502,3773033649,1672655950,1672659185,3235
3913,3689697817,3293835352,1672670886,1672672612,1726
3445,3773027597,3774178201,1672681656,1672682240,584
3633,3906536154,3438489358,1672558248,1672560500,2252
3706,3500604680,3926643445,1672608207,1672609650,1443
3444,3680810086,3661447322,1672542077,1672544402,2325
3828,3792745809,3347419520,1672574790,1672576518,1728
3457,3533079336,3208452238,1672697397,1672698746,1349
3906,3428027649,3392943173,1672590490,1672591299,809
3914,3236458894,3760721303,1672576550,1672577952,1402
3677,3779613523,3436257398,1672539637,1672540757,1120
3586,3773837847,3613206049,1672687537,1672690324,2787
3656,3410600350,3336339664,1672555063,1672555903,840
3843,3776084820,3780322355,1672599869,1672602045,2176
3844,3520560590,3304971369,1672667538,1672668818,1280
3606,3533079336,3296462324,1672615198,1672615724,526
3635,3279473441,3793868716,1672571131,1672572214,1083
3880,3667673649,3774718695,1672534136,1672534305,169
3600,3793740407,3500341755,1672542402,1672543646,1244
3909,3533929349,3299781901,1672617318,1672618693,1375
3915,3900276517,3511005395,1672627193,1672629832,2639
3845,3779738691,3711637255,1672623454,1672626106,2652
3691,3280268483,3930242012,1672599814,1672602619,2805
3574,3272030610,3300979975,1672538613,1672540194,1581
3808,3447672935,3300229945,1672636402,1672637672,1270
3792,3701247948,3902760230,1672598580,1672601196,2616
3724,3688796737,3511791953,1672596539,1672598484,1945
3439,3770296583,3518194482,1672549196,1672550466,1270
3902,3520578796,3757903168,1672619395,1672620595,1200
3503,3885157459,3757318448,1672581285,1672584088,2803
3459,3552824113,3271454397,1672643262,1672646185,2923
3920,3777694660,3437286517,1672684973,1672685735,762
3557,3336627643,3900898992,1672651272,1672654133,2861
3522,3519909393,3380767040,1672628760,1672630703,1943
3840,3316800320,3510818674,1672698083,1672698434,351
3783,3440137407,3770624662,1672540872,1672544341,3469
3857,3505111292,3833217041,1672598052,1672600463,2411
3572,3755158925,3533423872,1672545553,1672547047,1494
3699,3490214516,3480490124,1672554505,1672556804,2299
3577,3774705415,3774605761,1672658468,1672659725,1257
3493,3792389522,3605221116,1672687787,1672689353,1566
3459,3500857494,3505434346,1672671159,1672674696,3537
3734,3514419100,3730071479,1672531216,1672534696,3480
3454,3814677862,3305336154,1672622365,1672625085,2720
3524,3412006598,3711097754,1672645719,1672648666,2947
3763,3836241528,3760721303,1672645211,1672645774,563
3598,3812534508,3416987084,1672541136,1672542950,1814
3549,3783340788,3624297844,1672661107,1672663187,2080
3615,3683113954,3928511283,1672644589,1672644735,146
3526,3710854064,3637313265,1672615303,1672617637,2334
3891,3772078494,3770676872,1672541418,1672542874,1456
3615,3630353876,3392943173,1672629182,1672630633,1451
3447,3836241528,3517288083,1672697909,1672700362,2453
3451,3620292035,3497808662,1672672590,1672674011,1421
3699,3288224595,3374183227,1672663008,1672664641,1633
3473,3510187271,3715854030,1672541592,1672542631,1039
3806,3349739136,3511442562,1672663471,1672663996,525
3819,3500347447,3279339278,1672652939,1672655477,2538
3702,3928511283,3245232284,1672634790,1672636429,1639
3763,3760364383,3431502855,1672642856,1672643628,772
3870,3836241528,3703433819,1672647592,1672647670,78
3501,3283144118,3617304541,1672701267,1672701607,340
3615,3510798825,3452016771,1672675751,1672677379,1628
3685,3713979100,3615087943,1672632632,1672635133,2501
3587,3399472693,3783147088,1672632668,1672634430,1762
3477,3770704999,3739911441,1672560250,1672560888,638
3718,3660063072,3279242917,1672668305,1672671459,3154
3879,3783520186,3501459390,1672590302,1672590832,530
3619,3505807416,3280268483,1672614704,1672617720,3016
3578,3517687662,3385323994,1672588098,1672590086,1988
3763,3710854064,3435167810,1672698825,1672700813,1988
3452,3515559913,3431502855,1672686724,1672688983,2259
3494,3778667336,3927403123,1672683104,1672683789,685
3816,3793969543,3774733620,1672681918,1672683406,1488
3863,3511442562,3814677862,1672557944,1672558058,114
3830,3621790707,3513327337,1672702602,1672703702,1100
3872,3607768197,3380982774,1672699101,1672702080,2979
3723,3500915908,3230868435,1672671797,1672675319,3522
3532,3885121158,3500703304,1672631836,1672634134,2298
3808,3505847380,3505807416,1672580578,1672582893,2315
3498,3383138270,3248058676,1672640512,1672641206,694
3913,3931627862,3438489358,1672547227,1672550351,3124
3899,3979784676,3814677862,1672541206,1672542784,1578
3906,3200308999,3609113156,1672607325,1672608440,1115
3466,3739895284,3519087371,1672615483,1672615744,261
3596,3505178849,3715974659,1672593649,1672595896,2247
3701,3791246640,3414940786,1672675273,1672677432,2159
3554,3400763927,3779613523,1672558282,1672558867,585
3579,3514956366,3618808151,1672567471,1672568006,535
3533,3833217041,3520322124,1672554393,1672556603,2210
3845,3710562338,3685816610,1672690146,1672692505,2359
3690,3203538212,3915162005,1672570651,1672571271,620
3538,3516741440,3770520359,1672649269,1672651598,2329
3588,3902861231,3905196766,1672669570,1672672660,3090
3723,3509893027,3715974659,1672699185,1672699675,490
3699,3713911104,3713911104,1672589591,1672590786,1195
3834,3415833929,3533929349,1672650042,1672652042,2000
3467,3380130228,3927403123,1672657599,1672661106,3507
3604,3559731671,3776244398,1672700637,1672701270,633
3831,3760842815,3500498112,1672579331,1672579862,531
3849,3755756564,3615737355,1672539636,1672542042,2406
3890,3714233826,3512830734,1672615320,1672616452,1132
3723,3791796585,3516703758,1672680339,1672681128,789
3464,3481640525,3807212280,1672607727,1672610094,2367
3494,3829864515,3291933594,1672557816,1672560155,2339
3891,3401496246,3505266860,1672637387,1672640665,3278
3722,3409114719,3834631333,1672590061,1672593397,3336
3576,3285204083,3208957949,1672670862,1672674029,3167
3701,3366423342,3621683102,1672585105,1672585645,540
3553,3783340788,3445206685,1672652663,1672655333,2670
3903,3505402439,3276269264,1672627414,1672630966,3552
3653,3889780657,3371455553,1672697536,1672698091,555
3909,3367111751,3520639768,1672558960,1672561494,2534
3754,3288224595,3495911207,1672632858,1672634634,1776
3785,3457620713,3821054646,1672539296,1672539780,484
3560,3793969543,3513853403,1672685028,1672686197,1169
3561,3364378127,3680810086,1672650192,1672650661,469
3698,3930242012,3625174002,1672618938,1672619514,576
3794,3774641380,3770438122,1672684741,1672687673,2932
3792,3783373154,3899786664,1672684309,1672685382,1073
3458,3367111751,3479851674,1672684113,1672685982,1869
3467,3351866415,3625174002,1672567986,1672571243,3257
3890,3776988674,3336339664,1672601210,1672603377,2167
3808,3714120857,3711097754,1672538951,1672539703,752
3454,3450286949,3514818819,1672608349,1672610812,2463
3494,3244004456,3773837847,1672606292,1672607843,1551
3605,3500498112,3713163045,1672615212,1672616512,1300
3523,3834960360,3392836218,1672668229,1672670310,2081
3756,3370227921,3686227677,1672616707,1672616931,224
3531,3319167958,3509764635,1672684984,1672687653,2669
3572,3661903000,3757700712,1672631322,1672632804,1482
3499,3971806004,3533274994,1672677726,1672679111,1385
3500,3711006062,3225636215,1672568335,1672570126,1791
3573,3760364383,3814305099,1672692052,1672694500,2448
3751,3490214516,3334993594,1672543515,1672546721,3206
3851,3627368399,3515890966,1672604440,1672605613,1173
3442,3445206685,3431460073,1672639347,1672642934,3587
3748,3512722110,3436257398,1672578029,1672579487,1458
3687,3703396825,3367971170,1672665936,1672669038,3102
3525,3621184108,3906536154,1672561584,1672565117,3533
3605,3923420131,3510554314,1672623482,1672625343,1861
3480,3534829213,3814677862,1672605383,1672606418,1035
3586,3783641602,3757075324,1672539326,1672540086,760
3635,3519087371,3334647380,1672546493,1672548271,1778
3766,3505437712,3703348097,1672655384,1672658642,3258
3809,3760640999,3205923620,1672600695,1672603929,3234
3857,3755573472,3615087943,1672694764,1672697564,2800
3888,3513410578,3856606678,1672552542,1672553231,689
3805,3817428320,3312998540,1672621564,1672624960,3396
3478,3757903168,3367509761,1672553077,1672553472,395
3458,3770236215,3557046880,1672534878,1672538330,3452
3503,3792801638,3619922891,1672605104,1672605432,328
3549,3792745809,3715986185,1672666841,1672667949,1108
3865,3285204083,3777240360,1672667498,1672667944,446
3821,3514703118,3512392431,1672686558,1672687572,1014
3474,3979784676,3517590837,1672665775,1672668790,3015
3676,3756474459,3226511603,1672635658,1672637926,2268
3770,3270697740,3510818674,1672620903,1672623911,3008
3571,3201800997,3887243870,1672547782,1672549209,1427
3567,3777037426,3755915206,1672559481,1672562487,3006
3853,3225631197,3932478321,1672653815,1672657254,3439
3620,3926643445,3608922867,1672702312,1672704947,2635
3897,3288224595,3398731252,1672688308,1672691593,3285
3875,3201676087,3227799827,1672625891,1672627759,1868
3891,3518565331,3517358573,1672561399,1672562210,811
3636,3500703304,3316800320,1672610238,1672611030,792
3551,3383138270,3927165965,1672576000,1672578916,2916
3669,3513295938,3923220461,1672585795,1672587509,1714
3579,3533274994,3412006598,1672622235,1672622934,699
3895,3774243020,3887243870,1672573123,1672576556,3433
3555,3617116290,3711006062,1672532408,1672533389,981
3631,3793868716,3289817992,1672698108,1672701682,3574
3511,3451326054,3887243870,1672579400,1672582693,3293
3556,3777485931,3424660806,1672631961,1672632358,397
3916,3311098437,3229822507,1672654508,1672655916,1408
3733,3792745809,3448633776,1672646506,1672646760,254
3477,3534566651,3683113954,1672543229,1672543752,523
3495,3608232640,3305722859,1672696319,1672697573,1254
3513,3208452238,3360813161,1672676547,1672676862,315
3643,3316800320,3375449013,1672583301,1672586516,3215
3554,3556969573,3668747074,1672553307,1672554628,1321
3657,3416987084,3608855425,1672554259,1672557684,3425
3764,3500841914,3975717896,1672670006,1672670738,732
3791,3441348818,3975717896,1672647299,1672649367,2068
3570,3512722110,3380767040,1672534184,1672537183,2999
3884,3438489358,3276269264,1672693841,1672697387,3546
3775,3680843171,3773837847,1672587897,1672589032,1135
3749,3713911104,3757863420,1672614547,1672615377,830
3659,3773027597,3605221116,1672580571,1672583926,3355
3571,3370068529,3305336154,1672642016,1672642756,740
3897,3310039260,3792801638,1672596558,1672598145,1587
3676,3900945856,3306412634,1672616201,1672619004,2803
3635,3334951866,3390660440,1672674708,1672674769,61
3793,3500915908,3779738691,1672640688,1672642332,1644
3870,3716963089,3779892400,1672539990,1672542355,2365
3662,3457960571,3635169815,1672579777,1672580839,1062
3790,3284932450,3447514821,1672639235,1672641575,2340
3841,3462636434,3516703758,1672567968,1672568228,260
3614,3510837901,3520873221,1672566771,1672570287,3516
3706,3362641275,3304155815,1672686396,1672688137,1741
3722,3534179433,3793969543,1672568072,1672571087,3015
3527,3519651506,3518653080,1672667740,1672670359,2619
3770,3410600350,3778134418,1672534196,1672535041,845
3877,3711853996,3774031303,1672643222,1672644020,798
3835,3897435944,3472068734,1672540042,1672543278,3236
3560,3380130228,3516903528,1672633261,1672634681,1420
3621,3711006062,3414049538,1672690742,1672693505,2763
3797,3791441520,3777779869,1672660948,1672664044,3096
3735,3448633776,3619922891,1672648027,1672651533,3506
3788,3713941638,3224811762,1672621865,1672625414,3549
3866,3283770991,3760645796,1672557546,1672558467,921
3813,3609113156,3621184108,1672549800,1672552520,2720
3475,3510642075,3517172354,1672638575,1672640190,1615
3519,3755222916,3512383699,1672608028,1672611586,3558
3625,3777624586,3341893384,1672540329,1672541101,772
3737,3309314379,3435116799,1672643189,1672646703,3514
3448,3500672156,3915162005,1672616646,1672620109,3463
3749,3448875382,3970198861,1672625753,1672626705,952
3727,3337362061,3783373154,1672665535,1672668274,2739
3454,3517222913,3500703304,1672700418,1672700536,118
3825,3408430195,3514512367,1672649018,1672649199,181
3468,3513545422,3856606678,1672533841,1672536016,2175
3643,3510919821,3383138270,1672554708,1672556692,1984
3579,3398731252,3760694096,1672702893,1672705433,2540
3816,3858172636,3609113156,1672596634,1672598044,1410
3675,3773913680,3777184389,1672651798,1672652436,638
3801,3291933594,3793740407,1672661629,1672662471,842
3576,3831586487,3424445495,1672566153,1672566882,729
3787,3776518452,3500044458,1672539132,1672542422,3290
3771,3688490530,3803517637,1672544014,1672545313,1299
3465,3780209375,3780209375,1672646822,1672647181,359
3629,3714067076,3613206049,1672681685,1672683189,1504
3443,3367509761,3773027597,1672640174,1672641120,946
3637,3438078818,3449333754,1672656767,1672659810,3043
3477,3284932450,3637313265,1672673313,1672674706,1393
3760,3225636215,3793407963,1672607547,1672608178,631
3726,3829822608,3792505974,1672615297,1672617761,2464
3911,3859868849,3815250107,1672559091,1672561564,2473
3921,3780209375,3774718695,1672692071,1672692684,613
3901,3360813161,3351696332,1672541906,1672544596,2690
3829,3739911441,3294703680,1672584349,1672584883,534
3510,3630353876,3412968120,1672616645,1672620197,3552
3604,3935913584,3554825448,1672652501,1672653435,934
3744,3487875183,3288224595,1672677334,1672680055,2721
3857,3779646172,3757383891,1672595253,1672596503,1250
3628,3774733620,3714233826,1672665692,1672665951,259
3750,3512958459,3783169442,1672537142,1672538881,1739
3663,3811075491,3791106564,1672600152,1672601660,1508
3507,3515525630,3823084403,1672667683,1672668421,738
3432,3533368789,3780712350,1672650715,1672653415,2700
3817,3710048469,3248058676,1672602693,1672605211,2518
3618,3615688740,3780209375,1672617762,1672621001,3239
3476,3792014516,3493017654,1672599621,1672601832,2211
3913,3337362061,3497671225,1672533495,1672537093,3598
3499,3500777439,3777779869,1672534473,1672535164,691
3593,3773837847,3492959689,1672682046,1672683621,1575
3759,3757700712,3609113156,1672686677,1672686751,74
3706,3469254160,3760842815,1672533994,1672537576,3582
3458,3609659642,3824215187,1672614215,1672617214,2999
3830,3490214516,3513065217,1672572385,1672575595,3210
3505,3510767239,3904569677,1672534453,1672534719,266
3881,3735374579,3791753345,1672593950,1672595371,1421
3893,3621461051,3226178937,1672702623,1672705092,2469
3677,3519087371,3517288083,1672668668,1672668865,197
3753,3902760230,3499217428,1672575540,1672577722,2182
3521,3783771827,3300979975,1672539838,1672541230,1392
3820,3779854934,3500949309,1672597164,1672599725,2561
3526,3714827719,3334647380,1672600204,1672603441,3237
3486,3418448389,3485540729,1672675027,1672677794,2767
3634,3715545685,3228888030,1672581703,1672584566,2863
3836,3357864626,3715854030,1672599931,1672602444,2513
3828,3224968597,3500109249,1672692892,1672695493,2601
3431,3315703693,3272096759,1672634394,1672635502,1108
3552,3386758279,3774790271,1672663511,1672664387,876
3837,3294703680,3892304880,1672599981,1672601798,1817
3506,3793583656,3360069849,1672666401,1672668129,1728
3758,3779425804,3357289672,1672549334,1672550826,1492
3467,3438078818,3713911104,1672547057,1672548083,1026
3448,3396980894,3551376095,1672696154,1672697949,1795
3478,3455018347,3343816795,1672550648,1672554235,3587
3502,3737112297,3755230952,1672533840,1672534237,397
3451,3303410628,3501459390,1672672436,1672675818,3382
3651,3885537225,3780209375,1672577746,1672578594,848
3753,3382733096,3779854934,1672542075,1672545340,3265
3617,3714666884,3713589994,1672537980,1672540512,2532
3793,3608855425,3897134762,1672700386,1672703794,3408
3486,3510641433,3240394404,1672590724,1672591624,900
3682,3834963772,3500347447,1672579299,1672579457,158
3596,3686227677,3792505974,1672648447,1672650628,2181
3424,3734451191,3519282716,1672538461,1672538678,217
3896,3909094917,3773572967,1672535482,1672538204,2722
3438,3835422146,3683113954,1672578766,1672582337,3571
3579,3462636434,3512830734,1672618478,1672621409,2931
3619,3460719322,3428027649,1672606156,1672606969,813
3841,3276003502,3615688740,1672695178,1672696091,913
3735,3778926763,3710496785,1672642047,1672644837,2790
3705,3900945856,3777814504,1672539259,1672540447,1188
3875,3456430614,3688220326,1672614497,1672614800,303
3654,3520322124,3514512367,1672701013,1672702977,1964
3703,3362641275,3755065949,1672685763,1672687126,1363
3886,3412968120,3511601997,1672657436,1672658867,1431
3815,3513360004,3294747828,1672642996,1672646282,3286
3548,3689697817,3773027597,1672699352,1672702592,3240
3755,3770146716,3209526819,1672685372,1672686267,895
3556,3780253901,3360813161,1672658862,1672662065,3203
3829,3533649454,3760651515,1672651150,1672651377,227
3494,3311098437,3780472203,1672571259,1672574755,3496
3535,3774790271,3777624586,1672600194,1672601506,1312
3727,3757323954,3891672228,1672640052,1672642579,2527
3739,3834960360,3972083617,1672593458,1672595509,2051
3678,3227799827,3501281016,1672637796,1672639422,1626
3581,3236354255,3757383891,1672595254,1672597930,2676
3639,3932478321,3778134418,1672561964,1672563900,1936
3726,3892304880,3515402792,1672611119,1672611794,675
3549,3512800570,3519416013,1672637205,1672639707,2502
3474,3509893027,3928511283,1672555983,1672556639,656
3855,3398198430,3516903528,1672665626,1672666493,867
3731,3401496246,3334974375,1672669000,1672672362,3362
3809,3668533536,3511843593,1672565770,1672569103,3333
3705,3520416075,3513295938,1672636699,1672639551,2852
3518,3970603231,3780209375,1672657773,1672658439,666
3590,3779639983,3793868716,1672683626,1672685301,1675
3883,3300979975,3900898992,1672644148,1672647120,2972
3654,3755915206,3792274796,1672579759,1672582021,2262
3504,3970909253,3334951866,1672599332,1672602572,3240
3511,3734915241,3760263530,1672573050,1672575488,2438
3875,3780115155,3711218296,1672532449,1672535946,3497
3639,3272096759,3770676872,1672557978,1672560369,2391
3461,3236354255,3774876004,1672609212,1672611288,2076
3491,3703798634,3240994288,1672594115,1672594696,581
3634,3424445495,3970603231,1672680106,1672680378,272
3436,3774907131,3497095254,1672571382,1672573574,2192
3819,3533090502,3501786419,1672690260,1672690675,415
3921,3513081354,3773027597,1672582973,1672584947,1974
3740,3688796737,3500072204,1672633155,1672635915,2760
3881,3931627862,3756474459,1672690918,1672691956,1038
3652,3772391882,3779639983,1672577131,1672579194,2063
3665,3715619259,3205985903,1672579857,1672582478,2621
3785,3627368399,3500703304,1672659596,1672662916,3320
3596,3920898925,3850911686,1672546414,1672548914,2500
3909,3685816610,3625463628,1672601329,1672601986,657
3641,3780322355,3713691388,1672610961,1672612794,1833
3628,3500777439,3610870949,1672553583,1672556100,2517
3897,3431502855,3792949946,1672636137,1672638845,2708
3624,3478114114,3445206685,1672624187,1672624554,367
3705,3357289672,3777037426,1672620235,1672620450,215
3718,3472312341,3305336154,1672572919,1672576202,3283
3501,3505481368,3710496785,1672549690,1672550516,826
3905,3421877923,3441348818,1672592648,1672595630,2982
3465,3713691388,3451726367,1672543569,1672545629,2060
3592,3556969573,3514324011,1672610019,1672613382,3363
3734,3500672156,3897376951,1672543185,1672544293,1108
3796,3715619259,3665998641,1672621283,1672621818,535
3835,3779425804,3513041785,1672625478,1672625807,329
3431,3613416045,3510028805,1672679457,1672681675,2218
3583,3935487534,3375449013,1672557558,1672558295,737
3750,3927599181,3533929349,1672566506,1672567024,518
3469,3927403123,3533649454,1672531990,1672534807,2817
3756,3897376951,3783163143,1672639190,1672642010,2820
3589,3791693821,3518561777,1672600439,1672603466,3027
3655,3779656423,3520560590,1672539175,1672540637,1462
3816,3779646172,3689114185,1672648465,1672649939,1474
3638,3411688875,3684523966,1672601904,1672605190,3286
3759,3757294769,3445206685,1672575858,1672578565,2707
3459,3710735406,3773033649,1672630527,1672631992,1465
3725,3241914067,3716272919,1672547374,1672549396,2022
3811,3792538417,3701664364,1672675072,1672678515,3443
3642,3516489668,3776244398,1672607620,1672610285,2665
3843,3970627281,3711077927,1672598091,1672599155,1064
3794,3613416045,3421385957,1672568867,1672569535,668
3820,3680843171,3734915241,1672658999,1672662505,3506
3610,3783147088,3500317969,1672693071,1672694934,1863
3683,3438078818,3500498112,1672575336,1672577068,1732
3822,3829822608,3777694660,1672674621,1672677298,2677
3437,3608855425,3732584121,1672657214,1672658985,1771
3445,3520181148,3755065949,1672608958,1672611975,3017
3864,3780872464,3414275042,1672693558,1672693712,154
3494,3440137407,3783641602,1672701833,1672702424,591
3900,3773121782,3683113954,1672662468,1672663755,1287
3476,3357689359,3343132529,1672614721,1672615780,1059
3920,3773009828,3510554314,1672650221,1672651870,1649
3528,3490214516,3780571086,1672702845,1672703656,811
3773,3279473441,3730071479,1672682638,1672682840,202
3647,3330340793,3714185969,1672556167,1672558023,1856
3687,3715707380,3499217428,1672584133,1672587263,3130
3484,3493017654,3276348699,1672674224,1672674322,98
3888,3276269264,3534126409,1672645586,1672646274,688
3882,3520181148,3410160376,1672571707,1672572736,1029
3914,3701373490,3733558985,1672683909,1672684299,390
3463,3853629553,3311049964,1672658023,1672658905,882
3841,3815392801,3512282789,1672698779,1672701927,3148
3831,3793740407,3909094917,1672576240,1672577233,993
3547,3734451191,3715986185,1672531292,1672533205,1913
3570,3770676872,3710008361,1672676816,1672677642,826
3880,3713784974,3815250107,1672581475,1672581555,80
3713,3793407963,3834963772,1672643119,1672644334,1215
3883,3612689556,3779646172,1672689097,1672690684,1587
3772,3660063072,3299125059,1672614418,1672617424,3006
3874,3812369928,3488763230,1672593677,1672596818,3141
3888,3617489344,3780322355,1672604336,1672604931,595
3908,3779425804,3334647380,1672550498,1672553481,2983
3573,3737112297,3793407963,1672548024,1672549266,1242
3673,3703798634,3279473441,1672566189,1672568531,2342
3816,3770468980,3636329663,1672626995,1672627956,961
3460,3334951866,3500442734,1672612189,1672614881,2692
3527,3793740407,3711077927,1672630655,1672631119,464
3438,3534126409,3772391882,1672550410,1672550805,395
3839,3921648519,3396980894,1672564248,1672564804,556
3840,3733558985,3760263530,1672584146,1672584969,823
3777,3933894942,3756789525,1672634370,1672635297,927
3427,3604589802,3304155815,1672602733,1672605799,3066
3673,3518229776,3927403123,1672626763,1672627976,1213
3887,3829822608,3303410628,1672600446,1672601809,1363
3908,3201629017,3777240360,1672659819,1672660916,1097
3526,3755230952,3711637255,1672675450,1672675581,131
3593,3515525630,3938503547,1672575150,1672578186,3036
3585,3515466096,3517358573,1672645240,1672647544,2304
3683,3893912331,3732131656,1672566595,1672569475,2880
3447,3773913680,3923220461,1672582481,1672585083,2602
3611,3970198861,3451726367,1672611651,1672612395,744
3830,3905196766,3604867757,1672628369,1672631751,3382
3715,3760094385,3734118023,1672623286,1672625717,2431
3461,3513327337,3713784974,1672617558,1672620728,3170
3863,3892304880,3428725843,1672675891,1672678100,2209
3670,3715086894,3516489668,1672622016,1672623969,1953
3675,3438489358,3230135532,1672603294,1672604992,1698
3525,3505847380,3520657891,1672612691,1672615481,2790
3618,3624297844,3511732493,1672606428,1672607693,1265
3744,3450969839,3970603231,1672692047,1672693302,1255
3871,3385323994,3621461051,1672600886,1672603543,2657
3553,3770624662,3715974659,1672620215,1672620808,593
3760,3533090502,3488763230,1672562901,1672563024,123
3562,3505888598,3812369928,1672686383,1672689412,3029
3811,3284932450,3900898992,1672586516,1672587705,1189
3520,3457620713,3428027649,1672596125,1672597316,1191
3824,3880926355,3714185969,1672593417,1672595077,1660
3862,3305336154,3246370118,1672546355,1672547802,1447
3908,3852686295,3792489602,1672668052,1672670663,2611
3611,3716110860,3835985172,1672570284,1672572392,2108
3847,3447672935,3757318448,1672578979,1672580794,1815
3627,3776831527,3734451191,1672578299,1672580567,2268
3566,3935487534,3791796585,1672652921,1672655390,2469
3450,3520639768,3520764926,1672604842,1672608302,3460
3614,3517881647,3500613459,1672578008,1672579242,1234
3564,3231713082,3513360004,1672558029,1672559101,1072
3439,3701664364,3776244398,1672612762,1672613319,557
3566,3715443333,3608855425,1672604377,1672607152,2775
3841,3777037426,3520764926,1672688453,1672690953,2500
3780,3428027649,3850911686,1672667115,1672669191,2076
3428,3757075324,3347446226,1672690053,1672692501,2448
3449,3394297564,3770236215,1672645740,1672646695,955
3499,3513295938,3505481368,1672657392,1672660838,3446
3876,3512337405,3500109249,1672696129,1672699471,3342
3539,3935399379,3734118023,1672670691,1672673582,2891
3869,3710008361,3609659642,1672598808,1672600019,1211
3516,3505521218,3858172636,1672576848,1672577169,321
3530,3668414677,3818575661,1672669205,1672672749,3544
3658,3209526819,3923754072,1672634470,1672635409,939
3446,3455018347,3510818674,1672550049,1672552838,2789
3619,3715086894,3514324011,1672541442,1672544579,3137
3520,3519142371,3760040019,1672678232,1672680593,2361
3765,3500613493,3402385957,1672599414,1672601814,2400
3547,3778667336,3520560590,1672637887,1672638222,335
3756,3604589802,3309314379,1672555516,1672557178,1662
3857,3500525825,3776518452,1672545124,1672547390,2266
3492,3513327337,3714185969,1672590410,1672591665,1255
3605,3611055563,3200308999,1672689706,1672692785,3079
3699,3533368789,3424660806,1672670461,1672673003,2542
3544,3270056120,3711734586,1672649080,1672652356,3276
3740,3791613604,3449639012,1672685254,1672685641,387
3728,3334951866,3622357348,1672652867,1672653293,426
3869,3417191856,3500857494,1672635100,1672635859,759
3674,3756746867,3225636215,1672631481,1672635051,3570
3889,3459681410,3510818674,1672627591,1672627725,134
3827,3410160376,3500302272,1672576768,1672580263,3495
3675,3517687662,3421877923,1672598892,1672599416,524
3908,3533368789,3516513251,1672689023,1672689541,518
3538,3551399764,3904569677,1672647309,1672650006,2697
3546,3779532653,3394401087,1672585248,1672585906,658
3902,3408498208,3469254160,1672608912,1672609262,350
3685,3533188828,3834963772,1672592208,1672593840,1632
3736,3515439826,3834631333,1672671048,1672672131,1083
3578,3500044458,3902625986,1672669511,1672672015,2504
3611,3370227921,3755992176,1672571910,1672572670,760
3484,3505283390,3334993594,1672547129,1672548867,1738
3568,3424660806,3512383699,1672602115,1672605551,3436
3818,3802932312,3701005527,1672639863,1672640977,1114
3755,3447672935,3513410578,1672696766,1672700231,3465
3662,3512379024,3311049964,1672593127,1672594550,1423
3679,3230135532,3505807416,1672635958,1672637449,1491
3872,3923754072,3760651515,1672692586,1672694243,1657
3484,3500604680,3209526819,1672634246,1672637287,3041
3521,3386758279,3516741440,1672682281,1672683611,1330
3789,3701823816,3639050419,1672540003,1672543249,3246
3789,3500777439,3276348699,1672630331,1672632103,1772
3705,3514334067,3492546679,1672619375,1672620580,1205
3706,3773027597,3396726504,1672636602,1672639743,3141
3856,3469254160,3715986185,1672694981,1672695831,850
3599,3925979970,3793935736,1672662524,1672665739,3215
3710,3513041785,3509366311,1672658438,1672660521,2083
3899,3288224595,3438078818,1672628038,1672631604,3566
3800,3792274796,3668414677,1672649227,1672651873,2646
3776,3520873221,3510642075,1672666379,1672666986,607
3571,3462273042,3757318448,1672593160,1672596658,3498
3832,3312998540,3272030610,1672640657,1672642966,2309
3729,3777814504,3519446663,1672648669,1672649284,615
3493,3500302272,3774155692,1672590669,1672593877,3208
3506,3927599181,3510641433,1672557992,1672561342,3350
3654,3505283390,3668414677,1672671054,1672673221,2167
3487,3680843171,3739895284,1672580314,1672581639,1325
3793,3783163143,3510187271,1672556441,1672556679,238
3626,3701823816,3411515369,1672686696,1672689315,2619
3427,3777485931,3533274994,1672541595,1672544177,2582
3572,3660063072,3279242917,1672552035,1672555430,3395
3884,3710048469,3229822507,1672581990,1672582206,216
3767,3505198734,3850911686,1672564793,1672564994,201
3577,3791436104,3613416045,1672682947,1672685293,2346
3488,3279475486,3791436104,1672622262,1672624138,1876
3449,3231713082,3780834916,1672607077,1672610650,3573
3746,3923420131,3515525630,1672573315,1672575736,2421
3489,3283492940,3680843171,1672535872,1672536044,172
3511,3734915241,3815250107,1672683927,1672684249,322
3595,3714666884,3773124276,1672680503,1672681791,1288
3485,3382733096,3517222913,1672641059,1672643590,2531
3766,3428027649,3812369928,1672547820,1672550641,2821
3881,3755915206,3739154408,1672702631,1672702866,235
3681,3401496246,3516321888,1672614725,1672616435,1710
3696,3490214516,3500709774,1672572263,1672575212,2949
3577,3347446226,3776988674,1672639421,1672641547,2126
3448,3701247948,3516903528,1672692927,1672694406,1479
3612,3284947372,3500915908,1672531470,1672532523,1053
3602,3714678331,3515525630,1672573984,1672575633,1649
3579,3701373490,3661447322,1672633032,1672633481,449
3654,3928511283,3713768950,1672615644,1672617952,2308
3480,3791796585,3357689359,1672671628,1672672596,968
3454,3231713082,3756704774,1672700829,1672702889,2060
3730,3622665543,3446533960,1672592858,1672593892,1034
3756,3431460073,3505663516,1672548651,1672551237,2586
3606,3448633776,3609659642,1672684021,1672686900,2879
3436,3372223551,3703348097,1672681235,1672684175,2940
3686,3823084403,3246370118,1672566758,1672567852,1094
3655,3505283390,3852533643,1672608833,1672611984,3151
3466,3241790910,3716963089,1672631031,1672631802,771
3509,3241914067,3938389661,1672614138,1672615266,1128
3509,3757700712,3716963089,1672539447,1672540447,1000
3740,3500347447,3513041785,1672541741,1672543565,1824
3850,3902861231,3436257398,1672550156,1672551704,1548
3745,3514818819,3977352557,1672563868,1672564150,282
3748,3276269264,3511843593,1672679028,1672680159,1131
3766,3533368789,3392943173,1672610122,1672610846,724
3585,3500915908,3977352557,1672575349,1672575623,274
3920,3533079336,3711006062,1672630453,1672631003,550
3476,3501121099,3289817992,1672700142,1672700320,178
3862,3735374579,3515402792,1672564832,1672566856,2024
3906,3716679950,3665998641,1672644183,1672645907,1724
3891,3459681410,3505634634,1672533651,1672536449,2798
3688,3713829743,3780571086,1672585829,1672585970,141
3655,3701322924,3511024016,1672648655,1672649440,785
3561,3517222913,3607882826,1672680171,1672680330,159
3613,3396726504,3510499038,1672542393,1672543923,1530
3694,3396726504,3850911686,1672677918,1672678525,607
3833,3271752081,3305722859,1672648160,1672648955,795
3567,3520560590,3492959689,1672580911,1672584486,3575
3626,3230868435,3791436104,1672646458,1672647935,1477
3864,3660887799,3370068529,1672614381,1672616299,1918
3679,3202804048,3739661856,1672544634,1672545565,931
3878,3208957949,3792389522,1672697116,1672699486,2370
3563,3447672935,3777779869,1672586470,1672589197,2727
3565,3783520186,3814305099,1672540344,1672541119,775
3559,3372223551,3415833929,1672545384,1672548552,3168
3657,3245232284,3711637255,1672695711,1672697977,2266
3772,3780472203,3684523966,1672610937,1672613210,2273
3643,3500737582,3887243870,1672541847,1672545361,3514
3517,3272030610,3710008361,1672699830,1672700219,389
3871,3733363628,3505634634,1672665015,1672668362,3347
3770,3411688875,3312998540,1672631199,1672633490,2291
3726,3915162005,3209481722,1672623149,1672624522,1373
3885,3401940259,3274831810,1672569265,1672570168,903
3562,3488686442,3739661856,1672610274,1672612931,2657
3858,3311049964,3289817992,1672539917,1672543249,3332
3425,3773572967,3294747828,1672668358,1672670855,2497
3493,3773121782,3284932450,1672559423,1672561478,2055
3469,3711077927,3779854934,1672661807,1672664594,2787
3539,3455018347,3431460073,1672613408,1672616156,2748
3631,3517462308,3475349791,1672647411,1672648955,1544
3794,3431460073,3755532873,1672644589,1672646128,1539
3840,3500613459,3372223551,1672671862,1672674372,2510
3590,3394297564,3514324011,1672662792,1672662948,156
3899,3551399764,3383138270,1672576887,1672577411,524
3854,3360813161,3306412634,1672641093,1672644466,3373
3898,3514285803,3276003502,1672651490,1672652402,912
3647,3551389192,3779301501,1672678213,1672681529,3316
3873,3450969839,3899326793,1672657082,1672658398,1316
3493,3774705415,3792489602,1672683076,1672686315,3239
3609,3533649454,3231494505,1672548978,1672549333,355
3749,3312998540,3460719322,1672669013,1672669855,842
3695,3793922324,3739154408,1672678354,1672681677,3323
3743,3668747074,3793969543,1672670286,1672672011,1725
3586,3970603231,3757318448,1672658644,1672660463,1819
3618,3533228966,3711853996,1672591344,1672594090,2746
3529,3488763230,3516489668,1672659779,1672663252,3473
3692,3685681577,3533228966,1672648383,1672650134,1751
3611,3505111292,3703139663,1672652702,1672654770,2068
3815,3520322124,3618176292,1672635942,1672638370,2428
3893,3818575661,3334647380,1672666224,1672667015,791
3726,3510499038,3916490839,1672627065,1672629178,2113
3492,3337322736,3512800570,1672700697,1672700817,120
3506,3516741440,3410160376,1672559664,1672562900,3236
3865,3710048469,3396980894,1672651414,1672652862,1448
3674,3316798920,3520181148,1672638361,1672639001,640
3830,3512379024,3516513251,1672628466,1672629941,1475
3767,3511791953,3511005395,1672540771,1672543362,2591
3724,3615115210,3500672156,1672644456,1672646765,2309
3769,3757903168,3793868716,1672620802,1672623186,2384
3710,3715545685,3309314379,1672627844,1672628943,1099
3909,3505847380,3920898925,1672647785,1672648591,806
3825,3475349791,3774290799,1672695938,1672697450,1512
3892,3399518841,3710315160,1672540925,1672543076,2151
3460,3826238375,3436025562,1672537049,1672540051,3002
3729,3435116799,3306412634,1672623611,1672624074,463
3674,3819767045,3711812325,1672702381,1672702528,147
3527,3716679950,3469254160,1672610995,1672613634,2639
3804,3734451191,3363162590,1672575331,1672577393,2062
3497,3516741440,3852533643,1672544228,1672546066,1838
3747,3511791953,3306175858,1672678997,1672681128,2131
3749,3202804048,3533929349,1672686697,1672687565,868
3803,3512379024,3609659642,1672609523,1672610964,1441
3659,3783550022,3713561276,1672613093,1672616437,3344
3901,3715974659,3892304880,1672656333,1672657147,814
3669,3757294769,3400763927,1672593769,1672596000,2231
3478,3770236215,3783163143,1672675037,1672677938,2901
3666,3491469603,3892304880,1672673152,1672673245,93
3859,3447672935,3288762795,1672625008,1672625146,138
3639,3776518452,3667673649,1672534104,1672534293,189
3853,3757630221,3534543776,1672536641,1672539790,3149
3675,3835422146,3970198861,1672549444,1672552100,2656
3847,3534175249,3279242917,1672557112,1672558927,1815
3456,3701322924,3760842815,1672675922,1672676279,357
3498,3935913584,3408498208,1672592051,1672593464,1413
3908,3409114719,3460719322,1672536682,1672538664,1982
3746,3608232640,3734915241,1672569823,1672570376,553
3763,3897435944,3239617320,1672596777,1672599855,3078
3596,3333918941,3783550022,1672638254,1672639986,1732
3723,3893912331,3517697722,1672682996,1672683977,981
3905,3835422146,3779892400,1672673326,1672674402,1076
3664,3398198430,3505178849,1672676656,1672678051,1395
3578,3703348097,3480726047,1672643710,1672646525,2815
3830,3756474459,3451691949,1672571122,1672571387,265
3519,3517887477,3519142371,1672621192,1672622828,1636
3852,3276003502,3730071479,1672653269,1672654567,1298
3818,3500341755,3732584121,1672542891,1672545470,2579
3870,3515439826,3520764926,1672641211,1672644554,3343
3658,3408430195,3450969839,1672532967,1672534040,1073
3694,3276269264,3519446663,1672572897,1672575295,2398
3857,3755992176,3410160376,1672651851,1672652875,1024
3803,3791046864,3517358573,1672584273,1672586018,1745
3905,3927599181,3780253901,1672687506,1672688977,1471
3558,3776518452,3608232640,1672573355,1672576045,2690
3463,3817428320,3401496246,1672699139,1672702240,3101
3589,3783169442,3517222913,1672635691,1672639141,3450
3574,3779646172,3774605761,1672549381,1672550216,835
3739,3972083617,3438489358,1672675177,1672677115,1938
3463,3793969543,3304971369,1672573587,1672576533,2946
3568,3509893027,3511005395,1672683769,1672684280,511
3829,3892304880,3448875382,1672564444,1672567946,3502
3479,3225631197,3514512367,1672625909,1672626899,990
3435,3421877923,3373028638,1672665446,1672666634,1188
3837,3625463628,3230868435,1672545017,1672547566,2549
3424,3512800570,3631479562,1672539535,1672539878,343
3466,3440107959,3512502036,1672601623,1672604422,2799
3902,3734915241,3440137407,1672648589,1672651897,3308
3663,3880926355,3889780657,1672539688,1672542072,2384
3886,3904867554,3436257398,1672533783,1672536355,2572
3767,3607882826,3736705719,1672608847,1672609092,245
3436,3714067076,3456430614,1672580784,1672583081,2297
3815,3248058676,3812369928,1672626093,1672629336,3243
3640,3271752081,3839245934,1672597903,1672601164,3261
3877,3500525825,3927403123,1672556900,1672560241,3341
3643,3248058676,3685816610,1672595130,1672597601,2471
3740,3793781065,3777240360,1672547457,1672548964,1507
3442,3701823816,3510837901,1672553255,1672553317,62
3793,3760651515,3520181148,1672608223,1672609228,1005
3706,3909094917,3451726367,1672567047,1672568224,1177
3574,3618697021,3774790271,1672536727,1672537038,311
3589,3451691949,3481640525,1672698859,1672699588,729
3528,3513296868,3306175858,1672532484,1672534410,1926
3444,3792442597,3337322736,1672676602,1672678151,1549
3730,3617304541,3831586487,1672666754,1672667930,1176
3761,3279339278,3774290799,1672540887,1672543784,2897
3518,3298151889,3774733620,1672657714,1672658864,1150
3624,3533274994,3783340788,1672678177,1672680519,2342
3536,3710489491,3780571086,1672649343,1672651261,1918
3885,3514956366,3311420950,1672686004,1672688510,2506
3652,3756746867,3472312341,1672623855,1672623965,110
3438,3311085279,3779646172,1672612354,1672615793,3439
3431,3970558632,3713784974,1672683308,1672683603,295
3499,3463849738,3661447322,1672535951,1672537973,2022
3845,3738026330,3209481722,1672550323,1672552088,1765
3667,3294703680,3770296583,1672585775,1672587503,1728
3795,3970603231,3492959689,1672531499,1672535022,3523
3892,3459681410,3604867757,1672702371,1672705426,3055
3488,3447672935,3338083680,1672617481,1672617810,329
3485,3774605761,3308760650,1672538080,1672539637,1557
3466,3505283390,3500672156,1672651824,1672654413,2589
3581,3201676087,3512379024,1672682289,1672683614,1325
3849,3514741348,3884596900,1672549419,1672552317,2898
3564,3510642075,3511843593,1672681451,1672682021,570
3515,3893912331,3688796737,1672644629,1672645712,1083
3802,3811040565,3398198430,1672672681,1672674423,1742
3443,3500949309,3450286949,1672592668,1672595325,2657
3648,3621790707,3689697817,1672688145,1672689901,1756
3556,3755496114,3770624662,1672656066,1672658891,2825
3835,3760721303,3714678331,1672645458,1672648223,2765
3477,3715619259,3515559913,1672553968,1672556839,2871
3850,3617304541,3276348699,1672559509,1672560340,831
3846,3711734586,3756474459,1672539069,1672541169,2100
3723,3734118023,3755496114,1672569445,1672572621,3176
3714,3970627281,3792274796,1672620484,1672623772,3288
3528,3392520516,3780769110,1672689933,1672691547,1614
3834,3760645796,3715986185,1672629730,1672631173,1443
3806,3500737582,3925979970,1672596104,1672596204,100
3559,3202141727,3757383891,1672677384,1672677757,373
3768,3415833929,3467988782,1672637688,1672639138,1450
3854,3770468980,3414049538,1672651735,1672651895,160
3703,3774907131,3513296868,1672550112,1672551829,1717
3895,3667673649,3511005395,1672560530,1672560653,123
3602,3613206049,3382733096,1672668830,1672671240,2410
3546,3533079336,3713941638,1672579576,1672581396,1820
3511,3905899155,3472312341,1672671743,1672675025,3282
3871,3509483172,3927599181,1672628573,1672629357,784
3471,3638660068,3513410578,1672555686,1672556566,880
3915,3491684096,3312998540,1672581327,1672581608,281
3599,3285204083,3739911441,1672579861,1672581353,1492
3644,3928719932,3668414677,1672534972,1672538362,3390
3776,3900945856,3414940786,1672691723,1672694053,2330
3690,3534566651,3518561777,1672678693,1672681302,2609
3533,3357689359,3760842815,1672676889,1672677124,235
3723,3793740407,3701247948,1672666406,1672669363,2957
3825,3393063657,3779646172,1672534560,1672537723,3163
3764,3513853403,3396726504,1672649423,1672652681,3258
3862,3336339664,3300979975,1672627056,1672630542,3486
3863,3772765746,3970627281,1672593548,1672595726,2178
3897,3360069849,3517887477,1672638065,1672639492,1427
3455,3497808662,3812534508,1672662602,1672663658,1056
3595,3505266860,3374183227,1672546055,1672549559,3504
3889,3491684096,3734451191,1672677824,1672681043,3219
3626,3357864626,3300818269,1672583737,1672584626,889
3813,3780680950,3701664364,1672541216,1672541551,335
3855,3733558985,3337362061,1672587361,1672590093,2732
3747,3711853996,3632814465,1672533962,1672537086,3124
3894,3227799827,3777330107,1672588528,1672590033,1505
3786,3713941638,3357289672,1672657911,1672660174,2263
3444,3615939504,3780680950,1672693468,1672693705,237
3538,3299125059,3533004959,1672639115,1672641816,2701
3759,3505111292,3416987084,1672599331,1672600349,1018
3666,3440107959,3815250107,1672615717,1672617366,1649
3477,3270056120,3680810086,1672678380,1672679597,1217
3639,3777240360,3417679834,1672638766,1672642348,3582
3461,3505266860,3491684096,1672702345,1672702852,507
3831,3380767040,3716963089,1672556080,1672558184,2104
3837,3299443125,3451326054,1672606180,1672607155,975
3575,3280268483,3755222916,1672569119,1672569924,805
3493,3714120857,3513041785,1672627477,1672630018,2541
3769,3500703304,3970627281,1672656480,1672658980,2500
3454,3334993594,3710489491,1672653128,1672655040,1912
3763,3625174002,3779786641,1672620754,1672621025,271
3531,3920625129,3516741440,1672646342,1672647419,1077
3832,3755915206,3276217799,1672585075,1672587966,2891
3615,3884596900,3916490839,1672637713,1672639238,1525
3848,3774243020,3500302272,1672646047,1672647110,1063
3903,3711734586,3248058676,1672631732,1672634616,2884
3825,3280268483,3512722110,1672583717,1672583921,204
3458,3394297564,3760263530,1672602904,1672606316,3412
3904,3410600350,3382733096,1672623024,1672625712,2688
3758,3757318448,3516489668,1672695526,1672696741,1215
3859,3404025196,3609659642,1672624555,1672627388,2833
3773,3505888598,3615115210,1672634038,1672635614,1576
3540,3519909393,3609881958,1672627500,1672629599,2099
3792,3500777439,3500709774,1672621731,1672622853,1122
3510,3501215099,3505995057,1672616687,1672618116,1429
3774,3774178201,3467779445,1672535290,1672536573,1283
3568,3229974066,3512722110,1672668905,1672672476,3571
3697,3665998641,3513410578,1672662670,1672663148,478
3856,3791796585,3363162590,1672688910,1672690387,1477
3860,3701424609,3780872464,1672587035,1672588711,1676
3551,3716963089,3501525100,1672646305,1672646767,462
3551,3505402439,3774907131,1672567878,1672569473,1595
3656,3360069849,3613338363,1672643324,1672645220,1896
3690,3760924079,3554825448,1672657122,1672658835,1713
3550,3519446663,3360616538,1672594389,1672596131,1742
3434,3298151889,3300511067,1672667085,1672667654,569
3695,3714128600,3661583097,1672612024,1672612654,630
3817,3390660440,3514971533,1672661073,1672664442,3369
3654,3478114114,3518565331,1672587973,1672591326,3353
3429,3608855425,3902861231,1672571655,1672572930,1275
3807,3686523546,3713829743,1672547097,1672548430,1333
3444,3776988674,3351866415,1672543534,1672545756,2222
3674,3739154408,3893912331,1672556844,1672556923,79
3798,3293835352,3688490530,1672626497,1672627312,815
3511,3900276517,3639050419,1672590110,1672592115,2005
3666,3501384020,3500604680,1672537810,1672540337,2527
3441,3613416045,3490214516,1672681104,1672681919,815
3545,3485540729,3685681577,1672652301,1672654472,2171
3788,3510499038,3517600136,1672538636,1672540524,1888
3894,3236354255,3224330592,1672570302,1672573090,2788
3477,3935913584,3495911207,1672623948,1672625869,1921
3533,3713163045,3927599181,1672700306,1672701560,1254
3589,3770704999,3472312341,1672697259,1672699618,2359
3839,3839245934,3283144118,1672564379,1672565131,752
3766,3757332128,3778926763,1672662844,1672665276,2432
3833,3626499450,3510767239,1672561721,1672562473,752
3557,3501567772,3938389661,1672613882,1672615815,1933
3493,3713941638,3613581796,1672682717,1672683896,1179
3616,3715443333,3774605761,1672641708,1672644097,2389
3782,3811040565,3513345163,1672633438,1672636135,2697
3869,3792489602,3609113156,1672671851,1672674587,2736
3468,3783550022,3481640525,1672640331,1672643476,3145
3583,3311049964,3514956366,1672625046,1672627037,1991
3531,3920898925,3613899351,1672681782,1672682440,658
3460,3774290799,3776244398,1672562553,1672563609,1056
3605,3618489670,3371455553,1672621215,1672621787,572
3671,3492546679,3808136029,1672572162,1672572926,764
3449,3519077659,3510767239,1672676230,1672677601,1371
3458,3780115155,3515439826,1672591563,1672592838,1275
3550,3608232640,3928719932,1672693535,1672694090,555
3470,3438078818,3533368789,1672610202,1672610584,382
3833,3885155975,3497095254,1672543875,1672544916,1041
3502,3792801638,3283492940,1672630857,1672634359,3502
3662,3424445495,3283144118,1672540317,1672542387,2070
3853,3716272919,3608922867,1672677416,1672677802,386
3811,3411688875,3468041839,1672585629,1672587721,2092
3778,3511601997,3835422146,1672695374,1672698385,3011
3836,3821054646,3734915241,1672558937,1672559499,562
3850,3618176292,3511288998,1672596418,1672598676,2258
3810,3638660068,3839245934,1672580894,1672583688,2794
3610,3470454332,3510837901,1672646952,1672648458,1506
3513,3792274796,3757863420,1672693397,1672694269,872
3593,3517887477,3897456874,1672571711,1672574849,3138
3448,3519416013,3513410578,1672600648,1672601556,908
3878,3500613493,3934064792,1672653758,1672654722,964
3905,3505437712,3201629017,1672703301,1672704309,1008
3449,3773009828,3808136029,1672562204,1672565686,3482
3711,3513345163,3904569677,1672531945,1672533018,1073
3918,3500777439,3715545685,1672566710,1672570127,3417
3748,3520991398,3480726047,1672554731,1672556077,1346
3782,3501121099,3819767045,1672572233,1672573758,1525
3848,3715854030,3711218296,1672607938,1672608914,976
3586,3793583656,3436025562,1672548482,1672551944,3462
3612,3341893384,3793868716,1672536252,1672538106,1854
3917,3615087943,3817428320,1672591343,1672593324,1981
3856,3283144118,3520322124,1672631373,1672634832,3459
3672,3714678331,3757294769,1672658619,1672662212,3593
3903,3971806004,3445206685,1672635217,1672637071,1854
3480,3451326054,3614740489,1672540959,1672542936,1977
3439,3334647380,3490029863,1672605098,1672605693,595
3717,3777189898,3394297564,1672697826,1672701344,3518
3755,3824215187,3398731252,1672701864,1672703824,1960
3500,3500072204,3293835352,1672634193,1672637423,3230
3467,3505111292,3632814465,1672656119,1672658334,2215
3843,3715086894,3613416045,1672594750,1672595459,709
3483,3902760230,3315279093,1672667700,1672668554,854
3500,3520639768,3505154885,1672559121,1672562108,2987
3618,3730071479,3783919913,1672541070,1672544615,3545
3701,3737972328,3351866415,1672688143,1672688650,507
3918,3514334067,3776244398,1672696705,1672698585,1880
3818,3757630221,3311049964,1672537011,1672537206,195
3873,3783169442,3792020993,1672580536,1672583692,3156
3532,3312998540,3274906650,1672637138,1672640445,3307
3456,3451326054,3367111751,1672541742,1672543360,1618
3491,3479851674,3311098437,1672672118,1672673517,1399
3469,3514285803,3604867757,1672626668,1672629061,2393
3616,3686523546,3400763927,1672593627,1672596717,3090
3509,3271752081,3923220461,1672560708,1672560930,222
3898,3357689359,3414049538,1672599190,1672599878,688
3584,3225029895,3360616538,1672618889,1672619523,634
3670,3912891315,3808136029,1672612540,1672615638,3098
3590,3411688875,3710562338,1672698284,1672700013,1729
3679,3515525630,3780769110,1672671915,1672675113,3198
3593,3711218296,3932478321,1672538598,1672541908,3310
3761,3534566651,3783433404,1672635942,1672638404,2462
3697,3711812325,3914691363,1672553404,1672555394,1990
3603,3738026330,3850911686,1672651257,1672652943,1686
3517,3755158925,3773902805,1672643556,1672646336,2780
3767,3912891315,3773332082,1672658800,1672661080,2280
3537,3225029895,3686523546,1672697726,1672697890,164
3604,3500709774,3412006598,1672555278,1672556869,1591
3741,3605221116,3610870949,1672609012,1672612446,3434
3593,3201800997,3776518452,1672598883,1672599874,991
3451,3501281016,3731646673,1672555704,1672557275,1571
3902,3519818818,3341893384,1672537825,1672540029,2204
3746,3517697722,3334974375,1672682139,1672685377,3238
3689,3396980894,3638660068,1672569010,1672569521,511
3455,3793883863,3435116799,1672687177,1672688242,1065
3584,3510187271,3513041785,1672599565,1672601129,1564
3717,3367971170,3711000597,1672548399,1672549879,1480
3781,3703139663,3757348722,1672675326,1672676195,869
3799,3834960360,3757318448,1672671121,1672673140,2019
3871,3773735484,3435167810,1672549451,1672551204,1753
3848,3636329663,3440107959,1672604225,1672607282,3057
3441,3972083617,3777694660,1672666487,1672667069,582
3827,3351696332,3559731671,1672642860,1672646129,3269
3917,3533090502,3773837847,1672547749,1672548202,453
3425,3683113954,3977352557,1672685214,1672686104,890
3778,3557046880,3756704774,1672702624,1672704436,1812
3487,3711000597,3514971533,1672562515,1672566033,3518
3470,3716628503,3455018347,1672612218,1672615628,3410
3565,3755065949,3773939399,1672615442,1672616173,731
3879,3680810086,3300818269,1672682596,1672683583,987
3642,3500498112,3760362417,1672697240,1672698268,1028
3497,3774178201,3821054646,1672629144,1672630659,1515
3876,3931627862,3516703758,1672660330,1672660427,97
3624,3271454397,3711812325,1672653394,1672654671,1277
3611,3305722859,3336339664,1672671308,1672674188,2880
3870,3501567772,3710854064,1672682465,1672683903,1438
3712,3500525825,3202141727,1672563182,1672563554,372
3575,3441348818,3757075324,1672624275,1672624936,661
3814,3897134762,3436257398,1672589699,1672590009,310
3868,3615087943,3626499450,1672562945,1672564970,2025
3858,3735374579,3834963772,1672646056,1672646730,674
3511,3757075324,3515466096,1672631526,1672634924,3398
3778,3511791953,3619922891,1672645745,1672648577,2832
3746,3971806004,3510919821,1672633807,1672636022,2215
3917,3363162590,3713691388,1672640753,1672643294,2541
3757,3380982774,3791613604,1672541051,1672544650,3599
3521,3512337405,3715545685,1672568222,1672570463,2241
3525,3552824113,3970558632,1672545074,1672548102,3028
3563,3932478321,3792442597,1672650174,1672653062,2888
3592,3500841914,3792072681,1672690382,1672693859,3477
3480,3231494505,3887243870,1672680060,1672680263,203
3573,3710489491,3711734586,1672675272,1672675624,352
3557,3520873221,3459681410,1672582299,1672585510,3211
3659,3516298579,3688490530,1672683062,1672684665,1603
3589,3500109249,3925979970,1672574214,1672577493,3279
3781,3520991398,3793922324,1672641536,1672641700,164
3456,3914691363,3755992176,1672588497,1672591195,2698
3618,3417191856,3520657891,1672551870,1672553398,1528
3607,3773939399,3399518841,1672655965,1672657478,1513
3669,3514818819,3630353876,1672701372,1672701821,449
3609,3472068734,3688490530,1672639397,1672642477,3080
3763,3756385685,3808136029,1672545776,1672546584,808
3762,3928511283,3779613523,1672627281,1672629803,2522
3731,3315279093,3933894942,1672610237,1672611424,1187
3442,3509483172,3520873221,1672655323,1672656676,1353
3665,3635169815,3511150845,1672571435,1672572167,732
3849,3386758279,3559731671,1672702461,1672702559,98
3920,3617489344,3510642075,1672554785,1672557911,3126
3652,3636329663,3441703884,1672641436,1672644100,2664
3818,3209481722,3514324011,1672664153,1672667592,3439
3728,3755065949,3304155815,1672646055,1672648181,2126
3595,3613581796,3401940259,1672570112,1672573514,3402
3483,3777037426,3934064792,1672617213,1672618645,1432
3810,3792538417,3501525100,1672567195,1672569134,1939
3668,3777189898,3920497528,1672635846,1672637339,1493
3771,3438489358,3309314379,1672679801,1672681890,2089
3549,3517288083,3774876004,1672562352,1672562482,130
3715,3711919537,3270042456,1672673560,1672673698,138
3791,3615737355,3437286517,1672645768,1672647039,1271
3525,3760651515,3520873221,1672678525,1672681452,2927
3465,3938503547,3779938251,1672583247,1672584405,1158
3735,3760694096,3248058676,1672572145,1672572429,284
3712,3834960360,3686523546,1672566455,1672569791,3336
3820,3516903528,3970558632,1672630389,1672633648,3259
3828,3513296868,3703433819,1672552098,1672554647,2549
3715,3778899160,3612689556,1672543880,1672544216,336
3690,3977148669,3755404116,1672538509,1672541947,3438
3436,3208957949,3362641275,1672619813,1672620045,232
3522,3779854934,3389634034,1672635695,1672638069,2374
3489,3935399379,3448875382,1672588387,1672590330,1943
3836,3737112297,3373089838,1672628651,1672629643,992
3757,3792389522,3509893027,1672595913,1672599330,3417
3793,3534175249,3304155815,1672532266,1672535335,3069
3819,3505923418,3793781065,1672612657,1672615240,2583
3428,3770676872,3688490530,1672645999,1672649087,3088
3615,3343132529,3516321888,1672555292,1672556350,1058
3869,3279242917,3366423342,1672701724,1672703718,1994
3608,3755737419,3467779445,1672551421,1672554180,2759
3754,3615939504,3236458894,1672682532,1672682809,277
3642,3609659642,3371455553,1672621952,1672623027,1075
3551,3760645796,3208452238,1672594284,1672596666,2382
3533,3783433404,3780872464,1672681100,1672681951,851
3700,3276003502,3505725706,1672599164,1672602204,3040
3725,3631479562,3270042456,1672640185,1672643457,3272
3539,3341893384,3916490839,1672549182,1672551378,2196
3546,3760651515,3779854934,1672594843,1672596069,1226
3512,3701107228,3636329663,1672578529,1672581830,3301
3587,3819767045,3380982774,1672547653,1672550227,2574
3800,3921648519,3369708250,1672686003,1672689431,3428
3820,3661903000,3608922867,1672681601,1672682157,556
3888,3970198861,3478114114,1672670324,1672671931,1607
3808,3505402439,3932478321,1672603945,1672604049,104
3654,3615113018,3334974375,1672703816,1672707138,3322
3751,3279242917,3308760650,1672651190,1672652514,1324
3779,3500302272,3792442597,1672605460,1672608552,3092
3743,3505402439,3517697722,1672534771,1672535447,676
3834,3774155692,3497671225,1672604321,1672604534,213
3874,3777240360,3517697722,1672562260,1672563025,765
3877,3703798634,3711812325,1672536528,1672537110,582
3893,3637313265,3920898925,1672655309,1672658782,3473
3479,3791436104,3689114185,1672568930,1672572134,3204
3873,3701884158,3512337405,1672670955,1672672175,1220
3595,3462158237,3792489602,1672599388,1672601685,2297
3914,3714233826,3511442562,1672548269,1672551011,2742
3712,3534175249,3480100311,1672570231,1672571090,859
3734,3633735593,3312998540,1672534957,1672538085,3128
3741,3279475486,3773837847,1672646840,1672648409,1569
3745,3715707380,3609113156,1672628134,1672628579,445
3644,3890739241,3757700712,1672558795,1672560191,1396
3443,3757700712,3394297564,1672698995,1672699687,692
3915,3755737419,3226178937,1672701137,1672703332,2195
3512,3734451191,3520873221,1672627196,1672629087,1891
3857,3669146016,3792014516,1672544560,1672544891,331
3592,3609933747,3311498666,1672664071,1672667043,2972
3714,3513327337,3241790910,1672623581,1672626794,3213
3890,3201800997,3272716462,1672675476,1672676221,745
3910,3279242917,3915162005,1672562373,1672563128,755
3708,3793969543,3615113018,1672570405,1672573906,3501
3868,3668747074,3615087943,1672697185,1672698238,1053
3537,3480490124,3755496114,1672692081,1672693252,1171
3562,3780209375,3454277788,1672616336,1672619831,3495
3472,3519850727,3975717896,1672599354,1672601611,2257
3611,3783928182,3512502036,1672565944,1672567039,1095
3671,3414049538,3501384020,1672672307,1672675766,3459
3776,3780253901,3778134418,1672632132,1672633416,1284
3431,3347419520,3510499038,1672581381,1672583561,2180
3590,3770704999,3608922867,1672600352,1672601716,1364
3757,3280268483,3777694660,1672631489,1672634168,2679
3441,3621184108,3273981374,1672639516,1672641681,2165
3511,3431460073,3711000597,1672696275,1672698103,1828
3728,3779639983,3514285803,1672608138,1672610526,2388
3910,3201800997,3334951866,1672607395,1672610363,2968
3602,3505521218,3417191856,1672695053,1672698338,3285
3901,3824215187,3518653080,1672582212,1672584897,2685
3883,3441348818,3701247948,1672661462,1672663010,1548
3920,3770236215,3770146716,1672626848,1672628985,2137
3811,3701882224,3760094385,1672655243,1672656855,1612
3552,3513018485,3756385685,1672674094,1672676609,2515
3782,3710489491,3921648519,1672678042,1672678177,135
3821,3776988674,3456430614,1672694918,1672696354,1436
3731,3774876004,3513853403,1672566496,1672568924,2428
3910,3793175445,3520639768,1672672372,1672674047,1675
3519,3839245934,3755158925,1672703248,1672706224,2976
3683,3414940786,3713911104,1672560584,1672562536,1952
3704,3817813340,3283492940,1672558915,1672559224,309
3634,3880926355,3533747868,1672649403,1672652798,3395
3817,3520115090,3711919537,1672661017,1672662831,1814
3812,3500841914,3510642075,1672661775,1672664389,2614
3889,3817428320,3783520186,1672630638,1672634152,3514
3687,3609881958,3470454332,1672652126,1672652461,335
3572,3791753345,3730071479,1672566249,1672568181,1932
3690,3511843593,3755992176,1672599163,1672600033,870
3715,3236499444,3826238375,1672632963,1672636089,3126
3735,3711077927,3505402439,1672634345,1672636540,2195
3625,3608232640,3224811762,1672565416,1672566740,1324
3428,3347419520,3315703693,1672574754,1672577621,2867
3512,3500613493,3631090677,1672666535,1672668964,2429
3531,3711637255,3410538749,1672646777,1672649558,2781
3712,3533079336,3390660440,1672650128,1672652849,2721
3733,3710048469,3780209375,1672600199,1672603312,3113
3843,3288224595,3780909839,1672595851,1672597594,1743
3518,3513360004,3500498112,1672652007,1672653884,1877
3916,3792801638,3511150845,1672633904,1672636736,2832
3457,3463740710,3517462308,1672569024,1672569420,396
3638,3520322124,3885155975,1672693567,1672694669,1102
3612,3513295938,3412006598,1672573651,1672576084,2433
3493,3684523966,3776988674,1672557767,1672559619,1852
3637,3660063072,3500317969,1672553977,1672557479,3502
3734,3396726504,3757318448,1672604507,1672606629,2122
3717,3780712350,3435167810,1672545303,1672545535,232
3502,3736705719,3292147449,1672699151,1672701168,2017
3571,3755532873,3519850727,1672563732,1672564136,404
3768,3436257398,3516298579,1672564609,1672567915,3306
3677,3783771827,3479851674,1672686729,1672689364,2635
3664,3621184108,3971806004,1672693917,1672695931,2014
3758,3363162590,3618808151,1672550817,1672553409,2592
3892,3438489358,3519142371,1672681419,1672682536,1117
3648,3815392801,3394401087,1672633543,1672636679,3136
3879,3551376095,3778899160,1672621635,1672623888,2253
3664,3756704774,3516444201,1672562073,1672563843,1770
3482,3701107228,3620292035,1672649713,1672651159,1446
3672,3512830734,3343132529,1672586226,1672588042,1816
3621,3885537225,3304971369,1672624190,1672625135,945
3766,3613206049,3812369928,1672629182,1672629910,728
3540,3613206049,3412006598,1672621250,1672623850,2600
3577,3703139663,3780115155,1672684372,1672684876,504
3738,3552824113,3306412634,1672560121,1672561866,1745
3772,3600876425,3770704999,1672644265,1672645002,737
3722,3900898992,3554825448,1672621137,1672623308,2171
3852,3518194482,3500044458,1672665390,1672667848,2458
3855,3505634634,3479851674,1672619906,1672623370,3464
3679,3367971170,3711812325,1672614274,1672614611,337
3547,3834963772,3516489668,1672666599,1672669272,2673
3565,3770236215,3513853403,1672696784,1672700045,3261
3486,3343132529,3270697740,1672572214,1672573713,1499
3468,3757075324,3488763230,1672569187,1672572192,3005
3762,3440107959,3756625818,1672639876,1672640348,472
3511,3613899351,3885155975,1672531945,1672532413,468
3786,3534764451,3519416013,1672620536,1672622324,1788
3905,3791441520,3279473441,1672673056,1672675872,2816
3914,3774641380,3334951866,1672621872,1672624742,2870
3614,3680810086,3450969839,1672667148,1672667426,278
3920,3770236215,3492546679,1672598526,1672601952,3426
3912,3517590837,3932478321,1672625575,1672628982,3407
3908,3779532653,3448633776,1672538275,1672538503,228
3625,3803517637,3777485931,1672649983,1672650419,436
3638,3289817992,3774155692,1672578748,1672580155,1407
3687,3509366311,3428725843,1672653824,1672657198,3374
3680,3514971533,3793969543,1672540404,1672543453,3049
3459,3661583097,3244004456,1672689273,1672691966,2693
3504,3732131656,3970627281,1672550777,1672553567,2790
3677,3975717896,3620292035,1672610818,1672614221,3403
3715,3923754072,3927403123,1672534820,1672538194,3374
3696,3777091903,3454277788,1672666825,1672667394,569
3602,3497095254,3315703693,1672678065,1672680369,2304
3845,3791106564,3618697021,1672538729,1672541999,3270
3739,3613206049,3779613523,1672656472,1672657784,1312
3544,3777091903,3271454397,1672535443,1672538006,2563
3593,3554825448,3778899160,1672672016,1672674521,2505
3711,3884596900,3814677862,1672699390,1672700781,1391
3511,3714670620,3839245934,1672563631,1672565256,1625
3659,3701823816,3516444201,1672554734,1672556170,1436
3681,3770236215,3376467719,1672541541,1672542115,574
3638,3715545685,3510642075,1672691405,1672694206,2801
3502,3534829213,3337322736,1672634411,1672637402,2991
3650,3500317969,3513545422,1672627103,1672628264,1161
3554,3779786641,3714678331,1672637176,1672640579,3403
3437,3515401243,3614740489,1672532315,1672533933,1618
3783,3376467719,3232208416,1672583242,1672585679,2437
3512,3312998540,3738026330,1672666701,1672668127,1426
3802,3713911104,3739661856,1672682914,1672685702,2788
3888,3779532653,3457960571,1672561885,1672562909,1024
3507,3858172636,3783520186,1672673677,1672677170,3493
3652,3283492940,3774705415,1672602887,1672605226,2339
3504,3811040565,3533423872,1672590610,1672592241,1631
3745,3714678331,3501457103,1672601268,1672603805,2537
3755,3713589994,3711097754,1672542296,1672544548,2252
3784,3514285803,3400069268,1672692284,1672695858,3574
3545,3554186380,3607768197,1672566848,1672567613,765
3740,3416987084,3778597171,1672576648,1672578179,1531
3652,3310125159,3488763230,1672701713,1672703000,1287
3565,3614740489,3780209375,1672609530,1672610692,1162
3860,3510818674,3818575661,1672606553,1672609538,2985
3785,3311498666,3382733096,1672532580,1672535669,3089
3547,3357864626,3505434346,1672565951,1672568782,2831
3860,3500109249,3770704999,1672703676,1672706385,2709
3635,3661903000,3970198861,1672672515,1672672972,457
3769,3897456874,3511150845,1672625404,1672627414,2010
3570,3732584121,3780472203,1672583888,1672585083,1195
3531,3780253901,3517590837,1672665333,1672665668,335
3615,3450286949,3203538212,1672700282,1672700876,594
3720,3200543880,3202804048,1672621288,1672622137,849
3914,3715707380,3469254160,1672563956,1672564186,230
3566,3979784676,3245232284,1672593295,1672594547,1252
3437,3369708250,3715545685,1672609337,1672612158,2821
3794,3636329663,3514419100,1672678107,1672679432,1325
3558,3604867757,3779646172,1672641545,1672643015,1470
3612,3270056120,3615688740,1672580260,1672580802,542
3587,3520355798,3613899351,1672624669,1672627091,2422
3542,3732584121,3755756564,1672623706,1672624839,1133
3577,3299781901,3760263530,1672671094,1672674683,3589
3544,3713979100,3885155975,1672555577,1672558789,3212
3498,3338083680,3513410578,1672634464,1672637215,2751
3706,3364378127,3610870949,1672700561,1672703440,2879
3836,3520416075,3889780657,1672612449,1672616037,3588
3816,3779854934,3793969543,1672641433,1672642762,1329
3889,3515439826,3472312341,1672658658,1672659672,1014
3678,3755848152,3364378127,1672557666,1672559671,2005
3668,3617116290,3639050419,1672692052,1672694629,2577
3533,3622665543,3513853403,1672698798,1672700554,1756
3455,3791613604,3622357348,1672588231,1672589945,1714
3839,3977148669,3462273042,1672650450,1672653916,3466
3667,3280054198,3667427125,1672595838,1672596149,311
3615,3622665543,3497671225,1672634875,1672637655,2780
3634,3977352557,3518194482,1672689690,1672690435,745
3841,3773735484,3773027597,1672570026,1672571418,1392
3902,3505111292,3791753345,1672633825,1672635677,1852
3491,3619922891,3200543880,1672569285,1672569665,380
3432,3931627862,3792745809,1672578864,1672579835,971
3466,3500347447,3445206685,1672651339,1672653597,2258
3477,3714185969,3201629017,1672613254,1672614264,1010
3683,3500498112,3793418209,1672655325,1672658895,3570
3665,3884596900,3500915908,1672599246,1672600909,1663
3450,3783147088,3898314440,1672541650,1672542214,564
3864,3757863420,3310039260,1672692719,1672695000,2281
3842,3791246640,3520578796,1672655126,1672655458,332
3753,3514334067,3792014516,1672635416,1672637307,1891
3521,3777240360,3500613459,1672577375,1672579470,2095
3712,3760694096,3490214516,1672659957,1672660336,379
3766,3500613493,3500915908,1672669811,1672670479,668
3873,3469254160,3288762795,1672556613,1672558943,2330
3887,3609659642,3793781065,1672655727,1672659259,3532
3686,3509366311,3920898925,1672681743,1672682635,892
3693,3481640525,3480490124,1672566584,1672569117,2533
3435,3904412440,3780322355,1672605882,1672609054,3172
3875,3791246640,3392836218,1672581627,1672582688,1061
3535,3703433819,3479851674,1672693838,1672696777,2939
3494,3463849738,3755404116,1672662516,1672665329,2813
3549,3716110860,3511843593,1672537874,1672539816,1942
3593,3367111751,3614740489,1672608051,1672611069,3018
3601,3514419100,3755992176,1672578329,1672581346,3017
3616,3517881647,3554186380,1672673507,1672676852,3345
3623,3436025562,3927403123,1672650369,1672652331,1962
3634,3739661856,3505111292,1672614248,1672614834,586
3852,3511601997,3773033649,1672702143,1672705295,3152
3463,3559458968,3450286949,1672609521,1672611983,2462
3904,3617489344,3607768197,1672579215,1672582335,3120
3918,3902625986,3617116290,1672661834,1672662842,1008
3918,3411515369,3779465522,1672551872,1672554566,2694
3652,3514285803,3226024417,1672607734,1672607997,263
3822,3791128487,3517697722,1672560703,1672560852,149
3634,3807212280,3438489358,1672672063,1672673554,1491
3922,3500604680,3925979970,1672603334,1672604540,1206
3429,3279339278,3452016771,1672588450,1672591725,3275
3617,3801645328,3783771827,1672683982,1672687562,3580
3854,3229822507,3514971533,1672573660,1672575558,1898
3920,3231713082,3755065949,1672615163,1672617607,2444
3639,3333403880,3516321888,1672698664,1672701290,2626
3909,3783520186,3703433819,1672655401,1672656740,1339
3503,3710489491,3685681577,1672616087,1672616257,170
3505,3801645328,3792505974,1672616808,1672618778,1970
3516,3773121782,3607882826,1672671335,1672671494,159
3914,3401496246,3803517637,1672609420,1672611284,1864
3632,3514512367,3792489602,1672702559,1672704797,2238
3869,3517358573,3773913680,1672692560,1672695833,3273
3733,3783771827,3624297844,1672571194,1672572952,1758
3471,3230135532,3357289672,1672696898,1672697133,235
3691,3701373490,3779854934,1672695887,1672698199,2312
3839,3518565331,3343132529,1672552008,1672553271,1263
3451,3970603231,3779438325,1672686151,1672687472,1321
3452,3621790707,3617304541,1672680318,1672682634,2316
3469,3713979100,3500827202,1672671037,1672672423,1386
3646,3608855425,3904569677,1672585090,1672585931,841
3839,3780115155,3409114719,1672611789,1672612988,1199
3884,3710048469,3533004959,1672551962,1672555375,3413
3823,3202804048,3774243020,1672612560,1672615526,2966
3734,3424445495,3270056120,1672563914,1672565953,2039
3824,3310125159,3779465522,1672551704,1672554688,2984
3598,3772078494,3779438325,1672648719,1672652019,3300
3687,3398731252,3492959689,1672649548,1672651983,2435
3590,3511883730,3618808151,1672614411,1672617749,3338
3452,3519142371,3920497528,1672662399,1672664985,2586
3736,3559458968,3551399764,1672532267,1672533139,872
3774,3239617320,3661903000,1672629745,1672631979,2234
3639,3360616538,3225636215,1672610873,1672612320,1447
3581,3500709774,3490214516,1672580083,1672583218,3135
3835,3713691388,3626499450,1672682169,1672683636,1467
3747,3520764926,3201676087,1672680198,1672682303,2105
3483,3792745809,3533090502,1672574555,1672575335,780
3497,3615737355,3890739241,1672554851,1672558322,3471
3440,3480726047,3276217799,1672691432,1672691579,147
3860,3817813340,3500613493,1672592047,1672594305,2258
3915,3618808151,3793175445,1672636454,1672639735,3281
3556,3380982774,3757630221,1672672986,1672676019,3033
3575,3739154408,3793583656,1672600431,1672600727,296
3727,3791693821,3783771827,1672610475,1672613924,3449
3711,3779301501,3534566651,1672702510,1672703546,1036
3867,3500341755,3463740710,1672636962,1672640488,3526
3512,3517590837,3755222916,1672647674,1672649586,1912
3577,3639050419,3380767040,1672608839,1672610554,1715
3849,3776988674,3975717896,1672537957,1672539301,1344
3737,3931627862,3661583097,1672573253,1672575121,1868
3646,3373028638,3505481368,1672692618,1672695706,3088
3639,3399472693,3793883863,1672647389,1672650623,3234
3824,3367111751,3511791953,1672609755,1672611128,1373
3593,3701373490,3362641275,1672596543,1672597939,1396
3681,3632814465,3776034743,1672541126,1672542887,1761
3545,3384068080,3979784676,1672567599,1672570217,2618
3831,3500613459,3512392431,1672659569,1672661329,1760
3550,3516741440,3610870949,1672689140,1672691968,2828
3640,3386758279,3760721303,1672568528,1672569625,1097
3720,3533747868,3814305099,1672690926,1672691806,880
3672,3737112297,3298151889,1672652244,1672652900,656
3500,3500709774,3703433819,1672566339,1672566857,518
3547,3770704999,3818575661,1672547558,1672549808,2250
3583,3505178849,3276003502,1672679851,1672682864,3013
3690,3283144118,3778597171,1672687806,1672691275,3469
3744,3515559913,3613899351,1672662604,1672665749,3145
3562,3500498112,3776244398,1672607220,1672610217,2997
3693,3276003502,3791796585,1672535183,1672538416,3233
3462,3206837348,3713911104,1672534160,1672534742,582
3811,3791441520,3279475486,1672643475,1672645962,2487
3787,3500525825,3920497528,1672695555,1672696685,1130
3716,3853629553,3336339664,1672633871,1672634336,465
3805,3455018347,3505847380,1672625249,1672625482,233
3635,3512282789,3715974659,1672602773,1672605865,3092
3503,3384068080,3755233658,1672607727,1672610788,3061
3524,3688796737,3351866415,1672542501,1672544221,1720
3468,3760645796,3621184108,1672574540,1672575360,820
3571,3510642075,3621683102,1672532785,1672536085,3300
3478,3230135532,3380767040,1672638770,1672641323,2553
3441,3778899160,3935399379,1672535576,1672537939,2363
3680,3457960571,3509764635,1672628169,1672630080,1911
3513,3639050419,3505521218,1672547938,1672549988,2050
3453,3791613604,3338083680,1672613836,1672614191,355
3913,3972192593,3701005527,1672590592,1672592411,1819
3477,3455018347,3500777439,1672622112,1672623063,951
3572,3631479562,3202804048,1672676651,1672677318,667
3647,3457960571,3710315160,1672684717,1672686413,1696
3611,3621461051,3620292035,1672674007,1672674724,717
3732,3892304880,3520764926,1672554618,1672557406,2788
3584,3500737582,3792745809,1672658569,1672660847,2278
3468,3713300120,3554186380,1672611433,1672612064,631
3524,3774907131,3710562338,1672687235,1672688014,779
3555,3505663516,3288224595,1672577714,1672579439,1725
3522,3630353876,3300229945,1672540304,1672542074,1770
3533,3500915665,3300979975,1672682476,1672683989,1513
3478,3534764451,3715400486,1672628098,1672629651,1553
3777,3310039260,3850911686,1672620274,1672621572,1298
3425,3360616538,3613416045,1672535022,1672537628,2606
3848,3367111751,3622357348,1672562650,1672563483,833
3586,3774031303,3773124276,1672664061,1672667459,3398
3632,3520322124,3380982774,1672618550,1672621076,2526
3740,3774243020,3779438325,1672647349,1672649298,1949
3782,3338083680,3826238375,1672591593,1672594658,3065
3508,3500498112,3520322124,1672564994,1672568390,3396
3743,3756704774,3920497528,1672688292,1672690712,2420
3676,3835422146,3935487534,1672579345,1672580903,1558
3620,3288762795,3701322924,1672683743,1672684117,374
3475,3715400486,3220031931,1672602663,1672605169,2506
3598,3449333754,3779532653,1672632824,1672633669,845
3822,3245232284,3440137407,1672591358,1672591567,209
3711,3283492940,3825881598,1672573685,1672575991,2306
3779,3780338697,3360813161,1672554403,1672555873,1470
3606,3792801638,3520873221,1672586255,1672586565,310
3699,3410538749,3755915206,1672668411,1672669213,802
3717,3777330107,3618697021,1672676169,1672677729,1560
3572,3515890966,3710048469,1672676131,1672676618,487
3873,3814305099,3626499450,1672672436,1672674605,2169
3844,3366423342,3514971533,1672578854,1672581001,2147
3796,3783169442,3231494505,1672547192,1672550533,3341
3510,3294747828,3971806004,1672697297,1672699382,2085
3491,3776831527,3780427126,1672626356,1672629901,3545
3659,3520115090,3621683102,1672586631,1672589763,3132
3552,3343132529,3414275042,1672703387,1672705522,2135
3910,3905899155,3887243870,1672607602,1672608871,1269
3601,3208957949,3783147088,1672646284,1672649296,3012
3922,3914691363,3517358573,1672648765,1672651930,3165
3551,3428725843,3351866415,1672586197,1672587902,1705
3441,3229822507,3780571086,1672551896,1672552855,959
3656,3224968597,3621184108,1672599239,1672600824,1585
3724,3299443125,3505807416,1672635930,1672639021,3091
3703,3512282789,3770438122,1672684109,1672684803,694
3713,3511288998,3450969839,1672662052,1672663585,1533
3718,3440107959,3618354185,1672703740,1672706279,2539
3484,3900945856,3621683102,1672640063,1672640796,733
3580,3515401243,3379143440,1672547340,1672548284,944
3659,3552824113,3780209375,1672662942,1672666401,3459
3821,3621790707,3333918941,1672565516,1672567957,2441
3472,3757348722,3803517637,1672581489,1672581895,406
3634,3232208416,3793740407,1672551714,1672554799,3085
3783,3505725706,3773009828,1672555509,1672557631,2122
3465,3776518452,3270042456,1672694047,1672696634,2587
3539,3783147088,3225029895,1672642100,1672643876,1776
3483,3638660068,3509483172,1672659969,1672662329,2360
3702,3350095157,3511601997,1672659851,1672661937,2086
3476,3779532653,3780115155,1672614312,1672617507,3195
3813,3519087371,3780712350,1672595122,1672598183,3061
3499,3245232284,3512383699,1672650618,1672652662,2044
3509,3238288884,3360813161,1672680667,1672681278,611
3877,3615115210,3777147510,1672623539,1672625225,1686
3474,3462158237,3201800997,1672692286,1672692697,411
3796,3311098437,3974674109,1672680022,1672680656,634
3600,3303410628,3393063657,1672647913,1672650687,2774
3854,3736231757,3513041785,1672574250,1672575366,1116
3893,3428027649,3533649454,1672554973,1672558021,3048
3652,3224968597,3625463628,1672557983,1672558812,829
3459,3605221116,3803517637,1672589753,1672591548,1795
3614,3515525630,3298151889,1672690976,1672692557,1581
3432,3620292035,3683113954,1672636700,1672637837,1137
3679,3814677862,3443357683,1672660609,1672663398,2789
3464,3889780657,3497808662,1672666438,1672668045,1607
3424,3778640261,3638660068,1672540837,1672541894,1057
3561,3236458894,3636329663,1672697118,1672698991,1873
3637,3491469603,3714128600,1672658517,1672658673,156
3644,3791106564,3505179890,1672564189,1672565929,1740
3451,3776988674,3511288998,1672638596,1672641117,2521
3477,3520560590,3551389192,1672582676,1672582758,82
3615,3311085279,3270056120,1672532066,1672534830,2764
3733,3311420950,3774031303,1672661920,1672664566,2646
3835,3891672228,3279242917,1672541367,1672544132,2765
3880,3270697740,3231713082,1672597435,1672597881,446
3798,3311098437,3613206049,1672624842,1672625230,388
3574,3926643445,3367111751,1672651627,1672652669,1042
3814,3519909393,3448875382,1672572576,1672574850,2274
3716,3338390596,3814305099,1672580032,1672582559,2527
3879,3472312341,3716963089,1672611605,1672613799,2194
3494,3383138270,3779465522,1672578542,1672580527,1985
3427,3615113018,3511442562,1672679198,1672681558,2360
3874,3933894942,3780472203,1672551470,1672552545,1075
3683,3737147209,3780834916,1672559712,1672560750,1038
3561,3515890966,3760842815,1672667064,1672668918,1854
3727,3607882826,3519416013,1672643614,1672644730,1116
3448,3463740710,3773939399,1672661471,1672661966,495
3690,3230135532,3367111751,1672656981,1672660209,3228
3736,3513360004,3626499450,1672685431,1672686345,914
3595,3240994288,3501121099,1672546261,1672548706,2445
3548,3770468980,3417191856,1672599798,1672602681,2883
3902,3733558985,3776559988,1672531695,1672534085,2390
3546,3200308999,3449639012,1672563092,1672565884,2792
3778,3905899155,3774605761,1672662891,1672663094,203
3557,3880926355,3916490839,1672678995,1672679136,141
3839,3914691363,3814305099,1672640004,1672640732,728
3720,3509483172,3900276517,1672693077,1672693325,248
3609,3509756823,3462636434,1672635956,1672636583,627
3665,3778134418,3500302272,1672602929,1672603141,212
3610,3714827719,3885121158,1672531214,1672531404,190
3581,3511843593,3513410578,1672619938,1672621479,1541
3461,3770624662,3303410628,1672673207,1672674097,890
3648,3513041785,3737972328,1672561939,1672563278,1339
3719,3224330592,3607768197,1672590570,1672590968,398
3725,3334993594,3293835352,1672586106,1672586528,422
3862,3501786419,3923420131,1672694300,1672697764,3464
3816,3488686442,3514741348,1672634056,1672637612,3556
3625,3773939399,3559731671,1672691885,1672694449,2564
3484,3519028898,3826238375,1672656084,1672658931,2847
3900,3462273042,3227799827,1672619790,1672620040,250
3810,3905899155,3305722859,1672645893,1672646729,836
3662,3428027649,3500317969,1672667856,1672668461,605
3745,3500703304,3778926763,1672699564,1672701054,1490
3542,3554825448,3608232640,1672693711,1672695014,1303
3590,3668533536,3515525630,1672587454,1672588721,1267
3794,3770146716,3401940259,1672668760,1672671809,3049
3627,3780338697,3755496114,1672563425,1672565365,1940
3894,3684523966,3618489670,1672623232,1672624310,1078
3540,3445206685,3415833929,1672667329,1672668172,843
3554,3445206685,3384068080,1672606572,1672607939,1367
3888,3510837901,3283144118,1672611024,1672613859,2835
3513,3755915206,3347419520,1672679673,1672683133,3460
3440,3739895284,3716272919,1672653697,1672655484,1787
3670,3470454332,3618697021,1672558140,1672558749,609
3467,3624297844,3826238375,1672684623,1672686867,2244
3625,3618176292,3812369928,1672635022,1672637713,2691
3788,3367111751,3610358027,1672595384,1672598219,2835
3550,3668414677,3780427126,1672682535,1672683500,965
3500,3927599181,3514308235,1672610859,1672611042,183
3718,3445206685,3615737355,1672569513,1672572477,2964
3608,3500044458,3756746867,1672604293,1672604862,569
3907,3437286517,3372223551,1672679692,1672681324,1632
3456,3682133690,3412968120,1672665726,1672666599,873
3895,3271454397,3701664364,1672693015,1672696514,3499
3599,3316798920,3225636215,1672568892,1672569545,653
3764,3505725706,3273981374,1672580882,1672582058,1176
3437,3777240360,3600876425,1672696377,1672699723,3346
3899,3755344363,3512379024,1672702550,1672702834,284
3557,3512383699,3770438122,1672590508,1672591223,715
3733,3380982774,3311420950,1672691726,1672692929,1203
3794,3367111751,3510964997,1672676836,1672678566,1730
3645,3791693821,3505178849,1672689249,1672691260,2011
3665,3711853996,3779532653,1672671307,1672673118,1811
3597,3757323954,3611055563,1672661936,1672664316,2380
3473,3519142371,3780680950,1672651144,1672653359,2215
3640,3311420950,3284932450,1672551907,1672554107,2200
3473,3791436104,3774718695,1672551583,1672553518,1935
3587,3385323994,3793315718,1672564913,1672565951,1038
3791,3703139663,3515525630,1672700502,1672702264,1762
3597,3364378127,3757294769,1672541019,1672542082,1063
3680,3226511603,3823084403,1672666393,1672668113,1720
3754,3801645328,3238288884,1672551651,1672554455,2804
3717,3319167958,3349856820,1672689877,1672690721,844
3774,3779613523,3783641602,1672549111,1672552614,3503
3653,3920497528,3491469603,1672607235,1672608845,1610
3852,3780872464,3517358573,1672614617,1672616073,1456
3615,3390660440,3755848152,1672595403,1672598777,3374
3634,3814305099,3449333754,1672608468,1672610834,2366
3541,3778667336,3516321888,1672656116,1672658493,2377
3636,3713911104,3351866415,1672616925,1672618572,1647
3830,3711734586,3511288998,1672694204,1672695484,1280
3528,3835422146,3791246640,1672560311,1672563587,3276
3872,3515439826,3512830734,1672669373,1672669560,187
3758,3511843593,3791753345,1672618217,1672621494,3277
3826,3311498666,3977352557,1672632779,1672633446,667
3567,3379143440,3774790271,1672558304,1672561848,3544
3668,3294703680,3248058676,1672532088,1672535628,3540
3574,3834960360,3481640525,1672646927,1672649900,2973
3524,3534126409,3773121782,1672630853,1672631442,589
3426,3435116799,3505521218,1672651743,1672654069,2326
3728,3514703118,3497671225,1672545618,1672548237,2619
3731,3462273042,3497095254,1672701733,1672704523,2790
3849,3316798920,3438078818,1672640403,1672640858,455
3820,3852686295,3501281016,1672612938,1672615266,2328
3730,3609881958,3803389195,1672557270,1672559397,2127
3793,3300979975,3552824113,1672595886,1672596696,810
3852,3228888030,3248058676,1672637796,1672639304,1508
3630,3514512367,3618176292,1672653522,1672653712,190
3464,3367509761,3305336154,1672550544,1672552664,2120
3822,3292147449,3520657891,1672583311,1672585790,2479
3583,3511442562,3701882224,1672669474,1672671141,1667
3590,3710562338,3626499450,1672688909,1672689909,1000
3917,3343816795,3512882178,1672662872,1672663817,945
3719,3715385401,3509483172,1672651982,1672654516,2534
3789,3509893027,3500072204,1672701700,1672704358,2658
3598,3833217041,3776034743,1672627539,1672627856,317
3455,3935913584,3298151889,1672658326,1672661100,2774
3802,3668747074,3347446226,1672546153,1672549747,3594
3436,3399518841,3935487534,1672687770,1672690225,2455
3769,3617116290,3505807416,1672703883,1672707049,3166
3736,3224330592,3814677862,1672564709,1672566138,1429
3836,3819767045,3736231757,1672629351,1672631704,2353
3547,3368283077,3284947372,1672572841,1672575234,2393
3748,3335694356,3310125159,1672602668,1672603755,1087
3766,3660063072,3773027597,1672607726,1672608600,874
3797,3793407963,3236499444,1672624326,1672625396,1070
3611,3452016771,3460719322,1672587597,1672587852,255
3520,3683113954,3755737419,1672613284,1672615960,2676
3482,3533929349,3428725843,1672698516,1672699561,1045
3752,3713784974,3774243020,1672578486,1672580612,2126
3594,3516903528,3899786664,1672561015,1672562586,1571
3740,3900276517,3933894942,1672617599,1672619531,1932
3864,3510499038,3201629017,1672549059,1672552521,3462
3898,3283144118,3418448389,1672667370,1672669326,1956
3746,3880926355,3510818674,1672634760,1672638234,3474
3877,3604589802,3518194482,1672561729,1672565081,3352
3637,3777037426,3618808151,1672686805,1672688170,1365
3851,3505266860,3783163143,1672701195,1672704165,2970
3659,3829864515,3520322124,1672605269,1672608366,3097
3430,3505663516,3437286517,1672624511,1672625215,704
3521,3485540729,3513345163,1672653180,1672656748,3568
3867,3774155692,3349739136,1672646029,1672647208,1179
3828,3757323954,3408430195,1672535983,1672537313,1330
3702,3773913680,3713691388,1672627067,1672628769,1702
3543,3710008361,3920898925,1672584733,1672584868,135
3617,3300511067,3513410578,1672587362,1672587695,333
3859,3205985903,3669146016,1672680902,1672681906,1004
3777,3734451191,3300229945,1672678816,1672680040,1224
3590,3517222913,3923220461,1672580881,1672582126,1245
3528,3711077927,3367111751,1672616657,1672618232,1575
3687,3363162590,3533090502,1672698962,1672702070,3108
3639,3689697817,3613338363,1672610231,1672611631,1400
3868,3202804048,3778040015,1672649864,1672650041,177
3766,3512499658,3311498666,1672591237,1672593700,2463
3720,3500302272,3639050419,1672638603,1672641468,2865
3639,3757294769,3770676872,1672570794,1672571236,442
3861,3791046864,3732584121,1672699452,1672701073,1621
3680,3701664364,3755233658,1672550585,1672551063,478
3614,3755233658,3757075324,1672672740,1672675108,2368
3589,3715086894,3770146716,1672609083,1672612067,2984
3829,3311085279,3226024417,1672590501,1672592016,1515
3569,3500827202,3469254160,1672667791,1672668975,1184
3804,3783615982,3757903168,1672695237,1672698014,2777
3464,3774031303,3668414677,1672560447,1672562614,2167
3765,3505402439,3505481368,1672597381,1672599675,2294
3806,3815250107,3274831810,1672543944,1672546696,2752
3572,3770468980,3310039260,1672696413,1672697973,1560
3770,3615688740,3375449013,1672649113,1672649500,387
3557,3975717896,3512800570,1672551649,1672553522,1873
3528,3514246749,3891672228,1672640011,1672641653,1642
3720,3680810086,3608922867,1672689435,1672690892,1457
3486,3622665543,3778926763,1672607376,1672608555,1179
3687,3518229776,3783147088,1672672677,1672674750,2073
3572,3513545422,3779646172,1672563617,1672563809,192
3555,3367509761,3288762795,1672651860,1672654165,2305
3515,3347419520,3511005395,1672641537,1672643079,1542
3871,3760645796,3300511067,1672557499,1672558631,1132
3427,3607882826,3236354255,1672580211,1672581543,1332
3510,3505888598,3512392431,1672542224,1672544538,2314
3432,3478114114,3774155692,1672624411,1672627234,2823
3562,3357289672,3236499444,1672580892,1672583157,2265
3867,3890739241,3774733620,1672571222,1672574305,3083
3672,3615087943,3533294425,1672599687,1672600813,1126
3507,3915162005,3284932450,1672550536,1672550758,222
3730,3701884158,3777240360,1672561825,1672562536,711
3869,3661447322,3972083617,1672696519,1672699638,3119
3909,3337362061,3716963089,1672634599,1672636170,1571
3831,3520560590,3778597171,1672561868,1672565322,3454
3427,3417679834,3664943873,1672534523,1672537939,3416
3552,3280054198,3791436104,1672597972,1672600668,2696
3577,3534566651,3791441520,1672604793,1672605131,338
3852,3783433404,3505434346,1672683025,1672684942,1917
3682,3633735593,3224968597,1672547366,1672550300,2934
3491,3533079336,3710562338,1672536683,1672537591,908
3712,3410160376,3902760230,1672615202,1672615755,553
3616,3714670620,3760645796,1672548270,1672549861,1591
3442,3757348722,3757630221,1672596981,1672598174,1193
3621,3623266256,3621184108,1672557398,1672560865,3467
3643,3773939399,3461119815,1672699792,1672701118,1326
3509,3777694660,3534829213,1672542264,1672545105,2841
3489,3368283077,3516489668,1672571307,1672573690,2383
3523,3519818818,3512379024,1672537961,1672540896,2935
3454,3703383853,3499217428,1672534802,1672535533,731
3666,3755496114,3912891315,1672679797,1672680277,480
3482,3814305099,3305722859,1672533441,1672535038,1597
3501,3511005395,3630353876,1672674003,1672675075,1072
3870,3619922891,3618808151,1672558401,1672560931,2530
3819,3285204083,3618697021,1672645120,1672647243,2123
3460,3735374579,3893912331,1672590370,1672592420,2050
3901,3515559913,3479851674,1672537192,1672537389,197
3619,3817813340,3461119815,1672573461,1672576048,2587
3871,3515466096,3977352557,1672605618,1672605731,113
3868,3755756564,3689697817,1672601234,1672602268,1034
3698,3516444201,3510028805,1672609787,1672613083,3296
3870,3480726047,3428725843,1672667102,1672670186,3084
3434,3500613459,3885121158,1672597529,1672600566,3037
3477,3686523546,3774641380,1672564413,1672565263,850
3620,3618697021,3777147510,1672589125,1672591180,2055
3785,3284947372,3414940786,1672701868,1672705023,3155
3897,3512337405,3835985172,1672579537,1672582193,2656
3576,3401940259,3760364383,1672563796,1672564721,925
3781,3447672935,3516903528,1672638097,1672641201,3104
3775,3333403880,3921648519,1672594661,1672597926,3265
3708,3514308235,3757193551,1672582123,1672583075,952
3771,3500498112,3783771827,1672558767,1672561700,2933
3561,3276269264,3858172636,1672682849,1672683030,181
3680,3501567772,3533004959,1672692586,1672694552,1966
3488,3509756823,3519028898,1672701144,1672703264,2120
3618,3362641275,3512337405,1672545268,1672546357,1089
3691,3347419520,3380982774,1672614741,1672616060,1319
3744,3516513251,3779532653,1672589966,1672591920,1954
3434,3518194482,3756789525,1672683555,1672685612,2057
3477,3793407963,3534126409,1672624615,1672625729,1114
3779,3467779445,3665998641,1672629920,1672633362,3442
3815,3511791953,3201629017,1672685029,1672687936,2907
3722,3779854934,3505847380,1672696896,1672698062,1166
3754,3890739241,3793969543,1672563928,1672566462,2534
3663,3776244398,3755404116,1672573210,1672574139,929
3712,3209526819,3520560590,1672654527,1672655261,734
3899,3505154885,3904569677,1672694467,1672695996,1529
3529,3343816795,3299443125,1672675096,1672676543,1447
3895,3294703680,3272030610,1672646760,1672647684,924
3717,3979802715,3500347447,1672659185,1672661221,2036
3653,3777240360,3613899351,1672633093,1672635116,2023
3491,3283492940,3755737419,1672540606,1672541522,916
3699,3467988782,3734118023,1672565087,1672567199,2112
3670,3512337405,3779656423,1672702694,1672705643,2949
3780,3291933594,3773332082,1672598659,1672600694,2035
3526,3623266256,3515401243,1672596434,1672599379,2945
3895,3773837847,3780253901,1672544161,1672547521,3360
3817,3516703758,3935913584,1672571696,1672573499,1803
3840,3668747074,3392836218,1672569586,1672570993,1407
3750,3304971369,3817813340,1672641854,1672642965,1111
3842,3308760650,3710854064,1672556157,1672559490,3333
3882,3617304541,3713163045,1672648008,1672650988,2980
3833,3777330107,3622665543,1672574379,1672576108,1729
3443,3701424609,3454277788,1672652929,1672655436,2507
3435,3514512367,3349856820,1672661790,1672664510,2720
3571,3338390596,3335694356,1672626349,1672628884,2535
3768,3551389192,3512958459,1672657424,1672660952,3528
3874,3701247948,3514971533,1672696263,1672699772,3509
3510,3552824113,3701884158,1672534547,1672534671,124
3850,3739911441,3667673649,1672606140,1672606995,855
3862,3815250107,3800257590,1672657856,1672660596,2740
3706,3384583385,3905196766,1672574683,1672576609,1926
3910,3203538212,3779738691,1672649054,1672649611,557
3919,3316800320,3511843593,1672659275,1672662873,3598
3527,3755230952,3970627281,1672539391,1672541233,1842
3471,3457620713,3791796585,1672663072,1672666126,3054
3626,3900276517,3447672935,1672603787,1672606650,2863
3777,3309314379,3713911104,1672620669,1672622117,1448
3638,3511791953,3688490530,1672698137,1672698749,612
3791,3534829213,3280268483,1672579068,1672580830,1762
3517,3711218296,3551399764,1672622836,1672624772,1936
3691,3776559988,3209481722,1672696782,1672697524,742
3727,3429943738,3379143440,1672578698,1672579991,1293
3687,3478114114,3500613493,1672667837,1672669364,1527
3600,3711077927,3774705415,1672617157,1672619218,2061
3430,3834963772,3515439826,1672571408,1672573316,1908
3654,3488763230,3755233658,1672581347,1672581733,386
3448,3779738691,3927599181,1672688110,1672688191,81
3751,3373028638,3512337405,1672576680,1672577365,685
3831,3626499450,3612689556,1672583128,1672583982,854
3611,3516321888,3511005395,1672535868,1672536903,1035
3892,3633735593,3518194482,1672537576,1672540734,3158
3790,3272716462,3776244398,1672600615,1672601301,686
3643,3618354185,3710854064,1672551816,1672552379,563
3615,3668747074,3715385401,1672569567,1672570557,990
3763,3801645328,3891672228,1672678748,1672680248,1500
3639,3713691388,3312998540,1672604770,1672605430,660
3775,3226024417,3730071479,1672579995,1672580059,64
3872,3617304541,3411688875,1672696089,1672697624,1535
3891,3770468980,3757700712,1672680543,1672683170,2627
3729,3500672156,3716963089,1672575266,1672578298,3032
3707,3755233658,3367111751,1672681984,1672684564,2580
3505,3285204083,3292147449,1672572901,1672573436,535
3721,3343132529,3392943173,1672544426,1672544788,362
3679,3715854030,3462273042,1672629536,1672632835,3299
3902,3274831810,3773939399,1672601429,1672602779,1350
3885,3232208416,3892304880,1672688629,1672690414,1785
3783,3517737088,3513041785,1672544554,1672547425,2871
3840,3273981374,3622357348,1672683118,1672686454,3336
3718,3495911207,3779738691,1672573446,1672574082,636
3729,3516444201,3714067076,1672538240,1672539646,1406
3625,3367111751,3756789525,1672668748,1672669755,1007
3597,3613338363,3412968120,1672667171,1672668737,1566
3429,3501459390,3760645796,1672595585,1672596386,801
3863,3410160376,3660887799,1672590951,1672593492,2541
3686,3417191856,3457620713,1672643546,1672644875,1329
3617,3401496246,3203538212,1672604452,1672606249,1797
3445,3760651515,3515402792,1672534595,1672535180,585
3523,3367509761,3638204468,1672544719,1672547653,2934
3709,3630353876,3492546679,1672633234,1672635996,2762
3431,3424660806,3208452238,1672682143,1672685055,2912
3738,3273981374,3505663516,1672601678,1672604565,2887
3604,3516321888,3661903000,1672603645,1672605474,1829
3580,3334974375,3230135532,1672618737,1672621999,3262
3735,3636329663,3480726047,1672573813,1672576539,2726
3477,3791441520,3230868435,1672683652,1672685492,1840
3722,3711812325,3488763230,1672624028,1672624122,94
3741,3661447322,3505481368,1672689019,1672690526,1507
3607,3713589994,3760694096,1672637314,1672639682,2368
3634,3853629553,3292147449,1672539570,1672541270,1700
3898,3533004959,3970627281,1672581624,1672582895,1271
3448,3283770991,3384068080,1672677884,1672679916,2032
3677,3680843171,3770468980,1672690359,1672691310,951
3721,3517600136,3500949309,1672691939,1672694112,2173
3729,3631479562,3501384020,1672671522,1672674077,2555
3433,3755065949,3533747868,1672629422,1672629833,411
3500,3519077659,3435116799,1672567320,1672569274,1954
3776,3710496785,3510818674,1672540001,1672541088,1087
3645,3415833929,3333403880,1672627325,1672630741,3416
3675,3713941638,3305722859,1672689310,1672691096,1786
3901,3920625129,3831586487,1672650224,1672651837,1613
3886,3777184389,3375449013,1672570332,1672570572,240
3542,3505283390,3613206049,1672546421,1672548666,2245
3764,3774178201,3792014516,1672568081,1672570468,2387
3542,3970603231,3511601997,1672632562,1672632941,379
3613,3500737582,3605221116,1672610068,1672612479,2411
3424,3710008361,3375449013,1672659917,1672660279,362
3637,3755233658,3757193307,1672533152,1672536230,3078
3856,3479851674,3411688875,1672680173,1672682066,1893
3491,3333918941,3713829743,1672682389,1672682937,548
3487,3505847380,3773735484,1672580336,1672580637,301
3774,3505283390,3688490530,1672641879,1672642585,706
3670,3491469603,3491469603,1672613083,1672616019,2936
3877,3714827719,3436025562,1672582739,1672584748,2009
3449,3757863420,3240394404,1672532791,1672533415,624
3657,3205923620,3631090677,1672671820,1672671885,65
3455,3514419100,3505847380,1672674548,1672674798,250
3909,3716679950,3736705719,1672605384,1672607006,1622
3703,3792442597,3684523966,1672625075,1672627124,2049
3772,3551399764,3415833929,1672577393,1672579141,1748
3573,3467779445,3360813161,1672570044,1672570685,641
3637,3904867554,3279475486,1672583779,1672584244,465
3833,3890739241,3713784974,1672667408,1672668432,1024
3702,3780472203,3630353876,1672632581,1672635228,2647
3633,3713979100,3780909839,1672557846,1672558881,1035
3647,3780712350,3856606678,1672547390,1672548342,952
3510,3533274994,3902760230,1672606699,1672608170,1471
3914,3711853996,3821054646,1672590406,1672591423,1017
3716,3516513251,3680843171,1672537073,1672540670,3597
3915,3935913584,3703383853,1672535766,1672537898,2132
3681,3410538749,3800257590,1672639111,1672640480,1369
3712,3533188828,3776034743,1672652052,1672654603,2551
3674,3236499444,3500498112,1672655358,1672657928,2570
3646,3451726367,3533649454,1672669831,1672672326,2495
3692,3665998641,3305336154,1672655254,1672655409,155
3798,3238288884,3622357348,1672684907,1672685993,1086
3654,3701322924,3774605761,1672546827,1672546980,153
3463,3792389522,3713784974,1672638752,1672639267,515
3452,3625174002,3436025562,1672570264,1672570893,629
3700,3811040565,3319167958,1672689588,1672691999,2411
3451,3757630221,3755756564,1672548452,1672550143,1691
3494,3520764926,3714827719,1672620086,1672621786,1700
3665,3777147510,3480726047,1672623324,1672626350,3026
3763,3294747828,3505434346,1672700971,1672701528,557
3432,3716272919,3779613523,1672576485,1672578197,1712
3853,3731646673,3306412634,1672617484,1672619877,2393
3555,3792389522,3399472693,1672642190,1672642949,759
3790,3228888030,3818575661,1672538354,1672539387,1033
3620,3637313265,3533228966,1672575751,1672575866,115
3700,3923220461,3510798825,1672692535,1672694414,1879
3652,3457620713,3760362417,1672702943,1672704819,1876
3903,3519818818,3514285803,1672579777,1672582007,2230
3549,3500072204,3284947372,1672598359,1672599695,1336
3565,3374183227,3736705719,1672597637,1672600122,2485
3640,3833217041,3773913680,1672632074,1672634611,2537
3540,3519142371,3509893027,1672697465,1672700407,2942
3445,3393063657,3817428320,1672612170,1672615124,2954
3678,3760924079,3770438122,1672695563,1672696008,445
3866,3514419100,3435167810,1672565488,1672566072,584
3595,3792020993,3714827719,1672671313,1672673344,2031
3672,3624297844,3780338697,1672572405,1672574172,1767
3870,3349856820,3475349791,1672542801,1672544547,1746
3668,3500915665,3711919537,1672542370,1672542533,163
3654,3392520516,3776988674,1672630520,1672631371,851
3568,3414275042,3617392620,1672689778,1672692443,2665
3592,3513065217,3632814465,1672576483,1672577260,777
3475,3272716462,3792020993,1672617326,1672620876,3550
3580,3916490839,3517462308,1672536120,1672538561,2441
3554,3897134762,3505847380,1672559844,1672562383,2539
3616,3500672156,3773033649,1672544197,1672547097,2900
3792,3460719322,3505434346,1672596676,1672597589,913
3912,3514308235,3600876425,1672562723,1672563468,745
3530,3519850727,3760040019,1672633219,1672635968,2749
3434,3515559913,3511883730,1672561078,1672563593,2515
3859,3514334067,3770520359,1672601434,1672603625,2191
3757,3510028805,3755404116,1672558865,1672560757,1892
3775,3284932450,3200308999,1672624335,1672624758,423
3897,3739895284,3686523546,1672554900,1672557121,2221
3910,3462158237,3688796737,1672698201,1672698465,264
3912,3520322124,3714670620,1672599034,1672600154,1120
3893,3501786419,3240994288,1672612748,1672613088,340
3813,3510499038,3451691949,1672605532,1672607714,2182
3724,3618354185,3389634034,1672562493,1672565125,2632
3877,3621461051,3711000597,1672661617,1672661737,120
3782,3236499444,3829822608,1672628235,1672628655,420
3430,3614740489,3228888030,1672652117,1672655544,3427
3527,3500827202,3272030610,1672542167,1672543034,867
3836,3711077927,3715986185,1672687549,1672688653,1104
3553,3635169815,3779738691,1672600466,1672600855,389
3636,3384583385,3300818269,1672700786,1672701389,603
3907,3755737419,3311420950,1672572373,1672574647,2274
3899,3232208416,3779465522,1672620235,1672620844,609
3520,3701424609,3783136330,1672689420,1672692201,2781
3456,3515439826,3791128487,1672566747,1672568033,1286
3435,3737147209,3500109249,1672688946,1672690366,1420
3651,3515559913,3780680950,1672575204,1672577462,2258
3639,3779938251,3703139663,1672543570,1672545867,2297
3729,3510964997,3534179433,1672632233,1672633562,1329
3515,3510798825,3501384020,1672649336,1672651632,2296
3777,3229974066,3791441520,1672632564,1672635717,3153
3919,3201800997,3246370118,1672662399,1672664379,1980
3761,3512722110,3755848152,1672566613,1672568020,1407
3880,3885537225,3519142371,1672582168,1672584074,1906
3607,3757348722,3633735593,1672582784,1672583120,336
3683,3713589994,3383138270,1672549153,1672549299,146
3714,3773027597,3364726656,1672579987,1672581328,1341
3776,3510028805,3755737419,1672650590,1672650842,252
3667,3824215187,3461119815,1672686887,1672688578,1691
3796,3520639768,3703348097,1672684747,1672686807,2060
3616,3885157459,3515439826,1672571293,1672571622,329
3804,3404025196,3780209375,1672681796,1672681905,109
3626,3448633776,3519818818,1672655504,1672657844,2340
3814,3520764926,3518194482,1672538786,1672542024,3238
3777,3510767239,3505725706,1672698916,1672702363,3447
3749,3512946768,3887243870,1672699157,1672699679,522
3620,3493017654,3688796737,1672634990,1672635395,405
3906,3680843171,3479851674,1672592081,1672592254,173
3542,3554944414,3772236797,1672681171,1672681675,504
3700,3609659642,3737112297,1672620692,1672623814,3122
3647,3511791953,3792801638,1672649392,1672652979,3587
3626,3757903168,3921648519,1672626361,1672628348,1987
3588,3668747074,3713561276,1672604874,1672606573,1699
3633,3366423342,3622665543,1672631329,1672634376,3047
3672,3367971170,3209526819,1672626441,1672627595,1154
3899,3780872464,3289114629,1672563204,1672564017,813
3429,3206837348,3757075324,1672556283,1672558149,1866
3579,3229822507,3500317969,1672691330,1672693191,1861
3606,3615939504,3623266256,1672621904,1672621973,69
3815,3791441520,3438489358,1672552681,1672555021,2340
3817,3783433404,3311098437,1672699930,1672703437,3507
3450,3793935736,3620292035,1672611836,1672614900,3064
3825,3209526819,3773332082,1672590985,1672593943,2958
3721,3510554314,3505807416,1672535862,1672536325,463
3589,3394297564,3609659642,1672562972,1672565417,2445
3431,3760842815,3715086894,1672589881,1672591419,1538
3585,3906536154,3460719322,1672661298,1672664334,3036
3658,3479851674,3793781065,1672679331,1672682348,3017
3846,3557046880,3511601997,1672613384,1672616116,2732
3664,3511843593,3559458968,1672683968,1672685700,1732
3819,3793935736,3518229776,1672540580,1672541293,713
3824,3793418209,3480991549,1672689355,1672691440,2085
3638,3350095157,3488686442,1672632781,1672634130,1349
3745,3501281016,3505923418,1672604103,1672605997,1894
3905,3457960571,3512830734,1672636671,1672637935,1264
3867,3448633776,3912891315,1672675093,1672678221,3128
3884,3336339664,3492959689,1672658719,1672661269,2550
3853,3971806004,3455018347,1672550290,1672551266,976
3542,3519651506,3392836218,1672682789,1672686242,3453
3523,3299125059,3279473441,1672621974,1672625340,3366
3519,3232208416,3289817992,1672627059,1672627515,456
3562,3620292035,3783615982,1672552466,1672554671,2205
3588,3271752081,3905899155,1672680638,1672683591,2953
3615,3688220326,3311085279,1672662401,1672665528,3127
3568,3409114719,3791128487,1672589927,1672593119,3192
3915,3335694356,3776117322,1672654374,1672656835,2461
3782,3227799827,3511883730,1672583170,1672585241,2071
3766,3510554314,3770624662,1672631985,1672633416,1431
3715,3738026330,3608855425,1672586487,1672589905,3418
3711,3510641433,3757294769,1672586490,1672587791,1301
3427,3773027597,3757193551,1672693852,1672694906,1054
3902,3756385685,3760364383,1672537599,1672538252,653
3813,3897134762,3300979975,1672692301,1672695535,3234
3763,3382733096,3510837901,1672690777,1672694339,3562
3615,3513295938,3200308999,1672635346,1672636533,1187
3432,3501215099,3757700712,1672567637,1672568496,859
3511,3783919913,3485540729,1672559279,1672561756,2477
3593,3510818674,3739911441,1672617359,1672619721,2362
3672,3756704774,3776988674,1672648530,1672648998,468
3462,3360813161,3618176292,1672574786,1672577525,2739
3625,3909094917,3975717896,1672572123,1672574030,1907
3556,3241914067,3500777439,1672642991,1672645452,2461
3738,3463849738,3780712350,1672545913,1672546131,218
3500,3770146716,3518561777,1672551600,1672553940,2340
3432,3710735406,3716110860,1672700618,1672702976,2358
3448,3713979100,3778640261,1672587719,1672590677,2958
3721,3755344363,3226178937,1672585154,1672586291,1137
3540,3793743698,3760263530,1672669652,1672670257,605
3455,3383138270,3402697190,1672598657,1672602056,3399
3822,3513345163,3309314379,1672563824,1672564345,521
3557,3514308235,3428725843,1672536240,1672537983,1743
3541,3716679950,3509764635,1672570765,1672572614,1849
3715,3312998540,3739154408,1672557806,1672560647,2841
3797,3480100311,3711919537,1672585290,1672587464,2174
3911,3306412634,3617116290,1672644680,1672645784,1104
3779,3622665543,3518653080,1672630569,1672630800,231
3505,3514741348,3533747868,1672584572,1672587509,2937
3876,3777485931,3274831810,1672607300,1672610208,2908
3753,3513296868,3448633776,1672602727,1672603730,1003
3458,3821054646,3300979975,1672685903,1672686817,914
3715,3927165965,3349856820,1672556303,1672556624,321
3612,3300229945,3734451191,1672535577,1672536826,1249
3881,3791613604,3926643445,1672638222,1672638982,760
3576,3731646673,3357864626,1672671729,1672672570,841
3649,3819767045,3501215099,1672625916,1672626228,312
3689,3315703693,3270697740,1672553758,1672555675,1917
3886,3815250107,3701424609,1672578630,1672582110,3480
3439,3713691388,3349856820,1672557748,1672560711,2963
3703,3372223551,3713517039,1672695089,1672697866,2777
3573,3230135532,3510964997,1672681661,1672682785,1124
3666,3713691388,3351696332,1672655763,1672658894,3131
3448,3387594369,3399472693,1672648346,1672649022,676
3539,3701247948,3791106564,1672614498,1672617564,3066
3893,3792020993,3514703118,1672543323,1672543540,217
3540,3938389661,3455018347,1672540180,1672540915,735
3847,3245232284,3272716462,1672619228,1672621273,2045
3919,3370227921,3270042456,1672637833,1672640055,2222
3627,3711734586,3902625986,1672687578,1672689379,1801
3592,3893912331,3713561276,1672545702,1672546769,1067
3903,3756789525,3660063072,1672569429,1672572391,2962
3873,3770520359,3299781901,1672687922,1672689528,1606
3786,3834960360,3970603231,1672673819,1672674911,1092
3460,3713829743,3457620713,1672649443,1672650446,1003
3912,3517737088,3514246749,1672700809,1672702904,2095
3448,3931627862,3780209375,1672687431,1672689029,1598
3455,3902625986,3615113018,1672696055,1672696520,465
3555,3618489670,3938503547,1672536589,1672540005,3416
3902,3457620713,3308760650,1672557832,1672559308,1476
3581,3404025196,3351866415,1672561389,1672561584,195
3767,3534566651,3272030610,1672684259,1672685144,885
3726,3447672935,3777779869,1672557113,1672558897,1784
3701,3780834916,3737112297,1672665218,1672668066,2848
3734,3472312341,3923754072,1672699725,1672702988,3263
3812,3793583656,3514285803,1672659939,1672661284,1345
3680,3617392620,3505634634,1672591089,1672591264,175
3577,3852533643,3514308235,1672617257,1672618809,1552
3805,3520657891,3412006598,1672623447,1672624338,891
3790,3625174002,3513296868,1672663483,1672664345,862
3821,3615087943,3621683102,1672604110,1672604867,757
3539,3791246640,3451726367,1672539499,1672540320,821
3479,3201629017,3515466096,1672617959,1672619993,2034
3435,3780680950,3501459390,1672695146,1672696819,1673
3613,3610358027,3300511067,1672584306,1672586882,2576
3831,3779892400,3229974066,1672554680,1672556609,1929
3765,3514419100,3703396825,1672578046,1672578626,580
3840,3803389195,3791106564,1672539534,1672542211,2677
3880,3505923418,3915162005,1672642988,1672646203,3215
3911,3500672156,3615737355,1672609131,1672611514,2383
3785,3429943738,3512882178,1672633124,1672636252,3128
3797,3633735593,3349856820,1672623598,1672624534,936
3462,3480100311,3856606678,1672663872,1672666886,3014
3834,3517172354,3815392801,1672692699,1672694921,2222
3857,3774641380,3396980894,1672694522,1672695562,1040
3522,3280268483,3500915908,1672623724,1672625352,1628
3814,3608922867,3512800570,1672573390,1672576682,3292
3882,3533090502,3731646673,1672654294,1672656910,2616
3603,3783928182,3934064792,1672580292,1672583119,2827
3560,3760694096,3299125059,1672561107,1672564546,3439
3667,3811075491,3421877923,1672644589,1672645140,551
3753,3202804048,3793407963,1672668950,1672670015,1065
3484,3231494505,3604589802,1672699951,1672701220,1269
3773,3773033649,3511024016,1672593033,1672594399,1366
3701,3617116290,3517737088,1672556711,1672559370,2659
3434,3923420131,3335694356,1672627762,1672629883,2121
3784,3279473441,3520873221,1672680618,1672680791,173
3602,3291933594,3512800570,1672652782,1672653685,903
3619,3500044458,3703798634,1672639439,1672640876,1437
3462,3808136029,3779854934,1672560954,1672563517,2563
3833,3774876004,3333403880,1672666114,1672667327,1213
3887,3389634034,3755532873,1672618689,1672619322,633
3480,3402697190,3821054646,1672555163,1672558002,2839
3913,3271454397,3279339278,1672591037,1672593952,2915
3428,3500347447,3370227921,1672569807,1672570182,375
3640,3510837901,3923754072,1672694514,1672697348,2834
3764,3716110860,3716272919,1672549049,1672551707,2658
3767,3551399764,3500949309,1672565087,1672566654,1567
3777,3615087943,3396980894,1672574784,1672574896,112
3829,3351866415,3411515369,1672601323,1672604788,3465
3823,3387594369,3792020993,1672615292,1672618436,3144
3620,3449639012,3360616538,1672541253,1672542774,1521
3549,3552824113,3518565331,1672655583,1672656276,693
3617,3884596900,3300979975,1672653732,1672654178,446
3892,3778040015,3757318448,1672572367,1672574145,1778
3860,3431502855,3716272919,1672598126,1672599653,1527
3689,3226024417,3605221116,1672591700,1672591772,72
3596,3736705719,3534764451,1672571870,1672574680,2810
3654,3760040019,3500737582,1672690174,1672693244,3070
3603,3757193551,3780834916,1672595245,1672596428,1183
3540,3349856820,3716628503,1672678224,1672680532,2308
3545,3934064792,3777240360,1672536324,1672538620,2296
3666,3756385685,3519028898,1672646274,1672646612,338
3557,3491684096,3897376951,1672573981,1672575433,1452
3616,3510837901,3316800320,1672637534,1672640662,3128
3874,3480490124,3701664364,1672552385,1672554630,2245
3556,3897456874,3513081354,1672659430,1672660803,1373
3730,3347419520,3970627281,1672606662,1672607325,663
3665,3392836218,3226178937,1672605683,1672608971,3288
3526,3520578796,3231494505,1672552900,1672554700,1800
3650,3626499450,3276003502,1672634463,1672637214,2751
3573,3897376951,3462636434,1672546546,1672547743,1197
3453,3520181148,3512383699,1672544527,1672546569,2042
3537,3534829213,3520181148,1672639733,1672642753,3020
3509,3755222916,3617116290,1672690353,1672692314,1961
3615,3288762795,3703433819,1672610124,1672610959,835
3530,3505402439,3739154408,1672616117,1672619424,3307
3706,3925979970,3770236215,1672555529,1672555746,217
3864,3245232284,3711097754,1672625595,1672629131,3536
3722,3511732493,3514419100,1672557741,1672560257,2516
3446,3713768950,3505266860,1672597513,1672599804,2291
3680,3400069268,3757630221,1672668340,1672670433,2093
3903,3412968120,3615939504,1672691670,1672694686,3016
3624,3897134762,3520322124,1672628020,1672629534,1514
3822,3760694096,3518561777,1672660287,1672660724,437
3621,3713911104,3499217428,1672672089,1672673186,1097
3713,3451691949,3437286517,1672680909,1672682733,1824
3737,3755848152,3304155815,1672641055,1672643456,2401
3863,3334647380,3755756564,1672661542,1672665100,3558
3653,3928511283,3608232640,1672688032,1672688569,537
3786,3755404116,3689114185,1672626668,1672627396,728
3484,3505434346,3923420131,1672607858,1672610310,2452
3763,3928511283,3384068080,1672663942,1672665008,1066
3589,3732584121,3664943873,1672598226,1672598655,429
3911,3509893027,3497808662,1672638032,1672641457,3425
3695,3610358027,3701107228,1672660265,1672662289,2024
3914,3512722110,3835985172,1672593799,1672594659,860
3488,3304155815,3514419100,1672644640,1672647246,2606
3562,3510767239,3500498112,1672640449,1672641983,1534
3478,3200308999,3774876004,1672583755,1672586302,2547
3546,3778134418,3635169815,1672533232,1672535183,1951
3596,3300229945,3512295534,1672700763,1672700917,154
3844,3510554314,3505995057,1672695811,1672697001,1190
3562,3347419520,3791246640,1672568557,1672569154,597
3921,3229822507,3341893384,1672627240,1672630325,3085
3806,3511288998,3387594369,1672590542,1672591679,1137
3873,3770296583,3713691388,1672568774,1672571597,2823
3495,3392836218,3783163143,1672570263,1672570486,223
3655,3611055563,3271752081,1672556333,1672559752,3419
3887,3490214516,3887243870,1672699889,1672702347,2458
3434,3885537225,3714678331,1672639850,1672642388,2538
3726,3661583097,3892304880,1672670261,1672670568,307
3446,3501457103,3778134418,1672642566,1672642782,216
3517,3760924079,3710496785,1672564756,1672566282,1526
3617,3298151889,3792072681,1672539162,1672541359,2197
3587,3554944414,3613338363,1672595357,1672596067,710
3518,3817428320,3447672935,1672532561,1672533749,1188
3714,3757318448,3518229776,1672621614,1672622091,477
3453,3685816610,3472068734,1672557420,1672560864,3444
3487,3899326793,3776084820,1672587039,1672588957,1918
3653,3518565331,3604589802,1672692971,1672696084,3113
3762,3680843171,3814305099,1672592898,1672594167,1269
3770,3893912331,3505888598,1672545953,1672548089,2136
3445,3289114629,3519028898,1672628008,1672630701,2693
3466,3299125059,3202141727,1672644844,1672646452,1608
3503,3701107228,3825881598,1672604351,1672604492,141
3577,3926643445,3774705415,1672637087,1672637811,724
3880,3515525630,3814305099,1672642939,1672643257,318
3597,3609113156,3900945856,1672637205,1672637427,222
3772,3893912331,3505995057,1672574992,1672578557,3565
3668,3351866415,3773735484,1672593557,1672594074,517
3507,3306412634,3300818269,1672545170,1672548565,3395
3634,3792389522,3780834916,1672669713,1672669842,129
3710,3635169815,3792014516,1672658099,1672658469,370
3623,3932478321,3500347447,1672599047,1672601148,2101
3684,3488763230,3779613523,1672595544,1672598943,3399
3492,3770520359,3701107228,1672610749,1672614206,3457
3753,3393063657,3343132529,1672606488,1672606940,452
3889,3710496785,3661583097,1672545034,1672546609,1575
3809,3777091903,3859868849,1672663066,1672663732,666
3613,3401793306,3512958459,1672697885,1672699054,1169
3747,3783928182,3514818819,1672593332,1672593582,250
3750,3501215099,3904569677,1672562333,1672565130,2797
3877,3368283077,3779656423,1672652915,1672653021,106
3481,3661447322,3906536154,1672667039,1672668371,1332
3493,3514818819,3512800570,1672556525,1672559882,3357
3773,3611055563,3815250107,1672659748,1672663139,3391
3802,3714678331,3510187271,1672573210,1672573810,600
3665,3451726367,3205923620,1672691806,1672692818,1012
3765,3791753345,3791128487,1672541806,1672542529,723
3581,3661903000,3780909839,1672598821,1672600339,1518
3878,3608232640,3711919537,1672625827,1672629299,3472
3618,3306412634,3618354185,1672662766,1672664446,1680
3616,3225631197,3791106564,1672533239,1672536378,3139
3718,3783641602,3513295938,1672626548,1672626872,324
3762,3783136330,3793935736,1672614873,1672617597,2724
3742,3735374579,3380130228,1672639584,1672641934,2350
3868,3517172354,3774876004,1672621597,1672622395,798
3626,3513081354,3757075324,1672698649,1672698984,335
3430,3505437712,3688796737,1672660238,1672662404,2166
3619,3373089838,3533294425,1672656455,1672659890,3435
3588,3885157459,3487875183,1672568665,1672569912,1247
3459,3621461051,3755222916,1672554964,1672555151,187
3885,3760721303,3617304541,1672599938,1672600291,353
3726,3609113156,3276348699,1672685317,1672686770,1453
3705,3299443125,3613416045,1672621370,1672624807,3437
3839,3714666884,3347446226,1672629088,1672629824,736
3717,3609881958,3714233826,1672559878,1672561764,1886
3846,3701882224,3615688740,1672533426,1672534616,1190
3742,3370227921,3518229776,1672568844,1672569552,708
3647,3534829213,3821054646,1672701619,1672703820,2201
3599,3909094917,3239617320,1672583353,1672584514,1161
3430,3500613459,3916490839,1672640933,1672641400,467
3547,3780834916,3661447322,1672539802,1672540015,213
3913,3755848152,3755915206,1672619884,1672621083,1199
3449,3512946768,3625463628,1672632650,1672633233,583
3710,3701373490,3613416045,1672697001,1672699055,2054
3431,3208452238,3500915665,1672681186,1672684586,3400
3485,3755496114,3776831527,1672549520,1672552403,2883
3654,3703798634,3711097754,1672629246,1672630050,804
3861,3779854934,3499217428,1672631359,1672632828,1469
3426,3533368789,3935487534,1672599070,1672600418,1348
3884,3518194482,3360069849,1672682305,1672685240,2935
3454,3760094385,3299781901,1672672410,1672674220,1810
3495,3711000597,3497671225,1672634485,1672637719,3234
3466,3927599181,3711812325,1672663112,1672663283,171
3727,3757075324,3885537225,1672634092,1672637060,2968
3731,3226178937,3505663516,1672544853,1672545930,1077
3848,3500613459,3312998540,1672566430,1672568891,2461
3603,3501525100,3551399764,1672629360,1672631417,2057
3686,3773009828,3853629553,1672617738,1672620925,3187
3479,3773913680,3395201292,1672641931,1672644743,2812
3614,3615737355,3505154885,1672690167,1672692798,2631
3782,3480991549,3887243870,1672556940,1672558535,1595
3463,3793407963,3734915241,1672699620,1672700648,1028
3710,3520115090,3410160376,1672634912,1672637197,2285
3584,3637313265,3684523966,1672588877,1672591505,2628
3579,3608232640,3296462324,1672575982,1672578713,2731
3506,3516741440,3437286517,1672651303,1672654710,3407
3810,3904867554,3517687662,1672666099,1672668786,2687
3427,3369708250,3512379024,1672663111,1672663980,869
3837,3859868849,3935399379,1672615965,1672619270,3305
3881,3682133690,3615087943,1672675420,1672678040,2620
3893,3668414677,3367509761,1672665338,1672666100,762
3798,3927599181,3615087943,1672696087,1672699606,3519
3690,3715385401,3209526819,1672693592,1672695160,1568
3584,3780338697,3667673649,1672694310,1672697540,3230
3766,3283144118,3773572967,1672608873,1672610574,1701
3761,3443357683,3732131656,1672544022,1672547023,3001
3866,3533228966,3519142371,1672651809,1672654114,2305
3548,3519446663,3826238375,1672618898,1672619660,762
3476,3450969839,3776117322,1672647154,1672647847,693
3638,3505923418,3500317969,1672604987,1672605324,337
3730,3818575661,3347446226,1672594195,1672596014,1819
3534,3792525861,3715986185,1672536986,1672540340,3354
3774,3736231757,3341893384,1672532378,1672534614,2236
3837,3519651506,3202804048,1672681274,1672682223,949
3728,3777330107,3394297564,1672642682,1672645723,3041
3626,3276348699,3495911207,1672562712,1672565495,2783
3521,3914691363,3516321888,1672647295,1672650685,3390
3876,3456430614,3902760230,1672625317,1672626682,1365
3562,3511288998,3638204468,1672580960,1672581901,941
3657,3270697740,3735374579,1672699088,1672702624,3536
3743,3703139663,3776244398,1672536281,1672536503,222
3734,3534357694,3299781901,1672662191,1672662387,196
3594,3615939504,3660887799,1672582899,1672586089,3190
3904,3755344363,3688796737,1672546075,1672546685,610
3536,3469254160,3610358027,1672537593,1672540028,2435
3462,3904412440,3791246640,1672579437,1672581828,2391
3720,3533747868,3511442562,1672572282,1672574728,2446
3802,3928511283,3970909253,1672599706,1672601764,2058
3849,3435116799,3362641275,1672550095,1672552923,2828
3739,3714185969,3300229945,1672626182,1672629661,3479
3732,3271454397,3514285803,1672586547,1672589787,3240
3838,3780712350,3533274994,1672548688,1672549701,1013
3753,3497671225,3512392431,1672655631,1672658258,2627
3801,3760094385,3500302272,1672677038,1672677684,646
3755,3928719932,3559731671,1672684195,1672686097,1902
3448,3375449013,3518229776,1672686964,1672687523,559
3646,3773572967,3515439826,1672702436,1672703799,1363
3854,3760651515,3228888030,1672589968,1672591761,1793
3493,3604589802,3363162590,1672678463,1672680916,2453
3660,3669146016,3225631197,1672572790,1672575066,2276
3674,3229822507,3224330592,1672544172,1672544512,340
3790,3512379024,3418448389,1672655512,1672656386,874
3839,3825881598,3516513251,1672663475,1672665832,2357
3793,3513041785,3772391882,1672599030,1672599949,919
3757,3610870949,3935487534,1672562640,1672563133,493
3621,3514285803,3713829743,1672612145,1672614907,2762
3646,3739154408,3792389522,1672586264,1672589557,3293
3594,3713691388,3292147449,1672658215,1672661454,3239
3534,3283492940,3821054646,1672566190,1672566306,116
3663,3462273042,3500777439,1672661474,1672664091,2617
3811,3615939504,3505847380,1672671014,1672671939,925
3800,3625174002,3515439826,1672686879,1672687707,828
3506,3613338363,3497671225,1672570112,1672573512,3400
3582,3456430614,3386758279,1672628179,1672630231,2052
3878,3760263530,3280268483,1672643421,1672644137,716
3448,3711218296,3209526819,1672613941,1672615859,1918
3677,3500703304,3791246640,1672629900,1672632907,3007
3620,3500604680,3513345163,1672665068,1672665315,247
3736,3682133690,3791106564,1672651813,1672653325,1512
3544,3505481368,3902625986,1672562833,1672563979,1146
3554,3609659642,3428725843,1672550577,1672553484,2907
3638,3202141727,3739895284,1672625757,1672626004,247
3552,3835422146,3505283390,1672593081,1672595703,2622
3494,3900276517,3895285664,1672657631,1672658566,935
3699,3834631333,3935913584,1672628276,1672629812,1536
3788,3701373490,3520416075,1672680463,1672683237,2774
3775,3779639983,3902861231,1672646379,1672647400,1021
3878,3512958459,3369708250,1672691325,1672692181,856
3696,3500208903,3519282716,1672585969,1672587353,1384
3684,3505178849,3501525100,1672650716,1672650967,251
3690,3685681577,3505807416,1672689531,1672691844,2313
3898,3514246749,3203538212,1672684124,1672684833,709
3898,3791753345,3513018485,1672646808,1672647010,202
3478,3505266860,3380130228,1672670864,1672673756,2892
3841,3716272919,3716110860,1672559245,1672561567,2322
3585,3472068734,3392520516,1672640215,1672643568,3353
3725,3890739241,3760842815,1672560288,1672563773,3485
3913,3534179433,3607768197,1672532390,1672534123,1733
3843,3686523546,3730071479,1672567513,1672567626,113
3547,3400069268,3512392431,1672641937,1672642881,944
3512,3680843171,3510187271,1672680360,1672683937,3577
3661,3510028805,3760364383,1672549947,1672552371,2424
3857,3500109249,3514308235,1672544999,1672546297,1298
3735,3294747828,3201676087,1672573409,1672574551,1142
3889,3774790271,3312998540,1672614984,1672616561,1577
3712,3713829743,3755158925,1672680604,1672684048,3444
3805,3715986185,3501525100,1672642964,1672645241,2277
3537,3298151889,3760651515,1672566038,1672567056,1018
3778,3533228966,3226511603,1672643523,1672645185,1662
3749,3731646673,3517887477,1672612152,1672612939,787
3750,3519446663,3512379024,1672612242,1672614229,1987
3721,3505923418,3513345163,1672582356,1672583297,941
3431,3284932450,3613206049,1672586435,1672589961,3526
3748,3512958459,3304971369,1672600164,1672602876,2712
3638,3556969573,3350095157,1672696257,1672699153,2896
3628,3520115090,3791693821,1672651045,1672653619,2574
3508,3311098437,3518229776,1672576589,1672578999,2410
3768,3311085279,3933894942,1672681356,1672684214,2858
3691,3511442562,3509893027,1672602572,1672603518,946
3636,3289817992,3783373154,1672627628,1672628880,1252
3566,3533274994,3401940259,1672608061,1672610815,2754
3919,3519651506,3300229945,1672589449,1672590625,1176
3708,3979784676,3703433819,1672612061,1672614643,2582
3560,3399518841,3513296868,1672614314,1672616748,2434
3805,3715986185,3772236797,1672570152,1672571956,1804
3679,3393063657,3497808662,1672683105,1672684093,988
3599,3382733096,3403370192,1672691700,1672693355,1655
3746,3500672156,3343816795,1672675666,1672677904,2238
3473,3780769110,3627368399,1672610197,1672612008,1811
3730,3627368399,3519850727,1672608537,1672609952,1415
3455,3716679950,3760040019,1672557771,1672559894,2123
3751,3897376951,3688796737,1672539617,1672543162,3545
3612,3512722110,3756127300,1672697904,1672701490,3586
3772,3780872464,3500613493,1672671584,1672674336,2752
3876,3505154885,3347419520,1672611391,1672614217,2826
3636,3756704774,3792274796,1672542903,1672546215,3312
3507,3780769110,3927165965,1672686304,1672687248,944
3766,3500044458,3505283390,1672689085,1672691898,2813
3679,3533368789,3779854934,1672629331,1672629582,251
3535,3273981374,3516489668,1672670099,1672672840,2741
3540,3480100311,3615939504,1672545202,1672548482,3280
3678,3613581796,3517600136,1672658283,1672660497,2214
3789,3661447322,3488686442,1672541991,1672543461,1470
3785,3315279093,3669146016,1672650422,1672652678,2256
3718,3283770991,3205923620,1672622786,1672625590,2804
3693,3921648519,3770236215,1672567857,1672569597,1740
3457,3638660068,3519446663,1672678462,1672680660,2198
3482,3688220326,3779786641,1672586429,1672589051,2622
3593,3279242917,3734451191,1672659741,1672662514,2773
3485,3398731252,3774705415,1672531787,1672534781,2994
3642,3501459390,3783928182,1672676499,1672679755,3256
3521,3905899155,3209481722,1672539004,1672539621,617
3595,3364378127,3200543880,1672654518,1672655766,1248
3736,3402385957,3623266256,1672539458,1672540932,1474
3673,3351866415,3439673892,1672610639,1672610736,97
3738,3792949946,3333403880,1672645643,1672648219,2576
3654,3401793306,3923420131,1672585028,1672586107,1079
3737,3510642075,3366423342,1672650905,1672653410,2505
3775,3776831527,3520416075,1672620625,1672620948,323
3690,3793883863,3710315160,1672618276,1672619625,1349
3501,3334974375,3779938251,1672632920,1672635624,2704
3502,3500302272,3230868435,1672548119,1672551320,3201
3792,3513360004,3733363628,1672558608,1672559892,1284
3881,3814677862,3511601997,1672536118,1672539167,3049
3726,3829864515,3501215099,1672674624,1672676195,1571
3523,3501525100,3554186380,1672575666,1672576178,512
3862,3639050419,3520355798,1672601463,1672604122,2659
3600,3714233826,3713163045,1672682985,1672684431,1446
3647,3757075324,3923220461,1672553515,1672554480,965
3599,3505179890,3792525861,1672578679,1672578761,82
3717,3316800320,3516489668,1672637764,1672638579,815
3895,3604867757,3632814465,1672683626,1672684882,1256
3621,3783136330,3517991730,1672571841,1672573582,1741
3760,3713784974,3410538749,1672675828,1672676547,719
3707,3776244398,3703348097,1672533732,1672534343,611
3530,3780834916,3885157459,1672592922,1672593719,797
3600,3209481722,3756704774,1672623516,1672626200,2684
3602,3607768197,3470454332,1672543228,1672544609,1381
3726,3289114629,3684523966,1672683499,1672686030,2531
3912,3511883730,3713589994,1672680397,1672682843,2446
3449,3701005527,3783641602,1672693529,1672694503,974
3491,3514741348,3500613493,1672531974,1672535496,3522
3810,3714827719,3755158925,1672556029,1672556685,656
3792,3900898992,3772765746,1672681231,1672683619,2388
3782,3732584121,3305336154,1672651633,1672652440,807
3674,3920898925,3756704774,1672562676,1672565484,2808
3718,3791441520,3505481368,1672588130,1672591235,3105
3705,3826238375,3760362417,1672551938,1672553043,1105
3837,3823084403,3900276517,1672583627,1672585970,2343
3431,3823084403,3739661856,1672556518,1672558970,2452
3627,3556969573,3791046864,1672674803,1672677813,3010
3763,3480490124,3760094385,1672601534,1672602356,822
3429,3457960571,3716110860,1672634658,1672636127,1469
3848,3512800570,3310125159,1672653923,1672655899,1976
3472,3509756823,3299443125,1672637188,1672639328,2140
3802,3293835352,3812369928,1672614026,1672615257,1231
3814,3559458968,3715986185,1672690436,1672691914,1478
3661,3783136330,3457620713,1672659435,1672661891,2456
3812,3500109249,3793407963,1672672192,1672673731,1539
3637,3777779869,3279475486,1672639121,1672639923,802
3660,3500857494,3513345163,1672545280,1672548797,3517
3695,3300979975,3802932312,1672689137,1672689978,841
3429,3511843593,3500613459,1672641140,1672642551,1411
3630,3755496114,3515401243,1672670754,1672672181,1427
3662,3512295534,3760651515,1672589019,1672589839,820
3448,3604867757,3615939504,1672603328,1672606604,3276
3650,3311498666,3512722110,1672585009,1672586442,1433
3776,3803517637,3760924079,1672666582,1672668612,2030
3843,3400069268,3736231757,1672653881,1672655101,1220
3745,3519909393,3710315160,1672667956,1672668566,610
3560,3449333754,3618354185,1672635296,1672637472,2176
3768,3824641227,3505481368,1672605775,1672606155,380
3529,3395201292,3392520516,1672581502,1672583431,1929
3899,3517697722,3791436104,1672595822,1672598267,2445
3655,3930242012,3368283077,1672607462,1672608792,1330
3746,3780115155,3793883863,1672556421,1672556780,359
3713,3667427125,3280054198,1672579748,1672582951,3203
3877,3279475486,3513065217,1672653893,1672657036,3143
3910,3488763230,3770236215,1672684311,1672685762,1451
3737,3283492940,3734118023,1672657447,1672660730,3283
3658,3519818818,3479851674,1672699376,1672700397,1021
3477,3738026330,3374183227,1672680518,1672683378,2860
3655,3516741440,3490029863,1672614379,1672617759,3380
3575,3970198861,3515559913,1672644837,1672647729,2892
3704,3774031303,3776988674,1672542886,1672544793,1907
3750,3411688875,3480726047,1672582127,1672584004,1877
3844,3757323954,3276348699,1672673741,1672675930,2189
3689,3607768197,3777147510,1672573421,1672574704,1283
3798,3509756823,3636329663,1672684862,1672687418,2556
3734,3520657891,3779854934,1672577202,1672579100,1898
3536,3711812325,3776831527,1672673419,1672676844,3425
3554,3271752081,3757903168,1672649670,1672652936,3266
3858,3500827202,3501215099,1672598097,1672599837,1740
3733,3623266256,3778597171,1672644547,1672647536,2989
3852,3783550022,3783163143,1672549504,1672552249,2745
3458,3403370192,3793781065,1672697317,1672697931,614
3592,3512337405,3292147449,1672565886,1672567295,1409
3730,3928719932,3349739136,1672541785,1672542478,693
3465,3609933747,3608232640,1672608521,1672609885,1364
3849,3436025562,3773027597,1672601549,1672601712,163
3545,3229974066,3515890966,1672575205,1672576359,1154
3893,3514512367,3351696332,1672535301,1672535420,119
3607,3635169815,3755496114,1672669664,1672673174,3510
3468,3776117322,3909094917,1672584663,1672587305,2642
3433,3202804048,3240394404,1672627663,1672629347,1684
3843,3661903000,3400069268,1672602288,1672602557,269
3558,3737972328,3739895284,1672576989,1672578856,1867
3883,3972083617,3394297564,1672665812,1672666924,1112
3537,3512946768,3734915241,1672570979,1672571526,547
3659,3778040015,3615113018,1672644440,1672647479,3039
3635,3515401243,3778597171,1672571628,1672573571,1943
3548,3812369928,3520764926,1672550736,1672552747,2011
3501,3900945856,3783163143,1672588233,1672591041,2808
3765,3500442734,3399472693,1672565224,1672565892,668
3492,3791441520,3757348722,1672598691,1672600942,2251
3748,3760694096,3772078494,1672548890,1672550065,1175
3888,3711097754,3500857494,1672665305,1672666200,895
3869,3534829213,3887243870,1672577721,1672581266,3545
3849,3780680950,3716628503,1672590291,1672593517,3226
3734,3710048469,3914691363,1672684469,1672687941,3472
3781,3283770991,3779613523,1672551590,1672552240,650
3586,3513853403,3714120857,1672654085,1672655017,932
3614,3351696332,3776988674,1672595340,1672595515,175
3501,3755848152,3609933747,1672702953,1672705876,2923
3691,3311085279,3613899351,1672559604,1672560919,1315
3490,3533368789,3500613459,1672670235,1672672483,2248
3778,3777485931,3701322924,1672557708,1672560940,3232
3503,3500949309,3515439826,1672567877,1672570467,2590
3661,3316798920,3701373490,1672662979,1672664950,1971
3603,3774876004,3617489344,1672608335,1672608505,170
3567,3617392620,3711853996,1672619514,1672622954,3440
3749,3793407963,3889780657,1672590510,1672590591,81
3763,3932478321,3735374579,1672607326,1672608085,759
3637,3811075491,3279339278,1672650007,1672650802,795
3632,3229822507,3279339278,1672640253,1672640965,712
3725,3367971170,3755915206,1672577453,1672578770,1317
3831,3519028898,3512800570,1672606320,1672606914,594
3886,3510818674,3715443333,1672544043,1672545248,1205
3777,3380982774,3611055563,1672671433,1672673431,1998
3910,3416987084,3635169815,1672533947,1672534991,1044
3523,3449333754,3533929349,1672640000,1672642912,2912
3590,3737112297,3517600136,1672616516,1672617896,1380
3699,3272096759,3780769110,1672620086,1672622999,2913
3655,3392836218,3774733620,1672597784,1672598929,1145
3578,3468041839,3773902805,1672639536,1672641640,2104
3623,3610870949,3441348818,1672560226,1672560553,327
3735,3834960360,3776117322,1672558948,1672559271,323
3749,3611055563,3231713082,1672626787,1672626868,81
3843,3607882826,3415833929,1672572094,1672574362,2268
3428,3392520516,3703139663,1672687456,1672687660,204
3539,3608232640,3517172354,1672625056,1672625162,106
3610,3773332082,3713561276,1672660855,1672663011,2156
3580,3760651515,3715986185,1672656124,1672656649,525
3645,3824641227,3779938251,1672555991,1672557966,1975
3679,3833217041,3421877923,1672661484,1672661774,290
3457,3520355798,3685681577,1672536274,1672539293,3019
3558,3238288884,3760094385,1672619281,1672619605,324
3475,3513545422,3756474459,1672552886,1672555237,2351
3668,3829822608,3533228966,1672562025,1672565025,3000
3868,3836241528,3780115155,1672631572,1672631696,124
3448,3401940259,3625174002,1672585955,1672587935,1980
3585,3450969839,3421877923,1672623571,1672626400,2829
3750,3668533536,3480991549,1672622015,1672622161,146
3622,3783373154,3783147088,1672623373,1672626131,2758
3608,3480100311,3513065217,1672635361,1672637094,1733
3600,3460719322,3518565331,1672569239,1672569501,262
3652,3512722110,3392943173,1672698493,1672698964,471
3888,3783373154,3401496246,1672616953,1672619971,3018
3467,3791796585,3310125159,1672591543,1672594293,2750
3447,3276269264,3289114629,1672588627,1672590339,1712
3792,3289817992,3505807416,1672605903,1672607782,1879
3481,3701005527,3236499444,1672589112,1672590875,1763
3444,3520416075,3505725706,1672552753,1672553942,1189
3619,3300511067,3777189898,1672531353,1672532682,1329
3877,3500777439,3513410578,1672664426,1672666158,1732
3576,3757903168,3305336154,1672617944,1672620167,2223
3620,3534179433,3386758279,1672677848,1672678226,378
3615,3205923620,3760094385,1672652487,1672652759,272
3824,3755230952,3440137407,1672533132,1672533748,616
3868,3500498112,3230135532,1672688076,1672690084,2008
3655,3891672228,3783169442,1672691411,1672691801,390
3839,3737147209,3630353876,1672635578,1672638241,2663
3695,3364726656,3351696332,1672693858,1672694295,437
3890,3821054646,3402697190,1672645069,1672647858,2789
3852,3898314440,3451691949,1672541986,1672542198,212
3511,3776034743,3779892400,1672701941,1672705179,3238
3427,3713911104,3500347447,1672554000,1672556770,2770
3808,3730071479,3404025196,1672546713,1672549953,3240
3441,3811075491,3774243020,1672659444,1672663032,3588
3709,3276348699,3220031931,1672647000,1672648147,1147
3678,3607768197,3890739241,1672677516,1672680944,3428
3621,3448633776,3686523546,1672592203,1672595417,3214
3630,3369708250,3818575661,1672558683,1672561029,2346
3800,3294747828,3510818674,1672561449,1672564896,3447
3497,3713829743,3756385685,1672556179,1672559719,3540
3747,3627368399,3311049964,1672697016,1672698259,1243
3567,3480726047,3625463628,1672629641,1672630340,699
3781,3516298579,3445206685,1672578451,1672581742,3291
3911,3520560590,3773902805,1672696802,1672697771,969
3790,3902861231,3510798825,1672695966,1672698756,2790
3572,3279242917,3445206685,1672635468,1672636168,700
3841,3410538749,3711637255,1672655234,1672657847,2613
3640,3520991398,3701005527,1672661975,1672663073,1098
3624,3380130228,3510028805,1672540576,1672542529,1953
3426,3480100311,3272096759,1672597157,1672597241,84
3457,3639050419,3710048469,1672688739,1672691761,3022
3428,3372223551,3513081354,1672632572,1672634781,2209
3634,3688796737,3755532873,1672618471,1672621031,2560
3717,3230135532,3460719322,1672604523,1672606177,1654
3585,3791106564,3511288998,1672625812,1672626497,685
3681,3713691388,3660063072,1672579807,1672579984,177
3738,3793583656,3500915908,1672539457,1672540784,1327
3491,3460719322,3979802715,1672674787,1672677320,2533
3860,3411515369,3773033649,1672541229,1672542308,1079
3807,3440107959,3334993594,1672651563,1672653228,1665
3641,3511601997,3889780657,1672585467,1672588543,3076
3904,3519028898,3404025196,1672580080,1672580959,879
3438,3414940786,3515559913,1672591238,1672594787,3549
3674,3398198430,3755230952,1672632278,1672634981,2703
3778,3505481368,3505888598,1672601270,1672602606,1336
3641,3774243020,3475349791,1672535599,1672536821,1222
3506,3202804048,3710008361,1672665225,1672667985,2760
3702,3811075491,3777091903,1672576258,1672579466,3208
3881,3609659642,3369708250,1672562419,1672563530,1111
3680,3783136330,3904412440,1672668090,1672670379,2289
3440,3755230952,3202804048,1672590391,1672591782,1391
3524,3451326054,3977148669,1672645111,1672646744,1633
3831,3289817992,3792745809,1672565020,1672567163,2143
3879,3760721303,3409114719,1672662605,1672664457,1852
3917,3512499658,3510818674,1672607741,1672609506,1765
3852,3510798825,3208452238,1672660152,1672663280,3128
3843,3824641227,3533929349,1672615993,1672618679,2686
3920,3757383891,3311098437,1672634064,1672636676,2612
3765,3513360004,3615087943,1672584599,1672587939,3340
3773,3923220461,3783771827,1672577424,1672580360,2936
3724,3510499038,3501459390,1672689302,1672689817,515
3658,3773913680,3312998540,1672587046,1672589986,2940
3587,3760362417,3517462308,1672540954,1672541873,919
3664,3791753345,3773572967,1672687516,1672688061,545
3438,3517737088,3811075491,1672553181,1672554231,1050
3466,3791693821,3362641275,1672630692,1672634203,3511
3879,3209526819,3300979975,1672692781,1672693604,823
3572,3505154885,3501459390,1672682357,1672683364,1007
3755,3520560590,3791106564,1672533358,1672533858,500
3647,3520416075,3811075491,1672661873,1672663345,1472
3477,3514512367,3274831810,1672644601,1672646545,1944
3814,3715385401,3383138270,1672650545,1672651938,1393
3777,3511843593,3731646673,1672558481,1672560858,2377
3790,3372223551,3396980894,1672694206,1672695253,1047
3672,3613206049,3923754072,1672700438,1672702215,1777
3916,3512392431,3613899351,1672630574,1672632906,2332
3489,3475349791,3756385685,1672532244,1672534785,2541
3705,3461119815,3715619259,1672660608,1672663915,3307
3815,3836241528,3975717896,1672642121,1672642670,549
3785,3834963772,3701884158,1672641756,1672645108,3352
3665,3412006598,3669146016,1672679177,1672679320,143
3678,3505228454,3557046880,1672553484,1672556671,3187
3583,3683113954,3613899351,1672604420,1672606641,2221
3841,3770438122,3715854030,1672531381,1672531509,128
3696,3520115090,3686227677,1672625839,1672626973,1134
3616,3920497528,3733558985,1672554183,1672557549,3366
3575,3276269264,3499217428,1672590216,1672591551,1335
3858,3770468980,3451691949,1672542453,1672545177,2724
3623,3283144118,3333403880,1672583864,1672586924,3060
3590,3615939504,3392836218,1672576851,1672577312,461
3741,3621790707,3779938251,1672666040,1672666584,544
3546,3856606678,3791693821,1672606635,1672607106,471
3447,3900898992,3554186380,1672605013,1672607652,2639
3602,3389634034,3556969573,1672701562,1672702880,1318
3824,3417679834,3737147209,1672623123,1672623662,539
3694,3891672228,3686227677,1672587445,1672587972,527
3796,3605221116,3333918941,1672605110,1672606618,1508
3785,3248058676,3885537225,1672673669,1672676370,2701
3478,3401496246,3631479562,1672693527,1672694981,1454
3649,3497095254,3452016771,1672581691,1672584550,2859
3582,3510818674,3892304880,1672608454,1672609286,832
3657,3710315160,3757294769,1672638140,1672638804,664
3714,3238288884,3367509761,1672572518,1672572669,151
3472,3491469603,3226024417,1672680449,1672682527,2078
3591,3519446663,3817813340,1672579982,1672582169,2187
3830,3793935736,3783550022,1672672578,1672674850,2272
3518,3519087371,3417191856,1672599093,1672601666,2573
3727,3714233826,3780472203,1672558813,1672559150,337
3593,3885157459,3701247948,1672695551,1672698732,3181
3803,3833217041,3979802715,1672595114,1672595715,601
3820,3622665543,3350095157,1672613063,1672615058,1995
3541,3338390596,3510499038,1672675839,1672678374,2535
3426,3639050419,3731646673,1672574346,1672576580,2234
3663,3792745809,3446533960,1672609280,1672611579,2299
3535,3248058676,3774243020,1672684500,1672686733,2233
3448,3780322355,3701882224,1672667214,1672667838,624
3846,3505521218,3500317969,1672652268,1672652374,106
3564,3412006598,3814305099,1672662162,1672663063,901
3529,3411515369,3512337405,1672588228,1672591813,3585
3472,3975717896,3714233826,1672702268,1672704266,1998
3819,3380982774,3933894942,1672655053,1672657478,2425
3568,3398731252,3360069849,1672649209,1672651610,2401
3609,3341893384,3347419520,1672600335,1672601062,727
3563,3680843171,3472312341,1672554908,1672556103,1195
3839,3638660068,3927165965,1672586806,1672590259,3453
3672,3382733096,3519818818,1672597352,1672598185,833
3592,3783163143,3757075324,1672639431,1672640441,1010
3509,3392943173,3512295534,1672531385,1672533571,2186
3733,3367111751,3401940259,1672703076,1672706309,3233
3747,3333918941,3505634634,1672668780,1672669079,299
3595,3241790910,3519446663,1672670248,1672673579,3331
3833,3899786664,3509893027,1672610915,1672611066,151
3721,3497808662,3386758279,1672671179,1672671748,569
3692,3625463628,3369708250,1672608212,1672610978,2766
3601,3774733620,3276348699,1672579226,1672581397,2171
3838,3885157459,3856606678,1672659628,1672661896,2268
3864,3341893384,3511288998,1672563202,1672566433,3231
3855,3927403123,3456430614,1672532476,1672535113,2637
3814,3755737419,3839245934,1672551725,1672553290,1565
3435,3366423342,3612689556,1672558784,1672561845,3061
3452,3701005527,3421877923,1672618245,1672620289,2044
3636,3801645328,3792525861,1672615746,1672618270,2524
3805,3518653080,3399518841,1672628657,1672629287,630
3856,3971806004,3402697190,1672660117,1672662411,2294
3825,3621683102,3630353876,1672630599,1672633338,2739
3751,3393063657,3279475486,1672569702,1672572445,2743
3632,3505198734,3409114719,1672696928,1672698332,1404
3498,3923220461,3773027597,1672608498,1672609300,802
3894,3533188828,3511791953,1672660058,1672662062,2004
3471,3299125059,3336627643,1672686100,1672686163,63
3614,3510798825,3510818674,1672664211,1672664303,92
3493,3792489602,3756704774,1672596366,1672599549,3183
3921,3512383699,3774907131,1672697310,1672699215,1905
3901,3228888030,3834963772,1672685025,1672686540,1515
3882,3783641602,3613338363,1672676499,1672677317,818
3767,3394401087,3755230952,1672659888,1672662590,2702
3425,3776034743,3714827719,1672648920,1672649893,973
3894,3970198861,3701664364,1672601424,1672604575,3151
3568,3620292035,3756789525,1672544200,1672546805,2605
3437,3780209375,3621790707,1672628343,1672630479,2136
3722,3760651515,3885157459,1672693144,1672693331,187
3558,3401496246,3517881647,1672532392,1672534298,1906
3476,3711097754,3927599181,1672553622,1672557126,3504
3447,3760640999,3621683102,1672613381,1672613571,190
3719,3316798920,3415833929,1672632415,1672634146,1731
3629,3299781901,3519909393,1672622754,1672623370,616
3811,3892304880,3337362061,1672613393,1672616032,2639
3835,3620292035,3309314379,1672563050,1672566449,3399
3483,3613416045,3890739241,1672673228,1672675137,1909
3736,3757318448,3280268483,1672637589,1672638398,809
3678,3517590837,3757383891,1672673366,1672676648,3282
3567,3456430614,3411515369,1672686072,1672687591,1519
3672,3220031931,3661583097,1672659599,1672661627,2028
3906,3510028805,3200543880,1672534762,1672536949,2187
3649,3714666884,3621683102,1672591143,1672592153,1010
3878,3306412634,3755404116,1672560424,1672563318,2894
3834,3514419100,3668747074,1672616582,1672617251,669
3518,3514419100,3445206685,1672621639,1672623007,1368
3629,3418448389,3510837901,1672625107,1672628469,3362
3537,3812534508,3638204468,1672682879,1672684939,2060
3567,3428725843,3898314440,1672605281,1672608235,2954
3736,3448633776,3283492940,1672670192,1672670467,275
3614,3462158237,3270056120,1672553972,1672555760,1788
3511,3618176292,3611055563,1672605976,1672608413,2437
3577,3435167810,3680810086,1672578969,1672581657,2688
3681,3533929349,3298151889,1672671154,1672672100,946
3518,3514741348,3519651506,1672672865,1672673062,197
3662,3533079336,3774907131,1672622394,1672623427,1033
3585,3711000597,3224330592,1672549955,1672553061,3106
3578,3513853403,3737147209,1672555557,1672557387,1830
3814,3511601997,3821054646,1672588858,1672591958,3100
3799,3399518841,3615688740,1672661215,1672661935,720
3436,3517600136,3333918941,1672531352,1672534770,3418
3760,3520764926,3613416045,1672572240,1672574739,2499
3606,3780834916,3394297564,1672682761,1672682925,164
3632,3500709774,3510798825,1672676614,1672679621,3007
3650,3334647380,3298151889,1672574199,1672577233,3034
3452,3780253901,3933894942,1672693055,1672695292,2237
3570,3715986185,3272096759,1672544192,1672546910,2718
3904,3756474459,3438078818,1672641091,1672641979,888
3684,3734451191,3501786419,1672539895,1672542689,2794
3818,3900945856,3739895284,1672700200,1672703797,3597
3825,3334647380,3905196766,1672701170,1672701430,260
3503,3735374579,3938503547,1672687555,1672689443,1888
3625,3902861231,3513345163,1672597934,1672599134,1200
3491,3520181148,3310039260,1672582336,1672584746,2410
3716,3512379024,3615939504,1672659646,1672661487,1841
3759,3715385401,3519416013,1672592927,1672594638,1711
3597,3800257590,3812369928,1672609032,1672609615,583
3578,3770438122,3480490124,1672689742,1672690693,951
3895,3665998641,3711218296,1672636404,1672636992,588
3641,3760651515,3617304541,1672555293,1672556339,1046
3804,3510919821,3509764635,1672605597,1672608883,3286
3689,3512392431,3519028898,1672556854,1672558422,1568
3860,3815250107,3512946768,1672536310,1672539471,3161
3797,3511317276,3428725843,1672619303,1672620038,735
3530,3817428320,3505847380,1672669890,1672671640,1750
3573,3920625129,3376467719,1672670900,1672672016,1116
3640,3638660068,3240394404,1672589618,1672591908,2290
3663,3500857494,3515439826,1672662941,1672665366,2425
3669,3757383891,3773735484,1672662193,1672663385,1192
3429,3512830734,3500072204,1672592007,1672592440,433
3897,3774907131,3757193307,1672582189,1672583689,1500
3511,3773332082,3624297844,1672648726,1672650571,1845
3665,3303410628,3737972328,1672634792,1672635211,419
3516,3305336154,3208452238,1672621514,1672622625,1111
3735,3703383853,3920497528,1672640220,1672640980,760
3568,3897134762,3609881958,1672609111,1672609203,92
3567,3858172636,3755756564,1672698292,1672701670,3378
3632,3367111751,3770438122,1672535174,1672535722,548
3645,3226178937,3627368399,1672540032,1672540092,60
3774,3711812325,3792525861,1672597582,1672600259,2677
3772,3513360004,3414049538,1672681631,1672681992,361
3775,3682133690,3757332128,1672611097,1672612958,1861
3652,3715707380,3713979100,1672646190,1672647826,1636
3552,3347419520,3885537225,1672693127,1672695340,2213
3621,3713784974,3386758279,1672599958,1672603126,3168
3661,3783147088,3299125059,1672616717,1672617463,746
3732,3224968597,3608855425,1672538591,1672539736,1145
3805,3534829213,3812369928,1672556738,1672559431,2693
3442,3938503547,3777814504,1672669695,1672670270,575
3729,3770676872,3780253901,1672610193,1672611781,1588
3780,3977352557,3375449013,1672609448,1672612781,3333
3785,3450969839,3272030610,1672650749,1672653263,2514
3873,3661447322,3505847380,1672543441,1672545267,1826
3602,3755737419,3296462324,1672579120,1672580627,1507
3885,3791796585,3669146016,1672695249,1672695717,468
3613,3893912331,3780472203,1672587923,1672590979,3056
3477,3776244398,3703383853,1672650973,1672654190,3217
3720,3904412440,3885157459,1672611205,1672613165,1960
3484,3519651506,3510187271,1672563498,1672566540,3042
3637,3519077659,3627368399,1672602595,1672602665,70
3496,3792442597,3396980894,1672657257,1672660482,3225
3816,3371455553,3517590837,1672628881,1672630187,1306
3681,3777330107,3756474459,1672613480,1672615080,1600
3862,3793315718,3760651515,1672574820,1672576212,1392
3766,3618808151,3783373154,1672628294,1672630069,1775
3535,3490029863,3688796737,1672591151,1672591804,653
3526,3711919537,3895285664,1672689935,1672692982,3047
3766,3625174002,3505402439,1672535389,1672538678,3289
3629,3779613523,3778040015,1672574625,1672575983,1358
3829,3689697817,3772765746,1672637826,1672640799,2973
3673,3617304541,3514246749,1672626369,1672628421,2052
3461,3497808662,3437286517,1672537763,1672537828,65
3431,3513081354,3779938251,1672619967,1672621124,1157
3890,3618354185,3505725706,1672622256,1672624333,2077
3753,3780209375,3305722859,1672671938,1672672050,112
3495,3880926355,3509756823,1672658912,1672662369,3457
3764,3617489344,3777485931,1672541645,1672543142,1497
3507,3885155975,3713911104,1672693044,1672695886,2842
3660,3409114719,3791436104,1672688913,1672690779,1866
3801,3462158237,3276269264,1672646909,1672647805,896
3648,3731646673,3309314379,1672544592,1672545305,713
3590,3791246640,3519909393,1672598405,1672599088,683
3739,3516489668,3689114185,1672588161,1672590176,2015
3535,3319167958,3920497528,1672667825,1672670970,3145
3492,3780427126,3801645328,1672561193,1672561952,759
3458,3970603231,3807212280,1672691527,1672694798,3271
3838,3783919913,3774031303,1672565908,1672566495,587
3609,3294703680,3241790910,1672678464,1672680852,2388
3487,3626499450,3493017654,1672552833,1672553661,828
3657,3834963772,3793743698,1672589991,1672591071,1080
3764,3241790910,3245232284,1672556203,1672559413,3210
3770,3773033649,3501457103,1672642274,1672645411,3137
3559,3975717896,3779786641,1672578096,1672581568,3472
3602,3792442597,3905196766,1672650335,1672651282,947
3581,3714128600,3491684096,1672655789,1672658072,2283
3731,3778926763,3364378127,1672586799,1672587704,905
3920,3925979970,3229822507,1672547685,1672548932,1247
3582,3897376951,3520578796,1672560590,1672562796,2206
3524,3288762795,3402697190,1672663422,1672665673,2251
3637,3701322924,3435116799,1672619064,1672621119,2055
3427,3227799827,3514334067,1672597357,1672597462,105
3805,3970909253,3779646172,1672590241,1672592923,2682
3850,3519142371,3501567772,1672683309,1672683518,209
3913,3398731252,3370227921,1672573650,1672574542,892
3887,3793922324,3310125159,1672668478,1672671791,3313
3904,3517737088,3509756823,1672703230,1672704774,1544
3909,3510554314,3311498666,1672601022,1672602207,1185
3558,3636329663,3713589994,1672679202,1672679888,686
3754,3485540729,3974674109,1672608295,1672609705,1410
3470,3780338697,3889780657,1672583476,1672584918,1442
3456,3714185969,3793315718,1672624861,1672627041,2180
3870,3622665543,3905196766,1672688385,1672689404,1019
3804,3793407963,3792745809,1672645412,1672647700,2288
3432,3793315718,3714670620,1672597926,1672600428,2502
3459,3604867757,3625174002,1672700593,1672703906,3313
3884,3534126409,3715986185,1672631766,1672633444,1678
3767,3779532653,3481640525,1672600971,1672604498,3527
3580,3559731671,3618808151,1672598666,1672600136,1470
3740,3970558632,3520991398,1672680979,1672681520,541
3686,3793740407,3902760230,1672625819,1672626032,213
3486,3396726504,3367111751,1672647384,1672650395,3011
3663,3859868849,3734451191,1672633891,1672636231,2340
3648,3559731671,3384583385,1672627424,1672629328,1904
3501,3615113018,3783163143,1672670195,1672671297,1102
3470,3732131656,3935487534,1672537910,1672541201,3291
3755,3777189898,3414940786,1672564332,1672566219,1887
3466,3920898925,3680843171,1672554141,1672556945,2804
3518,3793868716,3514512367,1672548653,1672550432,1779
3714,3431460073,3440107959,1672578316,1672581185,2869
3562,3756127300,3701424609,1672671174,1672674266,3092
3780,3925979970,3779938251,1672687779,1672691016,3237
3659,3360813161,3928719932,1672629286,1672631110,1824
3750,3516298579,3367971170,1672670488,1672671159,671
3683,3757318448,3463849738,1672532575,1672535381,2806
3532,3402697190,3660887799,1672571972,1672575078,3106
3570,3817813340,3975717896,1672533319,1672533462,143
3577,3226024417,3756127300,1672701828,1672704332,2504
3615,3780712350,3739154408,1672644359,1672645456,1097
3646,3858172636,3315703693,1672639219,1672639469,250
3603,3791046864,3220031931,1672675468,1672676070,602
3745,3497808662,3410538749,1672664849,1672664968,119
3774,3450286949,3887243870,1672637488,1672640835,3347
3447,3519087371,3683113954,1672655171,1672656340,1169
3790,3362641275,3303410628,1672677035,1672678589,1554
3803,3811040565,3774718695,1672558040,1672561031,2991
3681,3757348722,3517697722,1672597215,1672597435,220
3584,3517737088,3367971170,1672533599,1672535125,1526
3513,3738026330,3703433819,1672643180,1672643741,561
3606,3780427126,3436025562,1672569706,1672570260,554
3435,3520991398,3715086894,1672691532,1672694019,2487
3729,3360616538,3364726656,1672576823,1672577137,314
3816,3512282789,3757193307,1672575386,1672577086,1700
3718,3760721303,3668414677,1672656428,1672659324,2896
3639,3884596900,3773332082,1672552444,1672553363,919
3853,3513081354,3609113156,1672664458,1672666606,2148
3787,3201800997,3274906650,1672570145,1672571678,1533
3700,3240394404,3716628503,1672685305,1672688816,3511
3656,3520322124,3807212280,1672673286,1672674759,1473
3753,3209481722,3774705415,1672532153,1672533667,1514
3904,3559731671,3904569677,1672628841,1672629031,190
3599,3739661856,3516489668,1672678289,1672679782,1493
3432,3551399764,3392836218,1672692779,1672693843,1064
3877,3970603231,3412006598,1672620706,1672622241,1535
3529,3225631197,3733558985,1672541773,1672542251,478
3449,3760842815,3667673649,1672603224,1672605511,2287
3530,3238288884,3755344363,1672670942,1672672820,1878
3665,3305336154,3773913680,1672570814,1672573682,2868
3688,3414940786,3667673649,1672634149,1672634617,468
3681,3701322924,3792489602,1672634507,1672634676,169
3789,3224330592,3814305099,1672582473,1672582720,247
3668,3621790707,3480490124,1672640326,1672641768,1442
3764,3779425804,3617116290,1672554003,1672556887,2884
3644,3904412440,3714670620,1672691956,1672695471,3515
3474,3685681577,3312998540,1672647052,1672650569,3517
3429,3294703680,3760645796,1672608987,1672611677,2690
3728,3500044458,3711637255,1672539087,1672541898,2811
3510,3490029863,3291933594,1672558577,1672560109,1532
3457,3534179433,3836241528,1672645922,1672646066,144
3632,3468041839,3334951866,1672618612,1672622027,3415
3708,3760364383,3780571086,1672533267,1672535234,1967
3895,3452016771,3437286517,1672627216,1672628947,1731
3483,3979802715,3638204468,1672595423,1672597174,1751
3799,3291933594,3515439826,1672561990,1672562146,156
3480,3703139663,3500044458,1672702143,1672702971,828
3835,3703798634,3534829213,1672671122,1672673356,2234
3490,3905196766,3357289672,1672569164,1672572397,3233
3789,3228888030,3605221116,1672645376,1672646802,1426
3424,3517887477,3387594369,1672579959,1672582635,2676
3588,3664943873,3793868716,1672690777,1672693186,2409
3870,3271454397,3334993594,1672539472,1672542869,3397
3615,3500703304,3979784676,1672674576,1672677949,3373
3915,3376467719,3774705415,1672622744,1672625224,2480
3822,3710315160,3492959689,1672535309,1672535464,155
3697,3509483172,3664943873,1672640360,1672640892,532
3608,3701136026,3468041839,1672569544,1672570296,752
3864,3737112297,3783169442,1672628664,1672629574,910
3778,3334993594,3510798825,1672667071,1672667402,331
3470,3668533536,3298151889,1672621748,1672623749,2001
3793,3834963772,3551389192,1672611784,1672614793,3009
3759,3333918941,3912891315,1672591241,1672591752,511
3585,3777779869,3716628503,1672555342,1672558762,3420
3541,3289114629,3511791953,1672533390,1672533739,349
3516,3770296583,3291933594,1672663635,1672663731,96
3692,3812369928,3404025196,1672699453,1672703042,3589
3475,3783771827,3731646673,1672547931,1672550461,2530
3736,3715400486,3609881958,1672553194,1672555316,2122
3713,3905196766,3776559988,1672567203,1672569210,2007
3885,3916490839,3792442597,1672541926,1672542625,699
3823,3280054198,3551376095,1672540294,1672542800,2506
3812,3773124276,3202804048,1672602608,1672604715,2107
3740,3783550022,3336627643,1672661183,1672661880,697
3524,3703396825,3534179433,1672654550,1672655416,866
3807,3500317969,3520181148,1672559056,1672560042,986
3650,3468041839,3970627281,1672531681,1672534355,2674
3430,3448633776,3514818819,1672651703,1672654651,2948
3793,3533649454,3774876004,1672606348,1672609058,2710
3563,3778926763,3604867757,1672626824,1672630374,3550
3719,3505179890,3970603231,1672700871,1672702802,1931
3875,3520322124,3772078494,1672656813,1672658889,2076
3642,3777189898,3354144091,1672703098,1672705418,2320
3593,3226178937,3517358573,1672584526,1672585132,606
3477,3462636434,3755158925,1672580472,1672581621,1149
3740,3774705415,3226511603,1672696538,1672699564,3026
3758,3410600350,3855583256,1672569666,1672570846,1180
3584,3668747074,3505402439,1672540086,1672541341,1255
3758,3757332128,3467988782,1672678812,1672681127,2315
3500,3777694660,3516489668,1672550532,1672552042,1510
3796,3621184108,3776034743,1672575203,1672576003,800
3497,3685816610,3519818818,1672624343,1672624514,171
3483,3399472693,3625174002,1672562663,1672562837,174
3840,3779892400,3826238375,1672608860,1672609263,403
3516,3472312341,3500208903,1672553017,1672555246,2229
3534,3514334067,3780209375,1672611639,1672613949,2310
3784,3417679834,3715127070,1672611947,1672615510,3563
3645,3519651506,3280054198,1672702282,1672704388,2106
3800,3608855425,3802932312,1672578196,1672579192,996
3635,3912891315,3279473441,1672599918,1672602097,2179
3842,3711919537,3376467719,1672667310,1672669482,2172
3670,3916490839,3500613459,1672645519,1672647034,1515
3705,3757294769,3773902805,1672604886,1672605376,490
3511,3736705719,3485540729,1672667707,1672669333,1626
3560,3636329663,3272096759,1672595155,1672595635,480
3488,3850911686,3363162590,1672547823,1672550379,2556
3781,3715986185,3431502855,1672559809,1672560309,500
3688,3668533536,3513545422,1672581564,1672584145,2581
3697,3915162005,3614740489,1672562114,1672565036,2922
3509,3792525861,3283144118,1672699823,1672700859,1036
3890,3972192593,3505725706,1672568162,1672568438,276
3538,3620292035,3513545422,1672583678,1672585758,2080
3576,3779465522,3808136029,1672568254,1672570700,2446
3908,3685681577,3814677862,1672683714,1672687312,3598
3553,3245232284,3227799827,1672662298,1672665844,3546
3785,3227799827,3236354255,1672647037,1672649102,2065
3807,3760694096,3505228454,1672563144,1672565135,1991
3729,3516298579,3914691363,1672647896,1672649573,1677
3665,3304155815,3783641602,1672674888,1672675191,303
3469,3518194482,3631479562,1672627934,1672629654,1720
3859,3710496785,3770468980,1672673542,1672675701,2159
3446,3518229776,3669146016,1672686506,1672686743,237
3823,3298151889,3776518452,1672566492,1672567822,1330
3756,3686227677,3618697021,1672549950,1672550830,880
3575,3711218296,3500302272,1672588090,1672589703,1613
3573,3779646172,3511843593,1672694403,1672697560,3157
3752,3518229776,3755404116,1672548297,1672551730,3433
3433,3637313265,3516903528,1672689760,1672693278,3518
3439,3808136029,3505154885,1672557118,1672558512,1394
3449,3757903168,3755230952,1672696738,1672699722,2984
3888,3467988782,3755404116,1672677159,1672677273,114
3864,3783919913,3279339278,1672663891,1672665912,2021
3509,3509366311,3760842815,1672572656,1672573547,891
3458,3241790910,3774605761,1672546744,1672547821,1077
3480,3367509761,3418448389,1672569263,1672571947,2684
3687,3511150845,3501786419,1672545552,1672548642,3090
3527,3772765746,3467988782,1672561135,1672561636,501
3797,3534175249,3431502855,1672603790,1672607299,3509
3715,3519028898,3808136029,1672672619,1672674427,1808
3492,3347419520,3505847380,1672572198,1672572969,771
3607,3779646172,3815392801,1672594397,1672596027,1630
3816,3370227921,3412968120,1672612886,1672614431,1545
3427,3512830734,3384583385,1672584390,1672587327,2937
3791,3610358027,3714233826,1672689685,1672690903,1218
3469,3927403123,3715974659,1672696777,1672697450,673
3700,3501384020,3811075491,1672571930,1672574563,2633
3772,3777485931,3241914067,1672678502,1672682002,3500
3658,3778899160,3491684096,1672665775,1672666141,366
3508,3512882178,3710854064,1672664860,1672667534,2674
3891,3512502036,3480100311,1672643888,1672646605,2717
3825,3730071479,3516298579,1672626063,1672627324,1261
3824,3715545685,3831586487,1672664355,1672666598,2243
3705,3509483172,3777184389,1672623045,1672626009,2964
3552,3337322736,3412006598,1672618517,1672619538,1021
3649,3714120857,3517288083,1672577562,1672580733,3171
3476,3534566651,3756625818,1672679208,1672681398,2190
3798,3609933747,3669146016,1672649048,1672649638,590
3437,3739911441,3487875183,1672665016,1672666080,1064
3797,3291933594,3480490124,1672532041,1672533623,1582
3698,3410538749,3511883730,1672593805,1672595282,1477
3504,3399518841,3534566651,1672628919,1672629051,132
3573,3783163143,3520416075,1672580887,1672583379,2492
3741,3776559988,3783550022,1672660835,1672663428,2593
3723,3710854064,3609113156,1672547620,1672549510,1890
3564,3387594369,3774178201,1672564140,1672564294,154
3884,3517222913,3428725843,1672681921,1672684907,2986
3756,3757075324,3610870949,1672598692,1672599358,666
3657,3711000597,3500915665,1672700537,1672702744,2207
3478,3273981374,3291933594,1672603278,1672606133,2855
3814,3792489602,3492959689,1672598131,1672599190,1059
3503,3492959689,3774718695,1672572652,1672575783,3131
3816,3780834916,3916490839,1672589719,1672590004,285
3515,3516489668,3512383699,1672589144,1672590488,1344
3562,3701107228,3510837901,1672653022,1672653920,898
3611,3534126409,3622665543,1672575029,1672577272,2243
3820,3408498208,3736705719,1672649480,1672652910,3430
3866,3618697021,3660887799,1672580137,1672581812,1675
3459,3613416045,3620292035,1672587046,1672589328,2282
3432,3613206049,3515402792,1672583180,1672585590,2410
3847,3500703304,3971806004,1672606887,1672609228,2341
3557,3512379024,3357864626,1672703866,1672706152,2286
3618,3520115090,3500442734,1672702042,1672704207,2165
3651,3311498666,3517172354,1672634730,1672635533,803
3448,3904412440,3460719322,1672589200,1672592533,3333
3778,3701107228,3516489668,1672581066,1672581151,85
3444,3440137407,3836241528,1672570765,1672572733,1968
3772,3757383891,3777624586,1672650453,1672653495,3042
3574,3770704999,3660887799,1672678480,1672681618,3138
3807,3755065949,3920625129,1672678654,1672679890,1236
3506,3505521218,3308760650,1672651114,1672654516,3402
3687,3500737582,3615688740,1672698160,1672698665,505
3526,3462158237,3201676087,1672553032,1672553475,443
3434,3373089838,3638660068,1672592166,1672595317,3151
3763,3279473441,3367509761,1672577745,1672579623,1878
3575,3757318448,3711077927,1672562966,1672563202,236
3495,3363162590,3621461051,1672631434,1672633911,2477
3727,3201629017,3335694356,1672637504,1672640088,2584
3825,3517887477,3686227677,1672666690,1672666849,159
3876,3615113018,3514324011,1672565972,1672568753,2781
3714,3777814504,3885155975,1672676360,1672676582,222
3780,3209481722,3289817992,1672678399,1672681293,2894
3757,3935913584,3519909393,1672697244,1672698597,1353
3644,3737147209,3516513251,1672546163,1672548128,1965
3756,3615087943,3887243870,1672559024,1672559530,506
3905,3914691363,3972083617,1672592358,1672592758,400
3600,3793969543,3510818674,1672623062,1672624049,987
3690,3713784974,3480991549,1672572139,1672572594,455
3510,3710854064,3732131656,1672588888,1672591979,3091
3811,3618808151,3300979975,1672604106,1672606697,2591
3852,3801645328,3308760650,1672634139,1672636006,1867
3619,3600876425,3970603231,1672644248,1672647752,3504
3807,3512383699,3774733620,1672672129,1672673885,1756
3836,3501215099,3276003502,1672679168,1672681388,2220
3474,3895285664,3926643445,1672648358,1672651725,3367
3851,3399518841,3500777439,1672584921,1672588110,3189
3484,3516513251,3480991549,1672634129,1672637175,3046
3541,3927599181,3755992176,1672676696,1672676774,78
3677,3774243020,3448875382,1672687020,1672690127,3107
3452,3505228454,3757700712,1672683838,1672685525,1687
3791,3668414677,3306175858,1672613479,1672614088,609
3502,3334974375,3770624662,1672578574,1672580803,2229
3503,3793407963,3488686442,1672559260,1672559541,281
3750,3731646673,3916490839,1672654353,1672654718,365
3772,3396726504,3701322924,1672533560,1672533704,144
3539,3370227921,3312998540,1672651264,1672654202,2938
3541,3618808151,3778899160,1672574615,1672576701,2086
3713,3701005527,3534764451,1672682950,1672684320,1370
3674,3519446663,3800257590,1672631990,1672632438,448
3663,3516903528,3757294769,1672668832,1672669933,1101
3709,3760645796,3280054198,1672580126,1672581618,1492
3584,3414940786,3938503547,1672536026,1672537754,1728
3849,3514818819,3310125159,1672622006,1672623881,1875
3824,3518561777,3245232284,1672554933,1672555726,793
3643,3713911104,3492959689,1672559432,1672562503,3071
3545,3500072204,3505481368,1672641909,1672644509,2600
3554,3501215099,3756789525,1672534592,1672538172,3580
3562,3714120857,3731646673,1672627737,1672629273,1536
3762,3336627643,3760645796,1672572538,1672574540,2002
3791,3520115090,3755915206,1672642445,1672645240,2795
3440,3505198734,3777485931,1672622385,1672624285,1900
3718,3437286517,3559731671,1672581522,1672581821,299
3740,3438078818,3979784676,1672698586,1672702109,3523
3690,3701373490,3779301501,1672684496,1672685033,537
3440,3783641602,3935913584,1672592151,1672595616,3465
3842,3299443125,3512295534,1672642828,1672646028,3200
3619,3534126409,3479851674,1672678409,1672680694,2285
3725,3271752081,3488686442,1672675927,1672676404,477
3870,3701107228,3713300120,1672579969,1672581200,1231
3764,3519909393,3779301501,1672668909,1672671530,2621
3882,3336627643,3701664364,1672574569,1672575281,712
3842,3500109249,3713300120,1672686981,1672688425,1444
3664,3777330107,3398198430,1672549078,1672551824,2746
3440,3713163045,3280268483,1672579118,1672581287,2169
3675,3615087943,3330340793,1672694998,1672696981,1983
3691,3779786641,3756789525,1672558262,1672561303,3041
3598,3612689556,3500302272,1672569135,1672569646,511
3873,3975717896,3306175858,1672642143,1672643014,871
3433,3793740407,3716110860,1672657441,1672659976,2535
3878,3777189898,3668414677,1672620110,1672620632,522
3832,3757318448,3402697190,1672587754,1672590406,2652
3643,3807212280,3755992176,1672587507,1672588610,1103
3574,3905899155,3501525100,1672635913,1672638899,2986
3767,3713561276,3519818818,1672653541,1672656802,3261
3722,3451326054,3774641380,1672680456,1672682790,2334
3855,3517222913,3516298579,1672555026,1672557233,2207
3827,3637313265,3334974375,1672559058,1672559627,569
3443,3793407963,3791441520,1672596477,1672597451,974
3896,3979802715,3780472203,1672568229,1672570677,2448
3822,3510499038,3533649454,1672691980,1672694225,2245
3651,3354144091,3905899155,1672614333,1672616440,2107
3908,3272030610,3224968597,1672582726,1672583131,405
3477,3520991398,3206837348,1672589856,1672592046,2190
3533,3760364383,3512379024,1672662766,1672665553,2787
3680,3770520359,3711812325,1672559698,1672562731,3033
3828,3807212280,3713979100,1672544732,1672546178,1446
3572,3236458894,3520416075,1672642428,1672645243,2815
3517,3245232284,3625174002,1672653027,1672655306,2279
3795,3933894942,3370068529,1672532611,1672533875,1264
3688,3380767040,3467779445,1672599963,1672602059,2096
3490,3513065217,3617489344,1672543082,1672545806,2724
3757,3383138270,3510798825,1672590306,1672591119,813
3703,3977352557,3660887799,1672610015,1672611482,1467
3655,3777147510,3436257398,1672694269,1672694484,215
3914,3701136026,3801645328,1672680337,1672683344,3007
3780,3402697190,3909094917,1672548073,1672549786,1713
3426,3232208416,3449639012,1672679754,1672680383,629
3687,3224811762,3783169442,1672661856,1672662833,977
3550,3480726047,3306175858,1672606462,1672608995,2533
3801,3899326793,3533228966,1672637764,1672640673,2909
3552,3803517637,3739895284,1672661649,1672664732,3083
3736,3236499444,3621683102,1672650928,1672651612,684
3715,3450969839,3505283390,1672678637,1672681184,2547
3861,3385323994,3509764635,1672558339,1672559369,1030
3664,3772236797,3735374579,1672658765,1672661892,3127
3562,3777330107,3431502855,1672626382,1672626619,237
3675,3304155815,3518561777,1672625659,1672627620,1961
3529,3310125159,3756127300,1672699559,1672702985,3426
3426,3713691388,3514956366,1672619963,1672621036,1073
3451,3451691949,3284932450,1672624494,1672624888,394
3723,3367111751,3274906650,1672543721,1672544661,940
3457,3270042456,3622665543,1672561241,1672563797,2556
3564,3812534508,3880926355,1672577618,1672580751,3133
3715,3714233826,3609113156,1672632910,1672634923,2013
3834,3685816610,3774641380,1672703820,1672704522,702
3741,3755756564,3927599181,1672671272,1672673806,2534
3478,3701823816,3500525825,1672685650,1672688964,3314
3574,3736231757,3311098437,1672637943,1672638856,913
3616,3225636215,3411688875,1672549348,1672552865,3517
3911,3617116290,3780769110,1672600873,1672601354,481
3642,3392943173,3224968597,1672548446,1672549650,1204
3582,3417191856,3928719932,1672577760,1672577865,105
3431,3534179433,3304971369,1672580086,1672581237,1151
3726,3756625818,3710562338,1672654718,1672655056,338
3545,3778899160,3715545685,1672662308,1672664126,1818
3582,3783433404,3398731252,1672690094,1672690478,384
3604,3780472203,3512383699,1672692876,1672694025,1149
3581,3926643445,3791693821,1672649086,1672649494,408
3429,3500703304,3516444201,1672621671,1672622821,1150
3668,3617392620,3311420950,1672583683,1672584009,326
3698,3462158237,3773939399,1672626339,1672626817,478
3783,3773009828,3480726047,1672679144,1672679708,564
3586,3270056120,3733558985,1672543036,1672546468,3432
3869,3511005395,3230135532,1672566206,1672567940,1734
3844,3850911686,3783169442,1672638370,1672641889,3519
3685,3779938251,3272030610,1672616052,1672616599,547
3508,3923420131,3803517637,1672691719,1672692136,417
3916,3276003502,3817813340,1672568196,1672571677,3481
3694,3834631333,3311085279,1672562920,1672563830,910
3547,3368283077,3439673892,1672608391,1672610020,1629
3697,3928511283,3209526819,1672594012,1672594492,480
3512,3516703758,3205985903,1672560738,1672562702,1964
3821,3661447322,3710489491,1672569599,1672569790,191
3445,3703433819,3276269264,1672542588,1672546035,3447
3484,3294747828,3701882224,1672589615,1672590345,730
3759,3373028638,3614740489,1672590029,1672590409,380
3439,3513327337,3270056120,1672660422,1672662211,1789
3579,3711637255,3316800320,1672627041,1672629011,1970
3516,3906536154,3710489491,1672542335,1672544660,2325
3820,3923220461,3312998540,1672647391,1672648975,1584
3557,3777240360,3715086894,1672700946,1672702783,1837
3696,3519077659,3401793306,1672653409,1672654243,834
3533,3621790707,3792538417,1672573077,1672574863,1786
3472,3400069268,3829822608,1672667758,1672671222,3464
3891,3306412634,3510818674,1672592659,1672593955,1296
3839,3839245934,3791693821,1672633647,1672637019,3372
3852,3330340793,3509764635,1672623044,1672624506,1462
3875,3370227921,3241790910,1672546490,1672548384,1894
3790,3756127300,3439673892,1672692227,1672694010,1783
3851,3437286517,3375449013,1672567266,1672567465,199
3709,3440107959,3501457103,1672566462,1672567548,1086
3675,3511150845,3927403123,1672676330,1672678221,1891
3477,3454277788,3519909393,1672581503,1672581884,381
3875,3618176292,3534126409,1672535832,1672539060,3228
3597,3703433819,3934064792,1672558513,1672559250,737
3590,3505847380,3505154885,1672549820,1672551497,1677
3605,3334647380,3783919913,1672658107,1672660065,1958
3739,3760924079,3475349791,1672605119,1672605356,237
3511,3246370118,3519909393,1672703408,1672706692,3284
3822,3776034743,3394297564,1672549503,1672553050,3547
3592,3934064792,3613581796,1672579212,1672580037,825
3515,3285204083,3552824113,1672635623,1672636917,1294
3534,3371455553,3637313265,1672672488,1672672792,304
3450,3276217799,3834631333,1672654680,1672655089,409
3435,3780472203,3510554314,1672637167,1672638818,1651
3581,3600876425,3635169815,1672566438,1672569547,3109
3521,3625174002,3777779869,1672656344,1672656818,474
3439,3512958459,3923220461,1672568672,1672569089,417
3850,3779646172,3638660068,1672571252,1672572863,1611
3693,3517687662,3491684096,1672574450,1672575754,1304
3584,3510028805,3505663516,1672535765,1672537210,1445
3839,3226511603,3773913680,1672651899,1672654594,2695
3503,3618176292,3383138270,1672606143,1672608851,2708
3609,3701107228,3668414677,1672616778,1672619787,3009
3593,3701664364,3520115090,1672622161,1672624170,2009
3784,3779532653,3519282716,1672548359,1672550201,1842
3668,3515466096,3279473441,1672693468,1672693610,142
3519,3622357348,3512337405,1672544364,1672546296,1932
3821,3859868849,3519416013,1672571258,1672571686,428
3622,3770520359,3773902805,1672594645,1672596386,1741
3880,3500109249,3710048469,1672670986,1672674129,3143
3535,3923420131,3760694096,1672637852,1672638480,628
3787,3757863420,3783550022,1672645695,1672647731,2036
3885,3773939399,3618697021,1672587132,1672588644,1512
3463,3774733620,3783771827,1672557217,1672559361,2144
3446,3272096759,3402697190,1672627233,1672628276,1043
3889,3686227677,3505663516,1672538404,1672541171,2767
3827,3792274796,3300511067,1672693374,1672693509,135
3873,3777189898,3534566651,1672657887,1672659713,1826
3455,3500915665,3607768197,1672547651,1672549426,1775
3739,3456430614,3777330107,1672640959,1672643248,2289
3477,3512502036,3493017654,1672619511,1672620757,1246
3437,3613581796,3755230952,1672660821,1672663120,2299
3783,3636329663,3757903168,1672576807,1672580205,3398
3751,3737147209,3914691363,1672557141,1672557950,809
3844,3306175858,3373089838,1672670158,1672672967,2809
3757,3783615982,3777330107,1672546204,1672548671,2467
3769,3905899155,3710048469,1672665771,1672665901,130
3569,3898314440,3755222916,1672690739,1672692963,2224
3628,3306175858,3231713082,1672679912,1672682047,2135
3537,3500949309,3779786641,1672540822,1672541911,1089
3660,3777184389,3517358573,1672639693,1672640158,465
3858,3621790707,3824641227,1672567658,1672570696,3038
3642,3777330107,3505228454,1672552936,1672554706,1770
3704,3803517637,3609113156,1672574008,1672577291,3283
3624,3232208416,3618354185,1672582956,1672586546,3590
3503,3372223551,3714827719,1672568890,1672569325,435
3659,3773572967,3668533536,1672592507,1672595457,2950
3575,3783433404,3510641433,1672570079,1672572031,1952
3517,3760651515,3500915908,1672617107,1672620545,3438
3428,3770146716,3777779869,1672597724,1672598565,841
3871,3825881598,3491469603,1672651810,1672652268,458
3531,3887243870,3520639768,1672552505,1672555479,2974
3647,3890739241,3713517039,1672606573,1672606835,262
3669,3449333754,3972192593,1672535096,1672537325,2229
3871,3713589994,3511024016,1672587232,1672589094,1862
3711,3231494505,3399472693,1672703896,1672706496,2600
3489,3701424609,3534829213,1672539037,1672540512,1475
3864,3710735406,3773332082,1672651679,1672652325,646
3720,3777814504,3779613523,1672583253,1672585365,2112
3496,3509483172,3467779445,1672602494,1672603400,906
3883,3618808151,3779438325,1672533236,1672536670,3434
3739,3714067076,3449639012,1672544763,1672547799,3036
3541,3501786419,3367971170,1672626093,1672627642,1549
3660,3757193551,3714067076,1672596272,1672598831,2559
3437,3225029895,3793883863,1672536813,1672539777,2964
3778,3347419520,3633735593,1672581626,1672583931,2305
3622,3793583656,3715127070,1672586890,1672589616,2726
3450,3520764926,3757700712,1672573191,1672576178,2987
3614,3756474459,3668533536,1672681959,1672683421,1462
3582,3612689556,3505521218,1672594882,1672596178,1296
3636,3920898925,3517222913,1672692277,1672693572,1295
3701,3737147209,3778040015,1672621693,1672624522,2829
3713,3620292035,3206837348,1672594665,1672596182,1517
3872,3512958459,3819767045,1672592942,1672594599,1657
3621,3912891315,3312998540,1672583213,1672586094,2881
3706,3533228966,3979784676,1672598608,1672599084,476
3629,3833217041,3520639768,1672612692,1672614757,2065
3562,3500208903,3534566651,1672591993,1672592853,860
3432,3777189898,3230868435,1672660317,1672662329,2012
3575,3554825448,3519077659,1672611320,1672613790,2470
3690,3889780657,3513545422,1672639264,1672642036,2772
3646,3439673892,3505847380,1672670486,1672671254,768
3774,3897134762,3421385957,1672587374,1672590197,2823
3813,3497808662,3384068080,1672614232,1672617696,3464
3424,3779892400,3514285803,1672541705,1672543540,1835
3879,3336627643,3737112297,1672673212,1672673282,70
3652,3711077927,3276269264,1672625221,1672625813,592
3884,3970909253,3559731671,1672677407,1672680685,3278
3571,3206837348,3619922891,1672558167,1672560817,2650
3833,3777330107,3367509761,1672574131,1672574793,662
3738,3971806004,3885155975,1672546841,1672547646,805
3540,3613899351,3935913584,1672544884,1672545938,1054
3482,3780115155,3509483172,1672682416,1672682561,145
3922,3415833929,3415833929,1672686161,1672687292,1131
3665,3512722110,3512295534,1672594576,1672596982,2406
3579,3715086894,3632814465,1672540093,1672542546,2453
3636,3514818819,3776244398,1672689823,1672690609,786
3804,3970558632,3710008361,1672666323,1672668325,2002
3651,3734451191,3478114114,1672650217,1672653541,3324
3487,3906536154,3449639012,1672536013,1672536948,935
3879,3774790271,3618354185,1672555214,1672557079,1865
3691,3475349791,3853629553,1672585033,1672587204,2171
3538,3607882826,3512800570,1672685014,1672685912,898
3610,3880926355,3231713082,1672633832,1672635444,1612
3755,3512379024,3780322355,1672670997,1672673174,2177
3799,3780209375,3229974066,1672614708,1672618083,3375
3741,3711218296,3350095157,1672578047,1672581139,3092
3494,3284932450,3777330107,1672661737,1672665053,3316
3521,3517697722,3513295938,1672624320,1672624977,657
3684,3305722859,3774243020,1672690556,1672693031,2475
3827,3515890966,3370068529,1672683191,1672686517,3326
3890,3688220326,3777091903,1672595878,1672597118,1240
3564,3516444201,3501384020,1672639642,1672641387,1745
3443,3220031931,3885121158,1672548527,1672551186,2659
3788,3224968597,3230868435,1672599146,1672599567,421
3693,3783928182,3510554314,1672696728,1672699267,2539
3706,3713829743,3362641275,1672629016,1672629789,773
3436,3232208416,3756789525,1672580209,1672580560,351
3541,3517737088,3500613493,1672590623,1672592387,1764
3631,3716963089,3783433404,1672557373,1672559311,1938
3592,3701823816,3880926355,1672613517,1672616784,3267
3852,3779301501,3856606678,1672541039,1672541299,260
3682,3935487534,3778597171,1672543553,1672543877,324
3629,3375449013,3757630221,1672637010,1672638500,1490
3710,3714233826,3488686442,1672635808,1672636694,886
3439,3930242012,3979784676,1672664747,1672667258,2511
3607,3226024417,3900945856,1672670622,1672673455,2833
3818,3757332128,3400763927,1672577464,1672577552,88
3891,3534764451,3500044458,1672585623,1672587262,1639
3512,3777184389,3756746867,1672549225,1672551370,2145
3467,3773572967,3230135532,1672667930,1672670675,2745
3638,3341893384,3519850727,1672591772,1672595007,3235
3798,3610870949,3791128487,1672560060,1672562621,2561
3704,3923420131,3776084820,1672696151,1672697696,1545
3588,3689697817,3409114719,1672617660,1672621186,3526
3872,3608232640,3224811762,1672576864,1672579953,3089
3900,3791693821,3970603231,1672639786,1672643240,3454
3637,3610870949,3520639768,1672580803,1672584337,3534
3919,3935399379,3505198734,1672643908,1672644066,158
3597,3935913584,3755915206,1672634026,1672635990,1964
3598,3930242012,3711812325,1672595935,1672598086,2151
3624,3772078494,3660063072,1672629106,1672630875,1769
3692,3701373490,3398731252,1672666903,1672667787,884
3520,3783136330,3384583385,1672655481,1672658501,3020
3792,3439673892,3731646673,1672598052,1672598344,292
3901,3914691363,3491469603,1672646888,1672649525,2637
3622,3338390596,3533294425,1672651693,1672653612,1919
3609,3414275042,3615688740,1672538452,1672539302,850
3842,3533004959,3833217041,1672676218,1672677375,1157
3674,3514956366,3311420950,1672614651,1672614974,323
3781,3373089838,3621790707,1672588604,1672590247,1643
3474,3500703304,3688220326,1672687273,1672687981,708
3661,3757332128,3534543776,1672576773,1672578356,1583
3497,3226178937,3439673892,1672569974,1672573320,3346
3499,3520578796,3619922891,1672576423,1672578447,2024
3855,3478114114,3774790271,1672575575,1672577551,1976
3754,3615737355,3480100311,1672655854,1672657293,1439
3424,3711000597,3335694356,1672604478,1672605199,721
3434,3229974066,3424445495,1672623780,1672625744,1964
3682,3777779869,3715400486,1672621888,1672623073,1185
3518,3755737419,3501281016,1672624735,1672625877,1142
3902,3689697817,3777485931,1672702760,1672705697,2937
3679,3792072681,3357289672,1672609916,1672611115,1199
3655,3608855425,3500949309,1672635928,1672637388,1460
3513,3898314440,3833217041,1672621372,1672623633,2261
3899,3890739241,3613581796,1672605390,1672607068,1678
3896,3441703884,3779738691,1672697515,1672699192,1677
3913,3779301501,3701882224,1672697189,1672697293,104
3446,3472312341,3760263530,1672591952,1672594633,2681
3720,3500347447,3513065217,1672659226,1672660606,1380
3558,3711919537,3505807416,1672574979,1672575096,117
3749,3701322924,3792072681,1672663113,1672664645,1532
3520,3410160376,3897456874,1672617706,1672620691,2985
3883,3776244398,3777814504,1672532226,1672535061,2835
3661,3617392620,3357289672,1672666807,1672668263,1456
3611,3230868435,3902861231,1672619385,1672619911,526
3441,3510818674,3534543776,1672695805,1672698316,2511
3857,3447672935,3711919537,1672697092,1672698536,1444
3623,3636329663,3534175249,1672608740,1672610669,1929
3662,3713163045,3299443125,1672541775,1672542954,1179
3576,3315703693,3904867554,1672701095,1672703098,2003
3606,3757863420,3713768950,1672650547,1672651851,1304
3697,3350095157,3620292035,1672643231,1672644106,875
3759,3777814504,3500737582,1672595949,1672597315,1366
3723,3734451191,3515525630,1672557995,1672558802,807
3857,3493017654,3512882178,1672543667,1672544017,350
3689,3776559988,3270697740,1672596361,1672597582,1221
3514,3776559988,3774605761,1672578940,1672581309,2369
3502,3776559988,3791106564,1672628600,1672631763,3163
3473,3511732493,3812369928,1672578372,1672578987,615
3580,3519077659,3455018347,1672534862,1672537522,2660
3778,3516703758,3341893384,1672689042,1672690387,1345
3860,3608232640,3780253901,1672589321,1672592400,3079
3571,3488763230,3226178937,1672614118,1672615784,1666
3454,3635169815,3392520516,1672624671,1672625154,483
3624,3410600350,3429943738,1672593758,1672594408,650
3581,3779938251,3779532653,1672617750,1672619674,1924
3636,3780253901,3417191856,1672684140,1672684779,639
3771,3288224595,3713911104,1672676096,1672676349,253
3575,3780712350,3783615982,1672659044,1672662425,3381
3691,3520322124,3424660806,1672609897,1672610215,318
3758,3819767045,3755532873,1672531210,1672534109,2899
3561,3520560590,3497808662,1672569288,1672569737,449
3582,3533090502,3821054646,1672555307,1672556351,1044
3761,3228888030,3289114629,1672650324,1672652789,2465
3919,3774790271,3715385401,1672619003,1672619141,138
3549,3977352557,3777091903,1672605516,1672606711,1195
3871,3613338363,3511024016,1672537170,1672539391,2221
3624,3516741440,3803389195,1672608152,1672610749,2597
3637,3636329663,3516298579,1672606730,1672609572,2842
3695,3516903528,3475349791,1672663732,1672664993,1261
3438,3414940786,3374183227,1672557413,1672558048,635
3668,3779613523,3515439826,1672658530,1672658892,362
3624,3926643445,3330340793,1672570556,1672571143,587
3707,3389634034,3279339278,1672552059,1672554202,2143
3658,3467988782,3516703758,1672633374,1672636912,3538
3689,3607768197,3760263530,1672698165,1672698454,289
3577,3791613604,3300511067,1672609136,1672609661,525
3565,3779656423,3411688875,1672603722,1672604730,1008
3891,3760645796,3755065949,1672686998,1672688406,1408
3688,3713768950,3755065949,1672687960,1672690836,2876
3697,3435167810,3429943738,1672575733,1672576909,1176
3631,3449639012,3660063072,1672590271,1672591184,913
3470,3461119815,3305336154,1672686120,1672687656,1536
3720,3288762795,3291933594,1672548235,1672551761,3526
3554,3773913680,3660063072,1672552921,1672553803,882
3899,3933894942,3892304880,1672557171,1672558082,911
3898,3505923418,3311498666,1672618338,1672621329,2991
3535,3241914067,3618354185,1672583086,1672583667,581
3826,3791693821,3826238375,1672593232,1672595760,2528
3551,3500498112,3480100311,1672581622,1672582141,519
3473,3713517039,3520115090,1672624338,1672627781,3443
3903,3516298579,3737147209,1672566727,1672568162,1435
3663,3609881958,3791441520,1672689865,1672690040,175
3789,3900276517,3607882826,1672642954,1672646259,3305
3629,3776034743,3711006062,1672574441,1672577313,2872
3717,3511442562,3500915665,1672587751,1672588910,1159
3643,3778040015,3638204468,1672565723,1672568806,3083
3453,3834963772,3972192593,1672621490,1672623729,2239
3584,3226024417,3792489602,1672538599,1672539518,919
3916,3289114629,3415833929,1672636190,1672637938,1748
3567,3701373490,3279339278,1672678498,1672679767,1269
3776,3500347447,3900898992,1672588013,1672588319,306
3882,3510187271,3449333754,1672640755,1672641751,996
3528,3890739241,3780909839,1672537951,1672539849,1898
3532,3885155975,3927403123,1672584661,1672586069,1408
3753,3402385957,3615688740,1672574458,1672576186,1728
3805,3821054646,3760094385,1672686918,1672690306,3388
3768,3386758279,3703139663,1672703037,1672706175,3138
3468,3618697021,3933894942,1672692398,1672693246,848
3817,3511791953,3410160376,1672579218,1672581593,2375
3777,3755230952,3780322355,1672531515,1672532688,1173
3655,3783520186,3510187271,1672579149,1672581070,1921
3817,3517600136,3514956366,1672578633,1672579034,401
3572,3510964997,3660887799,1672569151,1672570385,1234
3662,3613206049,3336339664,1672554768,1672556901,2133
3687,3716110860,3336339664,1672629669,1672630068,399
3801,3850911686,3514324011,1672623427,1672624497,1070
3476,3613206049,3316800320,1672674972,1672676968,1996
3888,3836241528,3778134418,1672613644,1672614901,1257
3448,3613899351,3776559988,1672636538,1672639325,2787
3645,3713589994,3610870949,1672533191,1672536681,3490
3744,3516489668,3533079336,1672596653,1672599611,2958
3427,3858172636,3713561276,1672567698,1672569255,1557
3890,3814305099,3510818674,1672662352,1672663306,954
3524,3202804048,3520639768,1672673633,1672673808,175
3748,3291933594,3856606678,1672590979,1672592819,1840
3662,3514971533,3713691388,1672657134,1672658976,1842
3802,3710489491,3715619259,1672636788,1672637126,338
3714,3770520359,3418448389,1672564949,1672566650,1701
3584,3500613459,3685816610,1672681544,1672683945,2401
3470,3714827719,3201800997,1672535630,1672537566,1936
3814,3516903528,3660063072,1672640097,1672642344,2247
3776,3661447322,3780680950,1672653416,1672653793,377
3437,3793175445,3737147209,1672673187,1672675526,2339
3902,3513295938,3760651515,1672597601,1672597741,140
3904,3409114719,3513081354,1672553178,1672553813,635
3918,3685681577,3380767040,1672556457,1672558272,1815
3541,3625174002,3617304541,1672595829,1672596586,757
3467,3520115090,3760842815,1672663716,1672664223,507
3670,3608922867,3793418209,1672581481,1672583650,2169
3729,3622665543,3333918941,1672575421,1672576222,801
3733,3777091903,3710048469,1672589048,1672591877,2829
3896,3783147088,3349856820,1672552593,1672554339,1746
3884,3783373154,3779465522,1672584632,1672586005,1373
3583,3505179890,3792442597,1672702779,1672704272,1493
3862,3793740407,3755992176,1672605447,1672607729,2282
3843,3618176292,3858172636,1672550747,1672553383,2636
3692,3202141727,3622665543,1672539857,1672541122,1265
3449,3684523966,3457960571,1672617010,1672617987,977
3785,3513296868,3509366311,1672679091,1672682255,3164
3504,3500109249,3512379024,1672586785,1672589178,2393
3634,3739895284,3885121158,1672695644,1672698278,2634
3859,3316798920,3618354185,1672574464,1672576775,2311
3436,3299781901,3802932312,1672573337,1672576890,3553
3490,3625174002,3711734586,1672552754,1672555427,2673
3842,3236499444,3779646172,1672545515,1672545950,435
3435,3500498112,3472312341,1672650325,1672653159,2834
3542,3500302272,3826238375,1672614803,1672616065,1262
3781,3470454332,3357689359,1672662911,1672663528,617
3462,3713691388,3230868435,1672661102,1672664646,3544
3864,3930242012,3904569677,1672601261,1672602647,1386
3890,3776988674,3778040015,1672655714,1672656427,713
3897,3472312341,3343816795,1672620524,1672622853,2329
3830,3206837348,3891672228,1672675222,1672675546,324
3460,3374183227,3288224595,1672690100,1672690653,553
3841,3288224595,3299443125,1672617623,1672618581,958
3523,3436257398,3779854934,1672668094,1672670474,2380
3686,3517462308,3505807416,1672699804,1672700631,827
3522,3461119815,3490029863,1672539657,1672540807,1150
3809,3770296583,3283492940,1672538425,1672538896,471
3443,3739911441,3470454332,1672660641,1672663884,3243
3718,3923420131,3505634634,1672676202,1672678604,2402
3904,3779854934,3792949946,1672570350,1672572324,1974
3478,3374183227,3409114719,1672622070,1672623519,1449
3715,3354144091,3779738691,1672663486,1672664760,1274
3704,3399518841,3621184108,1672700710,1672701419,709
3427,3429943738,3513081354,1672562614,1672563734,1120
3681,3780834916,3975717896,1672694122,1672694875,753
3582,3402385957,3792274796,1672550462,1672551638,1176
3828,3492959689,3791106564,1672681797,1672683122,1325
3477,3713979100,3511791953,1672538467,1672541503,3036
3825,3792020993,3311098437,1672585373,1672585633,260
3488,3514512367,3394297564,1672546306,1672547277,971
3511,3414940786,3520657891,1672576938,1672577041,103
3493,3772765746,3777694660,1672617011,1672617691,680
3825,3513081354,3756746867,1672698049,1672698773,724
3450,3774155692,3779646172,1672563281,1672565042,1761
3517,3739154408,3236458894,1672613078,1672613617,539
3451,3621790707,3711734586,1672534460,1672535670,1210
3567,3393063657,3680810086,1672563547,1672563942,395
3836,3970909253,3401793306,1672613013,1672616288,3275
3794,3451726367,3224330592,1672609700,1672610660,960
3431,3382733096,3392520516,1672626879,1672627864,985
3611,3783550022,3534126409,1672640203,1672642177,1974
3662,3817428320,3668533536,1672668927,1672670482,1555
3792,3289114629,3773735484,1672678934,1672679944,1010
3479,3236499444,3859868849,1672539178,1672541601,2423
3874,3511024016,3760645796,1672581439,1672581731,292
3774,3510964997,3228888030,1672573636,1672574814,1178
3794,3285204083,3931627862,1672562187,1672564365,2178
3893,3510818674,3607882826,1672578496,1672580122,1626
3643,3792072681,3812369928,1672605569,1672608135,2566
3492,3513360004,3500347447,1672635488,1672636638,1150
3791,3512282789,3519909393,1672573537,1672576655,3118
3877,3777814504,3774178201,1672626164,1672627194,1030
3665,3557046880,3897376951,1672558705,1672561096,2391
3694,3512958459,3714185969,1672550048,1672552136,2088
3428,3461119815,3517172354,1672541490,1672541757,267
3760,3497671225,3631479562,1672569689,1672570607,918
3608,3205985903,3417191856,1672540483,1672541512,1029
3741,3505179890,3736705719,1672583814,1672587320,3506
3808,3780834916,3364726656,1672625998,1672628093,2095
3679,3224811762,3500442734,1672606215,1672608616,2401
3833,3780115155,3779786641,1672602159,1672603974,1815
3735,3636329663,3364378127,1672541688,1672543950,2262
3871,3617489344,3520115090,1672574478,1672575328,850
3739,3774641380,3500341755,1672569215,1672571145,1930
3577,3497808662,3777091903,1672609576,1672612152,2576
3456,3513853403,3760364383,1672578137,1672579562,1425
3732,3783928182,3688490530,1672685034,1672687193,2159
3684,3736231757,3533079336,1672628304,1672628673,369
3646,3513327337,3384068080,1672581084,1672581380,296
3697,3783373154,3513345163,1672552530,1672555592,3062
3551,3448875382,3783147088,1672570504,1672573887,3383
3794,3455018347,3517288083,1672594466,1672596921,2455
3852,3770704999,3770146716,1672534887,1672535999,1112
3459,3713768950,3511150845,1672698783,1672700681,1898
3594,3711919537,3436257398,1672561579,1672563488,1909
3731,3334993594,3505481368,1672703387,1672703877,490
3887,3856606678,3935913584,1672614546,1672616800,2254
3559,3285204083,3554186380,1672587784,1672590639,2855
3913,3518561777,3715443333,1672561768,1672562421,653
3626,3735374579,3773121782,1672556604,1672557062,458
3465,3791246640,3756127300,1672589544,1672593017,3473
3806,3779639983,3270042456,1672666772,1672667047,275
3562,3716679950,3225636215,1672684757,1672685029,272
3668,3715854030,3468041839,1672673405,1672674909,1504
3752,3505663516,3396980894,1672696903,1672697118,215
3438,3777694660,3367971170,1672624739,1672626661,1922
3757,3615737355,3516903528,1672679029,1672681608,2579
3856,3505434346,3757700712,1672622676,1672625449,2773
3756,3778597171,3701664364,1672665015,1672668249,3234
3436,3715385401,3755344363,1672605281,1672606447,1166
3569,3783136330,3814305099,1672685574,1672687403,1829
3842,3773939399,3505437712,1672597944,1672598727,783
3721,3617392620,3793175445,1672614876,1672617324,2448
3848,3715619259,3779613523,1672564461,1672567851,3390
3700,3777694660,3633735593,1672608686,1672609169,483
3762,3715619259,3774705415,1672640177,1672642307,2130
3643,3792538417,3512499658,1672608684,1672610328,1644
3807,3622665543,3505725706,1672624681,1672625697,1016
3496,3716628503,3515890966,1672557317,1672558857,1540
3675,3479851674,3755222916,1672560767,1672561670,903
3825,3905899155,3621683102,1672679922,1672680292,370
3719,3895285664,3807212280,1672599536,1672602838,3302
3678,3230135532,3410538749,1672682707,1672685933,3226
3884,3512392431,3885155975,1672664210,1672667276,3066
3821,3520416075,3505179890,1672623468,1672624554,1086
3670,3270042456,3306175858,1672573139,1672575098,1959
3733,3808136029,3505437712,1672555952,1672558068,2116
3559,3467988782,3370068529,1672601883,1672603572,1689
3749,3559458968,3773033649,1672567790,1672568171,381
3670,3971806004,3921648519,1672692572,1672695778,3206
3647,3511843593,3500341755,1672676192,1672679256,3064
3603,3780909839,3559731671,1672550937,1672551258,321
3441,3517687662,3519818818,1672534634,1672536780,2146
3623,3401793306,3685681577,1672620004,1672620671,667
3559,3505888598,3791106564,1672628932,1672629305,373
3812,3454277788,3500109249,1672655649,1672657140,1491
3854,3811040565,3633735593,1672629404,1672630176,772
3897,3514818819,3480100311,1672535511,1672535882,371
3479,3338390596,3236458894,1672629507,1672630412,905
3896,3554825448,3514818819,1672689030,1672691577,2547
3635,3668414677,3517737088,1672570369,1672571812,1443
3440,3711812325,3516321888,1672680077,1672683181,3104
3790,3899786664,3225029895,1672665936,1672668179,2243
3690,3612689556,3778597171,1672563876,1672567325,3449
3774,3515466096,3783163143,1672569448,1672570653,1205
3661,3710315160,3760263530,1672608073,1672610584,2511
3582,3777330107,3711000597,1672674261,1672674945,684
3811,3238288884,3615115210,1672587601,1672591073,3472
3566,3513410578,3613416045,1672628229,1672628971,742
3577,3711637255,3272716462,1672687069,1672688749,1680
3654,3472068734,3934064792,1672693871,1672695050,1179
3578,3858172636,3231494505,1672618891,1672621499,2608
3752,3534829213,3270697740,1672569547,1672571978,2431
3430,3367509761,3703348097,1672644720,1672645576,856
3672,3514246749,3334647380,1672606320,1672606419,99
3829,3815250107,3852533643,1672703152,1672703544,392
3576,3457960571,3447514821,1672675392,1672676784,1392
3726,3225631197,3923220461,1672601403,1672603930,2527
3434,3770704999,3714185969,1672605026,1672605389,363
3430,3200543880,3512295534,1672620339,1672622309,1970
3665,3497095254,3778667336,1672606527,1672609698,3171
3501,3534829213,3518561777,1672684024,1672684778,754
3754,3710315160,3688220326,1672562969,1672564170,1201
3561,3411688875,3417191856,1672674116,1672675896,1780
3878,3713517039,3512499658,1672629530,1672632413,2883
3602,3367509761,3811040565,1672621152,1672622762,1610
3472,3513041785,3468041839,1672566380,1672568835,2455
3757,3714827719,3935913584,1672636610,1672639317,2707
3562,3636329663,3834631333,1672601206,1672601577,371
3818,3835985172,3513853403,1672566630,1672568595,1965
3646,3534543776,3710489491,1672556516,1672558692,2176
3803,3512383699,3514334067,1672669440,1672670984,1544
3829,3716963089,3773939399,1672631668,1672632571,903
3763,3271454397,3783163143,1672686803,1672687793,990
3849,3737112297,3716272919,1672564017,1672566793,2776
3853,3552824113,3755065949,1672688090,1672690487,2397
3473,3401793306,3774907131,1672538281,1672539387,1106
3524,3609881958,3783373154,1672593106,1672594312,1206
3452,3637313265,3897456874,1672656423,1672659366,2943
3732,3811040565,3711919537,1672568915,1672569868,953
3898,3713979100,3384068080,1672653827,1672653918,91
3487,3520181148,3292147449,1672680689,1672683989,3300
3606,3514956366,3551399764,1672681212,1672681378,166
3528,3736231757,3505847380,1672627394,1672630164,2770
3468,3514956366,3236458894,1672609862,1672612662,2800
3764,3274831810,3715545685,1672581033,1672583214,2181
3868,3776084820,3513360004,1672660498,1672661032,534
3455,3778640261,3773121782,1672605164,1672608106,2942
3762,3792274796,3520416075,1672671719,1672675023,3304
3733,3515439826,3351866415,1672667632,1672668053,421
3450,3449333754,3449333754,1672589344,1672591668,2324
3718,3206837348,3511732493,1672665902,1672668821,2919
3888,3519416013,3755230952,1672587662,1672591232,3570
3693,3500827202,3515466096,1672659337,1672660356,1019
3847,3515559913,3802932312,1672631326,1672634092,2766
3825,3505283390,3514285803,1672658510,1672660288,1778
3712,3613338363,3793175445,1672580327,1672583380,3053
3551,3793740407,3270042456,1672580128,1672581850,1722
3547,3505807416,3905899155,1672620171,1672621312,1141
3478,3505178849,3774641380,1672694592,1672697436,2844
3848,3739911441,3480490124,1672648931,1672650238,1307
3587,3300979975,3511442562,1672559982,1672561598,1616
3780,3615087943,3271454397,1672679629,1672683148,3519
3846,3209481722,3783919913,1672608429,1672611836,3407
3721,3556969573,3900898992,1672614100,1672617113,3013
3815,3891672228,3686227677,1672695887,1672698895,3008
3787,3617489344,3227799827,1672582563,1672583099,536
3493,3755233658,3938503547,1672625307,1672626542,1235
3803,3685816610,3428725843,1672677373,1672680299,2926
3670,3756127300,3710735406,1672578261,1672579598,1337
3591,3516298579,3792525861,1672691972,1672695203,3231
3455,3757863420,3777814504,1672666379,1672667707,1328
3482,3500613493,3505888598,1672567207,1672568218,1011
3601,3812534508,3621184108,1672657223,1672659181,1958
3513,3710008361,3467779445,1672593105,1672593437,332
3446,3757700712,3488686442,1672616728,1672618986,2258
3912,3338390596,3511150845,1672616903,1672618694,1791
3446,3202141727,3270042456,1672683850,1672684906,1056
3574,3773902805,3714670620,1672545051,1672546879,1828
3676,3304155815,3208452238,1672557216,1672559152,1936
3793,3757318448,3774178201,1672562633,1672565481,2848
3832,3757294769,3732131656,1672686186,1672688823,2637
3572,3755737419,3774605761,1672633532,1672635349,1817
3567,3392836218,3900898992,1672695384,1672696534,1150
3749,3833217041,3516489668,1672613091,1672615201,2110
3556,3519028898,3755532873,1672544127,1672546865,2738
3469,3779465522,3777814504,1672588521,1672590430,1909
3730,3928719932,3703396825,1672682824,1672683604,780
3667,3835985172,3392520516,1672577510,1672579564,2054
3549,3756474459,3299125059,1672639516,1672640912,1396
3566,3511601997,3783373154,1672703737,1672704900,1163
3688,3280268483,3780209375,1672569975,1672573421,3446
3796,3515890966,3311085279,1672614940,1672616079,1139
3426,3897435944,3609881958,1672580881,1672583435,2554
3482,3501525100,3732584121,1672681357,1672684157,2800
3454,3711000597,3757630221,1672689588,1672690321,733
3503,3412968120,3248058676,1672618054,1672618940,886
3725,3829864515,3791246640,1672565301,1672566901,1600
3562,3509483172,3793418209,1672681421,1672682232,811
3800,3757075324,3793883863,1672688193,1672691789,3596
3458,3501786419,3770146716,1672532272,1672532880,608
3616,3899786664,3438078818,1672623569,1672626932,3363
3555,3509366311,3512946768,1672602562,1672604658,2096
3585,3689114185,3715619259,1672672653,1672675202,2549
3886,3608922867,3833217041,1672591473,1672593497,2024
3855,3500737582,3392943173,1672664875,1672667514,2639
3815,3511024016,3520657891,1672665077,1672667186,2109
3920,3412006598,3777624586,1672631579,1672633045,1466
3704,3660063072,3393063657,1672682152,1672685726,3574
3555,3533004959,3792525861,1672594580,1672596751,2171
3728,3370227921,3239617320,1672583418,1672586551,3133
3621,3783169442,3770146716,1672632349,1672632663,314
3524,3792949946,3811075491,1672567598,1672570148,2550
3752,3760640999,3667427125,1672548669,1672551859,3190
3458,3316800320,3511791953,1672560084,1672560699,615
3909,3294703680,3615688740,1672645843,1672646295,452
3665,3414940786,3224330592,1672687104,1672687181,77
3877,3608922867,3831586487,1672533789,1672536661,2872
3588,3710315160,3613581796,1672663515,1672665606,2091
3589,3491469603,3389634034,1672623658,1672625733,2075
3550,3834960360,3505198734,1672542731,1672544822,2091
3476,3394401087,3519282716,1672544776,1672545435,659
3749,3520991398,3501281016,1672647552,1672649070,1518
3787,3389634034,3236499444,1672594631,1672597764,3133
3756,3500857494,3621683102,1672593428,1672597028,3600
3843,3665998641,3780338697,1672637383,1672637771,388
3641,3534175249,3394297564,1672665045,1672666098,1053
3857,3501459390,3461119815,1672591329,1672594253,2924
3662,3772765746,3505663516,1672588143,1672590498,2355
3911,3501281016,3439673892,1672618496,1672620595,2099
3803,3850911686,3510187271,1672561837,1672562433,596
3462,3730071479,3791753345,1672639036,1672641774,2738
3671,3897435944,3760640999,1672586381,1672588500,2119
3740,3661903000,3208452238,1672645021,1672647191,2170
3681,3739661856,3232208416,1672535158,1672536313,1155
3610,3934064792,3834960360,1672671749,1672675253,3504
3774,3780712350,3732584121,1672570250,1672572819,2569
3444,3512282789,3338083680,1672582335,1672584139,1804
3595,3900898992,3515402792,1672682794,1672683589,795
3601,3905899155,3371455553,1672623048,1672623246,198
3673,3703798634,3360616538,1672659704,1672661848,2144
3897,3737112297,3357864626,1672699267,1672700517,1250
3608,3688490530,3777485931,1672565079,1672567549,2470
3848,3500915665,3276217799,1672654648,1672655277,629
3520,3511601997,3485540729,1672648613,1672649966,1353
3507,3780571086,3776559988,1672642034,1672645115,3081
3493,3519446663,3349856820,1672645463,1672646475,1012
3774,3306175858,3200308999,1672537887,1672539885,1998
3584,3610358027,3514512367,1672543945,1672544995,1050
3817,3713829743,3661447322,1672550529,1672551644,1115
3652,3777485931,3519087371,1672698462,1672701076,2614
3866,3612689556,3755222916,1672601234,1672601959,725
3511,3513360004,3520181148,1672579595,1672583049,3454
3718,3737972328,3938503547,1672618444,1672619931,1487
3818,3931627862,3780322355,1672599919,1672602060,2141
3594,3774155692,3283492940,1672634570,1672635278,708
3722,3792014516,3783163143,1672598610,1672599874,1264
3461,3505481368,3932478321,1672639381,1672639684,303
3532,3333918941,3513853403,1672701193,1672702111,918
3897,3938389661,3480490124,1672683603,1672686714,3111
3675,3279473441,3926643445,1672658076,1672659942,1866
3866,3445206685,3710562338,1672600248,1672602044,1796
3500,3715986185,3853629553,1672566654,1672569509,2855
3863,3513410578,3793418209,1672647544,1672649003,1459
3706,3520657891,3360813161,1672532926,1672536427,3501
3594,3780872464,3385323994,1672558601,1672560560,1959
3689,3514334067,3534357694,1672696827,1672697380,553
3763,3898314440,3231713082,1672668493,1672669405,912
3454,3855583256,3505228454,1672586748,1672587586,838
3724,3511317276,3510642075,1672686512,1672687935,1423
3466,3891672228,3516741440,1672536910,1672539518,2608
3566,3625463628,3440107959,1672669743,1672670842,1099
3641,3897435944,3780571086,1672551119,1672551738,619
3784,3298151889,3824215187,1672643503,1672644129,626
3798,3779938251,3462636434,1672630436,1672631717,1281
3724,3777814504,3285204083,1672668955,1672670620,1665
3517,3604867757,3613206049,1672663507,1672666347,2840
3589,3793743698,3305336154,1672538207,1672541193,2986
3625,3363162590,3203538212,1672592950,1672596491,3541
3488,3701882224,3401793306,1672534340,1672537517,3177
3609,3897134762,3685816610,1672536402,1672539033,2631
3543,3637313265,3667673649,1672582766,1672585999,3233
3600,3689114185,3714120857,1672646781,1672647533,752
3817,3608855425,3501567772,1672601511,1672605044,3533
3914,3770146716,3701136026,1672642221,1672645449,3228
3918,3512379024,3517737088,1672585287,1672587298,2011
3481,3970198861,3815392801,1672560230,1672561853,1623
3788,3926643445,3779613523,1672650625,1672651165,540
3480,3776559988,3279475486,1672665761,1672666298,537
3738,3334951866,3713517039,1672576016,1672579190,3174
3646,3224811762,3205923620,1672669160,1672669639,479
3588,3811040565,3520639768,1672654773,1672656288,1515
3627,3613416045,3757863420,1672590311,1672593027,2716
3904,3610358027,3716272919,1672534837,1672536167,1330
3458,3783340788,3428027649,1672640540,1672643635,3095
3531,3505663516,3472312341,1672695711,1672697220,1509
3474,3715086894,3760364383,1672698014,1672701091,3077
3815,3283492940,3500341755,1672607227,1672607694,467
3580,3825881598,3779425804,1672620521,1672623519,2998
3438,3778667336,3511150845,1672684592,1672687369,2777
3683,3632814465,3755158925,1672610706,1672611422,716
3624,3780472203,3512282789,1672560326,1672560485,159
3652,3713561276,3770438122,1672595489,1672598923,3434
3681,3858172636,3514285803,1672608335,1672608426,91
3727,3777485931,3821054646,1672633564,1672634179,615
3684,3885537225,3734451191,1672609489,1672612007,2518
3500,3231713082,3777485931,1672550388,1672551178,790
3536,3792546035,3668533536,1672556368,1672558351,1983
3471,3492959689,3500613493,1672540539,1672541378,839
3734,3462273042,3450286949,1672641743,1672643693,1950
3847,3505111292,3516741440,1672601951,1672605105,3154
3581,3732131656,3500949309,1672658083,1672661236,3153
3513,3515402792,3369708250,1672550246,1672551622,1376
3756,3304971369,3514971533,1672593314,1672595881,2567
3705,3511732493,3826238375,1672631373,1672634187,2814
3431,3519077659,3821054646,1672578152,1672578931,779
3698,3701107228,3773033649,1672574236,1672577404,3168
3738,3778040015,3512722110,1672676196,1672678238,2042
3533,3357289672,3334993594,1672641261,1672643071,1810
3783,3228888030,3713561276,1672677684,1672678010,326
3654,3533079336,3731646673,1672558371,1672558743,372
3897,3492546679,3627368399,1672690788,1672691785,997
3534,3793868716,3551376095,1672601288,1672604049,2761
3452,3371455553,3416987084,1672608246,1672608380,134
3532,3512722110,3615087943,1672544335,1672547558,3223
3721,3510964997,3714067076,1672636348,1672637460,1112
3477,3226024417,3514512367,1672639372,1672641738,2366
3491,3534566651,3755756564,1672693011,1672694149,1138
3786,3632814465,3783169442,1672556412,1672559605,3193
3563,3347419520,3379143440,1672573575,1672573652,77
3557,3467779445,3783919913,1672535383,1672537438,2055
3814,3384583385,3780571086,1672640078,1672640323,245
3592,3757903168,3272716462,1672554440,1672556986,2546
3687,3850911686,3497095254,1672669633,1672672283,2650
3470,3713768950,3487875183,1672579153,1672580473,1320
3499,3285204083,3814305099,1672578852,1672580452,1600
3700,3467988782,3829864515,1672666338,1672667710,1372
3552,3885157459,3773033649,1672647481,1672650119,2638
3621,3517288083,3618176292,1672687739,1672688455,716
3916,3375449013,3511791953,1672546833,1672548050,1217
3763,3792546035,3733558985,1672538576,1672539821,1245
3530,3304971369,3710048469,1672701244,1672704191,2947
3622,3516298579,3904867554,1672701476,1672702133,657
3495,3500604680,3793583656,1672633167,1672633936,769
3867,3534357694,3777485931,1672630571,1672630962,391
3579,3890739241,3715086894,1672575605,1672575962,357
3495,3520322124,3661447322,1672564478,1672565535,1057
3848,3515890966,3776518452,1672540363,1672541988,1625
3572,3664943873,3515525630,1672686249,1672687655,1406
3672,3710008361,3363162590,1672536908,1672537889,981
3564,3512392431,3792949946,1672682202,1672685493,3291
3815,3793315718,3792949946,1672628370,1672628504,134
3897,3783641602,3711000597,1672566275,1672567663,1388
3894,3438489358,3431502855,1672702734,1672703107,373
3801,3513545422,3380130228,1672556467,1672559343,2876
3677,3501215099,3351866415,1672541904,1672543863,1959
3663,3338390596,3920898925,1672627808,1672628835,1027
3716,3520873221,3500857494,1672671552,1672673642,2090
3734,3337322736,3436025562,1672596370,1672596482,112
3871,3293835352,3480726047,1672695699,1672697306,1607
3567,3440107959,3783169442,1672605724,1672605849,125
3437,3823084403,3335694356,1672551826,1672554533,2707
3551,3480100311,3201629017,1672601262,1672604303,3041
3789,3713829743,3905196766,1672608526,1672610595,2069
3733,3891672228,3808136029,1672680633,1672684087,3454
3900,3778134418,3680810086,1672612258,1672614469,2211
3517,3760263530,3905899155,1672700899,1672704209,3310
3643,3341893384,3755532873,1672597059,1672597295,236
3439,3777037426,3500317969,1672531529,1672531675,146
3607,3613338363,3739661856,1672642780,1672642866,86
3560,3821054646,3201629017,1672656421,1672659233,2812
3628,3793883863,3520578796,1672577924,1672580039,2115
3572,3501567772,3517737088,1672641854,1672642956,1102
3735,3299125059,3510818674,1672600744,1672602063,1319
3895,3774705415,3500347447,1672631448,1672633711,2263
3785,3711000597,3509764635,1672539714,1672542175,2461
3683,3393063657,3783520186,1672573833,1672575175,1342
3596,3791441520,3228888030,1672602205,1672604965,2760
3532,3777240360,3517737088,1672582060,1672583120,1060
3704,3519416013,3534126409,1672607326,1672607512,186
3552,3703396825,3776084820,1672616769,1672618465,1696
3710,3615115210,3270042456,1672641825,1672644618,2793
3788,3928511283,3904412440,1672624722,1672627180,2458
3736,3714185969,3688490530,1672540970,1672543847,2877
3742,3534357694,3510187271,1672698045,1672698567,522
3648,3737112297,3684523966,1672584761,1672585563,802
3567,3783373154,3615737355,1672625545,1672627182,1637
3554,3559458968,3604589802,1672611362,1672613997,2635
3465,3505179890,3710854064,1672584057,1672586045,1988
3480,3510554314,3928511283,1672621036,1672623498,2462
3473,3898314440,3516903528,1672561185,1672564033,2848
3730,3607768197,3814305099,1672600537,1672604112,3575
3766,3510798825,3279475486,1672639574,1672642309,2735
3870,3208957949,3623266256,1672582322,1672584183,1861
3640,3276217799,3510798825,1672624968,1672627704,2736
3688,3714128600,3480490124,1672671197,1672673382,2185
3907,3793935736,3333918941,1672576991,1672580302,3311
3665,3511150845,3906536154,1672596466,1672599733,3267
3812,3501281016,3669146016,1672623773,1672626152,2379
3608,3224811762,3380982774,1672676880,1672678851,1971
3666,3280268483,3533294425,1672568531,1672569381,850
3459,3512383699,3533368789,1672695726,1672697096,1370
3452,3224968597,3737147209,1672661248,1672662366,1118
3708,3780834916,3371455553,1672669424,1672672664,3240
3710,3773902805,3823084403,1672612974,1672615649,2675
3904,3316798920,3382733096,1672556662,1672558258,1596
3803,3770146716,3608855425,1672593432,1672594090,658
3791,3682133690,3501281016,1672675920,1672678215,2295
3629,3783928182,3780115155,1672682850,1672684387,1537
3890,3760924079,3316798920,1672564612,1672567156,2544
3640,3401940259,3330340793,1672565934,1672567346,1412
3883,3500777439,3612689556,1672586217,1672586357,140
3528,3315703693,3626499450,1672556758,1672558991,2233
3741,3380767040,3971806004,1672677675,1672677825,150
3463,3774178201,3350095157,1672643312,1672645678,2366
3631,3885537225,3510964997,1672644041,1672645864,1823
3507,3686227677,3421385957,1672602083,1672603836,1753
3596,3435167810,3680810086,1672700110,1672700470,360
3898,3279473441,3774178201,1672639801,1672642086,2285
3564,3626499450,3533274994,1672667425,1672669792,2367
3609,3279242917,3500208903,1672618549,1672620805,2256
3709,3305722859,3488763230,1672591740,1672594779,3039
3799,3760694096,3500841914,1672651855,1672654697,2842
3544,3488763230,3617304541,1672673382,1672675775,2393
3573,3889780657,3271752081,1672610510,1672611374,864
3534,3780115155,3791128487,1672576956,1672578368,1412
3819,3347446226,3777189898,1672583828,1672586714,2886
3568,3755737419,3714670620,1672605474,1672605769,295
3629,3777624586,3512882178,1672654764,1672655407,643
3666,3513065217,3777694660,1672534928,1672538521,3593
3734,3514741348,3611055563,1672601179,1672602757,1578
3740,3736231757,3229974066,1672543369,1672544357,988
3571,3791106564,3776831527,1672626912,1672628598,1686
3620,3505923418,3777624586,1672567389,1672570852,3463
3425,3777779869,3414049538,1672555851,1672557355,1504
3484,3770624662,3516444201,1672599366,1672600186,820
3521,3633735593,3272716462,1672587908,1672590647,2739
3567,3618354185,3713979100,1672668261,1672669728,1467
3515,3793583656,3793883863,1672616483,1672619513,3030
3761,3456430614,3825881598,1672553059,1672555226,2167
3809,3364726656,3512282789,1672532131,1672535512,3381
3759,3394401087,3776518452,1672581575,1672581795,220
3704,3938389661,3315703693,1672655468,1672657058,1590
3438,3755233658,3703348097,1672619954,1672622941,2987
3548,3777330107,3757348722,1672620860,1672621147,287
3519,3497095254,3815250107,1672539293,1672540104,811
3432,3755496114,3780209375,1672563346,1672566459,3113
3572,3403370192,3970603231,1672536752,1672538599,1847
3728,3304971369,3689114185,1672536908,1672539600,2692
3914,3773124276,3510641433,1672624857,1672628170,3313
3688,3393063657,3518561777,1672587038,1672587526,488
3851,3509893027,3436025562,1672690746,1672690884,138
3519,3755404116,3777091903,1672557937,1672558065,128
3859,3533294425,3510642075,1672650994,1672652788,1794
3564,3760924079,3398198430,1672585375,1672585989,614
3686,3485540729,3715854030,1672674785,1672677791,3006
3654,3501215099,3714678331,1672560187,1672563705,3518
3573,3669146016,3351866415,1672702724,1672704680,1956
3758,3979784676,3515439826,1672679281,1672680558,1277
3907,3516489668,3621461051,1672680949,1672681521,572
3540,3713829743,3660887799,1672586741,1672590328,3587
3652,3514308235,3793743698,1672540754,1672541590,836
3805,3404025196,3701884158,1672608749,1672610584,1835
3596,3792949946,3714233826,1672666169,1672668300,2131
3655,3819767045,3793781065,1672592103,1672592822,719
3634,3792745809,3500949309,1672636635,1672637887,1252
3546,3343816795,3559731671,1672534994,1672537590,2596
3460,3920625129,3701107228,1672635067,1672635957,890
3834,3505481368,3609881958,1672698689,1672701900,3211
3469,3380982774,3839245934,1672672668,1672674538,1870
3657,3773121782,3534175249,1672550642,1672552499,1857
3480,3460719322,3755756564,1672663751,1672666780,3029
3770,3815392801,3510818674,1672655203,1672656204,1001
3693,3897134762,3760362417,1672666077,1672669486,3409
3839,3736231757,3617392620,1672572541,1672573318,777
3711,3288762795,3791441520,1672622667,1672625397,2730
3487,3227799827,3463849738,1672668586,1672669421,835
3492,3512722110,3777330107,1672534424,1672536009,1585
3754,3418448389,3780115155,1672673830,1672677264,3434
3559,3770146716,3554825448,1672548892,1672550897,2005
3727,3817428320,3501384020,1672670143,1672671403,1260
3479,3298151889,3533368789,1672627418,1672629077,1659
3667,3714827719,3300511067,1672600048,1672602531,2483
3536,3520639768,3492959689,1672660272,1672662533,2261
3581,3392520516,3500317969,1672643110,1672644878,1768
3672,3512502036,3520560590,1672594259,1672594478,219
3809,3510642075,3519909393,1672560180,1672560312,132
3514,3399518841,3802932312,1672562744,1672565193,2449
3604,3780909839,3711218296,1672593072,1672596271,3199
3663,3686523546,3897456874,1672543670,1672544913,1243
3531,3421385957,3232208416,1672585946,1672586536,590
3690,3399472693,3783163143,1672699850,1672702018,2168
3498,3793935736,3600876425,1672618290,1672620216,1926
3527,3927165965,3613416045,1672556875,1672559794,2919
3906,3734451191,3364378127,1672534931,1672535074,143
3789,3395201292,3685681577,1672602601,1672602887,286
3827,3778640261,3688796737,1672596105,1672598510,2405
3767,3500777439,3480991549,1672590947,1672592656,1709
3766,3240994288,3500672156,1672544582,1672546255,1673
3439,3738026330,3905899155,1672550182,1672553289,3107
3856,3501459390,3977148669,1672657053,1672660296,3243
3486,3396980894,3836241528,1672658671,1672659675,1004
3681,3379143440,3792489602,1672624129,1672626368,2239
3910,3417679834,3399518841,1672571272,1672573890,2618
3870,3779738691,3500109249,1672585146,1672587174,2028
3794,3732584121,3516903528,1672592369,1672593471,1102
3740,3906536154,3613338363,1672600903,1672602272,1369
3887,3395201292,3292147449,1672701846,1672703568,1722
3761,3710489491,3757903168,1672683624,1672685231,1607
3649,3201800997,3927403123,1672604457,1672606531,2074
3867,3533649454,3714067076,1672659164,1672659432,268
3709,3520181148,3520115090,1672673945,1672675412,1467
3800,3701247948,3224811762,1672660852,1672661884,1032
3642,3424445495,3519909393,1672675933,1672677863,1930
3768,3285204083,3773121782,1672673554,1672674742,1188
3911,3617116290,3792546035,1672568599,1672568846,247
3477,3884596900,3200308999,1672568257,1672570108,1851
3901,3441348818,3500915908,1672671893,1672674834,2941
3627,3514818819,3500857494,1672687341,1672690248,2907
3846,3283144118,3807212280,1672685285,1672686054,769
3819,3512337405,3497671225,1672578615,1672581314,2699
3787,3279242917,3280054198,1672537142,1672540174,3032
3790,3710489491,3773027597,1672581444,1672584014,2570
3679,3711853996,3533294425,1672622667,1672625980,3313
3889,3626499450,3349739136,1672595383,1672598117,2734
3907,3778640261,3791128487,1672643194,1672644355,1161
3494,3517991730,3512958459,1672631171,1672632919,1748
3424,3710008361,3734118023,1672559888,1672561897,2009
3458,3680843171,3519282716,1672691464,1672691717,253
3801,3311049964,3497095254,1672669728,1672672494,2766
3827,3559458968,3470454332,1672560848,1672564345,3497
3603,3714067076,3274906650,1672647169,1672650691,3522
3678,3333403880,3715400486,1672553381,1672556258,2877
3675,3283144118,3636329663,1672680187,1672682491,2304
3761,3511288998,3209481722,1672621276,1672623968,2692
3446,3343132529,3517687662,1672604658,1672607715,3057
3877,3839245934,3505154885,1672631127,1672631972,845
3743,3930242012,3416987084,1672641809,1672643958,2149
3764,3201800997,3604867757,1672591938,1672594630,2692
3802,3306412634,3623266256,1672646597,1672647942,1345
3722,3774718695,3735374579,1672660226,1672663399,3173
3903,3824641227,3200543880,1672641245,1672644828,3583
3710,3533274994,3732131656,1672602961,1672604004,1043
3828,3885155975,3792546035,1672560338,1672562603,2265
3788,3201629017,3780571086,1672584202,1672587595,3393
3571,3780472203,3701247948,1672599365,1672602700,3335
3887,3319167958,3511150845,1672670954,1672672447,1493
3882,3283770991,3306412634,1672684735,1672687771,3036
3840,3835985172,3534175249,1672691950,1672693855,1905
3648,3518229776,3370068529,1672641834,1672642960,1126
3580,3776034743,3636329663,1672622394,1672622993,599
3718,3783373154,3625174002,1672587188,1672588860,1672
3825,3462158237,3500777439,1672677994,1672679129,1135
3910,3660063072,3923420131,1672546004,1672549585,3581
3917,3462636434,3556969573,1672703983,1672704069,86
3665,3201629017,3534764451,1672654609,1672654793,184
3477,3760924079,3733558985,1672591010,1672591209,199
3866,3500703304,3773033649,1672627376,1672630801,3425
3668,3488763230,3710562338,1672565109,1672567163,2054
3544,3414275042,3715545685,1672590857,1672593524,2667
3424,3510767239,3505228454,1672634126,1672636513,2387
3717,3284932450,3792949946,1672582183,1672584533,2350
3637,3778134418,3713941638,1672650237,1672650382,145
3890,3617489344,3852533643,1672616224,1672616535,311
3855,3613581796,3201629017,1672689999,1672690472,473
3638,3505923418,3517172354,1672644167,1672646073,1906
3851,3710315160,3285204083,1672689886,1672690874,988
3635,3927165965,3372223551,1672602874,1672603444,570
3622,3620292035,3779438325,1672665596,1672668954,3358
3787,3284932450,3424445495,1672572719,1672574069,1350
3687,3773124276,3338083680,1672584109,1672587506,3397
3552,3462158237,3625174002,1672669987,1672672999,3012
3578,3791441520,3431460073,1672684296,1672685525,1229
3804,3755848152,3661447322,1672674347,1672675276,929
3523,3226024417,3710315160,1672658483,1672659312,829
3817,3715385401,3517358573,1672675816,1672677002,1186
3435,3394401087,3416987084,1672545175,1672545934,759
3637,3756474459,3512958459,1672654737,1672656533,1796
3429,3428027649,3384068080,1672603287,1672604835,1548
3821,3792745809,3610358027,1672676343,1672679764,3421
3751,3902625986,3776117322,1672665264,1672667503,2239
3659,3755404116,3701247948,1672681311,1672681648,337
3781,3831586487,3792546035,1672703090,1672704468,1378
3465,3715974659,3370227921,1672569753,1672570108,355
3430,3776084820,3311498666,1672593818,1672596009,2191
3702,3205923620,3970558632,1672555424,1672556994,1570
3809,3500827202,3276348699,1672648675,1672651998,3323
3744,3449333754,3777147510,1672676744,1672678040,1296
3666,3714827719,3400069268,1672574354,1672576468,2114
3484,3367111751,3449333754,1672654399,1672655487,1088
3492,3682133690,3713941638,1672680830,1672681250,420
3457,3457620713,3756474459,1672627391,1672630923,3532
3437,3900898992,3777147510,1672670416,1672673713,3297
3446,3783433404,3811075491,1672573958,1672575418,1460
3646,3701884158,3492546679,1672650023,1672653299,3276
3538,3463740710,3279339278,1672552504,1672553405,901
3482,3202804048,3773572967,1672651932,1672653908,1976
3483,3739895284,3505228454,1672603888,1672604355,467
3701,3424445495,3534175249,1672699631,1672700980,1349
3680,3280268483,3793781065,1672572700,1672576294,3594
3670,3347419520,3904412440,1672575152,1672576731,1579
3547,3757193551,3337322736,1672569131,1672571986,2855
3876,3608922867,3793868716,1672683317,1672685930,2613
3557,3812369928,3510642075,1672646207,1672648968,2761
3601,3716272919,3501281016,1672628013,1672628739,726
3689,3519818818,3417679834,1672593871,1672595419,1548
3827,3615115210,3225636215,1672629481,1672630790,1309
3591,3885537225,3755158925,1672621360,1672623329,1969
3809,3519446663,3773735484,1672690898,1672692654,1756
3620,3505663516,3938503547,1672576875,1672578339,1464
3765,3776117322,3500208903,1672577596,1672580020,2424
3496,3380982774,3665998641,1672591726,1672592709,983
3771,3701247948,3619922891,1672597817,1672599353,1536
3455,3514246749,3510919821,1672606706,1672607453,747
3646,3710735406,3514956366,1672563466,1672565414,1948
3763,3777091903,3429943738,1672575624,1672575715,91
3599,3684523966,3610358027,1672701018,1672703344,2326
3909,3497095254,3824641227,1672669024,1672671306,2282
3840,3447514821,3279473441,1672622546,1672624367,1821
3732,3859868849,3272030610,1672560249,1672563718,3469
3730,3900276517,3975717896,1672634134,1672634993,859
3529,3500613459,3512379024,1672547740,1672550037,2297
3467,3554944414,3517172354,1672679975,1672682958,2983
3906,3505847380,3608922867,1672700292,1672703015,2723
3631,3779425804,3971806004,1672645264,1672646137,873
3694,3970198861,3618808151,1672650701,1672652472,1771
3504,3520764926,3248058676,1672674039,1672675583,1544
3680,3714120857,3513345163,1672649683,1672652833,3150
3853,3770676872,3757348722,1672577551,1672578955,1404
3541,3480991549,3970558632,1672679237,1672680669,1432
3919,3533079336,3755222916,1672585490,1672586483,993
3856,3500915665,3493017654,1672626692,1672629381,2689
3678,3512722110,3357864626,1672660015,1672663597,3582
3596,3776117322,3518194482,1672564998,1672568291,3293
3796,3511791953,3511024016,1672673637,1672676619,2982
3534,3551376095,3791796585,1672664132,1672665777,1645
3539,3203538212,3739911441,1672663508,1672664343,835
3513,3776988674,3520355798,1672673534,1672676471,2937
3537,3336627643,3554186380,1672592399,1672595660,3261
3799,3518565331,3338083680,1672619009,1672621557,2548
3826,3614740489,3755848152,1672542257,1672544444,2187
3909,3452016771,3515401243,1672581030,1672583072,2042
3453,3226511603,3902625986,1672636834,1672638447,1613
3516,3779938251,3780680950,1672587459,1672589044,1585
3908,3930242012,3793922324,1672568464,1672571904,3440
3437,3783340788,3417679834,1672691361,1672693120,1759
3736,3792274796,3779639983,1672605013,1672606890,1877
3585,3701373490,3519028898,1672635336,1672637190,1854
3449,3512295534,3511883730,1672607843,1672608956,1113
3525,3400763927,3701136026,1672636119,1672638514,2395
3661,3928511283,3780712350,1672550900,1672554184,3284
3788,3451326054,3505663516,1672576131,1672576555,424
3890,3292147449,3887243870,1672676569,1672677589,1020
3660,3912891315,3495911207,1672576120,1672576723,603
3662,3304155815,3736231757,1672688381,1672689492,1111
3866,3780338697,3491684096,1672637922,1672638182,260
3880,3512337405,3611055563,1672542631,1672545684,3053
3445,3224330592,3383138270,1672586666,1672587589,923
3777,3772236797,3398198430,1672621803,1672623156,1353
3725,3972192593,3480991549,1672661574,1672661894,320
3915,3283492940,3357289672,1672670001,1672672099,2098
3658,3701823816,3899786664,1672640231,1672642440,2209
3814,3501459390,3435167810,1672570764,1672573021,2257
3896,3701884158,3475349791,1672700194,1672701674,1480
3790,3760364383,3777091903,1672703916,1672704229,313
3430,3885155975,3512282789,1672622028,1672623652,1624
3764,3510641433,3460719322,1672638999,1672639305,306
3804,3205985903,3715385401,1672638434,1672641278,2844
3479,3772391882,3512499658,1672533687,1672534898,1211
3619,3511317276,3239617320,1672693013,1672695613,2600
3791,3519028898,3701882224,1672550768,1672552928,2160
3619,3505283390,3409114719,1672603263,1672606284,3021
3445,3467988782,3514703118,1672652964,1672654793,1829
3429,3774155692,3774031303,1672628511,1672630928,2417
3462,3779738691,3906536154,1672685513,1672687147,1634
3869,3513853403,3608232640,1672593618,1672594343,725
3740,3500857494,3386758279,1672629600,1672631028,1428
3700,3312998540,3518194482,1672582228,1672584744,2516
3531,3533747868,3931627862,1672671340,1672674149,2809
3495,3509483172,3500613459,1672642745,1672646140,3395
3431,3714666884,3972192593,1672554949,1672555147,198
3577,3850911686,3334647380,1672608107,1672610959,2852
3846,3517887477,3757863420,1672643539,1672643775,236
3889,3688490530,3770438122,1672544904,1672546870,1966
3796,3417679834,3613206049,1672654766,1672657043,2277
3546,3625174002,3970603231,1672593007,1672596157,3150
3598,3609933747,3914691363,1672660792,1672661204,412
3782,3372223551,3296462324,1672578059,1672579658,1599
3511,3975717896,3605221116,1672581628,1672585007,3379
3609,3511005395,3417679834,1672605552,1672605660,108
3642,3779938251,3825881598,1672596134,1672599168,3034
3797,3710048469,3793407963,1672693091,1672695896,2805
3605,3617304541,3755496114,1672665200,1672666263,1063
3852,3299443125,3514741348,1672702692,1672704979,2287
3871,3410538749,3792274796,1672654286,1672656680,2394
3462,3534829213,3376467719,1672655821,1672658887,3066
3803,3885537225,3510499038,1672565304,1672568214,2910
3529,3770468980,3701882224,1672616863,1672620013,3150
3565,3760645796,3401940259,1672581230,1672583649,2419
3848,3835985172,3783919913,1672703380,1672705249,1869
3846,3780427126,3815392801,1672684606,1672686483,1877
3634,3905196766,3429943738,1672612832,1672614979,2147
3491,3246370118,3374183227,1672630183,1672630859,676
3631,3520355798,3510641433,1672658692,1672660250,1558
3541,3618808151,3513065217,1672582203,1672585064,2861
3908,3792505974,3500072204,1672554340,1672554903,563
3804,3336339664,3229822507,1672531314,1672533343,2029
3893,3310125159,3734118023,1672534600,1672535964,1364
3598,3885537225,3501121099,1672624400,1672624546,146
3484,3450286949,3395201292,1672625111,1672626427,1316
3513,3505437712,3778134418,1672670048,1672671164,1116
3447,3519446663,3311498666,1672575225,1672576446,1221
3660,3349856820,3618808151,1672695664,1672697683,2019
3429,3855583256,3480100311,1672582847,1672586159,3312
3918,3517991730,3500672156,1672646227,1672648984,2757
3749,3511732493,3386758279,1672547052,1672547987,935
3882,3755496114,3500949309,1672553562,1672554948,1386
3427,3852533643,3703433819,1672592639,1672596130,3491
3622,3792072681,3667427125,1672672402,1672674236,1834
3914,3793781065,3773572967,1672671829,1672673951,2122
3825,3449333754,3516741440,1672545437,1672546204,767
3825,3551376095,3609113156,1672645623,1672648924,3301
3743,3791753345,3500109249,1672652167,1672653339,1172
3580,3245232284,3511024016,1672613434,1672616519,3085
3595,3533004959,3632814465,1672575459,1672577300,1841
3597,3514275974,3336339664,1672597104,1672597297,193
3434,3279242917,3920625129,1672604662,1672605556,894
3776,3446533960,3337322736,1672576808,1672578982,2174
3725,3783520186,3934064792,1672694509,1672695963,1454
3676,3513410578,3500709774,1672657302,1672658597,1295
3631,3773121782,3408498208,1672663255,1672664014,759
3687,3664943873,3776988674,1672537305,1672539933,2628
3752,3732584121,3202141727,1672689355,1672689637,282
3550,3300818269,3710489491,1672682017,1672682653,636
3755,3770296583,3783163143,1672579962,1672580186,224
3767,3803389195,3776244398,1672690888,1672691841,953
3520,3505179890,3488763230,1672699372,1672702859,3487
3767,3299443125,3734915241,1672671370,1672674594,3224
3511,3792389522,3225029895,1672702954,1672703944,990
3789,3734118023,3817428320,1672655125,1672658474,3349
3543,3497671225,3778597171,1672633963,1672634562,599
3865,3511442562,3303410628,1672625442,1672626365,923
3876,3608232640,3760842815,1672691825,1672694132,2307
3432,3689114185,3272096759,1672689983,1672693198,3215
3478,3485540729,3224330592,1672531947,1672534875,2928
3574,3615939504,3534829213,1672536324,1672537979,1655
3451,3811075491,3512379024,1672544923,1672547030,2107
3695,3912891315,3793740407,1672613668,1672614829,1161
3546,3367971170,3621184108,1672606211,1672606866,655
3798,3792546035,3515402792,1672538311,1672540283,1972
3663,3469254160,3220031931,1672699426,1672700076,650
3443,3370227921,3792389522,1672586744,1672587978,1234
3831,3337362061,3615115210,1672566533,1672568990,2457
3877,3517687662,3514971533,1672604055,1672606148,2093
3765,3512337405,3300818269,1672689056,1672692154,3098
3444,3791693821,3776988674,1672557951,1672561331,3380
3917,3791613604,3803389195,1672547923,1672550035,2112
3608,3618808151,3912891315,1672635729,1672636381,652
3433,3501215099,3514419100,1672700376,1672700967,591
3788,3812369928,3226024417,1672567139,1672568559,1420
3474,3514741348,3970558632,1672551122,1672551982,860
3666,3793740407,3780571086,1672654971,1672656377,1406
3804,3241790910,3500613459,1672545346,1672548168,2822
3537,3824641227,3625174002,1672549858,1672550288,430
3617,3512392431,3783801141,1672612184,1672613804,1620
3663,3520873221,3514956366,1672541796,1672543512,1716
3642,3819767045,3459681410,1672650182,1672650855,673
3567,3932478321,3519651506,1672658400,1672660513,2113
3512,3615737355,3701884158,1672542634,1672543880,1246
3810,3895285664,3621461051,1672600736,1672601661,925
3579,3512946768,3783520186,1672533393,1672536853,3460
3681,3392943173,3401793306,1672627968,1672628281,313
3887,3511288998,3437286517,1672701710,1672703664,1954
3904,3714666884,3533274994,1672669935,1672672602,2667
3544,3398731252,3887243870,1672567056,1672570472,3416
3824,3703139663,3273981374,1672597389,1672599217,1828
3455,3283144118,3461119815,1672532444,1672533534,1090
3598,3755756564,3533090502,1672601835,1672604856,3021
3848,3710854064,3889780657,1672614846,1672616631,1785
3583,3461119815,3312998540,1672690707,1672691980,1273
3771,3533747868,3341893384,1672612130,1672613952,1822
3814,3618808151,3230868435,1672583628,1672586371,2743
3572,3283144118,3515559913,1672573862,1672574596,734
3679,3440137407,3206837348,1672662588,1672664767,2179
3705,3711097754,3938503547,1672642944,1672646426,3482
3724,3305336154,3783520186,1672544405,1672545534,1129
3540,3520416075,3349856820,1672580046,1672580286,240
3485,3615115210,3703383853,1672577018,1672579306,2288
3916,3935399379,3779892400,1672554341,1672555787,1446
3900,3510767239,3970627281,1672653533,1672655964,2431
3661,3609881958,3715854030,1672693424,1672694011,587
3732,3515466096,3760094385,1672609293,1672612402,3109
3744,3512337405,3505634634,1672623076,1672626259,3183
3534,3667427125,3713941638,1672542794,1672546145,3351
3563,3534543776,3468041839,1672697693,1672698495,802
3509,3440107959,3934064792,1672652296,1672653302,1006
3739,3519416013,3500072204,1672702508,1672703761,1253
3732,3551376095,3711919537,1672597199,1672598519,1320
3528,3818575661,3505179890,1672563663,1672566379,2716
3620,3520657891,3668533536,1672646222,1672647864,1642
3891,3520115090,3792505974,1672537076,1672538755,1679
3431,3974674109,3231494505,1672623253,1672626584,3331
3622,3236354255,3410600350,1672545247,1672548817,3570
3632,3615688740,3451726367,1672669543,1672672093,2550
3492,3757294769,3711919537,1672565302,1672566686,1384
3885,3414275042,3276269264,1672539154,1672540024,870
3425,3932478321,3271454397,1672612798,1672614433,1635
3491,3410538749,3773332082,1672572136,1672572609,473
3756,3755992176,3398731252,1672641299,1672642598,1299
3540,3367971170,3714666884,1672574882,1672575471,589
3890,3396980894,3552824113,1672541483,1672544689,3206
3643,3780209375,3514324011,1672681997,1672685437,3440
3437,3201800997,3904412440,1672620779,1672621016,237
3546,3635169815,3400069268,1672663032,1672666434,3402
3848,3755848152,3757193551,1672636383,1672639877,3494
3485,3384583385,3534543776,1672656041,1672656638,597
3610,3620292035,3274906650,1672555101,1672555714,613
3854,3511442562,3715127070,1672649425,1672650225,800
3898,3520560590,3792274796,1672567878,1672568187,309
3831,3505434346,3512502036,1672685065,1672686486,1421
3533,3510818674,3618808151,1672565343,1672566063,720
3694,3935399379,3669146016,1672616688,1672617207,519
3654,3511843593,3783919913,1672668025,1672671252,3227
3903,3760040019,3394297564,1672580982,1672581268,286
3665,3760640999,3829864515,1672533237,1672536547,3310
3562,3710854064,3518653080,1672532044,1672534161,2117
3454,3374183227,3774790271,1672679475,1672680793,1318
3770,3711218296,3906536154,1672694518,1672695068,550
3741,3895285664,3755344363,1672637630,1672641063,3433
3609,3779646172,3514308235,1672560756,1672563723,2967
3808,3308760650,3829822608,1672541409,1672544889,3480
3537,3208957949,3510767239,1672574727,1672577856,3129
3751,3780571086,3371455553,1672637745,1672641329,3584
3689,3511288998,3559458968,1672570935,1672571640,705
3887,3368283077,3491684096,1672544377,1672547271,2894
3815,3760364383,3756746867,1672556790,1672558808,2018
3732,3396726504,3500604680,1672677328,1672678716,1388
3533,3515890966,3625174002,1672669328,1672672270,2942
3767,3904569677,3774290799,1672630270,1672631849,1579
3432,3336339664,3311098437,1672679419,1672680175,756
3619,3512830734,3462158237,1672653568,1672655993,2425
3804,3811075491,3780872464,1672570601,1672571291,690
3692,3454277788,3533228966,1672575985,1672579012,3027
3814,3495911207,3518229776,1672555546,1672557080,1534
3481,3701373490,3920898925,1672625726,1672627976,2250
3860,3927599181,3273981374,1672703318,1672704020,702
3513,3668414677,3926643445,1672680363,1672681945,1582
3506,3517590837,3792274796,1672637030,1672640091,3061
3642,3773033649,3791246640,1672643074,1672645663,2589
3599,3410600350,3909094917,1672615223,1672617563,2340
3573,3299443125,3514971533,1672559707,1672561070,1363
3803,3792505974,3387594369,1672641037,1672641401,364
3484,3774733620,3620292035,1672550919,1672551952,1033
3669,3793418209,3713589994,1672675331,1672675582,251
3644,3618176292,3513360004,1672658175,1672661592,3417
3865,3714185969,3244004456,1672597348,1672599857,2509
3516,3701107228,3399518841,1672628453,1672631303,2850
3440,3519028898,3714233826,1672664085,1672665969,1884
3837,3412006598,3501121099,1672592524,1672595125,2601
3884,3621683102,3505847380,1672666661,1672670176,3515
3597,3667673649,3668747074,1672593428,1672593947,519
3426,3793868716,3410538749,1672701544,1672703079,1535
3726,3623266256,3505481368,1672568773,1672570043,1270
3702,3509483172,3815392801,1672601277,1672604611,3334
3613,3904412440,3792801638,1672685957,1672689007,3050
3829,3497671225,3534543776,1672655481,1672658756,3275
3643,3493017654,3607882826,1672557315,1672557828,513
3728,3831586487,3793935736,1672693841,1672696147,2306
3658,3669146016,3505198734,1672598238,1672599473,1235
3762,3360069849,3710315160,1672689844,1672690356,512
3663,3736231757,3713911104,1672621955,1672624702,2747
3486,3481640525,3499217428,1672692831,1672693479,648
3870,3935399379,3231713082,1672697532,1672698694,1162
3900,3770236215,3776117322,1672696546,1672699133,2587
3760,3509764635,3514971533,1672678349,1672678506,157
3582,3760842815,3609933747,1672667302,1672670117,2815
3439,3511791953,3533294425,1672674810,1672677696,2886
3804,3793935736,3517172354,1672642668,1672644486,1818
3464,3514334067,3930242012,1672683352,1672684248,896
3644,3384068080,3774178201,1672540018,1672543255,3237
3477,3979784676,3703396825,1672690923,1672694487,3564
3662,3390660440,3443357683,1672536212,1672536593,381
3767,3731646673,3226024417,1672598111,1672599920,1809
3726,3737112297,3920898925,1672550770,1672553421,2651
3673,3517222913,3680810086,1672568037,1672568200,163
3848,3899326793,3559458968,1672591017,1672591632,615
3831,3398198430,3417191856,1672541266,1672542662,1396
3477,3970558632,3897376951,1672635687,1672636073,386
3764,3732584121,3520639768,1672676547,1672678047,1500
3487,3791693821,3512337405,1672592613,1672594694,2081
3825,3730071479,3431460073,1672534588,1672535096,508
3768,3618354185,3904569677,1672660808,1672661404,596
3595,3497671225,3776988674,1672693179,1672694671,1492
3440,3773939399,3661903000,1672627510,1672629168,1658
3617,3737972328,3437286517,1672602232,1672604590,2358
3785,3893912331,3617392620,1672690917,1672693635,2718
3922,3608232640,3513410578,1672638220,1672639792,1572
3783,3519818818,3390660440,1672594953,1672595087,134
3581,3514956366,3534357694,1672650900,1672651442,542
3473,3970909253,3852533643,1672538623,1672539446,823
3626,3501215099,3398731252,1672630477,1672632037,1560
3804,3853629553,3734451191,1672539382,1672540885,1503
3883,3618808151,3811040565,1672703830,1672705485,1655
3476,3793740407,3311420950,1672680755,1672681946,1191
3820,3739661856,3244004456,1672542128,1672544640,2512
3473,3779656423,3975717896,1672624553,1672626551,1998
3537,3437286517,3382733096,1672602051,1672604068,2017
3871,3756625818,3735374579,1672690856,1672693401,2545
3769,3627368399,3807212280,1672600874,1672601396,522
3460,3500672156,3304155815,1672611522,1672613506,1984
3656,3513081354,3774876004,1672574235,1672576425,2190
3598,3370227921,3839245934,1672623401,1672626661,3260
3579,3773033649,3609113156,1672653141,1672654290,1149
3865,3613899351,3410600350,1672635866,1672639008,3142
3598,3773124276,3760694096,1672568768,1672570873,2105
3727,3733558985,3626499450,1672574049,1672576365,2316
3742,3244004456,3714827719,1672674710,1672675114,404
3581,3512337405,3520355798,1672573875,1672576678,2803
3456,3713784974,3617392620,1672580728,1672581444,716
3470,3450286949,3760645796,1672646001,1672648088,2087
3440,3370068529,3551376095,1672675296,1672675377,81
3491,3428725843,3373089838,1672534081,1672536435,2354
3597,3505847380,3880926355,1672579682,1672582617,2935
3468,3248058676,3520355798,1672697243,1672700672,3429
3848,3415833929,3791693821,1672671227,1672673220,1993
3648,3373028638,3979802715,1672651005,1672652899,1894
3626,3733558985,3760924079,1672681859,1672685041,3182
3749,3392836218,3497808662,1672652981,1672655542,2561
3811,3505481368,3665998641,1672538585,1672541076,2491
3787,3559458968,3354144091,1672614744,1672617960,3216
3610,3226178937,3415833929,1672637598,1672639118,1520
3529,3272030610,3283770991,1672543671,1672545681,2010
3695,3669146016,3517288083,1672659153,1672662568,3415
3838,3970603231,3701884158,1672685953,1672688491,2538
3700,3811075491,3375449013,1672566255,1672569369,3114
3905,3497095254,3755756564,1672591172,1672592777,1605
3733,3770468980,3779438325,1672594116,1672596639,2523
3579,3711812325,3611055563,1672697969,1672701268,3299
3488,3270056120,3511883730,1672574942,1672578137,3195
3843,3272096759,3756127300,1672626791,1672627107,316
3887,3505402439,3534543776,1672587306,1672588840,1534
3621,3514285803,3774031303,1672569861,1672570796,935
3796,3716628503,3226511603,1672610637,1672613810,3173
3513,3209481722,3509893027,1672548314,1672549664,1350
3758,3774705415,3438078818,1672680520,1672681081,561
3656,3608232640,3737147209,1672640844,1672642521,1677
3756,3780115155,3783147088,1672687831,1672688987,1156
3645,3410600350,3554186380,1672621546,1672623747,2201
3613,3490029863,3534126409,1672656849,1672658141,1292
3728,3613338363,3288224595,1672686146,1672689471,3325
3715,3905196766,3821054646,1672541955,1672544122,2167
3898,3776244398,3533228966,1672592401,1672594006,1605
3768,3412006598,3343816795,1672671322,1672673012,1690
3443,3505481368,3777184389,1672631164,1672633360,2196
3792,3793418209,3501281016,1672662724,1672663168,444
3472,3517887477,3505179890,1672531713,1672534997,3284
3507,3306175858,3491469603,1672611564,1672615151,3587
3497,3309314379,3279242917,1672571702,1672574915,3213
3437,3735374579,3625463628,1672672847,1672674143,1296
3743,3757700712,3664943873,1672590853,1672590970,117
3722,3364726656,3760362417,1672611661,1672613071,1410
3590,3443357683,3417191856,1672659133,1672661163,2030
3764,3225631197,3516513251,1672586922,1672589379,2457
3521,3312998540,3777091903,1672577398,1672577686,288
3694,3500442734,3201629017,1672588360,1672591489,3129
3685,3520991398,3977148669,1672554676,1672555344,668
3530,3780872464,3714067076,1672658133,1672659651,1518
3458,3773033649,3793175445,1672592686,1672595688,3002
3555,3815250107,3669146016,1672597779,1672599024,1245
3558,3509483172,3711734586,1672607780,1672609331,1551
3600,3306175858,3715854030,1672691082,1672692567,1485
3620,3480490124,3770146716,1672681621,1672682179,558
3682,3615115210,3739911441,1672617253,1672619174,1921
3625,3512282789,3773332082,1672609198,1672612499,3301
3751,3299781901,3755233658,1672563690,1672565105,1415
3706,3793315718,3715127070,1672693947,1672694719,772
3843,3802932312,3885121158,1672542593,1672544416,1823
3875,3276217799,3739661856,1672682888,1672683490,602
3530,3630353876,3850911686,1672675100,1672678281,3181
3545,3505198734,3783550022,1672631344,1672633542,2198
3488,3793418209,3364378127,1672537588,1672538086,498
3794,3792745809,3533649454,1672532876,1672535982,3106
3789,3533649454,3637313265,1672666458,1672667853,1395
3732,3517358573,3755233658,1672568518,1672569663,1145
3650,3400763927,3930242012,1672541816,1672542632,816
3461,3783919913,3499217428,1672609020,1672611248,2228
3812,3383138270,3488763230,1672564884,1672567311,2427
3850,3622665543,3684523966,1672702781,1672703149,368
3689,3305722859,3921648519,1672658852,1672660275,1423
3883,3230868435,3462636434,1672701803,1672704606,2803
3471,3624297844,3469254160,1672631716,1672634597,2881
3698,3375449013,3500442734,1672555699,1672555769,70
3865,3770624662,3470454332,1672695607,1672696391,784
3642,3902760230,3447514821,1672643867,1672646322,2455
3574,3925979970,3895285664,1672612551,1672615087,2536
3789,3231713082,3517687662,1672545511,1672549022,3511
3520,3408430195,3376467719,1672600452,1672601574,1122
3793,3803389195,3480991549,1672696990,1672698193,1203
3809,3770438122,3347419520,1672691530,1672695000,3470
3880,3441348818,3480100311,1672673601,1672674961,1360
3691,3512295534,3811040565,1672677836,1672679138,1302
3491,3357864626,3500613459,1672631773,1672634900,3127
3647,3756127300,3230868435,1672534167,1672534848,681
3921,3334993594,3613206049,1672600890,1672601989,1099
3500,3299781901,3701005527,1672582052,1672585631,3579
3589,3736705719,3520322124,1672614341,1672616774,2433
3905,3310039260,3512383699,1672700291,1672703399,3108
3878,3757630221,3607768197,1672686482,1672687614,1132
3896,3311098437,3351696332,1672535134,1672537616,2482
3900,3667427125,3500777439,1672667150,1672669850,2700
3730,3713589994,3304155815,1672653324,1672654734,1410
3642,3713163045,3520416075,1672541491,1672544405,2914
3780,3824215187,3513296868,1672563830,1672566500,2670
3532,3770704999,3778667336,1672664907,1672665329,422
3712,3774178201,3513295938,1672596067,1672599353,3286
3748,3202804048,3500317969,1672602181,1672602442,261
3788,3739911441,3773913680,1672649847,1672652797,2950
3659,3308760650,3512830734,1672618711,1672619904,1193
3761,3380130228,3791106564,1672604846,1672606445,1599
3593,3774876004,3667673649,1672635370,1672638687,3317
3891,3617489344,3311085279,1672557583,1672561131,3548
3622,3310039260,3505179890,1672664311,1672666377,2066
3798,3735374579,3229822507,1672659807,1672662837,3030
3777,3688220326,3779465522,1672599673,1672602687,3014
3822,3834963772,3514703118,1672638716,1672640457,1741
3756,3757193307,3902760230,1672595769,1672595874,105
3899,3505725706,3360069849,1672674573,1672677622,3049
3539,3288224595,3899326793,1672596009,1672596397,388
3480,3791753345,3610358027,1672552035,1672554314,2279
3782,3801645328,3779646172,1672535588,1672538076,2488
3806,3760094385,3334647380,1672612424,1672614162,1738
3814,3829864515,3755756564,1672543900,1672547148,3248
3793,3518229776,3248058676,1672666341,1672667949,1608
3883,3793740407,3517737088,1672601913,1672602806,893
3770,3774733620,3736231757,1672600687,1672601843,1156
3917,3517462308,3773572967,1672555039,1672557035,1996
3474,3505521218,3310039260,1672582257,1672584241,1984
3553,3202141727,3510837901,1672544664,1672547989,3325
3785,3351866415,3513410578,1672565391,1672568984,3593
3826,3774790271,3756746867,1672625256,1672625765,509
3615,3779786641,3779738691,1672696774,1672700130,3356
3452,3512502036,3791693821,1672701482,1672702134,652
3494,3783615982,3711853996,1672607466,1672610268,2802
3845,3514308235,3778899160,1672532075,1672534104,2029
3760,3703139663,3703139663,1672625988,1672626810,822
3560,3534357694,3310039260,1672668730,1672669202,472
3786,3923420131,3534543776,1672544259,1672547704,3445
3903,3463849738,3316798920,1672663074,1672665654,2580
3915,3403370192,3505807416,1672549015,1672552065,3050
3643,3773572967,3485540729,1672533887,1672534224,337
3641,3469254160,3241914067,1672603622,1672604369,747
3730,3416987084,3551399764,1672653842,1672655873,2031
3844,3829822608,3979802715,1672541188,1672541420,232
3624,3501215099,3410160376,1672674934,1672676619,1685
3683,3417679834,3516513251,1672701804,1672704749,2945
3818,3701136026,3518194482,1672643679,1672644077,398
3834,3316800320,3714067076,1672698235,1672698943,708
3670,3270697740,3509483172,1672677729,1672678456,727
3702,3228888030,3519818818,1672578419,1672580241,1822
3472,3288224595,3757193551,1672558350,1672558782,432
3885,3511442562,3515890966,1672537343,1672538661,1318
3603,3730071479,3520115090,1672697133,1672698938,1805
3719,3906536154,3600876425,1672554420,1672556840,2420
3896,3349856820,3551376095,1672672988,1672674077,1089
3727,3510798825,3791753345,1672582961,1672584526,1565
3474,3203538212,3610358027,1672638331,1672640985,2654
3751,3793740407,3514275974,1672628991,1672630736,1745
3602,3374183227,3818575661,1672622673,1672625481,2808
3616,3710489491,3885155975,1672696706,1672697110,404
3770,3738026330,3201629017,1672625805,1672627643,1838
3645,3817428320,3337322736,1672551947,1672554584,2637
3799,3897134762,3421877923,1672654648,1672655761,1113
3504,3418448389,3475349791,1672662655,1672665894,3239
3630,3927403123,3688490530,1672549168,1672552151,2983
3718,3519850727,3635169815,1672635053,1672636354,1301
3473,3773837847,3283770991,1672667741,1672668883,1142
3841,3510767239,3240994288,1672575688,1672579134,3446
3432,3661903000,3238288884,1672590852,1672592531,1679
3832,3500109249,3770704999,1672594368,1672596927,2559
3767,3274906650,3472068734,1672663657,1672663718,61
3797,3209526819,3400069268,1672544858,1672546037,1179
3779,3395201292,3360616538,1672579284,1672580518,1234
3772,3500613459,3271454397,1672683864,1672684855,991
3795,3501281016,3710489491,1672578388,1672581651,3263
3780,3664943873,3279473441,1672654652,1672656369,1717
3821,3686523546,3774178201,1672633453,1672633614,161
3528,3285204083,3632814465,1672694047,1672695337,1290
3648,3402385957,3716628503,1672613350,1672614813,1463
3500,3779465522,3701884158,1672649647,1672650660,1013
3528,3793922324,3689114185,1672667704,1672671054,3350
3570,3441348818,3289817992,1672590622,1672593207,2585
3881,3701373490,3220031931,1672596167,1672598836,2669
3635,3615115210,3231494505,1672605110,1672605254,144
3561,3713829743,3310039260,1672698794,1672699723,929
3725,3209526819,3511288998,1672602095,1672605552,3457
3481,3625463628,3294747828,1672672311,1672673684,1373
3736,3905196766,3380982774,1672637604,1672640697,3093
3808,3621461051,3773572967,1672636553,1672637961,1408
3698,3400763927,3631090677,1672661637,1672663164,1527
3535,3435167810,3703396825,1672692106,1672694967,2861
3831,3395201292,3512392431,1672657042,1672659834,2792
3598,3226511603,3760263530,1672553220,1672554328,1108
3837,3732584121,3500317969,1672553989,1672555381,1392
3825,3272030610,3928511283,1672571167,1672572586,1419
3873,3614740489,3667673649,1672540377,1672541206,829
3632,3770236215,3514334067,1672584010,1672585692,1682
3497,3462273042,3669146016,1672578723,1672580861,2138
3696,3970198861,3770520359,1672681335,1672683447,2112
3819,3501457103,3793175445,1672564031,1672565254,1223
3567,3369708250,3891672228,1672632663,1672633416,753
3805,3923754072,3710315160,1672544171,1672545555,1384
3631,3772765746,3793418209,1672643079,1672643968,889
3447,3369708250,3609659642,1672612752,1672613879,1127
3830,3440107959,3824641227,1672635066,1672637603,2537
3854,3492959689,3631090677,1672659613,1672661908,2295
3842,3457960571,3898314440,1672657710,1672659295,1585
3647,3510818674,3755158925,1672680104,1672683486,3382
3711,3533423872,3638660068,1672701895,1672704356,2461
3630,3347419520,3310039260,1672623924,1672624467,543
3613,3774155692,3446533960,1672615457,1672615831,374
3646,3774178201,3533004959,1672555927,1672557969,2042
3592,3783928182,3472312341,1672636298,1672638307,2009
3823,3338083680,3780834916,1672593497,1672594540,1043
3895,3972083617,3621461051,1672647239,1672647843,604
3710,3500915908,3304155815,1672679515,1672681795,2280
3816,3306412634,3510499038,1672544620,1672548166,3546
3764,3927165965,3512958459,1672614722,1672617711,2989
3569,3288762795,3518229776,1672681700,1672683328,1628
3793,3500915908,3514275974,1672634168,1672637576,3408
3655,3920625129,3779639983,1672701698,1672704517,2819
3547,3514246749,3624297844,1672579525,1672580548,1023
3884,3487875183,3510767239,1672611452,1672613573,2121
3430,3733363628,3305722859,1672597790,1672598845,1055
3864,3617489344,3737972328,1672611887,1672614078,2191
3907,3226178937,3373028638,1672671704,1672673601,1897
3871,3902625986,3280268483,1672563685,1672566364,2679
3512,3288224595,3755573472,1672650541,1672653915,3374
3899,3311049964,3225636215,1672665323,1672667988,2665
3912,3520873221,3893912331,1672551084,1672551771,687
3764,3534126409,3336627643,1672658504,1672660235,1731
3705,3604589802,3431460073,1672647720,1672649168,1448
3540,3835422146,3715986185,1672578905,1672579318,413
3480,3935913584,3533368789,1672644623,1672645939,1316
3559,3792801638,3683113954,1672696654,1672697455,801
3552,3757903168,3737112297,1672695977,1672697673,1696
3744,3347446226,3770146716,1672583860,1672584368,508
3527,3715127070,3776559988,1672638854,1672639261,407
3499,3519077659,3732131656,1672654498,1672654808,310
3782,3774907131,3711637255,1672553140,1672554508,1368
3560,3505434346,3436025562,1672693885,1672696591,2706
3648,3519282716,3455018347,1672598527,1672600556,2029
3587,3517697722,3457620713,1672588704,1672590414,1710
3690,3337322736,3439673892,1672590352,1672591130,778
3640,3970909253,3934064792,1672555984,1672558446,2462
3732,3554944414,3534357694,1672599384,1672602620,3236
3748,3520322124,3410160376,1672568030,1672569487,1457
3819,3739661856,3625174002,1672580417,1672581276,859
3583,3495911207,3792546035,1672695357,1672698037,2680
3731,3774876004,3241790910,1672646322,1672646413,91
3609,3514419100,3512882178,1672694155,1672697638,3483
3739,3618808151,3441348818,1672627884,1672629901,2017
3584,3369708250,3779656423,1672564414,1672566449,2035
3508,3485540729,3230135532,1672648893,1672649722,829
3860,3774641380,3360813161,1672607912,1672608486,574
3618,3777814504,3791128487,1672546346,1672548091,1745
3848,3401940259,3299781901,1672567160,1672568535,1375
3811,3245232284,3701424609,1672602509,1672605354,2845
3579,3755532873,3462636434,1672694402,1672697172,2770
3453,3778899160,3224968597,1672619050,1672621892,2842
3451,3533423872,3514285803,1672628145,1672628327,182
3605,3517358573,3309314379,1672555861,1672558371,2510
3441,3777330107,3510919821,1672672070,1672674311,2241
3692,3441703884,3505228454,1672640468,1672643502,3034
3720,3613416045,3514971533,1672568555,1672569371,816
3517,3661903000,3279339278,1672581007,1672583962,2955
3542,3680843171,3773913680,1672670568,1672672080,1512
3610,3533004959,3711000597,1672666279,1672667248,969
3914,3280268483,3440137407,1672534972,1672535443,471
3765,3834963772,3803517637,1672689447,1672692801,3354
3763,3779854934,3777091903,1672623621,1672624947,1326
3707,3311420950,3701424609,1672649274,1672652450,3176
3826,3701136026,3231713082,1672647715,1672648598,883
3808,3396980894,3298151889,1672635645,1672637240,1595
3833,3661583097,3760364383,1672672498,1672674418,1920
3515,3757332128,3633735593,1672656733,1672659219,2486
3873,3447514821,3424445495,1672673259,1672676322,3063
3497,3534175249,3891672228,1672581613,1672585026,3413
3838,3556969573,3803389195,1672536009,1672539155,3146
3776,3500737582,3610870949,1672626608,1672630051,3443
3730,3209481722,3613338363,1672651100,1672654587,3487
3867,3774155692,3665998641,1672660711,1672661138,427
3823,3607882826,3773332082,1672646942,1672647061,119
3429,3229822507,3716679950,1672620417,1672622066,1649
3641,3972192593,3760645796,1672619045,1672621180,2135
3662,3713300120,3713768950,1672582437,1672585713,3276
3872,3774705415,3276217799,1672564543,1672564914,371
3572,3774155692,3779639983,1672578729,1672579991,1262
3426,3770704999,3421877923,1672626975,1672629629,2654
3818,3517222913,3279339278,1672662951,1672665416,2465
3547,3783340788,3360616538,1672531836,1672533502,1666
3787,3618808151,3660887799,1672535436,1672536515,1079
3654,3296462324,3819767045,1672636808,1672638426,1618
3554,3716963089,3776084820,1672614124,1672615198,1074
3708,3439673892,3756704774,1672653007,1672655461,2454
3817,3364726656,3800257590,1672608153,1672610924,2771
3921,3623266256,3772765746,1672611141,1672612077,936
3575,3793883863,3338390596,1672584552,1672587945,3393
3741,3714827719,3979784676,1672539487,1672540501,1014
3813,3500827202,3451726367,1672673742,1672674976,1234
3875,3734915241,3774178201,1672565452,1672566074,622
3764,3505521218,3791441520,1672615797,1672619069,3272
3497,3239617320,3533368789,1672614506,1672614789,283
3790,3501459390,3554825448,1672649592,1672652735,3143
3752,3811040565,3921648519,1672590427,1672590587,160
3601,3760362417,3889780657,1672558714,1672559278,564
3579,3351866415,3732131656,1672545879,1672548547,2668
3638,3773332082,3710315160,1672600495,1672601116,621
3684,3499217428,3402385957,1672689607,1672693142,3535
3461,3349856820,3367509761,1672677708,1672679761,2053
3860,3533747868,3661447322,1672604718,1672607259,2541
3598,3408430195,3760094385,1672574115,1672576947,2832
3635,3600876425,3710562338,1672653512,1672657009,3497
3674,3773121782,3513345163,1672686162,1672686552,390
3449,3773735484,3760924079,1672544993,1672545745,752
3695,3485540729,3245232284,1672614773,1672617014,2241
3451,3703139663,3460719322,1672666468,1672669090,2622
3538,3811075491,3834631333,1672683159,1672685440,2281
3650,3240394404,3803517637,1672591667,1672594563,2896
3497,3925979970,3713784974,1672539935,1672541022,1087
3606,3803389195,3773033649,1672604754,1672605570,816
3565,3236354255,3513410578,1672599492,1672602122,2630
3738,3472068734,3760694096,1672691691,1672693963,2272
3649,3270056120,3457620713,1672670959,1672671694,735
3573,3803517637,3533228966,1672557390,1672558746,1356
3461,3398198430,3701823816,1672669472,1672671172,1700
3716,3774641380,3300511067,1672647330,1672650310,2980
3726,3500857494,3793315718,1672648122,1672651191,3069
3876,3241790910,3783641602,1672632729,1672632858,129
3443,3500525825,3512882178,1672603985,1672604560,575
3551,3715443333,3279242917,1672650061,1672650617,556
3449,3779656423,3336627643,1672647661,1672650687,3026
3761,3773033649,3814305099,1672579950,1672582910,2960
3483,3373089838,3701823816,1672677083,1672677247,164
3914,3755344363,3770438122,1672604261,1672605818,1557
3885,3793935736,3510837901,1672647277,1672650363,3086
3486,3701322924,3923220461,1672669022,1672672472,3450
3653,3622665543,3505888598,1672603219,1672606578,3359
3784,3517222913,3500442734,1672657385,1672659599,2214
3874,3792745809,3334951866,1672550434,1672552955,2521
3556,3304971369,3906536154,1672547238,1672547513,275
3758,3732584121,3488763230,1672625071,1672627328,2257
3682,3500341755,3715986185,1672693452,1672696768,3316
3528,3777485931,3231494505,1672622983,1672624987,2004
3835,3517991730,3772391882,1672635650,1672638366,2716
3640,3347419520,3711218296,1672663980,1672665308,1328
3767,3773009828,3408430195,1672545488,1672546725,1237
3810,3760651515,3300229945,1672700511,1672703198,2687
3820,3892304880,3779892400,1672545098,1672545655,557
3503,3500347447,3633735593,1672681955,1672683595,1640
3912,3780322355,3710489491,1672571117,1672574265,3148
3644,3977148669,3792525861,1672623245,1672623890,645
3714,3505663516,3271752081,1672621287,1672622590,1303
3866,3551399764,3316800320,1672549348,1672551856,2508
3479,3711006062,3703139663,1672688695,1672691456,2761
3619,3512502036,3443357683,1672544035,1672547272,3237
3732,3902625986,3271454397,1672697018,1672700185,3167
3642,3711853996,3552824113,1672546723,1672549031,2308
3804,3517590837,3900945856,1672565011,1672565125,114
3445,3739911441,3757323954,1672560591,1672563425,2834
3830,3755404116,3791106564,1672667589,1672667674,85
3496,3309314379,3737147209,1672556688,1672558307,1619
3786,3792020993,3821054646,1672601466,1672603817,2351
3469,3513853403,3435167810,1672593856,1672596201,2345
3660,3604589802,3291933594,1672609194,1672610466,1272
3516,3512800570,3279473441,1672677780,1672680732,2952
3458,3792745809,3812369928,1672630067,1672631291,1224
3574,3923420131,3713589994,1672560872,1672561331,459
3720,3793315718,3715545685,1672643894,1672646770,2876
3549,3800257590,3512800570,1672604877,1672607733,2856
3787,3509483172,3932478321,1672668474,1672671458,2984
3532,3710315160,3777485931,1672574444,1672576484,2040
3555,3512958459,3711637255,1672598796,1672599767,971
3869,3815250107,3338390596,1672696834,1672697521,687
3836,3900898992,3516489668,1672659973,1672663538,3565
3705,3710735406,3534126409,1672589674,1672593031,3357
3855,3248058676,3923754072,1672615490,1672616473,983
3642,3360616538,3338083680,1672618154,1672620904,2750
3779,3780680950,3783433404,1672683603,1672685577,1974
3718,3932478321,3714120857,1672572264,1672572484,220
3661,3667673649,3935913584,1672552324,1672553837,1513
3906,3756789525,3517600136,1672696666,1672698315,1649
3722,3515525630,3509764635,1672552732,1672556040,3308
3499,3279242917,3517697722,1672690745,1672691931,1186
3509,3505521218,3512946768,1672679966,1672682563,2597
3871,3713941638,3792538417,1672537812,1672540608,2796
3725,3713517039,3979802715,1672531732,1672532875,1143
3697,3554825448,3755532873,1672598551,1672599873,1322
3846,3685681577,3780472203,1672628748,1672631879,3131
3438,3608232640,3776559988,1672640082,1672640311,229
3558,3501215099,3686227677,1672635847,1672639435,3588
3636,3780338697,3714120857,1672655898,1672658180,2282
3814,3897456874,3280268483,1672621973,1672625044,3071
3495,3515402792,3772236797,1672541108,1672542046,938
3528,3374183227,3514334067,1672652912,1672654517,1605
3588,3520560590,3773009828,1672556688,1672558626,1938
3540,3779854934,3783340788,1672683806,1672685738,1932
3645,3429943738,3792442597,1672677114,1672679752,2638
3737,3493017654,3478114114,1672664513,1672666867,2354
3510,3238288884,3780115155,1672644385,1672647396,3011
3903,3714120857,3615939504,1672604328,1672606421,2093
3586,3770236215,3514308235,1672691734,1672692178,444
3643,3467779445,3398731252,1672699882,1672703431,3549
3630,3276217799,3780571086,1672641885,1672644906,3021
3828,3899326793,3715974659,1672583278,1672583790,512
3645,3457620713,3909094917,1672612704,1672613485,781
3515,3520115090,3505437712,1672612983,1672616530,3547
3519,3938503547,3505634634,1672701436,1672703118,1682
3605,3517737088,3777624586,1672650500,1672651735,1235
3630,3780909839,3899326793,1672569525,1672573084,3559
3672,3898314440,3491469603,1672642700,1672645735,3035
3479,3779425804,3732584121,1672615847,1672616370,523
3678,3398198430,3226024417,1672570076,1672570995,919
3905,3815392801,3920898925,1672572442,1672572805,363
3885,3927403123,3667673649,1672655754,1672658710,2956
3464,3773913680,3230135532,1672675080,1672675583,503
3922,3373089838,3276269264,1672629703,1672630388,685
3721,3739661856,3620292035,1672607949,1672611003,3054
3887,3716679950,3934064792,1672654219,1672656413,2194
3603,3511005395,3273981374,1672679139,1672679270,131
3757,3777814504,3270697740,1672622902,1672626332,3430
3891,3780834916,3780680950,1672620434,1672620920,486
3921,3534126409,3770676872,1672621591,1672623607,2016
3709,3892304880,3774155692,1672541039,1672544427,3388
3913,3512337405,3276217799,1672676621,1672679622,3001
3455,3756127300,3280054198,1672592570,1672595914,3344
3799,3552824113,3412968120,1672646486,1672648244,1758
3459,3635169815,3734118023,1672627169,1672627758,589
3782,3783373154,3609881958,1672631024,1672633026,2002
3659,3370068529,3534179433,1672542773,1672544249,1476
3754,3778640261,3511883730,1672556020,1672557466,1446
3853,3299443125,3311420950,1672555710,1672556962,1252
3714,3509893027,3780427126,1672657544,1672659173,1629
3802,3902625986,3416987084,1672588854,1672591036,2182
3851,3703798634,3779786641,1672659859,1672661858,1999
3465,3519416013,3512295534,1672679177,1672679899,722
3840,3770438122,3778134418,1672569807,1672573258,3451
3549,3519282716,3801645328,1672658199,1672660387,2188
3667,3500347447,3792072681,1672550804,1672553370,2566
3795,3226178937,3514334067,1672571667,1672572939,1272
3886,3492546679,3299443125,1672646384,1672647299,915
3701,3927403123,3519651506,1672679704,1672683041,3337
3467,3279242917,3480100311,1672550456,1672553350,2894
3749,3414275042,3793935736,1672681579,1672683063,1484
3886,3773121782,3369708250,1672641951,1672643050,1099
3497,3516741440,3368283077,1672620692,1672623267,2575
3850,3284947372,3713979100,1672611710,1672614808,3098
3696,3519142371,3231494505,1672628199,1672628652,453
3756,3200543880,3773124276,1672689656,1672692165,2509
3666,3812534508,3791046864,1672673165,1672675910,2745
3575,3343816795,3336627643,1672578192,1672580357,2165
3652,3665998641,3715127070,1672630331,1672632982,2651
3473,3757323954,3783919913,1672652225,1672655606,3381
3765,3398198430,3970909253,1672598776,1672600177,1401
3691,3711077927,3632814465,1672599045,1672599871,826
3869,3617489344,3738026330,1672662274,1672662622,348
3497,3710008361,3514308235,1672674716,1672675983,1267
3432,3421385957,3912891315,1672551970,1672552642,672
3502,3445206685,3880926355,1672548175,1672548764,589
3770,3760094385,3519282716,1672596018,1672599047,3029
3507,3688220326,3619922891,1672685605,1672686889,1284
3718,3208452238,3776244398,1672570482,1672572281,1799
3581,3500703304,3711853996,1672554304,1672555310,1006
3575,3716963089,3608922867,1672532709,1672534771,2062
3434,3349739136,3711637255,1672684321,1672684669,348
3723,3755756564,3310039260,1672580748,1672582297,1549
3440,3915162005,3291933594,1672622780,1672623536,756
3903,3711006062,3609933747,1672582020,1672584810,2790
3582,3891672228,3380767040,1672622327,1672622533,206
3472,3714067076,3792745809,1672595723,1672599047,3324
3720,3926643445,3231713082,1672640731,1672640919,188
3567,3780115155,3791246640,1672551913,1672555294,3381
3870,3701136026,3357689359,1672551970,1672552376,406
3659,3757332128,3519087371,1672646011,1672647974,1963
3619,3819767045,3780322355,1672590476,1672593372,2896
3731,3436025562,3505178849,1672572939,1672575767,2828
3505,3716628503,3505283390,1672624386,1672627211,2825
3485,3711077927,3928511283,1672634991,1672637946,2955
3534,3428725843,3613338363,1672693240,1672695087,1847
3541,3716963089,3514334067,1672702188,1672703642,1454
3551,3736231757,3364726656,1672599714,1672599918,204
3826,3368283077,3500613459,1672702997,1672704622,1625
3635,3780712350,3776034743,1672659016,1672662228,3212
3783,3710854064,3780834916,1672611519,1672613505,1986
3859,3514334067,3713941638,1672591427,1672592297,870
3864,3777240360,3667427125,1672679210,1672680927,1717
3871,3284947372,3310039260,1672595430,1672596356,926
3548,3515439826,3777694660,1672648428,1672650027,1599
3504,3793740407,3935399379,1672626437,1672627531,1094
3581,3773572967,3715127070,1672635755,1672637935,2180
3608,3513018485,3435116799,1672618301,1672619649,1348
3738,3701005527,3519282716,1672626037,1672627949,1912
3805,3363162590,3400763927,1672539995,1672542455,2460
3860,3334951866,3236499444,1672636425,1672637995,1570
3471,3715443333,3200308999,1672605861,1672607534,1673
3699,3396980894,3220031931,1672551267,1672552110,843
3920,3203538212,3516444201,1672564324,1672565831,1507
3862,3517462308,3974674109,1672532137,1672534109,1972
3620,3791128487,3821054646,1672558035,1672560858,2823
3910,3755848152,3370068529,1672615322,1672615983,661
3836,3755573472,3382733096,1672633114,1672635238,2124
3792,3622665543,3451326054,1672581224,1672583541,2317
3528,3701823816,3520560590,1672546305,1672548518,2213
3814,3779786641,3604589802,1672631065,1672634106,3041
3799,3898314440,3414275042,1672556539,1672556793,254
3904,3935399379,3685816610,1672599482,1672602398,2916
3852,3236458894,3428725843,1672534985,1672536363,1378
3465,3279475486,3625174002,1672653814,1672656004,2190
3584,3734915241,3801645328,1672542650,1672544248,1598
3566,3909094917,3821054646,1672569307,1672569908,601
3540,3230868435,3520764926,1672607154,1672607466,312
3835,3500341755,3431502855,1672625564,1672626566,1002
3696,3757193307,3513545422,1672551235,1672554818,3583
3771,3488686442,3776831527,1672612695,1672615675,2980
3716,3511024016,3511317276,1672589973,1672590296,323
3563,3620292035,3893912331,1672643881,1672646109,2228
3909,3501786419,3713941638,1672695317,1672698720,3403
3775,3279339278,3773332082,1672638684,1672641585,2901
3427,3513296868,3236354255,1672703783,1672705757,1974
3657,3335694356,3779438325,1672589872,1672590429,557
3426,3711637255,3200543880,1672531862,1672535389,3527
3428,3505437712,3714067076,1672535323,1672536989,1666
3556,3783928182,3609881958,1672695035,1672695248,213
3507,3812369928,3977352557,1672676864,1672677960,1096
3539,3351866415,3510554314,1672680535,1672683476,2941
3686,3513327337,3319167958,1672587797,1672589351,1554
3500,3385323994,3783373154,1672640046,1672640852,806
3629,3714067076,3505179890,1672548147,1672549317,1170
3706,3604867757,3710735406,1672555302,1672557354,2052
3797,3621683102,3779786641,1672637893,1672638355,462
3456,3618489670,3852686295,1672620541,1672623607,3066
3877,3512882178,3624297844,1672675446,1672677369,1923
3772,3276217799,3514703118,1672653669,1672655556,1887
3724,3511791953,3364726656,1672570142,1672572168,2026
3536,3682133690,3360813161,1672671981,1672674282,2301
3803,3701136026,3500302272,1672583580,1672585462,1882
3778,3812369928,3520322124,1672550781,1672551202,421
3876,3512392431,3334974375,1672640661,1672643193,2532
3626,3756385685,3757630221,1672582084,1672584608,2524
3457,3791106564,3792072681,1672577011,1672580345,3334
3735,3443357683,3554825448,1672550540,1672550602,62
3678,3516513251,3783433404,1672580362,1672583453,3091
3568,3905196766,3774243020,1672601692,1672603163,1471
3583,3625174002,3639050419,1672606682,1672609250,2568
3655,3380767040,3519028898,1672537886,1672541429,3543
3791,3299443125,3615939504,1672533948,1672535107,1159
3880,3770624662,3779738691,1672621105,1672623186,2081
3673,3396980894,3701373490,1672688758,1672691300,2542
3815,3480991549,3774605761,1672674497,1672677858,3361
3910,3511024016,3236499444,1672599658,1672600540,882
3658,3280054198,3701136026,1672540373,1672540806,433
3904,3793740407,3447672935,1672581365,1672582211,846
3880,3779892400,3270697740,1672612864,1672616396,3532
3895,3783373154,3834960360,1672574844,1672576930,2086
3743,3755404116,3904867554,1672578795,1672581552,2757
3877,3792801638,3970198861,1672678848,1672681088,2240
3609,3505111292,3470454332,1672653795,1672655261,1466
3442,3236499444,3519142371,1672683783,1672684356,573
3901,3793883863,3773902805,1672591973,1672592133,160
3719,3280054198,3283492940,1672544124,1672545607,1483
3556,3501567772,3920625129,1672689839,1672692084,2245
3591,3400763927,3500347447,1672669976,1672671734,1758
3866,3398198430,3271454397,1672567371,1672569947,2576
3678,3520873221,3500841914,1672641942,1672642637,695
3739,3338390596,3436025562,1672552838,1672553688,850
3686,3902760230,3618808151,1672602255,1672603254,999
3548,3201800997,3446533960,1672648889,1672649323,434
3506,3970558632,3384068080,1672591271,1672591685,414
3635,3374183227,3793175445,1672693005,1672694050,1045
3639,3713517039,3500613493,1672607850,1672609572,1722
3574,3773735484,3455018347,1672699450,1672700383,933
3608,3367971170,3374183227,1672605827,1672606313,486
3682,3279473441,3512830734,1672638296,1672638502,206
3905,3711097754,3303410628,1672651003,1672652471,1468
3567,3755065949,3517697722,1672546373,1672547694,1321
3625,3414940786,3780872464,1672693111,1672696470,3359
3770,3316798920,3500737582,1672533510,1672535117,1607
3610,3760924079,3777694660,1672541716,1672543509,1793
3548,3714128600,3757193307,1672625423,1672628874,3451
3922,3303410628,3614740489,1672662143,1672664547,2404
3910,3902760230,3300818269,1672636774,1672638341,1567
3766,3510798825,3897134762,1672615358,1672616971,1613
3533,3715619259,3814305099,1672684628,1672685260,632
3898,3780571086,3380130228,1672675186,1672676056,870
3524,3779656423,3513410578,1672603750,1672606069,2319
3746,3440107959,3783136330,1672634267,1672636916,2649
3756,3773332082,3492546679,1672556547,1672560067,3520
3820,3615115210,3516513251,1672637887,1672641343,3456
3884,3780338697,3315703693,1672620249,1672621932,1683
3808,3970603231,3680843171,1672537771,1672540560,2789
3468,3773735484,3739911441,1672700998,1672701409,411
3771,3970627281,3613338363,1672578526,1672579600,1074
3766,3376467719,3383138270,1672634828,1672635345,517
3884,3510642075,3792801638,1672653345,1672654390,1045
3863,3711637255,3703383853,1672666941,1672668772,1831
3603,3760362417,3336627643,1672623760,1672626003,2243
3778,3448633776,3311498666,1672627913,1672629376,1463
3479,3491684096,3370227921,1672701664,1672702515,851
3917,3200308999,3618354185,1672690142,1672693499,3357
3462,3272716462,3893912331,1672647618,1672650921,3303
3631,3779438325,3713300120,1672691773,1672693875,2102
3850,3350095157,3501525100,1672585858,1672588659,2801
3644,3774907131,3779938251,1672643494,1672643605,111
3700,3778134418,3417191856,1672548346,1672548513,167
3433,3468041839,3615087943,1672545120,1672547716,2596
3679,3500613493,3510919821,1672674541,1672675463,922
3739,3802932312,3480991549,1672564264,1672566905,2641
3625,3360069849,3824641227,1672597951,1672598754,803
3713,3369708250,3501121099,1672678863,1672680797,1934
3617,3518229776,3519850727,1672560900,1672563116,2216
3540,3850911686,3319167958,1672695764,1672698013,2249
3531,3756704774,3240994288,1672611961,1672613133,1172
3475,3394401087,3431460073,1672693936,1672694011,75
3795,3899326793,3357289672,1672670457,1672672827,2370
3859,3517590837,3431460073,1672684032,1672686004,1972
3818,3774790271,3349856820,1672682766,1672683209,443
3890,3935913584,3402385957,1672686983,1672687196,213
3873,3200543880,3479851674,1672549606,1672549913,307
3788,3685816610,3774733620,1672653819,1672654360,541
3755,3710735406,3716679950,1672555264,1672557207,1943
3458,3760645796,3516903528,1672617112,1672620341,3229
3440,3283770991,3776988674,1672669649,1672672208,2559
3905,3783147088,3793315718,1672703940,1672704702,762
3445,3783919913,3515401243,1672686891,1672689212,2321
3526,3760651515,3310125159,1672691007,1672693243,2236
3551,3513545422,3272030610,1672683580,1672685294,1714
3534,3802932312,3938503547,1672653986,1672654964,978
3516,3428027649,3285204083,1672599606,1672600761,1155
3833,3415833929,3364726656,1672693968,1672694768,800
3691,3514275974,3351866415,1672671635,1672675173,3538
3576,3392943173,3777037426,1672561317,1672561955,638
3551,3900276517,3516298579,1672629112,1672629594,482
3498,3271454397,3815250107,1672665791,1672666667,876
3516,3791106564,3773572967,1672573095,1672574175,1080
3897,3610358027,3510919821,1672605160,1672605952,792
3661,3491684096,3777147510,1672608941,1672609642,701
3554,3311498666,3516321888,1672674600,1672676808,2208
3574,3514275974,3780872464,1672660947,1672661515,568
3660,3411688875,3394297564,1672582639,1672584350,1711
3692,3497808662,3715545685,1672592315,1672593848,1533
3425,3885155975,3238288884,1672616820,1672617553,733
3537,3713300120,3834631333,1672608709,1672610894,2185
3681,3711218296,3755496114,1672570965,1672572191,1226
3440,3500109249,3400069268,1672684283,1672686495,2212
3549,3517600136,3793922324,1672573065,1672576451,3386
3757,3612689556,3500525825,1672548212,1672549512,1300
3893,3812534508,3451691949,1672571373,1672573025,1652
3709,3452016771,3431460073,1672699926,1672701231,1305
3513,3938503547,3970198861,1672638903,1672641103,2200
3535,3284932450,3757323954,1672562020,1672562654,634
3643,3513410578,3783801141,1672675409,1672678204,2795
3525,3534126409,3770146716,1672567772,1672567892,120
3799,3514512367,3611055563,1672654383,1672657054,2671
3447,3309314379,3501384020,1672639607,1672642287,2680
3557,3475349791,3505179890,1672535887,1672538452,2565
3459,3451726367,3519087371,1672661356,1672664409,3053
3483,3505634634,3467988782,1672628744,1672631753,3009
3538,3780680950,3760640999,1672668227,1672668397,170
3686,3310125159,3793743698,1672621814,1672624350,2536
3823,3396980894,3412968120,1672564754,1672566496,1742
3772,3713589994,3534566651,1672697663,1672700136,2473
3780,3774155692,3512295534,1672556643,1672559554,2911
3600,3607768197,3783169442,1672661956,1672664634,2678
3775,3387594369,3518653080,1672647665,1672648364,699
3868,3713163045,3815392801,1672614548,1672616618,2070
3915,3755915206,3710854064,1672563422,1672566902,3480
3663,3713829743,3900945856,1672560029,1672561004,975
3581,3512882178,3783919913,1672691551,1672693968,2417
3911,3618808151,3890739241,1672651696,1672654591,2895
3547,3480991549,3774178201,1672602709,1672603351,642
3782,3367111751,3689114185,1672601787,1672604799,3012
3791,3713911104,3461119815,1672552329,1672554044,1715
3899,3688490530,3688490530,1672586572,1672589685,3113
3504,3701107228,3276217799,1672675605,1672678465,2860
3554,3481640525,3501121099,1672624747,1672625350,603
3562,3773124276,3200308999,1672626883,1672627042,159
3889,3733558985,3370068529,1672687716,1672688549,833
3467,3514512367,3417191856,1672592736,1672593490,754
3774,3517881647,3274906650,1672535284,1672538176,2892
3458,3839245934,3246370118,1672611860,1672614052,2192
3462,3510837901,3791128487,1672697932,1672698341,409
3575,3777184389,3760364383,1672533492,1672535773,2281
3893,3533188828,3333918941,1672674013,1672674669,656
3900,3715127070,3462273042,1672679936,1672682695,2759
3908,3452016771,3791436104,1672567961,1672570982,3021
3449,3488686442,3683113954,1672604616,1672605170,554
3904,3534175249,3668747074,1672622619,1672624523,1904
3491,3933894942,3686523546,1672608590,1672610194,1604
3831,3514971533,3554944414,1672642448,1672644451,2003
3510,3701247948,3713517039,1672597852,1672598724,872
3868,3500208903,3392943173,1672658928,1672660208,1280
3440,3783641602,3915162005,1672551076,1672554406,3330
3872,3774876004,3716679950,1672696576,1672698327,1751
3881,3519077659,3680810086,1672664896,1672665556,660
3538,3932478321,3491469603,1672614614,1672616246,1632
3656,3780115155,3760094385,1672672810,1672674414,1604
3572,3770146716,3669146016,1672579973,1672581047,1074
3532,3793868716,3757075324,1672588561,1672591934,3373
3704,3783928182,3755848152,1672553396,1672554931,1535
3911,3904412440,3701322924,1672594822,1672596094,1272
3877,3438489358,3514324011,1672613082,1672613743,661
3468,3500857494,3714666884,1672639134,1672641619,2485
3799,3825881598,3814305099,1672644369,1672646307,1938
3759,3500709774,3230868435,1672550844,1672553604,2760
3477,3779438325,3395201292,1672678672,1672680225,1553
3467,3823084403,3711218296,1672682403,1672685796,3393
3759,3715443333,3505634634,1672606435,1672607240,805
3593,3304155815,3802932312,1672627057,1672630201,3144
3506,3384068080,3399518841,1672583001,1672584521,1520
3912,3283770991,3512800570,1672543330,1672546163,2833
3913,3793583656,3285204083,1672638768,1672639631,863
3903,3487875183,3899786664,1672608436,1672611856,3420
3604,3514703118,3513327337,1672670476,1672672873,2397
3691,3457620713,3534566651,1672602194,1672603991,1797
3907,3410160376,3774718695,1672653467,1672655666,2199
3832,3714185969,3667673649,1672540144,1672542563,2419
3581,3885537225,3701136026,1672637211,1672640740,3529
3791,3783520186,3710048469,1672584455,1672587485,3030
3602,3783433404,3793935736,1672595803,1672597010,1207
3775,3777189898,3739911441,1672582618,1672584606,1988
3840,3774641380,3615939504,1672576748,1672579708,2960
3439,3380982774,3418448389,1672585627,1672585716,89
3545,3505228454,3979784676,1672645790,1672648928,3138
3450,3713979100,3713911104,1672559746,1672560868,1122
3887,3792546035,3783801141,1672551097,1672553725,2628
3855,3454277788,3205985903,1672590115,1672591642,1527
3493,3972083617,3904412440,1672563736,1672566405,2669
3511,3460719322,3512337405,1672607814,1672610630,2816
3508,3336339664,3393063657,1672700960,1672703310,2350
3767,3621683102,3380982774,1672682499,1672685283,2784
3584,3280268483,3414049538,1672535829,1672535962,133
3492,3793407963,3520657891,1672565860,1672566707,847
3564,3513327337,3347419520,1672622844,1672625444,2600
3431,3456430614,3510818674,1672688712,1672691157,2445
3478,3793781065,3472312341,1672603843,1672604957,1114
3718,3270056120,3736231757,1672659004,1672662504,3500
3812,3778667336,3755065949,1672634071,1672634300,229
3739,3900898992,3757700712,1672603426,1672603808,382
3733,3289114629,3311098437,1672550020,1672551493,1473
3452,3408498208,3900276517,1672682080,1672684941,2861
3722,3770438122,3364726656,1672565298,1672566287,989
3834,3351866415,3224330592,1672697475,1672699880,2405
3610,3393063657,3621461051,1672615024,1672616336,1312
3473,3511732493,3310125159,1672694390,1672697845,3455
3809,3462273042,3783169442,1672606446,1672607194,748
3900,3904569677,3306175858,1672558842,1672562224,3382
3611,3401940259,3469254160,1672691365,1672691427,62
3792,3296462324,3334993594,1672703710,1672705129,1419
3877,3337322736,3512383699,1672584555,1672586585,2030
3494,3791046864,3411515369,1672686954,1672687294,340
3685,3500703304,3823084403,1672599007,1672599479,472
3540,3893912331,3534357694,1672542472,1672544504,2032
3877,3393063657,3270042456,1672636462,1672639873,3411
3510,3501457103,3701136026,1672690828,1672694191,3363
3621,3300511067,3516741440,1672634161,1672637514,3353
3543,3714670620,3755848152,1672584919,1672588195,3276
3638,3513295938,3779786641,1672633352,1672635591,2239
3691,3930242012,3755404116,1672651255,1672652253,998
3456,3684523966,3731646673,1672611859,1672615426,3567
3621,3755915206,3436025562,1672682596,1672686168,3572
3701,3777184389,3756385685,1672553529,1672554501,972
3430,3773939399,3279475486,1672558414,1672559811,1397
3832,3451691949,3714120857,1672653638,1672656024,2386
3809,3818575661,3421877923,1672552763,1672555841,3078
3832,3609659642,3716110860,1672672458,1672675534,3076
3652,3710562338,3386758279,1672656514,1672658094,1580
3599,3505807416,3783147088,1672585295,1672586789,1494
3507,3400069268,3421877923,1672649870,1672652088,2218
3723,3248058676,3236354255,1672594550,1672597314,2764
3904,3271752081,3311420950,1672644330,1672645287,957
3564,3780571086,3716628503,1672624138,1672625947,1809
3630,3755065949,3519446663,1672674770,1672677589,2819
3455,3276217799,3515890966,1672689488,1672691258,1770
3667,3604589802,3779738691,1672679444,1672680484,1040
3741,3972192593,3920625129,1672658511,1672660619,2108
3606,3793781065,3780834916,1672596117,1672598499,2382
3804,3772236797,3792442597,1672579596,1672582237,2641
3653,3501121099,3793743698,1672613498,1672615739,2241
3426,3912891315,3780253901,1672624713,1672627871,3158
3633,3701107228,3774178201,1672594279,1672595140,861
3716,3512392431,3201800997,1672602332,1672602832,500
3535,3807212280,3715443333,1672664514,1672667995,3481
3488,3739661856,3501281016,1672695961,1672698432,2471
3829,3513018485,3930242012,1672556457,1672557888,1431
3655,3371455553,3461119815,1672607885,1672611461,3576
3882,3711077927,3783136330,1672583560,1672586618,3058
3437,3402385957,3225631197,1672687363,1672689698,2335
3739,3714233826,3610358027,1672691525,1672694384,2859
3571,3770468980,3760640999,1672629284,1672631151,1867
3477,3446533960,3755737419,1672552278,1672553899,1621
3683,3509893027,3283492940,1672665470,1672666860,1390
3838,3689114185,3716110860,1672639862,1672642701,2839
3467,3509483172,3977148669,1672626234,1672626492,258
3445,3505663516,3715443333,1672682879,1672685673,2794
3868,3288762795,3757075324,1672703454,1672704308,854
3562,3467779445,3774641380,1672567440,1672568983,1543
3703,3400069268,3408430195,1672537838,1672537957,119
3789,3812369928,3817428320,1672607101,1672609628,2527
3486,3512295534,3236458894,1672676737,1672677797,1060
3808,3792389522,3384583385,1672548191,1672549829,1638
3472,3491684096,3755915206,1672560674,1672560751,77
3841,3900276517,3935487534,1672562636,1672564461,1825
3611,3472312341,3623266256,1672562704,1672563605,901
3727,3363162590,3713561276,1672614569,1672616824,2255
3666,3618354185,3618808151,1672587592,1672590661,3069
3459,3534566651,3513853403,1672572050,1672572872,822
3658,3519651506,3438489358,1672577349,1672577612,263
3453,3380982774,3510767239,1672620571,1672622034,1463
3451,3515525630,3509756823,1672702042,1672702178,136
3835,3735374579,3714233826,1672632479,1672635955,3476
3560,3770468980,3276003502,1672697957,1672698908,951
3624,3501121099,3613899351,1672535794,1672537421,1627
3519,3336339664,3289114629,1672681669,1672682991,1322
3777,3609659642,3394297564,1672622713,1672626313,3600
3534,3280268483,3500525825,1672533170,1672535451,2281
3846,3479851674,3241790910,1672590872,1672592094,1222
3725,3414049538,3812369928,1672566137,1672568379,2242
3847,3205985903,3360069849,1672620651,1672622813,2162
3875,3436025562,3714067076,1672596886,1672600372,3486
3615,3688220326,3792538417,1672571993,1672573398,1405
3483,3793922324,3899786664,1672562935,1672563923,988
3809,3734118023,3777779869,1672585184,1672586865,1681
3766,3757383891,3520991398,1672594459,1672595532,1073
3842,3793407963,3551399764,1672608346,1672609706,1360
3654,3415833929,3435116799,1672600718,1672601878,1160
3731,3424660806,3518561777,1672638547,1672639000,453
3623,3534566651,3440137407,1672696075,1672698727,2652
3762,3490029863,3534175249,1672594251,1672597767,3516
3796,3500208903,3505198734,1672562783,1672566346,3563
3718,3609659642,3774155692,1672627033,1672628061,1028
3610,3514275974,3739911441,1672606987,1672608093,1106
3768,3776244398,3226178937,1672630459,1672630925,466
3669,3512282789,3777779869,1672552309,1672555619,3310
3845,3711637255,3779301501,1672637221,1672639848,2627
3515,3509366311,3618489670,1672600968,1672604278,3310
3594,3519651506,3514971533,1672618826,1672622091,3265
3429,3270697740,3904412440,1672702793,1672705806,3013
3881,3667427125,3755233658,1672609106,1672611542,2436
3784,3773121782,3230868435,1672561061,1672561696,635
3651,3417679834,3757630221,1672548498,1672551686,3188
3805,3710854064,3779656423,1672652147,1672655114,2967
3637,3757903168,3283492940,1672589138,1672590432,1294
3468,3488763230,3689114185,1672566985,1672569953,2968
3605,3513327337,3615087943,1672654460,1672656395,1935
3470,3499217428,3897456874,1672664990,1672668248,3258
3787,3519282716,3791796585,1672538989,1672541923,2934
3828,3509366311,3631090677,1672584869,1672588385,3516
3687,3514334067,3715400486,1672688535,1672691670,3135
3893,3554944414,3208957949,1672683352,1672685600,2248
3470,3459681410,3714067076,1672626423,1672629280,2857
3575,3343132529,3349856820,1672652495,1672653715,1220
3459,3534566651,3760694096,1672592482,1672594898,2416
3638,3492546679,3208452238,1672580704,1672582318,1614
3426,3774641380,3757193307,1672663899,1672665406,1507
3620,3714233826,3510028805,1672653236,1672654473,1237
3458,3938503547,3770520359,1672670638,1672672976,2338
3446,3284932450,3228888030,1672542351,1672545692,3341
3689,3470454332,3203538212,1672656649,1672658369,1720
3632,3885155975,3431460073,1672667530,1672669495,1965
3826,3609881958,3246370118,1672699396,1672701419,2023
3605,3308760650,3819767045,1672646605,1672646903,298
3912,3238288884,3225636215,1672624884,1672627388,2504
3590,3513545422,3505888598,1672535324,1672537162,1838
3905,3927599181,3615115210,1672589860,1672592045,2185
3556,3701884158,3711097754,1672678417,1672679897,1480
3784,3480991549,3505154885,1672651163,1672652126,963
3487,3513041785,3615113018,1672573279,1672575686,2407
3592,3624297844,3511601997,1672615188,1672617905,2717
3910,3311085279,3618176292,1672701680,1672703495,1815
3580,3774733620,3505807416,1672546878,1672548340,1462
3719,3501459390,3421385957,1672573087,1672573551,464
3810,3272030610,3205923620,1672548384,1672551893,3509
3881,3279242917,3615939504,1672621626,1672625010,3384
3625,3510642075,3374183227,1672586928,1672590484,3556
3491,3520322124,3513041785,1672580461,1672581771,1310
3685,3932478321,3608232640,1672613644,1672617200,3556
3666,3363162590,3755848152,1672618568,1672621153,2585
3791,3972192593,3779301501,1672626697,1672626921,224
3516,3415833929,3236458894,1672681283,1672684040,2757
3829,3607768197,3609659642,1672566771,1672568304,1533
3621,3280054198,3711812325,1672577055,1672578899,1844
3582,3351696332,3505521218,1672703472,1672704641,1169
3607,3835422146,3780322355,1672599253,1672601254,2001
3559,3455018347,3713300120,1672612478,1672612650,172
3547,3779892400,3807212280,1672693811,1672696590,2779
3740,3792274796,3439673892,1672568491,1672571690,3199
3619,3412968120,3296462324,1672564866,1672567904,3038
3459,3823084403,3293835352,1672567312,1672570544,3232
3500,3791246640,3411515369,1672550184,1672551013,829
3442,3334993594,3400069268,1672643127,1672645490,2363
3649,3608855425,3615939504,1672664779,1672667343,2564
3534,3625463628,3713517039,1672555946,1672559018,3072
3620,3510641433,3513295938,1672623829,1672625375,1546
3458,3500777439,3276003502,1672644918,1672645011,93
3674,3306175858,3384068080,1672635379,1672635561,182
3446,3509756823,3904569677,1672686866,1672688587,1721
3662,3200308999,3701322924,1672606927,1672607883,956
3459,3493017654,3928511283,1672659485,1672662834,3349
3647,3414049538,3520578796,1672624699,1672625977,1278
3866,3225029895,3270056120,1672685370,1672687889,2519
3565,3928719932,3510187271,1672682044,1672685292,3248
3878,3241914067,3505634634,1672533558,1672533838,280
3551,3293835352,3220031931,1672622952,1672625954,3002
3455,3792489602,3501459390,1672641274,1672644661,3387
3583,3730071479,3438078818,1672625355,1672625669,314
3688,3714067076,3559731671,1672650007,1672653016,3009
3635,3711218296,3909094917,1672633237,1672636147,2910
3783,3350095157,3514512367,1672609050,1672610850,1800
3752,3701005527,3817428320,1672624409,1672624891,482
3713,3533188828,3793583656,1672581393,1672582006,613
3899,3739895284,3516703758,1672686860,1672688695,1835
3896,3923754072,3517172354,1672566593,1672569647,3054
3647,3399472693,3933894942,1672665478,1672667372,1894
3812,3780472203,3449333754,1672558649,1672559554,905
3476,3385323994,3613416045,1672691781,1672693248,1467
3643,3347419520,3627368399,1672565163,1672568420,3257
3783,3615688740,3618354185,1672694555,1672696085,1530
3512,3839245934,3884596900,1672615276,1672616636,1360
3493,3463849738,3360069849,1672570386,1672571855,1469
3672,3807212280,3757383891,1672581051,1672582721,1670
3677,3533228966,3514334067,1672548254,1672550108,1854
3550,3519446663,3904569677,1672621286,1672623595,2309
3511,3380982774,3803389195,1672620628,1672620854,226
3469,3714678331,3551399764,1672589161,1672590244,1083
3757,3793743698,3510641433,1672566414,1672569033,2619
3614,3783641602,3400763927,1672606094,1672607367,1273
3801,3500949309,3520657891,1672628141,1672630836,2695
3556,3411515369,3703396825,1672701213,1672704456,3243
3890,3615113018,3737972328,1672637814,1672639131,1317
3893,3897134762,3615737355,1672549285,1672551862,2577
3853,3520560590,3276003502,1672687014,1672687215,201
3552,3505178849,3511317276,1672557113,1672558487,1374
3635,3935399379,3739895284,1672542284,1672543056,772
3559,3773009828,3505228454,1672594966,1672597230,2264
3500,3778134418,3756746867,1672543962,1672544455,493
3731,3773837847,3884596900,1672576123,1672579283,3160
3486,3512392431,3392836218,1672665663,1672666411,748
3593,3335694356,3614740489,1672659075,1672660060,985
3493,3480991549,3774733620,1672578394,1672581364,2970
3475,3897134762,3436257398,1672592055,1672592121,66
3430,3791753345,3887243870,1672594600,1672596190,1590
3536,3736231757,3736231757,1672671853,1672673478,1625
3585,3514703118,3533079336,1672631794,1672635188,3394
3463,3668533536,3511024016,1672654178,1672657608,3430
3728,3533423872,3236499444,1672583881,1672584691,810
3555,3517737088,3778134418,1672671009,1672672536,1527
3483,3632814465,3701107228,1672561006,1672562280,1274
3609,3780769110,3783641602,1672567202,1672568341,1139
3811,3380982774,3517881647,1672690240,1672690602,362
3430,3500347447,3510837901,1672601137,1672601931,794
3424,3270697740,3930242012,1672662907,1672663153,246
3831,3780834916,3792389522,1672696343,1672698027,1684
3731,3311098437,3387594369,1672630475,1672631866,1391
3895,3904412440,3201800997,1672540616,1672544011,3395
3510,3774733620,3414275042,1672664773,1672665706,933
3760,3617304541,3370227921,1672594981,1672596985,2004
3808,3626499450,3905196766,1672678083,1672680214,2131
3430,3226024417,3276003502,1672671901,1672672129,228
3556,3774705415,3514703118,1672552550,1672553535,985
3680,3632814465,3554186380,1672627975,1672629425,1450
3670,3559458968,3812369928,1672623471,1672624273,802
3790,3777184389,3402385957,1672596506,1672599039,2533
3494,3777330107,3614740489,1672565188,1672565716,528
3579,3245232284,3713979100,1672668410,1672671178,2768
3741,3609933747,3276348699,1672590819,1672590897,78
3478,3777184389,3350095157,1672612995,1672615979,2984
3490,3514324011,3515890966,1672647141,1672648684,1543
3587,3774243020,3300979975,1672627995,1672631050,3055
3825,3316798920,3200308999,1672605255,1672608500,3245
3730,3703383853,3793743698,1672576854,1672579768,2914
3747,3617489344,3760842815,1672659809,1672661598,1789
3795,3739895284,3836241528,1672645378,1672647417,2039
3714,3497808662,3516513251,1672588384,1672590373,1989
3762,3829822608,3923420131,1672591889,1672594681,2792
3454,3500737582,3927403123,1672681564,1672681846,282
3851,3510767239,3408498208,1672649631,1672650502,871
3876,3780472203,3454277788,1672625488,1672627723,2235
3473,3622357348,3404025196,1672575743,1672576902,1159
3665,3755532873,3533274994,1672561596,1672563319,1723
3707,3517288083,3772078494,1672669303,1672671583,2280
3444,3451326054,3374183227,1672655400,1672656568,1168
3556,3760721303,3755848152,1672538929,1672540939,2010
3488,3710735406,3613338363,1672658700,1672660764,2064
3525,3500915908,3341893384,1672668104,1672670328,2224
3611,3357289672,3836241528,1672582200,1672585203,3003
3474,3412006598,3923220461,1672600557,1672603135,2578
3778,3410160376,3777779869,1672653064,1672653530,466
3738,3607768197,3394401087,1672676925,1672678851,1926
3877,3500208903,3500709774,1672617458,1672620054,2596
3464,3533274994,3512379024,1672594666,1672596039,1373
3509,3519651506,3755532873,1672533122,1672535846,2724
3503,3510641433,3481640525,1672649134,1672650192,1058
3618,3374183227,3885121158,1672574165,1672576399,2234
3657,3385323994,3401496246,1672533148,1672536141,2993
3913,3417191856,3334993594,1672641025,1672642564,1539
3439,3513295938,3492546679,1672645949,1672646559,610
3426,3793407963,3935399379,1672627484,1672629202,1718
3583,3757323954,3421877923,1672590807,1672592857,2050
3836,3366423342,3703798634,1672531345,1672534212,2867
3795,3205923620,3778667336,1672569843,1672571938,2095
3897,3516703758,3760362417,1672663535,1672666451,2916
3648,3713979100,3713517039,1672697672,1672698350,678
3494,3300979975,3818575661,1672577227,1672578193,966
3505,3977352557,3248058676,1672686226,1672688278,2052
3907,3636329663,3793740407,1672605578,1672607872,2294
3592,3371455553,3500949309,1672600334,1672603102,2768
3464,3276348699,3220031931,1672621949,1672623027,1078
3826,3685816610,3208957949,1672703765,1672704290,525
3908,3683113954,3517590837,1672594176,1672596361,2185
3804,3760364383,3513853403,1672594750,1672597820,3070
3561,3624297844,3520115090,1672589434,1672590287,853
3804,3363162590,3201800997,1672622612,1672623288,676
3860,3201800997,3714678331,1672644175,1672645219,1044
3762,3279475486,3513296868,1672685052,1672685486,434
3465,3792014516,3438078818,1672555451,1672556411,960
3670,3495911207,3636329663,1672700337,1672700861,524
3579,3519282716,3638660068,1672661316,1672662697,1381
3587,3979802715,3552824113,1672627730,1672631032,3302
3750,3367111751,3935913584,1672672521,1672673357,836
3693,3621790707,3755158925,1672646552,1672649427,2875
3696,3451726367,3611055563,1672548856,1672550626,1770
3480,3914691363,3783615982,1672553522,1672553730,208
3425,3614740489,3490029863,1672595415,1672595512,97
3442,3513360004,3492546679,1672692111,1672693291,1180
3776,3533929349,3505437712,1672625899,1672626071,172
3758,3274831810,3779532653,1672543435,1672546550,3115
3756,3514334067,3392943173,1672540011,1672542120,2109
3705,3500604680,3412006598,1672572363,1672572743,380
3569,3791436104,3505807416,1672561972,1672564866,2894
3919,3928511283,3755404116,1672625972,1672627659,1687
3568,3608922867,3739895284,1672541746,1672544082,2336
3906,3791693821,3783641602,1672677060,1672679973,2913
3695,3505111292,3791246640,1672637460,1672638415,955
3511,3510499038,3500915665,1672606932,1672608519,1587
3794,3778597171,3354144091,1672590533,1672593905,3372
3591,3773121782,3360616538,1672650890,1672651247,357
3528,3379143440,3757863420,1672573354,1672573946,592
3429,3488686442,3703348097,1672639639,1672640140,501
3789,3236354255,3852686295,1672533199,1672533359,160
3677,3410160376,3607768197,1672554272,1672555572,1300
3477,3424660806,3481640525,1672673738,1672675090,1352
3911,3777147510,3701322924,1672684109,1672686954,2845
3568,3510837901,3755915206,1672555137,1672558708,3571
3864,3710048469,3892304880,1672698977,1672699897,920
3743,3517358573,3360069849,1672689920,1672691074,1154
3446,3774290799,3774605761,1672636347,1672638977,2630
3509,3617116290,3608922867,1672669745,1672671594,1849
3888,3475349791,3272716462,1672698363,1672699892,1529
3558,3505663516,3447514821,1672562832,1672564028,1196
3514,3920625129,3755915206,1672538813,1672541332,2519
3887,3511791953,3510642075,1672696989,1672699672,2683
3911,3208957949,3714678331,1672541496,1672542489,993
3597,3396726504,3416987084,1672585683,1672588927,3244
3605,3404025196,3201800997,1672630776,1672634038,3262
3753,3792014516,3399518841,1672698886,1672700409,1523
3844,3770468980,3779532653,1672691881,1672693335,1454
3675,3500044458,3730071479,1672642335,1672644472,2137
3720,3613899351,3618354185,1672655641,1672656334,693
3628,3711812325,3618808151,1672664919,1672667693,2774
3807,3463849738,3779301501,1672668987,1672671155,2168
3684,3631090677,3783169442,1672602306,1672604069,1763
3799,3714678331,3451326054,1672645390,1672646456,1066
3652,3514703118,3613416045,1672562185,1672564085,1900
3669,3272030610,3756746867,1672701486,1672704780,3294
3632,3334993594,3505198734,1672589173,1672592446,3273
3468,3311498666,3711919537,1672632368,1672635457,3089
3690,3336627643,3232208416,1672688346,1672690402,2056
3429,3713768950,3859868849,1672578042,1672580961,2919
3542,3780322355,3899326793,1672643729,1672646594,2865
3836,3384583385,3410538749,1672685072,1672686422,1350
3555,3755848152,3451726367,1672686166,1672687345,1179
3614,3774705415,3730071479,1672539461,1672540255,794
3872,3736231757,3738026330,1672631893,1672632333,440
3876,3271454397,3500525825,1672561636,1672562889,1253
3800,3714827719,3441348818,1672568720,1672569254,534
3635,3439673892,3304971369,1672659084,1672662521,3437
3646,3520764926,3514334067,1672620418,1672622190,1772
3552,3613416045,3510028805,1672662326,1672663115,789
3613,3403370192,3604589802,1672619334,1672621102,1768
3528,3520560590,3300511067,1672664537,1672665213,676
3780,3517222913,3774907131,1672594759,1672595204,445
3885,3512830734,3618489670,1672612538,1672613272,734
3675,3492546679,3792489602,1672549666,1672553058,3392
3891,3760645796,3312998540,1672688880,1672691917,3037
3920,3280268483,3779646172,1672608413,1672608708,295
3571,3409114719,3685816610,1672663986,1672666005,2019
3472,3440107959,3401496246,1672553214,1672555522,2308
3718,3315703693,3777037426,1672703451,1672703533,82
3776,3533294425,3900945856,1672683847,1672686257,2410
3731,3435167810,3923420131,1672560519,1672561488,969
3494,3897134762,3513853403,1672593533,1672593734,201
3436,3336339664,3389634034,1672534817,1672537140,2323
3521,3757903168,3309314379,1672634244,1672636655,2411
3915,3638660068,3513545422,1672660091,1672662989,2898
3815,3791613604,3284932450,1672569708,1672573291,3583
3689,3760651515,3834960360,1672562154,1672565296,3142
3587,3533090502,3774243020,1672618132,1672621451,3319
3659,3885155975,3371455553,1672615025,1672615489,464
3734,3392836218,3631090677,1672641245,1672643011,1766
3463,3510499038,3711006062,1672627180,1672628495,1315
3703,3757332128,3609933747,1672540048,1672543607,3559
3685,3755992176,3893912331,1672606275,1672609031,2756
3575,3459681410,3403370192,1672669635,1672671133,1498
3438,3688796737,3500841914,1672545408,1672547999,2591
3728,3270697740,3773913680,1672614543,1672614805,262
3664,3622357348,3447514821,1672628279,1672630787,2508
3655,3713163045,3757383891,1672580273,1672582253,1980
3844,3230135532,3779938251,1672599508,1672601687,2179
3913,3780571086,3615939504,1672636275,1672638717,2442
3516,3438078818,3739154408,1672654044,1672655234,1190
3654,3773913680,3757332128,1672624714,1672627079,2365
3687,3519416013,3510642075,1672594020,1672595270,1250
3763,3205985903,3715986185,1672693682,1672697047,3365
3533,3517462308,3515890966,1672564597,1672567826,3229
3633,3401793306,3514956366,1672609070,1672612094,3024
3837,3701322924,3360616538,1672622798,1672626011,3213
3756,3773913680,3417679834,1672681064,1672681308,244
3560,3800257590,3460719322,1672634480,1672637889,3409
3660,3686227677,3500302272,1672550169,1672550498,329
3717,3885121158,3620292035,1672596295,1672596790,495
3903,3451691949,3715974659,1672564355,1672565597,1242
3876,3895285664,3714233826,1672616673,1672618187,1514
3745,3755573472,3533929349,1672639845,1672641630,1785
3572,3402385957,3703433819,1672658651,1672661523,2872
3628,3618489670,3834960360,1672639099,1672640182,1083
3587,3780427126,3715400486,1672582236,1672583880,1644
3886,3533929349,3394297564,1672597640,1672598259,619
3829,3289817992,3855583256,1672552953,1672555393,2440
3469,3713829743,3783550022,1672655895,1672657770,1875
3436,3685816610,3487875183,1672555130,1672557500,2370
3692,3760040019,3793407963,1672665876,1672667687,1811
3834,3755344363,3410600350,1672560245,1672560320,75
3595,3780712350,3715619259,1672628972,1672632104,3132
3525,3401940259,3309314379,1672629964,1672630257,293
3688,3516321888,3923754072,1672662787,1672666078,3291
3835,3472068734,3850911686,1672569503,1672570270,767
3645,3517887477,3533079336,1672572093,1672573209,1116
3558,3440137407,3739154408,1672700674,1672703856,3182
3758,3383138270,3618354185,1672569788,1672573069,3281
3887,3534357694,3386758279,1672598779,1672600338,1559
3618,3839245934,3760094385,1672576605,1672576772,167
3565,3617116290,3480991549,1672637857,1672640242,2385
3476,3880926355,3610358027,1672569401,1672569518,117
3862,3373089838,3779938251,1672698585,1672699208,623
3445,3783169442,3780834916,1672675585,1672677189,1604
3742,3276348699,3412006598,1672632999,1672633564,565
3605,3713941638,3518194482,1672583393,1672584024,631
3868,3630353876,3714827719,1672571754,1672575122,3368
3847,3520578796,3737112297,1672628067,1672629846,1779
3885,3241914067,3556969573,1672679623,1672681944,2321
3782,3512958459,3631479562,1672675537,1672676989,1452
3644,3791753345,3928511283,1672611895,1672614747,2852
3570,3667427125,3779738691,1672593058,1672596477,3419
3596,3229974066,3639050419,1672540706,1672542674,1968
3712,3716963089,3519651506,1672610591,1672613731,3140
3920,3779656423,3610358027,1672565677,1672567869,2192
3591,3552824113,3770704999,1672589217,1672589396,179
3868,3385323994,3688220326,1672662708,1672665809,3101
3508,3710008361,3467779445,1672642518,1672645217,2699
3517,3554186380,3274906650,1672585859,1672588008,2149
3655,3516513251,3792745809,1672635927,1672638269,2342
3455,3310039260,3711734586,1672567316,1672570271,2955
3664,3415833929,3369708250,1672673812,1672676674,2862
3722,3893912331,3274831810,1672629430,1672631723,2293
3595,3774243020,3272096759,1672636348,1672639093,2745
3615,3793407963,3514275974,1672685220,1672687936,2716
3500,3632814465,3823084403,1672608085,1672611615,3530
3907,3778667336,3511024016,1672600461,1672601917,1456
3717,3815392801,3500737582,1672689830,1672691547,1717
3906,3755233658,3485540729,1672569942,1672571698,1756
3539,3853629553,3533228966,1672681783,1672683257,1474
3822,3500341755,3716110860,1672599283,1672602800,3517
3708,3429943738,3333918941,1672595163,1672597779,2616
3823,3438078818,3309314379,1672642719,1672645282,2563
3697,3515525630,3639050419,1672642169,1672642401,232
3895,3316798920,3495911207,1672661836,1672661980,144
3457,3454277788,3885121158,1672682467,1672683939,1472
3568,3551376095,3357289672,1672666743,1672667911,1168
3843,3897376951,3510187271,1672699340,1672700926,1586
3905,3774641380,3855583256,1672533747,1672534786,1039
3858,3514246749,3856606678,1672663588,1672667094,3506
3446,3416987084,3916490839,1672697380,1672698868,1488
3518,3812369928,3970558632,1672661609,1672662829,1220
3919,3776831527,3756625818,1672658436,1672660177,1741
3721,3613338363,3780769110,1672591582,1672594619,3037
3710,3610870949,3554186380,1672581057,1672582960,1903
3575,3533423872,3435116799,1672543542,1672545718,2176
3453,3622357348,3279242917,1672610262,1672610336,74
3590,3201800997,3793868716,1672632950,1672634763,1813
3910,3773572967,3398198430,1672689254,1672689334,80
3641,3783433404,3778667336,1672625710,1672626108,398
3907,3779613523,3714120857,1672664589,1672668034,3445
3482,3609881958,3777189898,1672690638,1672692509,1871
3830,3371455553,3703348097,1672556192,1672557204,1012
3516,3360616538,3778040015,1672595255,1672598746,3491
3769,3756127300,3533929349,1672536080,1672538900,2820
3762,3760694096,3776244398,1672662135,1672663648,1513
3676,3505111292,3512499658,1672627653,1672630103,2450
3796,3791106564,3421385957,1672571613,1672571719,106
3810,3343816795,3440137407,1672652244,1672652780,536
3601,3618697021,3760640999,1672610295,1672613449,3154
3751,3311420950,3773027597,1672568205,1672568452,247
3769,3661447322,3609933747,1672537465,1672538639,1174
3826,3660887799,3680810086,1672599801,1672603023,3222
3698,3792949946,3509764635,1672575979,1672576552,573
3445,3412968120,3772765746,1672642952,1672645795,2843
3763,3534829213,3780571086,1672554458,1672557549,3091
3608,3783169442,3625463628,1672692912,1672693131,219
3474,3229822507,3906536154,1672593919,1672595643,1724
3832,3777189898,3500737582,1672538800,1672539738,938
3472,3624297844,3773913680,1672596656,1672598603,1947
3685,3362641275,3834960360,1672680900,1672682771,1871
3687,3615115210,3902625986,1672660074,1672660405,331
3641,3920898925,3288224595,1672624715,1672625065,350
3882,3445206685,3305336154,1672655668,1672658463,2795
3577,3701005527,3703383853,1672595142,1672595363,221
3889,3226024417,3514285803,1672691574,1672693053,1479
3689,3779465522,3792014516,1672539379,1672540856,1477
3466,3533747868,3665998641,1672687392,1672689359,1967
3605,3241790910,3519850727,1672690963,1672693539,2576
3912,3906536154,3817813340,1672641296,1672642602,1306
3774,3515890966,3514308235,1672648769,1672652040,3271
3629,3617304541,3341893384,1672686378,1672687081,703
3774,3779738691,3500777439,1672544964,1672547160,2196
3500,3501459390,3714666884,1672691383,1672692054,671
3601,3714233826,3511150845,1672541369,1672542267,898
3663,3515466096,3517687662,1672627422,1672629860,2438
3811,3780338697,3885537225,1672690883,1672694383,3500
3649,3450286949,3737972328,1672554691,1672555750,1059
3549,3715385401,3411688875,1672657167,1672660340,3173
3703,3701136026,3274906650,1672599174,1672602651,3477
3547,3824641227,3703348097,1672589153,1672591757,2604
3732,3500915665,3610870949,1672661280,1672662293,1013
3622,3304971369,3514275974,1672701503,1672704760,3257
3426,3737112297,3853629553,1672637097,1672638594,1497
3621,3501281016,3668747074,1672646448,1672648781,2333
3594,3779438325,3554944414,1672569984,1672570552,568
3909,3416987084,3505847380,1672574800,1672578315,3515
3585,3779425804,3714678331,1672537382,1672538592,1210
3502,3972083617,3615115210,1672699183,1672701440,2257
3586,3230135532,3373089838,1672565865,1672566384,519
3473,3390660440,3513081354,1672668722,1672671655,2933
3848,3607882826,3779639983,1672551595,1672554847,3252
3598,3309314379,3710735406,1672687030,1672690301,3271
3498,3516513251,3774733620,1672625242,1672625564,322
3484,3533649454,3803389195,1672639679,1672639834,155
3512,3300979975,3294703680,1672615695,1672615855,160
3789,3778040015,3923420131,1672703691,1672706111,2420
3473,3757193307,3774243020,1672683328,1672684103,775
3430,3685816610,3779532653,1672624493,1672625438,945
3731,3932478321,3443357683,1672559639,1672561781,2142
3685,3245232284,3711919537,1672665031,1672665502,471
3465,3895285664,3467988782,1672663353,1672665110,1757
3679,3505283390,3900898992,1672587873,1672589429,1556
3527,3311085279,3236458894,1672643877,1672646808,2931
3915,3783373154,3610870949,1672680767,1672683979,3212
3898,3608232640,3347446226,1672571669,1672573056,1387
3539,3774733620,3620292035,1672657559,1672660574,3015
3565,3773735484,3928511283,1672643417,1672645598,2181
3579,3615688740,3501457103,1672532259,1672533192,933
3900,3615939504,3516321888,1672535435,1672537270,1835
3629,3737147209,3757193551,1672532621,1672533185,564
3795,3793315718,3343132529,1672575118,1672576194,1076
3706,3533929349,3450969839,1672651025,1672653380,2355
3638,3315279093,3755573472,1672610550,1672610806,256
3576,3509756823,3635169815,1672685926,1672687995,2069
3831,3481640525,3370068529,1672588677,1672590184,1507
3433,3337322736,3500317969,1672626314,1672627508,1194
3919,3668747074,3518194482,1672702057,1672705545,3488
3914,3520578796,3513295938,1672658300,1672660101,1801
3828,3557046880,3500208903,1672615791,1672617892,2101
3730,3902760230,3780472203,1672542839,1672546238,3399
3853,3333918941,3757863420,1672600856,1672601873,1017
3490,3205985903,3481640525,1672627288,1672629054,1766
3539,3780322355,3500525825,1672663656,1672666622,2966
3908,3519909393,3895285664,1672651337,1672653511,2174
3838,3711006062,3238288884,1672564284,1672566727,2443
3904,3513295938,3683113954,1672612645,1672614774,2129
3598,3421877923,3349856820,1672598112,1672599301,1189
3441,3395201292,3852533643,1672582137,1672582625,488
3546,3608855425,3970627281,1672586969,1672590022,3053
3643,3414940786,3760362417,1672675917,1672676257,340
3533,3900898992,3688220326,1672623892,1672627293,3401
3891,3713561276,3779465522,1672570788,1672571877,1089
3642,3780338697,3500857494,1672641471,1672642139,668
3574,3774178201,3409114719,1672564735,1672568034,3299
3732,3780338697,3783641602,1672556507,1672557116,609
3471,3734451191,3756474459,1672664274,1672664439,165
3456,3791128487,3485540729,1672568102,1672569056,954
3781,3713768950,3803517637,1672619771,1672620559,788
3881,3686523546,3755992176,1672586923,1672589824,2901
3622,3618354185,3512282789,1672545246,1672547892,2646
3726,3270697740,3283144118,1672553798,1672556597,2799
3631,3773033649,3793175445,1672557777,1672559726,1949
3773,3505807416,3779892400,1672565060,1672566587,1527
3845,3731646673,3778134418,1672633813,1672637193,3380
3767,3428725843,3431460073,1672671808,1672674227,2419
3566,3299443125,3514818819,1672585551,1672588383,2832
3739,3364726656,3812534508,1672604456,1672605033,577
3770,3736231757,3501457103,1672620064,1672623429,3365
3636,3979802715,3780253901,1672627466,1672630693,3227
3818,3517358573,3714678331,1672642368,1672644933,2565
3478,3660887799,3701005527,1672601877,1672602434,557
3575,3514956366,3371455553,1672540208,1672543317,3109
3437,3480490124,3500498112,1672651947,1672654912,2965
3684,3236354255,3512502036,1672596186,1672599425,3239
3636,3777330107,3905899155,1672555259,1672558603,3344
3776,3777779869,3554186380,1672612895,1672614837,1942
3711,3631479562,3792014516,1672555924,1672557744,1820
3684,3791753345,3613338363,1672668428,1672668521,93
3841,3505634634,3777694660,1672687947,1672690021,2074
3708,3200308999,3801645328,1672702212,1672704345,2133
3791,3807212280,3803389195,1672664486,1672664765,279
3654,3333918941,3736705719,1672575160,1672575629,469
3543,3513018485,3815250107,1672623888,1672627339,3451
3920,3609113156,3412006598,1672566651,1672567289,638
3702,3757348722,3520322124,1672653809,1672654126,317
3742,3225029895,3517991730,1672592023,1672593082,1059
3725,3756474459,3272716462,1672672799,1672675289,2490
3646,3609659642,3505888598,1672671422,1672671898,476
3690,3371455553,3755404116,1672649088,1672652616,3528
3448,3756474459,3520764926,1672643701,1672645781,2080
3663,3520560590,3271454397,1672571674,1672572652,978
3698,3618176292,3224968597,1672606559,1672607728,1169
3866,3793418209,3533274994,1672601469,1672602488,1019
3803,3979802715,3783641602,1672576384,1672579350,2966
3847,3770296583,3778640261,1672533451,1672534538,1087
3750,3778667336,3935399379,1672633345,1672636620,3275
3532,3480726047,3757318448,1672629018,1672630883,1865
3826,3783550022,3977352557,1672612706,1672613041,335
3891,3716272919,3511024016,1672628105,1672629765,1660
3559,3239617320,3279475486,1672573814,1672575358,1544
3837,3713911104,3776559988,1672609943,1672611816,1873
3902,3793922324,3513296868,1672546236,1672546362,126
3717,3231713082,3800257590,1672623974,1672624381,407
3507,3335694356,3779532653,1672581257,1672584234,2977
3549,3415833929,3516741440,1672545034,1672547725,2691
3541,3625463628,3774790271,1672605019,1672607420,2401
3499,3271752081,3757863420,1672560263,1672562308,2045
3823,3686523546,3609933747,1672570155,1672571705,1550
3471,3519850727,3492546679,1672628790,1672631353,2563
3604,3441348818,3448875382,1672636003,1672638077,2074
3904,3421877923,3319167958,1672568110,1672568191,81
3677,3895285664,3470454332,1672670453,1672672422,1969
3767,3711006062,3231713082,1672579056,1672581804,2748
3521,3615939504,3380130228,1672553098,1672555811,2713
3629,3515559913,3776244398,1672575782,1672579041,3259
3859,3776831527,3518194482,1672625365,1672627928,2563
3740,3533228966,3557046880,1672672924,1672675381,2457
3493,3347446226,3239617320,1672674628,1672676899,2271
3871,3303410628,3516321888,1672582498,1672583007,509
3805,3920625129,3905899155,1672643311,1672645372,2061
3736,3511883730,3715974659,1672542202,1672544827,2625
3566,3935913584,3510767239,1672654108,1672654303,195
3769,3283770991,3774705415,1672689643,1672691972,2329
3878,3517687662,3780472203,1672694939,1672697864,2925
3902,3209526819,3500613493,1672548096,1672548524,428
3830,3501215099,3451691949,1672631280,1672631514,234
3628,3511024016,3462158237,1672578784,1672581399,2615
3514,3475349791,3772236797,1672640942,1672643022,2080
3644,3451326054,3347419520,1672646148,1672649218,3070
3864,3478114114,3755496114,1672620821,1672622089,1268
3625,3938503547,3793740407,1672675266,1672677432,2166
3752,3205985903,3923220461,1672550116,1672550328,212
3621,3533294425,3505888598,1672693684,1672694729,1045
3635,3739661856,3520322124,1672662422,1672665878,3456
3614,3772078494,3310125159,1672601807,1672603171,1364
3796,3276003502,3791106564,1672702767,1672704377,1610
3896,3299781901,3505521218,1672606199,1672608469,2270
3761,3701823816,3760645796,1672654244,1672656496,2252
3892,3852686295,3783615982,1672669177,1672669812,635
3573,3384583385,3360813161,1672532715,1672533931,1216
3469,3497095254,3511024016,1672690084,1672691370,1286
3448,3509366311,3605221116,1672548393,1672550722,2329
3827,3501121099,3835985172,1672642210,1672644905,2695
3760,3856606678,3783340788,1672637919,1672641088,3169
3499,3319167958,3780253901,1672595013,1672595752,739
3679,3513065217,3480490124,1672597200,1672599298,2098
3593,3205923620,3411688875,1672699641,1672702196,2555
3798,3308760650,3715986185,1672678045,1672678387,342
3754,3279475486,3225631197,1672534975,1672536708,1733
3787,3517288083,3516321888,1672586018,1672587857,1839
3853,3757630221,3360813161,1672558894,1672560443,1549
3575,3617116290,3520639768,1672631137,1672633946,2809
3804,3979784676,3236458894,1672609415,1672612533,3118
3778,3316800320,3505178849,1672551789,1672555184,3395
3714,3793418209,3773902805,1672623955,1672625193,1238
3625,3225029895,3710315160,1672600754,1672601647,893
3779,3897435944,3517590837,1672650103,1672653090,2987
3476,3283492940,3824641227,1672655675,1672656920,1245
3617,3315703693,3935399379,1672554935,1672555617,682
3541,3519282716,3715443333,1672697576,1672697843,267
3855,3885121158,3520657891,1672647293,1672648688,1395
3890,3772078494,3505266860,1672619720,1672621246,1526
3748,3505663516,3306175858,1672695764,1672696706,942
3828,3513327337,3791046864,1672572970,1672574061,1091
3642,3770296583,3279473441,1672679420,1672681327,1907
3561,3770624662,3495911207,1672687653,1672688903,1250
3516,3757348722,3755756564,1672537496,1672539796,2300
3787,3487875183,3401793306,1672691947,1672694653,2706
3715,3621683102,3780209375,1672553664,1672554167,503
3903,3755158925,3755737419,1672643838,1672644000,162
3841,3431460073,3736231757,1672562678,1672565027,2349
3525,3774605761,3510642075,1672616236,1672616995,759
3691,3607882826,3515559913,1672639920,1672640732,812
3588,3226178937,3774641380,1672545839,1672548362,2523
3846,3777147510,3793407963,1672557338,1672560208,2870
3872,3777330107,3509756823,1672561182,1672563993,2811
3756,3338083680,3513327337,1672549302,1672550875,1573
3721,3519087371,3710496785,1672540645,1672541629,984
3585,3779465522,3435116799,1672676056,1672679475,3419
3789,3238288884,3773121782,1672677738,1672679157,1419
3812,3501786419,3534175249,1672619213,1672619619,406
3512,3774031303,3638204468,1672616360,1672619510,3150
3711,3637313265,3613899351,1672541348,1672544337,2989
3582,3715400486,3780338697,1672622921,1672623594,673
3850,3225029895,3777091903,1672639243,1672640721,1478
3743,3938389661,3680810086,1672650854,1672653699,2845
3828,3773124276,3760721303,1672677431,1672678816,1385
3551,3773124276,3715974659,1672676691,1672677526,835
3698,3902625986,3450969839,1672680038,1672681603,1565
3823,3311420950,3512282789,1672698551,1672699308,757
3898,3435116799,3513065217,1672589051,1672592581,3530
3494,3296462324,3714185969,1672550095,1672552681,2586
3749,3701247948,3791796585,1672597801,1672600824,3023
3922,3554825448,3770236215,1672533257,1672536502,3245
3893,3512800570,3934064792,1672591796,1672593470,1674
3556,3716628503,3631090677,1672671187,1672674149,2962
3674,3609881958,3511791953,1672548242,1672550023,1781
3807,3626499450,3774790271,1672627018,1672627478,460
3802,3460719322,3470454332,1672702943,1672705354,2411
3597,3779438325,3505634634,1672534935,1672537413,2478
3759,3357289672,3970627281,1672668806,1672670366,1560
3724,3626499450,3512295534,1672561382,1672563889,2507
3515,3280268483,3500498112,1672594424,1672596645,2221
3698,3511317276,3505434346,1672649148,1672652213,3065
3839,3220031931,3228888030,1672611504,1672613358,1854
3850,3450286949,3688220326,1672689045,1672692179,3134
3811,3777147510,3853629553,1672581048,1672582550,1502
3706,3770704999,3513295938,1672549447,1672552987,3540
3658,3368283077,3272096759,1672565467,1672565717,250
3764,3351866415,3713691388,1672628632,1672631387,2755
3845,3772078494,3829822608,1672649425,1672651788,2363
3875,3533274994,3935487534,1672564277,1672566388,2111
3770,3780769110,3512502036,1672582966,1672584411,1445
3542,3932478321,3778667336,1672650910,1672653689,2779
3761,3774641380,3509366311,1672549226,1672549927,701
3586,3770624662,3475349791,1672541573,1672544701,3128
3584,3228888030,3395201292,1672677407,1672678884,1477
3432,3713979100,3500498112,1672575090,1672576409,1319
3532,3401940259,3618354185,1672583651,1672585653,2002
3562,3284932450,3280054198,1672543080,1672543218,138
3913,3236499444,3274906650,1672673429,1672674018,589
3590,3710008361,3330340793,1672658765,1672662016,3251
3525,3778597171,3311049964,1672597601,1672599641,2040
3764,3778667336,3755737419,1672662589,1672663282,693
3673,3773332082,3392943173,1672697686,1672698757,1071
3696,3514275974,3779892400,1672669955,1672670160,205
3600,3414049538,3733363628,1672624924,1672625717,793
3766,3779438325,3415833929,1672677259,1672679455,2196
3603,3935487534,3241790910,1672584685,1672584862,177
3840,3244004456,3505228454,1672580970,1672581717,747
3695,3514285803,3288224595,1672679062,1672679968,906
3828,3436025562,3410600350,1672600179,1672600268,89
3626,3757193307,3680810086,1672678427,1672681950,3523
3712,3500915665,3513853403,1672594706,1672598298,3592
3460,3490029863,3447672935,1672588456,1672589674,1218
3699,3715974659,3853629553,1672573981,1672574433,452
3735,3510187271,3661583097,1672579226,1672580859,1633
3609,3604867757,3757903168,1672569575,1672570166,591
3755,3770146716,3793969543,1672576770,1672579588,2818
3817,3792389522,3511317276,1672658137,1672659601,1464
3595,3772078494,3515559913,1672607521,1672607672,151
3793,3621184108,3618489670,1672648455,1672649127,672
3829,3703396825,3394401087,1672678000,1672678834,834
3791,3773332082,3520181148,1672576527,1672579296,2769
3726,3617304541,3240394404,1672685974,1672689333,3359
3587,3715619259,3491469603,1672608004,1672609357,1353
3892,3791753345,3899786664,1672593363,1672595505,2142
3616,3680810086,3209526819,1672676479,1672678220,1741
3840,3520657891,3300229945,1672597524,1672598635,1111
3879,3777779869,3713941638,1672550136,1672550234,98
3705,3515525630,3703433819,1672548380,1672550668,2288
3674,3271752081,3370068529,1672630544,1672633468,2924
3576,3701823816,3533423872,1672534734,1672536271,1537
3832,3613206049,3792389522,1672601654,1672605063,3409
3503,3760721303,3608855425,1672543281,1672546289,3008
3736,3445206685,3341893384,1672685034,1672685869,835
3893,3450969839,3500709774,1672647654,1672650329,2675
3486,3228888030,3279473441,1672660747,1672663805,3058
3561,3534829213,3450286949,1672624824,1672626673,1849
3713,3780909839,3777091903,1672670124,1672672960,2836
3551,3739911441,3448633776,1672629174,1672631858,2684
3861,3608922867,3366423342,1672665693,1672666945,1252
3627,3905196766,3512337405,1672668616,1672672002,3386
3612,3803517637,3926643445,1672663768,1672664651,883
3793,3512383699,3364378127,1672701473,1672701871,398
3465,3730071479,3774290799,1672646784,1672648246,1462
3452,3500857494,3383138270,1672696295,1672696418,123
3907,3819767045,3777091903,1672669169,1672670728,1559
3869,3451691949,3852533643,1672592387,1672594678,2291
3603,3608855425,3511288998,1672552731,1672553295,564
3768,3777330107,3778134418,1672582024,1672582986,962
3605,3495911207,3335694356,1672567743,1672568313,570
3721,3604867757,3783433404,1672622952,1672625027,2075
3519,3463740710,3829864515,1672564715,1672566914,2199
3561,3703383853,3505521218,1672697179,1672699646,2467
3894,3926643445,3783163143,1672673246,1672675825,2579
3647,3520873221,3468041839,1672646739,1672647909,1170
3436,3783520186,3387594369,1672688794,1672689781,987
3505,3520873221,3711919537,1672538156,1672539290,1134
3752,3490029863,3613899351,1672544423,1672545540,1117
3799,3206837348,3497808662,1672641626,1672641705,79
3746,3224968597,3829864515,1672652488,1672652771,283
3806,3779613523,3435167810,1672579331,1672582105,2774
3802,3461119815,3514703118,1672662837,1672665746,2909
3833,3609933747,3206837348,1672628134,1672629160,1026
3861,3514308235,3513410578,1672672801,1672675008,2207
3687,3715443333,3711097754,1672658149,1672659975,1826
3721,3773124276,3454277788,1672649981,1672651391,1410
3821,3773837847,3714067076,1672690411,1672692425,2014
3774,3373028638,3490214516,1672560416,1672560828,412
3621,3780712350,3510818674,1672619465,1672621094,1629
3620,3449333754,3559731671,1672584546,1672585285,739
3609,3835422146,3779938251,1672566544,1672567421,877
3560,3688220326,3447672935,1672572598,1672575641,3043
3519,3792525861,3461119815,1672575701,1672577424,1723
3825,3792020993,3925979970,1672565257,1672565722,465
3695,3773033649,3608922867,1672589815,1672589920,105
3526,3520578796,3270056120,1672668443,1672670208,1765
3697,3367509761,3760924079,1672586829,1672588670,1841
3864,3431502855,3713829743,1672671626,1672674021,2395
3606,3777091903,3711006062,1672645661,1672648054,2393
3903,3201676087,3330340793,1672675554,1672678565,3011
3855,3510554314,3617116290,1672630028,1672630320,292
3714,3490214516,3455018347,1672578798,1672579641,843
3778,3779465522,3533004959,1672677660,1672679253,1593
3644,3421877923,3783550022,1672572460,1672573067,607
3793,3304155815,3469254160,1672641116,1672642097,981
3552,3230868435,3520416075,1672585142,1672587180,2038
3692,3440107959,3203538212,1672613361,1672614496,1135
3678,3298151889,3279475486,1672682954,1672685652,2698
3774,3774876004,3611055563,1672597055,1672597963,908
3531,3792801638,3500672156,1672596228,1672597340,1112
3671,3923420131,3399518841,1672574473,1672576813,2340
3597,3516444201,3367509761,1672583479,1672584686,1207
3710,3452016771,3515401243,1672576742,1672579832,3090
3538,3617392620,3519909393,1672701384,1672701792,408
3546,3770468980,3777184389,1672669732,1672671922,2190
3503,3505663516,3347419520,1672661240,1672664712,3472
3680,3757630221,3935487534,1672541012,1672542073,1061
3483,3500341755,3714666884,1672564805,1672564980,175
3501,3739661856,3360616538,1672550835,1672551178,343
3898,3770704999,3755222916,1672628536,1672630549,2013
3835,3970909253,3491469603,1672677088,1672680145,3057
3481,3777814504,3306175858,1672556235,1672556322,87
3750,3505923418,3500949309,1672560287,1672562326,2039
3832,3776559988,3456430614,1672640413,1672641626,1213
3770,3510642075,3271752081,1672575227,1672577703,2476
3738,3755158925,3501786419,1672648955,1672652453,3498
3425,3715400486,3467779445,1672549402,1672551016,1614
3536,3755532873,3505847380,1672595262,1672597052,1790
3719,3783919913,3756474459,1672542227,1672544406,2179
3427,3855583256,3776518452,1672622135,1672623914,1779
3752,3394401087,3551399764,1672659244,1672660420,1176
3837,3791441520,3480726047,1672611633,1672614650,3017
3737,3387594369,3755496114,1672570568,1672573591,3023
3711,3660063072,3710048469,1672607241,1672610296,3055
3751,3915162005,3895285664,1672676194,1672677532,1338
3900,3620292035,3715854030,1672568590,1672569712,1122
3541,3410600350,3831586487,1672628964,1672629237,273
3816,3289114629,3447514821,1672639999,1672643222,3223
3525,3368283077,3400069268,1672651483,1672652117,634
3784,3349739136,3686227677,1672662280,1672663920,1640
3852,3500347447,3510767239,1672696390,1672699101,2711
3502,3533274994,3703383853,1672668760,1672670901,2141
3865,3488686442,3902861231,1672551208,1672553984,2776
3881,3776244398,3773939399,1672624088,1672627194,3106
3648,3424445495,3533090502,1672578345,1672579196,851
3481,3305336154,3716110860,1672622509,1672623120,611
3812,3501525100,3824641227,1672659963,1672662647,2684
3648,3501215099,3619922891,1672568859,1672571357,2498
3836,3621683102,3852533643,1672541162,1672541635,473
3733,3280268483,3605221116,1672682797,1672683055,258
3533,3755532873,3534179433,1672539867,1672541807,1940
3791,3713589994,3970627281,1672650290,1672652395,2105
3746,3756625818,3304155815,1672561360,1672563151,1791
3632,3803389195,3501459390,1672622973,1672625324,2351
3567,3686523546,3906536154,1672543784,1672546745,2961
3473,3330340793,3825881598,1672634303,1672636739,2436
3681,3887243870,3703433819,1672622421,1672623985,1564
3817,3755158925,3685681577,1672568832,1672572247,3415
3769,3713589994,3289114629,1672642824,1672643720,896
3805,3972083617,3783928182,1672549056,1672549374,318
3803,3783919913,3617116290,1672675128,1672676124,996
3579,3200543880,3312998540,1672563480,1672563959,479
3658,3229974066,3774031303,1672655394,1672655961,567
3770,3774733620,3975717896,1672551678,1672553505,1827
3670,3491469603,3757383891,1672682540,1672684627,2087
3448,3412006598,3517737088,1672652386,1672654222,1836
3710,3836241528,3336339664,1672605102,1672608592,3490
3796,3414940786,3739895284,1672701077,1672702422,1345
3623,3450969839,3703396825,1672601851,1672604915,3064
3783,3774876004,3755404116,1672641742,1672642648,906
3810,3519651506,3688220326,1672669932,1672673446,3514
3710,3311098437,3296462324,1672659074,1672661876,2802
3666,3817813340,3492959689,1672626819,1672627744,925
3477,3518565331,3455018347,1672646896,1672647793,897
3757,3411515369,3777091903,1672618029,1672619674,1645
3833,3835422146,3347419520,1672641941,1672643942,2001
3597,3909094917,3897376951,1672698369,1672698673,304
3675,3760094385,3617304541,1672567656,1672568948,1292
3860,3716963089,3270056120,1672683581,1672686546,2965
3506,3734915241,3920898925,1672686067,1672688509,2442
3583,3711734586,3776988674,1672693070,1672696203,3133
3569,3534829213,3445206685,1672675631,1672677343,1712
3588,3376467719,3512946768,1672571299,1672573958,2659
3882,3273981374,3607882826,1672597794,1672600712,2918
3792,3467988782,3773902805,1672698323,1672700750,2427
3535,3469254160,3488686442,1672678578,1672678882,304
3896,3755233658,3713784974,1672666668,1672669001,2333
3896,3513345163,3517991730,1672640334,1672641276,942
3889,3783147088,3421385957,1672536907,1672539128,2221
3424,3713691388,3534179433,1672647827,1672649340,1513
3716,3608922867,3792505974,1672703396,1672706884,3488
3600,3519142371,3733558985,1672647579,1672649049,1470
3630,3513296868,3401496246,1672697616,1672700585,2969
3729,3505179890,3511005395,1672577801,1672580814,3013
3913,3505283390,3400763927,1672628882,1672630023,1141
3620,3757294769,3451726367,1672573323,1672574859,1536
3460,3836241528,3635169815,1672537077,1672538256,1179
3544,3360813161,3515525630,1672654684,1672655536,852
3751,3760640999,3755532873,1672654007,1672656211,2204
3895,3637313265,3467779445,1672627682,1672631268,3586
3454,3665998641,3514971533,1672647514,1672649152,1638
3537,3757193307,3793740407,1672578650,1672580549,1899
3752,3780712350,3774178201,1672642373,1672645821,3448
3717,3791246640,3791106564,1672576108,1672577609,1501
3717,3518194482,3899326793,1672545687,1672547376,1689
3450,3834631333,3554944414,1672614684,1672615970,1286
3866,3793868716,3711637255,1672531653,1672533560,1907
3571,3500109249,3668414677,1672636585,1672637144,559
3635,3626499450,3551389192,1672577142,1672578131,989
3809,3757318448,3409114719,1672679269,1672681014,1745
3476,3821054646,3938389661,1672661569,1672664331,2762
3906,3755992176,3410538749,1672574773,1672578183,3410
3664,3737147209,3470454332,1672597266,1672599001,1735
3607,3783928182,3533368789,1672585311,1672586346,1035
3820,3424445495,3505179890,1672661563,1672662098,535
3614,3501457103,3701882224,1672544698,1672547809,3111
3895,3384583385,3791246640,1672574019,1672577480,3461
3810,3500949309,3441348818,1672593307,1672594145,838
3740,3773121782,3220031931,1672658115,1672661256,3141
3581,3390660440,3884596900,1672592096,1672595665,3569
3442,3773902805,3778597171,1672561681,1672563825,2144
3497,3511791953,3834963772,1672617531,1672620940,3409
3484,3402385957,3826238375,1672610723,1672611215,492
3517,3400763927,3701884158,1672573804,1672575908,2104
3456,3519818818,3438489358,1672555851,1672558387,2536
3792,3779854934,3514275974,1672562952,1672566503,3551
3735,3500841914,3231713082,1672579383,1672580721,1338
3838,3472312341,3505725706,1672649676,1672652504,2828
3719,3239617320,3393063657,1672631480,1672634146,2666
3590,3711812325,3534829213,1672677191,1672677280,89
3586,3315703693,3370068529,1672596076,1672597484,1408
3908,3613581796,3456430614,1672593255,1672593411,156
3778,3778926763,3500857494,1672613514,1672616024,2510
3573,3394297564,3501215099,1672619736,1672620297,561
3812,3226511603,3778040015,1672620814,1672621315,501
3623,3228888030,3238288884,1672593397,1672595692,2295
3889,3462158237,3803389195,1672648981,1672649736,755
3473,3357864626,3511005395,1672597099,1672600491,3392
3497,3770624662,3533929349,1672532811,1672535002,2191
3640,3408430195,3232208416,1672685983,1672687691,1708
3777,3630353876,3300979975,1672657029,1672657842,813
3585,3802932312,3512282789,1672627017,1672627580,563
3556,3311420950,3756746867,1672645567,1672647543,1976
3663,3224968597,3791693821,1672614206,1672614745,539
3588,3774290799,3902760230,1672547099,1672547172,73
3613,3299443125,3773837847,1672678494,1672679027,533
3769,3737112297,3236354255,1672697669,1672698574,905
3906,3600876425,3513853403,1672667583,1672670417,2834
3482,3778040015,3505663516,1672617854,1672620483,2629
3752,3393063657,3386758279,1672625553,1672627513,1960
3507,3448875382,3773837847,1672691281,1672694185,2904
3778,3475349791,3713784974,1672597466,1672598907,1441
3681,3513081354,3554825448,1672629359,1672629994,635
3503,3505634634,3610358027,1672621473,1672623153,1680
3840,3776988674,3829864515,1672552445,1672553281,836
3798,3394297564,3617489344,1672589540,1672591836,2296
3494,3617304541,3777814504,1672634794,1672636154,1360
3560,3384068080,3500109249,1672564078,1672567244,3166
3428,3703396825,3783520186,1672674735,1672677931,3196
3674,3617304541,3777624586,1672537358,1672537447,89
3756,3713163045,3755158925,1672667158,1672668869,1711
3905,3500525825,3463849738,1672589018,1672592517,3499
3905,3201629017,3472312341,1672605283,1672605931,648
3752,3975717896,3533294425,1672603598,1672605895,2297
3564,3604867757,3737972328,1672642706,1672642786,80
3430,3333403880,3333918941,1672539244,1672540121,877
3906,3803389195,3511883730,1672603405,1672603468,63
3442,3920625129,3715385401,1672591343,1672592684,1341
3840,3618808151,3512379024,1672648611,1672650801,2190
3859,3900945856,3516703758,1672669770,1672671549,1779
3896,3714185969,3777240360,1672599491,1672600593,1102
3576,3449639012,3208452238,1672624062,1672627475,3413
3756,3336339664,3779854934,1672577821,1672580997,3176
3583,3225631197,3617116290,1672557019,1672557469,450
3610,3202141727,3739154408,1672663869,1672666007,2138
3804,3316800320,3757318448,1672531361,1672534319,2958
3824,3272096759,3513065217,1672623237,1672623662,425
3746,3245232284,3880926355,1672698648,1672701026,2378
3475,3510964997,3437286517,1672647126,1672647378,252
3438,3780712350,3500915665,1672665607,1672666004,397
3815,3505481368,3757332128,1672665811,1672667876,2065
3514,3276348699,3713163045,1672702825,1672706172,3347
3838,3638204468,3225636215,1672633326,1672634945,1619
3819,3617489344,3510798825,1672532694,1672534454,1760
3743,3902760230,3814677862,1672630260,1672632142,1882
3814,3500703304,3303410628,1672537879,1672540645,2766
3629,3492546679,3517881647,1672576734,1672578128,1394
3826,3792546035,3902861231,1672632677,1672635970,3293
3626,3755737419,3399472693,1672532417,1672532760,343
3880,3779854934,3205985903,1672633392,1672634927,1535
3618,3902760230,3793743698,1672565661,1672566578,917
3755,3631479562,3793922324,1672703204,1672704313,1109
3535,3617392620,3459681410,1672689913,1672693315,3402
3519,3309314379,3777330107,1672660443,1672664031,3588
3827,3367509761,3534764451,1672588399,1672591560,3161
3619,3370227921,3449639012,1672643582,1672645222,1640
3671,3511317276,3711919537,1672572672,1672574256,1584
3740,3610358027,3533004959,1672604342,1672606078,1736
3670,3451726367,3534179433,1672662831,1672665919,3088
3869,3357689359,3620292035,1672696811,1672698215,1404
3720,3760651515,3470454332,1672570683,1672572968,2285
3857,3551389192,3505402439,1672638311,1672639990,1679
3796,3615115210,3780834916,1672701461,1672703273,1812
3766,3505481368,3899786664,1672562660,1672564799,2139
3882,3500949309,3415833929,1672548419,1672548607,188
3573,3791246640,3852686295,1672658238,1672660149,1911
3537,3338390596,3533090502,1672597798,1672598348,550
3441,3514324011,3756385685,1672628651,1672629688,1037
3608,3900945856,3491469603,1672574298,1672577025,2727
3600,3518565331,3755573472,1672593916,1672594090,174
3829,3280268483,3739154408,1672589205,1672592509,3304
3588,3500613493,3357864626,1672614921,1672616200,1279
3580,3779425804,3417191856,1672695687,1672698281,2594
3922,3701136026,3372223551,1672627604,1672629999,2395
3634,3770438122,3926643445,1672551675,1672552547,872
3774,3715127070,3276269264,1672585749,1672586562,813
3554,3533004959,3500672156,1672684973,1672687988,3015
3525,3608232640,3312998540,1672549522,1672553074,3552
3855,3701424609,3276217799,1672649874,1672650863,989
3720,3925979970,3276217799,1672591777,1672591895,118
3850,3501121099,3497671225,1672679268,1672680650,1382
3754,3630353876,3398731252,1672696763,1672698879,2116
3838,3445206685,3456430614,1672600404,1672602460,2056
3830,3510642075,3236354255,1672590007,1672591822,1815
3858,3272096759,3783433404,1672563709,1672564613,904
3567,3829864515,3500525825,1672618918,1672620518,1600
3887,3351696332,3615939504,1672544176,1672545663,1487
3527,3501215099,3885537225,1672606425,1672609364,2939
3627,3517358573,3511005395,1672688900,1672690306,1406
3651,3517991730,3972083617,1672606173,1672606251,78
3701,3236499444,3461119815,1672684500,1672687423,2923
3486,3510641433,3783433404,1672603706,1672605772,2066
3728,3783147088,3436257398,1672690754,1672692817,2063
3793,3209481722,3808136029,1672675466,1672677051,1585
3523,3497095254,3357289672,1672698974,1672699084,110
3708,3490214516,3734915241,1672671635,1672673978,2343
3742,3927403123,3231494505,1672652288,1672654632,2344
3895,3229974066,3739895284,1672677924,1672679178,1254
3802,3512282789,3779438325,1672638608,1672638892,284
3490,3500841914,3495911207,1672685171,1672686887,1716
3647,3714827719,3713561276,1672647198,1672650320,3122
3738,3792745809,3517737088,1672578786,1672581714,2928
3912,3363162590,3394401087,1672639217,1672642158,2941
3690,3514971533,3312998540,1672642199,1672645199,3000
3759,3905899155,3424445495,1672556046,1672559458,3412
3692,3395201292,3915162005,1672648153,1672650604,2451
3528,3392520516,3463849738,1672535055,1672538288,3233
3534,3431460073,3271752081,1672566529,1672568509,1980
3842,3621683102,3715854030,1672661077,1672661993,916
3780,3520560590,3772391882,1672579005,1672582222,3217
3555,3488686442,3512800570,1672645356,1672648625,3269
3715,3772078494,3713589994,1672541990,1672542952,962
3755,3633735593,3710735406,1672662646,1672663272,626
3639,3772236797,3975717896,1672639722,1672642432,2710
3698,3367111751,3970558632,1672560330,1672562355,2025
3772,3710008361,3337362061,1672672308,1672672424,116
3750,3689697817,3755404116,1672571703,1672574244,2541
3659,3201676087,3793743698,1672589736,1672592571,2835
3724,3852533643,3500703304,1672584006,1672586893,2887
3679,3367509761,3793883863,1672641316,1672642753,1437
3781,3793868716,3779465522,1672564796,1672566733,1937
3527,3617116290,3928511283,1672665416,1672666586,1170
3893,3505179890,3451726367,1672541367,1672541561,194
3770,3701373490,3447514821,1672672720,1672676160,3440
3809,3814677862,3755737419,1672613599,1672613923,324
3834,3517737088,3780338697,1672648635,1672651818,3183
3832,3755532873,3519028898,1672604316,1672607696,3380
3876,3600876425,3920625129,1672612593,1672616114,3521
3590,3777485931,3497095254,1672627192,1672629869,2677
3594,3668414677,3429943738,1672608030,1672609137,1107
3819,3711000597,3500709774,1672664347,1672667518,3171
3851,3819767045,3608855425,1672540643,1672541412,769
3467,3714666884,3513410578,1672589159,1672590378,1219
3460,3513345163,3934064792,1672622285,1672623712,1427
3753,3757863420,3315703693,1672568931,1672569961,1030
3875,3283492940,3533929349,1672574235,1672575701,1466
3728,3509893027,3291933594,1672642500,1672643759,1259
3505,3778597171,3703433819,1672699480,1672701929,2449
3523,3757383891,3899786664,1672552289,1672552619,330
3718,3715986185,3757903168,1672667087,1672668678,1591
3759,3715385401,3930242012,1672660227,1672662204,1977
3517,3519651506,3783801141,1672648406,1672648511,105
3583,3688220326,3399472693,1672701019,1672703900,2881
3775,3755230952,3716272919,1672632589,1672636022,3433
3729,3534357694,3792801638,1672689776,1672690902,1126
3465,3516298579,3514275974,1672628855,1672630226,1371
3656,3533649454,3716110860,1672628447,1672630729,2282
3565,3770704999,3338390596,1672629877,1672630505,628
3897,3777240360,3435116799,1672663477,1672666286,2809
3621,3757630221,3460719322,1672568108,1672570727,2619
3614,3400069268,3512722110,1672616021,1672618451,2430
3460,3462158237,3757348722,1672560264,1672561019,755
3470,3457620713,3285204083,1672633503,1672634850,1347
3683,3404025196,3714233826,1672559371,1672561825,2454
3489,3621683102,3338390596,1672694502,1672696093,1591
3623,3517222913,3289817992,1672589291,1672592036,2745
3597,3738026330,3276003502,1672543909,1672546192,2283
3802,3732584121,3780472203,1672592385,1672593521,1136
3696,3559458968,3399518841,1672540018,1672543494,3476
3510,3791613604,3513296868,1672658860,1672659212,352
3709,3701882224,3826238375,1672656276,1672657685,1409
3566,3618808151,3513345163,1672678067,1672678695,628
3671,3736705719,3517887477,1672533104,1672535136,2032
3462,3793935736,3510642075,1672632504,1672634941,2437
3807,3554944414,3310125159,1672535272,1672537486,2214
3789,3710315160,3246370118,1672665059,1672667548,2489
3807,3614740489,3803517637,1672602938,1672604431,1493
3733,3757700712,3518561777,1672667350,1672669060,1710
3484,3451691949,3509893027,1672644149,1672646958,2809
3784,3780571086,3517222913,1672542287,1672544315,2028
3710,3778667336,3511024016,1672606081,1672608067,1986
3436,3401940259,3241914067,1672693661,1672697198,3537
3515,3533294425,3858172636,1672559323,1672562256,2933
3885,3923754072,3517288083,1672586081,1672588016,1935
3705,3760094385,3411688875,1672568689,1672569615,926
3599,3710854064,3710489491,1672598725,1672601656,2931
3855,3930242012,3428027649,1672654247,1672656859,2612
3519,3272030610,3337362061,1672577036,1672578266,1230
3572,3757903168,3803389195,1672641909,1672642180,271
3521,3520991398,3518229776,1672600126,1672600658,532
3739,3770468980,3201800997,1672655502,1672656111,609
3506,3520355798,3480100311,1672602050,1672605333,3283
3858,3773913680,3299443125,1672535077,1672537742,2665
3832,3501525100,3201676087,1672645837,1672648113,2276
3654,3517172354,3779646172,1672688394,1672690621,2227
3790,3399518841,3635169815,1672607929,1672608210,281
3531,3979784676,3462158237,1672688423,1672690132,1709
3560,3462158237,3661903000,1672629692,1672632818,3126
3467,3859868849,3715086894,1672625607,1672626777,1170
3748,3779938251,3505198734,1672654391,1672656211,1820
3810,3703798634,3755848152,1672698953,1672699932,979
3659,3710854064,3755573472,1672613607,1672614499,892
3670,3517172354,3514971533,1672589337,1672592499,3162
3835,3519909393,3514971533,1672539653,1672539834,181
3914,3533423872,3414049538,1672658779,1672662194,3415
3789,3613899351,3756127300,1672626726,1672629348,2622
3860,3711077927,3703396825,1672553148,1672555896,2748
3669,3732584121,3240994288,1672622599,1672622774,175
3447,3510767239,3520578796,1672651573,1672652001,428
3456,3925979970,3783928182,1672568153,1672571525,3372
3759,3519028898,3338083680,1672701021,1672703499,2478
3544,3505178849,3711218296,1672547278,1672549061,1783
3612,3357864626,3205923620,1672551602,1672552917,1315
3480,3517687662,3613338363,1672676147,1672679535,3388
3757,3755230952,3367509761,1672555363,1672558674,3311
3810,3713163045,3714666884,1672575738,1672575825,87
3784,3271752081,3935913584,1672563857,1672566459,2602
3493,3930242012,3451326054,1672578037,1672581171,3134
3753,3731646673,3512882178,1672672274,1672673111,837
3685,3467779445,3688490530,1672649542,1672650316,774
3535,3519142371,3773124276,1672688249,1672691809,3560
3507,3773735484,3778597171,1672607393,1672610555,3162
3610,3374183227,3551376095,1672656286,1672658042,1756
3538,3360069849,3501215099,1672606049,1672607037,988
3484,3760645796,3773939399,1672633532,1672636569,3037
3747,3201800997,3450286949,1672603968,1672606399,2431
3473,3836241528,3772078494,1672676210,1672678016,1806
3570,3623266256,3285204083,1672557940,1672560878,2938
3644,3412006598,3454277788,1672553653,1672554869,1216
3712,3404025196,3513018485,1672689840,1672691669,1829
3802,3363162590,3511317276,1672560996,1672561193,197
3837,3226024417,3792949946,1672549836,1672552642,2806
3526,3783340788,3812369928,1672593111,1672593535,424
3908,3756789525,3463849738,1672598828,1672601972,3144
3920,3615087943,3625174002,1672668952,1672670494,1542
3432,3689697817,3481640525,1672626649,1672629849,3200
3880,3803389195,3714128600,1672531601,1672533766,2165
3533,3792525861,3336339664,1672679639,1672680293,654
3828,3756474459,3551399764,1672582033,1672582790,757
3424,3436257398,3615688740,1672669418,1672669764,346
3457,3760094385,3500737582,1672560122,1672563522,3400
3704,3347446226,3716110860,1672573246,1672574238,992
3750,3715086894,3714827719,1672578845,1672579149,304
3477,3792949946,3520991398,1672658226,1672658571,345
3733,3900898992,3276003502,1672658621,1672659332,711
3648,3899326793,3513081354,1672568712,1672571317,2605
3548,3609933747,3372223551,1672685442,1672686403,961
3680,3364726656,3773124276,1672539755,1672543327,3572
3525,3240994288,3667673649,1672577235,1672578256,1021
3555,3449639012,3889780657,1672563461,1672564598,1137
3482,3497095254,3500672156,1672703871,1672704104,233
3726,3501457103,3304971369,1672576948,1672579692,2744
3581,3343132529,3512295534,1672675060,1672676300,1240
3808,3279242917,3852686295,1672586006,1672588895,2889
3534,3609881958,3974674109,1672589057,1672590698,1641
3515,3414275042,3711853996,1672681063,1672683146,2083
3494,3245232284,3512379024,1672610928,1672613666,2738
3779,3505228454,3364726656,1672663507,1672665843,2336
3439,3226511603,3711218296,1672563378,1672566925,3547
3849,3448875382,3716963089,1672701776,1672703813,2037
3506,3505178849,3310039260,1672548828,1672551688,2860
3862,3780769110,3311049964,1672644114,1672644549,435
3615,3514275974,3779738691,1672543676,1672546150,2474
3567,3979802715,3833217041,1672701865,1672704147,2282
3667,3713784974,3713589994,1672579046,1672580017,971
3832,3292147449,3770676872,1672607371,1672609520,2149
3898,3435116799,3776034743,1672689342,1672691879,2537
3813,3618354185,3772765746,1672691775,1672693990,2215
3670,3382733096,3971806004,1672691309,1672694194,2885
3845,3533079336,3384583385,1672620873,1672623036,2163
3525,3519282716,3776084820,1672578513,1672580914,2401
3568,3236354255,3424445495,1672645128,1672648157,3029
3822,3773572967,3201676087,1672544800,1672545430,630
3781,3711077927,3514703118,1672589735,1672593226,3491
3832,3617116290,3554944414,1672583110,1672584085,975
3438,3354144091,3367509761,1672647214,1672647812,598
3582,3480490124,3755756564,1672600783,1672603705,2922
3548,3755158925,3615087943,1672698829,1672700333,1504
3873,3246370118,3756127300,1672680305,1672681924,1619
3721,3335694356,3533294425,1672629352,1672630947,1595
3793,3333403880,3519142371,1672604417,1672606917,2500
3772,3755573472,3739911441,1672627213,1672629256,2043
3897,3760640999,3534179433,1672623625,1672624561,936
3578,3714678331,3792489602,1672671513,1672673317,1804
3579,3520560590,3701823816,1672645187,1672645828,641
3454,3201629017,3520578796,1672572290,1672575480,3190
3893,3518653080,3923420131,1672606387,1672609834,3447
3749,3792949946,3533090502,1672611979,1672612202,223
3511,3517288083,3514741348,1672624524,1672626283,1759
3838,3631090677,3826238375,1672602963,1672604017,1054
3629,3501567772,3497095254,1672612286,1672614324,2038
3538,3311498666,3490214516,1672643818,1672644269,451
3849,3225631197,3459681410,1672612251,1672613942,1691
3828,3462636434,3613416045,1672649339,1672651958,2619
3464,3230868435,3737112297,1672702106,1672704481,2375
3723,3412968120,3417679834,1672578182,1672579395,1213
3605,3636329663,3370227921,1672614010,1672614679,669
3481,3780115155,3714666884,1672577251,1672577422,171
3428,3791441520,3520873221,1672613997,1672617029,3032
3458,3500827202,3416987084,1672549112,1672552144,3032
3883,3241914067,3510641433,1672560119,1672560828,709
3455,3757700712,3703383853,1672559645,1672562694,3049
3651,3512882178,3615737355,1672601109,1672601856,747
3742,3402385957,3294747828,1672569370,1672570632,1262
3449,3236499444,3703433819,1672620250,1672623690,3440
3798,3780769110,3776034743,1672585836,1672588362,2526
3678,3200543880,3893912331,1672664265,1672664972,707
3633,3516321888,3715385401,1672553522,1672555481,1959
3624,3505995057,3711812325,1672583002,1672585056,2054
3572,3890739241,3515439826,1672541030,1672544503,3473
3836,3774155692,3554944414,1672602792,1672605472,2680
3895,3357689359,3972083617,1672606788,1672609484,2696
3768,3400069268,3403370192,1672689738,1672690690,952
3838,3972083617,3792072681,1672663280,1672666845,3565
3453,3518194482,3283770991,1672697135,1672697967,832
3727,3389634034,3501215099,1672572552,1672574500,1948
3872,3401940259,3612689556,1672611263,1672611818,555
3641,3462158237,3500317969,1672666676,1672669856,3180
3794,3481640525,3912891315,1672678792,1672680834,2042
3636,3783641602,3618354185,1672597534,1672599625,2091
3470,3904867554,3469254160,1672693693,1672696269,2576
3877,3514275974,3220031931,1672572690,1672573957,1267
3843,3791436104,3510798825,1672579691,1672581236,1545
3526,3305336154,3435116799,1672624895,1672625231,336
3495,3791246640,3517991730,1672538670,1672540058,1388
3458,3228888030,3710008361,1672663080,1672663477,397
3745,3510642075,3773121782,1672534732,1672535203,471
3611,3417191856,3818575661,1672634927,1672636724,1797
3612,3505725706,3205923620,1672579002,1672579684,682
3522,3774155692,3421385957,1672617477,1672619807,2330
3649,3533188828,3710562338,1672552203,1672554383,2180
3859,3711077927,3311420950,1672533525,1672535570,2045
3458,3435167810,3899326793,1672671004,1672672211,1207
3622,3315703693,3534764451,1672558892,1672560292,1400
3762,3803389195,3510767239,1672537516,1672538806,1290
3738,3760094385,3481640525,1672612776,1672616189,3413
3617,3835985172,3492546679,1672587159,1672589685,2526
3682,3487875183,3814305099,1672641443,1672644793,3350
3548,3736231757,3783433404,1672605993,1672606996,1003
3668,3337362061,3979784676,1672607362,1672607750,388
3513,3283770991,3923420131,1672650905,1672653836,2931
3532,3778040015,3776831527,1672648406,1672650442,2036
3753,3519850727,3792072681,1672621174,1672623134,1960
3637,3513065217,3818575661,1672686656,1672688949,2293
3863,3554825448,3617392620,1672565120,1672565405,285
3753,3226511603,3410538749,1672540457,1672543992,3535
3641,3934064792,3517887477,1672648563,1672651512,2949
3770,3395201292,3311049964,1672568539,1672571479,2940
3658,3431502855,3515525630,1672594274,1672595935,1661
3702,3811075491,3633735593,1672591909,1672595224,3315
3456,3934064792,3701322924,1672602967,1672604528,1561
3552,3294747828,3739661856,1672677182,1672677561,379
3685,3398198430,3783801141,1672664963,1672666850,1887
3769,3383138270,3512882178,1672549222,1672552650,3428
3515,3620292035,3615939504,1672622471,1672622829,358
3892,3533747868,3760364383,1672555795,1672557641,1846
3879,3462158237,3309314379,1672646856,1672647854,998
3771,3511791953,3511288998,1672640233,1672641231,998
3486,3714827719,3534764451,1672614530,1672615364,834
3633,3509756823,3370068529,1672636405,1672638539,2134
3493,3755230952,3817428320,1672646247,1672649244,2997
3829,3203538212,3977148669,1672680944,1672681734,790
3545,3779892400,3783928182,1672602183,1672605777,3594
3473,3912891315,3500442734,1672606836,1672610206,3370
3739,3914691363,3514308235,1672566426,1672568793,2367
3529,3779738691,3760842815,1672641394,1672642163,769
3563,3283770991,3311085279,1672646848,1672648270,1422
3918,3811040565,3780909839,1672641310,1672641513,203
3780,3792745809,3977148669,1672693654,1672695339,1685
3446,3511150845,3624297844,1672534515,1672537056,2541
3551,3711077927,3792525861,1672547415,1672549344,1929
3652,3463849738,3209526819,1672680160,1672680468,308
3756,3609113156,3519850727,1672552500,1672552599,99
3634,3909094917,3510187271,1672564358,1672564654,296
3873,3200543880,3912891315,1672608757,1672609905,1148
3671,3517697722,3520560590,1672583169,1672584732,1563
3839,3319167958,3200308999,1672574360,1672575517,1157
3570,3777147510,3206837348,1672611494,1672614519,3025
3526,3638660068,3897376951,1672619797,1672623175,3378
3875,3402697190,3396980894,1672679145,1672681360,2215
3703,3900276517,3228888030,1672565027,1672566870,1843
3485,3791753345,3533079336,1672606892,1672608263,1371
3794,3824641227,3605221116,1672562928,1672564060,1132
3891,3518229776,3755737419,1672582837,1672583268,431
3515,3520560590,3610358027,1672702764,1672704242,1478
3547,3229822507,3343132529,1672687740,1672690029,2289
3900,3791436104,3240394404,1672649551,1672652966,3415
3820,3414049538,3441348818,1672677953,1672681493,3540
3669,3783641602,3428725843,1672591451,1672592306,855
3760,3505266860,3512282789,1672646031,1672647252,1221
3511,3513853403,3618176292,1672538144,1672539363,1219
3857,3451326054,3512882178,1672566636,1672567175,539
3468,3556969573,3618489670,1672537895,1672538571,676
3584,3505923418,3792949946,1672548781,1672549999,1218
3837,3279473441,3756789525,1672535435,1672536206,771
3809,3557046880,3511024016,1672631748,1672632224,476
3864,3773027597,3715443333,1672636846,1672639391,2545
3757,3276003502,3688796737,1672591366,1672593799,2433
3438,3935487534,3777240360,1672617248,1672619036,1788
3723,3279475486,3701424609,1672545719,1672547784,2065
3697,3760040019,3533929349,1672541631,1672542703,1072
3768,3511732493,3668747074,1672690205,1672692175,1970
3493,3610870949,3205923620,1672668473,1672670463,1990
3805,3299781901,3417191856,1672544821,1672545872,1051
3637,3450286949,3335694356,1672539151,1672539339,188
3637,3447514821,3334974375,1672536201,1672536779,578
3895,3686523546,3737147209,1672584160,1672586159,1999
3871,3852533643,3400069268,1672621119,1672621857,738
3773,3613899351,3280054198,1672550310,1672551619,1309
3799,3226178937,3900898992,1672660209,1672662112,1903
3730,3783771827,3225636215,1672660119,1672661272,1153
3746,3703348097,3791613604,1672615909,1672616566,657
3717,3457960571,3772391882,1672595473,1672596683,1210
3450,3208452238,3493017654,1672625357,1672627465,2108
3668,3209481722,3783771827,1672577969,1672581493,3524
3545,3534829213,3607768197,1672594018,1672595032,1014
3858,3510641433,3492546679,1672620233,1672623512,3279
3906,3715443333,3791613604,1672619519,1672622659,3140
3502,3714670620,3299125059,1672655670,1672657292,1622
3433,3336339664,3500302272,1672538061,1672538912,851
3635,3402385957,3778667336,1672576895,1672577309,414
3914,3819767045,3382733096,1672665966,1672668815,2849
3488,3272096759,3514956366,1672619032,1672620994,1962
3536,3774733620,3520991398,1672625303,1672627784,2481
3707,3505521218,3552824113,1672599240,1672599460,220
3653,3310039260,3633735593,1672694338,1672696071,1733
3628,3774733620,3510767239,1672545861,1672548297,2436
3766,3514741348,3703798634,1672532764,1672533547,783
3435,3613206049,3622665543,1672699105,1672699952,847
3547,3424445495,3890739241,1672637886,1672639477,1591
3876,3228888030,3637313265,1672595215,1672597832,2617
3734,3349739136,3283770991,1672694943,1672695802,859
3685,3755573472,3713517039,1672700987,1672702320,1333
3747,3793781065,3778597171,1672620050,1672623536,3486
3509,3534357694,3551399764,1672698063,1672698771,708
3810,3492959689,3457960571,1672699724,1672702406,2682
3506,3817813340,3685681577,1672607516,1672610028,2512
3587,3614740489,3778899160,1672661623,1672662094,471
3499,3701005527,3205923620,1672584351,1672587739,3388
3520,3757294769,3859868849,1672642958,1672646272,3314
3786,3713561276,3783928182,1672659945,1672661869,1924
3430,3852686295,3515559913,1672533982,1672535086,1104
3856,3533004959,3688796737,1672681208,1672683558,2350
3897,3515890966,3774718695,1672576132,1672579155,3023
3622,3534126409,3778040015,1672573256,1672574641,1385
3661,3511288998,3777091903,1672634631,1672635108,477
3894,3773124276,3343132529,1672612327,1672612899,572
3724,3713163045,3270697740,1672657158,1672657504,346
3790,3800257590,3364378127,1672580079,1672583023,2944
3851,3500604680,3533274994,1672539342,1672541884,2542
3670,3783928182,3415833929,1672675237,1672676685,1448
3484,3226511603,3364378127,1672688893,1672690362,1469
3640,3516298579,3757700712,1672681332,1672682321,989
3739,3300818269,3713941638,1672538862,1672540047,1185
3912,3554825448,3505437712,1672531389,1672531611,222
3878,3783771827,3408430195,1672540635,1672542204,1569
3534,3438489358,3780253901,1672692644,1672694990,2346
3832,3515559913,3460719322,1672557203,1672557816,613
3673,3770676872,3347446226,1672560588,1672562465,1877
3525,3783340788,3335694356,1672547596,1672549080,1484
3426,3209526819,3336627643,1672671802,1672673507,1705
3879,3713979100,3793175445,1672550303,1672552757,2454
3899,3661447322,3244004456,1672661966,1672663130,1164
3718,3711734586,3776559988,1672583081,1672585546,2465
3435,3621683102,3517881647,1672611482,1672612873,1391
3662,3737147209,3305722859,1672661690,1672664294,2604
3525,3885537225,3519446663,1672641836,1672643908,2072
3511,3614740489,3410600350,1672669797,1672671421,1624
3601,3710489491,3497095254,1672622418,1672624974,2556
3891,3421877923,3714128600,1672677293,1672680674,3381
3440,3357864626,3421385957,1672687579,1672690366,2787
3808,3511288998,3438078818,1672536501,1672539043,2542
3765,3500347447,3366423342,1672556703,1672560149,3446
3601,3240994288,3513410578,1672570264,1672573648,3384
3610,3513327337,3971806004,1672687766,1672688987,1221
3605,3900276517,3438078818,1672575992,1672578268,2276
3797,3835985172,3500525825,1672685017,1672688314,3297
3527,3285204083,3291933594,1672641778,1672643479,1701
3663,3514818819,3880926355,1672656845,1672657740,895
3491,3780680950,3713784974,1672696677,1672698323,1646
3813,3803517637,3490214516,1672565894,1672566311,417
3478,3304971369,3777624586,1672701973,1672704006,2033
3902,3399518841,3512392431,1672657419,1672659491,2072
3526,3456430614,3411515369,1672545444,1672546741,1297
3869,3511288998,3920898925,1672703766,1672704714,948
3587,3500208903,3392943173,1672554620,1672554860,240
3693,3517462308,3923420131,1672531954,1672534101,2147
3831,3534566651,3701424609,1672562623,1672564910,2287
3565,3396980894,3447514821,1672562872,1672565185,2313
3665,3279473441,3512958459,1672602349,1672605428,3079
3598,3734451191,3436025562,1672667883,1672670489,2606
3564,3736231757,3897456874,1672661073,1672663412,2339
3760,3404025196,3760651515,1672591432,1672593556,2124
3502,3398731252,3533747868,1672552381,1672553096,715
3705,3821054646,3779938251,1672631084,1672632848,1764
3549,3500949309,3686227677,1672702290,1672704527,2237
3461,3270056120,3701664364,1672617095,1672618628,1533
3852,3609933747,3534829213,1672645657,1672646823,1166
3655,3205923620,3333403880,1672611514,1672613780,2266
3887,3776988674,3505888598,1672585420,1672588866,3446
3746,3400763927,3517172354,1672557198,1672559672,2474
3860,3625174002,3710562338,1672690382,1672692124,1742
3801,3636329663,3714067076,1672698740,1672700588,1848
3683,3773939399,3613581796,1672565377,1672568460,3083
3719,3534764451,3311498666,1672590474,1672593518,3044
3466,3780872464,3291933594,1672540142,1672541472,1330
3682,3500341755,3780712350,1672676893,1672678195,1302
3807,3898314440,3499217428,1672560089,1672562908,2819
3427,3755756564,3850911686,1672659513,1672660429,916
3791,3760364383,3760640999,1672588935,1672591668,2733
3684,3435116799,3294747828,1672636336,1672639567,3231
3514,3667427125,3617489344,1672649373,1672651546,2173
3574,3818575661,3500915908,1672598373,1672600998,2625
3436,3445206685,3451691949,1672614134,1672614362,228
3542,3859868849,3398731252,1672601395,1672603601,2206
3757,3440107959,3417191856,1672613820,1672613894,74
3579,3685816610,3451726367,1672566028,1672567902,1874
3434,3970198861,3220031931,1672700837,1672701047,210
3829,3833217041,3500915665,1672535414,1672537747,2333
3885,3688490530,3792525861,1672571851,1672573801,1950
3811,3979802715,3831586487,1672632312,1672634151,1839
3801,3613206049,3291933594,1672673866,1672675719,1853
3890,3505179890,3511843593,1672694407,1672696925,2518
3443,3710854064,3517991730,1672589426,1672590645,1219
3715,3630353876,3304971369,1672635515,1672639111,3596
3887,3783928182,3710048469,1672680183,1672683257,3074
3822,3817813340,3779438325,1672550533,1672552145,1612
3695,3814305099,3455018347,1672543154,1672544250,1096
3501,3897456874,3779301501,1672627442,1672628233,791
3491,3859868849,3713941638,1672604191,1672605539,1348
3513,3338390596,3615115210,1672561044,1672562955,1911
3677,3551376095,3299125059,1672571741,1672574490,2749
3436,3500672156,3343132529,1672667208,1672667920,712
3668,3510642075,3792014516,1672608451,1672610812,2361
3516,3299781901,3501384020,1672606943,1672607865,922
3583,3834631333,3912891315,1672639777,1672641791,2014
3574,3715707380,3668747074,1672627992,1672631015,3023
3495,3757193551,3367111751,1672686616,1672687522,906
3803,3760362417,3367509761,1672627001,1672628253,1252
3588,3517991730,3402385957,1672663942,1672665791,1849
3667,3778667336,3437286517,1672576720,1672577423,703
3609,3231494505,3373089838,1672663419,1672666244,2825
3527,3400069268,3462158237,1672618890,1672620201,1311
3499,3551389192,3479851674,1672575580,1672576641,1061
3560,3801645328,3905899155,1672648896,1672652029,3133
3854,3510028805,3780322355,1672609268,1672611884,2616
3855,3517697722,3408430195,1672603348,1672604217,869
3905,3685816610,3713517039,1672599402,1672600812,1410
3522,3780427126,3923220461,1672630749,1672631646,897
3623,3713979100,3772236797,1672572671,1672573043,372
3622,3501384020,3604867757,1672703761,1672704781,1020
3879,3244004456,3517222913,1672554572,1672557654,3082
3568,3520873221,3414275042,1672670716,1672673231,2515
3701,3760721303,3517697722,1672678412,1672681145,2733
3467,3205985903,3757075324,1672564591,1672566950,2359
3616,3774718695,3206837348,1672553070,1672555309,2239
3454,3665998641,3475349791,1672672682,1672674091,1409
3586,3511883730,3520578796,1672654852,1672658131,3279
3856,3703383853,3779786641,1672588017,1672589849,1832
3860,3773009828,3791441520,1672692917,1672694803,1886
3661,3783801141,3392520516,1672562027,1672564033,2006
3481,3632814465,3780680950,1672608548,1672611416,2868
3769,3756127300,3448875382,1672654362,1672657664,3302
3455,3280268483,3457620713,1672586647,1672589134,2487
3619,3757294769,3421385957,1672558539,1672560697,2158
3833,3631090677,3780115155,1672553446,1672554805,1359
3497,3792949946,3513295938,1672650476,1672651097,621
3479,3836241528,3392836218,1672563646,1672566485,2839
3554,3500072204,3714666884,1672560854,1672562655,1801
3712,3770296583,3760040019,1672532900,1672534550,1650
3720,3336339664,3500949309,1672667458,1672670301,2843
3697,3774790271,3710008361,1672554224,1672556456,2232
3877,3618176292,3311498666,1672677879,1672678746,867
3517,3774178201,3792442597,1672626352,1672626545,193
3577,3898314440,3923420131,1672563162,1672565802,2640
3669,3636329663,3701373490,1672599267,1672602808,3541
3640,3209526819,3615115210,1672606296,1672609400,3104
3713,3734118023,3311049964,1672531240,1672533331,2091
3592,3454277788,3505178849,1672638280,1672641759,3479
3735,3517222913,3229974066,1672585061,1672586093,1032
3713,3304971369,3505888598,1672656811,1672659876,3065
3814,3510642075,3289114629,1672649599,1672653087,3488
3778,3300229945,3613338363,1672595580,1672598593,3013
3606,3755230952,3230868435,1672661510,1672663225,1715
3882,3350095157,3617116290,1672536998,1672539325,2327
3585,3773913680,3556969573,1672646209,1672646660,451
3724,3711637255,3285204083,1672666470,1672669706,3236
3515,3928719932,3319167958,1672662492,1672664771,2279
3861,3362641275,3306412634,1672668109,1672671357,3248
3843,3450286949,3783136330,1672547006,1672550542,3536
3666,3501567772,3780712350,1672614773,1672614856,83
3752,3774705415,3517737088,1672640255,1672643675,3420
3465,3513295938,3776244398,1672586092,1672587527,1435
3760,3351866415,3385323994,1672637918,1672640647,2729
3447,3515890966,3414049538,1672679060,1672682032,2972
3776,3501525100,3778134418,1672625858,1672628215,2357
3527,3513018485,3514246749,1672592325,1672594233,1908
3768,3492959689,3931627862,1672667073,1672667672,599
3444,3609881958,3501567772,1672672656,1672674922,2266
3909,3404025196,3623266256,1672657723,1672659069,1346
3472,3401940259,3778134418,1672686190,1672688167,1977
3646,3688220326,3774031303,1672556099,1672556639,540
3630,3299125059,3337322736,1672566231,1672568287,2056
3508,3276003502,3710562338,1672647928,1672649818,1890
3570,3778040015,3485540729,1672664145,1672666873,2728
3436,3274906650,3852533643,1672651313,1672652877,1564
3804,3304155815,3520355798,1672683491,1672684215,724
3839,3533368789,3680810086,1672585506,1672587581,2075
3852,3337322736,3226511603,1672685419,1672686175,756
3673,3209526819,3780338697,1672701391,1672704394,3003
3876,3737112297,3791246640,1672569927,1672572465,2538
3550,3777184389,3513018485,1672560446,1672561379,933
3853,3534829213,3533004959,1672557516,1672559377,1861
3687,3383138270,3517358573,1672655652,1672656266,614
3891,3638204468,3206837348,1672609005,1672611284,2279
3490,3839245934,3773913680,1672679344,1672681675,2331
3553,3607882826,3364378127,1672628722,1672629552,830
3593,3684523966,3452016771,1672572099,1672575029,2930
3711,3776559988,3513545422,1672657010,1672658292,1282
3565,3608922867,3778899160,1672621867,1672625303,3436
3839,3200543880,3777694660,1672611386,1672613798,2412
3586,3792801638,3440137407,1672683066,1672683957,891
3474,3920898925,3755344363,1672622253,1672623577,1324
3644,3755915206,3512379024,1672605107,1672605640,533
3704,3455018347,3904412440,1672646541,1672646900,359
3449,3783340788,3451326054,1672578122,1672580513,2391
3526,3972192593,3276217799,1672652604,1672655197,2593
3728,3927599181,3613899351,1672591418,1672592553,1135
3706,3534764451,3607882826,1672671244,1672673251,2007
3788,3661447322,3776034743,1672585378,1672585688,310
3762,3800257590,3475349791,1672630545,1672630752,207
3523,3513018485,3414049538,1672593662,1672597101,3439
3513,3776084820,3780872464,1672556219,1672556392,173
3850,3779938251,3512958459,1672666542,1672667371,829
3482,3792949946,3334974375,1672607126,1672609608,2482
3445,3615113018,3779639983,1672669135,1672671538,2403
3597,3534764451,3500737582,1672558831,1672561949,3118
3526,3362641275,3383138270,1672551025,1672551342,317
3750,3480726047,3421385957,1672671819,1672673215,1396
3705,3370068529,3500841914,1672590721,1672591642,921
3453,3517358573,3819767045,1672684987,1672687455,2468
3547,3703348097,3774718695,1672664376,1672667460,3084
3709,3402697190,3452016771,1672698097,1672699766,1669
3695,3756474459,3296462324,1672582101,1672583875,1774
3683,3895285664,3517288083,1672540147,1672541346,1199
3506,3637313265,3715400486,1672622454,1672622915,461
3914,3554825448,3833217041,1672617243,1672619615,2372
3743,3734451191,3713784974,1672561768,1672564816,3048
3791,3772765746,3638204468,1672617159,1672620485,3326
3698,3880926355,3520115090,1672622893,1672625542,2649
3532,3923220461,3831586487,1672589003,1672590825,1822
3562,3884596900,3713829743,1672695676,1672698475,2799
3574,3756789525,3770520359,1672627734,1672630827,3093
3581,3500347447,3701005527,1672542430,1672544868,2438
3617,3792072681,3404025196,1672560451,1672562924,2473
3706,3231494505,3715443333,1672534360,1672536712,2352
3800,3274831810,3533747868,1672589082,1672589631,549
3740,3826238375,3417679834,1672675329,1672676659,1330
3660,3492959689,3510499038,1672565724,1672566172,448
3846,3205985903,3783147088,1672658822,1672659416,594
3501,3777184389,3773121782,1672555852,1672556089,237
3570,3435116799,3512502036,1672608125,1672610460,2335
3462,3440137407,3661903000,1672646169,1672646669,500
3564,3715443333,3513296868,1672669047,1672670701,1654
3608,3900276517,3273981374,1672618847,1672619438,591
3432,3480100311,3311498666,1672589279,1672592792,3513
3461,3779639983,3716628503,1672629792,1672630226,434
3555,3376467719,3519142371,1672635002,1672636636,1634
3865,3783340788,3241790910,1672683098,1672685849,2751
3789,3439673892,3505807416,1672548324,1672549922,1598
3772,3519909393,3513041785,1672603586,1672603891,305
3462,3226024417,3734118023,1672535130,1672537215,2085
3533,3294747828,3480726047,1672566999,1672570128,3129
3854,3685816610,3369708250,1672658207,1672660711,2504
3596,3914691363,3534126409,1672647273,1672648830,1557
3458,3793175445,3779532653,1672602902,1672605876,2974
3746,3492546679,3367509761,1672538776,1672539941,1165
3627,3715443333,3926643445,1672590577,1672593854,3277
3590,3783919913,3814305099,1672640929,1672644448,3519
3921,3350095157,3824641227,1672583571,1672584447,876
3637,3829864515,3400069268,1672668357,1672669874,1517
3449,3360813161,3732584121,1672587234,1672590660,3426
3528,3488686442,3612689556,1672551475,1672551695,220
3702,3451326054,3783641602,1672554237,1672556422,2185
3495,3902861231,3756746867,1672601658,1672605034,3376
3908,3792389522,3505198734,1672636445,1672638566,2121
3618,3500498112,3534829213,1672639894,1672642996,3102
3793,3514324011,3716272919,1672584112,1672587699,3587
3810,3401940259,3772391882,1672679942,1672680766,824
3482,3852533643,3514324011,1672579849,1672583232,3383
3662,3774907131,3435116799,1672542883,1672543891,1008
3883,3393063657,3276348699,1672551376,1672551475,99
3867,3774243020,3400763927,1672607204,1672607690,486
3567,3710315160,3703396825,1672691877,1672694472,2595
3621,3825881598,3739154408,1672624508,1672627785,3277
3894,3224968597,3461119815,1672692825,1672694329,1504
3635,3351696332,3514419100,1672660715,1672661770,1055
3665,3505434346,3778134418,1672589728,1672590928,1200
3878,3905196766,3349739136,1672580773,1672582303,1530
3673,3780338697,3880926355,1672658435,1672661756,3321
3688,3971806004,3500915908,1672701230,1672701949,719
3564,3621683102,3519909393,1672597536,1672600715,3179
3659,3711218296,3835985172,1672610197,1672613139,2942
3748,3684523966,3777624586,1672600958,1672602168,1210
3738,3401940259,3404025196,1672702029,1672703364,1335
3641,3491469603,3511732493,1672631362,1672633289,1927
3530,3928719932,3469254160,1672553137,1672554393,1256
3509,3792505974,3713589994,1672621978,1672623742,1764
3880,3273981374,3505521218,1672550575,1672553893,3318
3862,3792801638,3818575661,1672689006,1672692001,2995
3734,3519651506,3274831810,1672531774,1672532625,851
3755,3505179890,3500109249,1672575893,1672576290,397
3437,3533274994,3284947372,1672631954,1672632957,1003
3788,3505198734,3517887477,1672700623,1672702805,2182
3485,3343816795,3520991398,1672533658,1672536328,2670
3707,3792072681,3711077927,1672561942,1672562328,386
3912,3448875382,3793175445,1672587389,1672590368,2979
3591,3680843171,3513360004,1672575872,1672576872,1000
3609,3511288998,3224811762,1672547115,1672548505,1390
3509,3703798634,3755496114,1672561737,1672562100,363
3430,3394401087,3757630221,1672603562,1672605357,1795
3762,3518229776,3457960571,1672688007,1672690150,2143
3921,3638660068,3757332128,1672543694,1672543975,281
3883,3534357694,3459681410,1672624836,1672626513,1677
3654,3392943173,3200543880,1672551123,1672552741,1618
3695,3343816795,3927165965,1672673742,1672677139,3397
3853,3517358573,3710854064,1672542053,1672545104,3051
3484,3520873221,3202804048,1672638099,1672641620,3521
3555,3512958459,3900276517,1672577616,1672579006,1390
3625,3472068734,3793315718,1672568916,1672572173,3257
3798,3710048469,3779532653,1672550144,1672552746,2602
3428,3755065949,3614740489,1672548037,1672548234,197
3436,3909094917,3509483172,1672649948,1672652378,2430
3573,3519651506,3435116799,1672554965,1672557523,2558
3832,3906536154,3384068080,1672664764,1672665703,939
3689,3438078818,3793175445,1672628745,1672630603,1858
3702,3505266860,3364378127,1672552333,1672553210,877
3800,3757348722,3309314379,1672551264,1672552901,1637
3735,3384583385,3556969573,1672623362,1672624869,1507
3860,3716679950,3623266256,1672604359,1672606625,2266
3639,3374183227,3512882178,1672548694,1672548947,253
3496,3554944414,3710315160,1672616923,1672619493,2570
3611,3928719932,3501281016,1672606240,1672608148,1908
3721,3716110860,3927165965,1672657987,1672659300,1313
3774,3271454397,3519282716,1672681717,1672682393,676
3433,3347446226,3467988782,1672566016,1672567366,1350
3818,3298151889,3279339278,1672603631,1672605922,2291
3623,3792020993,3619922891,1672683527,1672684725,1198
3438,3897435944,3669146016,1672651393,1672654247,2854
3706,3209481722,3410600350,1672533008,1672534483,1475
3482,3792525861,3232208416,1672647090,1672648396,1306
3681,3703348097,3683113954,1672619193,1672622770,3577
3470,3835422146,3417679834,1672660017,1672660404,387
3786,3431502855,3755233658,1672606780,1672608579,1799
3879,3514741348,3428725843,1672616293,1672618747,2454
3495,3610358027,3971806004,1672558481,1672561561,3080
3577,3791128487,3516903528,1672697478,1672698105,627
3558,3855583256,3516513251,1672674422,1672676390,1968
3815,3755737419,3689697817,1672565704,1672568651,2947
3557,3226511603,3914691363,1672613581,1672614707,1126
3668,3609933747,3512282789,1672657424,1672657941,517
3913,3770468980,3755222916,1672701615,1672702109,494
3852,3971806004,3509756823,1672626325,1672626564,239
3547,3757318448,3501567772,1672625856,1672628480,2624
3728,3780322355,3713517039,1672590175,1672591864,1689
3688,3305336154,3624297844,1672534313,1672534605,292
3646,3710008361,3778640261,1672544419,1672544647,228
3716,3714678331,3300979975,1672557248,1672560002,2754
3467,3500857494,3779301501,1672622125,1672625628,3503
3669,3460719322,3885157459,1672678287,1672679119,832
3529,3519818818,3619922891,1672569111,1672569819,708
3860,3826238375,3773332082,1672545269,1672546751,1482
3596,3480726047,3739661856,1672660209,1672663691,3482
3670,3225631197,3776559988,1672676701,1672679508,2807
3687,3737112297,3501786419,1672646921,1672650349,3428
3829,3209481722,3517697722,1672602950,1672604720,1770
3475,3839245934,3463849738,1672651136,1672652008,872
3801,3462158237,3493017654,1672615261,1672618812,3551
3890,3333918941,3923220461,1672596440,1672599882,3442
3489,3382733096,3779854934,1672633027,1672634573,1546
3452,3783641602,3974674109,1672566398,1672566592,194
3506,3895285664,3970558632,1672668984,1672670703,1719
3900,3817813340,3776117322,1672544113,1672546903,2790
3887,3756127300,3205985903,1672547529,1672548646,1117
3557,3778597171,3517172354,1672686144,1672689594,3450
3721,3451326054,3349739136,1672602000,1672603997,1997
3631,3760924079,3511601997,1672573607,1672575541,1934
3652,3701107228,3885121158,1672679996,1672682754,2758
3718,3515402792,3284947372,1672547106,1672547831,725
3552,3792546035,3437286517,1672645523,1672645837,314
3764,3448875382,3779738691,1672644613,1672646086,1473
3833,3916490839,3367971170,1672698782,1672699549,767
3760,3472312341,3757700712,1672536093,1672537219,1126
3519,3284932450,3773033649,1672551700,1672554174,2474
3679,3533079336,3701882224,1672575575,1672575865,290
3491,3613338363,3518653080,1672666322,1672669476,3154
3833,3404025196,3885157459,1672655007,1672655523,516
3921,3512392431,3505437712,1672572427,1672573113,686
3553,3394297564,3900945856,1672599080,1672600174,1094
3802,3509483172,3510554314,1672572282,1672574435,2153
3591,3772765746,3755230952,1672685697,1672686182,485
3685,3760694096,3299781901,1672550868,1672552259,1391
3656,3310125159,3757323954,1672592545,1672595190,2645
3755,3517172354,3556969573,1672549119,1672552683,3564
3511,3299443125,3715707380,1672626960,1672628642,1682
3821,3685816610,3500604680,1672678498,1672679438,940
3835,3514419100,3621461051,1672689168,1672689693,525
3608,3347446226,3801645328,1672703512,1672706150,2638
3767,3612689556,3931627862,1672634090,1672635652,1562
3466,3367111751,3757348722,1672545140,1672547335,2195
3443,3520873221,3803517637,1672637754,1672640740,2986
3862,3475349791,3460719322,1672625056,1672625164,108
3913,3309314379,3777779869,1672690877,1672692728,1851
3576,3511150845,3935913584,1672637253,1672639636,2383
3553,3335694356,3773124276,1672600573,1672603811,3238
3572,3774641380,3513410578,1672540128,1672540509,381
3427,3480726047,3411515369,1672575193,1672576783,1590
3451,3520991398,3680810086,1672625862,1672628846,2984
3566,3731646673,3774733620,1672595283,1672598323,3040
3708,3244004456,3472312341,1672576907,1672580447,3540
3810,3714128600,3772391882,1672622053,1672623539,1486
3654,3760645796,3559458968,1672659542,1672659802,260
3702,3382733096,3780909839,1672648619,1672650400,1781
3714,3452016771,3510964997,1672582060,1672584242,2182
3599,3773939399,3605221116,1672544850,1672545751,901
3772,3512282789,3627368399,1672565847,1672569177,3330
3915,3500072204,3714670620,1672567621,1672567875,254
3662,3501525100,3534829213,1672667515,1672670680,3165
3898,3510919821,3276003502,1672600278,1672601109,831
3720,3773913680,3505198734,1672634758,1672637213,2455
3488,3505111292,3500341755,1672631979,1672635394,3415
3508,3792274796,3480991549,1672646144,1672648198,2054
3515,3608922867,3520578796,1672651793,1672653683,1890
3860,3270056120,3410538749,1672653281,1672654285,1004
3495,3778926763,3512337405,1672650868,1672651424,556
3524,3779786641,3398731252,1672571181,1672572581,1400
3436,3736231757,3294747828,1672643935,1672644189,254
3522,3517358573,3462273042,1672554536,1672555026,490
3780,3791613604,3935913584,1672535279,1672538708,3429
3507,3333918941,3620292035,1672679535,1672680809,1274
3460,3970909253,3505807416,1672633210,1672633781,571
3889,3777485931,3424660806,1672575849,1672576004,155
3727,3510837901,3760040019,1672621585,1672622693,1108
3543,3667427125,3779465522,1672686512,1672688231,1719
3766,3783147088,3306175858,1672654803,1672655855,1052
3727,3534175249,3475349791,1672547229,1672548605,1376
3559,3533079336,3230868435,1672692340,1672693790,1450
3612,3792072681,3517358573,1672611992,1672612262,270
3434,3935399379,3905899155,1672555794,1672559044,3250
3659,3714120857,3450286949,1672593913,1672596620,2707
3501,3200543880,3513360004,1672563603,1672564765,1162
3524,3890739241,3826238375,1672620492,1672622774,2282
3455,3515466096,3501121099,1672666084,1672666198,114
3506,3770520359,3927165965,1672629797,1672630642,845
3519,3467988782,3622665543,1672580529,1672581343,814
3483,3710315160,3714185969,1672561947,1672565121,3174
3775,3505402439,3791753345,1672659997,1672660102,105
3767,3509483172,3231494505,1672576971,1672577358,387
3445,3312998540,3715385401,1672581758,1672583836,2078
3778,3227799827,3773837847,1672545949,1672546985,1036
3774,3757700712,3554825448,1672583937,1672585060,1123
3604,3713561276,3713589994,1672589410,1672592382,2972
3909,3777240360,3630353876,1672543101,1672546637,3536
3656,3823084403,3760040019,1672697592,1672700585,2993
3769,3300511067,3904569677,1672659718,1672661344,1626
3797,3623266256,3792538417,1672605228,1672607747,2519
3681,3510818674,3824641227,1672663550,1672666488,2938
3541,3770676872,3519028898,1672587386,1672589473,2087
3615,3776117322,3414275042,1672681463,1672684275,2812
3641,3510919821,3500841914,1672533479,1672533688,209
3566,3510919821,3226024417,1672641490,1672643923,2433
3687,3438489358,3500302272,1672558729,1672560399,1670
3496,3200308999,3792505974,1672637776,1672639118,1342
3720,3443357683,3493017654,1672595068,1672596697,1629
3566,3897456874,3349739136,1672630800,1672631790,990
3900,3770438122,3710048469,1672651453,1672652885,1432
3733,3928511283,3246370118,1672683196,1672685279,2083
3763,3604867757,3514512367,1672577552,1672578444,892
3804,3512383699,3403370192,1672594885,1672597926,3041
3606,3300229945,3609113156,1672562049,1672562528,479
3915,3777037426,3490214516,1672621949,1672622258,309
3664,3505521218,3298151889,1672647784,1672649700,1916
3455,3519142371,3276217799,1672542811,1672544563,1752
3568,3457620713,3636329663,1672652185,1672655478,3293
3619,3897456874,3887243870,1672682839,1672684654,1815
3621,3349739136,3488763230,1672685280,1672687547,2267
3685,3497671225,3396726504,1672613252,1672616468,3216
3614,3500777439,3533079336,1672669176,1672670050,874
3429,3621461051,3891672228,1672557929,1672558653,724
3467,3392943173,3880926355,1672568356,1672569554,1198
3885,3622357348,3803517637,1672700673,1672700806,133
3618,3831586487,3778134418,1672561494,1672564221,2727
3849,3617304541,3462158237,1672670230,1672673817,3587
3816,3501384020,3412006598,1672634534,1672637005,2471
3799,3776244398,3755233658,1672690568,1672691415,847
3510,3898314440,3928719932,1672643758,1672645142,1384
3830,3304971369,3445206685,1672678640,1672681156,2516
3921,3452016771,3757075324,1672552430,1672555013,2583
3720,3777091903,3757075324,1672643275,1672643690,415
3470,3472312341,3791693821,1672646438,1672646967,529
3583,3513041785,3778640261,1672670058,1672673616,3558
3790,3791693821,3283770991,1672676451,1672678567,2116
3702,3757323954,3979784676,1672560521,1672563872,3351
3478,3777624586,3852533643,1672603634,1672606662,3028
3495,3669146016,3783550022,1672559461,1672559787,326
3439,3510837901,3757193551,1672636990,1672638650,1660
3831,3623266256,3517172354,1672552386,1672554189,1803
3701,3776988674,3360616538,1672531388,1672533133,1745
3741,3520873221,3513360004,1672654179,1672657061,2882
3424,3505178849,3921648519,1672657862,1672661128,3266
3785,3236354255,3791613604,1672586944,1672588159,1215
3904,3829822608,3534126409,1672651749,1672654555,2806
3876,3518194482,3500109249,1672563535,1672565008,1473
3692,3760842815,3779892400,1672622579,1672626074,3495
3504,3245232284,3710562338,1672686171,1672687684,1513
3709,3736705719,3402697190,1672604878,1672607149,2271
3658,3401793306,3604589802,1672601939,1672602963,1024
3712,3459681410,3780253901,1672644714,1672647951,3237
3860,3480490124,3408498208,1672548718,1672549246,528
3589,3835985172,3618354185,1672576094,1672576325,231
3738,3500109249,3451326054,1672547778,1672550614,2836
3550,3834963772,3928719932,1672583136,1672585063,1927
3866,3613338363,3912891315,1672683112,1672683524,412
3739,3517687662,3472068734,1672562056,1672563274,1218
3700,3291933594,3505266860,1672548566,1672548873,307
3593,3515402792,3517887477,1672564660,1672566530,1870
3572,3778926763,3792745809,1672582709,1672584256,1547
3718,3501215099,3385323994,1672581497,1672584595,3098
3625,3792020993,3617304541,1672559932,1672561950,2018
3914,3783919913,3226511603,1672532494,1672533599,1105
3667,3792525861,3618176292,1672555009,1672558422,3413
3609,3516444201,3306412634,1672703472,1672705419,1947
3478,3773902805,3343816795,1672699317,1672700344,1027
3887,3516513251,3374183227,1672597180,1672600114,2934
3430,3520322124,3770296583,1672673448,1672674243,795
3628,3792020993,3533090502,1672585093,1672588511,3418
3732,3814305099,3613899351,1672534555,1672535174,619
3492,3897435944,3505402439,1672536288,1672537378,1090
3726,3783520186,3505634634,1672631924,1672633399,1475
3879,3972192593,3360616538,1672685837,1672688253,2416
3425,3773837847,3777485931,1672692977,1672696250,3273
3693,3505402439,3613581796,1672623511,1672626462,2951
3598,3511288998,3224330592,1672541492,1672544704,3212
3652,3972192593,3783373154,1672587268,1672587501,233
3480,3779786641,3661583097,1672536379,1672539526,3147
3594,3755992176,3201800997,1672702161,1672704474,2313
3919,3777694660,3241790910,1672570644,1672574075,3431
3840,3514818819,3534175249,1672608487,1672611021,2534
3724,3904867554,3972083617,1672558903,1672560886,1983
3902,3710735406,3783520186,1672681714,1672685117,3403
3671,3513065217,3514703118,1672693141,1672694505,1364
3432,3519416013,3512882178,1672695725,1672696850,1125
3673,3920497528,3684523966,1672618986,1672620574,1588
3662,3511317276,3410600350,1672589681,1672593148,3467
3790,3793883863,3850911686,1672670610,1672671743,1133
3483,3467988782,3686523546,1672613728,1672613867,139
3521,3783433404,3773913680,1672552635,1672553119,484
3897,3935913584,3783641602,1672650354,1672653735,3381
3675,3285204083,3509764635,1672564937,1672567021,2084
3478,3370068529,3780253901,1672655560,1672657163,1603
3506,3757294769,3510554314,1672695710,1672698384,2674
3793,3817428320,3897456874,1672573048,1672576155,3107
3825,3793743698,3703798634,1672534727,1672537252,2525
3912,3733363628,3288762795,1672692777,1672694099,1322
3863,3619922891,3272096759,1672554803,1672556198,1395
3921,3774178201,3418448389,1672533035,1672535931,2896
3551,3520639768,3757348722,1672535532,1672537639,2107
3743,3470454332,3509764635,1672628205,1672628912,707
3428,3294703680,3779656423,1672626689,1672627842,1153
3556,3349856820,3363162590,1672572321,1672572880,559
3554,3456430614,3270042456,1672606735,1672607635,900
3655,3520657891,3274906650,1672692857,1672694416,1559
3529,3779639983,3783169442,1672576108,1672579464,3356
3735,3455018347,3333918941,1672674165,1672677073,2908
3608,3792505974,3923220461,1672624343,1672625577,1234
3854,3514419100,3512282789,1672544803,1672545471,668
3447,3501459390,3337322736,1672685959,1672689003,3044
3851,3229822507,3236354255,1672540531,1672542331,1800
3878,3424445495,3715127070,1672588777,1672591601,2824
3766,3756127300,3613338363,1672604880,1672605542,662
3650,3448633776,3780909839,1672680040,1672681119,1079
3764,3410538749,3389634034,1672579126,1672579845,719
3823,3772391882,3408430195,1672694525,1672695415,890
3871,3385323994,3509893027,1672568350,1672568604,254
3907,3306175858,3715086894,1672654551,1672655666,1115
3782,3783801141,3284947372,1672629235,1672630636,1401
3634,3513327337,3829864515,1672663372,1672666643,3271
3613,3793868716,3515466096,1672534055,1672535026,971
3706,3777330107,3821054646,1672614419,1672617161,2742
3723,3298151889,3714185969,1672686060,1672687246,1186
3464,3279339278,3463740710,1672555793,1672557510,1717
3877,3424445495,3500949309,1672618671,1672618835,164
3664,3308760650,3774290799,1672662097,1672664830,2733
3572,3701005527,3396980894,1672608689,1672611561,2872
3639,3511005395,3661583097,1672547577,1672549997,2420
3439,3791436104,3793175445,1672599887,1672600320,433
3446,3625463628,3513327337,1672540758,1672543949,3191
3603,3272096759,3756127300,1672580683,1672583661,2978
3615,3713300120,3505634634,1672582395,1672584884,2489
3496,3737147209,3776559988,1672539724,1672542857,3133
3880,3975717896,3457960571,1672531616,1672533082,1466
3739,3821054646,3500525825,1672591624,1672594803,3179
3885,3501281016,3770704999,1672684511,1672686904,2393
3826,3773124276,3783919913,1672679238,1672681766,2528
3732,3701882224,3305336154,1672687830,1672690903,3073
3681,3884596900,3825881598,1672649280,1672651090,1810
3447,3319167958,3505283390,1672577036,1672579453,2417
3874,3938503547,3773735484,1672562487,1672564994,2507
3896,3299781901,3299443125,1672579128,1672579989,861
3559,3689114185,3608922867,1672558265,1672561502,3237
3867,3930242012,3520657891,1672554530,1672554926,396
3850,3811040565,3514275974,1672683753,1672685908,2155
3681,3396726504,3774031303,1672663296,1672664465,1169
3667,3773124276,3774243020,1672699523,1672702841,3318
3768,3533004959,3880926355,1672644270,1672644581,311
3736,3715443333,3710735406,1672572750,1672575556,2806
3679,3604867757,3780834916,1672696447,1672697161,714
3454,3412968120,3209481722,1672634805,1672636841,2036
3798,3501215099,3500737582,1672648946,1672650977,2031
3803,3760263530,3778667336,1672613968,1672616250,2282
3858,3760040019,3770704999,1672538540,1672541465,2925
3638,3793922324,3607768197,1672684867,1672688400,3533
3847,3505725706,3270697740,1672576198,1672577243,1045
3624,3710048469,3855583256,1672576789,1672578638,1849
3908,3779786641,3445206685,1672634051,1672636423,2372
3462,3713300120,3734451191,1672585849,1672586081,232
3824,3920625129,3500857494,1672607427,1672610535,3108
3463,3514741348,3664943873,1672681571,1672684055,2484
3619,3715974659,3299125059,1672611754,1672614738,2984
3716,3817813340,3792014516,1672669605,1672670475,870
3655,3777694660,3776988674,1672580630,1672583609,2979
3749,3240994288,3791106564,1672549374,1672551854,2480
3730,3791246640,3505402439,1672649307,1672650280,973
3557,3271454397,3367509761,1672679322,1672682826,3504
3494,3885155975,3415833929,1672677256,1672678774,1518
3917,3974674109,3625174002,1672536181,1672539088,2907
3833,3815250107,3715127070,1672568332,1672571267,2935
3676,3713691388,3970603231,1672606608,1672610169,3561
3844,3900945856,3713163045,1672637706,1672639067,1361
3442,3401793306,3274906650,1672567046,1672569467,2421
3492,3450286949,3241914067,1672571482,1672574032,2550
3774,3371455553,3385323994,1672635424,1672637944,2520
3595,3756625818,3454277788,1672557438,1672559472,2034
3596,3778040015,3336627643,1672694349,1672695502,1153
3880,3392520516,3226511603,1672567584,1672570518,2934
3619,3209481722,3661903000,1672540770,1672542923,2153
3787,3510554314,3688490530,1672640543,1672643711,3168
3476,3443357683,3638660068,1672552547,1672555469,2922
3864,3230135532,3279475486,1672544686,1672546411,1725
3864,3220031931,3780115155,1672595163,1672598219,3056
3919,3714128600,3311098437,1672543784,1672544726,942
3873,3220031931,3505995057,1672567519,1672568810,1291
3587,3931627862,3401496246,1672550146,1672552779,2633
3675,3512392431,3773913680,1672573850,1672574666,816
3803,3501525100,3711734586,1672700826,1672701372,546
3534,3428725843,3520181148,1672583987,1672585868,1881
3462,3517881647,3206837348,1672579044,1672581363,2319
3726,3360813161,3793740407,1672560230,1672562123,1893
3732,3770468980,3932478321,1672668976,1672669450,474
3602,3734118023,3613338363,1672689134,1672690763,1629
3857,3791796585,3803389195,1672534734,1672536942,2208
3779,3756474459,3773939399,1672639579,1672641266,1687
3903,3311420950,3335694356,1672638730,1672638968,238
3538,3760640999,3512499658,1672632847,1672635702,2855
3470,3501384020,3613206049,1672567727,1672570802,3075
3442,3334993594,3852533643,1672593597,1672595209,1612
3454,3772078494,3273981374,1672648189,1672651546,3357
3632,3770146716,3615113018,1672619075,1672621819,2744
3636,3774705415,3636329663,1672616759,1672620107,3348
3922,3401793306,3501215099,1672584778,1672586406,1628
3769,3448633776,3499217428,1672669500,1672672139,2639
3571,3817428320,3891672228,1672641213,1672642824,1611
3882,3383138270,3311049964,1672635294,1672637001,1707
3465,3201629017,3791693821,1672695861,1672699092,3231
3565,3715619259,3710496785,1672543476,1672546382,2906
3868,3737147209,3621184108,1672682978,1672685738,2760
3540,3440137407,3201800997,1672545987,1672548766,2779
3503,3463849738,3335694356,1672628474,1672631095,2621
3674,3387594369,3711853996,1672551736,1672554537,2801
3908,3338390596,3686227677,1672645411,1672646680,1269
3687,3811040565,3396980894,1672658436,1672661358,2922
3782,3510028805,3517737088,1672627974,1672629578,1604
3880,3500341755,3512337405,1672669857,1672670071,214
3633,3780253901,3351866415,1672613296,1672613923,627
3481,3372223551,3513410578,1672541477,1672542430,953
3618,3209481722,3755233658,1672566857,1672569037,2180
3720,3491469603,3802932312,1672679484,1672681473,1989
3655,3701664364,3500302272,1672557340,1672558220,880
3766,3418448389,3283492940,1672532927,1672535394,2467
3424,3738026330,3439673892,1672663629,1672664157,528
3716,3890739241,3399472693,1672645936,1672647313,1377
3534,3701823816,3914691363,1672629800,1672631945,2145
3528,3240994288,3351866415,1672675317,1672677648,2331
3556,3808136029,3349739136,1672657920,1672659939,2019
3668,3534543776,3909094917,1672545361,1672547066,1705
3506,3774641380,3534566651,1672696610,1672699327,2717
3755,3701424609,3225636215,1672702067,1672703575,1508
3522,3239617320,3367509761,1672608890,1672610608,1718
3915,3905899155,3519087371,1672634909,1672636942,2033
3536,3701823816,3755344363,1672545904,1672547510,1606
3586,3505178849,3501121099,1672574755,1672576515,1760
3553,3900945856,3438489358,1672687865,1672689352,1487
3488,3904569677,3716110860,1672556672,1672556970,298
3661,3412006598,3770236215,1672681265,1672684258,2993
3792,3414275042,3511601997,1672640655,1672643751,3096
3831,3441703884,3375449013,1672609227,1672611022,1795
3858,3513295938,3480490124,1672570661,1672571345,684
3539,3667427125,3791613604,1672636530,1672639477,2947
3595,3739895284,3777240360,1672608460,1672611750,3290
3769,3424445495,3505154885,1672669588,1672671239,1651
3611,3617392620,3703396825,1672666994,1672669267,2273
3542,3780253901,3613338363,1672596579,1672598979,2400
3863,3760645796,3633735593,1672600636,1672604147,3511
3724,3448875382,3516513251,1672675097,1672677561,2464
3889,3793315718,3607768197,1672574653,1672576551,1898
3565,3517697722,3380767040,1672606759,1672609808,3049
3695,3703433819,3713691388,1672557882,1672558089,207
3668,3689114185,3475349791,1672642120,1672643325,1205
3459,3730071479,3609933747,1672603006,1672603101,95
3602,3457620713,3780712350,1672545569,1672546758,1189
3565,3519028898,3283144118,1672607765,1672608294,529
3781,3773837847,3773735484,1672679862,1672681470,1608
3461,3791436104,3511005395,1672580440,1672580904,464
3908,3791046864,3780680950,1672641471,1672642434,963
3576,3802932312,3294703680,1672579123,1672582462,3339
3655,3448875382,3905196766,1672531764,1672534749,2985
3551,3613338363,3316798920,1672594370,1672597614,3244
3651,3333403880,3791246640,1672567140,1672569251,2111
3506,3682133690,3517172354,1672683728,1672686820,3092
3754,3206837348,3703396825,1672576734,1672578517,1783
3622,3600876425,3401940259,1672541105,1672543857,2752
3687,3437286517,3279339278,1672674371,1672676470,2099
3900,3793743698,3520181148,1672703131,1672703682,551
3877,3904569677,3904412440,1672578195,1672579587,1392
3571,3500347447,3715086894,1672563876,1672566176,2300
3840,3533274994,3298151889,1672655448,1672658808,3360
3753,3617116290,3713941638,1672697378,1672697984,606
3797,3310125159,3779425804,1672657893,1672658174,281
3907,3777485931,3938389661,1672617364,1672619769,2405
3785,3739154408,3511024016,1672698477,1672700933,2456
3607,3668414677,3783928182,1672635977,1672638841,2864
3879,3792745809,3236354255,1672659987,1672661639,1652
3527,3770624662,3735374579,1672558382,1672560934,2552
3563,3533929349,3780834916,1672569989,1672570831,842
3784,3511883730,3431460073,1672667094,1672668849,1755
3491,3757863420,3511150845,1672649250,1672649418,168
3660,3774290799,3500672156,1672669160,1672670091,931
3633,3793969543,3792489602,1672653802,1672654186,384
3532,3517991730,3793418209,1672684748,1672687048,2300
3655,3710315160,3515890966,1672695962,1672697147,1185
3777,3776034743,3559458968,1672667557,1672669487,1930
3756,3770296583,3516321888,1672586182,1672589724,3542
3763,3520639768,3441348818,1672567809,1672569942,2133
3809,3224968597,3713784974,1672697892,1672699299,1407
3661,3760640999,3703396825,1672532012,1672533730,1718
3693,3479851674,3512282789,1672662788,1672665717,2929
3799,3927165965,3500604680,1672638610,1672638729,119
3869,3668414677,3468041839,1672673628,1672676971,3343
3770,3977352557,3509893027,1672653572,1672654670,1098
3752,3513327337,3756625818,1672587015,1672589057,2042
3816,3660887799,3793935736,1672609737,1672612191,2454
3452,3411515369,3701107228,1672660524,1672663362,2838
3891,3783163143,3370227921,1672607137,1672608199,1062
3607,3394297564,3610358027,1672649231,1672650954,1723
3872,3773027597,3776559988,1672572033,1672574680,2647
3688,3511601997,3760721303,1672573797,1672573903,106
3583,3518653080,3380767040,1672591213,1672592443,1230
3771,3792274796,3240394404,1672650554,1672653954,3400
3820,3625174002,3757193551,1672623852,1672625260,1408
3532,3773735484,3500208903,1672598090,1672598938,848
3896,3519077659,3776084820,1672618532,1672621961,3429
3463,3512337405,3975717896,1672598307,1672600876,2569
3538,3514334067,3208452238,1672618608,1672619423,815
3896,3713784974,3701823816,1672638232,1672638707,475
3560,3760842815,3308760650,1672570563,1672570906,343
3712,3793418209,3513327337,1672695115,1672698451,3336
3797,3779425804,3773121782,1672537220,1672538460,1240
3805,3305336154,3711006062,1672647376,1672648455,1079
3514,3755344363,3380130228,1672609382,1672610423,1041
3432,3977148669,3834963772,1672680323,1672683183,2860
3577,3300979975,3773902805,1672577209,1672577507,298
3812,3354144091,3515890966,1672573996,1672576166,2170
3500,3520639768,3772236797,1672682252,1672683891,1639
3437,3792020993,3760842815,1672570187,1672571637,1450
3874,3757075324,3835422146,1672531637,1672532382,745
3753,3756625818,3776831527,1672595539,1672595774,235
3445,3510767239,3515559913,1672558695,1672559017,322
3702,3774733620,3206837348,1672698659,1672699752,1093
3567,3928511283,3803389195,1672536066,1672539096,3030
3454,3780209375,3791128487,1672635707,1672636513,806
3501,3792489602,3467779445,1672604930,1672605233,303
3470,3971806004,3533929349,1672651651,1672653257,1606
3779,3756789525,3399472693,1672566582,1672568008,1426
3616,3792274796,3399518841,1672560690,1672561211,521
3603,3714233826,3636329663,1672635396,1672636491,1095
3487,3404025196,3514818819,1672630474,1672631242,768
3878,3208957949,3779425804,1672573821,1672574067,246
3547,3354144091,3815250107,1672553200,1672556042,2842
3646,3772236797,3778134418,1672595018,1672598405,3387
3652,3516703758,3230135532,1672626854,1672627821,967
3521,3505402439,3360616538,1672617682,1672620124,2442
3771,3376467719,3774605761,1672687068,1672689915,2847
3503,3780680950,3515466096,1672693013,1672693812,799
3667,3519446663,3770520359,1672591593,1672594194,2601
3788,3777694660,3821054646,1672617243,1672618456,1213
3879,3428725843,3279475486,1672549973,1672550635,662
3583,3811040565,3500317969,1672664982,1672668437,3455
3916,3776034743,3714185969,1672671561,1672674235,2674
3821,3783169442,3703798634,1672636806,1672637905,1099
3673,3509366311,3396980894,1672579979,1672581201,1222
3634,3505154885,3668414677,1672559759,1672561355,1596
3911,3409114719,3202141727,1672546461,1672549261,2800
3456,3757630221,3501786419,1672537094,1672538522,1428
3624,3774243020,3533423872,1672618683,1672621388,2705
3803,3630353876,3500341755,1672591761,1672592989,1228
3506,3501281016,3776831527,1672581027,1672583805,2778
3430,3520115090,3505923418,1672652573,1672652959,386
3834,3970198861,3780571086,1672570910,1672572785,1875
3849,3617392620,3408498208,1672555276,1672557464,2188
3804,3803517637,3631090677,1672626585,1672627618,1033
3583,3710489491,3701107228,1672602924,1672605740,2816
3546,3492959689,3930242012,1672577039,1672577215,176
3685,3783801141,3274831810,1672587008,1672587890,882
3555,3428725843,3224330592,1672680173,1672682918,2745
3638,3311420950,3519028898,1672598863,1672602352,3489
3832,3448633776,3713163045,1672650861,1672651134,273
3571,3760364383,3200543880,1672640143,1672642884,2741
3809,3470454332,3360069849,1672608682,1672610939,2257
3463,3933894942,3757863420,1672644223,1672647620,3397
3767,3701823816,3534179433,1672690951,1672693380,2429
3638,3513327337,3686523546,1672546992,1672550335,3343
3426,3757903168,3513545422,1672639585,1672642889,3304
3711,3776034743,3448633776,1672696826,1672697501,675
3611,3500915665,3780322355,1672598011,1672600877,2866
3797,3469254160,3288224595,1672559868,1672561329,1461
3432,3791441520,3715086894,1672628896,1672630604,1708
3898,3518229776,3505283390,1672646596,1672646776,180
3552,3319167958,3364378127,1672654214,1672657242,3028
3819,3792014516,3793175445,1672547929,1672550429,2500
3647,3375449013,3715443333,1672677728,1672681135,3407
3584,3517222913,3515402792,1672696194,1672698252,2058
3498,3792072681,3514818819,1672578998,1672579775,777
3693,3513081354,3435116799,1672630273,1672632448,2175
3688,3756704774,3625463628,1672563834,1672564725,891
3847,3500915665,3897435944,1672603968,1672604150,182
3551,3283492940,3893912331,1672698872,1672700997,2125
3736,3441703884,3900276517,1672619298,1672620204,906
3768,3505266860,3202141727,1672632264,1672634220,1956
3875,3283144118,3977352557,1672570020,1672571169,1149
3455,3520416075,3439673892,1672580997,1672581704,707
3424,3783136330,3497095254,1672701370,1672704243,2873
3548,3780338697,3715986185,1672546192,1672548393,2201
3461,3515402792,3370227921,1672595431,1672596680,1249
3437,3517288083,3734915241,1672632870,1672635535,2665
3813,3271454397,3736705719,1672644229,1672645675,1446
3630,3270697740,3517288083,1672606733,1672608497,1764
3686,3441348818,3309314379,1672571773,1672574760,2987
3886,3715385401,3363162590,1672575386,1672577161,1775
3746,3608922867,3493017654,1672623031,1672625432,2401
3847,3774155692,3792538417,1672681603,1672683689,2086
3454,3511843593,3206837348,1672557517,1672557904,387
3869,3392836218,3273981374,1672699271,1672700900,1629
3441,3408498208,3333918941,1672659831,1672661939,2108
3738,3534126409,3914691363,1672574805,1672576470,1665
3489,3713941638,3510919821,1672640406,1672641286,880
3433,3711853996,3923754072,1672558931,1672559687,756
3684,3970627281,3500777439,1672533255,1672534972,1717
3896,3512722110,3812369928,1672606425,1672608582,2157
3507,3401496246,3205985903,1672642692,1672643701,1009
3431,3291933594,3756789525,1672682615,1672684734,2119
3759,3500498112,3811040565,1672591300,1672594235,2935
3545,3683113954,3470454332,1672585130,1672587549,2419
3895,3621461051,3934064792,1672697982,1672700562,2580
3698,3783550022,3231494505,1672544009,1672545408,1399
3742,3760721303,3791753345,1672635334,1672635931,597
3602,3276003502,3505266860,1672641872,1672642677,805
3717,3310039260,3773332082,1672532592,1672535374,2782
3803,3512830734,3334993594,1672562127,1672565255,3128
3624,3227799827,3228888030,1672678360,1672679462,1102
3831,3481640525,3226511603,1672548963,1672552013,3050
3586,3304971369,3898314440,1672644076,1672645340,1264
3747,3512722110,3631479562,1672675276,1672675754,478
3630,3398731252,3792745809,1672679657,1672683028,3371
3562,3300818269,3205923620,1672627708,1672629863,2155
3470,3970558632,3607768197,1672554539,1672554986,447
3596,3909094917,3935399379,1672578463,1672580612,2149
3431,3815392801,3716963089,1672609735,1672613272,3537
3898,3772391882,3500949309,1672548598,1672549640,1042
3633,3902861231,3480991549,1672620020,1672623273,3253
3553,3440107959,3831586487,1672611779,1672613523,1744
3563,3902625986,3714120857,1672548623,1672548712,89
3515,3780769110,3780872464,1672655719,1672655835,116
3720,3438078818,3500703304,1672653928,1672655463,1535
3904,3802932312,3715545685,1672679719,1672682562,2843
3868,3972083617,3713768950,1672658378,1672658809,431
3897,3630353876,3410600350,1672590816,1672594240,3424
3745,3970198861,3755404116,1672594467,1672594733,266
3889,3792389522,3360813161,1672663762,1672666906,3144
3510,3452016771,3638204468,1672673498,1672676001,2503
3537,3791436104,3520764926,1672560371,1672560909,538
3761,3435167810,3501786419,1672556972,1672558681,1709
3438,3776084820,3396726504,1672586580,1672590125,3545
3813,3680843171,3497808662,1672591726,1672594358,2632
3778,3773121782,3970558632,1672533786,1672536964,3178
3873,3621184108,3703348097,1672657095,1672659923,2828
3584,3520639768,3713589994,1672628225,1672630977,2752
3508,3926643445,3271454397,1672596483,1672598718,2235
3491,3431502855,3500737582,1672629142,1672632043,2901
3875,3424660806,3970909253,1672647555,1672650483,2928
3874,3300979975,3780115155,1672584363,1672584680,317
3898,3428027649,3839245934,1672573756,1672574976,1220
3540,3977352557,3831586487,1672693889,1672697475,3586
3785,3534126409,3825881598,1672576919,1672580444,3525
3704,3518561777,3497095254,1672583453,1672586929,3476
3655,3668747074,3680843171,1672592521,1672596006,3485
3695,3710735406,3505521218,1672609609,1672610521,912
3517,3714067076,3688220326,1672611884,1672613742,1858
3738,3533649454,3714120857,1672571388,1672573586,2198
3730,3817428320,3272030610,1672671926,1672672141,215
3664,3733558985,3703798634,1672545635,1672547402,1767
3816,3311049964,3534543776,1672573434,1672574198,764
3671,3793315718,3513065217,1672540055,1672540487,432
3742,3500857494,3279473441,1672577000,1672578648,1648
3427,3517462308,3360616538,1672679266,1672679862,596
3840,3774907131,3491469603,1672632749,1672634271,1522
3880,3710735406,3889780657,1672584752,1672587466,2714
3821,3600876425,3337322736,1672701118,1672704568,3450
3776,3514818819,3343816795,1672600996,1672603852,2856
3907,3774718695,3513360004,1672702835,1672706034,3199
3887,3354144091,3534566651,1672664560,1672664718,158
3809,3511732493,3369708250,1672684405,1672686967,2562
3544,3501281016,3711077927,1672573556,1672575091,1535
3677,3835422146,3916490839,1672666541,1672668892,2351
3577,3472312341,3373028638,1672629667,1672633025,3358
3696,3410600350,3779656423,1672683831,1672686327,2496
3634,3713829743,3402385957,1672543461,1672544548,1087
3461,3511288998,3716628503,1672627463,1672627806,343
3657,3517881647,3779738691,1672698512,1672699433,921
3519,3501567772,3906536154,1672599835,1672600400,565
3747,3979802715,3935913584,1672621532,1672623341,1809
3837,3757294769,3520416075,1672584422,1672584914,492
3768,3923220461,3225631197,1672531500,1672531599,99
3574,3791246640,3517462308,1672661406,1672663616,2210
3861,3972083617,3716110860,1672638953,1672641265,2312
3903,3791106564,3739154408,1672561866,1672565178,3312
3740,3500613459,3229974066,1672534607,1672536293,1686
3675,3294747828,3891672228,1672565803,1672569106,3303
3645,3370227921,3773124276,1672541131,1672541318,187
3454,3438489358,3701823816,1672552883,1672553452,569
3679,3779646172,3510964997,1672635708,1672639105,3397
3654,3757294769,3667427125,1672616435,1672617262,827
3864,3733558985,3802932312,1672559564,1672559643,79
3505,3456430614,3625463628,1672541182,1672544085,2903
3788,3710854064,3438078818,1672549415,1672552908,3493
3892,3792801638,3513041785,1672631610,1672632026,416
3452,3605221116,3514334067,1672668615,1672671727,3112
3822,3513065217,3367971170,1672537661,1672540022,2361
3641,3780769110,3376467719,1672553266,1672554612,1346
3594,3711734586,3792274796,1672581268,1672581464,196
3461,3783615982,3402697190,1672584804,1672586243,1439
3426,3463849738,3279339278,1672533844,1672536368,2524
3667,3615939504,3428027649,1672567320,1672568144,824
3833,3500915665,3701107228,1672548942,1672550928,1986
3609,3927403123,3394297564,1672640501,1672642821,2320
3789,3511843593,3505437712,1672641986,1672643007,1021
3471,3271752081,3755344363,1672626916,1672630488,3572
3810,3661583097,3714670620,1672687394,1672689157,1763
3746,3299443125,3770146716,1672583823,1672584897,1074
3830,3335694356,3613581796,1672566791,1672568932,2141
3804,3625174002,3773027597,1672593029,1672593746,717
3646,3791106564,3885155975,1672630279,1672631040,761
3478,3291933594,3815250107,1672697909,1672699968,2059
3856,3512282789,3283144118,1672620038,1672620486,448
3537,3621790707,3778040015,1672543028,1672546421,3393
3555,3292147449,3783615982,1672683385,1672684790,1405
3777,3783163143,3517222913,1672556410,1672559027,2617
3448,3909094917,3800257590,1672678322,1672680364,2042
3921,3714670620,3415833929,1672611372,1672613128,1756
3466,3285204083,3497095254,1672570944,1672572501,1557
3575,3884596900,3783641602,1672675119,1672676021,902
3561,3777330107,3492546679,1672640477,1672643098,2621
3780,3621184108,3757318448,1672700054,1672700133,79
3871,3669146016,3428725843,1672570237,1672573283,3046
3587,3716679950,3819767045,1672540028,1672541616,1588
3433,3512499658,3447514821,1672535160,1672535317,157
3822,3612689556,3778040015,1672611026,1672613461,2435
3790,3200543880,3793969543,1672684518,1672684754,236
3793,3626499450,3513853403,1672666570,1672667809,1239
3433,3500302272,3316800320,1672537861,1672539645,1784
3768,3450969839,3461119815,1672542117,1672544509,2392
3773,3370068529,3511883730,1672557811,1672558720,909
3625,3202804048,3505283390,1672689844,1672693044,3200
3862,3793315718,3979784676,1672678831,1672679061,230
3483,3501457103,3517358573,1672581944,1672585003,3059
3596,3834631333,3271454397,1672642614,1672644272,1658
3816,3501121099,3510642075,1672540536,1672541259,723
3813,3375449013,3834631333,1672624127,1672626899,2772
3501,3230135532,3231494505,1672661951,1672664490,2539
3689,3772391882,3615115210,1672669105,1672669914,809
3678,3270056120,3383138270,1672689619,1672691414,1795
3873,3739154408,3513327337,1672633641,1672636945,3304
3734,3519651506,3713589994,1672655652,1672656984,1332
3816,3333918941,3716272919,1672602805,1672604387,1582
3567,3495911207,3509483172,1672557480,1672559485,2005
3515,3231713082,3774031303,1672549294,1672550804,1510
3824,3617116290,3734915241,1672605107,1672607006,1899
3680,3920898925,3300229945,1672566909,1672569493,2584
3556,3703433819,3500841914,1672606875,1672610033,3158
3449,3533079336,3343132529,1672696185,1672697343,1158
3474,3757323954,3760651515,1672570785,1672573040,2255
3579,3505437712,3294703680,1672671203,1672674802,3599
3720,3515402792,3201629017,1672591104,1672592630,1526
3447,3226178937,3714666884,1672608570,1672611988,3418
3448,3774907131,3776559988,1672571188,1672573512,2324
3724,3202804048,3404025196,1672587298,1672588490,1192
3519,3520181148,3777189898,1672602751,1672603627,876
3822,3512337405,3398731252,1672648776,1672649405,629
3515,3776518452,3516741440,1672620675,1672621498,823
3794,3240394404,3792072681,1672564826,1672566006,1180
3866,3610358027,3515466096,1672574415,1672577757,3342
3542,3732131656,3500341755,1672607633,1672607716,83
3743,3520657891,3970603231,1672663303,1672664497,1194
3881,3461119815,3396980894,1672668639,1672671067,2428
3827,3284932450,3792538417,1672632000,1672633456,1456
3571,3224968597,3897435944,1672638191,1672640210,2019
3865,3505437712,3392943173,1672629454,1672629984,530
3863,3755230952,3617116290,1672621314,1672623360,2046
3564,3551389192,3294747828,1672701587,1672704172,2585
3621,3783147088,3201800997,1672587444,1672587789,345
3560,3935399379,3914691363,1672637374,1672639427,2053
3724,3533294425,3517881647,1672602029,1672604733,2704
3563,3774790271,3777624586,1672627067,1672627773,706
3606,3513410578,3396726504,1672594852,1672595526,674
3661,3386758279,3411688875,1672666640,1672668021,1381
3877,3791441520,3893912331,1672636149,1672639030,2881
3453,3337322736,3514285803,1672535509,1672538410,2901
3568,3930242012,3793740407,1672699402,1672701283,1881
3494,3510767239,3710735406,1672561454,1672562464,1010
3514,3713784974,3773033649,1672652339,1672655447,3108
3631,3414940786,3703433819,1672656912,1672658917,2005
3480,3311098437,3470454332,1672567908,1672569915,2007
3672,3632814465,3613581796,1672566792,1672569140,2348
3515,3230135532,3757630221,1672613208,1672614149,941
3836,3519850727,3904569677,1672585851,1672586460,609
3801,3379143440,3479851674,1672653271,1672654528,1257
3584,3519818818,3792442597,1672649782,1672650260,478
3446,3505434346,3208452238,1672601660,1672602719,1059
3548,3399472693,3202141727,1672627564,1672630947,3383
3832,3276348699,3240394404,1672653842,1672654326,484
3591,3711097754,3897435944,1672682124,1672683996,1872
3773,3715707380,3516444201,1672661616,1672661747,131
3566,3777240360,3850911686,1672630832,1672632565,1733
3656,3760651515,3664943873,1672693470,1672693852,382
3743,3609659642,3534179433,1672660726,1672662924,2198
3897,3611055563,3710489491,1672621158,1672621371,213
3578,3201800997,3783641602,1672662264,1672662963,699
3447,3779646172,3551389192,1672607792,1672611072,3280
3581,3203538212,3347419520,1672687478,1672689943,2465
3580,3410538749,3880926355,1672605728,1672606100,372
3705,3533747868,3605221116,1672601060,1672603023,1963
3479,3617304541,3776244398,1672616580,1672619242,2662
3866,3288762795,3934064792,1672571105,1672571233,128
3710,3311049964,3979784676,1672581896,1672583414,1518
3570,3778926763,3279473441,1672625794,1672628253,2459
3553,3792014516,3660063072,1672608573,1672610529,1956
3433,3716628503,3511791953,1672628626,1672631800,3174
3827,3793868716,3757630221,1672703434,1672705286,1852
3603,3774178201,3240394404,1672626026,1672628617,2591
3507,3520991398,3519077659,1672559096,1672561413,2317
3759,3513327337,3757903168,1672649149,1672652610,3461
3779,3770146716,3509366311,1672661550,1672663628,2078
3495,3680843171,3364726656,1672670288,1672671204,916
3773,3300979975,3201629017,1672538011,1672538151,140
3792,3271454397,3414940786,1672631309,1672634171,2862
3922,3557046880,3618354185,1672576140,1672576434,294
3754,3412006598,3517590837,1672658157,1672660298,2141
3870,3793583656,3823084403,1672627569,1672628108,539
3897,3509764635,3904412440,1672671914,1672674427,2513
3910,3451726367,3501459390,1672609109,1672609663,554
3825,3497671225,3490029863,1672621145,1672622416,1271
3465,3710489491,3756385685,1672629558,1672633023,3465
3671,3236354255,3783771827,1672590958,1672594315,3357
3889,3510642075,3850911686,1672681636,1672684491,2855
3633,3519850727,3517881647,1672584581,1672586160,1579
3756,3450969839,3418448389,1672602953,1672603876,923
3525,3360069849,3408430195,1672676317,1672679887,3570
3450,3780472203,3467988782,1672587519,1672588019,500
3524,3246370118,3510499038,1672697755,1672701250,3495
3747,3201800997,3829864515,1672566816,1672569742,2926
3839,3793407963,3513295938,1672559239,1672560094,855
3519,3514275974,3500827202,1672640948,1672642941,1993
3678,3519077659,3208957949,1672694997,1672697136,2139
3757,3517887477,3632814465,1672701638,1672705205,3567
3546,3516903528,3835985172,1672685601,1672687781,2180
3532,3435116799,3900276517,1672671111,1672673325,2214
3802,3511005395,3779646172,1672667677,1672669341,1664
3637,3819767045,3715854030,1672582530,1672583788,1258
3549,3779786641,3779465522,1672628255,1672630236,1981
3805,3228888030,3779786641,1672569433,1672571254,1821
3679,3834631333,3520416075,1672685339,1672688662,3323
3548,3914691363,3792442597,1672586681,1672589221,2540
3518,3517222913,3500841914,1672583685,1672584646,961
3899,3631090677,3336627643,1672610874,1672611272,398
3660,3510964997,3779738691,1672684638,1672687878,3240
3566,3284947372,3505111292,1672691744,1672694722,2978
3791,3436025562,3779301501,1672588057,1672588903,846
3901,3897376951,3715385401,1672553484,1672556420,2936
3820,3299125059,3815250107,1672688096,1672691525,3429
3587,3230135532,3760362417,1672578463,1672579280,817
3791,3236354255,3607768197,1672549944,1672552432,2488
3810,3271752081,3716110860,1672575131,1672577571,2440
3474,3777694660,3372223551,1672575009,1672576502,1493
3448,3824641227,3852533643,1672671542,1672671709,167
3878,3280268483,3770146716,1672693863,1672694159,296
3600,3715443333,3349739136,1672625592,1672626433,841
3880,3783433404,3226178937,1672641541,1672644396,2855
3430,3713911104,3773939399,1672665517,1672668684,3167
3631,3760263530,3513410578,1672687203,1672688379,1176
3515,3915162005,3710496785,1672699791,1672701038,1247
3749,3534126409,3513295938,1672584097,1672586889,2792
3858,3394401087,3713300120,1672639693,1672640950,1257
3513,3534764451,3773902805,1672556121,1672556546,425
3564,3438078818,3519909393,1672546815,1672549575,2760
3463,3512502036,3534764451,1672609179,1672611553,2374
3475,3500915908,3611055563,1672597582,1672598589,1007
3895,3755992176,3852533643,1672601789,1672603413,1624
3888,3884596900,3505437712,1672570791,1672574330,3539
3656,3617392620,3778667336,1672534156,1672535965,1809
3900,3703348097,3451726367,1672548468,1672548959,491
3490,3669146016,3714233826,1672624662,1672625419,757
3550,3490214516,3236499444,1672690450,1672691658,1208
3777,3715854030,3615688740,1672655675,1672655843,168
3805,3515401243,3311085279,1672671953,1672673258,1305
3853,3713517039,3514334067,1672593805,1672594924,1119
3439,3333403880,3715127070,1672595279,1672596074,795
3910,3315703693,3760645796,1672663529,1672666197,2668
3890,3776831527,3449333754,1672608542,1672608999,457
3527,3938503547,3510964997,1672651718,1672652889,1171
3682,3783641602,3533079336,1672567446,1672568788,1342
3425,3513853403,3779786641,1672622251,1672625529,3278
3864,3732131656,3509893027,1672675509,1672676707,1198
3502,3516903528,3336627643,1672663921,1672665360,1439
3845,3459681410,3513081354,1672629522,1672630829,1307
3468,3501215099,3510964997,1672648829,1672649219,390
3805,3517358573,3760362417,1672621672,1672623200,1528
3544,3515559913,3688796737,1672699315,1672700765,1450
3764,3310039260,3515439826,1672624510,1672627991,3481
3449,3478114114,3733558985,1672669897,1672671219,1322
3492,3510641433,3379143440,1672570767,1672572818,2051
3878,3516513251,3517887477,1672669310,1672669527,217
3853,3511601997,3773837847,1672653827,1672656184,2357
3489,3815250107,3312998540,1672539849,1672543444,3595
3640,3783163143,3418448389,1672659097,1672661824,2727
3690,3534357694,3411688875,1672634778,1672635045,267
3908,3285204083,3682133690,1672646207,1672648947,2740
3537,3505923418,3289817992,1672658767,1672661896,3129
3456,3792274796,3227799827,1672571919,1672574114,2195
3717,3710048469,3488686442,1672700624,1672703116,2492
3578,3714670620,3393063657,1672592284,1672593401,1117
3792,3386758279,3270042456,1672575059,1672576969,1910
3603,3512958459,3776244398,1672584829,1672586961,2132
3591,3519850727,3511024016,1672650042,1672652474,2432
3464,3495911207,3755496114,1672586833,1672589494,2661
3653,3792442597,3519282716,1672652901,1672655075,2174
3903,3935913584,3520991398,1672630995,1672632540,1545
3854,3205985903,3620292035,1672649005,1672650699,1694
3680,3421385957,3783520186,1672633383,1672633987,604
3500,3410538749,3664943873,1672597911,1672599402,1491
3865,3701664364,3440137407,1672682106,1672685039,2933
3841,3505228454,3364378127,1672688286,1672690644,2358
3825,3900276517,3711853996,1672691206,1672694577,3371
3736,3448633776,3513327337,1672592627,1672593462,835
3636,3371455553,3604589802,1672620273,1672623394,3121
3765,3688490530,3310039260,1672681174,1672684392,3218
3805,3289114629,3780209375,1672620354,1672623789,3435
3893,3783147088,3818575661,1672573962,1672575010,1048
3598,3895285664,3859868849,1672663479,1672664174,695
3860,3793922324,3380982774,1672591128,1672591592,464
3623,3928719932,3246370118,1672675455,1672678097,2642
3433,3552824113,3516703758,1672654446,1672656836,2390
3679,3514419100,3613338363,1672565795,1672568358,2563
3527,3638660068,3793935736,1672592843,1672595381,2538
3748,3279242917,3680843171,1672587527,1672590397,2870
3440,3457620713,3534357694,1672566188,1672567876,1688
3845,3755737419,3783550022,1672626846,1672627104,258
3629,3821054646,3335694356,1672653475,1672655368,1893
3496,3815250107,3774243020,1672630250,1672632093,1843
3912,3520115090,3773572967,1672612816,1672614652,1836
3678,3534566651,3510798825,1672635425,1672635497,72
3440,3776559988,3637313265,1672608790,1672611108,2318
3737,3459681410,3240394404,1672674988,1672675572,584
3781,3974674109,3438078818,1672543203,1672544939,1736
3623,3514246749,3779438325,1672667338,1672669428,2090
3858,3520322124,3792014516,1672593004,1672593466,462
3802,3825881598,3283492940,1672575251,1672578404,3153
3744,3279339278,3500347447,1672615727,1672616020,293
3802,3467779445,3792801638,1672653845,1672655694,1849
3460,3779532653,3283492940,1672625603,1672628869,3266
3539,3398731252,3457960571,1672649632,1672649994,362
3804,3701882224,3226178937,1672646567,1672649329,2762
3869,3818575661,3514246749,1672694058,1672695030,972
3711,3499217428,3770296583,1672558198,1672561671,3473
3687,3462273042,3509483172,1672537392,1672537723,331
3512,3368283077,3793922324,1672670924,1672673920,2996
3863,3516741440,3449333754,1672559267,1672562820,3553
3557,3783550022,3246370118,1672625631,1672629054,3423
3771,3770438122,3715545685,1672683132,1672684897,1765
3756,3618489670,3897456874,1672667170,1672668813,1643
3689,3534764451,3511442562,1672594290,1672595827,1537
3673,3710008361,3393063657,1672532777,1672535171,2394
3663,3279475486,3446533960,1672661508,1672663810,2302
3503,3470454332,3713589994,1672611884,1672614057,2173
3788,3756127300,3630353876,1672667266,1672670685,3419
3861,3774790271,3755158925,1672646942,1672648885,1943
3846,3509756823,3398198430,1672614530,1672617850,3320
3441,3608855425,3364378127,1672580382,1672582394,2012
3671,3225636215,3554944414,1672626304,1672627833,1529
3468,3920497528,3206837348,1672644899,1672645971,1072
3844,3533747868,3773009828,1672668956,1672671620,2664
3756,3500302272,3461119815,1672578416,1672579194,778
3687,3777240360,3408498208,1672641073,1672642768,1695
3782,3714827719,3755230952,1672575928,1672579078,3150
3830,3513545422,3621184108,1672635821,1672635991,170
3729,3511883730,3779613523,1672588551,1672588813,262
3799,3501121099,3421385957,1672688955,1672689263,308
3622,3904412440,3770676872,1672571208,1672574784,3576
3570,3279242917,3513041785,1672670556,1672673243,2687
3524,3515439826,3462273042,1672571447,1672574432,2985
3510,3512800570,3779438325,1672593223,1672595807,2584
3590,3895285664,3437286517,1672604328,1672607599,3271
3532,3780834916,3244004456,1672691805,1672693724,1919
3598,3505847380,3623266256,1672685610,1672686684,1074
3680,3417191856,3480991549,1672693737,1672695959,2222
3753,3773913680,3773033649,1672647895,1672650297,2402
3826,3205985903,3792745809,1672698637,1672701558,2921
3643,3755404116,3519416013,1672631906,1672635492,3586
3916,3772078494,3417191856,1672691306,1672694114,2808
3717,3829864515,3273981374,1672622211,1672623247,1036
3829,3783771827,3554186380,1672662044,1672662861,817
3832,3760094385,3898314440,1672539378,1672539603,225
3723,3618489670,3533188828,1672653721,1672657039,3318
3786,3511288998,3245232284,1672537936,1672540825,2889
3471,3703348097,3315703693,1672639392,1672642686,3294
3428,3777330107,3621461051,1672590337,1672593598,3261
3629,3509893027,3780427126,1672685865,1672688852,2987
3586,3900945856,3512392431,1672653249,1672655528,2279
3910,3792745809,3224811762,1672567666,1672568152,486
3444,3920497528,3711637255,1672623844,1672624162,318
3665,3760694096,3279475486,1672642546,1672644650,2104
3837,3382733096,3500841914,1672624317,1672627036,2719
3545,3713768950,3551376095,1672687093,1672688291,1198
3554,3792072681,3299125059,1672667233,1672670200,2967
3497,3905196766,3319167958,1672652647,1672655572,2925
3464,3285204083,3500737582,1672627246,1672628721,1475
3658,3755737419,3925979970,1672651762,1672652597,835
3742,3517222913,3979784676,1672669584,1672671433,1849
3482,3511288998,3715443333,1672553330,1672556768,3438
3919,3755756564,3885155975,1672594300,1672597825,3525
3586,3300979975,3517881647,1672560392,1672561586,1194
3702,3735374579,3711812325,1672582731,1672586102,3371
3493,3480991549,3452016771,1672614529,1672616418,1889
3479,3773027597,3519282716,1672664751,1672667835,3084
3852,3880926355,3792538417,1672627555,1672629677,2122
3718,3513041785,3238288884,1672561604,1672564172,2568
3725,3501457103,3815250107,1672691456,1672694133,2677
3489,3399518841,3812369928,1672535972,1672537581,1609
3567,3927165965,3737147209,1672553653,1672554758,1105
3885,3808136029,3510837901,1672578864,1672578961,97
3670,3900945856,3770236215,1672629874,1672633413,3539
3897,3713300120,3509366311,1672575110,1672577455,2345
3718,3824215187,3284932450,1672571221,1672572287,1066
3668,3772391882,3779938251,1672700958,1672702669,1711
3572,3621184108,3337322736,1672655143,1672657895,2752
3503,3613581796,3360813161,1672564143,1672564670,527
3492,3780834916,3511024016,1672542981,1672544821,1840
3756,3299443125,3661447322,1672682225,1672682599,374
3662,3757332128,3739911441,1672701622,1672702794,1172
3602,3703139663,3885121158,1672689927,1672693149,3222
3654,3612689556,3756704774,1672611835,1672612017,182
3922,3513295938,3783801141,1672577782,1672579834,2052
3724,3457620713,3224330592,1672635922,1672638640,2718
3717,3450969839,3714827719,1672702482,1672705706,3224
3900,3772391882,3248058676,1672678943,1672681099,2156
3801,3389634034,3533747868,1672629782,1672631562,1780
3685,3760640999,3773033649,1672623158,1672624358,1200
3490,3927165965,3283492940,1672662864,1672663502,638
3606,3737147209,3394297564,1672619721,1672622610,2889
3662,3429943738,3711006062,1672532348,1672533269,921
3467,3793407963,3500827202,1672671717,1672674740,3023
3501,3974674109,3500672156,1672658854,1672662404,3550
3740,3411515369,3394401087,1672684890,1672688445,3555
3432,3447672935,3686523546,1672641414,1672643617,2203
3516,3732584121,3505663516,1672598725,1672599289,564
3715,3716963089,3408498208,1672676841,1672677211,370
3507,3621184108,3826238375,1672531231,1672534302,3071
3812,3200308999,3276348699,1672638082,1672639748,1666
3510,3312998540,3408498208,1672672691,1672674010,1319
3887,3500072204,3371455553,1672566951,1672569673,2722
3741,3333918941,3520991398,1672646514,1672649029,2515
3890,3776559988,3396980894,1672624404,1672625521,1117
3661,3632814465,3363162590,1672654106,1672657322,3216
3680,3778597171,3608855425,1672664040,1672665132,1092
3763,3760645796,3533368789,1672569708,1672571993,2285
3724,3236499444,3279475486,1672574771,1672575573,802
3881,3311098437,3505634634,1672621220,1672624767,3547
3655,3518194482,3480490124,1672580242,1672580469,227
3695,3401496246,3711077927,1672654737,1672656194,1457
3496,3777814504,3824641227,1672660775,1672661446,671
3605,3839245934,3226024417,1672571887,1672574372,2485
3895,3300229945,3505198734,1672607240,1672607376,136
3743,3780834916,3364726656,1672580234,1672583570,3336
3731,3897435944,3756127300,1672597565,1672599172,1607
3770,3815250107,3779738691,1672561698,1672562162,464
3663,3711006062,3703396825,1672557566,1672560193,2627
3483,3510499038,3469254160,1672658033,1672659546,1513
3776,3518653080,3897456874,1672614835,1672615320,485
3776,3791753345,3514334067,1672669822,1672671450,1628
3674,3618697021,3777485931,1672537221,1672540011,2790
3498,3231494505,3383138270,1672670780,1672674367,3587
3595,3710489491,3757318448,1672603040,1672603115,75
3627,3500915908,3733363628,1672674205,1672676912,2707
3665,3239617320,3713911104,1672579558,1672583110,3552
3593,3206837348,3500777439,1672622760,1672624976,2216
3532,3360616538,3885155975,1672651070,1672651906,836
3761,3288224595,3509483172,1672628680,1672629507,827
3603,3607768197,3776084820,1672614637,1672618176,3539
3600,3556969573,3428725843,1672693158,1672696298,3140
3779,3703396825,3739661856,1672683019,1672685523,2504
3714,3514512367,3852686295,1672668431,1672671690,3259
3888,3757193307,3776244398,1672558630,1672560504,1874
3715,3505725706,3711734586,1672541465,1672543185,1720
3582,3487875183,3505178849,1672645740,1672648982,3242
3690,3757193307,3711853996,1672650591,1672652806,2215
3766,3757348722,3899786664,1672640623,1672642321,1698
3908,3360616538,3783550022,1672671092,1672673776,2684
3606,3401496246,3904412440,1672674389,1672675837,1448
3918,3607882826,3440137407,1672540631,1672543221,2590
3701,3635169815,3443357683,1672551275,1672551905,630
3641,3713300120,3899326793,1672600946,1672603722,2776
3818,3206837348,3824215187,1672584416,1672585651,1235
3584,3755992176,3367111751,1672574871,1672578073,3202
3837,3770624662,3701882224,1672688917,1672689806,889
3757,3511288998,3337362061,1672621616,1672623313,1697
3607,3319167958,3757348722,1672535350,1672536347,997
3800,3777189898,3349856820,1672659079,1672659657,578
3830,3630353876,3783169442,1672554763,1672555457,694
3864,3688490530,3811075491,1672650537,1672652016,1479
3906,3897134762,3363162590,1672651170,1672654592,3422
3495,3631090677,3500915665,1672673632,1672674881,1249
3666,3774290799,3520355798,1672701906,1672704864,2958
3786,3715854030,3715974659,1672639776,1672643261,3485
3582,3714120857,3779438325,1672570346,1672573881,3535
3577,3904412440,3808136029,1672595716,1672596531,815
3444,3311085279,3343816795,1672701006,1672702091,1085
3511,3386758279,3534566651,1672532818,1672533283,465
3652,3711077927,3701322924,1672683521,1672683933,412
3577,3513041785,3835422146,1672638669,1672642118,3449
3905,3284947372,3760924079,1672642878,1672646302,3424
3630,3757332128,3512830734,1672610642,1672611582,940
3831,3668533536,3609933747,1672687574,1672689133,1559
3539,3534764451,3618808151,1672688358,1672691070,2712
3686,3893912331,3755344363,1672625152,1672626938,1786
3892,3710008361,3520355798,1672625253,1672626331,1078
3559,3517222913,3520873221,1672612002,1672612443,441
3497,3777694660,3393063657,1672634813,1672636433,1620
3499,3412006598,3615688740,1672637702,1672639129,1427
3793,3685681577,3431460073,1672551912,1672554362,2450
3781,3517887477,3505179890,1672596307,1672599643,3336
3455,3429943738,3431502855,1672612216,1672614240,2024
3719,3902625986,3303410628,1672637021,1672639803,2782
3443,3513081354,3316800320,1672667351,1672670368,3017
3637,3554825448,3756127300,1672566706,1672569994,3288
3719,3439673892,3399472693,1672703623,1672706042,2419
3727,3889780657,3240994288,1672533999,1672535695,1696
3426,3604589802,3454277788,1672561804,1672564542,2738
3658,3667673649,3934064792,1672630094,1672633535,3441
3466,3778667336,3716679950,1672691756,1672694612,2856
3503,3714678331,3617392620,1672553384,1672555845,2461
3545,3757332128,3513296868,1672676486,1672678193,1707
3818,3299443125,3240994288,1672559243,1672561833,2590
3451,3895285664,3520416075,1672553915,1672553977,62
3776,3279242917,3285204083,1672671204,1672673369,2165
3707,3245232284,3513081354,1672599321,1672600305,984
3675,3510499038,3410538749,1672603742,1672604203,461
3805,3510187271,3520657891,1672590267,1672591564,1297
3870,3231494505,3626499450,1672606931,1672608478,1547
3788,3387594369,3270056120,1672597248,1672599985,2737
3687,3288224595,3274906650,1672694587,1672696111,1524
3488,3517590837,3279475486,1672584323,1672584792,469
3539,3512295534,3779301501,1672646943,1672649513,2570
3676,3446533960,3448633776,1672623409,1672626353,2944
3524,3470454332,3783771827,1672607068,1672608255,1187
3468,3336627643,3970558632,1672671805,1672672246,441
3734,3739154408,3619922891,1672588910,1672591903,2993
3600,3510028805,3780338697,1672557398,1672557699,301
3532,3904412440,3760362417,1672643497,1672646958,3461
3898,3394401087,3627368399,1672595434,1672596255,821
3572,3772765746,3300818269,1672598616,1672599966,1350
3703,3774290799,3336339664,1672607945,1672609134,1189
3903,3905899155,3826238375,1672546797,1672546997,200
3603,3780834916,3472068734,1672656379,1672656512,133
3610,3713517039,3778926763,1672677556,1672677977,421
3850,3534543776,3923220461,1672688705,1672692220,3515
3501,3209526819,3773913680,1672551619,1672553780,2161
3837,3412006598,3201800997,1672538707,1672542145,3438
3664,3685816610,3236354255,1672654013,1672657567,3554
3827,3467988782,3631479562,1672561279,1672563647,2368
3918,3755573472,3403370192,1672574561,1672578014,3453
3756,3226024417,3500302272,1672674734,1672676793,2059
3903,3480490124,3559458968,1672593454,1672595289,1835
3538,3814305099,3333403880,1672677317,1672679144,1827
3556,3713941638,3421385957,1672540385,1672542451,2066
3457,3520657891,3276217799,1672547023,1672547946,923
3455,3518565331,3791436104,1672671166,1672672638,1472
3450,3613899351,3770704999,1672701316,1672702387,1071
3739,3401940259,3225636215,1672568402,1672570210,1808
3464,3480490124,3638204468,1672641712,1672643897,2185
3594,3481640525,3470454332,1672544745,1672548162,3417
3830,3403370192,3485540729,1672603397,1672606518,3121
3477,3636329663,3774243020,1672652369,1672655761,3392
3900,3889780657,3928511283,1672602885,1672605019,2134
3833,3514512367,3448875382,1672553729,1672556464,2735
3704,3792525861,3394401087,1672563226,1672565478,2252
3830,3930242012,3280268483,1672556544,1672558534,1990
3802,3436025562,3739911441,1672675663,1672676609,946
3571,3774790271,3480991549,1672632722,1672633364,642
3789,3829822608,3739661856,1672592243,1672593074,831
3561,3510919821,3509893027,1672633582,1672635363,1781
3471,3401793306,3757193551,1672605794,1672606107,313
3488,3334951866,3625174002,1672562564,1672562978,414
3615,3783433404,3200543880,1672615754,1672618535,2781
3563,3296462324,3755756564,1672560355,1672560676,321
3814,3711734586,3510798825,1672542346,1672545608,3262
3890,3424660806,3972083617,1672651130,1672651984,854
3797,3979802715,3661903000,1672565726,1672566339,613
3691,3927403123,3703383853,1672659075,1672661111,2036
3464,3783919913,3890739241,1672562776,1672564482,1706
3577,3701322924,3273981374,1672665568,1672668671,3103
3564,3835422146,3456430614,1672588981,1672592198,3217
3430,3930242012,3970627281,1672633462,1672636461,2999
3457,3248058676,3366423342,1672571520,1672572938,1418
3669,3417679834,3463740710,1672657020,1672658924,1904
3875,3780253901,3412968120,1672602641,1672605472,2831
3619,3711919537,3435116799,1672680094,1672682292,2198
3513,3668747074,3480991549,1672549663,1672552247,2584
3902,3792014516,3511601997,1672562345,1672564721,2376
3681,3533188828,3780427126,1672561162,1672563164,2002
3610,3472068734,3715545685,1672597159,1672600343,3184
3767,3371455553,3520873221,1672604167,1672605232,1065
3871,3241914067,3315703693,1672608158,1672609206,1048
3862,3410538749,3778926763,1672576180,1672577505,1325
3510,3514741348,3515466096,1672612955,1672616549,3594
3756,3244004456,3336627643,1672543372,1672543589,217
3676,3513360004,3777147510,1672627434,1672628136,702
3807,3470454332,3774031303,1672631955,1672633854,1899
3868,3916490839,3971806004,1672614550,1672617472,2922
3680,3792538417,3609113156,1672640955,1672641644,689
3761,3970603231,3515466096,1672660884,1672663532,2648
3873,3512392431,3925979970,1672555514,1672557414,1900
3777,3505266860,3299781901,1672703703,1672704670,967
3796,3408498208,3615688740,1672567235,1672567358,123
3747,3499217428,3613416045,1672555513,1672557199,1686
3711,3776034743,3818575661,1672613882,1672615392,1510
3797,3779613523,3205923620,1672576401,1672578383,1982
3596,3632814465,3715400486,1672567533,1672567888,355
3609,3780209375,3714233826,1672552993,1672554059,1066
3456,3829822608,3231713082,1672613738,1672616502,2764
3759,3510641433,3500072204,1672544889,1672546283,1394
3591,3226511603,3793583656,1672535153,1672538731,3578
3658,3519651506,3510818674,1672545282,1672545965,683
3554,3897456874,3714067076,1672535178,1672536699,1521
3430,3236354255,3510837901,1672606853,1672609183,2330
3572,3516903528,3776117322,1672567626,1672568421,795
3805,3501525100,3893912331,1672682311,1672685036,2725
3518,3505847380,3311420950,1672594075,1672594699,624
3690,3773124276,3515401243,1672591516,1672595072,3556
3826,3446533960,3637313265,1672565249,1672568730,3481
3550,3513327337,3756474459,1672651184,1672653836,2652
3546,3431460073,3231494505,1672617986,1672618468,482
3793,3791796585,3516703758,1672685937,1672686561,624
3669,3499217428,3734118023,1672611162,1672613482,2320
3744,3680810086,3514334067,1672617133,1672620674,3541
3909,3715400486,3755158925,1672550752,1672552514,1762
3665,3902760230,3890739241,1672632418,1672634206,1788
3857,3520578796,3270042456,1672614789,1672616175,1386
3861,3517687662,3467988782,1672641759,1672642533,774
3848,3279339278,3515402792,1672618218,1672620826,2608
3511,3240394404,3480100311,1672567569,1672570833,3264
3460,3517697722,3755915206,1672577598,1672580227,2629
3478,3511150845,3225636215,1672699596,1672702583,2987
3863,3384583385,3311098437,1672586322,1672587152,830
3707,3773837847,3200308999,1672656305,1672657886,1581
3494,3711734586,3703383853,1672599727,1672601493,1766
3560,3396726504,3783373154,1672574852,1672577349,2497
3436,3511732493,3513296868,1672586847,1672587641,794
3626,3773124276,3294747828,1672574936,1672575530,594
3617,3450286949,3779892400,1672560545,1672562187,1642
3745,3609659642,3517887477,1672568830,1672571468,2638
3518,3515559913,3715400486,1672633706,1672634014,308
3500,3760094385,3375449013,1672616179,1672619074,2895
3467,3518229776,3305336154,1672578337,1672581264,2927
3467,3739661856,3505663516,1672573427,1672575456,2029
3833,3852533643,3414275042,1672557668,1672560874,3206
3868,3283770991,3636329663,1672679072,1672679678,606
3432,3501281016,3779639983,1672533426,1672535287,1861
3910,3703798634,3701823816,1672670994,1672674194,3200
3533,3925979970,3224330592,1672542611,1672542974,363
3453,3462273042,3783433404,1672628338,1672631131,2793
3501,3202804048,3714678331,1672625546,1672627363,1817
3563,3360813161,3925979970,1672586729,1672589453,2724
3667,3850911686,3777330107,1672571484,1672573898,2414
3601,3511883730,3387594369,1672586806,1672587593,787
3870,3490214516,3793175445,1672566631,1672567414,783
3856,3779613523,3533274994,1672696391,1672697410,1019
3776,3756746867,3308760650,1672649035,1672651094,2059
3840,3341893384,3414940786,1672692334,1672694967,2633
3655,3684523966,3202141727,1672539599,1672540181,582
3914,3734451191,3311049964,1672679450,1672680868,1418
3805,3757294769,3688490530,1672625368,1672628062,2694
3568,3701424609,3500044458,1672677308,1672678930,1622
3888,3533368789,3370227921,1672684890,1672686854,1964
3699,3510642075,3517222913,1672623555,1672624179,624
3672,3304155815,3713979100,1672639452,1672640292,840
3476,3774290799,3384068080,1672586398,1672588394,1996
3540,3899786664,3793418209,1672552892,1672554879,1987
3852,3401793306,3701884158,1672568012,1672569322,1310
3549,3338083680,3778597171,1672651387,1672651746,359
3471,3777240360,3478114114,1672546094,1672548980,2886
3532,3793922324,3611055563,1672620124,1672621998,1874
3634,3439673892,3225631197,1672681712,1672682377,665
3521,3231713082,3520764926,1672691160,1672692277,1117
3578,3736705719,3500613493,1672551177,1672552432,1255
3457,3714067076,3615737355,1672581309,1672582877,1568
3648,3404025196,3402697190,1672703551,1672705854,2303
3509,3934064792,3457620713,1672568125,1672570727,2602
3610,3488686442,3793418209,1672533543,1672535523,1980
3879,3774907131,3791436104,1672537629,1672539970,2341
3759,3776559988,3772765746,1672623458,1672624952,1494
3615,3414049538,3923754072,1672585674,1672587253,1579
3730,3689697817,3755573472,1672618979,1672620316,1337
3721,3514971533,3814677862,1672566526,1672569112,2586
3487,3421877923,3760364383,1672572882,1672572949,67
3869,3711637255,3310125159,1672609792,1672611549,1757
3501,3604589802,3710496785,1672560089,1672563051,2962
3809,3491469603,3500498112,1672614731,1672614971,240
3432,3509764635,3814677862,1672613018,1672615446,2428
3451,3220031931,3270697740,1672653412,1672656768,3356
3545,3760362417,3279475486,1672580924,1672583386,2462
3533,3293835352,3780322355,1672676585,1672678706,2121
3591,3780472203,3311049964,1672539878,1672541571,1693
3900,3510642075,3505437712,1672555594,1672558213,2619
3866,3294747828,3755573472,1672685720,1672686424,704
3694,3714670620,3793883863,1672591016,1672593249,2233
3807,3715086894,3225631197,1672619441,1672620236,795
3694,3533294425,3711637255,1672634050,1672636298,2248
3846,3300511067,3497808662,1672552011,1672554953,2942
3793,3519909393,3515559913,1672608321,1672609049,728
3585,3460719322,3373089838,1672546755,1672548985,2230
3650,3296462324,3739911441,1672570275,1672570690,415
3739,3554825448,3664943873,1672549502,1672550964,1462
3909,3533090502,3513410578,1672568135,1672568861,726
3866,3701136026,3783433404,1672647536,1672650137,2601
3585,3791796585,3457960571,1672674678,1672677046,2368
3526,3615939504,3336339664,1672614549,1672614774,225
3732,3710496785,3760364383,1672637152,1672638931,1779
3847,3410600350,3755158925,1672602371,1672603097,726
3894,3225029895,3811075491,1672679567,1672683087,3520
3801,3424660806,3240994288,1672614522,1672614588,66
3649,3858172636,3310039260,1672564032,1672565341,1309
3684,3916490839,3715986185,1672567495,1672568253,758
3908,3401940259,3701424609,1672569689,1672570704,1015
3627,3793743698,3409114719,1672576075,1672579315,3240
3725,3825881598,3401793306,1672642235,1672643542,1307
3549,3731646673,3932478321,1672649921,1672650530,609
3602,3513410578,3829864515,1672605332,1672606195,863
3890,3488763230,3792525861,1672603419,1672605749,2330
3820,3783928182,3272716462,1672560917,1672562444,1527
3434,3774790271,3760842815,1672671432,1672674291,2859
3459,3311098437,3780322355,1672537918,1672540817,2899
3701,3389634034,3777624586,1672651614,1672652310,696
3533,3510554314,3399518841,1672658603,1672661003,2400
3896,3438489358,3774876004,1672670596,1672671222,626
3922,3889780657,3778597171,1672564417,1672566919,2502
3685,3780253901,3834963772,1672556777,1672558682,1905
3646,3517887477,3661447322,1672540534,1672542561,2027
3632,3500915908,3711006062,1672644048,1672645329,1281
3685,3367509761,3533747868,1672679400,1672682068,2668
3752,3271752081,3360813161,1672602415,1672605737,3322
3811,3770520359,3713589994,1672546123,1672548473,2350
3707,3367111751,3774705415,1672659200,1672659474,274
3453,3441348818,3803517637,1672626089,1672627057,968
3728,3480726047,3383138270,1672675906,1672676982,1076
3744,3450969839,3701107228,1672599371,1672599633,262
3873,3831586487,3760364383,1672651261,1672653113,1852
3504,3701823816,3441703884,1672699005,1672701426,2421
3568,3534829213,3714128600,1672650988,1672653944,2956
3542,3779786641,3533747868,1672644953,1672645645,692
3810,3551399764,3683113954,1672596892,1672597754,862
3860,3935487534,3916490839,1672688378,1672688894,516
3544,3517881647,3885537225,1672638281,1672641680,3399
3698,3770296583,3755737419,1672666043,1672669260,3217
3592,3463849738,3793407963,1672607801,1672609131,1330
3588,3914691363,3792538417,1672633215,1672634582,1367
3701,3815250107,3319167958,1672582385,1672585609,3224
3531,3360813161,3392836218,1672601910,1672603902,1992
3848,3773902805,3927599181,1672573859,1672576905,3046
3521,3715385401,3386758279,1672546390,1672547907,1517
3512,3739895284,3505995057,1672612212,1672614373,2161
3831,3509764635,3337362061,1672548383,1672548703,320
3719,3701664364,3343816795,1672605112,1672608278,3166
3514,3511732493,3516741440,1672663761,1672665706,1945
3771,3760721303,3500915908,1672661879,1672662658,779
3483,3300229945,3856606678,1672547290,1672549662,2372
3670,3770146716,3684523966,1672672932,1672674463,1531
3430,3760924079,3780209375,1672571748,1672573706,1958
3903,3357689359,3276348699,1672620977,1672622541,1564
3669,3289114629,3360069849,1672533600,1672536379,2779
3658,3755344363,3512830734,1672618826,1672621013,2187
3519,3711000597,3450286949,1672643133,1672646646,3513
3599,3637313265,3808136029,1672533347,1672536227,2880
3551,3811075491,3793418209,1672598660,1672600284,1624
3617,3414275042,3279473441,1672638575,1672639518,943
3896,3298151889,3688220326,1672590228,1672592768,2540
3505,3513853403,3760842815,1672544920,1672545856,936
3904,3500302272,3701322924,1672677891,1672678099,208
3580,3485540729,3713589994,1672579678,1672580568,890
3589,3756704774,3773033649,1672607332,1672608207,875
3555,3760694096,3414275042,1672618563,1672619277,714
3645,3780872464,3977148669,1672554995,1672557488,2493
3675,3276269264,3701424609,1672539848,1672539940,92
3780,3609113156,3501281016,1672701241,1672703077,1836
3612,3475349791,3516513251,1672567930,1672571159,3229
3737,3533188828,3556969573,1672571577,1672573882,2305
3753,3488686442,3852533643,1672620072,1672623139,3067
3564,3202804048,3244004456,1672556926,1672558411,1485
3432,3380130228,3270697740,1672699298,1672700326,1028
3829,3459681410,3633735593,1672643918,1672645064,1146
3646,3792505974,3411515369,1672672101,1672672220,119
3817,3400069268,3660887799,1672569624,1672569685,61
3528,3934064792,3505923418,1672673900,1672674258,358
3426,3772391882,3414049538,1672687622,1672688277,655
3742,3979802715,3283144118,1672682820,1672685567,2747
3589,3517887477,3294703680,1672667700,1672670098,2398
3783,3480991549,3613581796,1672603734,1672605680,1946
3618,3755532873,3757332128,1672633371,1672634110,739
3478,3510028805,3887243870,1672607112,1672607436,324
3598,3513327337,3505111292,1672600274,1672602188,1914
3735,3333403880,3404025196,1672537738,1672538084,346
3832,3773027597,3757332128,1672572281,1672575723,3442
3713,3390660440,3396726504,1672574605,1672575871,1266
3803,3412968120,3757383891,1672660183,1672660626,443
3721,3315703693,3501121099,1672702454,1672705084,2630
3896,3824215187,3713691388,1672667578,1672670250,2672
3630,3246370118,3311098437,1672646437,1672649471,3034
3595,3500737582,3618354185,1672681829,1672682386,557
3715,3887243870,3638204468,1672560349,1672561378,1029
3440,3792442597,3488686442,1672672267,1672675220,2953
3901,3429943738,3350095157,1672688817,1672691514,2697
3876,3770520359,3514275974,1672586385,1672588305,1920
3822,3701882224,3333918941,1672564940,1672568211,3271
3848,3623266256,3715986185,1672668436,1672669236,800
3535,3551376095,3347446226,1672623744,1672626853,3109
3434,3605221116,3638204468,1672604073,1672606699,2626
3707,3685681577,3664943873,1672537992,1672539770,1778
3510,3300511067,3428027649,1672599334,1672602771,3437
3693,3938389661,3517881647,1672590440,1672593546,3106
3496,3491469603,3776988674,1672576444,1672578576,2132
3832,3792072681,3511601997,1672699034,1672702430,3396
3772,3636329663,3370227921,1672697343,1672699716,2373
3910,3914691363,3512383699,1672586606,1672588129,1523
3858,3792949946,3756385685,1672555765,1672556371,606
3498,3661583097,3889780657,1672605287,1672605906,619
3645,3757700712,3515439826,1672617904,1672619172,1268
3447,3455018347,3621790707,1672575135,1672577844,2709
3726,3429943738,3493017654,1672657074,1672660101,3027
3525,3350095157,3701884158,1672536327,1672537582,1255
3593,3623266256,3294703680,1672646376,1672647639,1263
3427,3394401087,3461119815,1672537237,1672540456,3219
3550,3783340788,3885121158,1672641735,1672642615,880
3780,3898314440,3792538417,1672692753,1672695340,2587
3806,3438489358,3417679834,1672575523,1672577673,2150
3902,3979802715,3241790910,1672606502,1672607570,1068
3627,3710489491,3451691949,1672665253,1672667651,2398
3849,3760694096,3533004959,1672588955,1672591676,2721
3464,3920497528,3905196766,1672700246,1672702016,1770
3578,3375449013,3398198430,1672618248,1672620892,2644
3634,3774641380,3334993594,1672533692,1672533987,295
3516,3533079336,3335694356,1672657981,1672659305,1324
3838,3520764926,3485540729,1672631546,1672634793,3247
3532,3437286517,3396980894,1672630274,1672632330,2056
3657,3411515369,3622357348,1672628711,1672628799,88
3894,3512282789,3306412634,1672676188,1672679321,3133
3792,3401793306,3448633776,1672532900,1672535185,2285
3497,3232208416,3779646172,1672602739,1672603471,732
3677,3493017654,3755737419,1672692236,1672692517,281
3652,3710562338,3793883863,1672578493,1672580884,2391
3787,3311085279,3341893384,1672677303,1672680548,3245
3554,3334993594,3520639768,1672695405,1672697807,2402
3528,3514285803,3533274994,1672702964,1672706513,3549
3887,3421385957,3408498208,1672640609,1672643323,2714
3919,3398731252,3462636434,1672697139,1672698433,1294
3819,3500525825,3517697722,1672535035,1672538229,3194
3693,3449333754,3534764451,1672625968,1672627314,1346
3489,3756127300,3511843593,1672645660,1672647998,2338
3912,3459681410,3375449013,1672640673,1672644113,3440
3880,3226024417,3773939399,1672658563,1672659286,723
3851,3927165965,3228888030,1672532577,1672535813,3236
3561,3241914067,3513545422,1672628491,1672630788,2297
3715,3338083680,3500604680,1672531901,1672533949,2048
3514,3778667336,3424660806,1672554373,1672556692,2319
3802,3516741440,3533649454,1672695119,1672695650,531
3818,3511317276,3505847380,1672653804,1672655110,1306
3627,3613899351,3500072204,1672679982,1672681317,1335
3544,3891672228,3755756564,1672622996,1672624527,1531
3498,3668414677,3289817992,1672532507,1672534024,1517
3894,3452016771,3791436104,1672590840,1672594366,3526
3440,3435167810,3932478321,1672622481,1672624152,1671
3695,3505111292,3618489670,1672634866,1672638286,3420
3764,3793315718,3757323954,1672567479,1672570396,2917
3453,3236354255,3283144118,1672663003,1672664232,1229
3769,3900898992,3739154408,1672569009,1672569158,149
3815,3505198734,3739911441,1672675384,1672676910,1526
3516,3520416075,3760040019,1672645838,1672646089,251
3583,3224811762,3605221116,1672665718,1672668465,2747
3831,3509764635,3755756564,1672563266,1672564941,1675
3556,3500709774,3557046880,1672545613,1672545940,327
3496,3783373154,3457960571,1672600638,1672601505,867
3524,3505521218,3408498208,1672589651,1672591508,1857
3863,3802932312,3515559913,1672575260,1672577630,2370
3711,3623266256,3736705719,1672700945,1672702837,1892
3870,3517358573,3398198430,1672592691,1672593778,1087
3804,3757348722,3715974659,1672650829,1672653799,2970
3529,3534566651,3631479562,1672631384,1672631479,95
3435,3517222913,3513327337,1672640607,1672641204,597
3618,3760364383,3289817992,1672571313,1672572971,1658
3899,3349739136,3410538749,1672541389,1672544204,2815
3663,3467779445,3974674109,1672575885,1672578286,2401
3737,3248058676,3756127300,1672671293,1672674311,3018
3823,3818575661,3279242917,1672573644,1672575346,1702
3776,3621184108,3792442597,1672556386,1672558555,2169
3555,3836241528,3497808662,1672580098,1672580204,106
3441,3977148669,3360616538,1672577375,1672578715,1340
3602,3885157459,3711097754,1672672957,1672674591,1634
3870,3511791953,3792072681,1672608847,1672609333,486
3705,3757348722,3757323954,1672590543,1672591514,971
3427,3492959689,3270042456,1672586474,1672589741,3267
3579,3713979100,3915162005,1672643133,1672643659,526
3619,3701107228,3435116799,1672643930,1672647296,3366
3530,3791441520,3398198430,1672702015,1672703284,1269
3685,3902760230,3755915206,1672547327,1672547608,281
3692,3932478321,3777189898,1672612520,1672613098,578
3517,3371455553,3792072681,1672628193,1672629730,1537
3874,3330340793,3517590837,1672671010,1672672327,1317
3604,3715086894,3902760230,1672595175,1672596669,1494
3881,3384068080,3224330592,1672574217,1672577210,2993
3570,3511317276,3793583656,1672613627,1672614812,1185
3777,3755915206,3519282716,1672670403,1672670761,358
3583,3206837348,3518561777,1672585122,1672586987,1865
3792,3680843171,3500827202,1672599675,1672601638,1963
3746,3209526819,3792274796,1672693759,1672695496,1737
3575,3627368399,3551376095,1672570495,1672572395,1900
3501,3793922324,3774641380,1672619632,1672621312,1680
3825,3711919537,3311085279,1672551931,1672552421,490
3593,3604589802,3760094385,1672647507,1672650442,2935
3516,3610358027,3780680950,1672626587,1672629037,2450
3813,3533368789,3516741440,1672703815,1672704749,934
3670,3802932312,3293835352,1672629413,1672629898,485
3891,3513853403,3630353876,1672571090,1672573183,2093
3832,3774907131,3364726656,1672653724,1672654823,1099
3687,3914691363,3716679950,1672696570,1672699587,3017
3698,3500709774,3793883863,1672548392,1672551167,2775
3717,3738026330,3490029863,1672686385,1672688344,1959
3665,3226178937,3519077659,1672676371,1672676703,332
3735,3408430195,3500827202,1672606390,1672608375,1985
3691,3225636215,3319167958,1672532567,1672532998,431
3627,3637313265,3713829743,1672635485,1672638912,3427
3478,3756704774,3501281016,1672570679,1672573081,2402
3841,3974674109,3711006062,1672659078,1672659996,918
3536,3755222916,3514285803,1672666439,1672667481,1042
3464,3469254160,3421385957,1672555728,1672559029,3301
3516,3488686442,3515402792,1672562188,1672562778,590
3828,3734118023,3554825448,1672657097,1672658784,1687
3484,3615087943,3614740489,1672607065,1672609724,2659
3555,3431502855,3792546035,1672654973,1672657884,2911
3654,3757318448,3715974659,1672639145,1672640019,874
3554,3408498208,3734915241,1672607373,1672610644,3271
3635,3500613459,3793315718,1672664144,1672664749,605
3765,3372223551,3668414677,1672557088,1672557972,884
3479,3777091903,3895285664,1672600786,1672600910,124
3616,3533423872,3716110860,1672614812,1672615550,738
3509,3517887477,3605221116,1672701457,1672705028,3571
3494,3402697190,3757193307,1672695758,1672697947,2189
3733,3270042456,3714666884,1672585906,1672588745,2839
3725,3817428320,3440107959,1672602581,1672603996,1415
3868,3793883863,3409114719,1672588265,1672589019,754
3645,3611055563,3393063657,1672592329,1672592712,383
3452,3615115210,3938389661,1672647087,1672650617,3530
3591,3519077659,3208452238,1672548877,1672551139,2262
3650,3201629017,3703396825,1672671118,1672673614,2496
3822,3610358027,3701247948,1672554293,1672554797,504
3503,3316800320,3311049964,1672679513,1672682338,2825
3843,3401940259,3972192593,1672677611,1672679356,1745
3793,3206837348,3825881598,1672591045,1672594149,3104
3653,3773837847,3778926763,1672623106,1672624545,1439
3558,3625174002,3272096759,1672545537,1672547730,2193
3589,3853629553,3623266256,1672545389,1672547745,2356
3554,3513018485,3760640999,1672559816,1672560027,211
3576,3457960571,3337322736,1672581699,1672582746,1047
3555,3774718695,3511601997,1672549501,1672552409,2908
3670,3774790271,3897435944,1672590567,1672593520,2953
3586,3777624586,3701884158,1672658711,1672662067,3356
3503,3518194482,3624297844,1672669359,1672671386,2027
3775,3514285803,3418448389,1672626637,1672628515,1878
3471,3519416013,3428027649,1672583140,1672585027,1887
3547,3500737582,3556969573,1672653300,1672653570,270
3633,3500827202,3783373154,1672557976,1672558156,180
3425,3897435944,3373089838,1672562416,1672562624,208
3872,3514324011,3417191856,1672625216,1672626769,1553
3710,3736705719,3710496785,1672591709,1672594173,2464
3651,3811075491,3515466096,1672695566,1672696778,1212
3917,3431460073,3398731252,1672573815,1672575524,1709
3465,3777037426,3802932312,1672619283,1672621247,1964
3810,3777189898,3225029895,1672701566,1672701786,220
3532,3714827719,3773913680,1672617667,1672620809,3142
3730,3501457103,3792525861,1672614439,1672615302,863
3438,3836241528,3701373490,1672537085,1672537650,565
3783,3776988674,3554825448,1672671492,1672674727,3235
3615,3513360004,3623266256,1672605770,1672608665,2895
3450,3779656423,3491684096,1672533362,1672536942,3580
3705,3334974375,3239617320,1672628453,1672630661,2208
3583,3514275974,3382733096,1672600853,1672602482,1629
3685,3757294769,3510499038,1672563166,1672563515,349
3738,3421877923,3792442597,1672630690,1672631677,987
3718,3276003502,3510798825,1672586180,1672588229,2049
3556,3760094385,3375449013,1672564616,1672566951,2335
3559,3501457103,3783615982,1672601279,1672603410,2131
3519,3703798634,3505481368,1672669527,1672672025,2498
3800,3615087943,3343132529,1672566625,1672569178,2553
3636,3733363628,3236499444,1672673583,1672673859,276
3602,3792274796,3604589802,1672531707,1672532512,805
3904,3711097754,3311085279,1672698949,1672699385,436
3789,3701247948,3510837901,1672696950,1672698584,1634
3702,3701424609,3977352557,1672672696,1672674750,2054
3520,3429943738,3780834916,1672546357,1672549053,2696
3837,3610870949,3534357694,1672541823,1672543902,2079
3530,3625463628,3499217428,1672661131,1672662693,1562
3661,3457960571,3347419520,1672541543,1672542536,993
3769,3803517637,3773939399,1672610553,1672612525,1972
3694,3792389522,3554944414,1672559567,1672560976,1409
3783,3715854030,3510028805,1672682710,1672685348,2638
3629,3617116290,3520873221,1672642424,1672645439,3015
3496,3510767239,3517590837,1672612894,1672613995,1101
3434,3780115155,3975717896,1672618699,1672621443,2744
3751,3713517039,3299125059,1672606907,1672608312,1405
3530,3613899351,3559458968,1672546539,1672547398,859
3709,3834963772,3774907131,1672677678,1672679535,1857
3431,3272716462,3858172636,1672561661,1672562336,675
3841,3661447322,3897134762,1672582933,1672586218,3285
3768,3514956366,3517737088,1672565940,1672568404,2464
3874,3760721303,3500827202,1672622349,1672624794,2445
3833,3714670620,3338390596,1672677044,1672678550,1506
3628,3226024417,3511442562,1672578810,1672581566,2756
3464,3505807416,3370227921,1672615688,1672616128,440
3519,3793583656,3760924079,1672582017,1672583264,1247
3450,3288762795,3462273042,1672628698,1672631815,3117
3762,3559731671,3970558632,1672680084,1672680441,357
3437,3392943173,3669146016,1672650232,1672652420,2188
3749,3623266256,3335694356,1672602070,1672602538,468
3708,3231713082,3493017654,1672564061,1672566504,2443
3787,3505283390,3505228454,1672644019,1672646296,2277
3656,3632814465,3512379024,1672541002,1672541184,182
3628,3368283077,3608855425,1672589578,1672591573,1995
3625,3445206685,3902861231,1672673141,1672675188,2047
3581,3357289672,3360813161,1672564210,1672567006,2796
3563,3710735406,3791436104,1672563508,1672565415,1907
3788,3209526819,3977352557,1672602827,1672605623,2796
3726,3770438122,3716272919,1672543571,1672546505,2934
3763,3683113954,3551376095,1672589897,1672590390,493
3884,3779465522,3755532873,1672642030,1672643953,1923
3595,3367509761,3685816610,1672583849,1672584301,452
3856,3979802715,3270042456,1672640605,1672640927,322
3497,3715986185,3619922891,1672653178,1672655570,2392
3843,3792020993,3793935736,1672614390,1672615712,1322
3763,3505283390,3755573472,1672654273,1672654420,147
3638,3421385957,3714678331,1672656525,1672656665,140
3663,3316800320,3337362061,1672588317,1672591471,3154
3745,3757075324,3685816610,1672543899,1672545429,1530
3648,3755230952,3510798825,1672568959,1672570868,1909
3481,3760364383,3610870949,1672652120,1672655557,3437
3703,3760924079,3500949309,1672567875,1672571457,3582
3536,3835422146,3447514821,1672680268,1672683544,3276
3697,3509366311,3613206049,1672544324,1672546367,2043
3544,3776117322,3661583097,1672597211,1672599882,2671
3778,3621790707,3490029863,1672676323,1672678234,1911
3464,3755496114,3364378127,1672687825,1672690618,2793
3441,3773902805,3823084403,1672548873,1672550018,1145
3476,3791128487,3773027597,1672683952,1672687251,3299
3515,3760094385,3783169442,1672588769,1672591571,2802
3676,3514741348,3402385957,1672611216,1672612085,869
3641,3803389195,3534829213,1672567974,1672570751,2777
3573,3604867757,3739911441,1672702197,1672704054,1857
3783,3760640999,3497095254,1672671449,1672671897,448
3708,3757863420,3511150845,1672662947,1672663363,416
3615,3552824113,3510919821,1672691892,1672694172,2280
3630,3660887799,3664943873,1672543783,1672546162,2379
3783,3618808151,3515890966,1672599412,1672602482,3070
3915,3972083617,3384068080,1672702820,1672702976,156
3820,3380982774,3770296583,1672538428,1672540803,2375
3807,3505402439,3431460073,1672628160,1672631624,3464
3628,3556969573,3756746867,1672644196,1672646661,2465
3767,3519446663,3638204468,1672536492,1672537764,1272
3621,3289114629,3500737582,1672606813,1672607773,960
3663,3902760230,3770296583,1672675695,1672677255,1560
3803,3500949309,3885157459,1672531922,1672532390,468
3624,3660063072,3514246749,1672698344,1672699565,1221
3806,3512830734,3333918941,1672676164,1672678465,2301
3531,3304155815,3424445495,1672589982,1672590063,81
3688,3228888030,3713768950,1672619752,1672621594,1842
3763,3500525825,3770624662,1672590099,1672593685,3586
3751,3773121782,3470454332,1672586338,1672589505,3167
3901,3715127070,3463849738,1672539045,1672541313,2268
3618,3783163143,3824215187,1672564271,1672566407,2136
3482,3519651506,3802932312,1672697328,1672700438,3110
3922,3711097754,3713561276,1672651469,1672653079,1610
3427,3510798825,3201629017,1672655021,1672657706,2685
3722,3414940786,3791106564,1672562003,1672564171,2168
3477,3390660440,3490214516,1672689632,1672692091,2459
3515,3505725706,3309314379,1672686801,1672688769,1968
3535,3516903528,3900898992,1672699134,1672702052,2918
3911,3414940786,3441703884,1672538839,1672540687,1848
3509,3517358573,3449639012,1672637888,1672638316,428
3730,3501786419,3711077927,1672640898,1672642222,1324
3885,3514246749,3701107228,1672673896,1672675754,1858
3918,3428725843,3475349791,1672564794,1672566222,1428
3852,3713517039,3200543880,1672676922,1672680060,3138
3683,3448633776,3330340793,1672686732,1672689236,2504
3728,3279475486,3410600350,1672696546,1672697989,1443
3648,3387594369,3850911686,1672612204,1672615137,2933
3807,3711077927,3802932312,1672550576,1672553337,2761
3582,3793175445,3632814465,1672623320,1672625391,2071
3453,3305336154,3774243020,1672610224,1672611944,1720
3718,3410600350,3513360004,1672668174,1672669827,1653
3474,3500317969,3760640999,1672623037,1672623646,609
3697,3736231757,3928719932,1672609675,1672610997,1322
3626,3902760230,3534829213,1672552269,1672554336,2067
3819,3475349791,3518229776,1672699048,1672700353,1305
3899,3349739136,3793743698,1672699326,1672699890,564
3538,3755233658,3780872464,1672701161,1672703254,2093
3523,3715986185,3777037426,1672643114,1672645671,2557
3668,3897376951,3455018347,1672673012,1672674515,1503
3847,3440107959,3517600136,1672670527,1672672224,1697
3866,3230135532,3402697190,1672671150,1672672681,1531
3780,3303410628,3514285803,1672618217,1672621260,3043
3808,3760040019,3770468980,1672665927,1672666068,141
3717,3625174002,3701005527,1672575412,1672575916,504
3826,3831586487,3631090677,1672697660,1672699733,2073
3817,3315279093,3452016771,1672560595,1672563169,2574
3688,3815250107,3772765746,1672664068,1672665161,1093
3479,3231494505,3701322924,1672573313,1672575321,2008
3687,3757630221,3436257398,1672557281,1672558609,1328
3727,3429943738,3710048469,1672612276,1672612682,406
3499,3757294769,3347446226,1672613422,1672614295,873
3742,3619922891,3835985172,1672672632,1672674403,1771
3790,3300511067,3399518841,1672641749,1672642130,381
3661,3513410578,3760924079,1672686427,1672689255,2828
3811,3608232640,3774605761,1672635617,1672635778,161
3446,3931627862,3510499038,1672543367,1672544486,1119
3791,3755158925,3791106564,1672609251,1672612524,3273
3469,3475349791,3505228454,1672686227,1672688566,2339
3649,3270056120,3411688875,1672540176,1672540685,509
3847,3770468980,3492959689,1672596759,1672599779,3020
3893,3777091903,3519446663,1672574563,1672576925,2362
3793,3755222916,3823084403,1672703831,1672705757,1926
3532,3467779445,3686523546,1672601561,1672604956,3395
3667,3972083617,3631090677,1672599730,1672602350,2620
3729,3497095254,3779613523,1672632966,1672634215,1249
3829,3552824113,3500857494,1672613892,1672616774,2882
3768,3435167810,3228888030,1672663654,1672666368,2714
3773,3772078494,3884596900,1672652935,1672655722,2787
3871,3780712350,3534126409,1672620738,1672620861,123
3792,3715400486,3920497528,1672604084,1672607072,2988
3814,3701884158,3760640999,1672695837,1672698595,2758
3632,3757193307,3280268483,1672602287,1672602990,703
3554,3792745809,3760040019,1672632070,1672635007,2937
3473,3511791953,3500703304,1672617810,1672620982,3172
3646,3793935736,3630353876,1672532318,1672533645,1327
3571,3715986185,3515401243,1672587737,1672588473,736
3431,3970603231,3682133690,1672643207,1672644196,989
3795,3241914067,3711853996,1672559815,1672562820,3005
3789,3701882224,3435116799,1672639327,1672641041,1714
3857,3533274994,3834631333,1672633188,1672636222,3034
3822,3760263530,3783801141,1672554730,1672555780,1050
3457,3300818269,3319167958,1672569324,1672569932,608
3776,3793883863,3732131656,1672612964,1672616434,3470
3679,3512502036,3760040019,1672644823,1672648274,3451
3459,3480490124,3777779869,1672658849,1672661934,3085
3876,3979784676,3905196766,1672692197,1672693374,1177
3844,3780680950,3738026330,1672629366,1672632642,3276
3516,3639050419,3737972328,1672673785,1672674587,802
3558,3351696332,3792538417,1672630426,1672633807,3381
3805,3241790910,3713979100,1672532143,1672533475,1332
3711,3315703693,3424445495,1672561740,1672565228,3488
3591,3926643445,3780769110,1672652408,1672652730,322
3908,3859868849,3202141727,1672544943,1672547550,2607
3732,3711000597,3205985903,1672642444,1672645666,3222
3447,3517697722,3774718695,1672636495,1672637966,1471
3895,3914691363,3604867757,1672600764,1672603985,3221
3435,3855583256,3512946768,1672638427,1672639795,1368
3678,3923754072,3505725706,1672628041,1672629095,1054
3634,3505663516,3780253901,1672585587,1672586561,974
3522,3505634634,3609933747,1672625451,1672627447,1996
3714,3668414677,3811040565,1672586381,1672587539,1158
3751,3779301501,3792014516,1672697696,1672698590,894
3710,3402697190,3783373154,1672672153,1672673102,949
3897,3850911686,3231494505,1672696951,1672699900,2949
3742,3638660068,3778040015,1672700959,1672702877,1918
3649,3310125159,3488686442,1672669308,1672672283,2975
3769,3757903168,3710315160,1672639126,1672641162,2036
3922,3622357348,3711734586,1672531497,1672534163,2666
3442,3618489670,3756625818,1672551732,1672552905,1173
3697,3554825448,3701247948,1672577521,1672578651,1130
3802,3772078494,3899786664,1672645918,1672649496,3578
3537,3633735593,3773033649,1672648291,1672651288,2997
3425,3773121782,3779646172,1672620035,1672622714,2679
3745,3512882178,3276348699,1672644069,1672646430,2361
3818,3415833929,3689697817,1672614079,1672614591,512
3473,3975717896,3296462324,1672532875,1672536182,3307
3425,3470454332,3510767239,1672613723,1672615635,1912
3527,3559458968,3533004959,1672669647,1672671871,2224
3693,3208452238,3713589994,1672694301,1672696423,2122
3649,3779613523,3276269264,1672693939,1672696212,2273
3859,3760040019,3385323994,1672559331,1672561781,2450
3883,3512337405,3774907131,1672563646,1672566746,3100
3479,3701107228,3520657891,1672539538,1672540841,1303
3778,3439673892,3343816795,1672671765,1672673567,1802
3745,3760924079,3512295534,1672557135,1672558474,1339
3565,3519651506,3760364383,1672669092,1672672393,3301
3611,3500613459,3519282716,1672694288,1672697432,3144
3584,3510964997,3714128600,1672642432,1672644325,1893
3742,3977148669,3737112297,1672681220,1672681307,87
3563,3811040565,3970198861,1672592334,1672593594,1260
3570,3779938251,3510499038,1672648214,1672650694,2480
3460,3738026330,3773027597,1672544613,1672546491,1878
3828,3779738691,3737112297,1672583986,1672586800,2814
3438,3979802715,3534543776,1672559282,1672560334,1052
3477,3714128600,3783340788,1672599738,1672600354,616
3612,3777779869,3972192593,1672686383,1672687219,836
3632,3974674109,3500072204,1672594600,1672596320,1720
3850,3380767040,3515525630,1672549188,1672552060,2872
3668,3505283390,3399472693,1672622608,1672626126,3518
3679,3448633776,3885157459,1672551145,1672552516,1371
3691,3613581796,3396980894,1672542800,1672543798,998
3641,3613206049,3351866415,1672568046,1672569828,1782
3870,3905899155,3511791953,1672693000,1672694287,1287
3600,3661447322,3777330107,1672649536,1672650382,846
3700,3533090502,3631479562,1672622589,1672623892,1303
3715,3398198430,3513065217,1672587211,1672589463,2252
3717,3394297564,3412968120,1672534428,1672537617,3189
3805,3446533960,3792274796,1672653673,1672655238,1565
3849,3895285664,3330340793,1672555249,1672556031,782
3451,3452016771,3206837348,1672543039,1672544417,1378
3912,3730071479,3811075491,1672550044,1672550753,709
3907,3738026330,3773027597,1672700911,1672704028,3117
3832,3246370118,3272030610,1672604351,1672606222,1871
3747,3505923418,3534179433,1672637017,1672637814,797
3894,3311049964,3688796737,1672659114,1672660717,1603
3746,3900945856,3934064792,1672574895,1672576186,1291
3660,3305336154,3510028805,1672649945,1672650760,815
3747,3402385957,3715127070,1672659731,1672661375,1644
3769,3513018485,3451726367,1672554580,1672554720,140
3744,3517887477,3630353876,1672659007,1672660856,1849
3798,3481640525,3505725706,1672641525,1672644181,2656
3712,3402385957,3497808662,1672644470,1672647486,3016
3608,3505437712,3500841914,1672654032,1672656763,2731
3528,3512958459,3412968120,1672699503,1672703011,3508
3856,3701373490,3398731252,1672603622,1672605393,1771
3703,3534543776,3490214516,1672584443,1672587613,3170
3908,3556969573,3514324011,1672611537,1672613912,2375
3486,3480490124,3613899351,1672637988,1672641203,3215
3863,3897435944,3793883863,1672633649,1672634242,593
3645,3772236797,3776831527,1672679339,1672680980,1641
3646,3716272919,3485540729,1672667464,1672670389,2925
3603,3934064792,3513296868,1672692100,1672694762,2662
3592,3760364383,3462273042,1672662744,1672665372,2628
3469,3284947372,3202141727,1672678762,1672681329,2567
3551,3488763230,3858172636,1672536309,1672538725,2416
3865,3386758279,3770438122,1672699331,1672699406,75
3794,3636329663,3478114114,1672596947,1672599379,2432
3818,3447514821,3621184108,1672637857,1672638552,695
3659,3760645796,3773735484,1672671450,1672671648,198
3650,3779738691,3711000597,1672626126,1672626755,629
3464,3631479562,3773572967,1672638152,1672638468,316
3632,3509764635,3349739136,1672640839,1672642272,1433
3659,3315703693,3500044458,1672694943,1672696933,1990
3524,3492546679,3412006598,1672638811,1672641335,2524
3670,3783641602,3902625986,1672693617,1672694757,1140
3581,3367509761,3927599181,1672680892,1672684081,3189
3597,3445206685,3826238375,1672599847,1672602808,2961
3478,3510837901,3428725843,1672646871,1672649267,2396
3528,3734451191,3609659642,1672599541,1672603001,3460
3894,3520355798,3205985903,1672552117,1672553742,1625
3857,3779646172,3516321888,1672686354,1672687904,1550
3473,3756474459,3551399764,1672536327,1672539774,3447
3596,3514308235,3780115155,1672626697,1672629755,3058
3672,3509366311,3933894942,1672587439,1672589269,1830
3531,3276217799,3436257398,1672674854,1672675822,968
3703,3518229776,3755915206,1672690359,1672692140,1781
3481,3731646673,3513295938,1672629542,1672632834,3292
3866,3271454397,3319167958,1672579953,1672582363,2410
3576,3505634634,3716272919,1672548121,1672551679,3558
3633,3354144091,3347446226,1672580614,1672583846,3232
3564,3774718695,3239617320,1672695607,1672697905,2298
3909,3667673649,3783919913,1672630585,1672631179,594
3596,3311098437,3309314379,1672664463,1672666268,1805
3842,3500341755,3711853996,1672625878,1672628795,2917
3604,3333403880,3480991549,1672621497,1672624099,2602
3833,3688220326,3298151889,1672608161,1672610887,2726
3453,3519909393,3912891315,1672607438,1672610352,2914
3676,3518194482,3270056120,1672669509,1672672289,2780
3855,3517991730,3711637255,1672532818,1672535901,3083
3741,3852686295,3756385685,1672624575,1672625796,1221
3469,3803389195,3299781901,1672553061,1672556167,3106
3802,3516444201,3447672935,1672557821,1672558138,317
3629,3436025562,3451326054,1672682920,1672683230,310
3449,3505154885,3514512367,1672652141,1672652485,344
3763,3773124276,3403370192,1672553607,1672555678,2071
3510,3933894942,3779786641,1672589387,1672590188,801
3669,3780571086,3824641227,1672558353,1672560902,2549
3563,3773009828,3680843171,1672583141,1672585558,2417
3678,3923420131,3226024417,1672579634,1672582682,3048
3629,3897435944,3279339278,1672674447,1672677181,2734
3573,3774705415,3776244398,1672597753,1672597949,196
3503,3713941638,3609881958,1672640542,1672643465,2923
3880,3791436104,3627368399,1672632681,1672633864,1183
3482,3909094917,3534764451,1672531900,1672532651,751
3654,3274906650,3518653080,1672656344,1672658214,1870
3810,3343816795,3375449013,1672570101,1672570231,130
3631,3977148669,3224811762,1672577686,1672579980,2294
3678,3511601997,3792389522,1672671274,1672673751,2477
3720,3513296868,3780712350,1672683122,1672685890,2768
3689,3756704774,3938389661,1672573157,1672573419,262
3433,3792489602,3316800320,1672638559,1672639021,462
3719,3636329663,3711077927,1672580253,1672580744,491
3567,3402385957,3716628503,1672668377,1672669548,1171
3649,3791106564,3760094385,1672698591,1672700689,2098
3638,3792072681,3614740489,1672641998,1672642144,146
3688,3779656423,3429943738,1672639746,1672642030,2284
3894,3615939504,3510919821,1672677231,1672679348,2117
3695,3660887799,3376467719,1672560479,1672561324,845
3733,3289817992,3414275042,1672666160,1672669693,3533
3626,3370227921,3710048469,1672658168,1672660764,2596
3860,3792525861,3396726504,1672531728,1672533989,2261
3490,3793315718,3814677862,1672582968,1672585391,2423
3429,3306175858,3516513251,1672538772,1672542258,3486
3731,3701882224,3778926763,1672681185,1672684583,3398
3732,3783615982,3519416013,1672608066,1672608402,336
3867,3209526819,3272716462,1672599684,1672602623,2939
3775,3757294769,3715974659,1672590383,1672591898,1515
3438,3360813161,3370068529,1672690763,1672693713,2950
3515,3773572967,3231713082,1672539439,1672541861,2422
3888,3472312341,3900945856,1672633935,1672635166,1231
3797,3514246749,3497671225,1672567079,1672567191,112
3541,3437286517,3834960360,1672572522,1672573331,809
3641,3905899155,3972192593,1672664136,1672666367,2231
3524,3972083617,3737147209,1672640947,1672641325,378
3585,3895285664,3387594369,1672651803,1672652147,344
3523,3371455553,3418448389,1672538224,1672538733,509
3782,3337322736,3779786641,1672542832,1672542966,134
3706,3271454397,3636329663,1672532010,1672534216,2206
3692,3880926355,3777147510,1672621582,1672622561,979
3434,3714678331,3519087371,1672562400,1672563911,1511
3613,3780909839,3661447322,1672667228,1672670074,2846
3446,3512830734,3859868849,1672556481,1672556614,133
3908,3618808151,3284947372,1672636907,1672637921,1014
3470,3273981374,3793175445,1672549098,1672550596,1498
3529,3615737355,3897134762,1672619394,1672622042,2648
3855,3519416013,3341893384,1672683116,1672684062,946
3889,3633735593,3279473441,1672619848,1672621010,1162
3782,3737972328,3334951866,1672680874,1672681414,540
3504,3279475486,3739154408,1672661178,1672662942,1764
3877,3202141727,3501121099,1672548088,1672550022,1934
3575,3311085279,3299443125,1672541101,1672543494,2393
3466,3516321888,3902625986,1672595465,1672595635,170
3656,3500208903,3933894942,1672551710,1672554310,2600
3656,3711812325,3399472693,1672645698,1672647600,1902
3826,3519909393,3501525100,1672644823,1672645484,661
3815,3889780657,3889780657,1672606432,1672609218,2786
3856,3516489668,3734915241,1672664603,1672666398,1795
3920,3660887799,3971806004,1672609942,1672610517,575
3919,3773735484,3513410578,1672603835,1672605034,1199
3724,3836241528,3403370192,1672640852,1672644156,3304
3733,3516298579,3272030610,1672687781,1672690919,3138
3689,3517222913,3714120857,1672643656,1672643978,322
3663,3780322355,3293835352,1672617583,1672618561,978
3758,3783136330,3520560590,1672540498,1672542862,2364
3623,3770704999,3815250107,1672574881,1672575651,770
3887,3812369928,3621461051,1672672402,1672675856,3454
3458,3387594369,3226511603,1672630486,1672633428,2942
3730,3520322124,3899326793,1672631147,1672634661,3514
3861,3347419520,3500857494,1672631895,1672632110,215
3854,3500703304,3783641602,1672692391,1672692562,171
3637,3778040015,3500672156,1672601477,1672604156,2679
3687,3520639768,3900898992,1672547843,1672551182,3339
3429,3780115155,3452016771,1672669214,1672672308,3094
3721,3299781901,3793743698,1672651113,1672652581,1468
3709,3424445495,3621184108,1672546063,1672546657,594
3490,3625463628,3448633776,1672657839,1672659410,1571
3726,3467779445,3661903000,1672565179,1672567318,2139
3435,3755496114,3414049538,1672563696,1672566403,2707
3815,3505847380,3760263530,1672577747,1672578408,661
3480,3608232640,3899786664,1672632031,1672635492,3461
3658,3343816795,3802932312,1672667772,1672668607,835
3806,3625174002,3760694096,1672663035,1672664181,1146
3788,3716110860,3289114629,1672541748,1672544983,3235
3654,3505888598,3927599181,1672553491,1672554171,680
3760,3778926763,3231494505,1672611984,1672614369,2385
3670,3274831810,3780834916,1672687792,1672689228,1436
3604,3622665543,3500672156,1672683613,1672685624,2011
3446,3298151889,3701136026,1672659088,1672662390,3302
3889,3835422146,3713941638,1672566350,1672567505,1155
3544,3511005395,3688796737,1672575656,1672577406,1750
3804,3501215099,3916490839,1672559190,1672559348,158
3561,3349856820,3505521218,1672540201,1672543074,2873
3521,3519087371,3515401243,1672626656,1672627071,415
3666,3520416075,3505634634,1672584650,1672587397,2747
3820,3513018485,3512502036,1672652560,1672652983,423
3598,3703433819,3834631333,1672655497,1672657254,1757
3841,3349739136,3780872464,1672597924,1672599984,2060
3630,3777037426,3779613523,1672653717,1672656006,2289
3523,3613338363,3519909393,1672669205,1672671503,2298
3826,3208452238,3409114719,1672540240,1672542889,2649
3779,3417191856,3338083680,1672677042,1672679199,2157
3687,3791046864,3610358027,1672535508,1672537973,2465
3474,3519850727,3311098437,1672630935,1672633934,2999
3809,3715443333,3367111751,1672627250,1672630665,3415
3579,3619922891,3514419100,1672649232,1672652258,3026
3838,3364378127,3429943738,1672661367,1672663567,2200
3716,3367509761,3271752081,1672659426,1672660550,1124
3428,3633735593,3778597171,1672676460,1672679209,2749
3483,3757630221,3298151889,1672695202,1672695431,229
3586,3409114719,3512946768,1672564250,1672566874,2624
3469,3500709774,3367111751,1672585571,1672587749,2178
3812,3514419100,3516741440,1672553088,1672555941,2853
3454,3923754072,3224968597,1672607351,1672608757,1406
3673,3774178201,3755737419,1672576527,1672580073,3546
3680,3736231757,3283770991,1672576162,1672577525,1363
3875,3667673649,3773027597,1672560896,1672563334,2438
3888,3513295938,3680810086,1672667729,1672670966,3237
3476,3660887799,3334974375,1672691712,1672692197,485
3601,3755158925,3756474459,1672659818,1672660313,495
3687,3515525630,3736705719,1672605477,1672605883,406
3818,3815250107,3703396825,1672687798,1672688462,664
3455,3714120857,3615087943,1672657375,1672658333,958
3814,3435116799,3520416075,1672634621,1672636302,1681
3715,3778134418,3305722859,1672687806,1672690614,2808
3717,3773027597,3514512367,1672659761,1672661444,1683
3740,3308760650,3460719322,1672674160,1672674749,589
3904,3770676872,3713768950,1672669262,1672669895,633
3839,3714120857,3505228454,1672679185,1672682577,3392
3659,3739911441,3668533536,1672701780,1672703713,1933
3858,3774790271,3608922867,1672649692,1672651743,2051
3508,3512946768,3337322736,1672554389,1672556426,2037
3760,3519909393,3511317276,1672630106,1672632680,2574
3902,3279242917,3398731252,1672568171,1672568343,172
3874,3228888030,3520416075,1672572552,1672574385,1833
3454,3710489491,3885155975,1672625720,1672628452,2732
3655,3738026330,3824215187,1672590605,1672591902,1297
3761,3774155692,3607768197,1672699551,1672702525,2974
3809,3615087943,3206837348,1672677947,1672679438,1491
3713,3519850727,3360069849,1672539945,1672543430,3485
3458,3923754072,3779425804,1672688584,1672690076,1492
3675,3711000597,3625463628,1672662814,1672663030,216
3609,3520322124,3452016771,1672653671,1672656080,2409
3629,3385323994,3779613523,1672680179,1672682721,2542
3817,3303410628,3396726504,1672580903,1672581769,866
3901,3975717896,3661583097,1672535910,1672536852,942
3722,3783147088,3376467719,1672587130,1672589609,2479
3883,3428027649,3792538417,1672547037,1672549380,2343
3663,3209526819,3710315160,1672590813,1672591449,636
3738,3715707380,3773913680,1672602434,1672603081,647
3755,3905196766,3614740489,1672611473,1672613962,2489
3704,3500613459,3505725706,1672609181,1672610437,1256
3501,3379143440,3613416045,1672694322,1672696235,1913
3782,3382733096,3935913584,1672702418,1672705385,2967
3734,3208957949,3773009828,1672685020,1672685462,442
3587,3518194482,3777624586,1672620693,1672622769,2076
3907,3520115090,3517887477,1672696589,1672697938,1349
3649,3716628503,3770468980,1672553520,1672556884,3364
3613,3273981374,3932478321,1672544171,1672545443,1272
3889,3497095254,3533368789,1672676751,1672679600,2849
3545,3533079336,3516321888,1672545836,1672547878,2042
3467,3618808151,3279339278,1672659952,1672661732,1780
3573,3756385685,3270697740,1672665166,1672667519,2353
3630,3500302272,3316800320,1672650355,1672652401,2046
3738,3457960571,3608855425,1672677277,1672679954,2677
3515,3279473441,3304155815,1672578565,1672580726,2161
3730,3357864626,3780834916,1672591502,1672595081,3579
3632,3299781901,3801645328,1672554790,1672555620,830
3505,3469254160,3793583656,1672639062,1672642632,3570
3788,3895285664,3610358027,1672650071,1672651879,1808
3850,3379143440,3513327337,1672668134,1672670975,2841
3586,3778597171,3520181148,1672625998,1672628214,2216
3897,3791436104,3280268483,1672630373,1672633142,2769
3599,3505434346,3451326054,1672676552,1672678798,2246
3521,3330340793,3773124276,1672601957,1672605122,3165
3653,3472312341,3463849738,1672644648,1672645596,948
3537,3714670620,3505888598,1672678216,1672681594,3378
3491,3776084820,3774290799,1672575222,1672576611,1389
3482,3701823816,3417191856,1672545391,1672546205,814
3726,3701373490,3510818674,1672542602,1672544216,1614
3431,3447514821,3817428320,1672550064,1672552224,2160
3866,3780909839,3773572967,1672585171,1672585777,606
3643,3271454397,3971806004,1672633986,1672634146,160
3535,3206837348,3897456874,1672698326,1672701410,3084
3527,3225631197,3505847380,1672677827,1672681019,3192
3788,3516513251,3714233826,1672645057,1672647969,2912
3516,3792072681,3812369928,1672654550,1672655617,1067
3891,3455018347,3500703304,1672587434,1672590246,2812
3443,3384583385,3248058676,1672633040,1672634269,1229
3500,3468041839,3772391882,1672548290,1672551544,3254
3732,3510767239,3935399379,1672688059,1672689799,1740
3729,3371455553,3632814465,1672698046,1672699220,1174
3787,3815250107,3711637255,1672543831,1672544739,908
3746,3315703693,3208452238,1672586727,1672589906,3179
3448,3770468980,3404025196,1672627356,1672628098,742
3797,3500672156,3756789525,1672686922,1672689172,2250
3494,3514818819,3715086894,1672543467,1672546511,3044
3820,3701136026,3246370118,1672599745,1672601029,1284
3671,3517358573,3617489344,1672632742,1672634701,1959
3832,3461119815,3515559913,1672661604,1672661806,202
3540,3773939399,3774790271,1672643545,1672646295,2750
3541,3241790910,3428027649,1672550805,1672552876,2071
3783,3778899160,3333918941,1672535109,1672536562,1453
3569,3412006598,3276003502,1672663872,1672665983,2111
3777,3856606678,3885155975,1672604141,1672604561,420
3837,3294703680,3613338363,1672662101,1672664700,2599
3716,3360813161,3923220461,1672571430,1672572768,1338
3748,3276217799,3279475486,1672660963,1672663690,2727
3755,3668533536,3774876004,1672659658,1672660007,349
3726,3404025196,3814305099,1672605670,1672607502,1832
3880,3303410628,3511317276,1672632985,1672634706,1721
3608,3429943738,3778899160,1672607240,1672610656,3416
3721,3490214516,3451326054,1672629085,1672632102,3017
3786,3778667336,3335694356,1672652458,1672653171,713
3839,3757193307,3921648519,1672534251,1672535074,823
3492,3509483172,3513065217,1672642894,1672646073,3179
3906,3429943738,3605221116,1672582508,1672583694,1186
3568,3818575661,3337322736,1672646547,1672648043,1496
3589,3306412634,3686523546,1672557984,1672560169,2185
3575,3533649454,3779532653,1672577183,1672580392,3209
3784,3517462308,3661583097,1672553384,1672555856,2472
3566,3279475486,3519142371,1672637810,1672638728,918
3523,3778640261,3517172354,1672549666,1672550265,599
3817,3615939504,3710562338,1672620246,1672621722,1476
3569,3631090677,3505434346,1672586968,1672588059,1091
3493,3776117322,3368283077,1672552911,1672553755,844
3494,3510919821,3410538749,1672585404,1672588429,3025
3617,3780338697,3514741348,1672684448,1672685664,1216
3663,3814305099,3770236215,1672535318,1672536970,1652
3492,3248058676,3517687662,1672616584,1672617922,1338
3480,3519077659,3850911686,1672542066,1672542823,757
3679,3551376095,3239617320,1672555520,1672559002,3482
3539,3905899155,3513296868,1672571080,1672572831,1751
3693,3791106564,3792505974,1672545587,1672546018,431
3912,3283492940,3715619259,1672612495,1672614828,2333
3911,3514818819,3514971533,1672595266,1672595499,233
3535,3379143440,3755233658,1672644579,1672645626,1047
3837,3792389522,3756789525,1672655891,1672656615,724
3714,3349856820,3906536154,1672594414,1672595658,1244
3601,3776244398,3512946768,1672681855,1672684361,2506
3632,3892304880,3448633776,1672592251,1672595343,3092
3596,3780322355,3793743698,1672662535,1672664657,2122
3600,3777147510,3736231757,1672584312,1672585844,1532
3589,3793740407,3283144118,1672603879,1672605708,1829
3570,3756385685,3777694660,1672580061,1672580556,495
3469,3334951866,3713163045,1672606865,1672607886,1021
3879,3500613459,3760645796,1672703947,1672705308,1361
3873,3200308999,3272030610,1672566073,1672566346,273
3440,3793583656,3398731252,1672650136,1672651225,1089
3649,3776084820,3625174002,1672598646,1672600656,2010
3648,3852533643,3977148669,1672540146,1672540331,185
3792,3478114114,3338083680,1672533447,1672536592,3145
3676,3509756823,3814677862,1672674959,1672676829,1870
3582,3226178937,3500347447,1672692770,1672693826,1056
3620,3408498208,3779892400,1672657253,1672658608,1355
3540,3737147209,3411688875,1672657829,1672660702,2873
3698,3783433404,3713517039,1672586070,1672589104,3034
3472,3633735593,3520764926,1672680357,1672683462,3105
3437,3715974659,3811075491,1672615986,1672617955,1969
3907,3760694096,3512379024,1672625504,1672625798,294
3445,3774031303,3667427125,1672573100,1672573567,467
3759,3500347447,3240394404,1672657100,1672658937,1837
3555,3240994288,3626499450,1672600826,1672603361,2535
3512,3513041785,3715400486,1672690099,1672691216,1117
3898,3492546679,3791128487,1672682616,1672683553,937
3885,3289114629,3373089838,1672563127,1672566542,3415
3615,3505634634,3811040565,1672698353,1672700214,1861
3441,3713561276,3226178937,1672689402,1672691465,2063
3523,3622665543,3510642075,1672547872,1672548745,873
3476,3615087943,3714678331,1672580269,1672581075,806
3593,3225029895,3774718695,1672654764,1672655569,805
3569,3834631333,3770520359,1672641480,1672642511,1031
3528,3604589802,3467988782,1672613738,1672617260,3522
3737,3511317276,3688490530,1672539670,1672542309,2639
3915,3793883863,3448633776,1672672624,1672675736,3112
3508,3511150845,3401496246,1672546365,1672546934,569
3818,3241790910,3825881598,1672554563,1672556828,2265
3840,3205985903,3852533643,1672547844,1672551037,3193
3525,3438078818,3757348722,1672547433,1672548551,1118
3887,3892304880,3783550022,1672651067,1672652482,1415
3607,3971806004,3512282789,1672545451,1672548397,2946
3476,3715707380,3710562338,1672571942,1672574923,2981
3518,3892304880,3630353876,1672687116,1672687419,303
3594,3500525825,3609933747,1672658661,1672660888,2227
3857,3472312341,3688220326,1672578729,1672580338,1609
3746,3336627643,3770296583,1672655675,1672655761,86
3621,3711077927,3505266860,1672693324,1672694544,1220
3506,3624297844,3933894942,1672682593,1672684130,1537
3730,3734915241,3780322355,1672644284,1672646065,1781
3542,3710735406,3351696332,1672648704,1672651050,2346
3512,3306412634,3472312341,1672540078,1672541061,983
3844,3777485931,3516703758,1672605861,1672606584,723
3578,3514971533,3500208903,1672676166,1672678332,2166
3425,3774243020,3853629553,1672568847,1672571492,2645
3664,3779301501,3711077927,1672533062,1672533647,585
3773,3685681577,3505663516,1672604514,1672607168,2654
3839,3783771827,3760645796,1672576665,1672579017,2352
3437,3310125159,3519142371,1672544822,1672548375,3553
3566,3289114629,3711097754,1672631941,1672635524,3583
3743,3792745809,3224330592,1672565582,1672567528,1946
3758,3703383853,3688490530,1672595762,1672598353,2591
3913,3497671225,3909094917,1672602610,1672603813,1203
3796,3462273042,3500841914,1672597743,1672599639,1896
3580,3279475486,3512958459,1672596550,1672596717,167
3903,3774733620,3760040019,1672697713,1672698643,930
3770,3778040015,3770296583,1672633265,1672636804,3539
3603,3367509761,3773121782,1672692636,1672694231,1595
3432,3792525861,3773913680,1672589320,1672592547,3227
3762,3333918941,3520416075,1672628010,1672628922,912
3534,3311085279,3631479562,1672583909,1672585330,1421
3676,3971806004,3610358027,1672572508,1672572936,428
3678,3776034743,3554186380,1672647449,1672648557,1108
3519,3970198861,3488763230,1672593614,1672594492,878
3627,3783340788,3682133690,1672663243,1672665639,2396
3547,3384068080,3970603231,1672544838,1672545659,821
3563,3500709774,3689697817,1672626732,1672627627,895
3600,3792020993,3279339278,1672543403,1672546852,3449
3530,3517737088,3370227921,1672659546,1672663128,3582
3634,3396726504,3905196766,1672671716,1672674047,2331
3675,3367509761,3460719322,1672582552,1672583197,645
3520,3610870949,3341893384,1672577839,1672579118,1279
3815,3669146016,3701373490,1672702574,1672704384,1810
3466,3404025196,3551376095,1672696857,1672698324,1467
3517,3231713082,3779438325,1672601351,1672601988,637
3814,3971806004,3270042456,1672697138,1672698487,1349
3713,3519416013,3516513251,1672565680,1672567597,1917
3881,3467779445,3513545422,1672542275,1672545804,3529
3575,3490214516,3818575661,1672691214,1672693491,2277
3660,3664943873,3770704999,1672586885,1672587418,533
3566,3792538417,3519850727,1672539236,1672539538,302
3492,3627368399,3520355798,1672673104,1672674047,943
3615,3520181148,3637313265,1672678571,1672681850,3279
3480,3760842815,3703433819,1672581587,1672584080,2493
3638,3559731671,3220031931,1672544041,1672544162,121
3661,3337362061,3780680950,1672550283,1672552730,2447
3632,3311420950,3240394404,1672613273,1672615887,2614
3512,3505228454,3500915665,1672609298,1672611831,2533
3845,3783550022,3347419520,1672666274,1672669555,3281
3611,3357289672,3456430614,1672568187,1672569316,1129
3463,3770468980,3380767040,1672550199,1672551428,1229
3542,3635169815,3737112297,1672634001,1672636386,2385
3588,3885155975,3373028638,1672655787,1672658998,3211
3473,3777330107,3225631197,1672534291,1672537513,3222
3901,3760263530,3890739241,1672591904,1672593735,1831
3557,3783771827,3756789525,1672642221,1672642922,701
3638,3421877923,3826238375,1672584738,1672585883,1145
3796,3519416013,3783163143,1672633626,1672636982,3356
3684,3229974066,3371455553,1672632809,1672634487,1678
3818,3780338697,3835422146,1672652362,1672653523,1161
3642,3833217041,3481640525,1672656637,1672657644,1007
3663,3776988674,3491684096,1672635052,1672636417,1365
3556,3793740407,3280054198,1672625870,1672628819,2949
3893,3283770991,3774243020,1672703451,1672706338,2887
3665,3511732493,3834960360,1672547450,1672549524,2074
3559,3480991549,3519850727,1672571755,1672573864,2109
3759,3500302272,3625174002,1672580113,1672580761,648
3563,3480991549,3279242917,1672568538,1672569858,1320
3806,3510837901,3480490124,1672703041,1672704007,966
3477,3412006598,3333403880,1672614032,1672615602,1570
3820,3900898992,3279339278,1672686506,1672688358,1852
3481,3517288083,3236354255,1672651465,1672654954,3489
3568,3638660068,3534566651,1672623622,1672624151,529
3704,3772236797,3818575661,1672640172,1672641749,1577
3584,3885157459,3774733620,1672650053,1672651652,1599
3875,3512958459,3299443125,1672666466,1672668675,2209
3466,3246370118,3462158237,1672684228,1672684931,703
3433,3833217041,3755158925,1672574706,1672574879,173
3512,3757383891,3807212280,1672587914,1672588569,655
3895,3350095157,3505179890,1672560468,1672564055,3587
3740,3773332082,3613416045,1672547612,1672551108,3496
3838,3885537225,3713784974,1672581987,1672582763,776
3799,3519142371,3625463628,1672625139,1672626556,1417
3794,3701424609,3934064792,1672582753,1672585004,2251
3615,3715400486,3334647380,1672694553,1672694773,220
3760,3665998641,3779738691,1672593685,1672596727,3042
3585,3520416075,3638660068,1672699289,1672699689,400
3848,3517991730,3512882178,1672628340,1672628413,73
3527,3226511603,3505725706,1672697393,1672700924,3531
3424,3783340788,3472312341,1672652038,1672653756,1718
3828,3500072204,3783801141,1672663554,1672667075,3521
3514,3514512367,3372223551,1672639599,1672642400,2801
3579,3777189898,3880926355,1672633166,1672636397,3231
3588,3760645796,3447672935,1672647826,1672648757,931
3748,3512383699,3520578796,1672674412,1672675701,1289
3719,3661447322,3414275042,1672557613,1672558779,1166
3742,3311085279,3319167958,1672649984,1672650355,371
3922,3760362417,3337322736,1672686336,1672686784,448
3529,3401793306,3512882178,1672670325,1672671897,1572
3804,3500703304,3511843593,1672544809,1672544930,121
3528,3441703884,3311085279,1672652030,1672653582,1552
3551,3817813340,3387594369,1672670756,1672673966,3210
3550,3519142371,3273981374,1672668921,1672670124,1203
3445,3300229945,3557046880,1672682790,1672686330,3540
3876,3338390596,3404025196,1672584636,1672586031,1395
3430,3615737355,3757700712,1672559352,1672561722,2370
3701,3621184108,3231713082,1672546790,1672547092,302
3623,3701247948,3783163143,1672658699,1672659426,727
3829,3380982774,3635169815,1672693354,1672696936,3582
3673,3755233658,3608922867,1672638322,1672641621,3299
3808,3437286517,3276217799,1672648490,1672650304,1814
3905,3417191856,3514285803,1672638498,1672640546,2048
3456,3715127070,3668747074,1672586045,1672589598,3553
3675,3514971533,3773009828,1672571969,1672572618,649
3720,3534179433,3780571086,1672663037,1672664796,1759
3808,3226178937,3411688875,1672587369,1672590110,2741
3507,3341893384,3613206049,1672695987,1672696293,306
3740,3935399379,3534175249,1672655462,1672657177,1715
3546,3376467719,3500915908,1672666990,1672669559,2569
3868,3500672156,3780769110,1672619228,1672621709,2481
3426,3760364383,3551399764,1672636670,1672640241,3571
3588,3505995057,3793583656,1672604236,1672606370,2134
3447,3336627643,3512882178,1672562012,1672562221,209
3743,3689114185,3920898925,1672678062,1672679928,1866
3560,3793315718,3714233826,1672547270,1672550552,3282
3786,3343816795,3380130228,1672560676,1672563844,3168
3847,3389634034,3624297844,1672635677,1672635854,177
3607,3791753345,3880926355,1672542129,1672543045,916
3527,3773913680,3514419100,1672601493,1672604037,2544
3437,3349739136,3791128487,1672597853,1672598758,905
3817,3490214516,3711812325,1672636064,1672637714,1650
3505,3716963089,3514334067,1672649830,1672650524,694
3716,3639050419,3915162005,1672638142,1672640173,2031
3902,3441703884,3792949946,1672606197,1672609090,2893
3741,3449333754,3609113156,1672564737,1672565248,511
3786,3613338363,3520639768,1672649993,1672653314,3321
3649,3899326793,3664943873,1672634250,1672634860,610
3552,3615688740,3773902805,1672662440,1672664161,1721
3768,3780338697,3505179890,1672669493,1672671520,2027
3900,3499217428,3713979100,1672596149,1672599232,3083
3491,3399472693,3500604680,1672650157,1672652358,2201
3887,3511791953,3510798825,1672701413,1672701923,510
3556,3792489602,3975717896,1672687535,1672690068,2533
3804,3621184108,3300229945,1672625814,1672629317,3503
3711,3977148669,3201629017,1672605495,1672607841,2346
3489,3770624662,3500302272,1672687110,1672688924,1814
3654,3236458894,3773009828,1672695296,1672696436,1140
3460,3272030610,3970198861,1672687800,1672688753,953
3549,3923420131,3833217041,1672671105,1672673564,2459
3618,3519416013,3774605761,1672643104,1672645674,2570
3887,3974674109,3274906650,1672543845,1672543974,129
3447,3514246749,3772236797,1672656688,1672658295,1607
3616,3520416075,3512295534,1672666815,1672668565,1750
3555,3710315160,3736231757,1672543337,1672545359,2022
3898,3534179433,3273981374,1672533862,1672534918,1056
3766,3402697190,3639050419,1672665007,1672666512,1505
3608,3283144118,3914691363,1672648839,1672652344,3505
3838,3300511067,3209481722,1672688021,1672691318,3297
3606,3396726504,3970558632,1672553686,1672555589,1903
3737,3229822507,3923754072,1672574966,1672575661,695
3552,3783801141,3515401243,1672562146,1672562825,679
3831,3370068529,3904412440,1672701696,1672702366,670
3897,3276348699,3354144091,1672556061,1672558423,2362
3689,3783340788,3501567772,1672670937,1672674414,3477
3501,3418448389,3613581796,1672540501,1672540785,284
3467,3279339278,3500317969,1672589815,1672592428,2613
3827,3814305099,3783136330,1672562792,1672563575,783
3461,3500915665,3905899155,1672660712,1672661630,918
3721,3934064792,3701373490,1672609576,1672612782,3206
3826,3770146716,3780872464,1672681657,1672682688,1031
3438,3739911441,3897456874,1672549538,1672552484,2946
3795,3231713082,3276217799,1672638886,1672640369,1483
3543,3505995057,3783771827,1672594979,1672596105,1126
3615,3291933594,3623266256,1672598503,1672601565,3062
3666,3416987084,3777485931,1672589527,1672591232,1705
3566,3294747828,3811075491,1672603974,1672605600,1626
3682,3239617320,3701664364,1672625135,1672628125,2990
3794,3533423872,3357689359,1672690506,1672691110,604
3501,3512383699,3935487534,1672699115,1672699994,879
3759,3410160376,3835985172,1672635046,1672638629,3583
3515,3382733096,3509483172,1672562869,1672565530,2661
3678,3714670620,3617489344,1672639186,1672639967,781
3850,3246370118,3780769110,1672696160,1672696958,798
3449,3711853996,3774031303,1672613275,1672614093,818
3767,3792745809,3715086894,1672620990,1672623886,2896
3548,3855583256,3431460073,1672679498,1672680990,1492
3885,3514741348,3520115090,1672638475,1672641711,3236
3632,3439673892,3689697817,1672549576,1672552505,2929
3627,3615087943,3778134418,1672676383,1672678126,1743
3864,3811075491,3701373490,1672646736,1672648133,1397
3569,3836241528,3392943173,1672597261,1672600829,3568
3907,3300979975,3835985172,1672594590,1672597879,3289
3890,3818575661,3773939399,1672660663,1672664176,3513
3509,3684523966,3607768197,1672643002,1672644352,1350
3815,3811040565,3777189898,1672612594,1672614854,2260
3832,3931627862,3600876425,1672589762,1672591112,1350
3634,3927599181,3510837901,1672567028,1672569936,2908
3807,3300979975,3459681410,1672541508,1672544446,2938
3603,3380130228,3834631333,1672657706,1672659250,1544
3893,3737147209,3633735593,1672659491,1672661923,2432
3541,3551376095,3448875382,1672656123,1672658773,2650
3481,3920497528,3343816795,1672642937,1672645489,2552
3879,3613416045,3823084403,1672674417,1672677778,3361
3909,3803389195,3780253901,1672611156,1672613087,1931
3500,3437286517,3480991549,1672692884,1672694511,1627
3502,3902760230,3779438325,1672662422,1672664634,2212
3594,3514275974,3926643445,1672549689,1672549784,95
3520,3773735484,3920898925,1672563364,1672565021,1657
3589,3734451191,3760040019,1672553503,1672554729,1226
3754,3334951866,3710735406,1672587801,1672591398,3597
3872,3533929349,3402385957,1672674100,1672675173,1073
3684,3770438122,3620292035,1672568646,1672569225,579
3769,3438489358,3793781065,1672664912,1672667684,2772
3573,3755496114,3505178849,1672688308,1672688950,642
3517,3780427126,3505228454,1672536539,1672540097,3558
3447,3534179433,3783928182,1672539235,1672539839,604
3838,3398198430,3891672228,1672550233,1672553107,2874
3889,3497095254,3755737419,1672533305,1672535831,2526
3874,3714128600,3512383699,1672532230,1672533374,1144
3719,3834960360,3497671225,1672659979,1672663043,3064
3721,3376467719,3928511283,1672633842,1672635174,1332
3663,3272096759,3510499038,1672681301,1672681385,84
3764,3779854934,3421877923,1672653144,1672656407,3263
3655,3519850727,3334951866,1672691984,1672695372,3388
3759,3928719932,3209481722,1672678646,1672680989,2343
3916,3770296583,3770438122,1672612035,1672613677,1642
3618,3480726047,3510818674,1672646959,1672649924,2965
3815,3660063072,3780209375,1672683036,1672686438,3402
3590,3274906650,3856606678,1672645366,1672647165,1799
3888,3684523966,3669146016,1672551496,1672555091,3595
3777,3534829213,3779656423,1672652334,1672653894,1560
3873,3310039260,3900898992,1672539774,1672540475,701
3671,3730071479,3289817992,1672677317,1672679176,1859
3789,3520639768,3921648519,1672569832,1672570673,841
3710,3897456874,3510964997,1672650061,1672652808,2747
3803,3292147449,3497808662,1672561848,1672565089,3241
3517,3202804048,3711637255,1672676932,1672680068,3136
3463,3505111292,3811040565,1672613901,1672614586,685
3584,3713784974,3792489602,1672588561,1672591614,3053
3666,3398198430,3505725706,1672673072,1672676549,3477
3518,3394401087,3229974066,1672580786,1672583084,2298
3745,3811040565,3225029895,1672627268,1672627902,634
3793,3305722859,3632814465,1672566714,1672569064,2350
3694,3230135532,3925979970,1672663552,1672664011,459
3836,3505725706,3701884158,1672618164,1672621325,3161
3495,3440137407,3890739241,1672542636,1672544161,1525
3827,3923420131,3517358573,1672645444,1672647219,1775
3514,3438078818,3309314379,1672703595,1672705367,1772
3749,3701882224,3517590837,1672575777,1672576544,767
3426,3505847380,3380130228,1672540658,1672541700,1042
3654,3756127300,3716679950,1672533938,1672535319,1381
3734,3306175858,3859868849,1672579495,1672582086,2591
3564,3236458894,3364378127,1672633062,1672635934,2872
3785,3401496246,3520560590,1672532091,1672533816,1725
3911,3283144118,3770296583,1672578285,1672580133,1848
3894,3417679834,3293835352,1672617669,1672617761,92
3694,3791046864,3512383699,1672687454,1672690347,2893
3433,3467779445,3885121158,1672575338,1672577585,2247
3676,3738026330,3609881958,1672658941,1672659990,1049
3888,3511317276,3338083680,1672593439,1672593888,449
3747,3500604680,3811040565,1672603980,1672605691,1711
3426,3505663516,3513018485,1672557147,1672559560,2413
3680,3510642075,3884596900,1672635181,1672636369,1188
3437,3228888030,3510641433,1672668925,1672671406,2481
3618,3559731671,3731646673,1672659107,1672659775,668
3859,3755496114,3685816610,1672695083,1672698003,2920
3431,3900276517,3627368399,1672685086,1672688073,2987
3604,3773121782,3514324011,1672615222,1672616462,1240
3828,3440137407,3500525825,1672583384,1672586482,3098
3605,3615087943,3500841914,1672619172,1672622031,2859
3866,3416987084,3898314440,1672531969,1672534490,2521
3539,3772391882,3394297564,1672655925,1672658797,2872
3606,3935487534,3373089838,1672630619,1672634028,3409
3566,3777624586,3760640999,1672601261,1672603437,2176
3548,3337362061,3334974375,1672644050,1672646080,2030
3756,3551376095,3501525100,1672703522,1672706675,3153
3518,3972083617,3756385685,1672690988,1672691982,994
3435,3815392801,3715086894,1672645865,1672648726,2861
3647,3621683102,3299781901,1672597441,1672599203,1762
3630,3850911686,3817428320,1672638401,1672640199,1798
3633,3897134762,3517991730,1672602588,1672605359,2771
3674,3885157459,3780834916,1672612335,1672615935,3600
3455,3516298579,3487875183,1672567915,1672570800,2885
3712,3793969543,3410600350,1672657900,1672659204,1304
3475,3714128600,3927599181,1672580264,1672582027,1763
3585,3834963772,3756789525,1672538977,1672541318,2341
3821,3811040565,3780427126,1672563971,1672567182,3211
3824,3513296868,3514275974,1672594035,1672596558,2523
3792,3684523966,3517991730,1672579129,1672582638,3509
3481,3777240360,3831586487,1672618314,1672620593,2279
3826,3505663516,3733558985,1672671688,1672674924,3236
3782,3505663516,3605221116,1672555890,1672556092,202
3645,3492959689,3780209375,1672593413,1672595981,2568
3829,3780769110,3334974375,1672565324,1672565509,185
3788,3776244398,3703433819,1672638941,1672640771,1830
3509,3363162590,3488686442,1672654939,1672655409,470
3701,3715545685,3514703118,1672632941,1672635222,2281
3779,3904412440,3517462308,1672547828,1672548494,666
3464,3225636215,3791128487,1672629070,1672631648,2578
3584,3404025196,3312998540,1672534533,1672536374,1841
3698,3760694096,3511317276,1672687186,1672688199,1013
3812,3276348699,3310125159,1672689434,1672691203,1769
3796,3774790271,3500703304,1672660980,1672662334,1354
3648,3360616538,3970909253,1672686354,1672687776,1422
3788,3793583656,3240994288,1672579012,1672581526,2514
3540,3436257398,3770624662,1672613120,1672614988,1868
3799,3533747868,3736705719,1672613136,1672616397,3261
3807,3455018347,3385323994,1672617712,1672620660,2948
3706,3519416013,3510767239,1672668740,1672670617,1877
3583,3774705415,3970198861,1672674113,1672676820,2707
3837,3815250107,3414275042,1672640882,1672644043,3161
3836,3399518841,3533004959,1672679645,1672681155,1510
3739,3733558985,3680810086,1672625244,1672626090,846
3511,3511442562,3220031931,1672566797,1672568925,2128
3911,3928511283,3245232284,1672572338,1672573621,1283
3640,3515890966,3208452238,1672568007,1672570494,2487
3757,3914691363,3513360004,1672622373,1672625671,3298
3865,3512722110,3343132529,1672555746,1672558227,2481
3678,3739911441,3773572967,1672568617,1672568963,346
3519,3774705415,3760094385,1672532643,1672535555,2912
3746,3779786641,3609113156,1672555125,1672555449,324
3854,3793743698,3399518841,1672655130,1672658313,3183
3806,3231713082,3201629017,1672571865,1672572897,1032
3691,3396980894,3714120857,1672545479,1672547361,1882
3769,3515890966,3755344363,1672643808,1672643983,175
3774,3756746867,3793740407,1672624392,1672625990,1598
3506,3711218296,3631090677,1672654511,1672655550,1039
3444,3230868435,3791693821,1672554882,1672556277,1395
3701,3774178201,3713300120,1672616998,1672618919,1921
3433,3897456874,3500442734,1672677881,1672678723,842
3887,3638660068,3625463628,1672580018,1672580738,720
3784,3732584121,3488763230,1672703322,1672703999,677
3801,3376467719,3770676872,1672660973,1672664571,3598
3686,3520764926,3416987084,1672614064,1672616296,2232
3686,3514308235,3276003502,1672648582,1672650320,1738
3522,3512958459,3780769110,1672630469,1672630882,413
3677,3373028638,3755756564,1672617805,1672620716,2911
3584,3500604680,3774790271,1672632657,1672633515,858
3776,3938389661,3755065949,1672616047,1672619354,3307
3729,3776831527,3661903000,1672561661,1672565251,3590
3695,3534179433,3554825448,1672697258,1672697589,331
3826,3280054198,3791246640,1672672419,1672672927,508
3595,3533649454,3760842815,1672701446,1672704424,2978
3474,3357289672,3972192593,1672599615,1672602330,2715
3722,3783641602,3716110860,1672619939,1672620224,285
3667,3519446663,3270056120,1672656619,1672658879,2260
3587,3511732493,3336339664,1672635612,1672636922,1310
3581,3501567772,3505521218,1672585030,1672585853,823
3554,3274906650,3505847380,1672602919,1672605237,2318
3715,3792745809,3774876004,1672607167,1672609987,2820
3500,3276348699,3890739241,1672550932,1672551967,1035
3679,3490029863,3793969543,1672565865,1672568351,2486
3705,3608855425,3513327337,1672701179,1672704436,3257
3843,3819767045,3469254160,1672683692,1672684167,475
3846,3300511067,3299781901,1672661339,1672664634,3295
3605,3714670620,3392836218,1672538617,1672538816,199
3788,3448875382,3713829743,1672665795,1672666856,1061
3539,3780253901,3776117322,1672702286,1672704800,2514
3834,3710008361,3245232284,1672553704,1672554613,909
3790,3500302272,3622357348,1672686529,1672687665,1136
3887,3774290799,3429943738,1672577064,1672578091,1027
3841,3714128600,3505154885,1672608709,1672609545,836
3621,3757863420,3779532653,1672586372,1672588567,2195
3692,3776988674,3315279093,1672555185,1672558043,2858
3788,3517600136,3734118023,1672640083,1672643209,3126
3841,3630353876,3684523966,1672553218,1672556698,3480
3435,3518565331,3515401243,1672610079,1672610247,168
3448,3316800320,3715400486,1672689125,1672691531,2406
3868,3710854064,3401793306,1672635152,1672638109,2957
3567,3514334067,3240994288,1672655187,1672657199,2012
3466,3604589802,3279242917,1672594379,1672596995,2616
3775,3230868435,3626499450,1672531574,1672533102,1528
3739,3756625818,3512392431,1672679494,1672681694,2200
3920,3756127300,3783801141,1672536558,1672538415,1857
3488,3734118023,3459681410,1672561510,1672562174,664
3627,3228888030,3316798920,1672633615,1672634236,621
3816,3680843171,3770438122,1672542690,1672543552,862
3729,3517288083,3711734586,1672601537,1672604657,3120
3534,3716110860,3730071479,1672695266,1672698716,3450
3803,3510837901,3701424609,1672627664,1672629164,1500
3727,3739154408,3334974375,1672589803,1672590557,754
3455,3208452238,3783771827,1672539334,1672541741,2407
3758,3436025562,3412006598,1672606069,1672609066,2997
3846,3755222916,3631090677,1672618958,1672621329,2371
3663,3511732493,3518229776,1672621661,1672622071,410
3672,3664943873,3520578796,1672688947,1672690605,1658
3897,3776034743,3499217428,1672601871,1672603110,1239
3817,3755737419,3715400486,1672678298,1672681116,2818
3711,3792072681,3779786641,1672677304,1672679726,2422
3807,3417191856,3812534508,1672538268,1672538389,121
3586,3513296868,3609933747,1672703792,1672705767,1975
3632,3513295938,3897456874,1672581201,1672584801,3600
3579,3834963772,3760924079,1672625468,1672627884,2416
3690,3715400486,3299781901,1672540555,1672542225,1670
3760,3201629017,3701107228,1672580770,1672582148,1378
3687,3516298579,3733558985,1672612232,1672615660,3428
3473,3336339664,3505725706,1672590374,1672593037,2663
3667,3410600350,3711097754,1672542017,1672544024,2007
3434,3770676872,3514419100,1672603667,1672607212,3545
3676,3559731671,3519909393,1672659064,1672660806,1742
3626,3443357683,3711734586,1672644727,1672645246,519
3431,3701107228,3774243020,1672587049,1672590228,3179
3570,3609659642,3445206685,1672658014,1672660746,2732
3715,3516741440,3701882224,1672594237,1672594502,265
3805,3311085279,3424660806,1672608558,1672610507,1949
3690,3533079336,3300818269,1672638704,1672640709,2005
3746,3620292035,3608232640,1672565796,1672566957,1161
3662,3739895284,3777485931,1672695873,1672696679,806
3750,3669146016,3779646172,1672583944,1672586081,2137
3759,3684523966,3613338363,1672686916,1672687685,769
3644,3716110860,3533079336,1672690567,1672694038,3471
3572,3770624662,3793883863,1672598198,1672600206,2008
3817,3208452238,3777240360,1672681047,1672681850,803
3485,3515402792,3792525861,1672593566,1672594642,1076
3522,3897134762,3734451191,1672664741,1672666759,2018
3909,3780253901,3923754072,1672581917,1672582235,318
3740,3783136330,3793969543,1672613411,1672614152,741
3834,3826238375,3736231757,1672632522,1672634558,2036
3505,3559458968,3513018485,1672652081,1672655611,3530
3515,3513296868,3534543776,1672548937,1672551106,2169
3659,3236499444,3429943738,1672618987,1672619215,228
3686,3500777439,3780834916,1672566641,1672568714,2073
3478,3760645796,3517687662,1672668493,1672670815,2322
3789,3490214516,3615939504,1672584383,1672586364,1981
3471,3501121099,3350095157,1672685702,1672689068,3366
3822,3713768950,3205985903,1672647420,1672648411,991
3572,3437286517,3780834916,1672562515,1672564013,1498
3670,3511024016,3756789525,1672633247,1672633623,376
3693,3351866415,3774718695,1672561509,1672562413,904
3609,3791613604,3893912331,1672613147,1672613461,314
3475,3735374579,3930242012,1672665165,1672666827,1662
3687,3202141727,3475349791,1672541695,1672544344,2649
3670,3512946768,3505847380,1672696830,1672698493,1663
3869,3625174002,3311498666,1672579723,1672582550,2827
3438,3713517039,3513018485,1672652115,1672652762,647
3921,3514334067,3970558632,1672653804,1672654194,390
3756,3330340793,3701884158,1672569243,1672569949,706
3768,3760263530,3710489491,1672541756,1672544355,2599
3772,3514324011,3231494505,1672647541,1672649170,1629
3540,3280268483,3713163045,1672535295,1672535697,402
3538,3511005395,3737972328,1672582030,1672584600,2570
3802,3505521218,3435167810,1672570516,1672573102,2586
3714,3920625129,3509893027,1672630506,1672631138,632
3714,3534566651,3513065217,1672624631,1672625808,1177
3763,3887243870,3779738691,1672591878,1672592913,1035
3705,3853629553,3780253901,1672536887,1672537564,677
3768,3890739241,3431460073,1672597096,1672599065,1969
3688,3510837901,3514324011,1672634646,1672636994,2348
3728,3884596900,3713911104,1672549422,1672551291,1869
3647,3791128487,3431460073,1672614176,1672615685,1509
3913,3739911441,3500703304,1672577239,1672578775,1536
3460,3755230952,3372223551,1672575118,1672576228,1110
3482,3512830734,3512800570,1672601220,1672603383,2163
3543,3823084403,3777624586,1672538453,1672540737,2284
3668,3520416075,3776034743,1672653187,1672656193,3006
3565,3510837901,3711218296,1672638177,1672638935,758
3525,3500737582,3831586487,1672689966,1672691388,1422
3918,3791046864,3500672156,1672659280,1672660623,1343
3877,3236499444,3236499444,1672617552,1672620355,2803
3756,3500709774,3408498208,1672652298,1672654471,2173
3457,3533228966,3783615982,1672659704,1672662834,3130
3647,3463849738,3713979100,1672614587,1672615592,1005
3848,3402697190,3513018485,1672612462,1672612662,200
3745,3811075491,3777240360,1672574513,1672576388,1875
3791,3760651515,3825881598,1672653573,1672654818,1245
3664,3447672935,3811040565,1672544918,1672547805,2887
3597,3774290799,3292147449,1672698909,1672700354,1445
3425,3621683102,3438489358,1672632985,1672635780,2795
3472,3463849738,3615737355,1672636608,1672638427,1819
3584,3510767239,3236499444,1672593177,1672595765,2588
3729,3225631197,3552824113,1672660567,1672663975,3408
3772,3512383699,3515559913,1672680601,1672682260,1659
3641,3714670620,3774718695,1672586845,1672587098,253
3852,3390660440,3490029863,1672531290,1672533674,2384
3598,3330340793,3514324011,1672664027,1672667260,3233
3751,3518229776,3401793306,1672653304,1672653727,423
3561,3715619259,3513345163,1672537637,1672538096,459
3716,3387594369,3914691363,1672568256,1672569392,1136
3832,3791441520,3438489358,1672678792,1672679250,458
3792,3517687662,3511601997,1672552035,1672554573,2538
3456,3209481722,3288224595,1672557896,1672558358,462
3492,3480100311,3284932450,1672670038,1672673625,3587
3755,3385323994,3756127300,1672613391,1672616474,3083
3627,3513295938,3757348722,1672588665,1672590801,2136
3481,3609659642,3514308235,1672544951,1672546190,1239
3778,3454277788,3779938251,1672682409,1672682518,109
3892,3661583097,3711006062,1672698998,1672702347,3349
3467,3467988782,3512499658,1672670441,1672673022,2581
3705,3757193307,3735374579,1672559595,1672559866,271
3657,3362641275,3793883863,1672543467,1672546081,2614
3604,3513296868,3776034743,1672694960,1672697990,3030
3720,3200543880,3382733096,1672553429,1672557028,3599
3758,3914691363,3793740407,1672626811,1672629695,2884
3903,3364726656,3554825448,1672549374,1672550439,1065
3553,3760924079,3533090502,1672567531,1672569372,1841
3883,3304971369,3757075324,1672616799,1672619179,2380
3824,3916490839,3480100311,1672691320,1672691539,219
3818,3515439826,3500317969,1672544435,1672546554,2119
3712,3306412634,3373028638,1672577194,1672577289,95
3562,3408498208,3791436104,1672537279,1672540137,2858
3652,3779646172,3925979970,1672539646,1672540216,570
3585,3701247948,3500672156,1672584803,1672585649,846
3708,3897456874,3608855425,1672663456,1672664590,1134
3718,3783136330,3343132529,1672534373,1672536115,1742
3737,3517737088,3510798825,1672576735,1672577563,828
3891,3778134418,3514971533,1672582935,1672583157,222
3536,3280268483,3915162005,1672551189,1672553717,2528
3521,3501457103,3520639768,1672599006,1672601088,2082
3633,3615087943,3836241528,1672662850,1672665825,2975
3439,3513545422,3812534508,1672645215,1672646763,1548
3832,3739661856,3979802715,1672689884,1672693269,3385
3743,3714678331,3501281016,1672665980,1672667192,1212
3743,3461119815,3902861231,1672553771,1672554047,276
3908,3457960571,3354144091,1672651656,1672652060,404
3878,3711000597,3815250107,1672658638,1672658952,314
3655,3512337405,3511150845,1672701392,1672703636,2244
3852,3513410578,3274906650,1672650160,1672652609,2449
3526,3783801141,3402697190,1672533788,1672534324,536
3777,3417191856,3294703680,1672603669,1672604739,1070
3675,3439673892,3701136026,1672535870,1672538970,3100
3516,3511601997,3349856820,1672577208,1672577825,617
3670,3362641275,3285204083,1672565320,1672565970,650
3531,3615087943,3500302272,1672664115,1672664318,203
3778,3379143440,3319167958,1672607697,1672609548,1851
3502,3512882178,3408498208,1672643360,1672645477,2117
3777,3519651506,3231713082,1672601552,1672602208,656
3910,3421877923,3777091903,1672535713,1672537572,1859
3629,3711812325,3510767239,1672535860,1672537668,1808
3743,3780115155,3505178849,1672635537,1672639055,3518
3805,3774031303,3500777439,1672544577,1672546924,2347
3822,3230868435,3793781065,1672644566,1672644747,181
3871,3200543880,3755158925,1672572250,1672574506,2256
3459,3360813161,3455018347,1672547791,1672548053,262
3751,3533274994,3369708250,1672663728,1672666967,3239
3686,3534566651,3884596900,1672634091,1672635529,1438
3501,3533079336,3859868849,1672600086,1672602162,2076
3919,3773121782,3380130228,1672698232,1672699498,1266
3445,3613581796,3970909253,1672656874,1672659801,2927
3567,3201629017,3774705415,1672539192,1672540942,1750
3684,3834631333,3520560590,1672628020,1672630403,2383
3598,3447514821,3280054198,1672647001,1672647764,763
3921,3780680950,3551376095,1672667776,1672670610,2834
3875,3516444201,3780712350,1672618121,1672618821,700
3688,3533747868,3701005527,1672613052,1672615557,2505
3845,3604867757,3364378127,1672544440,1672544526,86
3461,3710854064,3773027597,1672539270,1672539618,348
3514,3733558985,3793922324,1672701890,1672704165,2275
3696,3515439826,3636329663,1672607687,1672610606,2919
3905,3357689359,3791613604,1672617650,1672618569,919
3784,3774641380,3517222913,1672625368,1672628651,3283
3821,3333403880,3686227677,1672674515,1672675956,1441
3684,3505888598,3792014516,1672540549,1672541723,1174
3874,3688796737,3779646172,1672676043,1672676244,201
3818,3635169815,3972083617,1672635292,1672638244,2952
3662,3792801638,3505178849,1672660448,1672660682,234
3681,3778667336,3755756564,1672549498,1672551835,2337
3684,3977352557,3517600136,1672681559,1672682317,758
3581,3435116799,3938503547,1672571830,1672575164,3334
3678,3470454332,3803517637,1672569879,1672572584,2705
3851,3923420131,3311098437,1672570432,1672572715,2283
3443,3824641227,3511024016,1672681853,1672684623,2770
3914,3778597171,3512282789,1672546768,1672547786,1018
3449,3224811762,3490214516,1672675828,1672678717,2889
3876,3685816610,3774876004,1672679447,1672681674,2227
3911,3435167810,3778899160,1672579468,1672580519,1051
3436,3200543880,3755756564,1672588644,1672591958,3314
3669,3533929349,3309314379,1672543216,1672543355,139
3796,3779639983,3755532873,1672692432,1672695716,3284
3503,3713300120,3777189898,1672597674,1672598408,734
3495,3505178849,3774718695,1672541103,1672542018,915
3432,3755848152,3480100311,1672699882,1672701360,1478
3500,3938503547,3783373154,1672651464,1672654216,2752
3719,3610358027,3757383891,1672551470,1672554959,3489
3674,3618354185,3514419100,1672558889,1672560809,1920
3711,3505437712,3500208903,1672679847,1672682091,2244
3887,3713911104,3533368789,1672596577,1672597173,596
3844,3773332082,3514971533,1672578574,1672581097,2523
3652,3517697722,3316800320,1672568139,1672569656,1517
3879,3534179433,3338390596,1672645894,1672648378,2484
3779,3773027597,3514512367,1672597237,1672597726,489
3542,3817813340,3554825448,1672596997,1672597401,404
3506,3831586487,3396726504,1672645947,1672649327,3380
3565,3716110860,3241790910,1672561244,1672561490,246
3486,3448875382,3520873221,1672691621,1672692550,929
3830,3516489668,3500915665,1672569976,1672573287,3311
3662,3513041785,3497808662,1672671126,1672672839,1713
3861,3793922324,3519142371,1672664583,1672664683,100
3916,3683113954,3239617320,1672650134,1672653201,3067
3518,3600876425,3927165965,1672634661,1672636934,2273
3797,3511288998,3777330107,1672567053,1672570184,3131
3697,3713768950,3793969543,1672638999,1672639889,890
3652,3713163045,3711006062,1672682732,1672683101,369
3463,3497808662,3276348699,1672541042,1672542287,1245
3681,3812534508,3716679950,1672571493,1672574734,3241
3743,3225029895,3491684096,1672554247,1672556580,2333
3654,3239617320,3201629017,1672652838,1672655292,2454
3448,3760924079,3556969573,1672688474,1672688859,385
3885,3240394404,3459681410,1672667660,1672669620,1960
3779,3517172354,3514703118,1672610119,1672611427,1308
3742,3755344363,3905899155,1672592272,1672594730,2458
3909,3509764635,3491469603,1672596251,1672598906,2655
3429,3205923620,3938503547,1672692366,1672695962,3596
3676,3972083617,3463849738,1672694557,1672698057,3500
3434,3357864626,3688490530,1672533248,1672536547,3299
3858,3475349791,3512958459,1672556704,1672560257,3553
3452,3760094385,3379143440,1672667962,1672669191,1229
3489,3773837847,3272716462,1672664119,1672666868,2749
3584,3276217799,3299125059,1672652228,1672655326,3098
3483,3776518452,3793743698,1672610009,1672611275,1266
3921,3668533536,3780115155,1672554899,1672558275,3376
3715,3380767040,3625463628,1672593390,1672595118,1728
3617,3971806004,3505434346,1672566893,1672567168,275
3430,3414049538,3438078818,1672701339,1672701579,240
3675,3497671225,3715707380,1672683614,1672685356,1742
3681,3621790707,3534175249,1672646298,1672647277,979
3898,3970909253,3773009828,1672584361,1672584818,457
3758,3776117322,3626499450,1672638736,1672641707,2971
3631,3283770991,3431460073,1672597195,1672599950,2755
3546,3701322924,3308760650,1672536522,1672537422,900
3823,3609881958,3201800997,1672573465,1672576250,2785
3622,3927599181,3931627862,1672682131,1672684788,2657
3498,3897134762,3624297844,1672642738,1672645807,3069
3592,3510919821,3773735484,1672560831,1672562416,1585
3888,3552824113,3512282789,1672603312,1672605860,2548
3816,3780769110,3417679834,1672558003,1672561295,3292
3554,3773332082,3533368789,1672681780,1672682481,701
3656,3511024016,3380130228,1672570655,1672572811,2156
3675,3780427126,3898314440,1672597449,1672600127,2678
3563,3509756823,3668533536,1672682849,1672684694,1845
3882,3900276517,3639050419,1672557571,1672558114,543
3647,3884596900,3776117322,1672688829,1672689991,1162
3897,3715086894,3513853403,1672668033,1672671059,3026
3698,3497095254,3518653080,1672563538,1672565181,1643
3894,3501457103,3285204083,1672595381,1672595983,602
3688,3780427126,3394297564,1672599302,1672602170,2868
3650,3505888598,3892304880,1672581601,1672584186,2585
3798,3480991549,3835985172,1672644760,1672647054,2294
3721,3824641227,3519446663,1672692518,1672694729,2211
3437,3703798634,3512392431,1672604209,1672606100,1891
3458,3793583656,3501121099,1672554917,1672556915,1998
3763,3897376951,3609113156,1672692823,1672695846,3023
3910,3357289672,3500737582,1672590077,1672592027,1950
3671,3776084820,3618697021,1672629314,1672629679,365
3748,3231494505,3713911104,1672554807,1672556649,1842
3526,3552824113,3408430195,1672701871,1672703039,1168
3612,3505923418,3480100311,1672570663,1672571732,1069
3649,3821054646,3366423342,1672641648,1672642215,567
3726,3713517039,3621790707,1672583352,1672585559,2207
3835,3516741440,3757903168,1672687246,1672687976,730
3548,3460719322,3713691388,1672682541,1672684812,2271
3700,3404025196,3776244398,1672556602,1672557170,568
3614,3479851674,3505995057,1672648680,1672651321,2641
3726,3510798825,3811075491,1672559851,1672561589,1738
3452,3559731671,3226024417,1672613238,1672614924,1686
3538,3661903000,3688220326,1672548693,1672550761,2068
3596,3909094917,3510837901,1672570601,1672572486,1885
3579,3829822608,3613416045,1672692234,1672692924,690
3581,3927165965,3609113156,1672634393,1672636329,1936
3621,3777189898,3293835352,1672569132,1672572555,3423
3484,3341893384,3480991549,1672666629,1672668498,1869
3662,3293835352,3739895284,1672662240,1672664698,2458
3467,3517222913,3511005395,1672545470,1672547665,2195
3895,3448875382,3661447322,1672703562,1672704607,1045
3804,3231713082,3783433404,1672581849,1672583737,1888
3584,3920625129,3902861231,1672669189,1672672401,3212
3850,3734915241,3230868435,1672692858,1672695262,2404
3824,3516321888,3618354185,1672694717,1672697434,2717
3772,3351696332,3276217799,1672642177,1672643267,1090
3745,3350095157,3363162590,1672647911,1672651231,3320
3847,3292147449,3534126409,1672693167,1672694196,1029
3620,3410538749,3500341755,1672676356,1672678429,2073
3859,3505437712,3481640525,1672599342,1672599445,103
3552,3311049964,3512882178,1672613110,1672616023,2913
3619,3703348097,3626499450,1672644226,1672645763,1537
3841,3509756823,3755848152,1672687831,1672691219,3388
3644,3513065217,3760364383,1672592279,1672594120,1841
3823,3793969543,3716628503,1672589243,1672589374,131
3454,3713829743,3818575661,1672566752,1672569528,2776
3679,3779438325,3224968597,1672680738,1672682066,1328
3585,3330340793,3308760650,1672571952,1672572430,478
3552,3713768950,3774155692,1672636041,1672636732,691
3591,3449333754,3975717896,1672687381,1672689286,1905
3857,3757193551,3701823816,1672682910,1672685708,2798
3686,3757075324,3362641275,1672541708,1672544316,2608
3613,3618354185,3364378127,1672620148,1672622556,2408
3752,3791613604,3777814504,1672531951,1672532923,972
3906,3931627862,3271752081,1672597149,1672598245,1096
3667,3514741348,3821054646,1672552380,1672553524,1144
3711,3777624586,3389634034,1672570809,1672572271,1462
3780,3757193307,3319167958,1672583238,1672586042,2804
3899,3783136330,3934064792,1672699642,1672701164,1522
3513,3500915665,3515401243,1672699528,1672702470,2942
3491,3357289672,3685681577,1672587132,1672589696,2564
3792,3500317969,3971806004,1672543832,1672546249,2417
3446,3511005395,3774705415,1672684336,1672687503,3167
3588,3686523546,3279242917,1672637685,1672639400,1715
3621,3777091903,3791436104,1672593190,1672596396,3206
3879,3513360004,3710854064,1672545876,1672546534,658
3451,3435167810,3777485931,1672648404,1672649994,1590
3885,3902625986,3757863420,1672671169,1672672318,1149
3643,3519077659,3625463628,1672680404,1672680785,381
3496,3925979970,3510028805,1672668261,1672670984,2723
3840,3760924079,3551376095,1672670342,1672672847,2505
3729,3613338363,3887243870,1672588276,1672588965,689
3585,3224811762,3389634034,1672600792,1672603401,2609
3858,3462273042,3791128487,1672678558,1672681329,2771
3583,3757348722,3689697817,1672640610,1672641711,1101
3701,3334974375,3779656423,1672546855,1672547846,991
3796,3892304880,3510554314,1672588845,1672591936,3091
3727,3520764926,3520639768,1672688671,1672691788,3117
3467,3773033649,3732131656,1672684990,1672688003,3013
3854,3511288998,3824641227,1672610390,1672610587,197
3646,3734118023,3733363628,1672594331,1672594403,72
3594,3773837847,3511005395,1672696597,1672698774,2177
3638,3305336154,3757700712,1672690610,1672691178,568
3702,3617489344,3776988674,1672619745,1672620172,427
3821,3209481722,3770520359,1672698419,1672700555,2136
3594,3512379024,3615688740,1672537538,1672538517,979
3438,3515401243,3512379024,1672548400,1672548836,436
3546,3462273042,3713768950,1672670393,1672673332,2939
3770,3935399379,3684523966,1672572575,1672573841,1266
3820,3519416013,3500341755,1672699501,1672702768,3267
3765,3534175249,3793969543,1672535195,1672535788,593
3527,3512383699,3333403880,1672674208,1672677310,3102
3834,3519282716,3336339664,1672621778,1672624184,2406
3790,3394401087,3510798825,1672633294,1672636271,2977
3902,3551376095,3200543880,1672574626,1672577059,2433
3441,3417679834,3887243870,1672546645,1672546917,272
3522,3367971170,3900276517,1672646174,1672647384,1210
3656,3280054198,3512946768,1672608311,1672608375,64
3900,3311049964,3440107959,1672594836,1672597866,3030
3864,3778640261,3923420131,1672647299,1672650281,2982
3651,3336627643,3732131656,1672691092,1672692259,1167
3673,3505807416,3684523966,1672602418,1672603700,1282
3800,3773913680,3899786664,1672669164,1672671100,1936
3694,3517887477,3622357348,1672618082,1672620336,2254
3872,3715986185,3209481722,1672684430,1672686365,1935
3660,3773735484,3368283077,1672566225,1672566991,766
3584,3779639983,3852686295,1672689420,1672690305,885
3584,3915162005,3415833929,1672581587,1672583048,1461
3480,3710489491,3780472203,1672702343,1672705814,3471
3824,3517600136,3533004959,1672670355,1672671582,1227
3717,3774243020,3511442562,1672607421,1672609706,2285
3892,3757383891,3383138270,1672553206,1672553830,624
3460,3757075324,3300979975,1672627184,1672629983,2799
3632,3510187271,3783147088,1672606110,1672607794,1684
3661,3511150845,3793781065,1672657108,1672660381,3273
3443,3818575661,3201629017,1672630736,1672633425,2689
3658,3777240360,3739895284,1672680888,1672682207,1319
3494,3779786641,3633735593,1672659085,1672661838,2753
3693,3792525861,3228888030,1672594545,1672597603,3058
3474,3792489602,3825881598,1672655298,1672656184,886
3787,3392520516,3300511067,1672600573,1672601396,823
3631,3517288083,3460719322,1672601857,1672604265,2408
3633,3500709774,3431502855,1672533367,1672536242,2875
3821,3402385957,3505725706,1672550605,1672552380,1775
3768,3713768950,3934064792,1672532053,1672532955,902
3552,3510028805,3272030610,1672605417,1672605773,356
3606,3517737088,3689114185,1672591885,1672592900,1015
3800,3684523966,3774155692,1672675133,1672676807,1674
3633,3447514821,3517887477,1672645109,1672647360,2251
3469,3520873221,3760651515,1672655424,1672657858,2434
3741,3711077927,3779892400,1672611582,1672611807,225
3722,3319167958,3410160376,1672627103,1672629711,2608
3716,3551376095,3887243870,1672669427,1672672599,3172
3837,3533228966,3224968597,1672572929,1672574496,1567
3481,3714185969,3714067076,1672637390,1672639756,2366
3429,3515559913,3686523546,1672669560,1672672349,2789
3462,3710048469,3291933594,1672577348,1672580589,3241
3700,3534764451,3338083680,1672593963,1672597247,3284
3686,3619922891,3773121782,1672627992,1672631223,3231
3577,3757193307,3755158925,1672617407,1672620232,2825
3645,3389634034,3393063657,1672637085,1672638686,1601
3518,3408430195,3756474459,1672661119,1672662479,1360
3903,3710496785,3732131656,1672624454,1672627021,2567
3622,3399518841,3811075491,1672592635,1672593812,1177
3565,3533228966,3239617320,1672663752,1672667174,3422
3450,3921648519,3490029863,1672701202,1672704406,3204
3431,3779301501,3518561777,1672644685,1672645965,1280
3600,3270697740,3905899155,1672559265,1672559716,451
3514,3757700712,3227799827,1672675631,1672677153,1522
3647,3713300120,3714233826,1672676107,1672679108,3001
3707,3515439826,3710735406,1672635507,1672636593,1086
3913,3209481722,3270697740,1672629771,1672631800,2029
3722,3777091903,3732584121,1672660431,1672661458,1027
3777,3777694660,3305336154,1672677889,1672678321,432
3482,3971806004,3500072204,1672677381,1672679552,2171
3851,3780338697,3756746867,1672637074,1672637926,852
3532,3533294425,3853629553,1672701452,1672702976,1524
3563,3519651506,3803517637,1672701923,1672704715,2792
3514,3514512367,3638204468,1672592298,1672594843,2545
3870,3509764635,3500737582,1672614500,1672617983,3483
3432,3622357348,3839245934,1672688779,1672691780,3001
3618,3311098437,3715127070,1672534115,1672534730,615
3634,3904569677,3615737355,1672631999,1672633809,1810
3648,3793969543,3414275042,1672535650,1672538532,2882
3599,3512295534,3338083680,1672605493,1672605941,448
3494,3357689359,3783520186,1672646824,1672648098,1274
3497,3500525825,3701005527,1672623141,1672624565,1424
3896,3792745809,3283770991,1672558721,1672561490,2769
3837,3732131656,3517358573,1672591806,1672593504,1698
3649,3928719932,3500777439,1672677119,1672677944,825
3660,3516741440,3533423872,1672614623,1672617989,3366
3556,3441348818,3812369928,1672546874,1672548558,1684
3841,3711637255,3208452238,1672553773,1672555653,1880
3502,3509366311,3792949946,1672600924,1672602493,1569
3812,3276269264,3635169815,1672557816,1672558550,734
3895,3979802715,3480991549,1672613464,1672616860,3396
3796,3505634634,3410600350,1672660976,1672662561,1585
3440,3448875382,3293835352,1672541855,1672543378,1523
3562,3755344363,3291933594,1672556932,1672557682,750
3885,3899326793,3238288884,1672630526,1672632715,2189
3679,3452016771,3347446226,1672631696,1672632565,869
3742,3774876004,3779425804,1672544984,1672548430,3446
3871,3402697190,3808136029,1672597971,1672598856,885
3459,3334993594,3661583097,1672632017,1672634668,2651
3506,3495911207,3933894942,1672566669,1672569408,2739
3426,3501567772,3299443125,1672613548,1672616826,3278
3752,3487875183,3783771827,1672600764,1672603038,2274
3717,3791246640,3272716462,1672571551,1672574882,3331
3567,3520764926,3688490530,1672654239,1672655755,1516
3776,3248058676,3439673892,1672683506,1672684047,541
3461,3440137407,3500208903,1672567679,1672568454,775
3811,3970603231,3900898992,1672542081,1672542448,367
3474,3510919821,3431502855,1672610252,1672610731,479
3668,3437286517,3975717896,1672673978,1672675450,1472
3758,3800257590,3513081354,1672660441,1672663468,3027
3858,3615688740,3792489602,1672657801,1672659391,1590
3625,3710008361,3510187271,1672699711,1672701880,2169
3871,3202804048,3248058676,1672663619,1672666173,2554
3625,3755737419,3617116290,1672598763,1672600672,1909
3730,3404025196,3510964997,1672681270,1672682896,1626
3714,3246370118,3777037426,1672537272,1672537505,233
3729,3835985172,3501459390,1672647626,1672650871,3245
3642,3271752081,3757318448,1672650871,1672651659,788
3549,3401793306,3383138270,1672550074,1672551836,1762
3687,3825881598,3715400486,1672564093,1672565070,977
3606,3791693821,3739895284,1672633123,1672636371,3248
3649,3757323954,3310039260,1672674403,1672676625,2222
3425,3612689556,3462158237,1672564928,1672567092,2164
3891,3520416075,3505521218,1672679385,1672680073,688
3741,3902760230,3500857494,1672645911,1672646349,438
3551,3460719322,3402697190,1672620199,1672621671,1472
3560,3362641275,3757348722,1672637650,1672640684,3034
3651,3291933594,3639050419,1672572482,1672575411,2929
3465,3411515369,3923420131,1672670568,1672673811,3243
3901,3533368789,3518653080,1672573152,1672574557,1405
3520,3520991398,3711812325,1672625749,1672626003,254
3554,3475349791,3520181148,1672546001,1672547441,1440
3468,3783169442,3792949946,1672619231,1672620708,1477
3623,3511883730,3463740710,1672659507,1672662519,3012
3633,3895285664,3368283077,1672655946,1672657442,1496
3713,3774718695,3915162005,1672559811,1672561192,1381
3608,3834963772,3685681577,1672671741,1672675195,3454
3457,3497808662,3231494505,1672554916,1672556799,1883
3552,3519850727,3351866415,1672695371,1672698311,2940
3520,3935399379,3283770991,1672662502,1672666092,3590
3918,3839245934,3817813340,1672650580,1672651620,1040
3629,3912891315,3772236797,1672623102,1672626331,3229
3895,3701882224,3394297564,1672607789,1672609698,1909
3880,3557046880,3770438122,1672596588,1672599203,2615
3798,3779639983,3855583256,1672590492,1672591327,835
3529,3793175445,3516513251,1672652614,1672653552,938
3636,3398198430,3299125059,1672614950,1672616552,1602
3894,3333918941,3701424609,1672626158,1672627841,1683
3784,3500709774,3783169442,1672688979,1672689485,506
3694,3791128487,3792489602,1672596318,1672598086,1768
3745,3609659642,3485540729,1672539860,1672540175,315
3712,3519818818,3760651515,1672696310,1672699104,2794
3608,3660063072,3774031303,1672570358,1672573358,3000
3590,3904412440,3791106564,1672588173,1672588631,458
3871,3512882178,3373089838,1672575088,1672577179,2091
3446,3417679834,3780769110,1672680477,1672681047,570
3509,3357689359,3511843593,1672610162,1672610533,371
3899,3533747868,3478114114,1672590563,1672592714,2151
3905,3757294769,3337362061,1672647540,1672649693,2153
3686,3825881598,3755532873,1672587767,1672590588,2821
3805,3374183227,3513041785,1672612404,1672614028,1624
3850,3533294425,3613899351,1672581390,1672584569,3179
3623,3232208416,3505888598,1672645255,1672646585,1330
3636,3884596900,3773902805,1672611407,1672613870,2463
3877,3780115155,3774031303,1672630625,1672631189,564
3788,3488686442,3520657891,1672703235,1672703470,235
3667,3615688740,3755222916,1672661007,1672661186,179
3682,3451726367,3927165965,1672615089,1672618577,3488
3606,3510837901,3500703304,1672548397,1672551088,2691
3816,3780834916,3669146016,1672683956,1672684775,819
3611,3923754072,3513545422,1672548273,1672548714,441
3645,3703383853,3462636434,1672555826,1672559354,3528
3542,3515439826,3463740710,1672573491,1672576005,2514
3761,3512383699,3715854030,1672680962,1672684547,3585
3866,3776034743,3224330592,1672621140,1672621915,775
3854,3713941638,3792489602,1672570992,1672572882,1890
3551,3920497528,3534566651,1672647789,1672649870,2081
3549,3904412440,3710008361,1672680081,1672682107,2026
3647,3817428320,3931627862,1672689852,1672690128,276
3542,3231494505,3454277788,1672642954,1672643206,252
3442,3661583097,3711077927,1672602318,1672604709,2391
3624,3398198430,3774155692,1672589526,1672590988,1462
3645,3228888030,3462273042,1672564053,1672565647,1594
3839,3366423342,3774641380,1672557092,1672558406,1314
3882,3817813340,3689114185,1672621800,1672622988,1188
3789,3755737419,3373089838,1672685506,1672688130,2624
3485,3414940786,3895285664,1672546162,1672546598,436
3540,3556969573,3408430195,1672591742,1672592598,856
3483,3533649454,3777091903,1672627818,1672630983,3165
3874,3533004959,3367971170,1672531665,1672532887,1222
3736,3500915665,3519416013,1672687182,1672689713,2531
3775,3513018485,3730071479,1672591928,1672594795,2867
3869,3774178201,3394297564,1672619111,1672621200,2089
3833,3714185969,3923754072,1672569372,1672571197,1825
3733,3519416013,3516489668,1672587817,1672587923,106
3610,3760651515,3299125059,1672615444,1672616327,883
3877,3514512367,3510554314,1672564737,1672567209,2472
3696,3400069268,3714128600,1672550673,1672553611,2938
3845,3557046880,3757630221,1672638120,1672639698,1578
3850,3299781901,3711637255,1672647519,1672650725,3206
3489,3604867757,3770146716,1672632559,1672634192,1633
3681,3367111751,3338083680,1672654250,1672656456,2206
3782,3716272919,3505481368,1672650373,1672651891,1518
3566,3701107228,3514971533,1672696269,1672699687,3418
3909,3373089838,3770624662,1672572203,1672575768,3565
3848,3711919537,3236499444,1672699148,1672700380,1232
3757,3389634034,3515402792,1672701520,1672702621,1101
3860,3505521218,3624297844,1672703637,1672705000,1363
3872,3271752081,3289114629,1672558127,1672560333,2206
3529,3739661856,3343132529,1672558873,1672559551,678
3718,3817428320,3516444201,1672617563,1672620806,3243
3675,3773572967,3792072681,1672662490,1672664788,2298
3711,3505178849,3928511283,1672582394,1672584780,2386
3665,3635169815,3757294769,1672687550,1672687872,322
3815,3501786419,3283492940,1672669475,1672671864,2389
3722,3638660068,3715974659,1672586806,1672588982,2176
3636,3783147088,3902861231,1672680124,1672681994,1870
3447,3500498112,3220031931,1672570021,1672572806,2785
3888,3615113018,3792274796,1672568096,1672569721,1625
3544,3520657891,3294747828,1672671320,1672672474,1154
3570,3516298579,3780872464,1672628251,1672628596,345
3670,3351866415,3779938251,1672556338,1672559168,2830
3432,3512958459,3760362417,1672663303,1672663627,324
3808,3514324011,3779738691,1672688968,1672689306,338
3848,3970909253,3635169815,1672531316,1672534055,2739
3519,3920625129,3500347447,1672695825,1672698371,2546
3542,3638660068,3714067076,1672649499,1672651558,2059
3648,3897376951,3393063657,1672551383,1672552107,724
3664,3631479562,3455018347,1672546325,1672549209,2884
3881,3500109249,3710489491,1672533615,1672535402,1787
3725,3479851674,3500498112,1672570829,1672571441,612
3560,3713911104,3773913680,1672567868,1672571183,3315
3703,3410600350,3803517637,1672621631,1672623742,2111
3505,3623266256,3815392801,1672634484,1672634653,169
3920,3505111292,3515890966,1672571175,1672572731,1556
3602,3208452238,3291933594,1672635980,1672638247,2267
3687,3467779445,3833217041,1672693991,1672696167,2176
3456,3203538212,3520578796,1672627728,1672627837,109
3651,3755222916,3600876425,1672553126,1672553860,734
3848,3401793306,3923420131,1672605759,1672606966,1207
3822,3760842815,3417191856,1672647459,1672650096,2637
3643,3400763927,3622357348,1672697713,1672699748,2035
3638,3460719322,3225636215,1672588222,1672591602,3380
3514,3778597171,3505847380,1672690277,1672690570,293
3797,3711097754,3371455553,1672582940,1672585819,2879
3766,3364726656,3500857494,1672675223,1672676415,1192
3905,3292147449,3512830734,1672685411,1672686088,677
3682,3829822608,3518561777,1672594681,1672595138,457
3526,3773735484,3457960571,1672551319,1672554270,2951
3756,3559458968,3276003502,1672699382,1672701966,2584
3563,3972192593,3203538212,1672665713,1672667860,2147
3688,3760263530,3772391882,1672620609,1672622228,1619
3719,3500709774,3500317969,1672542081,1672543592,1511
3628,3714120857,3283492940,1672626290,1672628311,2021
3623,3904867554,3357289672,1672677995,1672680737,2742
3786,3756704774,3783373154,1672532860,1672536168,3308
3919,3457620713,3710496785,1672647730,1672647790,60
3733,3500613459,3487875183,1672656492,1672659851,3359
3494,3774290799,3520657891,1672632628,1672634334,1706
3437,3230868435,3631090677,1672634801,1672637187,2386
3611,3970909253,3715127070,1672686392,1672687399,1007
3666,3289817992,3638660068,1672620750,1672622529,1779
3844,3715086894,3770146716,1672595995,1672596318,323
3703,3520181148,3500347447,1672539893,1672540753,860
3908,3450969839,3716679950,1672664841,1672665376,535
3543,3300979975,3246370118,1672549916,1672553309,3393
3491,3511843593,3517172354,1672670732,1672673871,3139
3747,3780338697,3500915908,1672576562,1672577424,862
3681,3270042456,3793407963,1672621500,1672622042,542
3731,3713300120,3792546035,1672688801,1672692375,3574
3733,3900898992,3241790910,1672576695,1672579077,2382
3619,3780872464,3236354255,1672544677,1672546874,2197
3714,3415833929,3431502855,1672702251,1672704500,2249
3632,3516741440,3885121158,1672701410,1672704528,3118
3723,3680810086,3440107959,1672572829,1672575148,2319
3546,3451726367,3780571086,1672641398,1672641802,404
3576,3478114114,3701424609,1672619892,1672620835,943
3499,3803517637,3615115210,1672600454,1672601145,691
3875,3703348097,3660063072,1672612907,1672615676,2769
3591,3776518452,3279475486,1672588259,1672589533,1274
3917,3417679834,3972192593,1672606841,1672608653,1812
3728,3280054198,3519416013,1672627537,1672629602,2065
3687,3617392620,3505995057,1672652478,1672653198,720
3797,3756127300,3970198861,1672640625,1672641126,501
3589,3792801638,3505521218,1672633536,1672636694,3158
3745,3505178849,3448875382,1672617110,1672620655,3545
3782,3773121782,3229822507,1672658955,1672660232,1277
3722,3757294769,3783433404,1672532148,1672534903,2755
3884,3912891315,3513296868,1672550710,1672551596,886
3777,3715707380,3770468980,1672652603,1672655250,2647
3660,3510798825,3760040019,1672623055,1672624810,1755
3703,3825881598,3927599181,1672587131,1672588975,1844
3788,3715127070,3370227921,1672678288,1672679527,1239
3741,3520181148,3382733096,1672645766,1672647528,1762
3481,3639050419,3513065217,1672545855,1672546065,210
3476,3885155975,3923754072,1672655180,1672658107,2927
3903,3778640261,3551389192,1672633403,1672635340,1937
3909,3731646673,3714827719,1672606662,1672608790,2128
3707,3791128487,3517288083,1672684663,1672684882,219
3650,3977352557,3925979970,1672582271,1672583274,1003
3482,3783433404,3609933747,1672555581,1672558895,3314
3497,3897435944,3622665543,1672634349,1672634421,72
3427,3270042456,3757193551,1672692973,1672695393,2420
3796,3319167958,3514275974,1672643373,1672645136,1763
3719,3533649454,3660887799,1672598110,1672599927,1817
3690,3935487534,3853629553,1672549163,1672552591,3428
3461,3462273042,3756704774,1672662540,1672665238,2698
3920,3500737582,3511005395,1672554239,1672554347,108
3504,3205985903,3500613493,1672600917,1672603314,2397
3435,3400069268,3711006062,1672594235,1672596721,2486
3606,3610870949,3368283077,1672699868,1672701755,1887
3539,3713691388,3711734586,1672618536,1672621648,3112
3588,3500317969,3279475486,1672641312,1672643190,1878
3478,3909094917,3701664364,1672561299,1672563647,2348
3862,3500777439,3713829743,1672688336,1672689982,1646
3587,3364378127,3357289672,1672576257,1672577731,1474
3491,3734451191,3780680950,1672614927,1672617295,2368
3457,3711218296,3934064792,1672549578,1672550178,600
3726,3715086894,3513018485,1672661271,1672663540,2269
3870,3510642075,3791613604,1672573781,1672575862,2081
3594,3920898925,3839245934,1672631057,1672634553,3496
3727,3977148669,3520873221,1672633063,1672634924,1861
3916,3793781065,3619922891,1672681644,1672684772,3128
3736,3289817992,3389634034,1672540611,1672541404,793
3697,3288224595,3364726656,1672695311,1672698710,3399
3730,3701884158,3510642075,1672533614,1672534976,1362
3714,3609113156,3231494505,1672686141,1672689463,3322
3857,3626499450,3232208416,1672641081,1672643887,2806
3737,3774733620,3447514821,1672617111,1672619147,2036
3468,3449639012,3668747074,1672601344,1672602616,1272
3463,3280054198,3514285803,1672648671,1672651198,2527
3717,3501567772,3403370192,1672647377,1672650112,2735
3469,3428725843,3773033649,1672587331,1672588449,1118
3819,3554825448,3270697740,1672538349,1672541500,3151
3868,3505402439,3534175249,1672679496,1672683040,3544
3810,3710496785,3625463628,1672541771,1672543155,1384
3904,3347419520,3232208416,1672666418,1672669327,2909
3902,3777189898,3897456874,1672603228,1672604716,1488
3733,3701664364,3778134418,1672565281,1672567037,1756
3787,3622357348,3288762795,1672565656,1672568752,3096
3549,3500841914,3773939399,1672551657,1672554997,3340
3462,3513410578,3487875183,1672599307,1672602246,2939
3504,3373028638,3395201292,1672589320,1672592670,3350
3497,3499217428,3777189898,1672657484,1672659750,2266
3883,3364378127,3791796585,1672681588,1672682618,1030
3653,3793583656,3310039260,1672657071,1672657879,808
3774,3491684096,3703383853,1672632803,1672635732,2929
3476,3505521218,3306175858,1672608252,1672608764,512
3637,3755848152,3488763230,1672537031,1672540039,3008
3683,3409114719,3446533960,1672635589,1672635837,248
3841,3807212280,3618354185,1672569211,1672569336,125
3558,3836241528,3912891315,1672660021,1672660252,231
3802,3776244398,3923754072,1672681659,1672683939,2280
3437,3514246749,3310125159,1672604109,1672605832,1723
3635,3755404116,3274831810,1672629797,1672633298,3501
3755,3271454397,3363162590,1672629188,1672632595,3407
3829,3770236215,3738026330,1672623595,1672624280,685
3789,3366423342,3607768197,1672651262,1672654705,3443
3911,3416987084,3457960571,1672637631,1672639933,2302
3647,3757318448,3505847380,1672668538,1672669991,1453
3639,3713784974,3613206049,1672624476,1672625679,1203
3510,3819767045,3279475486,1672653325,1672655901,2576
3664,3710008361,3833217041,1672646124,1672647108,984
3623,3772391882,3511005395,1672668427,1672671553,3126
3817,3773837847,3517737088,1672609911,1672610103,192
3879,3239617320,3631479562,1672683413,1672683755,342
3709,3554825448,3500672156,1672684062,1672684361,299
3542,3516298579,3755915206,1672695982,1672699448,3466
3726,3438489358,3859868849,1672532296,1672534834,2538
3705,3904569677,3337322736,1672679452,1672682061,2609
3774,3660063072,3292147449,1672559599,1672562180,2581
3505,3513327337,3825881598,1672604646,1672606794,2148
3840,3551399764,3306175858,1672558572,1672560785,2213
3612,3533747868,3402385957,1672603027,1672605449,2422
3514,3279242917,3497095254,1672649194,1672650721,1527
3505,3783163143,3739661856,1672610592,1672612780,2188
3616,3497808662,3621184108,1672626739,1672628632,1893
3823,3772765746,3928719932,1672631953,1672635439,3486
3763,3774907131,3925979970,1672587924,1672590033,2109
3807,3780338697,3514971533,1672701077,1672703833,2756
3495,3380982774,3392943173,1672695683,1672697378,1695
3750,3435116799,3773735484,1672559266,1672560163,897
3542,3520181148,3403370192,1672681527,1672681918,391
3833,3783163143,3756746867,1672547128,1672550077,2949
3726,3755737419,3774243020,1672598665,1672601947,3282
3490,3497671225,3316798920,1672586168,1672589136,2968
3495,3559458968,3757903168,1672682082,1672683998,1916
3467,3472312341,3374183227,1672640124,1672640696,572
3920,3500317969,3500857494,1672545067,1672545659,592
3711,3824215187,3815250107,1672572606,1672572697,91
3508,3715545685,3401940259,1672696749,1672698653,1904
3917,3783340788,3792745809,1672660362,1672661459,1097
3713,3714678331,3715986185,1672551220,1672553470,2250
3531,3773837847,3311498666,1672583210,1672585865,2655
3859,3791046864,3554944414,1672603354,1672604603,1249
3795,3510798825,3315703693,1672648736,1672650822,2086
3919,3755737419,3270697740,1672586973,1672588277,1304
3827,3779938251,3770236215,1672687603,1672688341,738
3492,3755532873,3232208416,1672679074,1672681306,2232
3804,3776084820,3885537225,1672555028,1672557900,2872
3709,3437286517,3778899160,1672659916,1672663060,3144
3760,3505437712,3520355798,1672619797,1672620877,1080
3596,3500208903,3623266256,1672638704,1672640838,2134
3732,3971806004,3310039260,1672699587,1672700543,956
3882,3792274796,3511791953,1672577354,1672579331,1977
3625,3205985903,3485540729,1672684742,1672687512,2770
3427,3518229776,3497671225,1672571311,1672573279,1968
3697,3410160376,3710854064,1672687594,1672687895,301
3892,3713979100,3390660440,1672564979,1672566340,1361
3805,3701884158,3777189898,1672555335,1672558272,2937
3917,3900945856,3311098437,1672654038,1672654281,243
3700,3511601997,3512800570,1672642699,1672643865,1166
3749,3534543776,3457960571,1672574917,1672576705,1788
3841,3366423342,3227799827,1672691128,1672693191,2063
3730,3370068529,3394401087,1672627364,1672628361,997
3436,3450969839,3734915241,1672660751,1672661732,981
3522,3492959689,3933894942,1672562685,1672564176,1491
3894,3500072204,3773735484,1672643421,1672645692,2271
3652,3884596900,3488763230,1672683481,1672685761,2280
3856,3351866415,3551389192,1672583543,1672585738,2195
3663,3501567772,3533004959,1672656889,1672658394,1505
3826,3512502036,3738026330,1672623601,1672626565,2964
3581,3487875183,3308760650,1672586022,1672587583,1561
3914,3505995057,3505154885,1672682522,1672682710,188
3734,3520873221,3513360004,1672553445,1672556135,2690
3894,3776559988,3510641433,1672618104,1672619882,1778
3738,3513410578,3858172636,1672589873,1672591664,1791
3649,3354144091,3793315718,1672619169,1672621459,2290
3654,3272030610,3443357683,1672645931,1672648185,2254
3443,3533004959,3713768950,1672624907,1672625873,966
3680,3770296583,3450969839,1672549262,1672551308,2046
3498,3760842815,3505111292,1672645621,1672648060,2439
3892,3300979975,3500044458,1672695460,1672695922,462
3449,3451326054,3777189898,1672550762,1672550950,188
3596,3337322736,3773009828,1672613387,1672613761,374
3897,3716110860,3884596900,1672603457,1672606135,2678
3830,3311498666,3514324011,1672636789,1672640145,3356
3528,3520873221,3228888030,1672570677,1672573751,3074
3784,3368283077,3517737088,1672687385,1672689854,2469
3880,3930242012,3357689359,1672585835,1672587539,1704
3729,3552824113,3245232284,1672660434,1672663416,2982
3593,3517881647,3369708250,1672689985,1672690378,393
3657,3515525630,3773121782,1672687333,1672688570,1237
3876,3899326793,3738026330,1672692914,1672694398,1484
3479,3505198734,3283492940,1672549691,1672552393,2702
3459,3227799827,3823084403,1672668450,1672670778,2328
3685,3889780657,3270042456,1672682060,1672682674,614
3781,3516741440,3337362061,1672618465,1672621160,2695
3547,3715986185,3701322924,1672551835,1672553480,1645
3612,3551399764,3609933747,1672658461,1672659607,1146
3697,3399518841,3734451191,1672613632,1672616007,2375
3546,3390660440,3815250107,1672611815,1672612269,454
3755,3239617320,3500613459,1672619260,1672620144,884
3549,3417679834,3500302272,1672542801,1672543205,404
3809,3514285803,3755344363,1672662437,1672665975,3538
3454,3711812325,3360616538,1672630571,1672630978,407
3613,3551389192,3447672935,1672692938,1672693728,790
3813,3226178937,3613899351,1672662674,1672663477,803
3491,3780834916,3516489668,1672592927,1672594624,1697
3826,3770624662,3208957949,1672632521,1672633980,1459
3532,3273981374,3274831810,1672693439,1672695180,1741
3696,3604867757,3511883730,1672673376,1672673957,581
3752,3660887799,3780209375,1672564503,1672567921,3418
3449,3410160376,3304971369,1672690630,1672691695,1065
3824,3921648519,3773332082,1672628740,1672630394,1654
3443,3501121099,3622665543,1672658873,1672659198,325
3664,3201629017,3899326793,1672624149,1672626393,2244
3895,3239617320,3664943873,1672701110,1672701960,850
3597,3637313265,3935399379,1672653000,1672655580,2580
3537,3514246749,3900945856,1672544778,1672546589,1811
3656,3779646172,3800257590,1672691641,1672692314,673
3480,3441703884,3776559988,1672651164,1672654283,3119
3832,3739911441,3793175445,1672578585,1672579853,1268
3898,3500525825,3454277788,1672568538,1672570808,2270
3657,3505847380,3436025562,1672651844,1672654529,2685
3644,3272716462,3783373154,1672603756,1672606935,3179
3609,3485540729,3311049964,1672549576,1672550473,897
3711,3392520516,3701107228,1672566047,1672568307,2260
3639,3716963089,3517687662,1672664112,1672666434,2322
3486,3505521218,3369708250,1672567602,1672570890,3288
3763,3534179433,3772236797,1672612915,1672615504,2589
3835,3668747074,3774907131,1672684564,1672687790,3226
3692,3220031931,3713589994,1672533220,1672535508,2288
3890,3311098437,3668414677,1672555299,1672556521,1222
3810,3710562338,3779738691,1672541410,1672542909,1499
3605,3904412440,3288762795,1672701346,1672701511,165
3558,3515402792,3393063657,1672641133,1672642717,1584
3797,3734451191,3514703118,1672573255,1672574300,1045
3615,3382733096,3817428320,1672691352,1672692242,890
3904,3618808151,3770438122,1672639919,1672641026,1107
3586,3701373490,3900945856,1672604454,1672605029,575
3626,3238288884,3783928182,1672552454,1672554212,1758
3442,3511843593,3774290799,1672680321,1672681070,749
3821,3519416013,3239617320,1672575872,1672578875,3003
3598,3755230952,3815392801,1672543759,1672545242,1483
3524,3770468980,3338390596,1672585070,1672587325,2255
3672,3757348722,3401793306,1672701968,1672704910,2942
3671,3505725706,3362641275,1672635808,1672638731,2923
3850,3905899155,3224811762,1672620257,1672623197,2940
3485,3410538749,3780338697,1672650617,1672652676,2059
3644,3776244398,3713589994,1672696509,1672699857,3348
3491,3618176292,3333918941,1672565256,1672567776,2520
3768,3367509761,3812534508,1672554879,1672558251,3372
3912,3683113954,3733558985,1672626576,1672629658,3082
3653,3803389195,3505663516,1672600975,1672604573,3598
3857,3505111292,3770236215,1672623817,1672625519,1702
3502,3505198734,3517358573,1672621396,1672621741,345
3747,3270056120,3714128600,1672699143,1672700694,1551
3778,3510554314,3512282789,1672661231,1672664653,3422
3741,3921648519,3713784974,1672587628,1672590335,2707
3807,3760640999,3974674109,1672557070,1672559784,2714
3729,3513410578,3316798920,1672568331,1672569891,1560
3789,3812534508,3519028898,1672640608,1672640959,351
3886,3364378127,3421385957,1672693943,1672695390,1447
3795,3774290799,3977148669,1672592525,1672595623,3098
3424,3495911207,3288762795,1672674116,1672677383,3267
3731,3852533643,3636329663,1672638523,1672641485,2962
3866,3927403123,3630353876,1672690626,1672693843,3217
3836,3533368789,3551399764,1672691351,1672691558,207
3574,3776988674,3347419520,1672554416,1672557819,3403
3582,3898314440,3613899351,1672698239,1672698646,407
3701,3779301501,3812369928,1672621993,1672623491,1498
3795,3376467719,3449333754,1672682532,1672685830,3298
3846,3279339278,3779738691,1672596745,1672598049,1304
3578,3512392431,3609881958,1672680724,1672682800,2076
3614,3780322355,3421385957,1672676322,1672678448,2126
3707,3534175249,3716963089,1672558102,1672561168,3066
3789,3392943173,3793883863,1672577117,1672580368,3251
3666,3517887477,3756385685,1672554103,1672557674,3571
3882,3435167810,3757193551,1672545674,1672546738,1064
3643,3517881647,3511843593,1672593696,1672593900,204
3564,3515401243,3613416045,1672541590,1672541696,106
3545,3755737419,3792020993,1672626039,1672628248,2209
3597,3517881647,3559458968,1672643958,1672645823,1865
3792,3500672156,3511442562,1672556114,1672558360,2246
3664,3755992176,3635169815,1672680061,1672680931,870
3663,3270056120,3337322736,1672680744,1672681459,715
3742,3436025562,3711097754,1672644185,1672647321,3136
3792,3226178937,3505521218,1672547240,1672549655,2415
3545,3780712350,3776518452,1672671303,1672673753,2450
3592,3500857494,3517222913,1672610070,1672613055,2985
3752,3437286517,3554944414,1672694886,1672697715,2829
3724,3621184108,3367509761,1672564771,1672565673,902
3885,3774705415,3416987084,1672689445,1672692656,3211
3517,3755230952,3201676087,1672669540,1672671715,2175
3892,3660063072,3514512367,1672634804,1672635121,317
3565,3760364383,3411688875,1672591954,1672592246,292
3879,3792072681,3509756823,1672566964,1672568767,1803
3790,3607882826,3780769110,1672560874,1672562005,1131
3870,3779532653,3773027597,1672637331,1672640299,2968
3745,3500109249,3703383853,1672562168,1672563154,986
3859,3485540729,3893912331,1672638364,1672639816,1452
3557,3611055563,3756625818,1672536408,1672537997,1589
3504,3310125159,3512392431,1672590875,1672594416,3541
3541,3461119815,3760924079,1672659778,1672662529,2751
3816,3298151889,3783928182,1672559847,1672561695,1848
3609,3305722859,3534543776,1672678738,1672678882,144
3573,3773913680,3615688740,1672640480,1672643850,3370
3728,3711919537,3668747074,1672698808,1672701117,2309
3550,3516489668,3855583256,1672550047,1672550132,85
3597,3534179433,3308760650,1672611332,1672614391,3059
3646,3370068529,3773009828,1672618923,1672621990,3067
3515,3755222916,3736705719,1672678962,1672679358,396
3846,3516703758,3226024417,1672641374,1672641777,403
3598,3311098437,3230135532,1672616003,1672619275,3272
3584,3625463628,3710735406,1672543851,1672546245,2394
3618,3371455553,3315279093,1672592498,1672594365,1867
3770,3450969839,3500442734,1672599686,1672603277,3591
3465,3974674109,3622665543,1672611055,1672612274,1219
3755,3410538749,3513018485,1672665957,1672669204,3247
3648,3436025562,3627368399,1672542322,1672543834,1512
3846,3512392431,3688220326,1672689478,1672692668,3190
3764,3615939504,3783147088,1672575661,1672576429,768
3767,3791753345,3793743698,1672552293,1672553401,1108
3855,3715707380,3334993594,1672664554,1672666361,1807
3890,3414049538,3514308235,1672563712,1672566336,2624
3839,3701823816,3511024016,1672596980,1672597162,182
3473,3455018347,3319167958,1672589790,1672591089,1299
3802,3791046864,3491469603,1672666538,1672668501,1963
3502,3710489491,3777624586,1672641576,1672645043,3467
3628,3760364383,3617304541,1672644427,1672644780,353
3780,3906536154,3209526819,1672609482,1672611227,1745
3661,3511442562,3373028638,1672680297,1672682582,2285
3541,3500915665,3757323954,1672667344,1672669476,2132
3527,3225636215,3755404116,1672685401,1672688015,2614
3437,3669146016,3534543776,1672668540,1672669709,1169
3906,3812534508,3534175249,1672592704,1672594796,2092
3694,3312998540,3448875382,1672619489,1672622141,2652
3733,3291933594,3774031303,1672532586,1672535444,2858
3846,3975717896,3363162590,1672680233,1672682898,2665
3836,3274831810,3893912331,1672540551,1672543091,2540
3822,3374183227,3516703758,1672556191,1672559676,3485
3535,3208452238,3367971170,1672656790,1672659388,2598
3738,3621683102,3520578796,1672573300,1672576118,2818
3760,3755756564,3520322124,1672560923,1672561620,697
3593,3500672156,3701884158,1672674744,1672675827,1083
3862,3514308235,3711000597,1672657149,1672660741,3592
3479,3414275042,3200543880,1672531808,1672533058,1250
3828,3415833929,3300511067,1672533608,1672535069,1461
3782,3817428320,3914691363,1672633088,1672635780,2692
3603,3534566651,3780712350,1672608447,1672609800,1353
3485,3713911104,3462636434,1672602968,1672606358,3390
3581,3437286517,3621184108,1672587761,1672591347,3586
3793,3713300120,3411515369,1672621117,1672622311,1194
3661,3756746867,3461119815,1672551781,1672552234,453
3705,3792072681,3792505974,1672561512,1672564540,3028
3715,3513360004,3398731252,1672583617,1672585169,1552
3827,3315703693,3614740489,1672598829,1672601488,2659
3772,3760040019,3760645796,1672600774,1672601200,426
3650,3289817992,3972192593,1672538966,1672541515,2549
3599,3714666884,3279475486,1672582715,1672583086,371
3723,3972083617,3891672228,1672586294,1672586801,507
3748,3205985903,3488686442,1672647737,1672648477,740
3860,3417679834,3931627862,1672548926,1672549316,390
3496,3610870949,3289114629,1672631142,1672632482,1340
3648,3713941638,3283770991,1672550651,1672551915,1264
3430,3757075324,3701136026,1672631183,1672632826,1643
3486,3701664364,3472068734,1672659447,1672659574,127
3603,3512337405,3792745809,1672627416,1672627792,376
3717,3932478321,3510641433,1672639247,1672642142,2895
3554,3760694096,3315703693,1672644462,1672646578,2116
3844,3276217799,3511150845,1672678339,1672681506,3167
3744,3737147209,3517590837,1672555224,1672557126,1902
3540,3333403880,3480490124,1672573473,1672575598,2125
3814,3505179890,3515401243,1672594515,1672595098,583
3891,3315279093,3713911104,1672699488,1672701334,1846
3671,3834631333,3900945856,1672595485,1672596782,1297
3726,3760694096,3505111292,1672688267,1672690340,2073
3696,3755573472,3246370118,1672669851,1672673181,3330
3879,3770438122,3618489670,1672549133,1672549889,756
3747,3783147088,3774178201,1672662943,1672663730,787
3896,3780115155,3451726367,1672694087,1672696336,2249
3723,3755065949,3479851674,1672537340,1672539517,2177
3885,3685681577,3760094385,1672622734,1672625609,2875
3714,3311085279,3977148669,1672588440,1672588847,407
3899,3736705719,3776034743,1672572355,1672574468,2113
3834,3831586487,3387594369,1672588614,1672589168,554
3554,3387594369,3304971369,1672652503,1672655183,2680
3863,3343132529,3517358573,1672698826,1672701204,2378
3878,3368283077,3436025562,1672585628,1672586058,430
3668,3858172636,3514419100,1672548979,1672550561,1582
3434,3367971170,3440107959,1672583116,1672585234,2118
3471,3777147510,3710735406,1672674542,1672674947,405
3446,3774155692,3418448389,1672615337,1672615401,64
3456,3447514821,3737972328,1672688422,1672690635,2213
3718,3501567772,3501215099,1672658579,1672659364,785
3822,3240994288,3478114114,1672571578,1672572394,816
3699,3224330592,3227799827,1672685677,1672686817,1140
3494,3514334067,3610870949,1672580669,1672581321,652
3844,3889780657,3935913584,1672562468,1672564486,2018
3592,3347446226,3770676872,1672632072,1672634776,2704
3724,3520560590,3770236215,1672608480,1672610004,1524
3707,3604867757,3513545422,1672532328,1672534550,2222
3445,3715707380,3451326054,1672652362,1672654013,1651
3426,3311420950,3449333754,1672573046,1672573213,167
3695,3610358027,3437286517,1672615612,1672616074,462
3769,3334974375,3779532653,1672597891,1672599464,1573
3465,3715385401,3500709774,1672539870,1672540054,184
3529,3970627281,3439673892,1672601257,1672602712,1455
3482,3279473441,3364378127,1672650945,1672651245,300
3771,3449333754,3457620713,1672654712,1672656401,1689
3475,3734915241,3770296583,1672696631,1672699730,3099
3648,3509366311,3792525861,1672664281,1672666022,1741
3699,3711006062,3517172354,1672641804,1672642690,886
3434,3858172636,3500604680,1672550154,1672553002,2848
3645,3276348699,3757348722,1672682182,1672682505,323
3781,3780338697,3512392431,1672587157,1672589031,1874
3487,3757193551,3509764635,1672599192,1672602158,2966
3547,3276003502,3703139663,1672630758,1672632546,1788
3772,3902760230,3468041839,1672650551,1672653373,2822
3487,3633735593,3276217799,1672580191,1672581150,959
3869,3492546679,3897435944,1672669809,1672671220,1411
3471,3225631197,3906536154,1672573507,1672574064,557
3441,3605221116,3780322355,1672618918,1672621280,2362
3918,3288224595,3394401087,1672692005,1672692350,345
3497,3711006062,3357864626,1672588030,1672588413,383
3864,3716963089,3615087943,1672555688,1672557848,2160
3817,3512379024,3334647380,1672637813,1672639255,1442
3478,3773121782,3783340788,1672591846,1672592905,1059
3717,3631479562,3972192593,1672570496,1672572097,1601
3693,3516321888,3780472203,1672665581,1672666841,1260
3746,3935399379,3451326054,1672562163,1672564520,2357
3702,3404025196,3933894942,1672630893,1672631884,991
3742,3510641433,3417679834,1672583313,1672585129,1816
3431,3559458968,3739895284,1672586773,1672587596,823
3660,3701823816,3661903000,1672675012,1672675869,857
3550,3757193307,3772078494,1672557740,1672559847,2107
3450,3686227677,3898314440,1672623060,1672624795,1735
3523,3734118023,3757193307,1672682737,1672682993,256
3556,3515401243,3783615982,1672680847,1672684266,3419
3588,3617116290,3760694096,1672634905,1672638320,3415
3769,3904569677,3793883863,1672559804,1672561480,1676
3465,3778597171,3688796737,1672595693,1672597640,1947
3820,3779613523,3710496785,1672636380,1672639290,2910
3735,3517590837,3609659642,1672698851,1672700852,2001
3482,3559458968,3518229776,1672697628,1672699515,1887
3813,3853629553,3500827202,1672676978,1672677306,328
3782,3711853996,3517697722,1672565509,1672567682,2173
3649,3760842815,3703383853,1672654282,1672654787,505
3588,3859868849,3916490839,1672606835,1672609903,3068
3722,3408430195,3609113156,1672622557,1672625593,3036
3605,3774907131,3516703758,1672659259,1672662483,3224
3666,3812534508,3608232640,1672650388,1672651275,887
3749,3778134418,3774705415,1672533422,1672535240,1818
3767,3668533536,3273981374,1672590677,1672591410,733
3730,3505847380,3975717896,1672629545,1672630910,1365
3854,3935913584,3739154408,1672597698,1672600809,3111
3861,3510028805,3618489670,1672564821,1672568315,3494
3436,3404025196,3711006062,1672534121,1672535255,1134
3903,3793175445,3368283077,1672604615,1672606259,1644
3827,3294747828,3669146016,1672569837,1672573258,3421
3632,3512800570,3733363628,1672586206,1672587699,1493
3764,3755230952,3773572967,1672662181,1672665362,3181
3908,3739895284,3533294425,1672672830,1672675624,2794
3673,3448633776,3448875382,1672542407,1672543543,1136
3539,3373028638,3778640261,1672545063,1672545297,234
3605,3701882224,3609113156,1672677969,1672679886,1917
3747,3713829743,3760645796,1672642589,1672644084,1495
3712,3716679950,3902861231,1672628114,1672629952,1838
3834,3514956366,3347419520,1672636018,1672637600,1582
3882,3780427126,3519087371,1672531554,1672532290,736
3454,3513081354,3713829743,1672677919,1672678394,475
3431,3447514821,3778597171,1672585865,1672588252,2387
3592,3610870949,3499217428,1672668354,1672669777,1423
3448,3777091903,3554825448,1672568612,1672569253,641
3477,3779786641,3710496785,1672607431,1672610752,3321
3773,3367111751,3554186380,1672558755,1672559551,796
3743,3703383853,3229822507,1672702202,1672703129,927
3593,3755158925,3831586487,1672613827,1672615402,1575
3874,3783136330,3760040019,1672613608,1672614460,852
3743,3701884158,3713784974,1672546795,1672548742,1947
3473,3424660806,3734118023,1672670324,1672672086,1762
3712,3905196766,3686227677,1672561075,1672561532,457
3723,3665998641,3780769110,1672547803,1672549185,1382
3467,3437286517,3517687662,1672679352,1672682212,2860
3690,3283492940,3776084820,1672690903,1672694093,3190
3700,3715974659,3773913680,1672531753,1672533599,1846
3700,3791693821,3461119815,1672692923,1672695134,2211
3917,3613416045,3826238375,1672670688,1672672664,1976
3892,3930242012,3714233826,1672662469,1672663825,1356
3730,3755573472,3760721303,1672635851,1672639092,3241
3699,3714670620,3533929349,1672623379,1672626886,3507
3732,3609659642,3491469603,1672574478,1672577824,3346
3454,3977148669,3300979975,1672606317,1672607886,1569
3586,3516741440,3701373490,1672610556,1672614154,3598
3780,3714827719,3533423872,1672579358,1672582628,3270
3629,3668747074,3636329663,1672682883,1672684353,1470
3749,3906536154,3792525861,1672697078,1672697469,391
3905,3398198430,3559731671,1672551594,1672554318,2724
3621,3306412634,3613338363,1672667976,1672668277,301
3514,3226024417,3780872464,1672677971,1672679275,1304
3624,3774290799,3362641275,1672642158,1672644860,2702
3686,3921648519,3625463628,1672593663,1672596507,2844
3864,3711734586,3228888030,1672595241,1672595699,458
3870,3315703693,3776244398,1672702983,1672703138,155
3584,3512502036,3773124276,1672598864,1672599213,349
3755,3511732493,3884596900,1672667982,1672671238,3256
3643,3500613459,3311098437,1672634699,1672637325,2626
3726,3732584121,3399472693,1672685417,1672686457,1040
3620,3925979970,3906536154,1672531559,1672532367,808
3503,3338083680,3375449013,1672599324,1672601106,1782
3768,3517697722,3517600136,1672557191,1672559837,2646
3652,3773033649,3495911207,1672668749,1672670028,1279
3808,3226024417,3701247948,1672543698,1672543845,147
3789,3534126409,3792505974,1672674058,1672676455,2397
3778,3519416013,3715619259,1672602127,1672603290,1163
3623,3519850727,3518653080,1672532623,1672534026,1403
3717,3835422146,3921648519,1672537178,1672537991,813
3888,3514419100,3311085279,1672562692,1672565663,2971
3662,3792072681,3774155692,1672626762,1672628487,1725
3532,3608922867,3703348097,1672581276,1672583060,1784
3735,3554186380,3478114114,1672573378,1672574348,970
3469,3823084403,3490029863,1672620446,1672620986,540
3630,3512722110,3306175858,1672649949,1672650114,165
3425,3511005395,3497671225,1672674704,1672675273,569
3862,3505402439,3619922891,1672619181,1672619301,120
3664,3410600350,3505437712,1672591640,1672594077,2437
3569,3517687662,3343816795,1672607295,1672608619,1324
3656,3438489358,3714678331,1672549557,1672552367,2810
3798,3225029895,3517737088,1672590329,1672593031,2702
3850,3500604680,3456430614,1672550450,1672553729,3279
3674,3284932450,3505179890,1672638737,1672640445,1708
3670,3770624662,3514971533,1672653456,1672654153,697
3544,3853629553,3428027649,1672645971,1672649017,3046
3668,3715619259,3680843171,1672552552,1672555988,3436
3881,3414049538,3500777439,1672635056,1672636678,1622
3698,3600876425,3774790271,1672657843,1672658283,440
3795,3306412634,3711637255,1672634057,1672635121,1064
3429,3511843593,3469254160,1672646852,1672649889,3037
3729,3510642075,3491684096,1672561907,1672562752,845
3560,3715545685,3552824113,1672602085,1672603218,1133
3852,3454277788,3773332082,1672675273,1672675358,85
3863,3445206685,3387594369,1672640280,1672641514,1234
3895,3514324011,3551389192,1672684187,1672685554,1367
3837,3713768950,3408498208,1672590071,1672590447,376
3540,3392836218,3351696332,1672650516,1672650679,163
3657,3715707380,3713300120,1672610673,1672613629,2956
3700,3760362417,3469254160,1672645768,1672648221,2453
3542,3715619259,3299125059,1672598952,1672599734,782
3682,3500915908,3904569677,1672578425,1672581873,3448
3625,3533747868,3755233658,1672559999,1672561837,1838
3535,3514419100,3276269264,1672534811,1672537923,3112
3854,3509764635,3399472693,1672549180,1672551557,2377
3889,3454277788,3226024417,1672582556,1672585513,2957
3592,3701136026,3517462308,1672650231,1672650765,534
3474,3505179890,3884596900,1672587316,1672590315,2999
3644,3505178849,3512499658,1672577738,1672580688,2950
3785,3520764926,3776034743,1672560222,1672563421,3199
3723,3701107228,3756127300,1672654642,1672657061,2419
3559,3755915206,3774718695,1672670679,1672673444,2765
3777,3429943738,3438078818,1672656974,1672658627,1653
3919,3370068529,3456430614,1672586372,1672588758,2386
3425,3778640261,3520416075,1672629356,1672632348,2992
3578,3839245934,3208957949,1672682678,1672683290,612
3435,3495911207,3516444201,1672657236,1672657551,315
3609,3559731671,3225631197,1672578863,1672580077,1214
3734,3380767040,3512722110,1672626187,1672628928,2741
3428,3622665543,3410160376,1672695532,1672697113,1581
3427,3512830734,3485540729,1672551080,1672553696,2616
3791,3516741440,3713979100,1672685522,1672688585,3063
3764,3513545422,3470454332,1672674050,1672677197,3147
3571,3732131656,3276003502,1672595123,1672597161,2038
3616,3611055563,3791246640,1672638973,1672641684,2711
3769,3367111751,3688490530,1672583398,1672585846,2448
3781,3609881958,3777694660,1672671670,1672672781,1111
3914,3685816610,3334993594,1672701911,1672704416,2505
3566,3512722110,3443357683,1672626903,1672630325,3422
3466,3300818269,3701136026,1672647142,1672650522,3380
3549,3500442734,3604589802,1672656272,1672659866,3594
3590,3500703304,3779738691,1672546784,1672547802,1018
3829,3829864515,3760651515,1672599042,1672600067,1025
3515,3792389522,3793583656,1672584320,1672585011,691
3540,3757193551,3777694660,1672573926,1672576976,3050
3546,3441348818,3732131656,1672563684,1672564665,981
3578,3715707380,3801645328,1672607124,1672609351,2227
3669,3791106564,3770704999,1672672732,1672675205,2473
3785,3618489670,3914691363,1672592235,1672594147,1912
3801,3755404116,3774243020,1672562772,1672563072,300
3573,3608922867,3288762795,1672649597,1672653064,3467
3569,3241914067,3757630221,1672650024,1672651235,1211
3525,3755573472,3375449013,1672663053,1672663875,822
3634,3716272919,3226024417,1672572874,1672575294,2420
3678,3534357694,3760364383,1672538128,1672540430,2302
3596,3351696332,3773837847,1672568840,1672570175,1335
3707,3615113018,3205985903,1672625780,1672627999,2219
3601,3319167958,3829822608,1672543576,1672546919,3343
3636,3783136330,3777147510,1672688707,1672691675,2968
3605,3714185969,3815250107,1672592348,1672593969,1621
3899,3438489358,3467779445,1672569183,1672571322,2139
3541,3774155692,3501567772,1672558855,1672560936,2081
3463,3500442734,3783163143,1672551177,1672553420,2243
3636,3904412440,3783147088,1672698411,1672699606,1195
3756,3713300120,3979802715,1672584466,1672584907,441
3851,3736231757,3774178201,1672664695,1672666356,1661
3614,3823084403,3802932312,1672569018,1672570972,1954
3748,3231713082,3554186380,1672553564,1672557137,3573
3542,3608922867,3715127070,1672570023,1672572356,2333
3514,3209481722,3812534508,1672675432,1672678261,2829
3666,3923220461,3534175249,1672537655,1672541167,3512
3746,3900276517,3859868849,1672568911,1672571955,3044
3437,3488763230,3505923418,1672624631,1672624694,63
3765,3299125059,3815250107,1672550466,1672552232,1766
3801,3711637255,3774718695,1672695537,1672698964,3427
3908,3411515369,3475349791,1672595557,1672596381,824
3562,3514275974,3520322124,1672602423,1672604186,1763
3467,3701005527,3715545685,1672601724,1672603693,1969
3662,3935913584,3511317276,1672702122,1672704849,2727
3590,3714120857,3270056120,1672614371,1672616386,2015
3607,3514741348,3304155815,1672636976,1672640199,3223
3501,3715545685,3533228966,1672536787,1672538714,1927
3653,3516513251,3490214516,1672597348,1672598790,1442
3556,3688490530,3618176292,1672588515,1672591911,3396
3654,3513081354,3505283390,1672636808,1672637158,350
3725,3604589802,3556969573,1672690561,1672692470,1909
3829,3343816795,3500613459,1672604591,1672607139,2548
3728,3283144118,3792389522,1672604276,1672606912,2636
3689,3396726504,3621184108,1672616281,1672617890,1609
3707,3501525100,3760640999,1672646456,1672648420,1964
3862,3776559988,3906536154,1672541920,1672545283,3363
3601,3510642075,3520639768,1672606623,1672607086,463
3431,3271752081,3457960571,1672567768,1672569701,1933
3456,3760640999,3516321888,1672573486,1672575142,1656
3630,3462158237,3755737419,1672612963,1672616561,3598
3551,3757075324,3488686442,1672651999,1672654954,2955
3822,3780680950,3938389661,1672604783,1672607230,2447
3859,3631090677,3711097754,1672608756,1672608833,77
3653,3462636434,3625463628,1672623554,1672626354,2800
3907,3739154408,3390660440,1672636664,1672638417,1753
3834,3500709774,3701884158,1672594299,1672596463,2164
3424,3685816610,3518653080,1672655497,1672657239,1742
3617,3512295534,3283492940,1672664615,1672666985,2370
3527,3801645328,3688796737,1672540363,1672542392,2029
3431,3336627643,3770704999,1672593841,1672596592,2751
3556,3703396825,3229822507,1672687058,1672688434,1376
3706,3800257590,3739895284,1672572460,1672573754,1294
3731,3501215099,3701424609,1672538710,1672539790,1080
3462,3711097754,3783433404,1672605920,1672609302,3382
3481,3505402439,3711734586,1672547635,1672549966,2331
3864,3457620713,3610870949,1672680676,1672682697,2021
3810,3551376095,3227799827,1672554842,1672557300,2458
3734,3920898925,3559731671,1672536706,1672537576,870
3858,3511288998,3463740710,1672562394,1672565651,3257
3660,3280054198,3621683102,1672541236,1672542449,1213
3681,3519651506,3557046880,1672686419,1672687383,964
3870,3608855425,3354144091,1672585585,1672587202,1617
3699,3685816610,3661447322,1672639087,1672640162,1075
3539,3716963089,3701823816,1672634038,1672634312,274
3465,3440137407,3270056120,1672580472,1672583595,3123
3730,3778040015,3615087943,1672673871,1672675048,1177
3694,3500208903,3386758279,1672660416,1672661556,1140
3764,3510767239,3667673649,1672638118,1672641437,3319
3855,3401496246,3338083680,1672578035,1672579662,1627
3448,3979784676,3757294769,1672568016,1672568651,635
3596,3519077659,3780834916,1672592230,1672594532,2302
3778,3520115090,3480490124,1672534963,1672538309,3346
3771,3716628503,3513545422,1672658010,1672658662,652
3708,3779425804,3208452238,1672563984,1672565055,1071
3785,3615087943,3897456874,1672588072,1672590615,2543
3650,3296462324,3349739136,1672563029,1672566039,3010
3536,3777147510,3468041839,1672533597,1672536578,2981
3803,3890739241,3931627862,1672668347,1672668896,549
3766,3512282789,3613581796,1672692686,1672693264,578
3699,3201800997,3613581796,1672640995,1672643949,2954
3672,3638660068,3630353876,1672667322,1672668519,1197
3433,3201676087,3334993594,1672610897,1672612430,1533
3555,3714128600,3660887799,1672683549,1672687129,3580
3899,3513345163,3516444201,1672591524,1672592770,1246
3560,3760040019,3783169442,1672574588,1672575256,668
3433,3661903000,3757630221,1672616416,1672616929,513
3852,3811075491,3457960571,1672680773,1672683716,2943
3704,3514275974,3241790910,1672690907,1672693416,2509
3816,3776244398,3299125059,1672555644,1672557223,1579
3701,3333918941,3513065217,1672582431,1672584224,1793
3720,3238288884,3770438122,1672659463,1672662332,2869
3860,3533929349,3714067076,1672688792,1672691616,2824
3824,3791613604,3225631197,1672687878,1672691470,3592
3451,3274906650,3238288884,1672562248,1672564494,2246
3528,3970909253,3920898925,1672601625,1672604023,2398
3717,3716679950,3369708250,1672618738,1672621780,3042
3917,3505111292,3501215099,1672594895,1672597977,3082
3633,3715619259,3701664364,1672580164,1672583340,3176
3533,3711734586,3900898992,1672628686,1672631663,2977
3622,3461119815,3835422146,1672589988,1672591638,1650
3667,3475349791,3636329663,1672549064,1672549537,473
3829,3515402792,3451726367,1672679278,1672681832,2554
3454,3774243020,3367971170,1672564896,1672566107,1211
3500,3431502855,3369708250,1672639165,1672642306,3141
3891,3898314440,3853629553,1672613207,1672613403,196
3669,3835422146,3835985172,1672672148,1672673799,1651
3465,3756704774,3206837348,1672596814,1672597912,1098
3563,3492546679,3500208903,1672622272,1672624327,2055
3737,3703798634,3309314379,1672674726,1672677807,3081
3498,3779639983,3500827202,1672686924,1672688357,1433
3666,3773902805,3336339664,1672539454,1672540424,970
3572,3511005395,3900898992,1672689699,1672692740,3041
3438,3485540729,3512958459,1672619165,1672619408,243
3755,3927165965,3792949946,1672604905,1672606587,1682
3706,3617489344,3517462308,1672534931,1672536864,1933
3635,3336339664,3734118023,1672536310,1672537092,782
3703,3756385685,3778899160,1672540400,1672540961,561
3915,3294747828,3774290799,1672607122,1672610194,3072
3671,3480490124,3443357683,1672641709,1672644531,2822
3656,3715619259,3611055563,1672543969,1672546001,2032
3757,3448633776,3500915908,1672624730,1672625327,597
3630,3509483172,3304971369,1672645529,1672645979,450
3429,3703396825,3609881958,1672685911,1672688739,2828
3912,3300979975,3897456874,1672608666,1672609091,425
3637,3904412440,3711853996,1672701170,1672703832,2662
3491,3392520516,3534543776,1672633211,1672633784,573
3851,3713829743,3783771827,1672622820,1672624347,1527
3452,3490029863,3971806004,1672611545,1672615106,3561
3626,3850911686,3443357683,1672600988,1672602730,1742
3922,3412006598,3208452238,1672660770,1672663499,2729
3616,3664943873,3231494505,1672691846,1672692704,858
3808,3833217041,3755065949,1672633320,1672635346,2026
3905,3780322355,3515402792,1672605762,1672607225,1463
3447,3512282789,3974674109,1672680816,1672683459,2643
3666,3701005527,3617116290,1672534058,1672536168,2110
3860,3793883863,3780712350,1672565391,1672566103,712
3829,3760842815,3783801141,1672542779,1672545188,2409
3507,3380130228,3925979970,1672539616,1672540843,1227
3510,3552824113,3780680950,1672615530,1672618739,3209
3585,3279475486,3604589802,1672594592,1672594663,71
3886,3272716462,3203538212,1672593396,1672594231,835
3662,3347446226,3298151889,1672662260,1672664356,2096
3737,3316800320,3284932450,1672591652,1672593960,2308
3659,3776244398,3880926355,1672692887,1672694887,2000
3634,3610358027,3757863420,1672644744,1672646468,1724
3559,3513041785,3510642075,1672602594,1672605466,2872
3459,3280268483,3852533643,1672682506,1672684871,2365
3664,3534126409,3757075324,1672610733,1672611650,917
3517,3610358027,3904569677,1672551456,1672552453,997
3712,3514818819,3904867554,1672577970,1672581451,3481
3427,3609113156,3615737355,1672647141,1672649806,2665
3751,3757193307,3517687662,1672549522,1672549871,349
3865,3500341755,3927165965,1672564380,1672565604,1224
3677,3517222913,3859868849,1672547471,1672548234,763
3481,3488686442,3338390596,1672634834,1672636982,2148
3532,3715086894,3893912331,1672687128,1672689108,1980
3551,3520560590,3737112297,1672536490,1672539753,3263
3722,3778899160,3711853996,1672627490,1672630957,3467
3581,3791246640,3608855425,1672665141,1672666898,1757
3835,3683113954,3665998641,1672663272,1672666676,3404
3847,3414275042,3375449013,1672548591,1672550620,2029
3464,3519651506,3621790707,1672642323,1672643968,1645
3579,3714233826,3760924079,1672533854,1672537005,3151
3657,3774907131,3770704999,1672621552,1672623325,1773
3653,3517687662,3739661856,1672626400,1672626819,419
3446,3774790271,3512295534,1672561117,1672564690,3573
3447,3478114114,3480726047,1672663510,1672666784,3274
3812,3783340788,3500915665,1672694506,1672696595,2089
3505,3505266860,3685816610,1672544219,1672544755,536
3671,3780209375,3715974659,1672604202,1672605375,1173
3804,3850911686,3701424609,1672611809,1672615135,3326
3882,3463849738,3619922891,1672539550,1672542905,3355
3652,3770296583,3270697740,1672668886,1672672460,3574
3606,3783641602,3202804048,1672673111,1672673638,527
3614,3793868716,3793315718,1672605853,1672606473,620
3615,3514971533,3518229776,1672539236,1672539634,398
3505,3500915908,3701823816,1672551644,1672553288,1644
3587,3668747074,3478114114,1672542492,1672545881,3389
3864,3703433819,3511005395,1672651631,1672651896,265
3427,3437286517,3431460073,1672625920,1672627352,1432
3882,3308760650,3533929349,1672686192,1672687096,904
3569,3932478321,3501281016,1672598763,1672599497,734
3808,3513081354,3505266860,1672660797,1672663059,2262
3849,3511150845,3296462324,1672696272,1672698531,2259
3603,3701373490,3779854934,1672631098,1672633587,2489
3543,3505725706,3774290799,1672541606,1672545152,3546
3686,3294747828,3300229945,1672613156,1672614683,1527
3867,3514512367,3793418209,1672662950,1672666057,3107
3651,3299125059,3608855425,1672649820,1672652018,2198
3562,3554944414,3792072681,1672544659,1672546085,1426
3497,3757348722,3615939504,1672588387,1672589176,789
3489,3975717896,3500347447,1672585016,1672586846,1830
3749,3512946768,3904569677,1672658439,1672661323,2884
3919,3610870949,3661903000,1672565265,1672566398,1133
3794,3714666884,3792014516,1672593339,1672594678,1339
3571,3617116290,3384583385,1672668631,1672672196,3565
3730,3615113018,3701136026,1672676899,1672680031,3132
3648,3374183227,3802932312,1672622808,1672624876,2068
3714,3514512367,3514419100,1672561014,1672564181,3167
3466,3716110860,3713589994,1672549253,1672551488,2235
3547,3414049538,3373028638,1672656118,1672657955,1837
3452,3414940786,3367509761,1672617495,1672620833,3338
3594,3514275974,3609113156,1672623031,1672626026,2995
3719,3517288083,3779938251,1672548885,1672551220,2335
3456,3777779869,3613416045,1672539317,1672541497,2180
3642,3224811762,3225636215,1672602695,1672605763,3068
3601,3534566651,3435116799,1672658375,1672659349,974
3496,3600876425,3774290799,1672697685,1672700535,2850
3666,3517881647,3272096759,1672617455,1672618367,912
3910,3792525861,3515402792,1672613326,1672615291,1965
3714,3800257590,3296462324,1672602699,1672603365,666
3914,3438489358,3452016771,1672668166,1672671513,3347
3861,3757193551,3505266860,1672674634,1672675513,879
3891,3898314440,3500302272,1672617571,1672619443,1872
3609,3208452238,3511005395,1672630683,1672632493,1810
3899,3299443125,3248058676,1672560909,1672561543,634
3852,3667673649,3512946768,1672631958,1672634381,2423
3736,3272716462,3533079336,1672643999,1672644287,288
3791,3505725706,3715400486,1672678078,1672679777,1699
3520,3899786664,3783147088,1672577815,1672580571,2756
3706,3755915206,3668414677,1672605524,1672607811,2287
3794,3778926763,3923754072,1672596059,1672596629,570
3623,3510642075,3807212280,1672574735,1672576236,1501
3550,3714067076,3776117322,1672631471,1672633814,2343
3586,3608232640,3519446663,1672685196,1672688146,2950
3572,3241914067,3510919821,1672554000,1672555820,1820
3649,3470454332,3414275042,1672699147,1672699263,116
3587,3519282716,3715986185,1672603179,1672604498,1319
3898,3412968120,3481640525,1672617048,1672620272,3224
3815,3208452238,3534126409,1672700904,1672702294,1390
3557,3517358573,3715986185,1672644431,1672644693,262
3486,3514324011,3392943173,1672687963,1672688314,351
3455,3755915206,3512295534,1672643659,1672644164,505
3591,3360069849,3240994288,1672584138,1672586396,2258
3808,3284932450,3756789525,1672571439,1672572372,933
3661,3409114719,3716963089,1672653245,1672654751,1506
3899,3285204083,3208452238,1672586596,1672588227,1631
3813,3617489344,3505228454,1672580465,1672580701,236
3701,3533368789,3380982774,1672685718,1672687134,1416
3739,3341893384,3685681577,1672691017,1672693354,2337
3567,3497095254,3835422146,1672636644,1672637945,1301
3795,3638660068,3513853403,1672533662,1672534864,1202
3478,3635169815,3451726367,1672541256,1672541545,289
3544,3932478321,3300818269,1672674665,1672675951,1286
3599,3276269264,3921648519,1672571367,1672572569,1202
3904,3500525825,3778640261,1672562577,1672562792,215
3641,3714670620,3884596900,1672574882,1672575341,459
3672,3970603231,3468041839,1672671619,1672674800,3181
3753,3450969839,3736231757,1672683815,1672685186,1371
3875,3478114114,3450286949,1672639620,1672640849,1229
3486,3517600136,3509893027,1672612497,1672615535,3038
3848,3336627643,3739895284,1672608265,1672609135,870
3480,3516703758,3757323954,1672533734,1672535356,1622
3816,3231713082,3920497528,1672611937,1672613729,1792
3909,3336627643,3834960360,1672634367,1672637663,3296
3844,3411515369,3895285664,1672686189,1672687908,1719
3751,3505402439,3760842815,1672589626,1672591774,2148
3674,3780571086,3412006598,1672691059,1672693292,2233
3658,3715385401,3927165965,1672673028,1672674565,1537
3647,3716272919,3793969543,1672586124,1672588632,2508
3586,3514308235,3513360004,1672532666,1672534421,1755
3470,3386758279,3774718695,1672608498,1672609431,933
3743,3935399379,3399518841,1672703774,1672706259,2485
3647,3516444201,3517590837,1672617220,1672619577,2357
3635,3534175249,3711077927,1672652545,1672655554,3009
3564,3451726367,3774031303,1672655679,1672657321,1642
3719,3367111751,3500737582,1672644631,1672645211,580
3474,3472068734,3462273042,1672620890,1672624332,3442
3748,3618697021,3201800997,1672594501,1672595273,772
3478,3711097754,3367111751,1672559534,1672560853,1319
3458,3480490124,3793883863,1672532685,1672533805,1120
3567,3714670620,3701322924,1672647648,1672647741,93
3613,3514419100,3668747074,1672546510,1672547299,789
3917,3232208416,3456430614,1672615146,1672618231,3085
3653,3202804048,3308760650,1672641823,1672644757,2934
3704,3395201292,3363162590,1672539578,1672541348,1770
3612,3533079336,3284932450,1672593096,1672593497,401
3732,3934064792,3734915241,1672550557,1672551468,911
3749,3411688875,3334974375,1672617258,1672619619,2361
3636,3757323954,3515439826,1672568627,1672570198,1571
3768,3897435944,3770704999,1672685732,1672688737,3005
3693,3734118023,3271752081,1672640655,1672641193,538
3896,3736705719,3511791953,1672537167,1672538304,1137
3867,3689114185,3364378127,1672581379,1672581666,287
3914,3501459390,3289817992,1672537851,1672541205,3354
3653,3431460073,3757294769,1672637628,1672640883,3255
3663,3357289672,3739661856,1672687080,1672690140,3060
3471,3979802715,3500777439,1672561434,1672563492,2058
3837,3294747828,3519077659,1672569405,1672571639,2234
3551,3479851674,3757193307,1672609840,1672613279,3439
3719,3505663516,3510818674,1672703147,1672703765,618
3673,3734451191,3773332082,1672549720,1672549949,229
3817,3509756823,3279242917,1672547234,1672550385,3151
3796,3411688875,3400069268,1672619366,1672622559,3193
3561,3371455553,3617489344,1672699543,1672702265,2722
3904,3833217041,3623266256,1672565979,1672566561,582
3548,3500442734,3479851674,1672631964,1672633063,1099
3793,3711812325,3926643445,1672619085,1672621353,2268
3819,3756746867,3774605761,1672587919,1672589613,1694
3603,3341893384,3435116799,1672689467,1672690282,815
3802,3491469603,3778640261,1672538563,1672540773,2210
3463,3511732493,3904412440,1672537793,1672540665,2872
3439,3977352557,3513041785,1672565093,1672567452,2359
3889,3780322355,3783801141,1672564638,1672568166,3528
3685,3500613493,3467988782,1672549665,1672549899,234
3791,3858172636,3533090502,1672557463,1672559538,2075
3691,3501457103,3756789525,1672673904,1672675772,1868
3817,3439673892,3778134418,1672595422,1672597972,2550
3917,3780909839,3270042456,1672702660,1672703916,1256
3506,3224330592,3793175445,1672543831,1672545962,2131
3628,3403370192,3408498208,1672616848,1672617637,789
3677,3534829213,3889780657,1672682380,1672683134,754
3683,3455018347,3755496114,1672614508,1672615848,1340
3585,3500109249,3792538417,1672615680,1672619061,3381
3748,3208452238,3500604680,1672622698,1672625973,3275
3620,3306175858,3792489602,1672634868,1672637625,2757
3683,3774790271,3977148669,1672662766,1672665403,2637
3482,3424445495,3404025196,1672623118,1672625241,2123
3909,3711000597,3398731252,1672640620,1672644035,3415
3635,3357689359,3398731252,1672574280,1672576084,1804
3648,3225631197,3770624662,1672636215,1672636925,710
3470,3668414677,3279475486,1672556178,1672557019,841
3430,3514324011,3505923418,1672608658,1672608904,246
3444,3711637255,3505807416,1672563917,1672565282,1365
3501,3559731671,3755065949,1672549106,1672549178,72
3626,3887243870,3224968597,1672688138,1672688847,709
3429,3440137407,3533274994,1672698314,1672698619,305
3535,3791753345,3607768197,1672582894,1672584555,1661
3910,3436025562,3715854030,1672689926,1672693151,3225
3886,3517172354,3858172636,1672631816,1672633574,1758
3507,3370227921,3534543776,1672698421,1672701499,3078
3786,3776117322,3513065217,1672648496,1672650799,2303
3609,3533929349,3737112297,1672572942,1672575027,2085
3656,3271454397,3311098437,1672586076,1672587867,1791
3628,3410160376,3202141727,1672671927,1672672640,713
3526,3734451191,3519142371,1672613000,1672614383,1383
3682,3408498208,3510798825,1672697118,1672697323,205
3864,3334951866,3776518452,1672692136,1672693673,1537
3760,3392520516,3680843171,1672687454,1672688808,1354
3761,3713589994,3902760230,1672655613,1672655910,297
3899,3755344363,3607768197,1672563420,1672566177,2757
3550,3772236797,3703383853,1672563672,1672566100,2428
3554,3490029863,3336627643,1672546478,1672549713,3235
3734,3807212280,3456430614,1672632928,1672633975,1047
3454,3617489344,3480726047,1672672230,1672674601,2371
3634,3209481722,3777147510,1672667378,1672668515,1137
3874,3316800320,3760263530,1672604745,1672605417,672
3473,3435167810,3760362417,1672544035,1672546925,2890
3769,3520560590,3392520516,1672662342,1672665396,3054
3805,3757318448,3306412634,1672553698,1672554042,344
3857,3703348097,3972083617,1672680225,1672682158,1933
3887,3505228454,3970909253,1672641416,1672641892,476
3754,3792072681,3774705415,1672599631,1672600347,716
3661,3858172636,3975717896,1672560346,1672562103,1757
3747,3341893384,3511288998,1672621841,1672624883,3042
3440,3390660440,3418448389,1672676677,1672679150,2473
3537,3920625129,3778040015,1672685564,1672686972,1408
3502,3238288884,3510964997,1672542461,1672544707,2246
3895,3688490530,3716628503,1672702389,1672702892,503
3443,3774178201,3619922891,1672586516,1672589110,2594
3692,3777814504,3972083617,1672678999,1672682336,3337
3673,3505228454,3770468980,1672556407,1672559845,3438
3446,3478114114,3777814504,1672647774,1672650359,2585
3853,3516513251,3311049964,1672553751,1672556331,2580
3725,3682133690,3362641275,1672621873,1672622851,978
3621,3737112297,3228888030,1672617146,1672619699,2553
3581,3518653080,3305722859,1672610860,1672611265,405
3750,3668414677,3367111751,1672662513,1672664352,1839
3513,3755573472,3401496246,1672580861,1672582499,1638
3434,3500857494,3500672156,1672653845,1672654498,653
3816,3755230952,3776084820,1672612119,1672612608,489
3789,3299443125,3308760650,1672682316,1672685000,2684
3548,3424445495,3552824113,1672553076,1672554297,1221
3511,3500302272,3293835352,1672663779,1672665130,1351
3497,3533649454,3710008361,1672566604,1672567161,557
3474,3934064792,3770520359,1672667371,1672667960,589
3872,3617304541,3777779869,1672533865,1672535255,1390
3908,3760362417,3514308235,1672606487,1672606977,490
3825,3902760230,3392520516,1672536342,1672538712,2370
3908,3225631197,3760040019,1672592341,1672595681,3340
3886,3668533536,3276217799,1672686580,1672689343,2763
3908,3305336154,3793315718,1672676083,1672678999,2916
3495,3468041839,3779938251,1672615733,1672615937,204
3685,3783641602,3439673892,1672604484,1672605009,525
3778,3367509761,3920898925,1672655224,1672657511,2287
3607,3497671225,3714827719,1672627740,1672629968,2228
3619,3533747868,3713768950,1672627258,1672627646,388
3746,3792274796,3900945856,1672616984,1672617963,979
3840,3491469603,3399472693,1672599259,1672601415,2156
3736,3517288083,3774605761,1672560428,1672561647,1219
3728,3900276517,3793883863,1672688263,1672691290,3027
3738,3461119815,3276269264,1672674865,1672676733,1868
3766,3488686442,3357864626,1672577354,1672579759,2405
3534,3701005527,3517222913,1672551008,1672551503,495
3782,3738026330,3898314440,1672618029,1672621216,3187
3703,3505178849,3360069849,1672696115,1672697759,1644
3669,3714128600,3710315160,1672590246,1672591559,1313
3826,3505434346,3755233658,1672575651,1672576332,681
3478,3773033649,3713911104,1672632342,1672633973,1631
3501,3737972328,3414940786,1672591038,1672594234,3196
3634,3439673892,3900898992,1672609131,1672610829,1698
3762,3519028898,3459681410,1672540771,1672542163,1392
3483,3776831527,3780253901,1672640259,1672642861,2602
3817,3312998540,3770520359,1672666466,1672669556,3090
3800,3520115090,3478114114,1672534450,1672534784,334
3645,3519282716,3713300120,1672664866,1672665273,407
3664,3638204468,3783163143,1672598675,1672598887,212
3548,3933894942,3441348818,1672639554,1672642489,2935
3601,3516741440,3612689556,1672584157,1672584631,474
3440,3906536154,3613899351,1672533268,1672533866,598
3708,3225631197,3289114629,1672556058,1672557659,1601
3870,3500442734,3513065217,1672691047,1672691989,942
3683,3500525825,3552824113,1672633421,1672633959,538
3897,3533294425,3279339278,1672670709,1672671846,1137
3668,3200308999,3684523966,1672550040,1672551945,1905
3633,3283144118,3505228454,1672653404,1672655790,2386
3459,3438489358,3493017654,1672644999,1672646944,1945
3745,3402385957,3519142371,1672689453,1672692232,2779
3430,3920497528,3783550022,1672568661,1672571049,2388
3474,3513065217,3714067076,1672662505,1672663817,1312
3673,3429943738,3778597171,1672559592,1672561937,2345
3701,3333918941,3779438325,1672657334,1672659070,1736
3794,3505995057,3621461051,1672556107,1672556641,534
3576,3779854934,3491469603,1672663372,1672664972,1600
3477,3701823816,3713589994,1672570066,1672572154,2088
3465,3231713082,3780338697,1672643475,1672645008,1533
3647,3505847380,3410600350,1672639384,1672641550,2166
3837,3833217041,3701823816,1672551522,1672553095,1573
3868,3236458894,3554944414,1672537636,1672537800,164
3878,3231713082,3514512367,1672701956,1672704232,2276
3901,3280054198,3514741348,1672608974,1672610941,1967
3705,3200543880,3912891315,1672692075,1672692311,236
3861,3208452238,3279475486,1672635531,1672635869,338
3837,3374183227,3533188828,1672608252,1672609206,954
3787,3783615982,3760040019,1672556946,1672558164,1218
3770,3510642075,3755532873,1672646736,1672647749,1013
3752,3205985903,3208957949,1672557892,1672559085,1193
3867,3825881598,3336627643,1672687264,1672690673,3409
3694,3779786641,3713829743,1672693953,1672697481,3528
3496,3927165965,3732131656,1672578000,1672579855,1855
3818,3291933594,3715974659,1672664540,1672667179,2639
3657,3276269264,3682133690,1672612422,1672615615,3193
3624,3533294425,3760645796,1672535898,1672538320,2422
3824,3757903168,3617392620,1672539718,1672541619,1901
3496,3368283077,3351696332,1672678836,1672680303,1467
3671,3467779445,3501525100,1672642893,1672644938,2045
3720,3755344363,3515439826,1672695126,1672695764,638
3625,3906536154,3505521218,1672636822,1672639192,2370
3828,3893912331,3436257398,1672621043,1672622052,1009
3817,3755065949,3510499038,1672567799,1672569649,1850
3541,3519909393,3500709774,1672659131,1672662485,3354
3794,3779425804,3303410628,1672600219,1672602865,2646
3639,3715086894,3401940259,1672690678,1672691004,326
3483,3209526819,3276348699,1672535215,1672538021,2806
3794,3710854064,3554825448,1672538243,1672541164,2921
3435,3636329663,3208452238,1672539157,1672539765,608
3684,3396980894,3410600350,1672676106,1672678276,2170
3662,3273981374,3519850727,1672585299,1672587144,1845
3761,3609113156,3298151889,1672540227,1672541948,1721
3546,3497671225,3777189898,1672684126,1672686682,2556
3689,3510798825,3283144118,1672616878,1672617328,450
3880,3793883863,3811075491,1672610528,1672613312,2784
3744,3772078494,3225631197,1672582827,1672583658,831
3514,3271752081,3621461051,1672551214,1672552952,1738
3922,3757332128,3505179890,1672624249,1672627340,3091
3792,3736231757,3793868716,1672576951,1672579430,2479
3431,3773837847,3934064792,1672547612,1672549287,1675
3661,3713517039,3280054198,1672543237,1672544350,1113
3449,3462636434,3713691388,1672636939,1672637764,825
3778,3925979970,3715974659,1672626639,1672627895,1256
3569,3452016771,3393063657,1672566756,1672568750,1994
3456,3716628503,3245232284,1672651080,1672652010,930
3746,3501525100,3534566651,1672623777,1672626379,2602
3519,3710496785,3288224595,1672598010,1672598749,739
3720,3760651515,3415833929,1672665336,1672667181,1845
3596,3710489491,3710315160,1672672700,1672675582,2882
3523,3519142371,3517991730,1672555148,1672555549,401
3455,3500857494,3890739241,1672576306,1672576809,503
3682,3509893027,3510554314,1672629791,1672630250,459
3870,3505434346,3505402439,1672646720,1672646842,122
3601,3773572967,3519446663,1672555253,1672558498,3245
3590,3714827719,3385323994,1672569451,1672571129,1678
3436,3783373154,3515890966,1672678391,1672681690,3299
3428,3780680950,3276003502,1672703802,1672705106,1304
3734,3900945856,3451726367,1672615304,1672618632,3328
3520,3614740489,3904867554,1672662784,1672666353,3569
3711,3780427126,3230135532,1672694785,1672695234,449
3499,3334647380,3367971170,1672554313,1672555347,1034
3876,3205923620,3783919913,1672641373,1672642959,1586
3902,3772765746,3811040565,1672603303,1672604220,917
3538,3713517039,3514741348,1672664882,1672664971,89
3667,3517288083,3815250107,1672700478,1672701397,919
3711,3817428320,3462636434,1672610573,1672612739,2166
3707,3689697817,3780909839,1672586588,1672589008,2420
3683,3770468980,3850911686,1672533601,1672535683,2082
3518,3774641380,3534829213,1672658539,1672661935,3396
3546,3424445495,3283492940,1672565728,1672566713,985
3543,3713589994,3338083680,1672562457,1672562745,288
3770,3701107228,3505154885,1672622929,1672625473,2544
3584,3393063657,3357289672,1672597006,1672600238,3232
3805,3296462324,3500857494,1672564199,1672565569,1370
3738,3783147088,3533929349,1672593964,1672595960,1996
3439,3774605761,3513041785,1672534297,1672534545,248
3628,3319167958,3360813161,1672586271,1672589741,3470
3626,3511883730,3852686295,1672562308,1672563873,1565
3554,3294703680,3780909839,1672536198,1672536517,319
3813,3713589994,3855583256,1672672612,1672673012,400
3674,3451326054,3893912331,1672667163,1672667754,591
3788,3360069849,3778597171,1672686867,1672687314,447
3581,3519818818,3231494505,1672634261,1672637559,3298
3848,3609881958,3686523546,1672665057,1672668288,3231
3542,3334647380,3206837348,1672590059,1672590339,280
3706,3774907131,3824215187,1672561672,1672562365,693
3765,3770520359,3294747828,1672587977,1672588632,655
3816,3463849738,3412006598,1672651712,1672654815,3103
3828,3205985903,3701882224,1672622170,1672623570,1400
3641,3371455553,3338083680,1672660395,1672660969,574
3644,3334647380,3514818819,1672547134,1672548930,1796
3490,3341893384,3284932450,1672665499,1672665966,467
3442,3229974066,3734915241,1672550752,1672553235,2483
3697,3665998641,3733558985,1672591289,1672592554,1265
3715,3814677862,3779656423,1672655616,1672659077,3461
3858,3630353876,3772236797,1672660068,1672661094,1026
3815,3755230952,3778926763,1672686369,1672688334,1965
3830,3714067076,3457620713,1672589121,1672590130,1009
3837,3292147449,3777330107,1672563140,1672563452,312
3669,3238288884,3739895284,1672676756,1672677086,330
3715,3500613459,3756746867,1672552547,1672555487,2940
3543,3517737088,3792020993,1672577385,1672578764,1379
3646,3972192593,3316800320,1672690788,1672691416,628
3649,3500613459,3904412440,1672531622,1672534284,2662
3902,3715545685,3760263530,1672538706,1672541221,2515
3587,3460719322,3347419520,1672641457,1672643426,1969
3616,3905899155,3783340788,1672700551,1672701132,581
3815,3613581796,3404025196,1672667889,1672670455,2566
3729,3271752081,3509764635,1672554116,1672554301,185
3424,3511732493,3514971533,1672702717,1672706308,3591
3799,3418448389,3756385685,1672583082,1672586144,3062
3460,3791441520,3890739241,1672637215,1672639695,2480
3769,3311085279,3680843171,1672561840,1672563864,2024
3740,3273981374,3757863420,1672677867,1672679553,1686
3499,3554944414,3505521218,1672650049,1672650580,531
3468,3715974659,3456430614,1672662020,1672664292,2272
3766,3283144118,3713829743,1672693536,1672695737,2201
3754,3777147510,3931627862,1672689222,1672690345,1123
3512,3385323994,3363162590,1672601516,1672602332,816
3601,3716110860,3792525861,1672629849,1672632572,2723
3687,3902760230,3519087371,1672566098,1672569496,3398
3918,3239617320,3412968120,1672701618,1672703738,2120
3800,3713768950,3333403880,1672605869,1672609169,3300
3530,3224330592,3370068529,1672674334,1672675456,1122
3499,3447672935,3618808151,1672578826,1672579923,1097
3658,3279339278,3934064792,1672640129,1672641446,1317
3569,3780909839,3710562338,1672689347,1672691849,2502
3576,3512830734,3468041839,1672546575,1672546664,89
3600,3792949946,3713300120,1672606930,1672609720,2790
3654,3856606678,3821054646,1672543283,1672546787,3504
3552,3631479562,3615737355,1672610070,1672611143,1073
3895,3621683102,3493017654,1672585217,1672586169,952
3463,3519651506,3755532873,1672620383,1672621851,1468
3729,3814305099,3791441520,1672652206,1672653182,976
3853,3533929349,3618489670,1672637654,1672639905,2251
3468,3818575661,3920898925,1672691053,1672692463,1410
3634,3289114629,3455018347,1672694630,1672697933,3303
3522,3500208903,3431460073,1672543368,1672544499,1131
3631,3880926355,3902861231,1672652768,1672652965,197
3627,3710854064,3713300120,1672665101,1672665711,610
3434,3779301501,3236354255,1672689160,1672691241,2081
3906,3208452238,3783615982,1672656592,1672658132,1540
3581,3714827719,3760263530,1672545344,1672548835,3491
3759,3779892400,3411688875,1672687996,1672688934,938
3791,3773572967,3770704999,1672592962,1672593879,917
3841,3774718695,3780427126,1672632094,1672632618,524
3810,3755222916,3272716462,1672603292,1672605424,2132
3648,3488763230,3713163045,1672583315,1672585867,2552
3637,3779938251,3368283077,1672694107,1672696057,1950
3864,3898314440,3716963089,1672580444,1672581586,1142
3531,3711637255,3791128487,1672633363,1672634519,1156
3469,3533929349,3772236797,1672561489,1672563865,2376
3754,3500208903,3931627862,1672649649,1672650582,933
3912,3509764635,3683113954,1672607186,1672609633,2447
3450,3501786419,3803389195,1672648211,1672649820,1609
3620,3935913584,3517358573,1672568870,1672571913,3043
3462,3296462324,3515401243,1672628779,1672630065,1286
3759,3760040019,3774907131,1672570799,1672573487,2688
3567,3241790910,3224811762,1672647615,1672651116,3501
3692,3512882178,3631479562,1672551727,1672554487,2760
3500,3514275974,3714067076,1672630003,1672630641,638
3503,3889780657,3714678331,1672548198,1672548553,355
3464,3438489358,3734451191,1672626558,1672627526,968
3797,3236499444,3500777439,1672539542,1672543042,3500
3734,3783136330,3241790910,1672560870,1672562524,1654
3738,3202804048,3819767045,1672537365,1672537847,482
3765,3793583656,3227799827,1672578783,1672580493,1710
3823,3737112297,3755737419,1672539797,1672541670,1873
3501,3205985903,3311085279,1672584604,1672588086,3482
3837,3714067076,3889780657,1672643090,1672643887,797
3551,3777184389,3399472693,1672585247,1672587672,2425
3467,3791436104,3757863420,1672553357,1672553634,277
3510,3373028638,3514956366,1672653790,1672656034,2244
3557,3330340793,3500777439,1672694123,1672695901,1778
3622,3533004959,3803517637,1672613547,1672614766,1219
3867,3441703884,3513545422,1672680451,1672682939,2488
3872,3276003502,3925979970,1672608184,1672608531,347
3704,3713979100,3338083680,1672572567,1672575886,3319
3532,3448633776,3357289672,1672614583,1672618125,3542
3762,3501457103,3380767040,1672632538,1672633628,1090
3795,3333403880,3516513251,1672689287,1672690982,1695
3730,3517172354,3380130228,1672642647,1672643049,402
3717,3715619259,3689114185,1672564664,1672566480,1816
3733,3554186380,3230135532,1672583453,1672583718,265
3859,3898314440,3308760650,1672657628,1672660693,3065
3829,3970627281,3609659642,1672582259,1672582778,519
3763,3505807416,3501281016,1672544371,1672547654,3283
3511,3449639012,3660063072,1672626618,1672628179,1561
3858,3436025562,3714067076,1672691899,1672694092,2193
3568,3609881958,3760694096,1672537292,1672538568,1276
3656,3274906650,3923754072,1672689718,1672690811,1093
3864,3783169442,3778667336,1672695847,1672696820,973
3739,3229822507,3701005527,1672610347,1672611298,951
3476,3714670620,3306175858,1672672473,1672672840,367
3575,3300979975,3792949946,1672579905,1672581199,1294
3807,3660887799,3533188828,1672657025,1672660035,3010
3436,3311098437,3396980894,1672672309,1672673507,1198
3808,3835422146,3206837348,1672544200,1672544458,258
3739,3817813340,3487875183,1672674162,1672676557,2395
3687,3730071479,3826238375,1672692692,1672695870,3178
3503,3615115210,3270042456,1672670200,1672671788,1588
3847,3512337405,3283492940,1672643916,1672645425,1509
3481,3855583256,3780322355,1672644246,1672646740,2494
3636,3783550022,3520639768,1672591075,1672592459,1384
3613,3512295534,3905196766,1672667206,1672670329,3123
3451,3812534508,3231494505,1672549566,1672550309,743
3521,3660063072,3437286517,1672558203,1672560221,2018
3612,3772391882,3818575661,1672679374,1672682807,3433
3584,3774641380,3300229945,1672631921,1672632370,449
3518,3230868435,3500857494,1672650712,1672653530,2818
3725,3686227677,3792014516,1672607569,1672608928,1359
3685,3622357348,3715385401,1672649317,1672650014,697
3486,3509366311,3880926355,1672551026,1672554480,3454
3426,3825881598,3710048469,1672593287,1672594953,1666
3798,3371455553,3615939504,1672568367,1672569210,843
3713,3926643445,3554825448,1672608446,1672608825,379
3639,3685681577,3399518841,1672582396,1672583954,1558
3749,3341893384,3300229945,1672564486,1672567587,3101
3894,3306175858,3760040019,1672596692,1672598550,1858
3686,3902861231,3774243020,1672583450,1672586668,3218
3719,3520416075,3734118023,1672639968,1672640558,590
3592,3515890966,3776117322,1672647754,1672649431,1677
3832,3772236797,3505521218,1672643023,1672646090,3067
3809,3472068734,3852686295,1672556763,1672559060,2297
3513,3512800570,3460719322,1672646806,1672650177,3371
3845,3757348722,3932478321,1672542701,1672544018,1317
3753,3823084403,3661903000,1672686016,1672686678,662
3565,3512379024,3304971369,1672645982,1672649520,3538
3652,3733363628,3639050419,1672662315,1672664828,2513
3500,3209481722,3715854030,1672533695,1672537238,3543
3781,3932478321,3711812325,1672543617,1672544522,905
3910,3739154408,3517172354,1672594006,1672596893,2887
3424,3451726367,3311085279,1672632486,1672632915,429
3814,3791046864,3893912331,1672571539,1672574994,3455
3842,3701884158,3715986185,1672617523,1672617936,413
3441,3780571086,3715707380,1672662601,1672664211,1610
3908,3892304880,3517590837,1672552990,1672555223,2233
3913,3516444201,3514971533,1672535463,1672538953,3490
3609,3360069849,3850911686,1672669695,1672672403,2708
3808,3625463628,3408498208,1672611167,1672614217,3050
3789,3209526819,3715385401,1672679733,1672682656,2923
3573,3515559913,3755233658,1672593963,1672596564,2601
3697,3311085279,3792442597,1672627885,1672630473,2588
3730,3737112297,3505434346,1672619212,1672621931,2719
3433,3779532653,3783373154,1672677030,1672679807,2777
3626,3393063657,3701247948,1672679292,1672679753,461
3658,3500442734,3319167958,1672533210,1672534828,1618
3688,3200543880,3715974659,1672609165,1672609552,387
3534,3520181148,3755222916,1672682389,1672683255,866
3527,3791106564,3449639012,1672616201,1672619239,3038
3791,3793740407,3227799827,1672585665,1672585878,213
3872,3513296868,3713829743,1672661931,1672664795,2864
3526,3685681577,3343132529,1672677296,1672678714,1418
3748,3333403880,3710489491,1672617167,1672620747,3580
3676,3367971170,3500317969,1672608091,1672609966,1875
3441,3490214516,3900898992,1672546904,1672549861,2957
3457,3497808662,3776244398,1672590773,1672592707,1934
3472,3783801141,3451691949,1672671073,1672674602,3529
3493,3701882224,3714666884,1672629556,1672632383,2827
3796,3773332082,3715986185,1672579732,1672583277,3545
3866,3755065949,3791246640,1672567312,1672569825,2513
3613,3792020993,3513360004,1672659758,1672662645,2887
3653,3927403123,3617304541,1672558171,1672559052,881
3799,3424445495,3792014516,1672570535,1672573208,2673
3669,3713517039,3201629017,1672661792,1672663394,1602
3514,3757863420,3418448389,1672582478,1672583180,702
3711,3245232284,3475349791,1672583944,1672587414,3470
3893,3224330592,3617116290,1672547684,1672548794,1110
3714,3770296583,3902861231,1672557353,1672560950,3597
3593,3505437712,3270042456,1672550613,1672551506,893
3852,3779646172,3367111751,1672631764,1672632516,752
3864,3505725706,3783340788,1672532095,1672534052,1957
3890,3756704774,3931627862,1672544032,1672546796,2764
3863,3279473441,3776117322,1672539317,1672541843,2526
3799,3412968120,3623266256,1672685620,1672686950,1330
3733,3284947372,3299125059,1672563422,1672563629,207
3852,3604867757,3621184108,1672535249,1672537206,1957
3753,3509764635,3836241528,1672610258,1672612343,2085
3739,3533649454,3756746867,1672693659,1672693964,305
3481,3889780657,3615737355,1672645601,1672647756,2155
3743,3711637255,3607768197,1672557690,1672559574,1884
3592,3401940259,3512499658,1672653891,1672654450,559
3628,3330340793,3209481722,1672587351,1672590226,2875
3629,3757323954,3517887477,1672621849,1672622270,421
3782,3836241528,3335694356,1672569563,1672572040,2477
3445,3776084820,3276348699,1672588109,1672588915,806
3683,3516321888,3245232284,1672588302,1672590256,1954
3697,3615939504,3909094917,1672635785,1672638063,2278
3712,3400069268,3414049538,1672627324,1672627517,193
3495,3441703884,3934064792,1672688435,1672689744,1309
3704,3415833929,3755737419,1672600618,1672601286,668
3657,3711006062,3885121158,1672613140,1672615416,2276
3744,3298151889,3403370192,1672602595,1672604880,2285
3876,3829864515,3505154885,1672646889,1672647083,194
3653,3501457103,3441703884,1672673159,1672676194,3035
3783,3756704774,3231713082,1672700545,1672701679,1134
3476,3714827719,3617304541,1672567667,1672570687,3020
3806,3517222913,3336339664,1672621098,1672622355,1257
3827,3716110860,3533188828,1672654415,1672654861,446
3905,3931627862,3900898992,1672609587,1672612068,2481
3467,3479851674,3755496114,1672604547,1672605799,1252
3825,3760640999,3512946768,1672546780,1672548374,1594
3523,3509893027,3668533536,1672550962,1672553487,2525
3662,3236499444,3451326054,1672692223,1672695690,3467
3724,3513065217,3450286949,1672609180,1672610134,954
3732,3715545685,3791693821,1672535430,1672537224,1794
3745,3711637255,3533423872,1672576180,1672576613,433
3904,3755404116,3520416075,1672544143,1672546938,2795
3752,3490029863,3793407963,1672587811,1672590245,2434
3458,3512383699,3519909393,1672604981,1672607304,2323
3897,3624297844,3336339664,1672588684,1672589042,358
3526,3757193551,3343816795,1672665871,1672668576,2705
3438,3685681577,3773902805,1672541806,1672542919,1113
3744,3518229776,3701884158,1672544513,1672544789,276
3741,3792072681,3519028898,1672591260,1672593783,2523
3853,3715986185,3783520186,1672593557,1672596626,3069
3864,3607768197,3246370118,1672607698,1672610759,3061
3440,3459681410,3274906650,1672621503,1672622851,1348
3776,3516513251,3462158237,1672547531,1672549161,1630
3664,3811040565,3201629017,1672681413,1672681534,121
3723,3271752081,3357864626,1672570736,1672571668,932
3744,3520181148,3499217428,1672557944,1672559405,1461
3452,3856606678,3533929349,1672655713,1672657022,1309
3849,3500915665,3280268483,1672578528,1672581159,2631
3757,3906536154,3472068734,1672687242,1672690452,3210
3886,3280054198,3814305099,1672557273,1672560312,3039
3865,3783163143,3364378127,1672573707,1672576630,2923
3645,3401496246,3791693821,1672695115,1672695720,605
3913,3206837348,3401496246,1672557782,1672558811,1029
3599,3236458894,3701107228,1672653064,1672655150,2086
3886,3289817992,3512499658,1672687394,1672687579,185
3595,3534179433,3885537225,1672539256,1672541131,1875
3895,3777779869,3369708250,1672606721,1672609799,3078
3790,3970558632,3755344363,1672637183,1672637420,237
3727,3710735406,3510818674,1672628770,1672631494,2724
3511,3923420131,3791613604,1672652189,1672655567,3378
3603,3231713082,3299443125,1672672033,1672674467,2434
3609,3711000597,3859868849,1672601620,1672604592,2972
3451,3505228454,3778134418,1672578040,1672579858,1818
3858,3500109249,3756746867,1672626649,1672626794,145
3658,3933894942,3273981374,1672546449,1672546912,463
3638,3770624662,3513327337,1672567861,1672571077,3216
3590,3512830734,3780322355,1672540472,1672542597,2125
3438,3208452238,3414940786,1672546353,1672547743,1390
3882,3757348722,3300818269,1672690533,1672690776,243
3436,3755992176,3520764926,1672576394,1672576761,367
3584,3304155815,3488686442,1672655553,1672657869,2316
3750,3514741348,3887243870,1672632524,1672633216,692
3746,3514246749,3850911686,1672550704,1672550915,211
3728,3613581796,3396726504,1672646597,1672647070,473
3779,3306175858,3515439826,1672555708,1672557281,1573
3906,3481640525,3417679834,1672700992,1672703576,2584
3690,3792949946,3925979970,1672659349,1672662552,3203
3737,3713911104,3272716462,1672687181,1672690568,3387
3873,3779938251,3512882178,1672670596,1672672897,2301
3790,3898314440,3850911686,1672679876,1672682666,2790
3912,3463740710,3500915665,1672637547,1672639998,2451
3631,3505847380,3859868849,1672570244,1672571512,1268
3452,3800257590,3783520186,1672636985,1672638779,1794
3463,3520181148,3604589802,1672581657,1672581918,261
3816,3668533536,3779854934,1672661036,1672663249,2213
3860,3364378127,3509366311,1672551892,1672553219,1327
3630,3472312341,3379143440,1672545564,1672546238,674
3716,3238288884,3392520516,1672613951,1672616211,2260
3457,3412006598,3501384020,1672553159,1672556154,2995
3501,3793315718,3224811762,1672686197,1672689649,3452
3614,3500709774,3791128487,1672574144,1672574678,534
3671,3435167810,3514275974,1672637009,1672640299,3290
3513,3770704999,3890739241,1672674525,1672676467,1942
3785,3517881647,3803517637,1672553890,1672555080,1190
3448,3455018347,3408430195,1672636938,1672638922,1984
3480,3914691363,3225029895,1672639502,1672639601,99
3585,3710315160,3889780657,1672621447,1672624714,3267
3524,3617304541,3351866415,1672611741,1672614563,2822
3915,3551376095,3778926763,1672591915,1672593352,1437
3603,3492959689,3516489668,1672537259,1672537684,425
3497,3773124276,3480100311,1672636725,1672637048,323
3700,3520657891,3500072204,1672546040,1672549195,3155
3590,3760694096,3701247948,1672688971,1672690697,1726
3745,3409114719,3688796737,1672538707,1672539075,368
3655,3512800570,3511791953,1672547950,1672548107,157
3488,3389634034,3826238375,1672586405,1672589671,3266
3657,3732584121,3511442562,1672576345,1672579573,3228
3889,3231713082,3737972328,1672599459,1672601221,1762
3613,3839245934,3801645328,1672629921,1672630350,429
3535,3774178201,3783928182,1672671724,1672672337,613
3845,3817813340,3970909253,1672531542,1672531867,325
3561,3505228454,3760094385,1672690732,1672692387,1655
3806,3792389522,3505888598,1672661563,1672664529,2966
3732,3514512367,3557046880,1672571894,1672571963,69
3824,3347419520,3390660440,1672674396,1672676135,1739
3791,3505807416,3935487534,1672662031,1672665065,3034
3740,3414940786,3713941638,1672587744,1672590279,2535
3786,3435167810,3710735406,1672575885,1672578358,2473
3709,3793740407,3451326054,1672605013,1672607708,2695
3808,3779465522,3288762795,1672606824,1672608922,2098
3618,3934064792,3615688740,1672547029,1672547367,338
3661,3783136330,3338083680,1672642851,1672644143,1292
3898,3274831810,3500604680,1672561985,1672562891,906
3437,3513296868,3409114719,1672599777,1672599936,159
3835,3457960571,3500302272,1672613465,1672614355,890
3475,3505283390,3739661856,1672678515,1672681042,2527
3756,3517600136,3716110860,1672632071,1672632218,147
3576,3631479562,3512392431,1672671538,1672673871,2333
3500,3783340788,3424660806,1672627422,1672629642,2220
3671,3630353876,3791436104,1672637340,1672640719,3379
3637,3711077927,3815250107,1672557849,1672560825,2976
3888,3514334067,3334647380,1672673060,1672676522,3462
3810,3701884158,3715619259,1672654482,1672657270,2788
3723,3711919537,3505663516,1672677509,1672680396,2887
3713,3400069268,3757193307,1672577815,1672581118,3303
3581,3520322124,3513327337,1672599536,1672600084,548
3638,3711000597,3513345163,1672692079,1672692284,205
3570,3933894942,3711000597,1672702897,1672704121,1224
3589,3510919821,3304971369,1672548156,1672551537,3381
3772,3395201292,3505634634,1672651864,1672652316,452
3774,3501567772,3447672935,1672606566,1672607084,518
3429,3312998540,3714120857,1672562874,1672563977,1103
3524,3932478321,3283770991,1672560458,1672563279,2821
3692,3836241528,3440107959,1672632994,1672635340,2346
3808,3512882178,3205923620,1672572650,1672574314,1664
3805,3818575661,3283492940,1672632396,1672635971,3575
3671,3811040565,3514275974,1672591054,1672592713,1659
3734,3622357348,3905899155,1672599058,1672599260,202
3768,3615939504,3512882178,1672572508,1672573331,823
3575,3757075324,3274906650,1672549983,1672551803,1820
3759,3711000597,3660063072,1672601751,1672602045,294
3531,3703139663,3208957949,1672699199,1672701263,2064
3564,3777147510,3520416075,1672546837,1672547640,803
3729,3311098437,3613899351,1672602624,1672604940,2316
3535,3517288083,3613206049,1672690478,1672693655,3177
3712,3892304880,3661903000,1672534624,1672535726,1102
3576,3680843171,3497808662,1672685814,1672687573,1759
3711,3779892400,3520355798,1672602546,1672604385,1839
3507,3500841914,3926643445,1672607082,1672608107,1025
3452,3367971170,3604589802,1672649787,1672650761,974
3803,3934064792,3246370118,1672548122,1672550997,2875
3690,3551389192,3495911207,1672672023,1672674744,2721
3448,3714678331,3512379024,1672568250,1672570200,1950
3833,3270042456,3905196766,1672595719,1672598997,3278
3470,3274831810,3930242012,1672685749,1672689332,3583
3817,3414275042,3300818269,1672607652,1672610314,2662
3675,3972192593,3817813340,1672628723,1672631137,2414
3759,3516298579,3312998540,1672623444,1672625293,1849
3506,3455018347,3519818818,1672685157,1672685482,325
3576,3513345163,3515402792,1672553041,1672556367,3326
3716,3224330592,3755915206,1672652872,1672655895,3023
3586,3472068734,3379143440,1672597958,1672599420,1462
3425,3500604680,3934064792,1672557121,1672558720,1599
3679,3520355798,3514324011,1672703960,1672705716,1756
3633,3510028805,3551376095,1672674034,1672677082,3048
3484,3885155975,3902861231,1672651794,1672652539,745
3764,3899786664,3701136026,1672632032,1672633225,1193
3780,3777037426,3316798920,1672533511,1672534168,657
3545,3241790910,3613581796,1672613126,1672615277,2151
3844,3440107959,3410600350,1672583124,1672583783,659
3718,3371455553,3330340793,1672672375,1672674609,2234
3462,3383138270,3228888030,1672613951,1672616191,2240
3562,3885157459,3680810086,1672630760,1672631340,580
3434,3205923620,3505228454,1672564293,1672567755,3462
3780,3280268483,3241790910,1672534132,1672534870,738
3688,3305722859,3931627862,1672600874,1672602302,1428
3908,3284932450,3533423872,1672640823,1672641693,870
3862,3711853996,3341893384,1672615720,1672618066,2346
3444,3368283077,3618354185,1672621408,1672621707,299
3537,3306412634,3755573472,1672696101,1672698059,1958
3465,3505434346,3821054646,1672651665,1672653194,1529
3583,3409114719,3757903168,1672571874,1672572753,879
3546,3533274994,3306412634,1672636229,1672637016,787
3614,3501525100,3772765746,1672619992,1672623552,3560
3719,3500109249,3811075491,1672623828,1672627310,3482
3739,3439673892,3383138270,1672690494,1672691679,1185
3753,3688220326,3770520359,1672638161,1672638970,809
3627,3900276517,3513545422,1672572537,1672575950,3413
3903,3885155975,3935913584,1672696906,1672698769,1863
3839,3514419100,3755065949,1672624326,1672626050,1724
3774,3927165965,3438078818,1672547223,1672547699,476
3467,3703383853,3779532653,1672545125,1672546053,928
3447,3770438122,3920625129,1672590694,1672591905,1211
3646,3783169442,3713561276,1672654954,1672655116,162
3535,3779854934,3793922324,1672646309,1672648200,1891
3722,3459681410,3755065949,1672667163,1672668141,978
3490,3902625986,3814677862,1672603666,1672603906,240
3742,3500737582,3977148669,1672584625,1672586687,2062
3665,3855583256,3505995057,1672626789,1672629409,2620
3793,3979784676,3510499038,1672640142,1672642295,2153
3725,3279242917,3686227677,1672609540,1672611528,1988
3571,3778640261,3520322124,1672542218,1672544146,1928
3822,3240994288,3505521218,1672677440,1672679384,1944
3673,3511005395,3500604680,1672554445,1672554566,121
3816,3793583656,3778640261,1672640744,1672641083,339
3688,3791693821,3608232640,1672545617,1672546109,492
3912,3779301501,3776518452,1672697099,1672700138,3039
3888,3411515369,3512882178,1672552925,1672554676,1751
3873,3773027597,3711097754,1672688862,1672691116,2254
3457,3897376951,3770468980,1672586995,1672590462,3467
3764,3512946768,3834960360,1672604994,1672607846,2852
3470,3760040019,3518565331,1672608746,1672609256,510
3848,3793175445,3435116799,1672585936,1672588386,2450
3789,3373028638,3357864626,1672594515,1672594786,271
3484,3773939399,3500777439,1672613476,1672616025,2549
3516,3274831810,3791246640,1672562594,1672562779,185
3766,3283770991,3711000597,1672624415,1672627475,3060
3548,3395201292,3773939399,1672672754,1672674397,1643
3899,3773939399,3979802715,1672595053,1672598505,3452
3612,3519651506,3757294769,1672671634,1672673033,1399
3542,3470454332,3760645796,1672623655,1672624917,1262
3884,3711853996,3710489491,1672576258,1672579316,3058
3490,3774790271,3360813161,1672600935,1672601036,101
3536,3792014516,3783163143,1672533128,1672535694,2566
3533,3487875183,3859868849,1672623224,1672623301,77
3689,3501121099,3783520186,1672531586,1672532358,772
3670,3926643445,3668747074,1672584033,1672584741,708
3812,3379143440,3500109249,1672630529,1672631775,1246
3808,3399472693,3270056120,1672644270,1672646150,1880
3473,3376467719,3880926355,1672634217,1672635756,1539
3807,3396980894,3711637255,1672691227,1672694251,3024
3885,3431502855,3904412440,1672550804,1672553066,2262
3703,3776518452,3410600350,1672653133,1672655143,2010
3668,3534764451,3850911686,1672697468,1672698428,960
3459,3792020993,3375449013,1672669781,1672669883,102
3613,3520416075,3500613459,1672662601,1672663553,952
3431,3773735484,3311085279,1672534384,1672534820,436
3694,3375449013,3714128600,1672686460,1672688301,1841
3801,3304971369,3519446663,1672629426,1672631855,2429
3472,3276348699,3238288884,1672550832,1672551873,1041
3750,3778926763,3714678331,1672535230,1672537216,1986
3562,3814677862,3417679834,1672696008,1672698250,2242
3818,3404025196,3605221116,1672554492,1672556669,2177
3517,3715385401,3630353876,1672623257,1672623670,413
3517,3902861231,3756474459,1672647317,1672649467,2150
3687,3514956366,3447514821,1672558229,1672561491,3262
3536,3412968120,3793175445,1672605968,1672606908,940
3538,3519142371,3812534508,1672607035,1672607377,342
3699,3399472693,3661903000,1672632279,1672633692,1413
3637,3793407963,3713163045,1672541832,1672542416,584
3605,3514512367,3893912331,1672681190,1672681751,561
3563,3511732493,3514308235,1672670192,1672672135,1943
3452,3755344363,3713163045,1672651088,1672654601,3513
3842,3711812325,3715707380,1672599413,1672601268,1855
3566,3403370192,3334647380,1672587390,1672589410,2020
3692,3354144091,3783147088,1672570462,1672572881,2419
3717,3511150845,3309314379,1672565923,1672567866,1943
3799,3852533643,3624297844,1672545339,1672547977,2638
3478,3280054198,3780338697,1672533865,1672535440,1575
3802,3514971533,3609933747,1672612520,1672614749,2229
3606,3897456874,3793883863,1672580125,1672580418,293
3615,3668414677,3505663516,1672595837,1672599331,3494
3607,3513345163,3276217799,1672695314,1672697262,1948
3548,3892304880,3510642075,1672655508,1672659059,3551
3690,3927403123,3770438122,1672663031,1672664851,1820
3841,3779854934,3202141727,1672666624,1672667265,641
3845,3375449013,3774243020,1672533567,1672533676,109
3623,3311420950,3970603231,1672658129,1672660904,2775
3558,3777189898,3621461051,1672595876,1672598560,2684
3761,3856606678,3713784974,1672563569,1672564087,518
3614,3518229776,3776518452,1672537539,1672537626,87
3755,3817428320,3363162590,1672557704,1672558584,880
3694,3833217041,3334647380,1672681929,1672685261,3332
3734,3715986185,3380130228,1672631393,1672634938,3545
3436,3859868849,3711000597,1672694083,1672697337,3254
3707,3739661856,3770520359,1672640178,1672640834,656
3453,3891672228,3889780657,1672626695,1672630184,3489
3578,3777814504,3517462308,1672624936,1672627419,2483
3678,3385323994,3516298579,1672643300,1672645367,2067
3898,3715400486,3509756823,1672599724,1672599822,98
3445,3519909393,3334647380,1672667536,1672668877,1341
3629,3897376951,3370068529,1672679967,1672680539,572
3659,3226511603,3516298579,1672590483,1672592704,2221
3737,3609933747,3660887799,1672577269,1672579416,2147
3775,3710489491,3512337405,1672601330,1672603348,2018
3823,3793740407,3770520359,1672537857,1672539983,2126
3650,3500613493,3514703118,1672681024,1672681906,882
3871,3505521218,3517172354,1672673991,1672674655,664
3786,3383138270,3505179890,1672572183,1672574242,2059
3898,3518565331,3713517039,1672546637,1672549214,2577
3806,3414049538,3533294425,1672588475,1672591906,3431
3822,3224811762,3713784974,1672597844,1672598999,1155
3467,3777189898,3774790271,1672557158,1672557424,266
3508,3926643445,3755756564,1672636784,1672637325,541
3710,3685816610,3311049964,1672569589,1672571124,1535
3448,3500442734,3457620713,1672691011,1672693170,2159
3618,3711218296,3299125059,1672617837,1672619048,1211
3851,3756625818,3792274796,1672676846,1672679738,2892
3853,3614740489,3716679950,1672568834,1672570500,1666
3795,3977352557,3791128487,1672583817,1672584550,733
3832,3533423872,3607882826,1672602124,1672605089,2965
3765,3755532873,3517737088,1672608972,1672612166,3194
3757,3492959689,3792505974,1672617450,1672618014,564
3903,3315279093,3792801638,1672686047,1672687061,1014
3709,3375449013,3505847380,1672674805,1672675680,875
3458,3779656423,3533079336,1672586730,1672587670,940
3682,3713691388,3505807416,1672665197,1672667818,2621
3741,3776988674,3920898925,1672689525,1672690228,703
3663,3533929349,3454277788,1672580097,1672582736,2639
3485,3779425804,3512379024,1672640941,1672643967,3026
3465,3630353876,3600876425,1672593317,1672594694,1377
3736,3294747828,3608232640,1672613908,1672615053,1145
3814,3291933594,3630353876,1672646752,1672647901,1149
3542,3770146716,3505179890,1672577177,1672579983,2806
3660,3512383699,3615115210,1672683787,1672684191,404
3505,3505995057,3755848152,1672577113,1672580164,3051
3827,3716679950,3517687662,1672535454,1672536809,1355
3612,3490029863,3357864626,1672547564,1672549824,2260
3444,3516444201,3625174002,1672602722,1672603239,517
3626,3330340793,3224968597,1672544495,1672545784,1289
3860,3682133690,3770704999,1672670119,1672672283,2164
3826,3909094917,3554944414,1672665745,1672668768,3023
3830,3821054646,3373028638,1672619171,1672621013,1842
3727,3515559913,3392520516,1672558104,1672561262,3158
3635,3792546035,3756789525,1672630167,1672631030,863
3598,3306412634,3631090677,1672547413,1672550965,3552
3764,3209526819,3971806004,1672537356,1672537837,481
3477,3500341755,3608232640,1672660314,1672663330,3016
3758,3780322355,3923220461,1672651575,1672653838,2263
3455,3774876004,3505178849,1672675636,1672678818,3182
3593,3514324011,3368283077,1672595514,1672597846,2332
3856,3468041839,3556969573,1672572385,1672575234,2849
3565,3533228966,3310125159,1672677864,1672681007,3143
3607,3334951866,3333918941,1672674623,1672677795,3172
3707,3511288998,3733363628,1672606438,1672608942,2504
3656,3517687662,3777330107,1672654381,1672656025,1644
3441,3513018485,3399472693,1672572078,1672573166,1088
3441,3457620713,3230135532,1672552904,1672553586,682
3769,3923220461,3686227677,1672679603,1672683122,3519
3804,3279242917,3633735593,1672621577,1672621892,315
3741,3852533643,3710008361,1672636015,1672638327,2312
3439,3715127070,3792745809,1672542318,1672542649,331
3601,3557046880,3600876425,1672631431,1672634105,2674
3689,3756625818,3615115210,1672554459,1672555816,1357
3755,3404025196,3711006062,1672615187,1672618086,2899
3576,3773913680,3902625986,1672607304,1672609566,2262
3787,3714670620,3760640999,1672599398,1672602964,3566
3613,3774155692,3780680950,1672591204,1672591480,276
3633,3715619259,3683113954,1672591544,1672593775,2231
3516,3931627862,3401940259,1672668164,1672670937,2773
3610,3497095254,3500302272,1672531639,1672534195,2556
3440,3774705415,3436025562,1672629612,1672632313,2701
3435,3497808662,3514512367,1672605402,1672608179,2777
3608,3412006598,3230868435,1672573090,1672573391,301
3445,3773033649,3621184108,1672659169,1672660914,1745
3707,3338390596,3668533536,1672544070,1672544589,519
3893,3736231757,3469254160,1672542717,1672544820,2103
3919,3793935736,3895285664,1672641457,1672644150,2693
3476,3780115155,3300979975,1672603731,1672607105,3374
3660,3779465522,3248058676,1672582183,1672584747,2564
3785,3337362061,3780834916,1672561472,1672564700,3228
3755,3757863420,3513041785,1672636059,1672638757,2698
3427,3516489668,3923754072,1672623320,1672626507,3187
3801,3779892400,3713300120,1672548460,1672551321,2861
3654,3715385401,3713784974,1672566570,1672567947,1377
3707,3513360004,3783801141,1672701239,1672703665,2426
3716,3716110860,3369708250,1672702315,1672704040,1725
3657,3203538212,3817813340,1672672038,1672672596,558
3462,3517462308,3779892400,1672580429,1672583857,3428
3619,3780712350,3448633776,1672532471,1672534151,1680
3734,3357289672,3688796737,1672677653,1672678236,583
3442,3338083680,3760640999,1672674391,1672677434,3043
3645,3557046880,3500208903,1672665563,1672669144,3581
3544,3347419520,3338390596,1672560014,1672560749,735
3516,3974674109,3715127070,1672685941,1672687283,1342
3870,3556969573,3515559913,1672609289,1672609748,459
3805,3824641227,3279242917,1672559332,1672562359,3027
3604,3932478321,3885537225,1672691095,1672691390,295
3687,3511150845,3460719322,1672660984,1672664455,3471
3554,3485540729,3970558632,1672578056,1672578354,298
3571,3516298579,3610870949,1672595059,1672597938,2879
3518,3517600136,3777091903,1672571076,1672574615,3539
3512,3511005395,3362641275,1672540023,1672542872,2849
3638,3513065217,3819767045,1672554915,1672556165,1250
3534,3703433819,3509756823,1672538919,1672539519,600
3844,3975717896,3231494505,1672570006,1672570871,865
3791,3347446226,3760694096,1672674976,1672677386,2410
3512,3236499444,3209481722,1672700154,1672703235,3081
3605,3362641275,3777037426,1672555651,1672557814,2163
3666,3505228454,3778597171,1672701401,1672703298,1897
3761,3755404116,3382733096,1672545492,1672546710,1218
3427,3510187271,3711734586,1672610112,1672610810,698
3837,3777814504,3935487534,1672541531,1672541794,263
3767,3452016771,3386758279,1672595714,1672597789,2075
3912,3778597171,3319167958,1672656677,1672659552,2875
3572,3333403880,3715086894,1672556754,1672557734,980
3561,3512502036,3818575661,1672663712,1672666770,3058
3873,3617116290,3357289672,1672616181,1672619323,3142
3562,3511317276,3303410628,1672636798,1672638193,1395
3436,3492546679,3436025562,1672558264,1672559930,1666
3554,3783615982,3512282789,1672575793,1672576494,701
3773,3447514821,3793583656,1672604778,1672605233,455
3821,3713589994,3757075324,1672557321,1672557434,113
3496,3802932312,3226511603,1672561558,1672564474,2916
3911,3852686295,3614740489,1672678787,1672681977,3190
3670,3623266256,3519142371,1672624184,1672624705,521
3479,3839245934,3711097754,1672628702,1672628995,293
3824,3454277788,3230868435,1672625890,1672628153,2263
3762,3668414677,3925979970,1672561049,1672563628,2579
3711,3519416013,3492959689,1672616651,1672618536,1885
3526,3793969543,3386758279,1672660075,1672660682,607
3458,3852686295,3783641602,1672680669,1672682948,2279
3659,3519028898,3773902805,1672663340,1672663556,216
3809,3513041785,3372223551,1672575311,1672577818,2507
3627,3241790910,3898314440,1672701731,1672702437,706
3711,3711637255,3505663516,1672583350,1672586274,2924
3774,3760263530,3509764635,1672547957,1672549793,1836
3458,3226511603,3513853403,1672657826,1672660391,2565
3564,3500317969,3711097754,1672554533,1672554595,62
3675,3311085279,3617116290,1672662130,1672662397,267
3545,3513853403,3713768950,1672579273,1672581155,1882
3434,3520355798,3701882224,1672532700,1672534568,1868
3728,3711812325,3551389192,1672654692,1672656424,1732
3890,3779892400,3779438325,1672669245,1672670803,1558
3633,3500302272,3336339664,1672695161,1672697479,2318
3559,3294703680,3311085279,1672676447,1672676685,238
3424,3661903000,3660887799,1672589365,1672592464,3099
3743,3755737419,3505283390,1672634542,1672636120,1578
3748,3393063657,3500302272,1672638045,1672640143,2098
3794,3500703304,3755230952,1672546502,1672547281,779
3743,3392520516,3448633776,1672638611,1672641096,2485
3860,3515525630,3770146716,1672633251,1672636557,3306
3532,3779613523,3714185969,1672583093,1672584284,1191
3862,3338390596,3395201292,1672637832,1672641026,3194
3820,3814677862,3927403123,1672666710,1672670135,3425
3460,3512946768,3791693821,1672606641,1672609703,3062
3679,3224968597,3357689359,1672602812,1672603698,886
3670,3906536154,3461119815,1672543252,1672544733,1481
3858,3382733096,3617392620,1672578237,1672581597,3360
3558,3774243020,3367971170,1672668832,1672671523,2691
3806,3310039260,3802932312,1672658676,1672659467,791
3569,3613338363,3773913680,1672674043,1672675910,1867
3788,3492546679,3773332082,1672533869,1672537324,3455
3720,3311085279,3501215099,1672613274,1672615936,2662
3848,3835985172,3401793306,1672663396,1672664209,813
3600,3400763927,3514334067,1672651876,1672655283,3407
3487,3448875382,3505198734,1672640964,1672644516,3552
3769,3853629553,3428027649,1672578684,1672580240,1556
3652,3631090677,3200308999,1672661490,1672663619,2129
3723,3500709774,3701107228,1672618352,1672618547,195
3600,3333403880,3517687662,1672644554,1672644801,247
3767,3283492940,3689697817,1672600051,1672600697,646
3642,3505995057,3240394404,1672653267,1672654259,992
3671,3777147510,3225631197,1672674193,1672675544,1351
3468,3621683102,3783136330,1672587497,1672588482,985
3567,3202141727,3556969573,1672568931,1672569613,682
3439,3927403123,3834963772,1672662706,1672665820,3114
3558,3780338697,3533228966,1672545825,1672546062,237
3723,3283770991,3276217799,1672671549,1672673930,2381
3703,3885155975,3289114629,1672621862,1672623834,1972
3917,3780680950,3500604680,1672554042,1672555756,1714
3805,3224811762,3224811762,1672651315,1672652582,1267
3852,3824641227,3757383891,1672592361,1672592766,405
3462,3713561276,3668414677,1672629979,1672631330,1351
3808,3497095254,3500949309,1672627655,1672628866,1211
3740,3792020993,3303410628,1672593853,1672596903,3050
3846,3401793306,3205985903,1672687564,1672690353,2789
3612,3836241528,3793781065,1672617808,1672620861,3053
3694,3512958459,3534566651,1672636833,1672639758,2925
3883,3777184389,3505198734,1672674244,1672674640,396
3859,3511150845,3600876425,1672578321,1672579292,971
3919,3394401087,3791796585,1672544403,1672546095,1692
3698,3533294425,3791046864,1672629930,1672632604,2674
3502,3783136330,3779892400,1672614687,1672615410,723
3772,3341893384,3776034743,1672547876,1672548937,1061
3804,3533004959,3791046864,1672601098,1672603124,2026
3842,3200308999,3803517637,1672646379,1672646606,227
3622,3283144118,3779786641,1672696807,1672696905,98
3735,3834963772,3513345163,1672652250,1672654932,2682
3802,3509893027,3424445495,1672579058,1672579679,621
3871,3897456874,3777189898,1672543950,1672545748,1798
3849,3500857494,3755737419,1672578708,1672581818,3110
3632,3898314440,3930242012,1672660489,1672661281,792
3785,3534126409,3680843171,1672701811,1672703497,1686
3870,3387594369,3396980894,1672638307,1672639509,1202
3648,3714666884,3241914067,1672587562,1672590612,3050
3587,3979784676,3661903000,1672700311,1672702960,2649
3824,3505634634,3481640525,1672613765,1672615756,1991
3591,3401793306,3276269264,1672592713,1672594871,2158
3714,3772078494,3246370118,1672663647,1672663842,195
3772,3668747074,3926643445,1672631656,1672631803,147
3618,3773009828,3519416013,1672567118,1672570154,3036
3873,3360813161,3931627862,1672614528,1672618023,3495
3823,3533090502,3853629553,1672648285,1672650120,1835
3462,3812534508,3519028898,1672552587,1672554369,1782
3894,3608922867,3455018347,1672555653,1672558894,3241
3756,3703396825,3293835352,1672698656,1672699525,869
3486,3760924079,3515466096,1672587103,1672590648,3545
3703,3510499038,3367971170,1672577101,1672578984,1883
3599,3513018485,3715854030,1672644297,1672645045,748
3569,3791796585,3334974375,1672571759,1672574728,2969
3669,3779854934,3492546679,1672602643,1672604136,1493
3559,3316800320,3424445495,1672642058,1672645495,3437
3571,3500347447,3336627643,1672595662,1672595865,203
3737,3509893027,3736705719,1672590345,1672590511,166
3918,3760364383,3351696332,1672600350,1672602458,2108
3856,3793935736,3715854030,1672570608,1672573154,2546
3425,3308760650,3284932450,1672635249,1672636594,1345
3532,3513295938,3311420950,1672607361,1672609672,2311
3876,3551399764,3755737419,1672571381,1672571850,469
3547,3668414677,3608232640,1672592469,1672593787,1318
3472,3411515369,3462158237,1672557915,1672560827,2912
3559,3412006598,3311085279,1672625106,1672626411,1305
3502,3730071479,3515401243,1672686256,1672687672,1416
3607,3448633776,3780872464,1672550758,1672551705,947
3791,3374183227,3774876004,1672645544,1672646683,1139
3677,3272096759,3505402439,1672572233,1672574036,1803
3599,3534543776,3501215099,1672621919,1672622466,547
3820,3505888598,3501459390,1672685299,1672686167,868
3555,3311098437,3778134418,1672538484,1672540849,2365
3425,3392943173,3357864626,1672627017,1672630055,3038
3733,3736705719,3777814504,1672552604,1672553299,695
3831,3450969839,3533929349,1672624809,1672626632,1823
3515,3701373490,3501786419,1672649510,1672650074,564
3581,3688490530,3756789525,1672622153,1672623696,1543
3804,3885157459,3755158925,1672681829,1672683062,1233
3656,3384068080,3711000597,1672650063,1672652810,2747
3866,3770296583,3551376095,1672690978,1672692508,1530
3665,3760362417,3791753345,1672672669,1672672918,249
3922,3931627862,3855583256,1672639172,1672642624,3452
3580,3394401087,3517887477,1672666679,1672667349,670
3884,3270697740,3773332082,1672590804,1672592637,1833
3559,3791796585,3347446226,1672674972,1672677799,2827
3812,3448875382,3791613604,1672686758,1672689118,2360
3891,3972083617,3299781901,1672564257,1672566396,2139
3444,3623266256,3780909839,1672663052,1672665542,2490
3831,3390660440,3621184108,1672695509,1672698503,2994
3799,3349739136,3778040015,1672657510,1672657791,281
3578,3732131656,3517687662,1672691731,1672692559,828
3734,3500525825,3449639012,1672676595,1672679505,2910
3576,3517358573,3817428320,1672655678,1672658288,2610
3709,3534543776,3510837901,1672547706,1672550066,2360
3698,3533929349,3930242012,1672543910,1672547320,3410
3609,3780769110,3793743698,1672550955,1672551464,509
3615,3604867757,3513041785,1672627122,1672627210,88
3738,3232208416,3513018485,1672569455,1672572501,3046
3559,3972192593,3499217428,1672590966,1672592301,1335
3841,3376467719,3398731252,1672631255,1672633431,2176
3623,3792072681,3386758279,1672699425,1672701142,1717
3584,3513296868,3414275042,1672548311,1672549263,952
3594,3351696332,3470454332,1672552642,1672553921,1279
3747,3618489670,3703396825,1672686611,1672688293,1682
3785,3384583385,3636329663,1672602855,1672606268,3413
3872,3713561276,3701884158,1672610097,1672611524,1427
3591,3609933747,3226511603,1672620876,1672623825,2949
3819,3517600136,3513041785,1672623579,1672625338,1759
3443,3793743698,3783520186,1672587356,1672587619,263
3921,3836241528,3510919821,1672651763,1672654321,2558
3650,3632814465,3711853996,1672629019,1672632015,2996
3541,3715086894,3534126409,1672617570,1672619582,2012
3629,3368283077,3480726047,1672574946,1672578105,3159
3743,3777814504,3935913584,1672658485,1672660858,2373
3485,3309314379,3310039260,1672693191,1672695566,2375
3701,3824641227,3225636215,1672613578,1672616087,2509
3668,3334974375,3441703884,1672626435,1672628752,2317
3900,3519087371,3622357348,1672535236,1672538360,3124
3785,3283492940,3777189898,1672547050,1672547130,80
3740,3457620713,3351866415,1672547369,1672549388,2019
3719,3283144118,3755222916,1672676201,1672677285,1084
3669,3630353876,3739661856,1672563533,1672564308,775
3914,3756704774,3667673649,1672590817,1672593473,2656
3647,3208452238,3225636215,1672551582,1672551764,182
3510,3517600136,3500302272,1672647407,1672648309,902
3893,3362641275,3779438325,1672642476,1672645630,3154
3806,3500498112,3520355798,1672555291,1672557504,2213
3744,3779938251,3343132529,1672648960,1672652443,3483
3751,3229822507,3773735484,1672691849,1672693878,2029
3554,3605221116,3935487534,1672625888,1672628739,2851
3854,3814677862,3447514821,1672640379,1672643774,3395
3697,3783147088,3779639983,1672549764,1672551191,1427
3508,3887243870,3220031931,1672603604,1672604746,1142
3817,3774733620,3288762795,1672579244,1672582243,2999
3615,3310125159,3760651515,1672651192,1672654601,3409
3750,3402697190,3246370118,1672538841,1672539331,490
3635,3437286517,3701107228,1672595972,1672597144,1172
3436,3779639983,3481640525,1672594108,1672594341,233
3502,3505434346,3511288998,1672564682,1672565302,620
3833,3731646673,3635169815,1672566350,1672568536,2186
3615,3299781901,3449333754,1672537433,1672539372,1939
3632,3791246640,3800257590,1672702412,1672704608,2196
3873,3825881598,3890739241,1672543531,1672545933,2402
3765,3852533643,3501281016,1672633097,1672634193,1096
3886,3791436104,3711637255,1672572733,1672574265,1532
3919,3760263530,3459681410,1672639063,1672640076,1013
3784,3971806004,3777240360,1672672076,1672672340,264
3875,3792949946,3856606678,1672596248,1672599456,3208
3547,3300511067,3613338363,1672596869,1672599276,2407
3912,3367509761,3516741440,1672697083,1672698261,1178
3795,3311098437,3306175858,1672587004,1672588770,1766
3818,3776988674,3364726656,1672552190,1672554027,1837
3714,3533004959,3517590837,1672599740,1672602383,2643
3758,3270042456,3757863420,1672596154,1672599329,3175
3631,3511791953,3505521218,1672553377,1672556030,2653
3698,3336339664,3776559988,1672678303,1672680387,2084
3722,3334647380,3517590837,1672544741,1672547321,2580
3919,3770438122,3400069268,1672593858,1672596096,2238
3858,3370227921,3431502855,1672654028,1672656457,2429
3845,3792525861,3497671225,1672672302,1672672384,82
3446,3818575661,3780909839,1672669311,1672671265,1954
3492,3669146016,3891672228,1672644592,1672646238,1646
3488,3224811762,3774733620,1672671052,1672674064,3012
3727,3371455553,3552824113,1672557885,1672560438,2553
3479,3779938251,3661447322,1672583826,1672587232,3406
3618,3451726367,3757700712,1672683946,1672684433,487
3428,3533368789,3664943873,1672654309,1672657274,2965
3600,3399472693,3905899155,1672650207,1672650630,423
3497,3791436104,3834963772,1672641500,1672643763,2263
3767,3715385401,3897435944,1672622610,1672625374,2764
3624,3469254160,3898314440,1672549633,1672550684,1051
3649,3668533536,3755737419,1672686028,1672687438,1410
3732,3904867554,3923220461,1672583909,1672587024,3115
3736,3410160376,3228888030,1672621758,1672622821,1063
3501,3979784676,3621461051,1672558118,1672560305,2187
3569,3701882224,3780680950,1672697237,1672700218,2981
3683,3815392801,3701823816,1672580648,1672584243,3595
3735,3487875183,3272030610,1672671474,1672674340,2866
3903,3396980894,3779301501,1672638849,1672640988,2139
3495,3395201292,3779613523,1672542535,1672545553,3018
3559,3293835352,3793922324,1672655734,1672657098,1364
3675,3774718695,3923754072,1672541430,1672544860,3430
3746,3435167810,3241790910,1672688060,1672689584,1524
3533,3519416013,3777189898,1672691848,1672693200,1352
3812,3518565331,3715707380,1672588713,1672589963,1250
3915,3398731252,3639050419,1672615661,1672616350,689
3581,3516444201,3701107228,1672652373,1672654206,1833
3729,3755737419,3779613523,1672575159,1672577468,2309
3786,3683113954,3201676087,1672532919,1672534840,1921
3749,3490214516,3853629553,1672602801,1672605591,2790
3729,3757348722,3519909393,1672604446,1672606158,1712
3538,3480100311,3688220326,1672642092,1672644673,2581
3821,3363162590,3703433819,1672647286,1672647560,274
3874,3836241528,3701136026,1672692411,1672694807,2396
3847,3935913584,3923754072,1672702311,1672703869,1558
3758,3793743698,3513853403,1672591447,1672593224,1777
3434,3244004456,3334647380,1672583497,1672586037,2540
3529,3774641380,3711734586,1672576393,1672579579,3186
3696,3791753345,3404025196,1672642332,1672644076,1744
3459,3777189898,3780472203,1672645545,1672647414,1869
3482,3492959689,3227799827,1672689092,1672691741,2649
3808,3812369928,3224811762,1672569872,1672570145,273
3827,3778926763,3900945856,1672578470,1672580991,2521
3470,3714678331,3334974375,1672619102,1672620127,1025
3507,3933894942,3703348097,1672696724,1672700107,3383
3687,3715974659,3812534508,1672674127,1672675656,1529
3807,3226178937,3513410578,1672547387,1672549651,2264
3842,3501215099,3491684096,1672656300,1672659759,3459
3821,3515525630,3664943873,1672688179,1672688902,723
3457,3885155975,3360069849,1672691901,1672692599,698
3556,3500317969,3224968597,1672543673,1672546358,2685
3537,3520560590,3516741440,1672557894,1672559999,2105
3553,3897435944,3451726367,1672541472,1672542343,871
3915,3904412440,3501567772,1672611414,1672613859,2445
3760,3350095157,3757323954,1672662120,1672664056,1936
3808,3500915665,3885121158,1672696753,1672697615,862
3531,3920898925,3780209375,1672696944,1672698641,1697
3444,3793781065,3631090677,1672662859,1672663672,813
3819,3337362061,3773939399,1672672730,1672673032,302
3593,3435167810,3520322124,1672565720,1672565786,66
3889,3418448389,3622357348,1672585166,1672588305,3139
3494,3520115090,3512946768,1672667132,1672668544,1412
3524,3756127300,3510818674,1672695363,1672695881,518
3760,3779656423,3514512367,1672611085,1672614529,3444
3700,3236458894,3776117322,1672532227,1672534176,1949
3578,3505807416,3533004959,1672660536,1672662019,1483
3748,3791796585,3271752081,1672591435,1672594116,2681
3512,3559458968,3600876425,1672643383,1672646442,3059
3512,3774031303,3200543880,1672584844,1672586679,1835
3524,3414275042,3779646172,1672556353,1672559131,2778
3775,3288224595,3284947372,1672604219,1672605926,1707
3483,3661903000,3446533960,1672608980,1672609662,682
3514,3443357683,3793175445,1672626143,1672627863,1720
3447,3892304880,3515439826,1672639485,1672641434,1949
3677,3533929349,3791046864,1672668698,1672670391,1693
3860,3783801141,3387594369,1672606078,1672606597,519
3720,3408430195,3715086894,1672625075,1672626331,1256
3575,3613206049,3979784676,1672545282,1672548357,3075
3602,3516513251,3760645796,1672689924,1672690560,636
3733,3770468980,3376467719,1672662798,1672664453,1655
3572,3401940259,3376467719,1672699743,1672702695,2952
3799,3714185969,3505198734,1672577465,1672577632,167
3673,3519416013,3737112297,1672538862,1672540345,1483
3645,3512392431,3760694096,1672684932,1672688196,3264
3548,3370227921,3279339278,1672583930,1672585774,1844
3841,3300818269,3773902805,1672532663,1672533830,1167
3670,3779301501,3977352557,1672645270,1672645559,289
3606,3715707380,3703396825,1672695241,1672695923,682
3426,3520355798,3333918941,1672576852,1672579176,2324
3805,3501121099,3757383891,1672663282,1672666813,3531
3707,3374183227,3443357683,1672598343,1672601693,3350
3455,3480100311,3515559913,1672554236,1672557334,3098
3901,3713561276,3887243870,1672588508,1672589998,1490
3577,3451691949,3398198430,1672689867,1672691800,1933
3718,3802932312,3792801638,1672681064,1672684283,3219
3600,3533929349,3513296868,1672645214,1672648159,2945
3677,3467988782,3713691388,1672621615,1672624718,3103
3905,3885157459,3852533643,1672695516,1672698714,3198
3646,3714128600,3618489670,1672587295,1672588786,1491
3503,3315279093,3509483172,1672619100,1672622022,2922
3472,3505663516,3517687662,1672540334,1672543502,3168
3782,3618489670,3639050419,1672552365,1672555349,2984
3446,3533423872,3972083617,1672555129,1672555735,606
3781,3452016771,3367509761,1672543745,1672546771,3026
3540,3607882826,3715974659,1672612334,1672613601,1267
3636,3512502036,3791613604,1672564632,1672565375,743
3595,3520115090,3414940786,1672555955,1672556322,367
3776,3505923418,3617489344,1672586411,1672588280,1869
3473,3469254160,3701322924,1672664689,1672666160,1471
3827,3710735406,3513545422,1672660728,1672661280,552
3765,3347446226,3927403123,1672692828,1672694649,1821
3584,3245232284,3713300120,1672647463,1672650119,2656
3646,3801645328,3815250107,1672665011,1672667138,2127
3578,3713979100,3516703758,1672602646,1672603627,981
3691,3625463628,3351866415,1672604639,1672606409,1770
3543,3376467719,3510818674,1672556504,1672557593,1089
3478,3905196766,3375449013,1672670960,1672673136,2176
3644,3618176292,3404025196,1672573621,1672575560,1939
3822,3777189898,3209481722,1672671077,1672671358,281
3687,3514275974,3928719932,1672542823,1672543890,1067
3810,3923220461,3703139663,1672561707,1672565258,3551
3681,3517288083,3711734586,1672634707,1672634783,76
3727,3756746867,3757348722,1672617849,1672621037,3188
3622,3776034743,3380130228,1672613756,1672615189,1433
3790,3517881647,3803517637,1672533636,1672534569,933
3604,3773332082,3533294425,1672618319,1672621692,3373
3584,3774641380,3711919537,1672686823,1672688346,1523
3444,3510837901,3495911207,1672547914,1672550468,2554
3910,3713691388,3510798825,1672578570,1672579364,794
3681,3774243020,3408430195,1672534653,1672534904,251
3450,3513296868,3755344363,1672563460,1672566132,2672
3499,3891672228,3500841914,1672615910,1672618957,3047
3647,3516741440,3780769110,1672585802,1672587662,1860
3760,3296462324,3755915206,1672677268,1672679749,2481
3576,3608232640,3779639983,1672681403,1672683261,1858
3461,3244004456,3605221116,1672567047,1672570578,3531
3688,3792489602,3244004456,1672650754,1672651069,315
3563,3935913584,3757318448,1672595281,1672598369,3088
3636,3897456874,3970627281,1672696228,1672696568,340
3579,3299781901,3501525100,1672582729,1672585103,2374
3802,3609881958,3780322355,1672668288,1672668396,108
3437,3519077659,3516489668,1672604497,1672607769,3272
3745,3238288884,3338083680,1672693883,1672694385,502
3768,3612689556,3450969839,1672568771,1672570966,2195
3433,3631479562,3283144118,1672700917,1672703873,2956
3576,3777037426,3305722859,1672611167,1672611960,793
3690,3817813340,3760924079,1672697332,1672700783,3451
3619,3500613459,3791441520,1672543958,1672546051,2093
3463,3885121158,3906536154,1672635729,1672638793,3064
3584,3435167810,3713784974,1672659478,1672660725,1247
3550,3380982774,3468041839,1672656423,1672656636,213
3816,3757332128,3517288083,1672689620,1672691880,2260
3814,3793922324,3366423342,1672616007,1672619291,3284
3756,3772078494,3701136026,1672629365,1672631988,2623
3845,3299443125,3441703884,1672612473,1672614280,1807
3779,3225636215,3271752081,1672536627,1672538194,1567
3790,3274906650,3505634634,1672571362,1672573995,2633
3627,3518565331,3520873221,1672653714,1672654773,1059
3801,3923420131,3661583097,1672693575,1672695346,1771
3473,3226511603,3615115210,1672598542,1672601723,3181
3616,3518194482,3618354185,1672620948,1672622533,1585
3832,3415833929,3755573472,1672623235,1672624661,1426
3604,3505995057,3520115090,1672654898,1672658201,3303
3729,3401793306,3885537225,1672541543,1672544587,3044
3856,3780769110,3772236797,1672662321,1672664379,2058
3526,3510837901,3279339278,1672683041,1672685819,2778
3536,3733558985,3701136026,1672592107,1672594816,2709
3538,3209526819,3467779445,1672553883,1672556720,2837
3704,3938389661,3459681410,1672585585,1672587455,1870
3488,3791246640,3363162590,1672640346,1672642414,2068
3692,3732131656,3783136330,1672537971,1672539280,1309
3570,3500827202,3512379024,1672620497,1672620692,195
3441,3897456874,3516903528,1672623890,1672625941,2051
3829,3417679834,3500857494,1672543396,1672543689,293
3840,3438078818,3923420131,1672698407,1672700019,1612
3690,3904569677,3367971170,1672648938,1672651285,2347
3913,3516321888,3779613523,1672588826,1672589237,411
3550,3803517637,3757348722,1672638063,1672639853,1790
3899,3461119815,3609113156,1672581358,1672581759,401
3809,3462158237,3755404116,1672640112,1672641190,1078
3426,3711919537,3202804048,1672635046,1672636766,1720
3625,3711812325,3780680950,1672535440,1672537945,2505
3866,3739154408,3303410628,1672675733,1672677148,1415
3877,3904569677,3661447322,1672618817,1672621487,2670
3711,3519909393,3757630221,1672552193,1672553309,1116
3437,3272716462,3613899351,1672537404,1672540854,3450
3850,3411515369,3208957949,1672676022,1672678116,2094
3523,3443357683,3337362061,1672702553,1672704266,1713
3447,3618489670,3715707380,1672624068,1672625959,1891
3882,3755065949,3411688875,1672669590,1672670604,1014
3833,3792745809,3429943738,1672631263,1672633211,1948
3786,3401793306,3424660806,1672688566,1672688672,106
3769,3462273042,3732584121,1672689603,1672691827,2224
3679,3625463628,3934064792,1672674644,1672676488,1844
3844,3299443125,3311098437,1672631476,1672631992,516
3636,3979784676,3814677862,1672614817,1672616199,1382
3840,3412968120,3517222913,1672695580,1672698642,3062
3450,3300229945,3622357348,1672583010,1672584645,1635
3738,3417191856,3492546679,1672612323,1672612418,95
3573,3858172636,3306175858,1672535426,1672538261,2835
3609,3276348699,3500613459,1672551202,1672552081,879
3501,3661903000,3350095157,1672549874,1672550759,885
3808,3392836218,3459681410,1672639471,1672640652,1181
3538,3271752081,3395201292,1672630238,1672632838,2600
3619,3510798825,3244004456,1672642151,1672643420,1269
3736,3556969573,3225636215,1672643835,1672647245,3410
3788,3347419520,3492546679,1672618902,1672621912,3010
3689,3229822507,3354144091,1672641870,1672642431,561
3502,3703798634,3514703118,1672590831,1672593361,2530
3730,3374183227,3834631333,1672657057,1672657440,383
3605,3500949309,3533090502,1672622945,1672624358,1413
3732,3226511603,3618176292,1672605503,1672607212,1709
3496,3777779869,3755573472,1672580846,1672581641,795
3885,3497808662,3375449013,1672699792,1672701821,2029
3869,3688796737,3333918941,1672543870,1672546532,2662
3614,3500827202,3734118023,1672699370,1672702441,3071
3839,3780115155,3520181148,1672574436,1672576093,1657
3589,3780472203,3400069268,1672578291,1672580935,2644
3549,3757383891,3469254160,1672561886,1672562988,1102
3874,3792389522,3774907131,1672545713,1672548009,2296
3483,3812534508,3791106564,1672669554,1672672801,3247
3706,3821054646,3970198861,1672700346,1672701458,1112
3699,3825881598,3202141727,1672558815,1672562323,3508
3852,3376467719,3621184108,1672641270,1672641899,629
3441,3852533643,3923754072,1672537983,1672540535,2552
3876,3376467719,3791613604,1672658919,1672661880,2961
3738,3300818269,3513296868,1672584742,1672586873,2131
3633,3791046864,3520873221,1672663294,1672663821,527
3578,3500604680,3773027597,1672700842,1672703667,2825
3708,3701424609,3520991398,1672592673,1672595476,2803
3755,3935399379,3201800997,1672662764,1672663326,562
3913,3347446226,3424445495,1672559571,1672561310,1739
3906,3224330592,3225636215,1672635893,1672636858,965
3555,3533929349,3780338697,1672534392,1672537886,3494
3629,3755915206,3481640525,1672564900,1672566126,1226
3674,3770704999,3500857494,1672572699,1672575676,2977
3458,3773913680,3311098437,1672697566,1672699463,1897
3778,3448875382,3551376095,1672612860,1672616079,3219
3599,3835985172,3201676087,1672702407,1672703317,910
3764,3515890966,3270697740,1672615945,1672616959,1014
3456,3513081354,3519028898,1672651586,1672654704,3118
3808,3686523546,3475349791,1672700424,1672700870,446
3549,3514703118,3510554314,1672636526,1672637578,1052
3611,3780834916,3780909839,1672591777,1672594054,2277
3898,3518194482,3686227677,1672697269,1672699233,1964
3870,3776244398,3395201292,1672555861,1672559390,3529
3720,3517697722,3772236797,1672597317,1672598765,1448
3755,3626499450,3780872464,1672592108,1672595276,3168
3675,3520657891,3783147088,1672637392,1672639113,1721
3837,3294703680,3737972328,1672641288,1672643950,2662
3626,3512946768,3858172636,1672533972,1672537476,3504
3559,3791693821,3501215099,1672569090,1672570269,1179
3556,3780712350,3660063072,1672602239,1672604730,2491
3837,3778134418,3402697190,1672670401,1672671358,957
3781,3516903528,3279242917,1672536083,1672536395,312
3541,3500841914,3773939399,1672642155,1672643675,1520
3803,3510642075,3607768197,1672666450,1672666961,511
3818,3370068529,3714185969,1672602502,1672602969,467
3904,3520639768,3520115090,1672698347,1672699087,740
3779,3779438325,3780834916,1672583287,1672584511,1224
3647,3280268483,3273981374,1672658419,1672660225,1806
3444,3338083680,3774705415,1672542987,1672546341,3354
3758,3518653080,3519909393,1672632576,1672634398,1822
3872,3516321888,3451326054,1672670789,1672671996,1207
3678,3773735484,3510837901,1672648786,1672651609,2823
3802,3631479562,3415833929,1672559789,1672561833,2044
3577,3773913680,3500109249,1672557359,1672559059,1700
3817,3451726367,3351866415,1672699314,1672699384,70
3455,3926643445,3440107959,1672635554,1672637864,2310
3566,3715707380,3350095157,1672588530,1672589792,1262
3612,3411688875,3310039260,1672536446,1672539328,2882
3836,3517462308,3514512367,1672674485,1672676198,1713
3762,3732131656,3448875382,1672553769,1672553993,224
3792,3480490124,3384583385,1672676480,1672679210,2730
3507,3979784676,3515401243,1672576622,1672576935,313
3796,3511317276,3500347447,1672607805,1672610789,2984
3768,3928719932,3500613493,1672660574,1672663941,3367
3830,3927403123,3367509761,1672633032,1672633302,270
3823,3757332128,3774178201,1672686499,1672688741,2242
3567,3928511283,3774155692,1672702717,1672705956,3239
3817,3510919821,3776117322,1672615856,1672617641,1785
3436,3701882224,3774290799,1672654217,1672657156,2939
3802,3492546679,3814305099,1672702880,1672703774,894
3881,3479851674,3225636215,1672667941,1672669973,2032
3660,3500498112,3201800997,1672631098,1672634177,3079
3620,3304971369,3416987084,1672675336,1672675602,266
3837,3515525630,3928511283,1672535750,1672539315,3565
3856,3779301501,3689114185,1672692398,1672692578,180
3656,3821054646,3891672228,1672661981,1672665128,3147
3761,3612689556,3510641433,1672616023,1672617592,1569
3817,3885157459,3755222916,1672662849,1672663948,1099
3717,3512502036,3713979100,1672568172,1672570688,2516
3861,3755222916,3488763230,1672678371,1672681382,3011
3479,3783169442,3440137407,1672573797,1672574831,1034
3683,3736231757,3613899351,1672608676,1672610817,2141
3433,3716110860,3755230952,1672602701,1672605169,2468
3512,3783550022,3661583097,1672655696,1672657764,2068
3844,3760842815,3375449013,1672562559,1672564623,2064
3431,3500442734,3621461051,1672618541,1672619761,1220
3667,3904867554,3622665543,1672624001,1672625406,1405
3802,3438078818,3760640999,1672545532,1672546064,532
3459,3309314379,3226024417,1672580453,1672581706,1253
3625,3389634034,3777091903,1672687387,1672688737,1350
3696,3773913680,3713163045,1672680849,1672684157,3308
3709,3519446663,3906536154,1672699932,1672703359,3427
3624,3779532653,3299443125,1672656394,1672656648,254
3895,3492959689,3792072681,1672650790,1672654138,3348
3837,3760721303,3367971170,1672685836,1672686609,773
3467,3205985903,3783340788,1672690796,1672692494,1698
3785,3447514821,3791436104,1672601881,1672602134,253
3663,3240994288,3638204468,1672533890,1672536812,2922
3858,3778134418,3533274994,1672698623,1672700723,2100
3828,3831586487,3808136029,1672647930,1672649157,1227
3478,3279475486,3703348097,1672589063,1672589759,696
3575,3780680950,3270056120,1672692544,1672692975,431
3795,3469254160,3703348097,1672692634,1672693822,1188
3708,3774178201,3791693821,1672560575,1672563379,2804
3758,3730071479,3334647380,1672571883,1672574488,2605
3626,3689697817,3308760650,1672608242,1672610239,1997
3523,3510919821,3611055563,1672649058,1672651507,2449
3484,3519077659,3716272919,1672682150,1672682961,811
3747,3783919913,3938389661,1672656316,1672658213,1897
3603,3428725843,3755158925,1672554159,1672555506,1347
3429,3783615982,3510818674,1672581287,1672583065,1778
3659,3224968597,3970627281,1672600985,1672604310,3325
3523,3511883730,3366423342,1672538182,1672539143,961
3693,3617116290,3319167958,1672679431,1672680518,1087
3881,3900276517,3400069268,1672692260,1672695441,3181
3435,3208957949,3500604680,1672620054,1672623266,3212
3644,3931627862,3239617320,1672609508,1672611097,1589
3799,3456430614,3701373490,1672618375,1672621447,3072
3901,3756385685,3627368399,1672538407,1672541846,3439
3478,3773009828,3462273042,1672621500,1672622120,620
3660,3480991549,3431460073,1672690640,1672691221,581
3868,3778640261,3294747828,1672587802,1672591173,3371
3702,3686523546,3248058676,1672547063,1672548679,1616
3891,3505198734,3778597171,1672601559,1672602313,754
3606,3780115155,3667427125,1672533706,1672537189,3483
3794,3510818674,3300979975,1672652799,1672655799,3000
3531,3770676872,3779854934,1672557029,1672559291,2262
3850,3755404116,3400069268,1672535434,1672536624,1190
3539,3627368399,3701107228,1672695452,1672698950,3498
3616,3337322736,3834631333,1672667512,1672669915,2403
3609,3205985903,3517991730,1672700025,1672703523,3498
3601,3970603231,3770296583,1672703431,1672704580,1149
3739,3288224595,3410160376,1672615656,1672616006,350
3741,3396980894,3303410628,1672579590,1672581978,2388
3781,3792389522,3979802715,1672626679,1672629953,3274
3653,3710489491,3714233826,1672685325,1672688255,2930
3905,3791106564,3519282716,1672686989,1672690342,3353
3777,3688490530,3501281016,1672615625,1672618709,3084
3533,3793740407,3386758279,1672646241,1672646994,753
3889,3779656423,3371455553,1672626848,1672630332,3484
3596,3398731252,3715127070,1672572910,1672575430,2520
3444,3311420950,3492546679,1672554527,1672554730,203
3763,3357689359,3513327337,1672639857,1672642814,2957
3745,3615087943,3774907131,1672609942,1672613052,3110
3745,3291933594,3372223551,1672688602,1672690609,2007
3880,3400069268,3505725706,1672697704,1672700111,2407
3633,3783147088,3811075491,1672589357,1672590725,1368
3730,3778899160,3513545422,1672657267,1672659174,1907
3656,3660887799,3516741440,1672566733,1672567775,1042
3818,3825881598,3779854934,1672627592,1672630315,2723
3438,3912891315,3620292035,1672531587,1672532858,1271
3515,3974674109,3791128487,1672536644,1672537135,491
3540,3774876004,3245232284,1672700927,1672704418,3491
3511,3792949946,3519818818,1672648368,1672649202,834
3756,3274906650,3201800997,1672691192,1672693974,2782
3823,3500737582,3755230952,1672614688,1672615748,1060
3862,3441348818,3776559988,1672703319,1672706530,3211
3502,3779425804,3516444201,1672614968,1672617761,2793
3557,3449639012,3392836218,1672629563,1672629761,198
3919,3736231757,3617392620,1672671161,1672674716,3555
3499,3777779869,3773124276,1672643798,1672645534,1736
3618,3238288884,3519446663,1672621377,1672624629,3252
3877,3462636434,3972083617,1672632761,1672634862,2101
3613,3927403123,3715854030,1672601632,1672604023,2391
3588,3306175858,3807212280,1672656863,1672659068,2205
3565,3609881958,3890739241,1672561662,1672563764,2102
3815,3336339664,3715400486,1672550622,1672552725,2103
3749,3610358027,3438078818,1672675265,1672677809,2544
3755,3668533536,3304155815,1672606786,1672607682,896
3890,3450286949,3853629553,1672615093,1672617549,2456
3639,3236458894,3793315718,1672604171,1672605038,867
3534,3615087943,3510767239,1672636927,1672639769,2842
3628,3438078818,3619922891,1672549237,1672550079,842
3483,3515559913,3760842815,1672548484,1672550423,1939
3883,3668414677,3739911441,1672604070,1672606460,2390
3910,3520873221,3375449013,1672575325,1672576919,1594
3745,3710496785,3501525100,1672593509,1672595091,1582
3731,3755756564,3815392801,1672662000,1672663390,1390
3831,3772078494,3517590837,1672700227,1672701166,939
3447,3513345163,3515525630,1672642520,1672644378,1858
3690,3934064792,3517600136,1672532740,1672533850,1110
3850,3757700712,3703396825,1672656026,1672657164,1138
3548,3792801638,3617392620,1672541667,1672544821,3154
3723,3756789525,3773837847,1672667546,1672669142,1596
3502,3517697722,3284932450,1672651805,1672654420,2615
3462,3613206049,3668414677,1672652528,1672655287,2759
3921,3792745809,3410160376,1672701371,1672703297,1926
3425,3791436104,3738026330,1672587705,1672589532,1827
3830,3376467719,3755233658,1672687219,1672688932,1713
3891,3792949946,3755756564,1672661573,1672664059,2486
3571,3818575661,3605221116,1672538166,1672540701,2535
3663,3283492940,3520560590,1672630260,1672632399,2139
3836,3757700712,3514956366,1672612349,1672614541,2192
3726,3241914067,3778134418,1672698720,1672701453,2733
3828,3510028805,3779613523,1672571177,1672572482,1305
3772,3793868716,3511732493,1672558797,1672561904,3107
3733,3505434346,3630353876,1672656175,1672659768,3593
3816,3815392801,3774178201,1672602040,1672603478,1438
3667,3668414677,3516298579,1672543283,1672544060,777
3461,3363162590,3713829743,1672665993,1672667036,1043
3634,3224968597,3713979100,1672677118,1672677893,775
3429,3900276517,3417191856,1672702217,1672703222,1005
3473,3273981374,3711734586,1672606646,1672609075,2429
3724,3441703884,3516513251,1672608902,1672610341,1439
3670,3435167810,3519028898,1672656226,1672659340,3114
3853,3686523546,3617116290,1672542941,1672543646,705
3726,3414275042,3760721303,1672535086,1672535568,482
3672,3337362061,3920625129,1672606941,1672609530,2589
3913,3239617320,3689114185,1672534089,1672537277,3188
3838,3778667336,3779301501,1672604543,1672607774,3231
3453,3783373154,3272096759,1672630754,1672632990,2236
3613,3288762795,3757294769,1672679347,1672682888,3541
3577,3440107959,3928719932,1672670481,1672671303,822
3580,3774290799,3814305099,1672539740,1672540303,563
3867,3975717896,3500949309,1672697809,1672699595,1786
3504,3394401087,3454277788,1672611569,1672613016,1447
3616,3890739241,3779892400,1672600924,1672602779,1855
3833,3513345163,3417191856,1672623167,1672626574,3407
3783,3772765746,3505228454,1672534480,1672537352,2872
3746,3400763927,3783801141,1672575470,1672577133,1663
3492,3773572967,3333403880,1672571091,1672572465,1374
3585,3777779869,3402697190,1672627333,1672629633,2300
3850,3480991549,3431460073,1672635708,1672637107,1399
3675,3505995057,3920625129,1672685788,1672687542,1754
3443,3519028898,3460719322,1672668447,1672670215,1768
3805,3276217799,3927599181,1672630828,1672630917,89
3641,3441348818,3970198861,1672686439,1672687884,1445
3592,3927403123,3711812325,1672643926,1672645172,1246
3424,3703348097,3774290799,1672647610,1672649225,1615
3633,3716679950,3404025196,1672566125,1672568975,2850
3593,3970603231,3385323994,1672665739,1672666179,440
3891,3280054198,3512295534,1672604870,1672608442,3572
3891,3783433404,3401496246,1672659185,1672661857,2672
3506,3450286949,3780712350,1672685650,1672688032,2382
3886,3514956366,3300979975,1672562530,1672564317,1787
3464,3713941638,3711218296,1672559549,1672560666,1117
3846,3757903168,3519909393,1672554226,1672557214,2988
3471,3360616538,3777189898,1672674413,1672675590,1177
3615,3783550022,3438489358,1672534777,1672536829,2052
3510,3438489358,3703433819,1672590326,1672592316,1990
3912,3713589994,3779465522,1672633283,1672634034,751
3745,3371455553,3756474459,1672664145,1672665194,1049
3744,3385323994,3905196766,1672596109,1672598725,2616
3554,3703798634,3367509761,1672612416,1672612749,333
3493,3733558985,3401793306,1672673958,1672675899,1941
3541,3808136029,3514956366,1672670808,1672672419,1611
3577,3774031303,3238288884,1672617080,1672617640,560
3524,3505179890,3792949946,1672611269,1672611848,579
3721,3306412634,3336339664,1672678401,1672681684,3283
3644,3421385957,3773009828,1672631889,1672633515,1626
3915,3513081354,3500498112,1672615918,1672618900,2982
3488,3615737355,3225029895,1672656730,1672657555,825
3756,3435167810,3500703304,1672652587,1672655524,2937
3678,3224811762,3900276517,1672568175,1672568860,685
3445,3516489668,3200543880,1672676026,1672677684,1658
3677,3501121099,3513295938,1672640122,1672642813,2691
3740,3714666884,3421877923,1672686312,1672689772,3460
3847,3500525825,3715707380,1672702300,1672704130,1830
3565,3284947372,3613581796,1672609420,1672610582,1162
3721,3715854030,3772236797,1672574488,1672575978,1490
3590,3394401087,3970909253,1672573202,1672576557,3355
3481,3271454397,3853629553,1672697812,1672700880,3068
3757,3817813340,3621184108,1672666731,1672667006,275
3552,3514741348,3808136029,1672569833,1672571104,1271
3645,3905196766,3311098437,1672623281,1672625048,1767
3884,3773332082,3792505974,1672703057,1672703194,137
3567,3711006062,3209481722,1672616819,1672617277,458
3888,3834963772,3791753345,1672661281,1672664331,3050
3512,3778134418,3683113954,1672577174,1672578057,883
3619,3935487534,3500709774,1672666149,1672666929,780
3477,3227799827,3668414677,1672679862,1672682811,2949
3633,3451691949,3935399379,1672655086,1672658669,3583
3494,3880926355,3613338363,1672703378,1672704869,1491
3529,3621683102,3209526819,1672663038,1672665945,2907
3598,3505178849,3380130228,1672615358,1672618260,2902
3469,3779738691,3791436104,1672570869,1672571976,1107
3678,3272030610,3225029895,1672541832,1672542409,577
3801,3300511067,3500347447,1672641989,1672643887,1898
3735,3791441520,3500915665,1672702218,1672705448,3230
3806,3979784676,3792442597,1672661042,1672661641,599
3875,3803517637,3424660806,1672665327,1672668268,2941
3487,3512337405,3300818269,1672682720,1672684746,2026
3632,3513081354,3760263530,1672671635,1672675116,3481
3491,3713941638,3610358027,1672629383,1672629942,559
3572,3467779445,3777240360,1672565372,1672565926,554
3567,3613338363,3497095254,1672634115,1672635630,1515
3835,3501567772,3225636215,1672566672,1672568199,1527
3866,3517881647,3756625818,1672640031,1672641638,1607
3753,3715974659,3897435944,1672553062,1672554922,1860
3716,3518565331,3757294769,1672562076,1672563637,1561
3624,3714128600,3437286517,1672660328,1672663607,3279
3917,3231713082,3972083617,1672571991,1672574733,2742
3900,3279242917,3392836218,1672535530,1672536311,781
3481,3334974375,3778667336,1672653555,1672656502,2947
3720,3501459390,3283770991,1672548305,1672549899,1594
3743,3505154885,3600876425,1672539729,1672540627,898
3613,3534543776,3610358027,1672619550,1672622158,2608
3541,3756385685,3622665543,1672579281,1672579559,278
3486,3505888598,3272030610,1672673931,1672677426,3495
3641,3288762795,3773332082,1672654099,1672657450,3351
3679,3505807416,3271454397,1672544138,1672546391,2253
3504,3711097754,3495911207,1672664470,1672666902,2432
3640,3885157459,3636329663,1672643152,1672643648,496
3645,3300979975,3417679834,1672680635,1672682713,2078
3531,3891672228,3850911686,1672534438,1672534648,210
3678,3757323954,3306412634,1672608013,1672610199,2186
3837,3824641227,3608855425,1672596943,1672597164,221
3470,3534764451,3792072681,1672634988,1672637046,2058
3580,3923420131,3756127300,1672583961,1672587257,3296
3652,3791441520,3770624662,1672563667,1672564337,670
3648,3776117322,3760094385,1672697912,1672701013,3101
3809,3772765746,3755233658,1672629528,1672631255,1727
3530,3774155692,3885157459,1672569609,1672570907,1298
3642,3783801141,3512882178,1672616792,1672620194,3402
3640,3283770991,3938389661,1672587695,1672587813,118
3726,3226511603,3773939399,1672576576,1672579945,3369
3780,3305336154,3495911207,1672692860,1672693639,779
3427,3516741440,3224968597,1672637642,1672640766,3124
3851,3755065949,3627368399,1672575566,1672577058,1492
3478,3703383853,3206837348,1672598172,1672599965,1793
3788,3776831527,3757700712,1672655095,1672658194,3099
3667,3512722110,3756789525,1672628468,1672629192,724
3445,3618176292,3491684096,1672572441,1672574784,2343
3885,3770624662,3897376951,1672586573,1672586683,110
3793,3701373490,3688796737,1672539852,1672543424,3572
3475,3756789525,3500044458,1672562890,1672564156,1266
3451,3938503547,3661447322,1672576578,1672579926,3348
3863,3710496785,3715086894,1672674849,1672677879,3030
3759,3511843593,3885121158,1672626204,1672626548,344
3633,3460719322,3505228454,1672561113,1672562192,1079
3435,3512392431,3511317276,1672686136,1672686794,658
3671,3773913680,3618697021,1672684045,1672686355,2310
3675,3770624662,3755992176,1672648275,1672650260,1985
3903,3513296868,3613206049,1672551085,1672551300,215
3518,3518194482,3801645328,1672571456,1672572215,759
3732,3514246749,3626499450,1672548138,1672549469,1331
3851,3714678331,3299781901,1672588468,1672590396,1928
3630,3938503547,3343816795,1672596564,1672596840,276
3513,3225029895,3552824113,1672658484,1672660334,1850
3473,3625174002,3774718695,1672581252,1672584393,3141
3896,3363162590,3780209375,1672636117,1672638080,1963
3643,3299443125,3510919821,1672561342,1672561930,588
3740,3463740710,3887243870,1672653544,1672654512,968
3622,3791246640,3300511067,1672572460,1672575961,3501
3718,3517991730,3713911104,1672655287,1672655951,664
3519,3201676087,3776559988,1672699731,1672699993,262
3749,3615939504,3701005527,1672663075,1672664304,1229
3734,3770438122,3500317969,1672534050,1672534961,911
3660,3715443333,3225636215,1672612876,1672615966,3090
3733,3739154408,3826238375,1672608324,1672611427,3103
3741,3439673892,3885121158,1672575554,1672575836,282
3498,3500827202,3852533643,1672591850,1672593291,1441
3691,3514956366,3306412634,1672552965,1672554699,1734
3527,3938389661,3500044458,1672628083,1672630072,1989
3533,3880926355,3899326793,1672535667,1672535980,313
3837,3373028638,3347419520,1672608361,1672610121,1760
3748,3364378127,3895285664,1672583440,1672584359,919
3876,3501281016,3441348818,1672538623,1672541280,2657
3782,3979802715,3518653080,1672606588,1672610107,3519
3478,3664943873,3770704999,1672552401,1672554715,2314
3827,3811075491,3703798634,1672626350,1672627917,1567
3458,3755158925,3776831527,1672614585,1672616965,2380
3813,3337322736,3792020993,1672548571,1672551215,2644
3675,3757700712,3829822608,1672540112,1672542693,2581
3871,3739661856,3912891315,1672662806,1672665808,3002
3670,3534179433,3463740710,1672659961,1672661387,1426
3783,3783801141,3511150845,1672595063,1672596868,1805
3831,3791046864,3783147088,1672697595,1672699194,1599
3865,3716110860,3734118023,1672642812,1672642993,181
3631,3778134418,3438078818,1672637546,1672638046,500
3534,3625463628,3713784974,1672607092,1672608783,1691
3847,3636329663,3664943873,1672531238,1672533708,2470
3567,3451326054,3792442597,1672562819,1672565747,2928
3529,3638660068,3299443125,1672601131,1672602464,1333
3768,3703383853,3288762795,1672655572,1672657452,1880
3555,3372223551,3912891315,1672543396,1672545844,2448
3844,3891672228,3517462308,1672570343,1672571304,961
3818,3757348722,3316798920,1672695981,1672696771,790
3883,3451691949,3354144091,1672589908,1672590868,960
3503,3490214516,3713979100,1672693471,1672696191,2720
3497,3737112297,3715974659,1672552587,1672554371,1784
3487,3333403880,3931627862,1672637413,1672639626,2213
3502,3411688875,3613206049,1672586086,1672589654,3568
3729,3617304541,3501459390,1672616892,1672620251,3359
3864,3500915665,3615115210,1672615598,1672616114,516
3481,3792489602,3554944414,1672656309,1672657048,739
3634,3512502036,3533423872,1672535215,1672537983,2768
3787,3231494505,3778899160,1672555674,1672557378,1704
3902,3240394404,3610358027,1672548181,1672549568,1387
3637,3613581796,3756625818,1672659670,1672660662,992
3752,3336339664,3626499450,1672549367,1672551292,1925
3601,3829864515,3630353876,1672602798,1672605151,2353
3434,3618354185,3552824113,1672689961,1672690996,1035
3773,3414049538,3615737355,1672565656,1672567659,2003
3760,3776831527,3463740710,1672702230,1672702567,337
3836,3711077927,3554825448,1672559866,1672559978,112
3904,3398198430,3773033649,1672576091,1672578737,2646
3555,3783520186,3773332082,1672653520,1672654909,1389
3904,3400763927,3500498112,1672568106,1672568927,821
3781,3316800320,3793740407,1672643014,1672646228,3214
3567,3505847380,3510028805,1672564947,1672565657,710
3508,3774733620,3478114114,1672565149,1672567743,2594
3693,3505266860,3231713082,1672621470,1672624831,3361
3537,3738026330,3501281016,1672611207,1672612482,1275
3636,3779613523,3554825448,1672655542,1672656724,1182
3664,3411515369,3245232284,1672613031,1672615453,2422
3554,3612689556,3380982774,1672537609,1672540608,2999
3866,3970198861,3836241528,1672574799,1672578087,3288
3514,3274831810,3288224595,1672562092,1672562278,186
3506,3310039260,3772765746,1672576424,1672577206,782
3835,3803517637,3289817992,1672700013,1672700370,357
3638,3372223551,3472068734,1672574360,1672574715,355
3729,3511843593,3760364383,1672586772,1672587740,968
3886,3512946768,3310039260,1672572107,1672575123,3016
3760,3609933747,3276003502,1672630095,1672631382,1287
3480,3715986185,3421877923,1672680504,1672683853,3349
3891,3421385957,3618354185,1672574854,1672576159,1305
3627,3236499444,3519818818,1672696415,1672697165,750
3561,3793935736,3380982774,1672665618,1672668793,3175
3889,3300818269,3885537225,1672551720,1672553722,2002
3842,3231494505,3793740407,1672570248,1672572611,2363
3482,3757903168,3457620713,1672612355,1672613174,819
3440,3456430614,3893912331,1672611702,1672611794,92
3725,3386758279,3229822507,1672665773,1672667337,1564
3911,3512882178,3715986185,1672701758,1672705216,3458
3592,3505179890,3291933594,1672579531,1672580022,491
3620,3836241528,3514512367,1672672115,1672675516,3401
3836,3220031931,3793407963,1672567876,1672568917,1041
3661,3298151889,3793883863,1672639342,1672642852,3510
3549,3755404116,3715986185,1672613440,1672616330,2890
3466,3421385957,3447514821,1672554005,1672554237,232
3819,3791128487,3970603231,1672534405,1672534730,325
3765,3715707380,3779532653,1672582406,1672585862,3456
3658,3510919821,3299125059,1672533735,1672534269,534
3711,3715400486,3500777439,1672588119,1672590157,2038
3651,3518565331,3770468980,1672635500,1672637208,1708
3516,3292147449,3902861231,1672583373,1672584917,1544
3693,3500109249,3776084820,1672588676,1672589531,855
3758,3357864626,3783801141,1672699383,1672701197,1814
3609,3367111751,3412968120,1672533753,1672534854,1101
3639,3632814465,3930242012,1672635696,1672636704,1008
3548,3451726367,3319167958,1672626792,1672630303,3511
3690,3515401243,3935399379,1672605591,1672607057,1466
3685,3779656423,3279475486,1672573462,1672575951,2489
3557,3347446226,3228888030,1672543701,1672546328,2627
3849,3481640525,3779938251,1672656656,1672659306,2650
3426,3515402792,3299125059,1672678593,1672679917,1324
3698,3975717896,3238288884,1672636673,1672637825,1152
3786,3276269264,3925979970,1672578387,1672578749,362
3814,3515401243,3925979970,1672616827,1672619971,3144
3914,3505111292,3440107959,1672562093,1672565588,3495
3433,3533747868,3519142371,1672641769,1672642510,741
3842,3688490530,3783771827,1672531585,1672534032,2447
3893,3701136026,3306175858,1672697305,1672699564,2259
3918,3780427126,3714666884,1672657520,1672658967,1447
3650,3773913680,3715385401,1672667177,1672670724,3547
3511,3490029863,3401940259,1672571239,1672572756,1517
3715,3710048469,3513327337,1672644960,1672646713,1753
3622,3462636434,3231713082,1672617954,1672618775,821
3742,3519818818,3933894942,1672585784,1672588809,3025
3860,3619922891,3501786419,1672663827,1672664105,278
3702,3715385401,3517590837,1672673284,1672674745,1461
3726,3517222913,3920625129,1672539815,1672542358,2543
3899,3439673892,3274906650,1672699825,1672700428,603
3555,3276269264,3685681577,1672619161,1672621700,2539
3527,3833217041,3701664364,1672610672,1672612228,1556
3844,3495911207,3710735406,1672640646,1672643175,2529
3560,3514971533,3921648519,1672691193,1672691411,218
3790,3480991549,3897134762,1672609540,1672612337,2797
3490,3935399379,3834963772,1672534625,1672535769,1144
3685,3610358027,3236499444,1672643951,1672645670,1719
3457,3488763230,3637313265,1672580858,1672581076,218
3454,3773902805,3779656423,1672674373,1672676223,1850
3784,3777814504,3451691949,1672566961,1672568679,1718
3783,3520416075,3515439826,1672698148,1672699787,1639
3437,3970198861,3533423872,1672631618,1672634871,3253
3554,3517991730,3885537225,1672671025,1672673008,1983
3451,3970198861,3224811762,1672598523,1672599576,1053
3854,3500613459,3776831527,1672694421,1672696952,2531
3539,3710854064,3510767239,1672622648,1672622816,168
3540,3520181148,3395201292,1672551734,1672553113,1379
3911,3791796585,3710315160,1672582009,1672582792,783
3602,3711734586,3609881958,1672593263,1672596420,3157
3825,3776117322,3609659642,1672547867,1672548659,792
3656,3516703758,3618808151,1672688552,1672689377,825
3814,3557046880,3635169815,1672547360,1672549816,2456
3752,3505888598,3469254160,1672620580,1672620890,310
3587,3418448389,3311498666,1672641192,1672642701,1509
3587,3605221116,3518565331,1672670853,1672672980,2127
3471,3274906650,3622357348,1672591655,1672593185,1530
3526,3783373154,3622665543,1672574064,1672577411,3347
3827,3773033649,3755848152,1672552155,1672555148,2993
3820,3500498112,3279475486,1672589506,1672590929,1423
3908,3228888030,3777330107,1672552234,1672552989,755
3440,3638660068,3519818818,1672652954,1672654404,1450
3628,3309314379,3533368789,1672677045,1672680046,3001
3464,3514956366,3776559988,1672577783,1672580785,3002
3892,3899326793,3501567772,1672597863,1672601014,3151
3846,3448875382,3270042456,1672580378,1672580852,474
3618,3731646673,3714670620,1672601620,1672602261,641
3457,3614740489,3435167810,1672593230,1672596305,3075
3720,3428027649,3300818269,1672549447,1672552024,2577
3883,3500044458,3757318448,1672605488,1672605939,451
3509,3515402792,3456430614,1672531852,1672532839,987
3758,3271752081,3379143440,1672540487,1672543439,2952
3816,3510964997,3783373154,1672608574,1672611242,2668
3507,3534126409,3447672935,1672542532,1672545021,2489
3720,3920497528,3201800997,1672614719,1672617676,2957
3697,3909094917,3793969543,1672587408,1672589978,2570
3797,3661903000,3276348699,1672678534,1672678927,393
3508,3793740407,3772078494,1672596607,1672598231,1624
3447,3488763230,3534126409,1672693303,1672695147,1844
3586,3638204468,3201629017,1672593752,1672595129,1377
3656,3220031931,3512392431,1672633577,1672635048,1471
3901,3226178937,3554186380,1672636747,1672638936,2189
3489,3239617320,3514703118,1672695889,1672697605,1716
3791,3335694356,3316798920,1672544953,1672546391,1438
3631,3684523966,3801645328,1672678420,1672681089,2669
3530,3715619259,3510837901,1672624098,1672626415,2317
3841,3756127300,3382733096,1672702787,1672704036,1249
3833,3387594369,3715400486,1672636516,1672638455,1939
3732,3305722859,3468041839,1672564428,1672564622,194
3796,3551389192,3534175249,1672673920,1672676238,2318
3915,3513345163,3660063072,1672544699,1672546839,2140
3918,3559731671,3512882178,1672653134,1672653777,643
3844,3791046864,3501281016,1672625593,1672627113,1520
3673,3773913680,3534357694,1672676682,1672677330,648
3712,3710735406,3933894942,1672545535,1672545875,340
3503,3520355798,3780872464,1672604162,1672607027,2865
3570,3778926763,3756704774,1672667507,1672669404,1897
3657,3500044458,3689697817,1672691224,1672692610,1386
3713,3884596900,3289114629,1672540634,1672542119,1485
3865,3517737088,3220031931,1672626335,1672629133,2798
3772,3501525100,3512383699,1672615038,1672616015,977
3809,3792442597,3622357348,1672678351,1672680048,1697
3562,3710735406,3462636434,1672646974,1672647534,560
3553,3500613459,3200308999,1672575362,1672578501,3139
3549,3793407963,3760694096,1672574908,1672578148,3240
3744,3336627643,3509764635,1672671503,1672672515,1012
3429,3928511283,3935399379,1672551714,1672552040,326
3582,3926643445,3224811762,1672584392,1672586420,2028
3818,3900945856,3505634634,1672565747,1672566662,915
3470,3412006598,3970603231,1672555949,1672557310,1361
3830,3285204083,3755233658,1672645277,1672648535,3258
3472,3383138270,3755404116,1672618189,1672618356,167
3541,3850911686,3774718695,1672552217,1672555768,3551
3614,3500604680,3228888030,1672607381,1672608843,1462
3830,3779646172,3224968597,1672545070,1672547421,2351
3703,3369708250,3236499444,1672531948,1672532080,132
3531,3505198734,3933894942,1672580534,1672583578,3044
3429,3793740407,3889780657,1672654812,1672656853,2041
3856,3229822507,3516703758,1672549548,1672550116,568
3891,3225631197,3520639768,1672702009,1672703897,1888
3559,3500857494,3739154408,1672605085,1672605682,597
3866,3299125059,3505995057,1672606461,1672609095,2634
3493,3776831527,3351866415,1672564703,1672566762,2059
3657,3347446226,3421877923,1672569398,1672572365,2967
3508,3202804048,3451326054,1672543867,1672543952,85
3439,3511317276,3206837348,1672588544,1672591923,3379
3902,3514818819,3518194482,1672659462,1672662963,3501
3725,3701884158,3520560590,1672667765,1672669260,1495
3817,3511883730,3380130228,1672664514,1672667638,3124
3469,3533274994,3513296868,1672686206,1672687901,1695
3448,3500604680,3772765746,1672615010,1672616097,1087
3762,3701884158,3930242012,1672628863,1672629574,711
3805,3609659642,3226511603,1672615810,1672617869,2059
3729,3205985903,3703139663,1672657144,1672660570,3426
3478,3774641380,3371455553,1672543669,1672545120,1451
3625,3519850727,3500208903,1672551613,1672553370,1757
3651,3296462324,3480991549,1672635635,1672637054,1419
3554,3970909253,3373089838,1672619619,1672620614,995
3497,3760651515,3337362061,1672599353,1672600565,1212
3822,3774718695,3533649454,1672667997,1672671247,3250
3555,3617489344,3615688740,1672580923,1672582040,1117
3792,3517697722,3279242917,1672638372,1672640322,1950
3710,3701664364,3520115090,1672555300,1672557171,1871
3637,3451326054,3294703680,1672616219,1672618283,2064
3892,3780712350,3714185969,1672614516,1672615641,1125
3803,3456430614,3773939399,1672631006,1672633987,2981
3832,3835422146,3382733096,1672681111,1672683295,2184
3684,3518229776,3513041785,1672547508,1672548594,1086
3803,3774733620,3310125159,1672632467,1672635261,2794
3891,3437286517,3972192593,1672676035,1672679108,3073
3634,3738026330,3779854934,1672584539,1672587862,3323
3912,3621790707,3713163045,1672635705,1672638577,2872
3663,3300511067,3760094385,1672649938,1672652758,2820
3647,3443357683,3760721303,1672634320,1672636450,2130
3758,3505725706,3780472203,1672665310,1672665783,473
3593,3900898992,3500072204,1672631760,1672633376,1616
3451,3760842815,3780872464,1672620024,1672623423,3399
3583,3380130228,3505402439,1672693934,1672695030,1096
3524,3682133690,3906536154,1672586421,1672587582,1161
3891,3520560590,3205923620,1672588546,1672591566,3020
3463,3833217041,3333403880,1672564098,1672565678,1580
3723,3631090677,3613416045,1672690553,1672691272,719
3580,3513081354,3814305099,1672687129,1672689981,2852
3729,3534179433,3349856820,1672592004,1672593635,1631
3900,3370068529,3309314379,1672627197,1672628494,1297
3640,3517172354,3772236797,1672658919,1672660144,1225
3624,3617489344,3333403880,1672582385,1672582660,275
3921,3283492940,3394297564,1672591285,1672594650,3365
3636,3501457103,3710854064,1672639732,1672643261,3529
3699,3817428320,3793418209,1672581691,1672584079,2388
3584,3270056120,3793740407,1672703200,1672704861,1661
3768,3780909839,3610358027,1672581621,1672581926,305
3835,3792538417,3818575661,1672554957,1672555147,190
3845,3417191856,3533929349,1672657836,1672659039,1203
3596,3514741348,3428725843,1672553750,1672555508,1758
3856,3756704774,3380130228,1672688535,1672690138,1603
3617,3899326793,3783928182,1672666536,1672669647,3111
3696,3780834916,3780338697,1672697366,1672699757,2391
3873,3516321888,3701424609,1672533468,1672536195,2727
3809,3294703680,3757318448,1672548178,1672548677,499
3445,3533747868,3411515369,1672601557,1672603154,1597
3842,3618808151,3608855425,1672580906,1672582708,1802
3887,3415833929,3701884158,1672541552,1672543758,2206
3712,3515402792,3755496114,1672614470,1672617897,3427
3657,3441348818,3510028805,1672550379,1672553051,2672
3556,3505847380,3534126409,1672642109,1672643841,1732
3871,3485540729,3713163045,1672542035,1672542630,595
3681,3760651515,3604867757,1672642759,1672646047,3288
3576,3737972328,3711218296,1672570166,1672570363,197
3800,3379143440,3363162590,1672623685,1672624218,533
3704,3615115210,3500672156,1672538544,1672541561,3017
3903,3777037426,3710496785,1672575391,1672575741,350
3586,3519282716,3714670620,1672542387,1672544915,2528
3459,3774790271,3500498112,1672574401,1672575030,629
3849,3272716462,3511024016,1672680620,1672683070,2450
3659,3608232640,3370227921,1672548405,1672549324,919
3563,3288224595,3398198430,1672596190,1672596683,493
3425,3362641275,3480490124,1672540895,1672543005,2110
3435,3757630221,3909094917,1672546966,1672549074,2108
3548,3773902805,3760924079,1672608690,1672609464,774
3674,3927403123,3505521218,1672640228,1672643670,3442
3523,3617392620,3935487534,1672547844,1672548026,182
3747,3885537225,3618354185,1672580570,1672581456,886
3824,3773837847,3289817992,1672619822,1672622031,2209
3813,3303410628,3885155975,1672589686,1672591832,2146
3679,3316800320,3534829213,1672628488,1672629005,517
3890,3661447322,3780834916,1672605792,1672607149,1357
3555,3834960360,3304971369,1672628407,1672630697,2290
3435,3711006062,3839245934,1672549879,1672553380,3501
3503,3519818818,3533368789,1672581440,1672582259,819
3782,3226178937,3783520186,1672698623,1672700353,1730
3748,3520416075,3975717896,1672694749,1672696021,1272
3508,3824215187,3306175858,1672659291,1672660544,1253
3440,3714678331,3516741440,1672563968,1672566065,2097
3514,3463740710,3715400486,1672585022,1672587724,2702
3811,3817428320,3779656423,1672640800,1672644196,3396
3521,3701823816,3757863420,1672586910,1672587441,531
3500,3512295534,3812369928,1672560978,1672562674,1696
3701,3772078494,3892304880,1672534013,1672537264,3251
3568,3779532653,3519028898,1672654100,1672654475,375
3524,3417679834,3852533643,1672647688,1672649432,1744
3736,3360616538,3685816610,1672634270,1672636299,2029
3865,3514956366,3224968597,1672543783,1672545604,1821
3599,3520873221,3780769110,1672610488,1672613343,2855
3476,3779613523,3451691949,1672603985,1672607382,3397
3735,3779892400,3232208416,1672590793,1672593258,2465
3921,3239617320,3556969573,1672589752,1672590700,948
3474,3736705719,3505888598,1672531210,1672531530,320
3555,3519909393,3337322736,1672577729,1672580809,3080
3907,3311420950,3289817992,1672539527,1672540186,659
3609,3779639983,3533004959,1672647898,1672649918,2020
3691,3424445495,3760094385,1672678294,1672680224,1930
3868,3500672156,3760651515,1672574770,1672577191,2421
3536,3757348722,3890739241,1672646193,1672647800,1607
3747,3757348722,3620292035,1672537183,1672540726,3543
3826,3517358573,3490214516,1672566232,1672569295,3063
3491,3309314379,3534543776,1672665474,1672665588,114
3477,3512502036,3914691363,1672689492,1672692471,2979
3805,3739911441,3347446226,1672557820,1672560572,2752
3794,3514956366,3904867554,1672640918,1672641246,328
3677,3777189898,3505283390,1672595397,1672597697,2300
3729,3776518452,3615115210,1672650830,1672653020,2190
3779,3774031303,3276003502,1672565046,1672565168,122
3745,3631479562,3516903528,1672588355,1672590373,2018
3890,3509756823,3737147209,1672640096,1672641453,1357
3637,3512882178,3778134418,1672603512,1672605305,1793
3486,3770146716,3311085279,1672669879,1672672223,2344
3475,3520578796,3514512367,1672622037,1672623663,1626
3657,3515559913,3926643445,1672645692,1672646768,1076
3830,3715619259,3739895284,1672646686,1672648353,1667
3634,3315703693,3505725706,1672600540,1672600842,302
3890,3338390596,3511732493,1672543073,1672545220,2147
3450,3661903000,3300511067,1672650572,1672651757,1185
3855,3777779869,3500613493,1672592942,1672595148,2206
3810,3520560590,3856606678,1672580107,1672580698,591
3723,3520873221,3439673892,1672618786,1672619548,762
3811,3208957949,3436025562,1672576251,1672578267,2016
3700,3347419520,3294703680,1672613755,1672616147,2392
3917,3231713082,3791753345,1672613076,1672615035,1959
3746,3756789525,3505266860,1672579045,1672580430,1385
3875,3518194482,3713691388,1672643691,1672644202,511
3904,3505179890,3517697722,1672546235,1672549444,3209
3586,3505481368,3334993594,1672560183,1672561262,1079
3443,3414940786,3979802715,1672680574,1672682735,2161
3683,3732584121,3519077659,1672633041,1672633531,490
3612,3660063072,3715127070,1672703807,1672704983,1176
3700,3279475486,3514956366,1672541907,1672545205,3298
3726,3305722859,3914691363,1672611049,1672612224,1175
3565,3607882826,3533929349,1672569014,1672570891,1877
3571,3667427125,3457620713,1672620806,1672623676,2870
3668,3517687662,3792389522,1672664494,1672667385,2891
3809,3360616538,3716110860,1672541268,1672544403,3135
3694,3386758279,3777624586,1672645933,1672649417,3484
3438,3715545685,3500841914,1672649902,1672650323,421
3753,3703396825,3714670620,1672625824,1672626043,219
3832,3354144091,3680810086,1672542964,1672545658,2694
3582,3501459390,3664943873,1672600838,1672601460,622
3517,3392836218,3906536154,1672640525,1672643240,2715
3586,3783147088,3714670620,1672586971,1672587309,338
3811,3739895284,3791693821,1672697780,1672699691,1911
3452,3202804048,3824641227,1672630020,1672631493,1473
3428,3834963772,3447672935,1672656616,1672660048,3432
3873,3760362417,3780253901,1672573817,1672575729,1912
3598,3201676087,3438489358,1672701487,1672701981,494
3644,3792020993,3500737582,1672658299,1672659938,1639
3536,3801645328,3512958459,1672596782,1672599556,2774
3584,3713911104,3971806004,1672588239,1672588335,96
3576,3777147510,3902625986,1672555853,1672558046,2193
3563,3979802715,3783801141,1672657623,1672657983,360
3893,3495911207,3276217799,1672589333,1672591708,2375
3723,3285204083,3200543880,1672703709,1672704278,569
3672,3716272919,3367111751,1672632801,1672635170,2369
3707,3439673892,3779613523,1672631230,1672634186,2956
3659,3757903168,3515402792,1672661206,1672664086,2880
3673,3395201292,3792442597,1672563200,1672565745,2545
3823,3914691363,3733558985,1672659825,1672662575,2750
3531,3500827202,3755404116,1672666631,1672667899,1268
3444,3779656423,3497808662,1672557151,1672559492,2341
3804,3779646172,3500737582,1672638966,1672642032,3066
3812,3618354185,3635169815,1672544287,1672546842,2555
3478,3410160376,3756474459,1672609255,1672611801,2546
3574,3614740489,3703433819,1672620101,1672621562,1461
3547,3512958459,3756385685,1672565118,1672566625,1507
3611,3608232640,3711218296,1672661911,1672663169,1258
3825,3316800320,3495911207,1672621946,1672622201,255
3567,3399472693,3928511283,1672637468,1672640368,2900
3915,3500827202,3774641380,1672605092,1672606154,1062
3526,3713979100,3449639012,1672587767,1672588761,994
3702,3780253901,3517887477,1672596623,1672598582,1959
3532,3776084820,3926643445,1672600320,1672601117,797
3724,3228888030,3517462308,1672598893,1672601282,2389
3429,3626499450,3500341755,1672626203,1672628328,2125
3919,3779738691,3615113018,1672590823,1672592162,1339
3662,3819767045,3715086894,1672575305,1672578614,3309
3902,3457620713,3271454397,1672655012,1672657825,2813
3772,3814677862,3408498208,1672677114,1672678984,1870
3600,3497808662,3520639768,1672671257,1672671822,565
3499,3509764635,3701005527,1672643436,1672644238,802
3657,3373028638,3533423872,1672566253,1672566390,137
3677,3451691949,3449639012,1672585597,1672585800,203
3698,3734451191,3780872464,1672593553,1672594817,1264
3918,3225631197,3409114719,1672653150,1672654876,1726
3632,3732584121,3341893384,1672666907,1672667203,296
3531,3514703118,3756385685,1672603430,1672603893,463
3814,3554825448,3276269264,1672645161,1672647749,2588
3577,3770146716,3485540729,1672533346,1672536440,3094
3899,3770146716,3516903528,1672570424,1672572453,2029
3458,3755573472,3923420131,1672703312,1672706718,3406
3871,3316798920,3399518841,1672605887,1672607777,1890
3533,3367111751,3683113954,1672586766,1672587495,729
3595,3858172636,3756127300,1672538748,1672539867,1119
3456,3517358573,3770438122,1672544115,1672544633,518
3879,3500604680,3519077659,1672544336,1672546406,2070
3805,3513545422,3815250107,1672600788,1672602070,1282
3896,3927165965,3500827202,1672639595,1672641609,2014
3843,3792014516,3451691949,1672682727,1672683013,286
3766,3347419520,3500442734,1672658044,1672661222,3178
3617,3713163045,3802932312,1672703843,1672704807,964
3591,3500525825,3621461051,1672688069,1672691210,3141
3917,3452016771,3490214516,1672633162,1672636501,3339
3912,3475349791,3885537225,1672665559,1672666771,1212
3520,3778134418,3534179433,1672536017,1672539329,3312
3597,3338390596,3661583097,1672639560,1672642886,3326
3754,3668747074,3938503547,1672584439,1672586559,2120
3716,3931627862,3757318448,1672549283,1672551666,2383
3512,3514512367,3228888030,1672657410,1672658433,1023
3511,3897134762,3686523546,1672565758,1672568870,3112
3672,3772765746,3245232284,1672703076,1672706404,3328
3772,3311420950,3501281016,1672660561,1672662055,1494
3768,3713163045,3551389192,1672549474,1672551490,2016
3461,3897456874,3457960571,1672629150,1672629941,791
3424,3334993594,3437286517,1672564141,1672565773,1632
3479,3461119815,3310039260,1672539176,1672541483,2307
3692,3428027649,3387594369,1672579806,1672581085,1279
3894,3977148669,3510554314,1672640705,1672643853,3148
3671,3505283390,3713691388,1672625945,1672629259,3314
3559,3239617320,3701882224,1672623526,1672626309,2783
3724,3760640999,3347419520,1672580774,1672582085,1311
3485,3350095157,3923220461,1672659331,1672660598,1267
3828,3554825448,3283144118,1672684735,1672685490,755
3577,3280054198,3926643445,1672649142,1672649729,587
3683,3733363628,3609113156,1672648366,1672650818,2452
3896,3306175858,3384583385,1672556281,1672559133,2852
3683,3900898992,3231713082,1672624527,1672626034,1507
3708,3773837847,3792489602,1672656955,1672658478,1523
3784,3783163143,3737112297,1672538145,1672538335,190
3544,3826238375,3511791953,1672692610,1672695273,2663
3750,3783641602,3792442597,1672703254,1672704730,1476
3633,3779854934,3780769110,1672695296,1672698832,3536
3464,3338083680,3272716462,1672585694,1672587223,1529
3529,3510767239,3512830734,1672648669,1672649601,932
3725,3632814465,3305336154,1672690473,1672693035,2562
3839,3520764926,3685681577,1672625109,1672628049,2940
3586,3791441520,3780472203,1672606370,1672606465,95
3871,3792489602,3703798634,1672565668,1672567812,2144
3632,3780472203,3375449013,1672701792,1672704215,2423
3599,3777779869,3382733096,1672559920,1672560434,514
3592,3773009828,3440107959,1672676388,1672678439,2051
3556,3386758279,3408498208,1672681259,1672684417,3158
3728,3209481722,3815392801,1672685235,1672686692,1457
3871,3505154885,3928511283,1672568845,1672571509,2664
3729,3401793306,3604589802,1672542847,1672545180,2333
3547,3783928182,3270042456,1672576962,1672579760,2798
3865,3774605761,3970558632,1672630348,1672630484,136
3471,3336339664,3701136026,1672644217,1672645270,1053
3839,3617489344,3534543776,1672619051,1672622217,3166
3455,3760842815,3780427126,1672612186,1672612643,457
3628,3732131656,3757348722,1672663054,1672664347,1293
3437,3780427126,3412968120,1672574635,1672576081,1446
3886,3519446663,3701823816,1672658616,1672660132,1516
3444,3621184108,3801645328,1672703336,1672705810,2474
3821,3783163143,3401496246,1672548771,1672550931,2160
3681,3417679834,3520873221,1672687626,1672689829,2203
3845,3608855425,3229822507,1672688693,1672689500,807
3857,3755230952,3452016771,1672546534,1672548341,1807
3534,3510187271,3664943873,1672606998,1672609436,2438
3736,3514971533,3757193551,1672651680,1672654625,2945
3581,3510837901,3517881647,1672550983,1672553672,2689
3885,3778134418,3619922891,1672683554,1672684732,1178
3716,3304971369,3773332082,1672598849,1672601615,2766
3692,3510767239,3938503547,1672596080,1672599111,3031
3489,3551399764,3533294425,1672645093,1672648428,3335
3720,3755233658,3615115210,1672592818,1672593658,840
3835,3685681577,3441703884,1672563814,1672565199,1385
3839,3299781901,3284932450,1672562480,1672566022,3542
3649,3710496785,3505283390,1672659463,1672661487,2024
3731,3457960571,3462158237,1672616006,1672618523,2517
3593,3737972328,3850911686,1672694147,1672697084,2937
3594,3701107228,3435167810,1672611883,1672614527,2644
3886,3609881958,3607882826,1672551891,1672555344,3453
3521,3713163045,3447514821,1672534740,1672535292,552
3813,3294703680,3299781901,1672642066,1672642311,245
3747,3791441520,3701005527,1672577491,1672578798,1307
3642,3667673649,3734118023,1672590729,1672593230,2501
3637,3824641227,3834631333,1672636273,1672639317,3044
3672,3500525825,3511024016,1672552586,1672556106,3520
3723,3715854030,3224811762,1672648008,1672650435,2427
3773,3780834916,3733363628,1672652152,1672654650,2498
3576,3446533960,3205985903,1672673435,1672675848,2413
3758,3774705415,3783147088,1672619548,1672619905,357
3710,3780115155,3357289672,1672547029,1672549241,2212
3813,3308760650,3660063072,1672564953,1672566340,1387
3652,3714666884,3829822608,1672588082,1672588403,321
3830,3792546035,3330340793,1672627168,1672628411,1243
3561,3513410578,3714185969,1672698051,1672700584,2533
3848,3633735593,3400069268,1672563000,1672564026,1026
3486,3491469603,3783771827,1672616677,1672617026,349
3542,3755737419,3518565331,1672673082,1672674543,1461
3638,3501786419,3534126409,1672686676,1672687339,663
3466,3501786419,3411515369,1672614396,1672617266,2870
3844,3209481722,3500109249,1672637839,1672640335,2496
3683,3933894942,3500672156,1672646813,1672649136,2323
3563,3757863420,3778667336,1672654892,1672657400,2508
3736,3513296868,3715707380,1672590904,1672593406,2502
3541,3510767239,3500777439,1672663780,1672665410,1630
3527,3892304880,3459681410,1672557396,1672559223,1827
3769,3714120857,3480100311,1672639240,1672642366,3126
3819,3610358027,3511601997,1672658498,1672660732,2234
3559,3412006598,3514324011,1672698173,1672700179,2006
3710,3711000597,3513081354,1672613794,1672616907,3113
3547,3334647380,3780338697,1672532066,1672533372,1306
3818,3236354255,3716963089,1672584723,1672586494,1771
3780,3338390596,3231713082,1672696926,1672698398,1472
3516,3224811762,3462273042,1672565657,1672566172,515
3755,3660063072,3661903000,1672646828,1672648170,1342
3532,3621683102,3288762795,1672642331,1672643132,801
3820,3931627862,3513041785,1672691075,1672693605,2530
3520,3505725706,3928511283,1672641723,1672644046,2323
3916,3774178201,3778899160,1672664979,1672668102,3123
3681,3783641602,3424445495,1672638143,1672639497,1354
3795,3505847380,3701107228,1672618393,1672621352,2959
3468,3899786664,3505111292,1672590727,1672592898,2171
3710,3685681577,3770520359,1672599071,1672602176,3105
3471,3711077927,3513018485,1672636176,1672637600,1424
3547,3716679950,3517172354,1672609899,1672612387,2488
3517,3501281016,3500672156,1672639765,1672643131,3366
3622,3617489344,3418448389,1672548527,1672549343,816
3643,3386758279,3338083680,1672633038,1672635965,2927
3588,3306412634,3513018485,1672652662,1672653859,1197
3446,3443357683,3493017654,1672609344,1672612474,3130
3453,3777779869,3559458968,1672602171,1672605581,3410
3591,3664943873,3454277788,1672549443,1672551872,2429
3546,3902760230,3279475486,1672647172,1672647830,658
3557,3534126409,3511150845,1672544624,1672547145,2521
3675,3760362417,3304155815,1672658109,1672659493,1384
3655,3713163045,3392943173,1672693474,1672694347,873
3631,3364726656,3334993594,1672592002,1672592709,707
3868,3408498208,3505228454,1672604028,1672606331,2303
3783,3505663516,3497095254,1672682533,1672685669,3136
3692,3505847380,3294703680,1672654864,1672657472,2608
3581,3757193551,3757318448,1672698831,1672699911,1080
3705,3777091903,3613206049,1672575720,1672576597,877
3723,3757700712,3475349791,1672594412,1672595879,1467
3791,3625174002,3972192593,1672555203,1672557166,1963
3802,3533649454,3505481368,1672582704,1672586173,3469
3634,3621683102,3491684096,1672669858,1672671973,2115
3908,3607768197,3793883863,1672537441,1672539443,2002
3545,3400069268,3460719322,1672581807,1672582065,258
3861,3714670620,3517590837,1672548528,1672549396,868
3733,3755404116,3703348097,1672578979,1672582471,3492
3704,3510818674,3500442734,1672627554,1672630729,3175
3902,3780427126,3710008361,1672571083,1672572166,1083
3531,3824641227,3272096759,1672549326,1672552817,3491
3755,3779786641,3737972328,1672552344,1672553583,1239
3450,3516513251,3276269264,1672647905,1672651016,3111
3683,3609659642,3349739136,1672572802,1672576341,3539
3725,3777091903,3732131656,1672539907,1672540788,881
3622,3505434346,3923420131,1672683936,1672685362,1426
3757,3780322355,3513410578,1672610707,1672611198,491
3740,3977148669,3236354255,1672579950,1672581995,2045
3873,3512392431,3757323954,1672691744,1672694820,3076
3499,3292147449,3517222913,1672586251,1672588827,2576
3651,3605221116,3776084820,1672587272,1672590440,3168
3577,3505179890,3779646172,1672693149,1672696437,3288
3774,3533188828,3408498208,1672572849,1672573538,689
3462,3807212280,3757383891,1672555224,1672556450,1226
3433,3500347447,3510964997,1672572622,1672576033,3411
3760,3615939504,3780472203,1672657731,1672659386,1655
3871,3389634034,3240994288,1672543006,1672545601,2595
3490,3710008361,3492546679,1672604454,1672604711,257
3835,3710496785,3396980894,1672687206,1672688202,996
3784,3456430614,3774705415,1672659594,1672660355,761
3916,3834963772,3701107228,1672539677,1672543003,3326
3671,3516741440,3777184389,1672581588,1672582498,910
3521,3271454397,3977148669,1672653683,1672655424,1741
3493,3760640999,3513410578,1672691656,1672692941,1285
3492,3343816795,3977148669,1672549306,1672552113,2807
3863,3480726047,3392943173,1672621498,1672623952,2454
3559,3800257590,3685681577,1672595550,1672597879,2329
3667,3500841914,3480726047,1672629632,1672632317,2685
3840,3660887799,3472312341,1672550242,1672550633,391
3827,3478114114,3246370118,1672616685,1672618915,2230
3881,3246370118,3807212280,1672690136,1672691985,1849
3434,3792274796,3777147510,1672565105,1672566383,1278
3486,3710048469,3609881958,1672655523,1672657070,1547
3913,3501786419,3516703758,1672557866,1672560237,2371
3880,3376467719,3623266256,1672602818,1672604295,1477
3623,3703383853,3520873221,1672670655,1672671473,818
3514,3370068529,3224330592,1672562328,1672563156,828
3602,3300818269,3554944414,1672581171,1672583617,2446
3775,3472312341,3715086894,1672563932,1672564487,555
3607,3710854064,3977352557,1672659410,1672662557,3147
3521,3501457103,3715619259,1672611030,1672611212,182
3572,3515466096,3201676087,1672550931,1672552208,1277
3916,3792949946,3505111292,1672668553,1672670736,2183
3536,3245232284,3779425804,1672573052,1672575958,2906
3552,3715400486,3777091903,1672570417,1672572208,1791
3798,3714670620,3891672228,1672666847,1672667757,910
3468,3493017654,3792442597,1672625708,1672628094,2386
3558,3206837348,3783520186,1672650279,1672650878,599
3727,3505437712,3283770991,1672592218,1672595526,3308
3894,3480726047,3501525100,1672638882,1672641967,3085
3792,3451691949,3533649454,1672531518,1672534375,2857
3731,3623266256,3779738691,1672569180,1672570080,900
3612,3895285664,3517358573,1672552637,1672553321,684
3773,3375449013,3669146016,1672569697,1672571383,1686
3810,3440107959,3364378127,1672571692,1672572834,1142
3829,3703798634,3783433404,1672608586,1672608660,74
3542,3609659642,3520416075,1672570063,1672573016,2953
3499,3347419520,3604589802,1672579374,1672580631,1257
3451,3273981374,3680810086,1672536604,1672538680,2076
3538,3621184108,3492546679,1672628653,1672629096,443
3822,3893912331,3513327337,1672571043,1672571618,575
3831,3836241528,3500857494,1672652505,1672655337,2832
3636,3825881598,3519282716,1672637276,1672639443,2167
3493,3514246749,3404025196,1672540515,1672541338,823
3921,3500604680,3859868849,1672569040,1672570558,1518
3640,3511442562,3902861231,1672684616,1672684717,101
3901,3791246640,3517172354,1672666782,1672667558,776
3756,3311098437,3783919913,1672540585,1672541527,942
3503,3447672935,3661903000,1672691632,1672693837,2205
3563,3609113156,3510642075,1672651544,1672654848,3304
3460,3225029895,3206837348,1672587698,1672589610,1912
3454,3611055563,3505663516,1672678657,1672681493,2836
3886,3446533960,3609881958,1672649238,1672650661,1423
3529,3776831527,3418448389,1672643978,1672645486,1508
3555,3412968120,3520416075,1672694123,1672694783,660
3482,3380130228,3931627862,1672615158,1672616035,877
3773,3701005527,3336339664,1672630393,1672631877,1484
3772,3410600350,3276269264,1672632323,1672635470,3147
3534,3478114114,3416987084,1672634681,1672635524,843
3509,3791436104,3779938251,1672646854,1672647430,576
3783,3668747074,3770676872,1672544641,1672546201,1560
3635,3853629553,3248058676,1672605493,1672608959,3466
3921,3792525861,3402385957,1672608398,1672610309,1911
3668,3783340788,3605221116,1672631393,1672633049,1656
3618,3448633776,3608232640,1672628653,1672629954,1301
3694,3902861231,3276003502,1672682541,1672684208,1667
3528,3778640261,3513065217,1672693733,1672694842,1109
3692,3500044458,3383138270,1672537615,1672540695,3080
3601,3770146716,3554186380,1672589944,1672592100,2156
3560,3201800997,3514285803,1672668625,1672669752,1127
3732,3715127070,3610358027,1672620964,1672622986,2022
3812,3783373154,3711097754,1672695623,1672696838,1215
3771,3520322124,3518653080,1672661015,1672661334,319
3714,3500857494,3289114629,1672628760,1672630312,1552
3607,3889780657,3510837901,1672543942,1672547163,3221
3921,3714120857,3885157459,1672593229,1672595387,2158
3519,3680810086,3834631333,1672578347,1672581855,3508
3908,3236354255,3792442597,1672658509,1672659222,713
3716,3689697817,3467779445,1672680259,1672682537,2278
3446,3661583097,3224968597,1672688658,1672689296,638
3834,3625174002,3533294425,1672624035,1672625391,1356
3818,3236499444,3248058676,1672641203,1672642676,1473
3906,3793743698,3511732493,1672544484,1672544939,455
3618,3311085279,3481640525,1672692311,1672695288,2977
3889,3513410578,3755915206,1672590370,1672591799,1429
3756,3714120857,3904569677,1672553374,1672553920,546
3694,3511024016,3892304880,1672693840,1672695572,1732
3483,3772391882,3916490839,1672666801,1672669511,2710
3891,3701882224,3500072204,1672557054,1672557998,944
3677,3793315718,3343816795,1672588524,1672591695,3171
3816,3739895284,3609113156,1672546595,1672547019,424
3470,3271752081,3341893384,1672678804,1672679862,1058
3876,3783520186,3667427125,1672578526,1672581402,2876
3794,3390660440,3714233826,1672685160,1672685548,388
3503,3451691949,3360813161,1672682243,1672682695,452
3636,3701823816,3520657891,1672676691,1672677277,586
3859,3618697021,3757193551,1672586170,1672589022,2852
3603,3309314379,3734451191,1672689931,1672690855,924
3806,3605221116,3703433819,1672637391,1672639528,2137
3716,3884596900,3510919821,1672650692,1672653849,3157
3911,3509756823,3272096759,1672693287,1672696139,2852
3704,3500498112,3330340793,1672565149,1672566197,1048
3874,3296462324,3512958459,1672543976,1672545504,1528
3459,3373089838,3834960360,1672622143,1672622410,267
3670,3517991730,3205923620,1672676608,1672678050,1442
3435,3791693821,3614740489,1672687787,1672691212,3425
3740,3517222913,3459681410,1672607549,1672607738,189
3455,3469254160,3276348699,1672588202,1672590927,2725
3911,3347419520,3619922891,1672647374,1672647496,122
3657,3815392801,3396980894,1672569673,1672572369,2696
3652,3408498208,3770146716,1672697449,1672697602,153
3712,3512337405,3793922324,1672625947,1672628090,2143
3577,3915162005,3834960360,1672631666,1672632917,1251
3676,3514419100,3350095157,1672634892,1672637035,2143
3785,3783136330,3716272919,1672682336,1672682979,643
3573,3244004456,3904569677,1672594980,1672598551,3571
3887,3501215099,3392520516,1672591071,1672592282,1211
3669,3756704774,3776518452,1672595043,1672598435,3392
3905,3667427125,3622357348,1672618503,1672619289,786
3618,3780769110,3711097754,1672639959,1672642807,2848
3750,3402697190,3500827202,1672649870,1672652129,2259
3660,3478114114,3780872464,1672573057,1672576517,3460
3521,3774155692,3351866415,1672586505,1672587189,684
3511,3774733620,3776831527,1672691843,1672694732,2889
3568,3373089838,3714670620,1672571308,1672574058,2750
3772,3617116290,3225636215,1672657141,1672659076,1935
3813,3667673649,3431460073,1672548473,1672550033,1560
3786,3460719322,3534566651,1672556342,1672559647,3305
3522,3500317969,3792442597,1672605243,1672607064,1821
3468,3970558632,3515402792,1672690816,1672693893,3077
3675,3932478321,3289817992,1672564467,1672567208,2741
3511,3505634634,3533188828,1672623047,1672626063,3016
3567,3236458894,3701424609,1672575558,1672578131,2573
3645,3835985172,3451691949,1672611855,1672614393,2538
3805,3225636215,3364726656,1672555428,1672557336,1908
3580,3203538212,3680810086,1672658214,1672659252,1038
3578,3226511603,3520764926,1672675525,1672676635,1110
3787,3411515369,3600876425,1672648641,1672651858,3217
3435,3480726047,3403370192,1672597763,1672600892,3129
3623,3385323994,3755496114,1672601420,1672603721,2301
3578,3372223551,3756474459,1672624131,1672625981,1850
3498,3347446226,3431502855,1672582015,1672582664,649
3841,3505178849,3517600136,1672631458,1672632421,963
3627,3760362417,3779854934,1672583050,1672584826,1776
3511,3505725706,3276003502,1672549489,1672549833,344
3631,3884596900,3461119815,1672680788,1672682534,1746
3641,3829822608,3347419520,1672688155,1672691423,3268
3542,3460719322,3515559913,1672682444,1672684328,1884
3490,3897435944,3500044458,1672540204,1672541196,992
3802,3512295534,3311085279,1672683226,1672684390,1164
3550,3760094385,3519651506,1672541144,1672544697,3553
3835,3408498208,3730071479,1672570062,1672571595,1533
3706,3632814465,3208957949,1672583688,1672585684,1996
3754,3367509761,3276217799,1672615488,1672617695,2207
3518,3621461051,3272716462,1672538329,1672538664,335
3833,3308760650,3514703118,1672560425,1672561512,1087
3859,3451726367,3622665543,1672598113,1672601025,2912
3849,3776117322,3392520516,1672642268,1672644019,1751
3689,3755404116,3463740710,1672695573,1672697075,1502
3604,3710048469,3935913584,1672568325,1672569858,1533
3836,3783919913,3514971533,1672592285,1672594885,2600
3686,3273981374,3519077659,1672539576,1672540660,1084
3857,3779532653,3772078494,1672636524,1672637812,1288
3727,3773124276,3897435944,1672643978,1672646023,2045
3503,3791436104,3701136026,1672657405,1672658017,612
3848,3730071479,3755573472,1672552212,1672555266,3054
3636,3686523546,3315703693,1672538705,1672539400,695
3650,3515559913,3793418209,1672611410,1672612816,1406
3631,3970558632,3923220461,1672690402,1672691345,943
3790,3613899351,3904867554,1672694731,1672695233,502
3518,3688220326,3732131656,1672678678,1672681195,2517
3650,3316800320,3514246749,1672657082,1672657531,449
3661,3478114114,3757630221,1672682540,1672686083,3543
3492,3518561777,3757318448,1672660627,1672661883,1256
3772,3715086894,3777330107,1672664483,1672667434,2951
3679,3202804048,3511601997,1672610206,1672612045,1839
3562,3472068734,3760651515,1672607890,1672610153,2263
3432,3370068529,3792949946,1672662661,1672662796,135
3801,3516513251,3734915241,1672701480,1672703402,1922
3515,3516489668,3891672228,1672554755,1672557740,2985
3686,3519087371,3914691363,1672666244,1672668433,2189
3691,3777485931,3559458968,1672661139,1672662583,1444
3536,3227799827,3510554314,1672638070,1672639767,1697
3597,3270697740,3306412634,1672669008,1672671268,2260
3507,3714067076,3239617320,1672623612,1672625712,2100
3482,3617489344,3463849738,1672578894,1672581564,2670
3800,3927599181,3715986185,1672655094,1672656048,954
3701,3835422146,3935913584,1672537588,1672539370,1782
3604,3757903168,3972192593,1672543617,1672547210,3593
3687,3354144091,3660887799,1672612045,1672613494,1449
3696,3780680950,3510641433,1672694907,1672697835,2928
3807,3505266860,3450969839,1672615463,1672617021,1558
3880,3518561777,3701373490,1672540509,1672541820,1311
3889,3330340793,3714666884,1672588414,1672589009,595
3712,3829864515,3890739241,1672540212,1672543034,2822
3691,3701884158,3510499038,1672699190,1672701849,2659
3436,3773572967,3533274994,1672622815,1672625736,2921
3684,3970909253,3811040565,1672700779,1672702025,1246
3919,3715400486,3770236215,1672643633,1672644450,817
3732,3510554314,3493017654,1672691502,1672693755,2253
3439,3770296583,3755158925,1672589399,1672590080,681
3543,3773572967,3505725706,1672630475,1672634046,3571
3615,3505437712,3512295534,1672654587,1672657236,2649
3681,3617116290,3689114185,1672644215,1672645314,1099
3628,3779301501,3609659642,1672615092,1672615188,96
3676,3276003502,3685681577,1672544755,1672545265,510
3705,3685681577,3519087371,1672689103,1672689599,496
3439,3289817992,3360813161,1672610384,1672612005,1621
3425,3400763927,3441703884,1672632466,1672633637,1171
3572,3392836218,3517991730,1672536948,1672537250,302
3890,3347419520,3501215099,1672569684,1672571638,1954
3654,3701136026,3631479562,1672541821,1672542537,716
3791,3439673892,3892304880,1672675744,1672675823,79
3614,3897376951,3500915665,1672662777,1672664925,2148
3655,3492546679,3803389195,1672621998,1672622579,581
3760,3497808662,3514512367,1672696736,1672697208,472
3849,3201800997,3701005527,1672698238,1672699271,1033
3638,3777330107,3778667336,1672640629,1672641765,1136
3771,3834631333,3517358573,1672701549,1672705118,3569
3597,3559731671,3899326793,1672602411,1672605704,3293
3845,3710489491,3979802715,1672581334,1672582066,732
3548,3774243020,3312998540,1672673103,1672674073,970
3603,3618808151,3686227677,1672544003,1672546152,2149
3557,3620292035,3309314379,1672540979,1672543851,2872
3849,3203538212,3770296583,1672702802,1672704667,1865
3721,3783641602,3505111292,1672625926,1672628344,2418
3590,3714120857,3440107959,1672654675,1672655977,1302
3516,3617489344,3780680950,1672568424,1672569154,730
3686,3622665543,3636329663,1672586532,1672590115,3583
3675,3495911207,3402385957,1672537719,1672539332,1613
3742,3468041839,3783373154,1672575627,1672578597,2970
3677,3451326054,3512337405,1672675595,1672679174,3579
3609,3735374579,3792745809,1672602202,1672603442,1240
3911,3757193307,3779786641,1672620765,1672621163,398
3634,3715545685,3520181148,1672538129,1672540939,2810
3794,3779656423,3224968597,1672551973,1672552051,78
3804,3736231757,3778597171,1672555385,1672556966,1581
3857,3803517637,3500525825,1672637556,1672638262,706
3428,3974674109,3773121782,1672615032,1672617403,2371
3558,3421385957,3902760230,1672572980,1672576472,3492
3639,3428725843,3716679950,1672597040,1672597795,755
3460,3970198861,3731646673,1672606316,1672608901,2585
3785,3457620713,3283770991,1672640295,1672641704,1409
3878,3369708250,3516298579,1672565068,1672568415,3347
3708,3515890966,3792538417,1672585983,1672588462,2479
3517,3793315718,3519282716,1672571042,1672571573,531
3588,3514275974,3505725706,1672577737,1672580354,2617
3835,3533747868,3208452238,1672652852,1672655450,2598
3554,3311098437,3600876425,1672545839,1672547407,1568
3440,3401793306,3505807416,1672633025,1672634312,1287
3713,3284932450,3354144091,1672553147,1672554400,1253
3528,3779438325,3757348722,1672647342,1672648540,1198
3497,3711218296,3511732493,1672678658,1672681311,2653
3844,3733558985,3618354185,1672644433,1672645556,1123
3508,3520416075,3618489670,1672681061,1672681214,153
3553,3239617320,3737112297,1672621787,1672622449,662
3818,3715854030,3389634034,1672560575,1672562756,2181
3743,3760094385,3819767045,1672593288,1672595842,2554
3527,3779639983,3336339664,1672599101,1672601050,1949
3481,3631479562,3974674109,1672636938,1672639875,2937
3455,3451691949,3776988674,1672604353,1672607322,2969
3619,3246370118,3520115090,1672670835,1672673368,2533
3581,3510554314,3891672228,1672696693,1672697718,1025
3730,3739911441,3889780657,1672605739,1672607429,1690
3539,3533423872,3793781065,1672555348,1672558619,3271
3610,3470454332,3436025562,1672700425,1672701778,1353
3507,3200308999,3889780657,1672534638,1672534994,356
3515,3311098437,3777091903,1672606291,1672608073,1782
3891,3305336154,3713768950,1672576003,1672576292,289
3598,3617304541,3200308999,1672555104,1672558310,3206
3471,3732131656,3533423872,1672597600,1672599580,1980
3470,3637313265,3776117322,1672662730,1672664308,1578
3605,3399472693,3713691388,1672676964,1672677541,577
3721,3780571086,3402697190,1672604708,1672608177,3469
3544,3468041839,3899786664,1672585169,1672586654,1485
3545,3773033649,3737112297,1672698630,1672699858,1228
3919,3512282789,3552824113,1672699862,1672703394,3532
3804,3280268483,3478114114,1672615929,1672616734,805
3579,3627368399,3554825448,1672698456,1672700663,2207
3546,3446533960,3279339278,1672574214,1672576922,2708
3458,3890739241,3520355798,1672688454,1672691625,3171
3810,3299781901,3938503547,1672669512,1672670477,965
3666,3757318448,3897435944,1672592632,1672592843,211
3901,3931627862,3756474459,1672683182,1672686073,2891
3885,3802932312,3439673892,1672538939,1672541522,2583
3526,3559731671,3757700712,1672618044,1672619864,1820
3521,3688796737,3431502855,1672537584,1672540322,2738
3769,3909094917,3971806004,1672652654,1672655517,2863
3467,3231713082,3975717896,1672637073,1672638595,1522
3822,3668747074,3517737088,1672575064,1672577299,2235
3803,3480490124,3467779445,1672552187,1672552977,790
3577,3733558985,3392520516,1672680507,1672680838,331
3766,3495911207,3229974066,1672703887,1672706358,2471
3864,3418448389,3821054646,1672693370,1672694295,925
3605,3209481722,3517462308,1672588017,1672588588,571
3548,3380982774,3812369928,1672698482,1672699894,1412
3519,3414275042,3469254160,1672550098,1672551766,1668
3536,3858172636,3823084403,1672668053,1672670902,2849
3696,3773027597,3625463628,1672540490,1672542679,2189
3642,3791436104,3272030610,1672673729,1672674782,1053
3759,3792801638,3885537225,1672646635,1672647580,945
3859,3501567772,3500044458,1672568109,1672571184,3075
3624,3520764926,3683113954,1672584985,1672588382,3397
3755,3902861231,3311049964,1672629981,1672633068,3087
3689,3518194482,3292147449,1672534187,1672537284,3097
3741,3224811762,3294747828,1672553210,1672555094,1884
3499,3500777439,3533079336,1672686133,1672686773,640
3486,3431502855,3711077927,1672609058,1672611820,2762
3762,3793583656,3305336154,1672569278,1672572026,2748
3744,3914691363,3360813161,1672677580,1672678620,1040
3858,3711218296,3776034743,1672634334,1672634595,261
3614,3803389195,3225029895,1672595660,1672596675,1015
3922,3757630221,3412968120,1672553809,1672555756,1947
3601,3800257590,3703383853,1672579959,1672581158,1199
3547,3783771827,3755573472,1672582673,1672584146,1473
3435,3710735406,3714120857,1672673697,1672674533,836
3714,3514818819,3400763927,1672597586,1672599958,2372
3738,3501281016,3928719932,1672603297,1672605392,2095
3761,3511601997,3895285664,1672683452,1672685997,2545
3719,3730071479,3414049538,1672572741,1672575271,2530
3892,3689114185,3284932450,1672643032,1672645467,2435
3513,3701247948,3231494505,1672678900,1672679990,1090
3573,3735374579,3970198861,1672687995,1672691496,3501
3632,3609933747,3517887477,1672597878,1672598786,908
3486,3625463628,3714067076,1672586335,1672587093,758
3561,3624297844,3386758279,1672673557,1672675092,1535
3875,3505283390,3501215099,1672625534,1672628404,2870
3777,3891672228,3460719322,1672634854,1672637183,2329
3582,3500208903,3887243870,1672546352,1672548331,1979
3799,3885157459,3311098437,1672551837,1672554348,2511
3864,3777814504,3912891315,1672671981,1672674103,2122
3550,3435167810,3414049538,1672585649,1672587428,1779
3708,3792949946,3520115090,1672628556,1672630013,1457
3907,3416987084,3294703680,1672653322,1672654939,1617
3428,3770468980,3500525825,1672621716,1672622183,467
3453,3779425804,3481640525,1672579506,1672580051,545
3534,3715619259,3467988782,1672631251,1672633180,1929
3707,3701322924,3893912331,1672548235,1672549376,1141
3656,3703383853,3308760650,1672635995,1672638803,2808
3758,3225631197,3792489602,1672618733,1672620593,1860
3785,3852533643,3897376951,1672615221,1672616450,1229
3608,3273981374,3625174002,1672608926,1672611891,2965
3782,3224330592,3424445495,1672644287,1672645164,877
3520,3701322924,3270056120,1672560962,1672562188,1226
3441,3208957949,3793743698,1672641292,1672644465,3173
3802,3734451191,3520578796,1672699220,1672701538,2318
3527,3480726047,3757348722,1672589337,1672590021,684
3887,3737972328,3631479562,1672633939,1672634869,930
3518,3621461051,3669146016,1672614294,1672614922,628
3887,3817428320,3310125159,1672599682,1672602187,2505
3856,3893912331,3492959689,1672607556,1672610893,3337
3519,3621461051,3518565331,1672591098,1672593990,2892
3638,3772236797,3739661856,1672546884,1672547910,1026
3693,3436025562,3514971533,1672635318,1672635922,604
3710,3208452238,3396726504,1672625794,1672628621,2827
3640,3757193307,3757075324,1672611621,1672612969,1348
3478,3515466096,3517600136,1672605584,1672608731,3147
3631,3817813340,3773572967,1672590361,1672593431,3070
3803,3760721303,3315279093,1672587725,1672591076,3351
3844,3208452238,3921648519,1672659532,1672660270,738
3476,3897134762,3791128487,1672687304,1672689139,1835
3615,3501457103,3757332128,1672573326,1672574624,1298
3673,3923220461,3923420131,1672567063,1672569843,2780
3429,3500347447,3715707380,1672651621,1672652834,1213
3749,3715400486,3511843593,1672674455,1672676301,1846
3628,3923754072,3714128600,1672686543,1672688202,1659
3429,3777694660,3512337405,1672673516,1672675491,1975
3759,3351866415,3897456874,1672576026,1672576156,130
3918,3505481368,3511791953,1672654048,1672655065,1017
3692,3715127070,3613899351,1672598306,1672599136,830
3882,3276269264,3701823816,1672539011,1672542507,3496
3730,3534175249,3839245934,1672599139,1672601559,2420
3703,3448875382,3618354185,1672651494,1672653975,2481
3476,3688220326,3930242012,1672623926,1672626353,2427
3730,3836241528,3354144091,1672587368,1672587696,328
3650,3336339664,3793583656,1672618121,1672619240,1119
3832,3409114719,3927403123,1672614931,1672616670,1739
3714,3334993594,3447672935,1672568710,1672570009,1299
3913,3971806004,3512882178,1672645507,1672648045,2538
3517,3514512367,3715707380,1672663341,1672666026,2685
3472,3935399379,3824215187,1672618625,1672620304,1679
3645,3225631197,3701005527,1672692385,1672693228,843
3463,3760364383,3300818269,1672535969,1672536305,336
3506,3428027649,3512379024,1672691665,1672692547,882
3831,3510837901,3902760230,1672585172,1672587583,2411
3817,3274831810,3299125059,1672663419,1672665660,2241
3716,3779938251,3774243020,1672660687,1672663049,2362
3582,3293835352,3817428320,1672674816,1672675323,507
3740,3457620713,3513041785,1672583767,1672585548,1781
3800,3414049538,3384068080,1672638174,1672639983,1809
3871,3512946768,3357689359,1672636036,1672636391,355
3815,3852533643,3421385957,1672685209,1672686899,1690
3446,3244004456,3710489491,1672540213,1672540369,156
3813,3371455553,3533188828,1672680124,1672681231,1107
3559,3383138270,3793740407,1672651042,1672651829,787
3727,3780909839,3703139663,1672616821,1672618176,1355
3544,3240394404,3716628503,1672538023,1672540616,2593
3474,3703396825,3509764635,1672653549,1672655951,2402
3722,3780253901,3500709774,1672620783,1672623259,2476
3592,3834960360,3515525630,1672541095,1672541580,485
3652,3818575661,3241914067,1672653179,1672655802,2623
3886,3513296868,3462158237,1672702655,1672702770,115
3569,3517687662,3279475486,1672698613,1672699130,517
3764,3900945856,3836241528,1672643913,1672645676,1763
3674,3449639012,3384583385,1672663334,1672663469,135
3830,3783340788,3448633776,1672657483,1672661041,3558
3567,3551376095,3514324011,1672592973,1672595875,2902
3885,3505179890,3636329663,1672661468,1672663192,1724
3640,3623266256,3518565331,1672686794,1672689637,2843
3489,3688490530,3776034743,1672558701,1672559007,306
3764,3459681410,3735374579,1672622670,1672624902,2232
3478,3889780657,3505807416,1672691108,1672692975,1867
3783,3208452238,3897134762,1672647084,1672649135,2051
3723,3680810086,3519028898,1672658076,1672660074,1998
3811,3682133690,3624297844,1672646906,1672647733,827
3863,3711812325,3463849738,1672651819,1672655209,3390
3441,3390660440,3661447322,1672580597,1672580869,272
3446,3688220326,3209526819,1672531836,1672531941,105
3455,3703383853,3417191856,1672586717,1672588855,2138
3809,3613581796,3760263530,1672659800,1672660369,569
3578,3620292035,3448875382,1672634401,1672636762,2361
3510,3755915206,3710048469,1672672098,1672672174,76
3802,3611055563,3499217428,1672703486,1672704689,1203
3560,3714067076,3316800320,1672625623,1672628978,3355
3841,3510798825,3777485931,1672633546,1672635625,2079
3529,3462636434,3279475486,1672600942,1672601800,858
3439,3447672935,3664943873,1672593529,1672595631,2102
3918,3440137407,3380767040,1672674574,1672675335,761
3503,3915162005,3231494505,1672535758,1672538392,2634
3800,3220031931,3932478321,1672559130,1672560984,1854
3749,3701136026,3505266860,1672696307,1672699375,3068
3642,3428027649,3905899155,1672586915,1672589057,2142
3812,3703798634,3519651506,1672695314,1672698522,3208
3922,3920497528,3777330107,1672539238,1672539579,341
3741,3778640261,3533228966,1672650499,1672651809,1310
3452,3757294769,3208452238,1672568227,1672570362,2135
3862,3510964997,3839245934,1672688534,1672690513,1979
3627,3310039260,3899786664,1672589444,1672589652,208
3775,3241914067,3774243020,1672658087,1672660649,2562
3895,3760645796,3299443125,1672534300,1672535052,752
3755,3760645796,3512379024,1672619890,1672622256,2366
3591,3774718695,3308760650,1672598177,1672600608,2431
3718,3554825448,3684523966,1672646927,1672648829,1902
3599,3779892400,3625174002,1672580940,1672581363,423
3816,3716628503,3408430195,1672656037,1672657026,989
3562,3300818269,3715974659,1672684127,1672687332,3205
3609,3757318448,3337322736,1672663276,1672664030,754
3871,3715974659,3514324011,1672672482,1672675976,3494
3500,3367971170,3714678331,1672599552,1672602262,2710
3766,3298151889,3371455553,1672653032,1672655859,2827
3694,3238288884,3417679834,1672532778,1672534431,1653
3440,3713163045,3276348699,1672682400,1672684166,1766
3790,3369708250,3515402792,1672653135,1672656571,3436
3871,3534175249,3608855425,1672631114,1672634481,3367
3727,3367971170,3738026330,1672653201,1672656433,3232
3796,3755222916,3760721303,1672617563,1672619239,1676
3639,3303410628,3246370118,1672696502,1672698874,2372
3528,3490029863,3520416075,1672662149,1672662625,476
3700,3229822507,3514956366,1672543025,1672543979,954
3905,3209526819,3384583385,1672564474,1672565496,1022
3799,3401793306,3512800570,1672557208,1672557994,786
3651,3933894942,3520115090,1672621298,1672622336,1038
3721,3299443125,3294747828,1672632505,1672634894,2389
3700,3632814465,3501384020,1672641073,1672642351,1278
3588,3232208416,3683113954,1672585707,1672588322,2615
3802,3276269264,3715127070,1672559577,1672559801,224
3738,3533004959,3500857494,1672564870,1672567662,2792
3622,3485540729,3505154885,1672616276,1672618738,2462
3722,3639050419,3306175858,1672543571,1672546789,3218
3799,3517737088,3293835352,1672574264,1672577854,3590
3604,3384068080,3780680950,1672547530,1672549574,2044
3492,3512499658,3615113018,1672628019,1672628456,437
3874,3735374579,3610870949,1672631610,1672634381,2771
3618,3505437712,3783163143,1672569087,1672570525,1438
3575,3500208903,3510919821,1672553686,1672556875,3189
3912,3441348818,3316800320,1672541775,1672542503,728
3713,3897134762,3270042456,1672641796,1672643706,1910
3664,3200543880,3783136330,1672583249,1672586413,3164
3618,3622357348,3853629553,1672615870,1672617622,1752
3513,3773837847,3770624662,1672645819,1672647152,1333
3879,3928719932,3607768197,1672669388,1672672914,3526
3877,3622357348,3791246640,1672654473,1672656782,2309
3869,3505228454,3493017654,1672662615,1672665928,3313
3502,3780909839,3436257398,1672548215,1672549397,1182
3841,3505847380,3701882224,1672585845,1672589246,3401
3482,3285204083,3623266256,1672679062,1672680644,1582
3857,3300511067,3760721303,1672603113,1672605724,2611
3537,3491684096,3481640525,1672644515,1672647099,2584
3698,3390660440,3632814465,1672646145,1672648928,2783
3834,3364726656,3615939504,1672546960,1672548209,1249
3641,3510641433,3205985903,1672654880,1672658072,3192
3589,3399472693,3885121158,1672638450,1672640094,1644
3715,3511883730,3414049538,1672670378,1672673978,3600
3886,3402697190,3710735406,1672674779,1672677894,3115
3527,3492959689,3713691388,1672590736,1672593256,2520
3852,3803517637,3533274994,1672595766,1672596503,737
3548,3791436104,3510798825,1672536168,1672536968,800
3550,3475349791,3713979100,1672679936,1672681430,1494
3781,3757323954,3631479562,1672692829,1672695530,2701
3846,3559731671,3613416045,1672618351,1672619916,1565
3763,3337322736,3516903528,1672552100,1672553276,1176
3731,3757323954,3710008361,1672587400,1672590224,2824
3843,3715854030,3772765746,1672535064,1672537277,2213
3901,3386758279,3777184389,1672544774,1672546588,1814
3860,3480100311,3783373154,1672618155,1672618234,79
3899,3829822608,3517991730,1672654910,1672658225,3315
3503,3305722859,3467988782,1672590711,1672590902,191
3522,3501567772,3517737088,1672623855,1672624939,1084
3921,3757193551,3515466096,1672664647,1672667130,2483
3720,3773027597,3514275974,1672665526,1672665811,285
3771,3934064792,3833217041,1672602869,1672605908,3039
3653,3792745809,3783136330,1672691917,1672695049,3132
3680,3627368399,3713517039,1672646938,1672650487,3549
3897,3783928182,3792801638,1672684381,1672684507,126
3554,3630353876,3783641602,1672614294,1672616159,1865
3604,3490214516,3438078818,1672630918,1672633690,2772
3642,3349739136,3905196766,1672664604,1672664677,73
3722,3533079336,3609881958,1672592074,1672595030,2956
3520,3792538417,3791796585,1672614615,1672617105,2490
3593,3609881958,3511442562,1672615209,1672616649,1440
3720,3384583385,3294747828,1672623688,1672624363,675
3669,3510187271,3755992176,1672604880,1672606485,1605
3656,3511317276,3288224595,1672538718,1672541283,2565
3653,3298151889,3808136029,1672544616,1672546057,1441
3713,3770624662,3760362417,1672687031,1672688413,1382
3471,3639050419,3776244398,1672674503,1672674614,111
3578,3470454332,3533079336,1672677996,1672680293,2297
3876,3610358027,3459681410,1672657281,1672657820,539
3447,3351866415,3511883730,1672569821,1672571924,2103
3514,3520578796,3520873221,1672538135,1672538395,260
3909,3928719932,3905196766,1672660267,1672660790,523
3786,3710854064,3793781065,1672623661,1672627216,3555
3759,3778899160,3711006062,1672687158,1672688313,1155
3669,3979784676,3511843593,1672579001,1672581411,2410
3508,3554825448,3714120857,1672626861,1672629051,2190
3633,3774178201,3298151889,1672589810,1672592051,2241
3696,3472068734,3701247948,1672634480,1672637670,3190
3756,3850911686,3559458968,1672614666,1672615510,844
3893,3716679950,3505228454,1672638843,1672639206,363
3580,3757630221,3773124276,1672667803,1672669159,1356
3662,3711734586,3512502036,1672576078,1672576765,687
3555,3819767045,3360616538,1672572743,1672575586,2843
3554,3512800570,3614740489,1672616394,1672617587,1193
3673,3552824113,3783771827,1672681870,1672682643,773
3719,3398731252,3635169815,1672678065,1672678137,72
3580,3923420131,3224330592,1672657191,1672659348,2157
3859,3505521218,3755496114,1672672637,1672673027,390
3468,3739661856,3760263530,1672699963,1672703195,3232
3512,3401940259,3783163143,1672557963,1672560126,2163
3427,3500737582,3618354185,1672599622,1672602156,2534
3866,3497808662,3305722859,1672702642,1672705064,2422
3575,3621790707,3380767040,1672566788,1672568139,1351
3917,3774790271,3513853403,1672555627,1672558713,3086
3532,3713589994,3376467719,1672582927,1672584728,1801
3452,3512499658,3757383891,1672621111,1672623586,2475
3476,3713163045,3776831527,1672532526,1672534260,1734
3848,3279475486,3431502855,1672560075,1672563219,3144
3471,3417679834,3239617320,1672692340,1672693453,1113
3666,3384583385,3757318448,1672662614,1672665669,3055
3568,3793883863,3500827202,1672638964,1672640816,1852
3457,3627368399,3636329663,1672540877,1672542454,1577
3650,3519087371,3887243870,1672669491,1672671747,2256
3717,3900276517,3780872464,1672688947,1672692355,3408
3531,3300511067,3791613604,1672656689,1672658083,1394
3509,3689697817,3513295938,1672652321,1672653470,1149
3653,3738026330,3534543776,1672539422,1672542226,2804
3640,3757294769,3823084403,1672595362,1672598011,2649
3889,3880926355,3449639012,1672599245,1672602451,3206
3638,3613581796,3715400486,1672595652,1672598403,2751
3869,3509756823,3711218296,1672618396,1672619113,717
3719,3246370118,3885537225,1672581366,1672583931,2565
3826,3479851674,3757193551,1672671834,1672673345,1511
3877,3501786419,3505266860,1672606625,1672606869,244
3457,3757294769,3437286517,1672553150,1672555999,2849
3618,3241790910,3618697021,1672626570,1672629914,3344
3575,3739895284,3294703680,1672654062,1672654725,663
3849,3778667336,3534566651,1672631159,1672632764,1605
3481,3620292035,3792442597,1672669753,1672671414,1661
3693,3927599181,3271752081,1672693022,1672693909,887
3673,3519850727,3357689359,1672626375,1672627816,1441
3888,3513065217,3714670620,1672538397,1672538670,273
3498,3274906650,3499217428,1672623262,1672625711,2449
3468,3885121158,3205985903,1672700579,1672701808,1229
3447,3501525100,3501525100,1672672454,1672673802,1348
3735,3780322355,3513296868,1672680210,1672681606,1396
3795,3505228454,3776117322,1672636626,1672639874,3248
3847,3618808151,3491469603,1672561498,1672564687,3189
3600,3349856820,3518565331,1672688626,1672692053,3427
3435,3512499658,3780834916,1672623192,1672625199,2007
3802,3394297564,3510798825,1672630744,1672632511,1767
3679,3685681577,3778597171,1672594280,1672597129,2849
3867,3774907131,3774243020,1672684696,1672687516,2820
3915,3225029895,3511005395,1672675660,1672678317,2657
3611,3757630221,3396726504,1672663279,1672666001,2722
3800,3360069849,3336339664,1672700491,1672701028,537
3723,3392943173,3618489670,1672623814,1672626748,2934
3666,3780769110,3516903528,1672621981,1672622418,437
3803,3791246640,3757348722,1672654460,1672656814,2354
3914,3714678331,3792442597,1672699255,1672701054,1799
3710,3509366311,3501215099,1672540992,1672543847,2855
3670,3780472203,3738026330,1672662725,1672663179,454
3472,3338390596,3520322124,1672637915,1672639845,1930
3914,3904867554,3369708250,1672695922,1672697431,1509
3537,3491469603,3509366311,1672669553,1672672858,3305
3847,3833217041,3279242917,1672576526,1672579910,3384
3801,3906536154,3739911441,1672535760,1672537809,2049
3730,3491469603,3510187271,1672620857,1672622515,1658
3550,3533079336,3755992176,1672647500,1672650282,2782
3919,3890739241,3925979970,1672540537,1672541689,1152
3631,3333918941,3893912331,1672703022,1672704182,1160
3810,3516298579,3462273042,1672639219,1672641766,2547
3556,3303410628,3428725843,1672695260,1672698636,3376
3896,3514324011,3791106564,1672665636,1672667713,2077
3704,3488686442,3209481722,1672545826,1672546977,1151
3517,3970198861,3308760650,1672577826,1672578214,388
3642,3779301501,3513018485,1672680325,1672682510,2185
3652,3408430195,3513296868,1672619831,1672621223,1392
3718,3283492940,3774155692,1672554273,1672555723,1450
3726,3554825448,3760362417,1672566151,1672569731,3580
3610,3755404116,3774641380,1672534992,1672536747,1755
3693,3272716462,3791441520,1672664495,1672666163,1668
3680,3711919537,3620292035,1672604594,1672607508,2914
3621,3793922324,3739661856,1672614569,1672617951,3382
3659,3668414677,3802932312,1672654620,1672656854,2234
3597,3509893027,3389634034,1672579688,1672582923,3235
3592,3779786641,3510187271,1672573399,1672574692,1293
3787,3791796585,3923754072,1672549087,1672549467,380
3847,3620292035,3760263530,1672538439,1672540411,1972
3605,3402385957,3490029863,1672592609,1672594218,1609
3696,3202141727,3615115210,1672587315,1672589909,2594
3561,3519909393,3351866415,1672591070,1672593390,2320
3921,3509483172,3778597171,1672534579,1672534847,268
3671,3501215099,3231713082,1672547373,1672549237,1864
3703,3421385957,3902625986,1672536814,1672538541,1727
3852,3490214516,3688220326,1672588378,1672590994,2616
3865,3791436104,3273981374,1672623951,1672624602,651
3751,3511317276,3833217041,1672555905,1672557306,1401
3844,3916490839,3893912331,1672646221,1672649810,3589
3820,3416987084,3518565331,1672571289,1672573109,1820
3584,3793883863,3791693821,1672647682,1672648119,437
3915,3518229776,3480991549,1672618946,1672621312,2366
3713,3734451191,3500915665,1672676121,1672677783,1662
3517,3915162005,3892304880,1672697972,1672698720,748
3582,3739911441,3512946768,1672597118,1672597655,537
3628,3499217428,3737972328,1672668767,1672670533,1766
3769,3682133690,3475349791,1672630751,1672633172,2421
3462,3399518841,3885121158,1672549687,1672551465,1778
3645,3778899160,3505634634,1672616965,1672618306,1341
3583,3756789525,3519087371,1672605671,1672605842,171
3522,3711812325,3739911441,1672639779,1672640102,323
3532,3713691388,3839245934,1672703352,1672706553,3201
3465,3792442597,3914691363,1672641071,1672644384,3313
3620,3505437712,3778926763,1672659014,1672661083,2069
3492,3226511603,3914691363,1672650681,1672653529,2848
3709,3551389192,3305722859,1672621645,1672622313,668
3451,3389634034,3367111751,1672665747,1672667553,1806
3597,3299443125,3793740407,1672536937,1672539347,2410
3598,3776831527,3793883863,1672682189,1672683217,1028
3921,3779425804,3715443333,1672544788,1672548025,3237
3800,3510919821,3779438325,1672560806,1672563276,2470
3642,3505995057,3517881647,1672606187,1672608748,2561
3918,3739661856,3224968597,1672682281,1672685331,3050
3793,3511442562,3783928182,1672560792,1672561608,816
3875,3661447322,3512830734,1672613364,1672613858,494
3682,3480490124,3714128600,1672549704,1672550840,1136
3780,3900276517,3783163143,1672683016,1672684276,1260
3590,3792538417,3475349791,1672695596,1672696364,768
3809,3623266256,3519850727,1672568968,1672571277,2309
3679,3701884158,3519850727,1672593428,1672594831,1403
3582,3701373490,3516489668,1672683450,1672685143,1693
3529,3757903168,3513081354,1672623182,1672625277,2095
3476,3755496114,3609659642,1672677135,1672677314,179
3544,3460719322,3661583097,1672669851,1672670584,733
3713,3779613523,3669146016,1672672334,1672674304,1970
3504,3780872464,3613338363,1672701327,1672702062,735
3658,3783801141,3475349791,1672548584,1672549752,1168
3444,3500044458,3923420131,1672575045,1672576608,1563
3891,3834960360,3451326054,1672640111,1672641677,1566
3850,3755992176,3834963772,1672596353,1672597968,1615
3739,3793418209,3935399379,1672623286,1672623973,687
3580,3701424609,3783641602,1672546286,1672546763,477
3826,3772391882,3773913680,1672657789,1672661156,3367
3770,3414940786,3449333754,1672598220,1672600715,2495
3890,3500044458,3305336154,1672626714,1672629137,2423
3711,3441703884,3777037426,1672604612,1672607414,2802
3912,3772236797,3229974066,1672642471,1672645954,3483
3531,3703139663,3735374579,1672694196,1672695900,1704
3643,3760924079,3604589802,1672555901,1672558519,2618
3676,3792020993,3487875183,1672540322,1672542241,1919
3844,3684523966,3715400486,1672687929,1672690626,2697
3781,3927403123,3772391882,1672593870,1672594320,450
3536,3792949946,3792745809,1672601667,1672604676,3009
3827,3512502036,3920497528,1672691080,1672693274,2194
3809,3735374579,3501384020,1672567897,1672568062,165
3635,3408430195,3485540729,1672539660,1672542037,2377
3853,3610870949,3615087943,1672600771,1672603339,2568
3821,3373089838,3613899351,1672536297,1672536595,298
3673,3485540729,3367509761,1672603503,1672606389,2886
3669,3715986185,3770468980,1672684892,1672687236,2344
3555,3821054646,3915162005,1672601164,1672603281,2117
3755,3607882826,3897376951,1672657707,1672661160,3453
3462,3500915908,3791441520,1672577379,1672580782,3403
3629,3203538212,3793418209,1672662959,1672663813,854
3646,3244004456,3972083617,1672561555,1672562814,1259
3654,3493017654,3713784974,1672612096,1672614330,2234
3505,3500525825,3732131656,1672606139,1672607667,1528
3804,3834963772,3736231757,1672665703,1672666105,402
3893,3615688740,3519282716,1672535705,1672538413,2708
3738,3467779445,3703396825,1672541646,1672543640,1994
3775,3711218296,3715400486,1672635465,1672636466,1001
3660,3360616538,3713784974,1672634198,1672636260,2062
3880,3914691363,3455018347,1672537874,1672541013,3139
3529,3300229945,3715854030,1672628626,1672630535,1909
3562,3439673892,3897456874,1672560949,1672562983,2034
3681,3701823816,3480100311,1672599460,1672602259,2799
3491,3373089838,3777814504,1672671967,1672673042,1075
3890,3836241528,3792525861,1672600855,1672603338,2483
3780,3902760230,3613581796,1672657634,1672658602,968
3527,3505228454,3885537225,1672696423,1672697746,1323
3630,3205985903,3511732493,1672630819,1672633010,2191
3608,3622357348,3808136029,1672608145,1672610098,1953
3843,3688490530,3224811762,1672688750,1672691919,3169
3433,3315703693,3755233658,1672626630,1672629654,3024
3888,3362641275,3386758279,1672581294,1672581495,201
3475,3467988782,3334993594,1672624614,1672627706,3092
3594,3226024417,3859868849,1672659867,1672662336,2469
3608,3510642075,3335694356,1672641374,1672644728,3354
3674,3777624586,3410538749,1672537988,1672538897,909
3756,3710735406,3385323994,1672668774,1672672093,3319
3887,3360813161,3511024016,1672698511,1672699090,579
3841,3972192593,3304971369,1672602535,1672605905,3370
3549,3880926355,3613581796,1672532107,1672534934,2827
3622,3519077659,3701884158,1672534396,1672537304,2908
3733,3711000597,3608855425,1672676251,1672677022,771
3854,3783136330,3500613493,1672557865,1672560816,2951
3699,3554944414,3500709774,1672663065,1672666335,3270
3852,3462158237,3884596900,1672540205,1672542703,2498
3567,3336339664,3533747868,1672703785,1672707044,3259
3838,3792014516,3817813340,1672611233,1672611861,628
3647,3779938251,3232208416,1672586466,1672588834,2368
3857,3975717896,3497671225,1672677172,1672678386,1214
3579,3533294425,3533649454,1672658396,1672660177,1781
3671,3783433404,3520322124,1672697596,1672699815,2219
3643,3517991730,3373089838,1672668954,1672670035,1081
3506,3401940259,3776559988,1672625146,1672628269,3123
3489,3622357348,3772078494,1672616744,1672619828,3084
3917,3389634034,3480726047,1672653296,1672654328,1032
3604,3416987084,3611055563,1672668897,1672670563,1666
3790,3777624586,3783373154,1672535357,1672537500,2143
3462,3710048469,3520657891,1672615470,1672618473,3003
3583,3394297564,3824641227,1672694514,1672695154,640
3424,3925979970,3613416045,1672673746,1672674848,1102
3466,3384068080,3757863420,1672592488,1672593814,1326
3772,3880926355,3533368789,1672555303,1672555906,603
3825,3515525630,3520657891,1672613239,1672613661,422
3558,3887243870,3336339664,1672667821,1672671311,3490
3888,3783928182,3533228966,1672556866,1672559338,2472
3444,3410600350,3533004959,1672555495,1672556634,1139
3746,3519416013,3338083680,1672555682,1672556862,1180
3568,3701884158,3510767239,1672644869,1672645395,526
3468,3756789525,3511005395,1672612896,1672614516,1620
3658,3371455553,3519087371,1672688712,1672689878,1166
3443,3519077659,3757193551,1672609092,1672610731,1639
3687,3902760230,3755992176,1672588020,1672589089,1069
3769,3739154408,3505228454,1672654428,1672655833,1405
3716,3500302272,3970198861,1672679726,1672682457,2731
3473,3779938251,3501786419,1672582712,1672585293,2581
3572,3715974659,3270056120,1672686504,1672689531,3027
3740,3500109249,3667673649,1672603723,1672604676,953
3891,3497808662,3703383853,1672575840,1672575902,62
3545,3779301501,3208452238,1672624197,1672625429,1232
3807,3500044458,3792014516,1672682931,1672683276,345
3762,3715086894,3713561276,1672551363,1672552850,1487
3588,3757318448,3620292035,1672603027,1672604522,1495
3598,3300979975,3615688740,1672572246,1672572865,619
3497,3713979100,3312998540,1672532802,1672536280,3478
3847,3902760230,3885537225,1672701115,1672701993,878
3712,3312998540,3791046864,1672578371,1672579547,1176
3787,3497671225,3715127070,1672648034,1672649598,1564
3734,3469254160,3792949946,1672701347,1672704190,2843
3678,3443357683,3972083617,1672674195,1672677164,2969
3793,3225636215,3447672935,1672544690,1672547928,3238
3560,3364726656,3315703693,1672682434,1672685771,3337
3593,3836241528,3312998540,1672555394,1672556189,795
3543,3620292035,3492959689,1672703015,1672704274,1259
3589,3665998641,3552824113,1672679153,1672679858,705
3485,3520416075,3757193307,1672689465,1672689593,128
3450,3505521218,3533423872,1672685962,1672687353,1391
3676,3927599181,3755496114,1672556757,1672558157,1400
3567,3760364383,3823084403,1672603758,1672604820,1062
3899,3736231757,3783615982,1672549596,1672552630,3034
3897,3515559913,3510818674,1672639672,1672639987,315
3496,3454277788,3382733096,1672644573,1672647477,2904
3775,3909094917,3776084820,1672698176,1672698850,674
3561,3710735406,3424660806,1672670233,1672671361,1128
3578,3202804048,3299443125,1672566841,1672568060,1219
3790,3780322355,3773902805,1672653794,1672654139,345
3507,3757323954,3500737582,1672636165,1672639759,3594
3459,3915162005,3534829213,1672589007,1672589483,476
3770,3831586487,3493017654,1672580487,1672583532,3045
3813,3505481368,3928511283,1672567611,1672567856,245
3686,3615087943,3617304541,1672665418,1672668061,2643
3505,3711734586,3505437712,1672657285,1672659770,2485
3430,3517737088,3515439826,1672576860,1672579360,2500
3564,3512392431,3485540729,1672587419,1672590431,3012
3803,3519077659,3469254160,1672537417,1672539002,1585
3728,3271454397,3668414677,1672550512,1672552863,2351
3447,3456430614,3757318448,1672656220,1672658461,2241
3897,3713589994,3513545422,1672661456,1672663880,2424
3618,3357864626,3793883863,1672557860,1672560131,2271
3717,3610358027,3897456874,1672558057,1672560113,2056
3450,3793743698,3633735593,1672678454,1672681682,3228
3665,3384583385,3337362061,1672645781,1672646083,302
3722,3773009828,3779854934,1672572565,1672573371,806
3547,3516513251,3304971369,1672557870,1672561331,3461
3914,3778899160,3500857494,1672661638,1672662443,805
3629,3858172636,3905899155,1672598054,1672599196,1142
3712,3777814504,3609659642,1672614145,1672614212,67
3530,3298151889,3517358573,1672679363,1672681028,1665
3555,3793740407,3760651515,1672639808,1672641009,1201
3454,3472068734,3511601997,1672583034,1672584480,1446
3439,3520873221,3311085279,1672542800,1672545585,2785
3437,3499217428,3500072204,1672616067,1672619274,3207
3844,3912891315,3272716462,1672567396,1672570574,3178
3881,3500857494,3424445495,1672552387,1672553824,1437
3881,3311049964,3385323994,1672538856,1672542427,3571
3578,3371455553,3518653080,1672657445,1672658272,827
3486,3343132529,3241914067,1672617489,1672618610,1121
3614,3732131656,3517172354,1672695597,1672696545,948
3856,3500317969,3226511603,1672653222,1672653635,413
3826,3739661856,3613338363,1672614345,1672616288,1943
3674,3510919821,3511317276,1672548049,1672551497,3448
3795,3385323994,3299781901,1672698302,1672701715,3413
3737,3501384020,3505521218,1672630752,1672632597,1845
3462,3516513251,3510964997,1672556552,1672556889,337
3755,3500604680,3770624662,1672538769,1672541284,2515
3714,3834963772,3435116799,1672642322,1672643850,1528
3537,3334974375,3774031303,1672664956,1672666591,1635
3448,3468041839,3304971369,1672550705,1672552525,1820
3628,3380982774,3932478321,1672597988,1672598213,225
3602,3760094385,3793583656,1672671165,1672672503,1338
3472,3776831527,3435167810,1672586409,1672589766,3357
3789,3238288884,3500672156,1672587037,1672589243,2206
3722,3533929349,3815250107,1672687607,1672688744,1137
3559,3334647380,3415833929,1672605474,1672608735,3261
3435,3821054646,3517687662,1672632166,1672633843,1677
3478,3801645328,3898314440,1672658570,1672661273,2703
3433,3716110860,3309314379,1672690597,1672693008,2411
3539,3826238375,3713589994,1672666071,1672668319,2248
3611,3617489344,3776988674,1672541330,1672543234,1904
3696,3735374579,3777485931,1672659221,1672661634,2413
3646,3368283077,3757193551,1672669133,1672671726,2593
3725,3713784974,3815250107,1672677471,1672677730,259
3752,3411688875,3480991549,1672687600,1672689513,1913
3750,3621683102,3734451191,1672640832,1672643683,2851
3782,3201800997,3779465522,1672559444,1672562695,3251
3747,3468041839,3462636434,1672619819,1672620393,574
3574,3800257590,3308760650,1672609160,1672609780,620
3464,3760362417,3608232640,1672568315,1672571852,3537
3700,3205985903,3205923620,1672633642,1672634064,422
3593,3306175858,3349739136,1672630630,1672634205,3575
3557,3511791953,3715127070,1672693833,1672695011,1178
3441,3505888598,3272030610,1672541959,1672543538,1579
3813,3778899160,3617489344,1672606219,1672609222,3003
3653,3514334067,3512337405,1672584468,1672584837,369
3791,3279473441,3311098437,1672660779,1672663041,2262
3533,3711077927,3715400486,1672657083,1672657242,159
3550,3394401087,3904412440,1672533319,1672535087,1768
3680,3927599181,3512958459,1672679011,1672681795,2784
3475,3923754072,3460719322,1672576867,1672578703,1836
3430,3517222913,3716679950,1672572108,1672572617,509
3899,3660063072,3511843593,1672533307,1672534971,1664
3470,3625174002,3501567772,1672561154,1672561610,456
3591,3512830734,3351866415,1672555192,1672555266,74
3685,3500604680,3716628503,1672686389,1672689868,3479
3747,3778640261,3977148669,1672654612,1672657170,2558
3606,3779425804,3512383699,1672561370,1672564796,3426
3449,3715545685,3757294769,1672624005,1672626196,2191
3838,3970909253,3424445495,1672571557,1672572252,695
3655,3362641275,3533368789,1672676307,1672679578,3271
3583,3400069268,3457960571,1672688390,1672690619,2229
3699,3516298579,3509483172,1672610748,1672610850,102
3602,3979784676,3715854030,1672572659,1672574394,1735
3475,3364378127,3374183227,1672691584,1672695166,3582
3490,3376467719,3839245934,1672559802,1672559972,170
3816,3625463628,3904867554,1672687722,1672689925,2203
3644,3972083617,3703139663,1672633374,1672635014,1640
3468,3627368399,3279339278,1672683559,1672686036,2477
3756,3703383853,3310125159,1672645213,1672646962,1749
3758,3299443125,3490029863,1672613463,1672616156,2693
3894,3792538417,3667427125,1672671881,1672675254,3373
3902,3520991398,3519077659,1672635420,1672637554,2134
3866,3236354255,3779425804,1672637420,1672637645,225
3569,3979802715,3902625986,1672545288,1672546114,826
3568,3515439826,3451726367,1672588441,1672590376,1935
3799,3480726047,3396980894,1672536417,1672538027,1610
3510,3304971369,3714233826,1672620144,1672623376,3232
3915,3885121158,3713941638,1672643346,1672643894,548
3601,3734915241,3500915665,1672542978,1672543538,560
3631,3893912331,3505663516,1672552222,1672555366,3144
3539,3615737355,3370068529,1672614757,1672615431,674
3622,3812534508,3551389192,1672664396,1672667488,3092
3503,3714670620,3777330107,1672667191,1672670782,3591
3464,3824215187,3519651506,1672624365,1672624876,511
3597,3834960360,3613206049,1672550215,1672551134,919
3886,3633735593,3938389661,1672646926,1672647682,756
3546,3513295938,3511732493,1672702321,1672702762,441
3513,3900276517,3511883730,1672634965,1672635813,848
3784,3505481368,3512392431,1672567605,1672571021,3416
3759,3512946768,3756704774,1672631541,1672634347,2806
3866,3512502036,3411515369,1672626888,1672627640,752
3586,3500341755,3772236797,1672544945,1672547189,2244
3642,3518561777,3520322124,1672643759,1672643966,207
3757,3757294769,3225029895,1672566608,1672569788,3180
3918,3935913584,3689697817,1672609178,1672611247,2069
3538,3793407963,3667673649,1672692480,1672694680,2200
3769,3793418209,3897134762,1672534919,1672535457,538
3640,3714067076,3505402439,1672573566,1672575615,2049
3811,3371455553,3713561276,1672643988,1672646379,2391
3512,3701823816,3230135532,1672656560,1672658400,1840
3628,3714185969,3633735593,1672553137,1672554651,1514
3555,3228888030,3513018485,1672569318,1672570965,1647
3474,3710562338,3554944414,1672630457,1672631032,575
3804,3710315160,3900898992,1672580517,1672584087,3570
3490,3367509761,3500613459,1672676678,1672680100,3422
3444,3974674109,3756789525,1672635088,1672638499,3411
3868,3470454332,3668747074,1672566231,1672567622,1391
3629,3608922867,3622665543,1672618736,1672620701,1965
3596,3711097754,3716679950,1672652805,1672653588,783
3889,3500827202,3630353876,1672628262,1672630914,2652
3576,3977148669,3517737088,1672564690,1672565976,1286
3888,3490029863,3272096759,1672640861,1672644385,3524
3609,3904569677,3514275974,1672640458,1672643918,3460
3719,3755848152,3459681410,1672622995,1672624175,1180
3688,3441703884,3272096759,1672698964,1672702003,3039
3650,3505725706,3227799827,1672577046,1672579016,1970
3914,3778134418,3515439826,1672664335,1672664584,249
3675,3792389522,3660063072,1672609180,1672609327,147
3771,3517991730,3308760650,1672535419,1672538877,3458
3577,3343132529,3456430614,1672582607,1672584178,1571
3872,3224968597,3774155692,1672603312,1672604183,871
3562,3631479562,3792020993,1672605718,1672609280,3562
3571,3637313265,3501786419,1672665983,1672666224,241
3515,3779438325,3224330592,1672590171,1672592886,2715
3695,3618808151,3336339664,1672656736,1672656887,151
3559,3770704999,3202804048,1672679354,1672682041,2687
3653,3774705415,3205923620,1672596236,1672597963,1727
3705,3462158237,3779301501,1672615501,1672615602,101
3734,3792546035,3514246749,1672679600,1672682518,2918
3531,3793315718,3450286949,1672624699,1672626890,2191
3724,3783147088,3605221116,1672637484,1672638621,1137
3501,3551389192,3682133690,1672579275,1672582536,3261
3500,3390660440,3517697722,1672575497,1672576406,909
3900,3372223551,3710315160,1672565611,1672566094,483
3600,3514308235,3533228966,1672546045,1672546710,665
3480,3739911441,3793935736,1672678346,1672680337,1991
3632,3488686442,3505888598,1672601299,1672604694,3395
3786,3773121782,3505481368,1672636984,1672640302,3318
3919,3499217428,3518565331,1672630316,1672630465,149
3650,3500613493,3467988782,1672675627,1672677905,2278
3511,3815392801,3777189898,1672541224,1672541303,79
3485,3497808662,3514818819,1672548732,1672551296,2564
3784,3770520359,3478114114,1672563086,1672565683,2597
3453,3611055563,3373028638,1672550677,1672553806,3129
3619,3490029863,3501786419,1672619217,1672622743,3526
3845,3350095157,3780680950,1672590010,1672592221,2211
3733,3500857494,3774733620,1672546393,1672547574,1181
3503,3505634634,3347446226,1672591770,1672592229,459
3811,3608922867,3206837348,1672688701,1672691909,3208
3672,3369708250,3469254160,1672696103,1672698818,2715
3689,3520578796,3447514821,1672662180,1672663932,1752
3760,3793743698,3513295938,1672703920,1672705429,1509
3561,3510919821,3688490530,1672679994,1672683249,3255
3757,3927599181,3515559913,1672593259,1672595095,1836
3650,3438078818,3970558632,1672652072,1672653375,1303
3492,3380767040,3902625986,1672696357,1672699730,3373
3681,3519282716,3200543880,1672606890,1672609327,2437
3912,3461119815,3608232640,1672636950,1672640251,3301
3680,3514334067,3500317969,1672543732,1672546544,2812
3640,3478114114,3500613493,1672681252,1672681486,234
3866,3513853403,3559731671,1672685172,1672688394,3222
3825,3774790271,3510818674,1672695057,1672697472,2415
3779,3229974066,3897435944,1672665265,1672665355,90
3695,3755992176,3933894942,1672678344,1672679468,1124
3544,3776559988,3517288083,1672553219,1672554633,1414
3664,3897435944,3737147209,1672665849,1672667256,1407
3819,3239617320,3792274796,1672558898,1672560172,1274
3744,3497095254,3902760230,1672665396,1672666153,757
3634,3311420950,3402697190,1672618663,1672620764,2101
3837,3519077659,3703383853,1672693247,1672695044,1797
3495,3773837847,3229974066,1672671381,1672674307,2926
3836,3512722110,3491469603,1672537277,1672539387,2110
3545,3713768950,3803389195,1672655547,1672655996,449
3539,3276217799,3780115155,1672697363,1672699352,1989
3526,3970558632,3490214516,1672589716,1672591996,2280
3501,3305722859,3714067076,1672640602,1672641683,1081
3441,3410160376,3514246749,1672644990,1672645871,881
3653,3618489670,3514334067,1672697808,1672700681,2873
3858,3373089838,3920898925,1672683757,1672685348,1591
3597,3417679834,3808136029,1672670226,1672672243,2017
3533,3384583385,3755756564,1672535714,1672538232,2518
3568,3533423872,3559458968,1672580450,1672581394,944
3870,3280054198,3280268483,1672537370,1672537493,123
3541,3680843171,3777189898,1672571640,1672574008,2368
3620,3615113018,3777240360,1672653602,1672656845,3243
3674,3774876004,3777189898,1672598301,1672598937,636
3528,3777814504,3519909393,1672565831,1672568446,2615
3780,3622357348,3710496785,1672623005,1672623201,196
3553,3520181148,3714678331,1672692561,1672693307,746
3606,3520355798,3755222916,1672612760,1672614208,1448
3425,3414275042,3834960360,1672628365,1672629311,946
3867,3394297564,3501121099,1672615612,1672618930,3318
3862,3757193307,3818575661,1672651217,1672652429,1212
3712,3520355798,3357289672,1672676262,1672676449,187
3855,3824641227,3401940259,1672686925,1672688390,1465
3755,3979802715,3780680950,1672601651,1672604647,2996
3746,3336339664,3621790707,1672573511,1672575485,1974
3854,3829822608,3777037426,1672638944,1672641903,2959
3909,3661583097,3793868716,1672696511,1672696817,306
3498,3605221116,3501457103,1672555344,1672556627,1283
3677,3711006062,3291933594,1672566277,1672567779,1502
3839,3776034743,3513853403,1672565576,1672567111,1535
3537,3792274796,3934064792,1672598387,1672600229,1842
3556,3716272919,3770704999,1672619994,1672620408,414
3493,3814305099,3514334067,1672568573,1672570254,1681
3792,3516321888,3280268483,1672654994,1672657849,2855
3615,3772078494,3755344363,1672680652,1672682098,1446
3500,3757323954,3241790910,1672692351,1672693701,1350
3807,3343816795,3500827202,1672542725,1672544492,1767
3607,3349856820,3783615982,1672553308,1672553890,582
3630,3772078494,3715974659,1672620155,1672621454,1299
3758,3514308235,3500703304,1672653587,1672655366,1779
3902,3779425804,3757903168,1672619608,1672622541,2933
3637,3755344363,3380130228,1672625682,1672626172,490
3730,3534175249,3890739241,1672599772,1672602778,3006
3849,3773332082,3414275042,1672693366,1672695864,2498
3468,3505663516,3520115090,1672628676,1672630163,1487
3663,3815250107,3515466096,1672652283,1672654581,2298
3919,3461119815,3897435944,1672698324,1672700761,2437
3446,3451691949,3225631197,1672610982,1672612967,1985
3700,3610870949,3480490124,1672564891,1672566096,1205
3808,3382733096,3615737355,1672671653,1672674257,2604
3735,3232208416,3463849738,1672674075,1672674376,301
3838,3776117322,3443357683,1672586749,1672587055,306
3695,3770704999,3333918941,1672631809,1672634623,2814
3899,3621683102,3783169442,1672680789,1672682944,2155
3483,3225631197,3921648519,1672635983,1672636431,448
3862,3970558632,3774790271,1672559375,1672561449,2074
3473,3400069268,3701373490,1672610190,1672612494,2304
3460,3300511067,3272030610,1672647153,1672649567,2414
3531,3276269264,3443357683,1672618079,1672621082,3003
3637,3520181148,3757323954,1672644060,1672646773,2713
3752,3510767239,3505283390,1672563337,1672565969,2632
3625,3513327337,3701005527,1672627719,1672630124,2405
3661,3852533643,3778134418,1672614810,1672617637,2827
3862,3615113018,3500044458,1672540077,1672543667,3590
3708,3470454332,3715400486,1672609765,1672610689,924
3483,3608855425,3246370118,1672550465,1672552326,1861
3706,3772391882,3703396825,1672606428,1672609653,3225
3585,3401793306,3554944414,1672620965,1672621379,414
3769,3501384020,3492546679,1672587953,1672589864,1911
3598,3443357683,3685681577,1672594736,1672597197,2461
3891,3410600350,3905899155,1672692173,1672694115,1942
3546,3977148669,3852686295,1672597479,1672600704,3225
3829,3225029895,3730071479,1672626182,1672627436,1254
3664,3513295938,3624297844,1672617446,1672620953,3507
3843,3315279093,3462158237,1672556794,1672559872,3078
3841,3516489668,3362641275,1672692488,1672692961,473
3661,3284932450,3488763230,1672622492,1672625065,2573
3519,3479851674,3780322355,1672644569,1672646459,1890
3558,3667427125,3893912331,1672696252,1672696455,203
3853,3510837901,3513360004,1672532016,1672532315,299
3825,3715986185,3487875183,1672680324,1672683535,3211
3837,3610870949,3311420950,1672694552,1672696691,2139
3435,3716272919,3501457103,1672678205,1672680483,2278
3756,3715545685,3440107959,1672649997,1672652432,2435
3854,3505402439,3928719932,1672615624,1672617700,2076
3819,3280054198,3834960360,1672685896,1672687369,1473
3555,3776244398,3462158237,1672599436,1672601185,1749
3655,3711000597,3770676872,1672691692,1672693405,1713
3780,3617392620,3935399379,1672557699,1672559520,1821
3427,3533423872,3512830734,1672699803,1672701449,1646
3796,3517172354,3920898925,1672602210,1672603214,1004
3517,3701005527,3316798920,1672534375,1672536632,2257
3792,3613338363,3408430195,1672629118,1672632460,3342
3879,3450286949,3309314379,1672703151,1672703509,358
3629,3772765746,3414049538,1672536316,1672539825,3509
3636,3500498112,3514818819,1672652673,1672654862,2189
3667,3533747868,3368283077,1672598726,1672599552,826
3550,3485540729,3792442597,1672552473,1672552936,463
3732,3777330107,3791106564,1672559857,1672560654,797
3825,3505634634,3755573472,1672646172,1672647651,1479
3705,3770236215,3713784974,1672694587,1672698118,3531
3454,3770676872,3512958459,1672590457,1672593341,2884
3580,3714120857,3279475486,1672592441,1672594312,1871
3874,3500613459,3437286517,1672609561,1672611192,1631
3749,3738026330,3884596900,1672670407,1672671272,865
3814,3680843171,3685681577,1672610979,1672614363,3384
3684,3778134418,3343816795,1672673340,1672674195,855
3821,3932478321,3271752081,1672609513,1672612893,3380
3583,3533747868,3273981374,1672613072,1672614231,1159
3883,3374183227,3701322924,1672638337,1672638544,207
3769,3621790707,3760694096,1672659470,1672659965,495
3684,3416987084,3501281016,1672550233,1672553270,3037
3670,3357689359,3770624662,1672684003,1672685211,1208
3877,3607768197,3770146716,1672702031,1672705163,3132
3750,3534175249,3714827719,1672608519,1672611297,2778
3776,3279339278,3923754072,1672636856,1672637976,1120
3483,3621683102,3613416045,1672650561,1672652125,1564
3882,3716679950,3897134762,1672695254,1672698713,3459
3762,3367971170,3225636215,1672545673,1672546820,1147
3473,3292147449,3208452238,1672673871,1672677192,3321
3454,3622357348,3792072681,1672561167,1672561505,338
3739,3510028805,3245232284,1672651372,1672654038,2666
3768,3480490124,3514285803,1672567002,1672570209,3207
3796,3927165965,3779639983,1672665822,1672665893,71
3681,3774178201,3513081354,1672532239,1672535053,2814
3896,3514512367,3519909393,1672676288,1672676551,263
3764,3520578796,3839245934,1672682786,1672686260,3474
3438,3240994288,3520991398,1672634680,1672637473,2793
3893,3835422146,3510837901,1672635716,1672637263,1547
3572,3778597171,3770236215,1672612426,1672612927,501
3800,3770236215,3517600136,1672656715,1672658065,1350
3635,3299781901,3501459390,1672637458,1672638020,562
3863,3379143440,3611055563,1672585415,1672588400,2985
3849,3505481368,3618489670,1672649713,1672652596,2883
3840,3310039260,3774031303,1672672910,1672673803,893
3589,3512722110,3829822608,1672600397,1672603904,3507
3446,3336339664,3774705415,1672642609,1672645892,3283
3905,3685816610,3500737582,1672639944,1672642667,2723
3876,3272030610,3893912331,1672638115,1672640223,2108
3744,3938503547,3618489670,1672541852,1672543049,1197
3893,3551389192,3774733620,1672537184,1672540422,3238
3767,3276217799,3773572967,1672575249,1672578830,3581
3589,3202804048,3499217428,1672605296,1672608343,3047
3818,3271454397,3792745809,1672691895,1672692122,227
3447,3610870949,3711812325,1672653522,1672654958,1436
3778,3623266256,3518565331,1672649483,1672651601,2118
3478,3777147510,3501457103,1672691057,1672693619,2562
3671,3533423872,3310039260,1672688453,1672690828,2375
3511,3414275042,3824641227,1672621354,1672623265,1911
3827,3208452238,3512946768,1672557755,1672560437,2682
3879,3818575661,3689697817,1672576334,1672579395,3061
3762,3468041839,3777485931,1672563844,1672566239,2395
3868,3515466096,3755065949,1672632223,1672632725,502
3835,3733363628,3610870949,1672553544,1672555736,2192
3436,3793743698,3501281016,1672620943,1672622495,1552
3748,3773033649,3710048469,1672703694,1672705162,1468
3800,3737112297,3238288884,1672545973,1672547179,1206
3533,3802932312,3688796737,1672646988,1672650120,3132
3543,3306412634,3289114629,1672564796,1672566838,2042
3604,3310039260,3755992176,1672586149,1672588362,2213
3570,3513853403,3733558985,1672560498,1672561070,572
3662,3520355798,3387594369,1672543621,1672544352,731
3768,3510798825,3715619259,1672538609,1672539678,1069
3445,3713911104,3512295534,1672539241,1672542637,3396
3661,3711218296,3812534508,1672656045,1672658964,2919
3824,3449333754,3519077659,1672591270,1672594281,3011
3774,3938503547,3701882224,1672637237,1672639044,1807
3425,3701664364,3701884158,1672634670,1672636431,1761
3830,3500044458,3791246640,1672607090,1672608095,1005
3889,3815250107,3512282789,1672557575,1672559357,1782
3539,3755992176,3621683102,1672576588,1672576811,223
3657,3688220326,3801645328,1672575946,1672576720,774
3709,3285204083,3792274796,1672546271,1672549805,3534
3777,3701373490,3979802715,1672684281,1672687014,2733
3495,3436257398,3236354255,1672679708,1672682584,2876
3791,3446533960,3205985903,1672542261,1672543478,1217
3592,3755065949,3713517039,1672634131,1672635560,1429
3688,3737112297,3513327337,1672638209,1672639204,995
3652,3410160376,3779301501,1672558089,1672559736,1647
3856,3451326054,3517288083,1672606382,1672609977,3595
3714,3518229776,3755233658,1672608119,1672609371,1252
3664,3276269264,3701247948,1672591964,1672592693,729
3673,3501786419,3375449013,1672566139,1672569351,3212
3604,3338083680,3715545685,1672702060,1672702237,177
3833,3306412634,3777189898,1672624804,1672626234,1430
3880,3509483172,3617392620,1672604892,1672606318,1426
3749,3271752081,3755158925,1672564396,1672566225,1829
3544,3370068529,3492546679,1672629954,1672633307,3353
3839,3276348699,3310039260,1672691718,1672695192,3474
3541,3756385685,3701373490,1672581928,1672584885,2957
3717,3713589994,3449333754,1672552069,1672553319,1250
3596,3755573472,3779438325,1672687449,1672690582,3133
3425,3360069849,3931627862,1672602989,1672604437,1448
3749,3357289672,3780712350,1672578781,1672581192,2411
3682,3238288884,3780571086,1672637075,1672639732,2657
3701,3518229776,3513345163,1672653527,1672654741,1214
3538,3772236797,3437286517,1672545035,1672545801,766
3515,3379143440,3689114185,1672632790,1672633842,1052
3886,3793935736,3688796737,1672671161,1672673827,2666
3827,3770704999,3500208903,1672572258,1672574961,2703
3729,3972192593,3684523966,1672678209,1672681652,3443
3693,3906536154,3396726504,1672625106,1672625678,572
3841,3760640999,3519818818,1672628667,1672631398,2731
3788,3713829743,3311098437,1672576667,1672579131,2464
3671,3716628503,3625463628,1672654809,1672658000,3191
3625,3716963089,3270042456,1672601949,1672605195,3246
3562,3779613523,3711000597,1672560322,1672563815,3493
3593,3713829743,3779738691,1672569458,1672570960,1502
3792,3927165965,3905196766,1672620167,1672621575,1408
3487,3793315718,3505198734,1672673696,1672676918,3222
3447,3554825448,3311498666,1672652312,1672653088,776
3807,3793868716,3852533643,1672671282,1672672506,1224
3710,3792801638,3497671225,1672532079,1672534264,2185
3867,3773572967,3902760230,1672649961,1672653465,3504
3580,3469254160,3554825448,1672597970,1672598239,269
3622,3688796737,3226511603,1672579831,1672582523,2692
3831,3900898992,3304155815,1672616334,1672617934,1600
3633,3514419100,3715385401,1672565816,1672569318,3502
3515,3439673892,3500915908,1672614348,1672617833,3485
3520,3514308235,3441703884,1672554320,1672555629,1309
3755,3773735484,3488686442,1672552870,1672554447,1577
3729,3779639983,3401496246,1672579896,1672580127,231
3580,3390660440,3703383853,1672560419,1672563431,3012
3772,3551376095,3514703118,1672670010,1672672465,2455
3842,3513545422,3384068080,1672591330,1672594890,3560
3762,3315279093,3605221116,1672616529,1672618396,1867
3677,3757903168,3772391882,1672694445,1672695778,1333
3491,3639050419,3202141727,1672674741,1672677934,3193
3651,3500709774,3289817992,1672694730,1672698243,3513
3825,3755915206,3897456874,1672532141,1672533818,1677
3770,3533423872,3757903168,1672610289,1672610447,158
3687,3551376095,3505154885,1672584297,1672585023,726
3843,3230135532,3783433404,1672659856,1672659951,95
3920,3613581796,3755230952,1672605076,1672606217,1141
3436,3373089838,3288224595,1672671481,1672672649,1168
3555,3443357683,3360069849,1672683907,1672684709,802
3893,3520181148,3224968597,1672590577,1672591520,943
3510,3513853403,3501786419,1672678437,1672678943,506
3912,3514703118,3511024016,1672552268,1672552881,613
3701,3428725843,3279339278,1672570467,1672570721,254
3902,3270697740,3351696332,1672609647,1672609866,219
3902,3518561777,3685816610,1672582429,1672585638,3209
3674,3412968120,3315279093,1672658390,1672660381,1991
3592,3360813161,3773009828,1672613113,1672614711,1598
3509,3792538417,3613206049,1672695388,1672697665,2277
3841,3289114629,3511442562,1672554335,1672557652,3317
3544,3310039260,3202141727,1672630320,1672633126,2806
3893,3500737582,3519282716,1672613828,1672614987,1159
3830,3701424609,3792538417,1672552566,1672553826,1260
3873,3505178849,3457620713,1672644079,1672647332,3253
3581,3371455553,3509893027,1672642806,1672645435,2629
3681,3513327337,3513295938,1672597617,1672600453,2836
3709,3779532653,3414049538,1672579267,1672581391,2124
3511,3793922324,3231713082,1672651905,1672652334,429
3907,3382733096,3760640999,1672651202,1672654631,3429
3633,3424445495,3779938251,1672629432,1672631133,1701
3535,3205923620,3248058676,1672687920,1672688895,975
3558,3618808151,3518565331,1672673769,1672676632,2863
3590,3792745809,3225636215,1672534261,1672534591,330
3586,3772236797,3625463628,1672532037,1672532541,504
3721,3734915241,3760924079,1672618080,1672618365,285
3779,3779532653,3279339278,1672637207,1672638359,1152
3485,3933894942,3755915206,1672598164,1672598674,510
3604,3760924079,3296462324,1672541199,1672543552,2353
3700,3334993594,3424445495,1672631175,1672634409,3234
3854,3534764451,3373089838,1672594467,1672595294,827
3777,3514419100,3520578796,1672687676,1672691229,3553
3702,3509366311,3500915665,1672660619,1672663416,2797
3472,3617392620,3311085279,1672554281,1672555074,793
3502,3733558985,3773027597,1672586272,1672589364,3092
3488,3792014516,3510187271,1672650490,1672653525,3035
3813,3685681577,3906536154,1672702964,1672706370,3406
3565,3505154885,3920898925,1672576849,1672580351,3502
3476,3449639012,3392520516,1672550421,1672551202,781
3859,3783615982,3815392801,1672660822,1672661081,259
3717,3462273042,3897134762,1672632942,1672636370,3428
3746,3492546679,3850911686,1672537680,1672538000,320
3542,3230868435,3520322124,1672632252,1672634287,2035
3853,3495911207,3414940786,1672643977,1672647163,3186
3431,3776831527,3519850727,1672532667,1672533584,917
3453,3773735484,3972083617,1672588712,1672589375,663
3516,3501786419,3783928182,1672635873,1672636422,549
3532,3885537225,3519028898,1672623519,1672624134,615
3571,3680810086,3734118023,1672550983,1672554276,3293
3535,3891672228,3520181148,1672692152,1672692481,329
3721,3780115155,3774243020,1672579658,1672580892,1234
3797,3792546035,3366423342,1672559514,1672561453,1939
3483,3450286949,3760364383,1672538411,1672540871,2460
3616,3338390596,3501457103,1672698744,1672700064,1320
3804,3770676872,3792442597,1672670844,1672671462,618
3863,3905196766,3710008361,1672700326,1672701600,1274
3674,3511150845,3374183227,1672545007,1672546462,1455
3818,3205985903,3449333754,1672579736,1672581640,1904
3517,3975717896,3977352557,1672649059,1672651300,2241
3717,3715986185,3935487534,1672634287,1672636271,1984
3820,3755233658,3711000597,1672696056,1672697164,1108
3610,3715127070,3605221116,1672560831,1672564023,3192
3533,3374183227,3516703758,1672557878,1672558334,456
3498,3225631197,3552824113,1672570983,1672572000,1017
3449,3739154408,3421385957,1672563526,1672566592,3066
3731,3823084403,3772236797,1672569900,1672572312,2412
3507,3512946768,3715545685,1672598597,1672602142,3545
3725,3511843593,3711812325,1672580101,1672583012,2911
3435,3757630221,3229974066,1672548299,1672548603,304
3602,3835422146,3668533536,1672702101,1672704392,2291
3784,3760640999,3760645796,1672653327,1672653398,71
3473,3392943173,3448633776,1672602029,1672604716,2687
3749,3852686295,3713829743,1672678141,1672680302,2161
3634,3701322924,3292147449,1672638357,1672641274,2917
3869,3619922891,3831586487,1672676718,1672679639,2921
3436,3714067076,3734915241,1672669114,1672672469,3355
3782,3793922324,3609113156,1672564278,1672567123,2845
3919,3500613459,3517697722,1672674192,1672674710,518
3612,3755233658,3760263530,1672615541,1672617248,1707
3555,3468041839,3905196766,1672631205,1672634476,3271
3618,3713589994,3272030610,1672557648,1672558527,879
3835,3512800570,3519651506,1672662896,1672663783,887
3530,3513545422,3500341755,1672668046,1672668461,415
3451,3737972328,3773121782,1672690023,1672692037,2014
3782,3517172354,3514512367,1672595650,1672596651,1001
3427,3777037426,3519077659,1672624293,1672624759,466
3598,3516513251,3834960360,1672633841,1672633994,153
3540,3447672935,3518229776,1672542371,1672542704,333
3627,3831586487,3779738691,1672585757,1672588796,3039
3654,3808136029,3757700712,1672595798,1672597034,1236
3710,3533079336,3715974659,1672664437,1672667050,2613
3855,3300511067,3757630221,1672592214,1672593564,1350
3680,3770624662,3774243020,1672625296,1672625657,361
3471,3513327337,3534764451,1672567109,1672567264,155
3688,3379143440,3481640525,1672676284,1672677278,994
3566,3291933594,3783147088,1672673554,1672676175,2621
3705,3791128487,3438489358,1672604959,1672606462,1503
3898,3374183227,3279475486,1672629538,1672631166,1628
3763,3238288884,3928719932,1672662284,1672662692,408
3698,3802932312,3311098437,1672596975,1672600296,3321
3918,3236458894,3773027597,1672531942,1672533040,1098
3468,3792801638,3229822507,1672650563,1672651044,481
3468,3380130228,3714827719,1672549387,1672550158,771
3785,3680843171,3479851674,1672622414,1672624789,2375
3803,3299781901,3360616538,1672635657,1672636904,1247
3735,3711812325,3779646172,1672642753,1672644997,2244
3729,3600876425,3418448389,1672554819,1672557953,3134
3719,3701005527,3811040565,1672620545,1672620642,97
3848,3459681410,3315279093,1672641362,1672641890,528
3859,3505481368,3783771827,1672614152,1672614951,799
3609,3311098437,3410160376,1672648826,1672650179,1353
3617,3520764926,3818575661,1672671449,1672674060,2611
3664,3513327337,3926643445,1672569104,1672570980,1876
3442,3338083680,3801645328,1672611120,1672613176,2056
3566,3938389661,3639050419,1672613777,1672616350,2573
3612,3802932312,3604867757,1672545597,1672548664,3067
3676,3248058676,3715986185,1672645993,1672646064,71
3702,3300229945,3402697190,1672680605,1672682564,1959
3515,3736705719,3518194482,1672573927,1672574723,796
3739,3510818674,3299125059,1672639878,1672642527,2649
3746,3791693821,3774705415,1672548597,1672549540,943
3857,3711734586,3780571086,1672673934,1672676659,2725
3895,3514275974,3772765746,1672593853,1672595588,1735
3583,3436257398,3519818818,1672574140,1672574932,792
3698,3511791953,3714666884,1672594461,1672597717,3256
3744,3773033649,3755848152,1672556454,1672559046,2592
3633,3408430195,3505154885,1672695746,1672697194,1448
3521,3713589994,3335694356,1672565115,1672567582,2467
3668,3519818818,3783801141,1672628419,1672629140,721
3509,3236354255,3770296583,1672558882,1672560002,1120
3455,3714233826,3792072681,1672620047,1672621000,953
3437,3755230952,3386758279,1672570608,1672571929,1321
3869,3408430195,3621790707,1672642919,1672645490,2571
3602,3288224595,3382733096,1672623666,1672626896,3230
3446,3638660068,3885121158,1672691026,1672693453,2427
3732,3792546035,3409114719,1672642849,1672645504,2655
3681,3533747868,3668414677,1672587747,1672589928,2181
3520,3246370118,3686227677,1672608412,1672609699,1287
3715,3510837901,3930242012,1672598965,1672599140,175
3788,3923220461,3713829743,1672531925,1672532508,583
3604,3711077927,3930242012,1672684108,1672686615,2507
3791,3776084820,3500341755,1672665458,1672668377,2919
3916,3456430614,3410538749,1672533489,1672534229,740
3644,3395201292,3501525100,1672534817,1672538264,3447
3451,3374183227,3500302272,1672687106,1672690142,3036
3566,3224811762,3375449013,1672695044,1672697909,2865
3770,3756625818,3505521218,1672563781,1672567098,3317
3603,3284932450,3856606678,1672670124,1672672624,2500
3804,3515401243,3711637255,1672695837,1672696554,717
3916,3928719932,3554944414,1672667015,1672669521,2506
3687,3206837348,3661447322,1672649519,1672650050,531
3450,3777485931,3511732493,1672572192,1672575562,3370
3572,3511024016,3534829213,1672667122,1672668408,1286
3521,3510964997,3902625986,1672677945,1672681057,3112
3793,3456430614,3686523546,1672661213,1672663940,2727
3872,3369708250,3716963089,1672547956,1672550435,2479
3848,3970198861,3505923418,1672676431,1672678068,1637
3802,3333918941,3792014516,1672638401,1672639618,1217
3671,3793407963,3384068080,1672556759,1672557534,775
3690,3225029895,3736231757,1672646649,1672649702,3053
3543,3505634634,3774876004,1672569238,1672572403,3165
3886,3448633776,3609113156,1672586847,1672588055,1208
3692,3308760650,3757863420,1672670799,1672673697,2898
3865,3479851674,3438078818,1672588094,1672589582,1488
3834,3792505974,3755756564,1672643658,1672644434,776
3778,3925979970,3736231757,1672683612,1672683866,254
3602,3618354185,3777485931,1672592527,1672592672,145
3425,3620292035,3511883730,1672613526,1672614891,1365
3746,3500317969,3615087943,1672702245,1672705730,3485
3638,3373028638,3511317276,1672592831,1672593249,418
3457,3760263530,3479851674,1672531934,1672533685,1751
3508,3202804048,3920497528,1672626783,1672628845,2062
3885,3760694096,3760645796,1672560023,1672562859,2836
3631,3520181148,3500208903,1672572324,1672572709,385
3794,3311498666,3779892400,1672686241,1672686709,468
3593,3923754072,3779301501,1672549722,1672550876,1154
3837,3783928182,3505266860,1672613305,1672613619,314
3830,3236499444,3974674109,1672563366,1672564345,979
3679,3284947372,3337362061,1672645278,1672647991,2713
3803,3500915665,3713561276,1672591760,1672593678,1918
3729,3935913584,3613338363,1672620276,1672620343,67
3604,3491684096,3970627281,1672698544,1672701315,2771
3456,3710854064,3713768950,1672682051,1672684967,2916
3469,3450286949,3514741348,1672632031,1672632433,402
3900,3511024016,3701424609,1672621481,1672624307,2826
3680,3617392620,3970603231,1672571346,1672572342,996
3831,3777240360,3639050419,1672633966,1672636438,2472
3513,3783919913,3774031303,1672667272,1672669467,2195
3596,3414049538,3485540729,1672674426,1672676704,2278
3675,3923220461,3624297844,1672699431,1672701931,2500
3727,3513410578,3621184108,1672690347,1672692552,2205
3677,3517600136,3608922867,1672625248,1672626216,968
3645,3276003502,3500109249,1672543159,1672543381,222
3727,3779613523,3714120857,1672537004,1672538470,1466
3628,3792949946,3710008361,1672703842,1672704101,259
3653,3605221116,3436257398,1672589973,1672590436,463
3866,3812534508,3607768197,1672551335,1672552585,1250
3502,3610358027,3618176292,1672607996,1672611219,3223
3425,3431502855,3890739241,1672570927,1672572182,1255
3578,3892304880,3701247948,1672612028,1672615161,3133
3573,3667427125,3732131656,1672661208,1672662701,1493
3485,3276269264,3481640525,1672605216,1672607129,1913
3870,3885121158,3713941638,1672693285,1672696345,3060
3617,3520657891,3517737088,1672537289,1672539918,2629
3828,3514419100,3224330592,1672628026,1672631432,3406
3908,3224968597,3615939504,1672622361,1672623195,834
3711,3505847380,3382733096,1672676443,1672678361,1918
3629,3300979975,3443357683,1672667156,1672670520,3364
3450,3379143440,3505228454,1672667463,1672670015,2552
3718,3373089838,3462636434,1672692558,1672695030,2472
3831,3510641433,3315703693,1672532084,1672533027,943
3515,3760362417,3783641602,1672671373,1672672020,647
3832,3517687662,3618697021,1672628072,1672628721,649
3693,3638660068,3376467719,1672551769,1672553057,1288
3639,3520115090,3441348818,1672536466,1672538415,1949
3867,3513295938,3779438325,1672688071,1672688813,742
3813,3778926763,3334951866,1672561757,1672562344,587
3917,3518653080,3636329663,1672648864,1672649051,187
3915,3701882224,3338083680,1672589926,1672590594,668
3492,3534764451,3501384020,1672699708,1672701571,1863
3454,3518653080,3232208416,1672587082,1672589914,2832
3834,3224330592,3713589994,1672579088,1672579421,333
3665,3714067076,3755230952,1672576024,1672576996,972
3549,3934064792,3714233826,1672651076,1672653952,2876
3462,3399518841,3825881598,1672617358,1672618743,1385
3467,3686523546,3488686442,1672670793,1672671957,1164
3624,3780571086,3511791953,1672560308,1672560867,559
3830,3607882826,3469254160,1672543409,1672546689,3280
3825,3791246640,3905899155,1672642437,1672643420,983
3753,3501215099,3760362417,1672590352,1672591468,1116
3484,3928511283,3711077927,1672556593,1672557973,1380
3914,3296462324,3970198861,1672610489,1672610602,113
3882,3779438325,3238288884,1672628440,1672631389,2949
3547,3617116290,3511843593,1672597763,1672600841,3078
3602,3715619259,3283144118,1672609253,1672612814,3561
3915,3533004959,3510187271,1672698094,1672700503,2409
3914,3792949946,3665998641,1672531492,1672531982,490
3435,3447672935,3533649454,1672636001,1672639085,3084
3547,3715974659,3770704999,1672686884,1672690188,3304
3922,3734451191,3713589994,1672586890,1672587397,507
3891,3311049964,3513345163,1672694173,1672696075,1902
3841,3514308235,3505807416,1672691964,1672694228,2264
3722,3225636215,3736705719,1672587391,1672589561,2170
3874,3299781901,3711077927,1672669996,1672672413,2417
3654,3455018347,3533423872,1672538246,1672538746,500
3480,3557046880,3791436104,1672688575,1672691291,2716
3851,3899326793,3774605761,1672689229,1672690997,1768
3807,3885155975,3739661856,1672593571,1672593799,228
3618,3780115155,3505807416,1672630051,1672632894,2843
3640,3607882826,3817813340,1672648625,1672652098,3473
3783,3613416045,3364726656,1672610996,1672614163,3167
3483,3505266860,3703433819,1672647193,1672648383,1190
3506,3897134762,3390660440,1672622297,1672623771,1474
3444,3439673892,3607768197,1672637491,1672640067,2576
3921,3716110860,3201800997,1672575609,1672579080,3471
3648,3774705415,3715127070,1672645203,1672645662,459
3795,3366423342,3617392620,1672578545,1672581028,2483
3567,3501459390,3284932450,1672560781,1672561108,327
3537,3791613604,3505725706,1672533492,1672535780,2288
3917,3512337405,3792389522,1672656284,1672657240,956
3501,3516321888,3309314379,1672661849,1672662604,755
3754,3716110860,3509893027,1672578429,1672581530,3101
3559,3905196766,3812534508,1672622956,1672623680,724
3894,3710048469,3713941638,1672597625,1672601098,3473
3521,3760721303,3927165965,1672672830,1672674841,2011
3533,3367509761,3396980894,1672612933,1672615885,2952
3513,3505228454,3202804048,1672605651,1672607086,1435
3785,3500841914,3701107228,1672665771,1672666725,954
3460,3780680950,3824215187,1672605584,1672609070,3486
3683,3367111751,3475349791,1672617685,1672619130,1445
3562,3551376095,3513327337,1672595738,1672598624,2886
3560,3792274796,3514308235,1672610754,1672612094,1340
3868,3505111292,3414275042,1672674661,1672677135,2474
3523,3244004456,3495911207,1672536570,1672537218,648
3468,3505725706,3713829743,1672582799,1672586073,3274
3872,3760364383,3610358027,1672676180,1672678452,2272
3741,3808136029,3780472203,1672543547,1672545048,1501
3639,3304971369,3621683102,1672652888,1672654019,1131
3647,3513327337,3713829743,1672552460,1672555096,2636
3549,3737972328,3760263530,1672586499,1672587939,1440
3913,3512379024,3279339278,1672539857,1672542168,2311
3675,3938503547,3755222916,1672693851,1672696622,2771
3732,3812369928,3520991398,1672643086,1672643580,494
3441,3792489602,3680810086,1672542199,1672542808,609
3674,3669146016,3514818819,1672558623,1672559046,423
3898,3510919821,3429943738,1672568258,1672569319,1061
3820,3239617320,3716110860,1672619093,1672622440,3347
3535,3533368789,3710008361,1672610473,1672612594,2121
3489,3793315718,3631090677,1672607196,1672610207,3011
3433,3500109249,3512379024,1672698659,1672702228,3569
3518,3739154408,3517358573,1672661896,1672664175,2279
3534,3500857494,3459681410,1672662707,1672665902,3195
3771,3517288083,3773572967,1672585932,1672587751,1819
3729,3510554314,3334993594,1672591454,1672593121,1667
3851,3238288884,3416987084,1672623217,1672626042,2825
3552,3224968597,3714666884,1672677323,1672680835,3512
3699,3500317969,3887243870,1672674829,1672674955,126
3669,3887243870,3512800570,1672597699,1672601028,3329
3795,3510187271,3505807416,1672693796,1672694231,435
3645,3661447322,3520639768,1672562560,1672564311,1751
3609,3835422146,3925979970,1672680393,1672681297,904
3862,3770438122,3201676087,1672536906,1672538824,1918
3728,3500442734,3757863420,1672544958,1672547108,2150
3693,3369708250,3791246640,1672673894,1672675657,1763
3540,3316800320,3500949309,1672641293,1672643104,1811
3746,3772236797,3440137407,1672597313,1672600673,3360
3737,3500949309,3488686442,1672699948,1672700740,792
3473,3500317969,3497808662,1672628807,1672629778,971
3730,3338390596,3977352557,1672666209,1672669452,3243
3709,3773009828,3713691388,1672607628,1672610198,2570
3829,3285204083,3309314379,1672608872,1672612160,3288
3536,3505266860,3511883730,1672637956,1672641490,3534
3424,3713517039,3825881598,1672572202,1672575712,3510
3869,3618697021,3900276517,1672661922,1672665262,3340
3624,3280268483,3792489602,1672593278,1672595807,2529
3708,3299125059,3791436104,1672681415,1672684140,2725
3591,3792949946,3294747828,1672604568,1672607751,3183
3446,3447672935,3500737582,1672646304,1672649070,2766
3893,3334993594,3756625818,1672610770,1672613272,2502
3826,3615113018,3220031931,1672611735,1672611842,107
3654,3511601997,3462636434,1672545116,1672548520,3404
3566,3382733096,3279473441,1672554935,1672557089,2154
3513,3970603231,3514308235,1672676056,1672677036,980
3519,3311420950,3516489668,1672627706,1672630761,3055
3857,3487875183,3899786664,1672603510,1672607110,3600
3658,3755233658,3710496785,1672584892,1672587556,2664
3588,3631090677,3774243020,1672642061,1672643094,1033
3455,3299443125,3829822608,1672555729,1672555956,227
3704,3384068080,3559731671,1672631277,1672632642,1365
3479,3511024016,3343816795,1672589974,1672590140,166
3914,3446533960,3773837847,1672678407,1672680540,2133
3913,3680843171,3755065949,1672613543,1672615898,2355
3699,3463740710,3294747828,1672550716,1672553732,3016
3657,3979802715,3668414677,1672688829,1672691878,3049
3691,3891672228,3803389195,1672562856,1672565670,2814
3852,3500604680,3713561276,1672554084,1672554385,301
3850,3513296868,3372223551,1672591625,1672594708,3083
3596,3815392801,3412968120,1672602941,1672604179,1238
3564,3938503547,3902760230,1672546659,1672546870,211
3489,3509483172,3202804048,1672553918,1672556398,2480
3531,3411515369,3236499444,1672660598,1672664078,3480
3497,3793740407,3792949946,1672579125,1672581862,2737
3586,3412968120,3505228454,1672612080,1672613495,1415
3860,3276003502,3279475486,1672586870,1672588313,1443
3703,3516298579,3792801638,1672658465,1672661747,3282
3501,3236499444,3505888598,1672656552,1672658291,1739
3552,3757294769,3363162590,1672661935,1672663649,1714
3572,3554825448,3927165965,1672687018,1672687624,606
3579,3226024417,3201629017,1672594756,1672596629,1873
3544,3461119815,3780115155,1672647900,1672650414,2514
3827,3401496246,3613581796,1672590397,1672591919,1522
3433,3970198861,3283492940,1672564251,1672567443,3192
3810,3485540729,3512502036,1672585588,1672586909,1321
3460,3357864626,3773735484,1672565299,1672568076,2777
3805,3512383699,3373089838,1672640962,1672641734,772
3440,3229974066,3791046864,1672560454,1672563456,3002
3439,3439673892,3779301501,1672700976,1672703958,2982
3557,3715854030,3755065949,1672658879,1672659560,681
3429,3609881958,3780680950,1672599894,1672602369,2475
3435,3394401087,3730071479,1672698575,1672700952,2377
3813,3755404116,3668414677,1672675639,1672675719,80
3916,3710048469,3715986185,1672567080,1672570284,3204
3531,3410600350,3349856820,1672679634,1672680618,984
3818,3713561276,3613338363,1672653755,1672655206,1451
3793,3613581796,3831586487,1672666215,1672669706,3491
3655,3760842815,3519077659,1672664732,1672664834,102
3732,3533423872,3811075491,1672557922,1672558142,220
3427,3505923418,3424445495,1672567414,1672570266,2852
3645,3779301501,3351866415,1672703688,1672706307,2619
3720,3776559988,3236499444,1672682829,1672684185,1356
3846,3310039260,3614740489,1672697485,1672698967,1482
3894,3689697817,3362641275,1672648139,1672650786,2647
3453,3715086894,3270697740,1672535490,1672537627,2137
3427,3779425804,3499217428,1672572504,1672573634,1130
3653,3552824113,3469254160,1672574748,1672578151,3403
3844,3801645328,3296462324,1672532358,1672532814,456
3588,3777624586,3505154885,1672697351,1672699292,1941
3673,3777184389,3711812325,1672541379,1672541460,81
3548,3450286949,3228888030,1672539373,1672539815,442
3881,3710008361,3294703680,1672586359,1672587736,1377
3835,3713300120,3334993594,1672621290,1672624027,2737
3841,3435167810,3505847380,1672550078,1672550141,63
3861,3803389195,3791106564,1672686795,1672687664,869
3467,3510499038,3500949309,1672621501,1672623523,2022
3834,3460719322,3511732493,1672615894,1672618490,2596
3811,3615115210,3512830734,1672668373,1672668595,222
3877,3756385685,3839245934,1672579733,1672581110,1377
3468,3497095254,3734915241,1672678998,1672681795,2797
3504,3714185969,3512958459,1672662346,1672662549,203
3743,3680843171,3520322124,1672550173,1672550532,359
3468,3514324011,3713784974,1672690954,1672693592,2638
3867,3617392620,3859868849,1672574398,1672575685,1287
3674,3505847380,3533090502,1672632927,1672634322,1395
3524,3891672228,3900276517,1672635285,1672637459,2174
3908,3330340793,3756127300,1672605261,1672606733,1472
3750,3715086894,3296462324,1672625098,1672628363,3265
3528,3617116290,3551389192,1672537003,1672539520,2517
3826,3776084820,3382733096,1672701896,1672702921,1025
3774,3615113018,3716963089,1672587664,1672591193,3529
3573,3372223551,3921648519,1672668686,1672670522,1836
3874,3770704999,3428027649,1672567306,1672569079,1773
3720,3665998641,3516489668,1672645984,1672648270,2286
3529,3236499444,3240994288,1672599653,1672601108,1455
3681,3383138270,3661583097,1672686472,1672687230,758
3681,3668414677,3392520516,1672606132,1672609277,3145
3629,3394401087,3481640525,1672582691,1672586179,3488
3891,3824215187,3803389195,1672640727,1672642780,2053
3611,3516298579,3974674109,1672669909,1672670804,895
3599,3760640999,3375449013,1672612224,1672613431,1207
3510,3776518452,3512958459,1672661163,1672662691,1528
3890,3520416075,3776518452,1672539131,1672541095,1964
3874,3773572967,3909094917,1672631871,1672633734,1863
3627,3516513251,3424445495,1672550788,1672553858,3070
3921,3821054646,3495911207,1672581914,1672582758,844
3771,3246370118,3783147088,1672651332,1672653893,2561
3748,3755532873,3517590837,1672591634,1672592980,1346
3886,3807212280,3755158925,1672623524,1672626350,2826
3700,3446533960,3516489668,1672622997,1672623988,991
3892,3850911686,3778040015,1672544258,1672546538,2280
3850,3500737582,3791246640,1672656761,1672657997,1236
3427,3739895284,3514419100,1672693928,1672695390,1462
3435,3351866415,3533004959,1672703179,1672703556,377
3708,3607882826,3501457103,1672685168,1672686621,1453
3839,3757863420,3505434346,1672605600,1672606239,639
3505,3621461051,3755915206,1672614246,1672614790,544
3651,3439673892,3380130228,1672689103,1672691536,2433
3645,3497095254,3534179433,1672634535,1672637755,3220
3517,3516489668,3505663516,1672656166,1672657750,1584
3768,3792801638,3411515369,1672579721,1672581500,1779
3738,3777814504,3622357348,1672575764,1672576647,883
3507,3509366311,3510798825,1672562152,1672563730,1578
3673,3399518841,3517881647,1672640532,1672643704,3172
3896,3500703304,3370227921,1672559916,1672562597,2681
3738,3334993594,3615737355,1672596028,1672597628,1600
3520,3520764926,3757903168,1672585241,1672586319,1078
3744,3505521218,3315279093,1672564841,1672567251,2410
3560,3780322355,3500915908,1672676052,1672679028,2976
3481,3934064792,3389634034,1672573108,1672575719,2611
3746,3209481722,3350095157,1672695558,1672697695,2137
3597,3279475486,3905899155,1672535547,1672536607,1060
3533,3270056120,3715086894,1672534427,1672536526,2099
3673,3792546035,3779438325,1672592375,1672593904,1529
3742,3447514821,3609113156,1672684641,1672686176,1535
3883,3703348097,3511883730,1672628919,1672630802,1883
3604,3349739136,3241790910,1672617994,1672620068,2074
3759,3711097754,3900276517,1672615153,1672617476,2323
3671,3609659642,3777037426,1672552873,1672556043,3170
3682,3773902805,3660887799,1672536622,1672538230,1608
3742,3501121099,3793868716,1672653730,1672655871,2141
3672,3514703118,3296462324,1672698469,1672701694,3225
3618,3793935736,3552824113,1672596090,1672598379,2289
3592,3288762795,3760842815,1672554341,1672557239,2898
3504,3779854934,3774155692,1672603325,1672605498,2173
3854,3556969573,3780427126,1672695069,1672696207,1138
3524,3905899155,3902861231,1672572959,1672573474,515
3681,3739661856,3500498112,1672551155,1672553405,2250
3443,3431460073,3713768950,1672666113,1672668785,2672
3537,3316800320,3891672228,1672535380,1672535800,420
3630,3608855425,3892304880,1672690244,1672693708,3464
3428,3669146016,3514334067,1672655395,1672657984,2589
3670,3445206685,3370068529,1672532296,1672535216,2920
3516,3512383699,3510767239,1672674474,1672675524,1050
3551,3512882178,3229974066,1672571036,1672572826,1790
3626,3370227921,3618808151,1672558030,1672558862,832
3900,3409114719,3912891315,1672648643,1672651128,2485
3608,3512392431,3792014516,1672592855,1672593347,492
3791,3445206685,3733558985,1672593142,1672595054,1912
3427,3401496246,3224330592,1672635081,1672636242,1161
3583,3551389192,3241790910,1672618260,1672619729,1469
3861,3715854030,3270697740,1672581706,1672582216,510
3696,3512882178,3811040565,1672703016,1672704627,1611
3689,3895285664,3669146016,1672548902,1672551688,2786
3824,3900276517,3923220461,1672644813,1672645090,277
3773,3613581796,3713517039,1672546912,1672550008,3096
3795,3776559988,3701373490,1672540144,1672542705,2561
3424,3224811762,3880926355,1672671915,1672672123,208
3855,3299781901,3284932450,1672652775,1672655747,2972
3646,3224330592,3757332128,1672557379,1672558098,719
3655,3885121158,3511843593,1672588485,1672589500,1015
3879,3793418209,3501457103,1672549528,1672552717,3189
3707,3306175858,3715385401,1672675152,1672678082,2930
3854,3774876004,3885121158,1672700425,1672703948,3523
3710,3500915908,3777091903,1672566879,1672570231,3352
3619,3970558632,3613416045,1672695513,1672696662,1149
3513,3231713082,3979784676,1672605795,1672607125,1330
3867,3500341755,3517358573,1672674118,1672674670,552
3503,3773332082,3514324011,1672570191,1672573246,3055
3709,3833217041,3513410578,1672664980,1672666782,1802
3471,3490029863,3856606678,1672654076,1672655346,1270
3434,3774290799,3505481368,1672590505,1672591665,1160
3704,3518561777,3315703693,1672684858,1672687652,2794
3774,3711006062,3920497528,1672591556,1672594271,2715
3589,3856606678,3270697740,1672615459,1672618748,3289
3918,3412968120,3701884158,1672636097,1672638452,2355
3861,3311098437,3551376095,1672664300,1672665715,1415
3887,3716963089,3514512367,1672620554,1672621514,960
3611,3755404116,3475349791,1672635511,1672637278,1767
3614,3517462308,3519909393,1672625344,1672627189,1845
3428,3505481368,3509764635,1672618851,1672619199,348
3899,3783373154,3760263530,1672642489,1672644531,2042
3433,3791106564,3904412440,1672575091,1672578117,3026
3815,3715974659,3510028805,1672666535,1672666912,377
3919,3779938251,3791046864,1672646640,1672647394,754
3751,3513295938,3711734586,1672630688,1672633300,2612
3893,3505437712,3228888030,1672613540,1672615310,1770
3600,3815392801,3559731671,1672546228,1672549198,2970
3517,3276217799,3734118023,1672638995,1672641648,2653
3679,3224811762,3517697722,1672560194,1672560722,528
3661,3300818269,3780427126,1672649960,1672653301,3341
3593,3760645796,3739895284,1672686201,1672687905,1704
3763,3351696332,3812534508,1672637669,1672639603,1934
3708,3711218296,3930242012,1672646394,1672649114,2720
3784,3500604680,3793743698,1672640887,1672644415,3528
3897,3773332082,3906536154,1672667370,1672668108,738
3712,3824641227,3737972328,1672657539,1672660883,3344
3918,3791441520,3927165965,1672697266,1672698759,1493
3657,3686227677,3777694660,1672698550,1672701770,3220
3458,3760640999,3779465522,1672576501,1672578504,2003
3626,3716679950,3904412440,1672599030,1672601918,2888
3830,3783615982,3305722859,1672635076,1672637398,2322
3668,3554186380,3970558632,1672637465,1672640315,2850
3502,3360813161,3231494505,1672546073,1672546336,263
3632,3773009828,3716272919,1672671465,1672674316,2851
3591,3463849738,3920898925,1672688183,1672689072,889
3723,3209526819,3829822608,1672538384,1672538991,607
3617,3977148669,3710735406,1672588812,1672591653,2841
3561,3772391882,3224811762,1672548452,1672551672,3220
3570,3515439826,3500915908,1672562430,1672563962,1532
3489,3463849738,3713300120,1672597037,1672597102,65
3898,3272716462,3613899351,1672546654,1672549627,2973
3634,3777485931,3533274994,1672566885,1672567832,947
3723,3392520516,3773121782,1672636635,1672640163,3528
3904,3557046880,3613206049,1672618883,1672622233,3350
3518,3889780657,3852533643,1672659160,1672661399,2239
3897,3713300120,3409114719,1672657784,1672659856,2072
3555,3534126409,3621184108,1672621444,1672622815,1371
3671,3514741348,3970198861,1672608323,1672611312,2989
3599,3519446663,3760040019,1672539829,1672542888,3059
3694,3374183227,3783801141,1672608715,1672609590,875
3782,3402697190,3520991398,1672566224,1672569463,3239
3581,3801645328,3859868849,1672582395,1672585669,3274
3582,3418448389,3779646172,1672587888,1672591005,3117
3438,3887243870,3760842815,1672536297,1672539197,2900
3758,3610358027,3711097754,1672643906,1672644961,1055
3680,3779639983,3667673649,1672657640,1672659091,1451
3675,3622665543,3783340788,1672566031,1672568333,2302
3654,3511442562,3792389522,1672571452,1672571857,405
3883,3776117322,3770468980,1672577130,1672579363,2233
3558,3421877923,3492546679,1672589350,1672592061,2711
3844,3291933594,3800257590,1672618955,1672621472,2517
3802,3773124276,3701373490,1672554740,1672555721,981
3460,3500613459,3755404116,1672666874,1672667742,868
3495,3776559988,3505888598,1672636166,1672637390,1224
3723,3891672228,3424660806,1672598543,1672600025,1482
3745,3680843171,3296462324,1672603737,1672603927,190
3544,3801645328,3505888598,1672572389,1672573645,1256
3686,3533649454,3501567772,1672562761,1672563174,413
3788,3384068080,3382733096,1672573578,1672573719,141
3624,3360616538,3831586487,1672693851,1672694914,1063
3632,3400763927,3312998540,1672595497,1672595639,142
3822,3777147510,3777147510,1672694822,1672695915,1093
3518,3505111292,3777037426,1672627441,1672629746,2305
3865,3714067076,3360069849,1672597520,1672600957,3437
3792,3370227921,3853629553,1672601225,1672601839,614
3500,3228888030,3772391882,1672630771,1672632890,2119
3774,3635169815,3533747868,1672698117,1672699027,910
3885,3609659642,3245232284,1672647794,1672648648,854
3764,3755222916,3440137407,1672601983,1672604428,2445
3656,3783340788,3756789525,1672688549,1672689501,952
3436,3812369928,3500672156,1672580685,1672581691,1006
3606,3638660068,3791613604,1672579278,1672581151,1873
3726,3279475486,3472068734,1672660605,1672662557,1952
3558,3776831527,3336339664,1672644593,1672645992,1399
3683,3236499444,3610870949,1672537687,1672538627,940
3896,3408498208,3510499038,1672544991,1672545188,197
3883,3551376095,3511732493,1672620853,1672621362,509
3864,3735374579,3791436104,1672684158,1672685551,1393
3565,3774790271,3703139663,1672556814,1672559012,2198
3780,3357289672,3885537225,1672616717,1672618617,1900
3637,3773009828,3680810086,1672678200,1672681385,3185
3728,3774641380,3520578796,1672644390,1672647609,3219
3665,3501457103,3241790910,1672565547,1672568355,2808
3656,3424660806,3289817992,1672674632,1672678119,3487
3775,3505888598,3511791953,1672593355,1672594159,804
3806,3472312341,3294703680,1672665354,1672665462,108
3815,3834631333,3777189898,1672572543,1672575930,3387
3737,3517590837,3311098437,1672573981,1672575680,1699
3916,3240994288,3225029895,1672597230,1672600428,3198
3885,3363162590,3380130228,1672652006,1672654269,2263
3501,3343816795,3500072204,1672692381,1672693702,1321
3663,3501525100,3686523546,1672646467,1672648222,1755
3872,3774790271,3338390596,1672557261,1672558684,1423
3833,3632814465,3615087943,1672538101,1672538623,522
3528,3711812325,3703433819,1672625402,1672627234,1832
3492,3824641227,3972192593,1672595175,1672595544,369
3702,3791128487,3812369928,1672534338,1672536396,2058
3610,3610870949,3384583385,1672537897,1672538093,196
3793,3309314379,3478114114,1672679806,1672679891,85
3464,3800257590,3347446226,1672588139,1672591690,3551
3751,3446533960,3615737355,1672667619,1672667727,108
3863,3357689359,3621461051,1672644357,1672644444,87
3605,3441348818,3935399379,1672685464,1672687098,1634
3889,3760362417,3512379024,1672628848,1672629324,476
3676,3970558632,3829864515,1672660317,1672661630,1313
3695,3713691388,3760651515,1672576011,1672577280,1269
3550,3236499444,3733363628,1672611688,1672613871,2183
3861,3334993594,3819767045,1672627298,1672628855,1557
3440,3368283077,3383138270,1672612906,1672616294,3388
3805,3802932312,3755573472,1672634494,1672635554,1060
3594,3793922324,3519077659,1672649435,1672651035,1600
3578,3885121158,3760263530,1672614828,1672615785,957
3448,3463740710,3515559913,1672700804,1672703060,2256
3780,3231494505,3905196766,1672680745,1672684308,3563
3791,3972192593,3777037426,1672605839,1672607486,1647
3697,3350095157,3509483172,1672647168,1672649261,2093
3906,3977352557,3710008361,1672533505,1672536017,2512
3721,3783433404,3760094385,1672640583,1672640939,356
3472,3611055563,3715127070,1672635418,1672635917,499
3868,3777189898,3516741440,1672541605,1672542409,804
3688,3668414677,3374183227,1672586802,1672587690,888
3847,3733363628,3885155975,1672681487,1672683852,2365
3919,3436025562,3316798920,1672561402,1672562545,1143
3529,3684523966,3200543880,1672593827,1672595986,2159
3793,3224811762,3533649454,1672616266,1672619383,3117
3565,3513345163,3773939399,1672600441,1672601454,1013
3713,3248058676,3241914067,1672624225,1672627788,3563
3864,3534175249,3912891315,1672640121,1672643367,3246
3880,3618176292,3618354185,1672649420,1672650351,931
3686,3615688740,3450286949,1672624269,1672625947,1678
3559,3777694660,3232208416,1672672005,1672673740,1735
3483,3713979100,3514308235,1672609993,1672613444,3451
3688,3272096759,3618176292,1672603271,1672606068,2797
3919,3780834916,3792014516,1672626204,1672627838,1634
3436,3490029863,3533747868,1672642841,1672644697,1856
3915,3380767040,3778667336,1672546233,1672548702,2469
3825,3501525100,3885157459,1672621194,1672624552,3358
3715,3783147088,3514334067,1672604808,1672608180,3372
3919,3682133690,3774155692,1672591758,1672593296,1538
3755,3224968597,3715974659,1672698584,1672698801,217
3739,3517887477,3626499450,1672570016,1672571640,1624
3464,3511883730,3779938251,1672652899,1672656430,3531
3554,3793407963,3972083617,1672667645,1672670437,2792
3592,3512295534,3779465522,1672684505,1672685379,874
3818,3230135532,3780115155,1672586875,1672588602,1727
3855,3791128487,3451691949,1672679152,1672681777,2625
3449,3686523546,3714670620,1672568778,1672571642,2864
3520,3454277788,3421877923,1672600535,1672603240,2705
3631,3927403123,3779786641,1672635982,1672637943,1961
3894,3510642075,3500613493,1672619939,1672622519,2580
3484,3229822507,3732584121,1672671810,1672672428,618
3912,3779892400,3417191856,1672555073,1672556161,1088
3657,3711637255,3852533643,1672654529,1672656346,1817
3716,3511843593,3714827719,1672700317,1672703262,2945
3677,3618489670,3757630221,1672688319,1672691689,3370
3830,3757193307,3811075491,1672571353,1672571470,117
3547,3776084820,3730071479,1672666576,1672669816,3240
3742,3774907131,3510818674,1672568426,1672570072,1646
3522,3713829743,3734451191,1672681741,1672684613,2872
3905,3514308235,3511732493,1672671379,1672674697,3318
3557,3518194482,3334993594,1672654056,1672654194,138
3539,3447672935,3773837847,1672558052,1672561641,3589
3773,3512502036,3711218296,1672703634,1672706351,2717
3774,3927403123,3890739241,1672645188,1672647252,2064
3866,3240994288,3770468980,1672681774,1672682094,320
3525,3457620713,3713768950,1672580931,1672583904,2973
3684,3905196766,3511732493,1672605000,1672605856,856
3559,3755737419,3515402792,1672614684,1672617548,2864
3794,3904412440,3501786419,1672604894,1672605252,358
3907,3319167958,3803517637,1672599316,1672600343,1027
3498,3383138270,3626499450,1672616227,1672618632,2405
3544,3386758279,3613416045,1672617904,1672618186,282
3888,3683113954,3472312341,1672690158,1672693544,3386
3573,3791046864,3470454332,1672672056,1672674872,2816
3648,3279339278,3618697021,1672650149,1672650805,656
3614,3534357694,3791436104,1672619352,1672619913,561
3777,3755496114,3774907131,1672701292,1672703257,1965
3560,3902861231,3793868716,1672614363,1672616911,2548
3556,3343132529,3821054646,1672658952,1672660541,1589
3806,3505847380,3902625986,1672585140,1672587914,2774
3430,3488686442,3513853403,1672598299,1672599555,1256
3429,3773913680,3791693821,1672662473,1672662828,355
3820,3776518452,3909094917,1672638599,1672642107,3508
3491,3511024016,3783615982,1672603042,1672606259,3217
3670,3777779869,3428027649,1672541585,1672544050,2465
3900,3793743698,3791441520,1672693055,1672693830,775
3700,3513041785,3515890966,1672560698,1672562478,1780
3583,3814305099,3288224595,1672591646,1672591769,123
3860,3613338363,3551389192,1672559756,1672561990,2234
3795,3517697722,3534175249,1672626578,1672629492,2914
3632,3310039260,3516321888,1672654666,1672654988,322
3856,3511288998,3201800997,1672544209,1672544279,70
3662,3454277788,3914691363,1672565696,1672566606,910
3488,3513296868,3887243870,1672628107,1672631494,3387
3437,3716963089,3533747868,1672629689,1672631766,2077
3605,3450286949,3276348699,1672597013,1672598166,1153
3536,3401496246,3231494505,1672629834,1672632963,3129
3686,3688220326,3501121099,1672623328,1672625469,2141
3471,3206837348,3755532873,1672535447,1672537441,1994
3812,3783373154,3932478321,1672568342,1672571870,3528
3699,3779892400,3472068734,1672614970,1672617173,2203
3729,3360616538,3779938251,1672697604,1672699067,1463
3813,3884596900,3776084820,1672647221,1672649579,2358
3672,3808136029,3902760230,1672533323,1672535855,2532
3495,3479851674,3716628503,1672626866,1672628424,1558
3489,3505228454,3920898925,1672552953,1672554275,1322
3922,3518565331,3778926763,1672543100,1672543585,485
3627,3760364383,3783801141,1672666084,1672669629,3545
3678,3341893384,3392943173,1672594070,1672596617,2547
3438,3887243870,3713941638,1672632884,1672633895,1011
3649,3518653080,3512392431,1672587881,1672588135,254
3888,3618808151,3710854064,1672641992,1672642220,228
3873,3488763230,3510641433,1672685187,1672685366,179
3682,3500604680,3714827719,1672662690,1672665825,3135
3840,3935487534,3793315718,1672579879,1672581343,1464
3488,3783169442,3979802715,1672637679,1672639386,1707
3509,3360813161,3462273042,1672664944,1672668177,3233
3752,3533747868,3793583656,1672700127,1672703104,2977
3797,3755344363,3791128487,1672624230,1672627365,3135
3795,3280268483,3615113018,1672667703,1672668922,1219
3520,3818575661,3394401087,1672694378,1672697323,2945
3560,3448875382,3770520359,1672603056,1672606550,3494
3609,3480490124,3701247948,1672698271,1672700102,1831
3512,3730071479,3803389195,1672678728,1672679349,621
3805,3774907131,3977352557,1672624774,1672625120,346
3538,3511791953,3516703758,1672592049,1672594837,2788
3700,3283492940,3401940259,1672544672,1672545941,1269
3509,3334974375,3770520359,1672540006,1672542095,2089
3610,3927165965,3793418209,1672621879,1672622923,1044
3685,3338083680,3398198430,1672534678,1672537695,3017
3721,3226178937,3411688875,1672678571,1672680490,1919
3495,3777091903,3298151889,1672643188,1672645321,2133
3527,3443357683,3300229945,1672541798,1672544497,2699
3688,3625174002,3510767239,1672653280,1672653583,303
3505,3283492940,3757193551,1672576985,1672580204,3219
3579,3776117322,3372223551,1672698465,1672698592,127
3610,3515401243,3970603231,1672617659,1672620019,2360
3755,3831586487,3296462324,1672656508,1672656821,313
3867,3909094917,3777814504,1672688946,1672691130,2184
3468,3631090677,3770624662,1672567154,1672568023,869
3476,3779892400,3684523966,1672676956,1672678553,1597
3662,3732131656,3792546035,1672598859,1672601189,2330
3447,3515525630,3284932450,1672700197,1672703540,3343
3858,3380767040,3780571086,1672569066,1672571402,2336
3891,3338083680,3231494505,1672650741,1672654087,3346
3501,3927599181,3436025562,1672533404,1672533519,115
3662,3228888030,3792489602,1672577725,1672580417,2692
3769,3366423342,3505481368,1672693304,1672696852,3548
3441,3935913584,3733558985,1672642637,1672644411,1774
3811,3773033649,3272096759,1672616768,1672619262,2494
3502,3635169815,3513545422,1672630427,1672632944,2517
3607,3783801141,3463740710,1672691046,1672693787,2741
3690,3733558985,3710562338,1672657661,1672658797,1136
3641,3501215099,3792801638,1672687567,1672688750,1183
3801,3354144091,3756746867,1672657726,1672657926,200
3447,3401496246,3534179433,1672546720,1672547193,473
3662,3517222913,3755404116,1672548168,1672550902,2734
3424,3760645796,3689114185,1672632514,1672633317,803
3480,3713589994,3468041839,1672537610,1672540262,2652
3739,3711218296,3462636434,1672642095,1672645205,3110
3920,3510964997,3516444201,1672546347,1672547903,1556
3871,3370227921,3793583656,1672686806,1672688737,1931
3637,3505266860,3499217428,1672702840,1672705086,2246
3836,3760640999,3757193551,1672661630,1672664304,2674
3748,3534566651,3711637255,1672654323,1672657408,3085
3759,3304155815,3310125159,1672648313,1672648853,540
3458,3715545685,3380982774,1672606349,1672606703,354
3904,3715545685,3500613493,1672572071,1672573764,1693
3861,3447514821,3770146716,1672588303,1672591400,3097
3588,3511317276,3512958459,1672604655,1672606231,1576
3561,3533004959,3518194482,1672683770,1672686305,2535
3652,3276348699,3296462324,1672564065,1672567086,3021
3453,3500613459,3905196766,1672661205,1672661647,442
3655,3716110860,3478114114,1672566097,1672567524,1427
3752,3792745809,3312998540,1672606949,1672608372,1423
3848,3518653080,3600876425,1672689622,1672692335,2713
3662,3500302272,3436257398,1672575667,1672577886,2219
3633,3306412634,3760640999,1672667747,1672668749,1002
3564,3635169815,3900898992,1672622867,1672626375,3508
3680,3520657891,3835422146,1672543657,1672546779,3122
3754,3803389195,3618176292,1672663105,1672666570,3465
3570,3755233658,3604589802,1672557366,1672558535,1169
3713,3829822608,3688490530,1672677918,1672681091,3173
3536,3449333754,3770624662,1672586268,1672588744,2476
3852,3970198861,3511317276,1672614848,1672618158,3310
3685,3774907131,3713911104,1672539127,1672540581,1454
3543,3421877923,3519028898,1672642889,1672644610,1721
3732,3737147209,3505154885,1672647097,1672647806,709
3581,3934064792,3284947372,1672651978,1672655416,3438
3458,3500613459,3460719322,1672628511,1672629543,1032
3900,3501786419,3202804048,1672619284,1672621565,2281
3789,3408430195,3417191856,1672674915,1672677330,2415
3855,3638660068,3376467719,1672553376,1672554847,1471
3821,3834960360,3755344363,1672543668,1672547117,3449
3643,3780680950,3920497528,1672543904,1672544716,812
3812,3737147209,3505437712,1672566946,1672568806,1860
3909,3380130228,3516489668,1672624667,1672627859,3192
3849,3755496114,3517288083,1672609845,1672612799,2954
3660,3515525630,3780338697,1672629821,1672631504,1683
3812,3491684096,3337362061,1672563900,1672565956,2056
3502,3688796737,3367111751,1672611032,1672613767,2735
3461,3520873221,3713300120,1672593272,1672596707,3435
3524,3715127070,3777037426,1672686568,1672687131,563
3464,3770438122,3783373154,1672579266,1672581956,2690
3517,3501459390,3514971533,1672615294,1672615619,325
3429,3780769110,3688490530,1672589035,1672590054,1019
3458,3637313265,3755065949,1672557768,1672558079,311
3849,3701247948,3760040019,1672541093,1672542114,1021
3470,3608232640,3928511283,1672547522,1672550134,2612
3897,3791046864,3497671225,1672690414,1672691029,615
3828,3730071479,3289817992,1672648218,1672651604,3386
3758,3776117322,3272096759,1672640874,1672643449,2575
3587,3390660440,3777037426,1672544898,1672547957,3059
3562,3551389192,3533188828,1672615302,1672616148,846
3776,3970198861,3733558985,1672643353,1672646229,2876
3776,3756625818,3783771827,1672537910,1672540506,2596
3630,3627368399,3490029863,1672636992,1672640477,3485
3433,3739154408,3793935736,1672545895,1672547138,1243
3687,3777624586,3889780657,1672634214,1672634966,752
3650,3306412634,3916490839,1672540438,1672543844,3406
3429,3770624662,3755848152,1672595146,1672596785,1639
3658,3443357683,3793740407,1672688068,1672688892,824
3432,3276269264,3713589994,1672664117,1672666601,2484
3705,3510642075,3514512367,1672637732,1672638330,598
3716,3437286517,3792745809,1672660827,1672661468,641
3487,3613338363,3492959689,1672603968,1672604208,240
3533,3461119815,3533747868,1672681875,1672683778,1903
3441,3885121158,3783433404,1672608003,1672608577,574
3824,3333918941,3492959689,1672606596,1672609979,3383
3530,3319167958,3201629017,1672552398,1672552695,297
3852,3774705415,3533188828,1672616382,1672616841,459
3647,3899326793,3975717896,1672666180,1672669608,3428
3760,3906536154,3760842815,1672682016,1672682880,864
3841,3927403123,3852533643,1672567135,1672567310,175
3435,3792505974,3393063657,1672681673,1672683866,2193
3892,3500915908,3755496114,1672537685,1672539263,1578
3500,3900276517,3792020993,1672639214,1672642136,2922
3593,3385323994,3773027597,1672607035,1672610170,3135
3919,3497808662,3362641275,1672632568,1672635955,3387
3630,3737972328,3682133690,1672652368,1672655092,2724
3555,3710315160,3225636215,1672626780,1672628948,2168
3828,3625174002,3509756823,1672593129,1672593344,215
3499,3510187271,3459681410,1672699684,1672701265,1581
3756,3505725706,3791436104,1672603526,1672606251,2725
3889,3776831527,3236354255,1672678869,1672680375,1506
3427,3661903000,3206837348,1672687785,1672690212,2427
3730,3384068080,3773939399,1672561156,1672561664,508
3637,3778899160,3711812325,1672577155,1672578075,920
3904,3779425804,3621683102,1672613230,1672613459,229
3459,3897134762,3757294769,1672647397,1672649456,2059
3717,3780571086,3778134418,1672685144,1672688054,2910
3590,3757075324,3920898925,1672631975,1672634749,2774
3517,3500613459,3392943173,1672551038,1672552853,1815
3739,3715974659,3850911686,1672563480,1672565983,2503
3679,3400069268,3440137407,1672682852,1672685721,2869
3733,3715385401,3440107959,1672683765,1672685064,1299
3558,3441348818,3609659642,1672658654,1672658768,114
3838,3716110860,3448875382,1672655180,1672657656,2476
3769,3467988782,3447514821,1672548886,1672550024,1138
3534,3617392620,3716272919,1672624155,1672626549,2394
3662,3714128600,3757630221,1672554959,1672557076,2117
3705,3774155692,3703348097,1672585252,1672587991,2739
3523,3240994288,3424445495,1672590883,1672591229,346
3666,3520416075,3780115155,1672621924,1672625257,3333
3792,3824641227,3891672228,1672681876,1672684895,3019
3595,3760842815,3608232640,1672604345,1672605556,1211
3609,3488686442,3779613523,1672594637,1672596559,1922
3684,3475349791,3533079336,1672582859,1672583684,825
3907,3505402439,3451726367,1672632151,1672634380,2229
3678,3505266860,3615939504,1672581342,1672584243,2901
3569,3500857494,3711734586,1672684087,1672687343,3256
3841,3689114185,3776559988,1672534566,1672535531,965
3831,3833217041,3534175249,1672677846,1672681436,3590
3828,3853629553,3510798825,1672546203,1672546710,507
3662,3757903168,3916490839,1672622501,1672624393,1892
3822,3333918941,3501457103,1672685937,1672687964,2027
3669,3757332128,3792072681,1672531842,1672532867,1025
3899,3436257398,3273981374,1672532203,1672532923,720
3442,3803389195,3417679834,1672552042,1672554464,2422
3813,3772078494,3515401243,1672690502,1672693392,2890
3598,3774705415,3299781901,1672623129,1672623754,625
3866,3755992176,3396726504,1672607948,1672611337,3389
3913,3774641380,3703383853,1672583180,1672586403,3223
3706,3501786419,3230868435,1672551354,1672553122,1768
3445,3618808151,3534566651,1672670502,1672671070,568
3858,3713561276,3412968120,1672595507,1672598543,3036
3577,3384068080,3505481368,1672688420,1672688993,573
3736,3774031303,3756704774,1672659507,1672661901,2394
3712,3203538212,3202804048,1672567037,1672570625,3588
3567,3272096759,3880926355,1672608416,1672611240,2824
3614,3757193307,3733363628,1672586456,1672588023,1567
3591,3305336154,3716679950,1672531290,1672532338,1048
3600,3505663516,3500044458,1672546353,1672546438,85
3544,3364378127,3500498112,1672659589,1672659701,112
3832,3833217041,3519909393,1672595354,1672598588,3234
3589,3701005527,3979802715,1672572900,1672576383,3483
3885,3772236797,3417679834,1672666932,1672668549,1617
3835,3402697190,3773332082,1672692953,1672693365,412
3813,3467988782,3757383891,1672583281,1672584786,1505
3608,3757348722,3500777439,1672572311,1672572454,143
3478,3757903168,3200543880,1672671105,1672672262,1157
3784,3912891315,3755344363,1672644231,1672645488,1257
3788,3773124276,3516903528,1672615827,1672616650,823
3493,3897134762,3481640525,1672702852,1672703862,1010
3818,3516513251,3505283390,1672559580,1672560210,630
3576,3807212280,3933894942,1672584103,1672584481,378
3557,3360813161,3447672935,1672693629,1672696488,2859
3472,3755532873,3610870949,1672625797,1672628587,2790
3443,3770468980,3431460073,1672564713,1672565146,433
3573,3711006062,3815392801,1672672214,1672672907,693
3864,3533294425,3668533536,1672647037,1672650226,3189
3577,3972192593,3792072681,1672630477,1672633343,2866
3694,3315703693,3639050419,1672687563,1672691082,3519
3776,3852533643,3333918941,1672678310,1672678622,312
3624,3244004456,3289817992,1672591843,1672592502,659
3869,3351866415,3488686442,1672702381,1672702701,320
3893,3500857494,3515466096,1672666104,1672668447,2343
3643,3755233658,3517462308,1672616388,1672617788,1400
3918,3880926355,3288762795,1672658003,1672660887,2884
3903,3517887477,3514324011,1672598664,1672599016,352
3515,3520657891,3756385685,1672535391,1672538090,2699
3437,3244004456,3779646172,1672652930,1672653910,980
3788,3309314379,3668533536,1672655793,1672656582,789
3624,3552824113,3793315718,1672666763,1672669044,2281
3541,3505154885,3938503547,1672622055,1672625008,2953
3650,3360616538,3686227677,1672691546,1672693524,1978
3513,3511005395,3755065949,1672540142,1672541780,1638
3860,3512800570,3357689359,1672547604,1672549208,1604
3505,3714185969,3534179433,1672545486,1672546099,613
3454,3238288884,3512499658,1672623788,1672626415,2627
3855,3296462324,3733363628,1672537911,1672539111,1200
3477,3611055563,3622665543,1672634995,1672637759,2764
3575,3347419520,3395201292,1672620570,1672621335,765
3687,3311098437,3390660440,1672548276,1672550820,2544
3560,3801645328,3443357683,1672558999,1672559941,942
3913,3316800320,3792072681,1672647236,1672647785,549
3921,3680810086,3776244398,1672686697,1672688204,1507
3592,3271454397,3770704999,1672682752,1672684380,1628
3487,3500827202,3231494505,1672580295,1672580702,407
3658,3511317276,3271454397,1672578838,1672579833,995
3860,3715974659,3783919913,1672644821,1672645529,708
3639,3686523546,3739661856,1672698641,1672699673,1032
3773,3403370192,3505725706,1672565184,1672566254,1070
3704,3225636215,3347446226,1672627615,1672628649,1034
3752,3714120857,3517358573,1672647564,1672648525,961
3552,3713784974,3777779869,1672643585,1672645846,2261
3566,3703139663,3839245934,1672649625,1672653016,3391
3470,3513853403,3902760230,1672602571,1672605577,3006
3514,3511883730,3736705719,1672697549,1672699086,1537
3557,3779532653,3201800997,1672586149,1672586953,804
3518,3757700712,3300979975,1672593084,1672593965,881
3816,3228888030,3505437712,1672570254,1672571001,747
3503,3512499658,3755158925,1672531844,1672533011,1167
3653,3445206685,3370068529,1672703611,1672705923,2312
3731,3343816795,3703433819,1672639198,1672639337,139
3718,3463849738,3500709774,1672537311,1672540544,3233
3507,3533423872,3856606678,1672622570,1672624516,1946
3719,3732584121,3755756564,1672589374,1672591941,2567
3452,3245232284,3497095254,1672602252,1672603412,1160
3919,3639050419,3715545685,1672635184,1672637376,2192
3429,3779646172,3447514821,1672581286,1672584444,3158
3659,3615113018,3552824113,1672657447,1672660024,2577
3580,3518653080,3490214516,1672633254,1672636752,3498
3664,3520322124,3520873221,1672555597,1672558832,3235
3852,3770520359,3779786641,1672615812,1672617497,1685
3551,3770468980,3780834916,1672596096,1672597082,986
3660,3897134762,3509756823,1672600009,1672603101,3092
3639,3400069268,3519651506,1672609429,1672612184,2755
3777,3829822608,3347419520,1672646665,1672646771,106
3620,3505995057,3500498112,1672686979,1672688264,1285
3437,3517600136,3793418209,1672534557,1672538124,3567
3564,3513081354,3533423872,1672552532,1672555212,2680
3516,3770624662,3710048469,1672628866,1672631161,2295
3444,3711000597,3500827202,1672632718,1672634992,2274
3598,3617489344,3618176292,1672615097,1672618199,3102
3761,3760362417,3734915241,1672578012,1672578188,176
3861,3559731671,3500525825,1672640128,1672641080,952
3511,3778667336,3779938251,1672537809,1672540074,2265
3776,3291933594,3715127070,1672686380,1672689395,3015
3623,3518229776,3480100311,1672657576,1672657834,258
3916,3803389195,3609113156,1672542462,1672543255,793
3878,3276003502,3472312341,1672564512,1672567701,3189
3775,3935399379,3780338697,1672647320,1672648642,1322
3899,3624297844,3755532873,1672544299,1672547078,2779
3702,3424445495,3689114185,1672644059,1672645889,1830
3635,3366423342,3440137407,1672578287,1672580104,1817
3860,3500703304,3364378127,1672567389,1672570492,3103
3706,3514419100,3803517637,1672600124,1672603237,3113
3856,3617116290,3480100311,1672552748,1672554813,2065
3467,3396726504,3824641227,1672569882,1672571837,1955
3907,3760640999,3757863420,1672675585,1672676329,744
3598,3669146016,3904412440,1672659629,1672663131,3502
3525,3436025562,3385323994,1672582418,1672583824,1406
3641,3462636434,3779639983,1672557448,1672559181,1733
3908,3512499658,3311085279,1672664855,1672665225,370
3619,3609659642,3288224595,1672534308,1672536697,2389
3588,3715086894,3370227921,1672532399,1672534170,1771
3447,3977352557,3713784974,1672589298,1672590712,1414
3540,3710496785,3783550022,1672555555,1672557232,1677
3472,3518565331,3631090677,1672647788,1672650245,2457
3865,3519282716,3285204083,1672558152,1672561505,3353
3707,3710489491,3462273042,1672626276,1672626637,361
3474,3792546035,3711097754,1672558846,1672559342,496
3640,3510818674,3416987084,1672605884,1672607714,1830
3889,3615737355,3931627862,1672655550,1672658008,2458
3577,3938503547,3224330592,1672540968,1672541152,184
3504,3276269264,3517358573,1672546124,1672546207,83
3773,3887243870,3757294769,1672551413,1672552677,1264
3725,3923754072,3730071479,1672546200,1672549395,3195
3721,3613416045,3774290799,1672548656,1672551608,2952
3577,3831586487,3904867554,1672578702,1672580460,1758
3460,3855583256,3399472693,1672616677,1672616900,223
3459,3225631197,3343132529,1672554594,1672556309,1715
3594,3510499038,3636329663,1672574729,1672575627,898
3429,3520764926,3280268483,1672702956,1672703908,952
3910,3777240360,3559731671,1672597498,1672600365,2867
3647,3201800997,3779425804,1672568754,1672570948,2194
3635,3713589994,3514334067,1672633166,1672636704,3538
3744,3791693821,3505178849,1672615919,1672617450,1531
3795,3333403880,3801645328,1672550701,1672551387,686
3816,3777091903,3715443333,1672614514,1672617173,2659
3828,3515559913,3289114629,1672584798,1672585327,529
3864,3791693821,3501786419,1672600324,1672600950,626
3427,3615688740,3778667336,1672687000,1672687714,714
3781,3347446226,3395201292,1672663706,1672664547,841
3828,3803389195,3347446226,1672654230,1672657704,3474
3909,3514512367,3803389195,1672622626,1672623643,1017
3766,3774876004,3500737582,1672591673,1672594404,2731
3804,3780680950,3510641433,1672579874,1672582873,2999
3457,3510837901,3630353876,1672549195,1672551137,1942
3852,3414940786,3505481368,1672640952,1672642328,1376
3520,3443357683,3516444201,1672555771,1672555987,216
3477,3431460073,3755573472,1672691404,1672694186,2782
3544,3501215099,3363162590,1672691690,1672692577,887
3810,3661447322,3739661856,1672576606,1672579541,2935
3807,3513296868,3533649454,1672674413,1672675836,1423
3617,3513345163,3923420131,1672599315,1672601984,2669
3880,3885157459,3416987084,1672531223,1672533737,2514
3494,3519651506,3448875382,1672590279,1672591518,1239
3876,3618354185,3456430614,1672548670,1672551964,3294
3837,3300511067,3622357348,1672536219,1672539706,3487
3861,3793743698,3203538212,1672596868,1672600277,3409
3477,3779938251,3516513251,1672587548,1672589962,2414
3919,3783169442,3490214516,1672581254,1672582550,1296
3502,3701823816,3338083680,1672566634,1672569930,3296
3690,3513018485,3755344363,1672570508,1672572225,1717
3519,3757294769,3436025562,1672685910,1672689259,3349
3523,3513345163,3533747868,1672581147,1672581393,246
3650,3288224595,3231713082,1672625946,1672629255,3309
3775,3280268483,3760094385,1672603490,1672606097,2607
3919,3501567772,3416987084,1672617762,1672619084,1322
3786,3839245934,3617489344,1672531883,1672534746,2863
3861,3609881958,3202141727,1672580583,1672582481,1898
3495,3760924079,3390660440,1672551907,1672555133,3226
3793,3779438325,3713589994,1672563707,1672566779,3072
3522,3715443333,3855583256,1672685370,1672686448,1078
3739,3770676872,3622357348,1672605985,1672606420,435
3558,3501459390,3600876425,1672673872,1672675783,1911
3902,3792389522,3760362417,1672569799,1672570451,652
3872,3533649454,3703348097,1672651452,1672654088,2636
3594,3231494505,3447672935,1672685568,1672688438,2870
3637,3934064792,3310039260,1672546942,1672549283,2341
3578,3316800320,3512379024,1672685556,1672688987,3431
3840,3354144091,3449639012,1672670437,1672672382,1945
3781,3760040019,3639050419,1672593920,1672595308,1388
3588,3713589994,3492959689,1672703910,1672705023,1113
3896,3971806004,3500525825,1672576831,1672576963,132
3838,3515525630,3613206049,1672703827,1672705021,1194
3835,3512282789,3814305099,1672633049,1672636602,3553
3428,3630353876,3760364383,1672604016,1672605859,1843
3517,3755532873,3627368399,1672559369,1672561870,2501
3718,3757383891,3970603231,1672545075,1672546443,1368
3774,3311098437,3305722859,1672651654,1672651891,237
3817,3895285664,3783373154,1672657493,1672660531,3038
3673,3513295938,3315703693,1672538332,1672540211,1879
3440,3226024417,3665998641,1672665794,1672667600,1806
3803,3520873221,3408430195,1672542910,1672543808,898
3818,3613206049,3500672156,1672614241,1672616273,2032
3687,3497671225,3513296868,1672697263,1672697774,511
3557,3285204083,3519077659,1672593786,1672596836,3050
3440,3291933594,3773913680,1672667496,1672670835,3339
3827,3512830734,3354144091,1672662633,1672666125,3492
3785,3757332128,3772078494,1672688345,1672691207,2862
3464,3792801638,3449333754,1672609713,1672611403,1690
3530,3414940786,3299781901,1672693979,1672696460,2481
3825,3224968597,3760924079,1672654366,1672655762,1396
3675,3400069268,3938503547,1672584332,1672585932,1600
3659,3457960571,3516298579,1672533719,1672536429,2710
3827,3468041839,3904412440,1672602516,1672603108,592
3489,3714827719,3780712350,1672591331,1672592903,1572
3920,3511150845,3451691949,1672685670,1672685763,93
3629,3905899155,3500208903,1672545097,1672546650,1553
3473,3716679950,3533294425,1672652444,1672652612,168
3874,3200543880,3415833929,1672664580,1672667610,3030
3560,3757903168,3410160376,1672693229,1672696349,3120
3694,3738026330,3897456874,1672642922,1672644955,2033
3900,3931627862,3394297564,1672649682,1672652732,3050
3632,3780834916,3514741348,1672590449,1672591273,824
3789,3497808662,3512882178,1672609846,1672612292,2446
3459,3414049538,3513327337,1672668393,1672669518,1125
3499,3500341755,3618489670,1672600461,1672603430,2969
3904,3755496114,3713691388,1672682803,1672683061,258
3453,3715986185,3824215187,1672673021,1672675734,2713
3452,3792546035,3291933594,1672627007,1672630372,3365
3671,3400069268,3509756823,1672612352,1672614630,2278
3655,3923420131,3338083680,1672532876,1672533830,954
3550,3738026330,3625174002,1672609030,1672611215,2185
3476,3401940259,3533423872,1672675179,1672678201,3022
3725,3777485931,3760842815,1672591430,1672592197,767
3431,3451691949,3501459390,1672540522,1672542563,2041
3589,3701247948,3208957949,1672572201,1672574736,2535
3777,3625463628,3279475486,1672556459,1672559779,3320
3535,3515402792,3514956366,1672638027,1672641104,3077
3564,3512946768,3780834916,1672545104,1672547173,2069
3433,3791796585,3714120857,1672566272,1672569606,3334
3455,3505283390,3534126409,1672607879,1672611012,3133
3897,3401940259,3833217041,1672585442,1672588657,3215
3686,3793583656,3515890966,1672537257,1672539477,2220
3602,3500777439,3757332128,1672533081,1672533434,353
3644,3241914067,3739911441,1672577912,1672581450,3538
3429,3517288083,3711637255,1672589046,1672592470,3424
3438,3819767045,3737972328,1672667048,1672667314,266
3673,3272030610,3443357683,1672660438,1672660671,233
3591,3460719322,3363162590,1672649771,1672651726,1955
3537,3370227921,3450969839,1672574968,1672577977,3009
3806,3970603231,3710048469,1672550101,1672551235,1134
3626,3778134418,3392520516,1672655261,1672657206,1945
3618,3513853403,3713979100,1672547712,1672549080,1368
3685,3902861231,3283144118,1672558058,1672561298,3240
3556,3533423872,3893912331,1672679902,1672680756,854
3433,3347446226,3509366311,1672619971,1672623129,3158
3481,3773009828,3505434346,1672568154,1672571159,3005
3617,3513018485,3779425804,1672657293,1672660094,2801
3665,3713517039,3971806004,1672539670,1672541016,1346
3584,3554825448,3491684096,1672537955,1672538805,850
3738,3783433404,3505178849,1672693766,1672694714,948
3619,3440107959,3336339664,1672660855,1672664323,3468
3602,3490029863,3516444201,1672700020,1672702722,2702
3654,3783641602,3375449013,1672559778,1672561522,1744
3753,3760924079,3488686442,1672600255,1672601384,1129
3600,3338390596,3613581796,1672574033,1672574818,785
3664,3440137407,3414049538,1672638955,1672641476,2521
3828,3334993594,3248058676,1672699228,1672700088,860
3884,3792546035,3409114719,1672700492,1672702561,2069
3922,3817428320,3475349791,1672636034,1672638085,2051
3905,3456430614,3770236215,1672534964,1672536249,1285
3852,3793922324,3513041785,1672607208,1672609410,2202
3813,3737112297,3520115090,1672667428,1672670916,3488
3661,3505663516,3396726504,1672642645,1672643591,946
3701,3436025562,3773913680,1672695382,1672697106,1724
3867,3510187271,3208452238,1672663529,1672663858,329
3851,3667673649,3396726504,1672645355,1672646926,1571
3480,3226511603,3608855425,1672617221,1672620164,2943
3853,3618354185,3492959689,1672646706,1672646972,266
3801,3776988674,3516513251,1672650906,1672651318,412
3846,3887243870,3711734586,1672536027,1672537556,1529
3611,3500109249,3270042456,1672677360,1672680249,2889
3611,3792525861,3333403880,1672537351,1672540827,3476
3723,3710562338,3756385685,1672688458,1672690629,2171
3553,3363162590,3605221116,1672560649,1672562157,1508
3750,3755065949,3660063072,1672598834,1672600972,2138
3775,3417679834,3245232284,1672663941,1672664921,980
3547,3777814504,3711006062,1672575612,1672577085,1473
3791,3554186380,3411688875,1672611687,1672614354,2667
3639,3738026330,3779656423,1672631297,1672634366,3069
3589,3497808662,3776518452,1672694695,1672695212,517
3630,3791106564,3294747828,1672575999,1672579328,3329
3733,3500442734,3441703884,1672572636,1672572999,363
3680,3462158237,3271752081,1672621497,1672622739,1242
3759,3730071479,3533294425,1672613335,1672616883,3548
3578,3710048469,3783163143,1672675020,1672675914,894
3638,3392520516,3373028638,1672674304,1672676186,1882
3886,3802932312,3414940786,1672535681,1672538998,3317
3795,3819767045,3276003502,1672654191,1672654308,117
3747,3519282716,3470454332,1672561416,1672564804,3388
3588,3533294425,3979784676,1672692972,1672695421,2449
3700,3701664364,3970627281,1672558396,1672559744,1348
3756,3773027597,3415833929,1672552668,1672552973,305
3783,3517737088,3500347447,1672688589,1672689901,1312
3642,3284947372,3773939399,1672699302,1672702361,3059
3649,3284932450,3615113018,1672598770,1672600737,1967
3515,3621790707,3732584121,1672628607,1672631948,3341
3838,3815250107,3511317276,1672639569,1672640315,746
3682,3229974066,3500737582,1672599307,1672601538,2231
3487,3829822608,3451691949,1672701217,1672701320,103
3733,3667427125,3357864626,1672603662,1672604573,911
3611,3703798634,3757318448,1672550417,1672553744,3327
3751,3778134418,3895285664,1672575641,1672579060,3419
3513,3510642075,3688796737,1672650257,1672652873,2616
3489,3783340788,3514741348,1672651089,1672654452,3363
3817,3772765746,3512282789,1672551245,1672552546,1301
3719,3429943738,3680810086,1672679817,1672681958,2141
3664,3441348818,3792489602,1672570734,1672572969,2235
3810,3201629017,3635169815,1672533129,1672535548,2419
3534,3500672156,3311098437,1672543796,1672544693,897
3554,3710854064,3783169442,1672590694,1672590948,254
3589,3701136026,3203538212,1672697092,1672699972,2880
3850,3390660440,3923754072,1672660226,1672660981,755
3883,3779854934,3513345163,1672695581,1672696449,868
3628,3780322355,3760645796,1672566916,1672570019,3103
3581,3618697021,3435167810,1672567308,1672570263,2955
3835,3814305099,3417679834,1672574424,1672577947,3523
3602,3520657891,3336627643,1672554477,1672557011,2534
3556,3819767045,3500915665,1672702087,1672704618,2531
3882,3518194482,3488686442,1672552119,1672554478,2359
3866,3852686295,3772765746,1672597526,1672599418,1892
3429,3714678331,3612689556,1672672584,1672675761,3177
3726,3792546035,3516513251,1672661094,1672663825,2731
3472,3505228454,3974674109,1672573959,1672576883,2924
3505,3495911207,3232208416,1672589415,1672592107,2692
3526,3505154885,3505634634,1672570076,1672572717,2641
3914,3757318448,3510028805,1672573973,1672577444,3471
3675,3357864626,3756474459,1672549940,1672552400,2460
3711,3613416045,3610870949,1672623064,1672623359,295
3755,3791693821,3533423872,1672618554,1672621720,3166
3881,3517358573,3519850727,1672652711,1672655542,2831
3461,3514956366,3341893384,1672638408,1672641040,2632
3475,3710562338,3512722110,1672571938,1672572618,680
3766,3417191856,3858172636,1672670624,1672673132,2508
3912,3500777439,3350095157,1672541593,1672542209,616
3767,3773332082,3713561276,1672630588,1672633037,2449
3646,3518565331,3760842815,1672645832,1672648879,3047
3882,3732584121,3517358573,1672668350,1672670135,1785
3560,3610870949,3410600350,1672659230,1672660438,1208
3735,3456430614,3735374579,1672598970,1672601881,2911
3621,3935487534,3915162005,1672666930,1672668964,2034
3865,3779301501,3475349791,1672674940,1672678422,3482
3723,3533079336,3714827719,1672691362,1672692347,985
3507,3236458894,3780909839,1672536804,1672539703,2899
3655,3288224595,3607882826,1672540322,1672541784,1462
3817,3392520516,3500709774,1672561169,1672561888,719
3763,3305336154,3513018485,1672546736,1672548976,2240
3550,3739661856,3520181148,1672588245,1672591011,2766
3711,3368283077,3710048469,1672637343,1672640741,3398
3509,3436257398,3739154408,1672566052,1672566628,576
3467,3499217428,3517991730,1672629375,1672631738,2363
3833,3885157459,3777240360,1672639361,1672639901,540
3735,3791046864,3970909253,1672655938,1672659490,3552
3783,3515402792,3232208416,1672672531,1672674709,2178
3813,3236499444,3516444201,1672650470,1672653822,3352
3646,3467988782,3757075324,1672546782,1672548172,1390
3787,3897456874,3609881958,1672589740,1672590291,551
3438,3811075491,3972192593,1672650751,1672651354,603
3541,3403370192,3667673649,1672589454,1672592531,3077
3643,3792505974,3792442597,1672642340,1672642932,592
3489,3500827202,3615688740,1672647831,1672648609,778
3496,3514818819,3715986185,1672700605,1672703703,3098
3449,3533079336,3615087943,1672533195,1672533353,158
3828,3757903168,3512882178,1672553287,1672556669,3382
3787,3520873221,3501457103,1672695344,1672697539,2195
3505,3386758279,3533294425,1672557838,1672560672,2834
3457,3520355798,3829864515,1672589930,1672593031,3101
3494,3450969839,3770520359,1672558633,1672561762,3129
3878,3500709774,3760651515,1672553316,1672553773,457
3472,3312998540,3905899155,1672675351,1672678613,3262
3779,3778667336,3270056120,1672689739,1672692549,2810
3667,3451726367,3232208416,1672588907,1672591274,2367
3438,3739154408,3516298579,1672612556,1672613318,762
3922,3551389192,3517600136,1672627523,1672630073,2550
3487,3448633776,3711006062,1672533496,1672534128,632
3501,3401496246,3505888598,1672565354,1672568094,2740
3916,3534829213,3519028898,1672696695,1672699657,2962
3688,3739911441,3885155975,1672592112,1672594608,2496
3534,3421385957,3516903528,1672622973,1672624906,1933
3610,3500072204,3618354185,1672587850,1672588514,664
3570,3459681410,3408430195,1672628204,1672628861,657
3448,3667427125,3777091903,1672544980,1672545067,87
3529,3514818819,3814305099,1672644553,1672645859,1306
3786,3890739241,3792949946,1672652228,1672654041,1813
3718,3520639768,3226511603,1672639577,1672640458,881
3753,3773735484,3776559988,1672557058,1672557186,128
3837,3900898992,3667427125,1672540627,1672543487,2860
3653,3701107228,3855583256,1672635947,1672638112,2165
3550,3238288884,3792538417,1672548780,1672550096,1316
3439,3462158237,3551399764,1672586565,1672589429,2864
3869,3733558985,3410600350,1672580189,1672582452,2263
3870,3384583385,3501786419,1672646954,1672647148,194
3820,3665998641,3938503547,1672538992,1672539069,77
3519,3783136330,3306412634,1672694711,1672697324,2613
3532,3499217428,3803517637,1672670554,1672671283,729
3787,3518561777,3513081354,1672652955,1672654048,1093
3558,3492959689,3289817992,1672647846,1672650838,2992
3588,3230868435,3511843593,1672581169,1672581870,701
3549,3514971533,3500341755,1672621949,1672622752,803
3544,3638660068,3481640525,1672620951,1672622709,1758
3917,3424445495,3311420950,1672689059,1672692111,3052
3910,3714233826,3889780657,1672645819,1672649170,3351
3730,3667427125,3927165965,1672648816,1672651762,2946
3489,3511883730,3551376095,1672651351,1672652837,1486
3478,3304155815,3480100311,1672599829,1672601177,1348
3672,3399472693,3512958459,1672667257,1672670422,3165
3721,3626499450,3791796585,1672688763,1672690912,2149
3771,3288224595,3516903528,1672587122,1672587563,441
3836,3807212280,3501525100,1672626895,1672627610,715
3880,3811040565,3519087371,1672702671,1672705412,2741
3618,3556969573,3684523966,1672669845,1672671866,2021
3801,3780322355,3515466096,1672680398,1672682286,1888
3433,3770624662,3417191856,1672564258,1672566558,2300
3890,3519282716,3270056120,1672569905,1672572643,2738
3846,3436257398,3668414677,1672569525,1672572711,3186
3779,3898314440,3500341755,1672617268,1672618114,846
3627,3780872464,3703433819,1672577115,1672580569,3454
3612,3512379024,3829822608,1672658081,1672660764,2683
3792,3889780657,3520764926,1672537087,1672538049,962
3915,3478114114,3510499038,1672643277,1672645265,1988
3627,3757348722,3793740407,1672622262,1672623689,1427
3521,3600876425,3621790707,1672622552,1672623563,1011
3672,3515401243,3551399764,1672700571,1672700998,427
3703,3760924079,3533004959,1672691151,1672694606,3455
3904,3760094385,3824215187,1672547902,1672550008,2106
3767,3756474459,3660063072,1672697117,1672699909,2792
3741,3515525630,3300979975,1672537586,1672538733,1147
3835,3456430614,3938389661,1672653663,1672656992,3329
3898,3826238375,3783163143,1672693075,1672696633,3558
3856,3834960360,3625174002,1672702668,1672703060,392
3886,3710562338,3776117322,1672637867,1672638474,607
3525,3661903000,3309314379,1672634179,1672635655,1476
3435,3501786419,3480490124,1672560070,1672563152,3082
3782,3979802715,3505888598,1672684671,1672684735,64
3835,3500442734,3412006598,1672649227,1672651886,2659
3752,3807212280,3513081354,1672643007,1672645282,2275
3667,3621790707,3755065949,1672662845,1672664349,1504
3654,3884596900,3609659642,1672673352,1672673851,499
3821,3755848152,3792801638,1672577544,1672580768,3224
3601,3229974066,3450286949,1672650602,1672652329,1727
3807,3512379024,3294747828,1672584673,1672585228,555
3527,3791246640,3853629553,1672554070,1672557421,3351
3538,3401793306,3756704774,1672602962,1672604421,1459
3594,3500109249,3935487534,1672598386,1672599741,1355
3624,3777091903,3776831527,1672668430,1672669937,1507
3783,3509366311,3927165965,1672607533,1672607835,302
3494,3230135532,3779892400,1672586000,1672588043,2043
3876,3384068080,3409114719,1672650844,1672653193,2349
3589,3513853403,3733363628,1672689614,1672691869,2255
3559,3396726504,3276348699,1672594947,1672595030,83
3489,3478114114,3613899351,1672682970,1672686208,3238
3799,3979784676,3513360004,1672666369,1672668057,1688
3774,3714678331,3756127300,1672658820,1672658980,160
3643,3343132529,3732131656,1672599315,1672600605,1290
3864,3349856820,3231494505,1672628995,1672632376,3381
3705,3927599181,3516444201,1672690310,1672692303,1993
3775,3514703118,3792546035,1672618884,1672621031,2147
3899,3611055563,3935399379,1672606240,1672606787,547
3728,3500777439,3803389195,1672656519,1672658146,1627
3688,3511843593,3551399764,1672532774,1672535575,2801
3577,3534179433,3773332082,1672593176,1672593325,149
3541,3926643445,3201629017,1672663579,1672664289,710
3554,3311049964,3608232640,1672683315,1672686376,3061
3809,3778597171,3299443125,1672576164,1672576493,329
3908,3520657891,3755233658,1672581015,1672582935,1920
3461,3711097754,3757075324,1672618533,1672621808,3275
3862,3514275974,3779646172,1672587030,1672589234,2204
3847,3686227677,3373028638,1672660543,1672663523,2980
3800,3711000597,3333403880,1672558867,1672561209,2342
3915,3366423342,3777694660,1672555475,1672556748,1273
3872,3776244398,3730071479,1672612377,1672613000,623
3751,3609881958,3791246640,1672698358,1672700233,1875
3508,3435167810,3713829743,1672694495,1672696884,2389
3631,3774178201,3739154408,1672619726,1672620816,1090
3845,3793922324,3638660068,1672658776,1672658955,179
3546,3401793306,3912891315,1672651598,1672653694,2096
3825,3923220461,3534126409,1672566745,1672569448,2703
3469,3333918941,3516513251,1672609078,1672611984,2906
3497,3414049538,3500317969,1672534354,1672535066,712
3887,3779786641,3411688875,1672653884,1672655976,2092
3535,3462273042,3370227921,1672681739,1672684582,2843
3625,3205985903,3778040015,1672659450,1672662766,3316
3845,3516513251,3373028638,1672643267,1672646267,3000
3432,3303410628,3512337405,1672599964,1672603456,3492
3832,3850911686,3703348097,1672679584,1672679934,350
3722,3760651515,3311420950,1672544112,1672545116,1004
3501,3510767239,3534764451,1672618098,1672620530,2432
3788,3711097754,3533649454,1672606617,1672609146,2529
3920,3714233826,3731646673,1672586140,1672587200,1060
3914,3703798634,3660063072,1672675450,1672677293,1843
3502,3792442597,3392943173,1672652160,1672655454,3294
3516,3774718695,3396726504,1672690484,1672691822,1338
3648,3488686442,3279473441,1672663094,1672664994,1900
3795,3899326793,3711637255,1672700323,1672703812,3489
3608,3777147510,3608922867,1672620668,1672621863,1195
3431,3399518841,3626499450,1672650923,1672652746,1823
3461,3272716462,3716272919,1672535743,1672538503,2760
3651,3931627862,3312998540,1672673684,1672676397,2713
3735,3505228454,3710315160,1672666388,1672668367,1979
3731,3732131656,3208957949,1672694187,1672694930,743
3731,3780769110,3333403880,1672658262,1672658829,567
3597,3472312341,3226511603,1672630275,1672630646,371
3702,3711097754,3505111292,1672686712,1672688455,1743
3559,3470454332,3514971533,1672589720,1672590452,732
3681,3617392620,3534179433,1672557657,1672560047,2390
3725,3793315718,3305722859,1672682369,1672683374,1005
3628,3305722859,3513853403,1672663949,1672664341,392
3755,3513065217,3774605761,1672582920,1672584733,1813
3568,3513360004,3366423342,1672666328,1672667746,1418
3663,3512946768,3398198430,1672577590,1672580745,3155
3813,3905899155,3893912331,1672696301,1672698588,2287
3792,3389634034,3315279093,1672591848,1672592300,452
3465,3505437712,3501281016,1672671970,1672674459,2489
3830,3737147209,3974674109,1672590615,1672591241,626
3806,3783801141,3923220461,1672612801,1672613526,725
3724,3756789525,3792546035,1672637048,1672638513,1465
3549,3500915665,3480100311,1672593203,1672596458,3255
3812,3774733620,3779425804,1672566035,1672567900,1865
3870,3305336154,3551389192,1672666117,1672666215,98
3722,3437286517,3776034743,1672662320,1672662531,211
3829,3336627643,3500341755,1672558149,1672560111,1962
3542,3516321888,3559731671,1672594033,1672595247,1214
3696,3755233658,3500949309,1672621959,1672624809,2850
3685,3630353876,3517288083,1672689980,1672692946,2966
3584,3244004456,3499217428,1672612273,1672613207,934
3672,3236354255,3928511283,1672675646,1672677317,1671
3578,3904867554,3755915206,1672662004,1672662374,370
3756,3713589994,3398731252,1672636473,1672639275,2802
3701,3491684096,3436025562,1672552927,1672554970,2043
3609,3774718695,3774733620,1672635382,1672637932,2550
3795,3803517637,3618808151,1672570055,1672570922,867
3765,3739154408,3279473441,1672602704,1672605815,3111
3838,3815250107,3773735484,1672556256,1672556891,635
3460,3780769110,3231713082,1672631993,1672635347,3354
3708,3279242917,3519651506,1672657021,1672660394,3373
3580,3439673892,3515402792,1672590034,1672592216,2182
3604,3791436104,3511024016,1672563056,1672563539,483
3482,3226178937,3904412440,1672683547,1672683662,115
3659,3457960571,3517600136,1672584636,1672585292,656
3494,3450286949,3853629553,1672614879,1672616443,1564
3889,3755573472,3615737355,1672605142,1672605938,796
3854,3757075324,3462636434,1672699885,1672702889,3004
3573,3680810086,3791106564,1672623969,1672626497,2528
3452,3403370192,3778040015,1672579827,1672581109,1282
3472,3479851674,3514324011,1672664107,1672664283,176
3450,3505663516,3927599181,1672573189,1672574695,1506
3530,3505179890,3511288998,1672551545,1672553319,1774
3760,3760640999,3534179433,1672645092,1672645701,609
3553,3899786664,3520560590,1672576244,1672577323,1079
3625,3921648519,3500317969,1672674981,1672676417,1436
3815,3408498208,3600876425,1672583049,1672583679,630
3431,3714666884,3791613604,1672693504,1672696991,3487
3580,3516903528,3500302272,1672618331,1672619734,1403
3661,3367111751,3979784676,1672577169,1672580269,3100
3646,3520355798,3500841914,1672600203,1672601972,1769
3597,3904412440,3431460073,1672553957,1672556149,2192
3912,3977148669,3898314440,1672688472,1672691321,2849
3443,3533649454,3514324011,1672643576,1672644991,1415
3571,3398198430,3441703884,1672683856,1672684909,1053
3815,3200543880,3791106564,1672613037,1672613246,209
3548,3714678331,3756625818,1672671946,1672673588,1642
3758,3333918941,3449639012,1672593056,1672593866,810
3719,3336627643,3200308999,1672674782,1672677070,2288
3913,3793175445,3621461051,1672691115,1672694069,2954
3825,3711919537,3755233658,1672690525,1672692286,1761
3658,3343816795,3610358027,1672552407,1672553810,1403
3532,3298151889,3778667336,1672681326,1672684048,2722
3683,3792801638,3792525861,1672680752,1672681044,292
3440,3451326054,3733363628,1672654455,1672657845,3390
3710,3610358027,3630353876,1672558195,1672558346,151
3860,3510919821,3776559988,1672586857,1672588985,2128
3920,3715443333,3468041839,1672689935,1672690268,333
3782,3793969543,3772236797,1672678191,1672680357,2166
3671,3417679834,3714067076,1672670261,1672671464,1203
3865,3621790707,3778926763,1672663982,1672665590,1608
3766,3834960360,3273981374,1672548450,1672551306,2856
3777,3436025562,3200308999,1672628540,1672631647,3107
3762,3513853403,3834960360,1672540965,1672542978,2013
3586,3780712350,3492959689,1672641441,1672644510,3069
3544,3715619259,3714233826,1672597385,1672599262,1877
3804,3500857494,3514818819,1672587660,1672589482,1822
3765,3791246640,3533423872,1672662052,1672663372,1320
3603,3701136026,3914691363,1672546195,1672549222,3027
3697,3499217428,3513018485,1672676289,1672678147,1858
3773,3770520359,3231713082,1672542426,1672545474,3048
3477,3513327337,3557046880,1672689175,1672689327,152
3895,3520991398,3500949309,1672674212,1672675677,1465
3819,3783801141,3299125059,1672638671,1672641555,2884
3752,3519446663,3927403123,1672657998,1672660923,2925
3436,3755344363,3514275974,1672625995,1672626574,579
3844,3793935736,3505437712,1672542140,1672544741,2601
3881,3299443125,3534829213,1672544284,1672546265,1981
3476,3518653080,3311420950,1672636625,1672639473,2848
3633,3336627643,3440137407,1672652207,1672653230,1023
3467,3714827719,3510499038,1672671132,1672673945,2813
3895,3231494505,3770676872,1672650250,1672651251,1001
3800,3338083680,3713561276,1672554898,1672557013,2115
3833,3626499450,3779854934,1672584985,1672588349,3364
3694,3853629553,3885121158,1672645164,1672645600,436
3898,3701884158,3770676872,1672603765,1672604706,941
3654,3613338363,3778134418,1672549179,1672549697,518
3545,3615939504,3203538212,1672648698,1672650737,2039
3918,3778667336,3226178937,1672632107,1672635222,3115
3646,3776034743,3500109249,1672659822,1672662009,2187
3532,3308760650,3772391882,1672629610,1672630706,1096
3719,3520115090,3236458894,1672585828,1672587081,1253
3816,3505521218,3515525630,1672553753,1672554718,965
3682,3839245934,3803517637,1672625759,1672628217,2458
3647,3428027649,3715545685,1672643269,1672644410,1141
3781,3791796585,3517288083,1672547956,1672548703,747
3475,3300511067,3520560590,1672615327,1672617727,2400
3658,3513410578,3615115210,1672561844,1672564552,2708
3797,3905899155,3660063072,1672584978,1672586728,1750
3510,3505481368,3505923418,1672592344,1672594417,2073
3640,3701882224,3500827202,1672653937,1672654927,990
3557,3715385401,3457960571,1672683383,1672683904,521
3603,3512882178,3701882224,1672664403,1672665126,723
3910,3792801638,3400763927,1672558436,1672561257,2821
3763,3516741440,3792538417,1672659416,1672662043,2627
3436,3977352557,3715443333,1672658201,1672658784,583
3867,3336339664,3270697740,1672680405,1672683075,2670
3778,3520657891,3617116290,1672603439,1672605757,2318
3677,3516321888,3834960360,1672617155,1672620351,3196
3723,3613206049,3226024417,1672536807,1672537735,928
3427,3891672228,3360813161,1672573176,1672575180,2004
3611,3510837901,3621683102,1672609553,1672610570,1017
3806,3600876425,3495911207,1672544952,1672547789,2837
3424,3516703758,3514741348,1672583717,1672585458,1741
3633,3757323954,3445206685,1672584211,1672584745,534
3661,3829864515,3351866415,1672635150,1672635669,519
3634,3271454397,3451691949,1672691299,1672693701,2402
3495,3774178201,3791128487,1672547914,1672550479,2565
3753,3513360004,3755158925,1672566187,1672567672,1485
3565,3792538417,3777485931,1672677722,1672677865,143
3531,3351696332,3891672228,1672675182,1672678227,3045
3465,3826238375,3448875382,1672589546,1672592973,3427
3490,3688220326,3780872464,1672574429,1672577392,2963
3456,3934064792,3206837348,1672532744,1672533776,1032
3777,3783433404,3777147510,1672696510,1672697823,1313
3646,3514324011,3938389661,1672541568,1672543159,1591
3466,3336627643,3774907131,1672559492,1672562600,3108
3620,3626499450,3241914067,1672661123,1672661798,675
3669,3347419520,3516703758,1672643163,1672643283,120
3655,3773033649,3780253901,1672681926,1672682577,651
3544,3776034743,3774605761,1672578278,1672579281,1003
3446,3791796585,3500857494,1672575195,1672577453,2258
3755,3711006062,3491684096,1672619973,1672622162,2189
3538,3611055563,3500709774,1672685160,1672687357,2197
3886,3688220326,3351866415,1672649761,1672649933,172
3916,3456430614,3701005527,1672671768,1672674353,2585
3456,3505847380,3716963089,1672576440,1672579248,2808
3910,3513081354,3491469603,1672674973,1672675910,937
3446,3793922324,3408430195,1672600937,1672603583,2646
3898,3701005527,3299443125,1672639364,1672639941,577
3852,3417679834,3774031303,1672568950,1672571829,2879
3875,3783641602,3517697722,1672568966,1672570038,1072
3828,3791246640,3859868849,1672611110,1672612537,1427
3553,3715707380,3231713082,1672594724,1672597674,2950
3504,3757318448,3240994288,1672538676,1672541725,3049
3445,3357289672,3371455553,1672538789,1672540971,2182
3855,3357289672,3347446226,1672642816,1672643565,749
3750,3713691388,3334951866,1672699930,1672702720,2790
3550,3618489670,3311420950,1672567655,1672567811,156
3646,3756789525,3289114629,1672584614,1672584965,351
3646,3774155692,3898314440,1672598778,1672601392,2614
3827,3491684096,3897456874,1672559497,1672562673,3176
3670,3510798825,3777694660,1672628486,1672630187,1701
3702,3500613459,3609881958,1672597962,1672598827,865
3544,3431460073,3510818674,1672651330,1672653962,2632
3441,3755158925,3205923620,1672638479,1672638727,248
3464,3905196766,3607768197,1672675044,1672675769,725
3463,3970603231,3300818269,1672614120,1672614824,704
3668,3505402439,3735374579,1672557866,1672559952,2086
3468,3334951866,3514818819,1672614368,1672614925,557
3820,3711637255,3517288083,1672618367,1672621349,2982
3864,3459681410,3312998540,1672622328,1672622734,406
3857,3394297564,3617392620,1672570538,1672571045,507
3911,3533228966,3633735593,1672657197,1672658856,1659
3723,3512379024,3505266860,1672634558,1672634858,300
3793,3887243870,3514334067,1672683729,1672687075,3346
3473,3517687662,3236458894,1672664087,1672665476,1389
3690,3472312341,3904569677,1672543589,1672546033,2444
3739,3296462324,3410600350,1672592983,1672595713,2730
3648,3371455553,3500915908,1672568283,1672570491,2208
3568,3915162005,3500498112,1672583418,1672585341,1923
3552,3770624662,3773735484,1672679093,1672682470,3377
3815,3773027597,3309314379,1672668735,1672669409,674
3730,3975717896,3274906650,1672552742,1672554467,1725
3559,3517600136,3512295534,1672609883,1672613019,3136
3810,3230868435,3760721303,1672619898,1672622317,2419
3542,3791046864,3779938251,1672647015,1672648442,1427
3489,3357689359,3779892400,1672580569,1672583299,2730
3516,3711000597,3773735484,1672548655,1672551494,2839
3585,3362641275,3272030610,1672642017,1672643609,1592
3653,3505521218,3225636215,1672569238,1672569533,295
3905,3791441520,3488763230,1672580667,1672581989,1322
3744,3292147449,3512830734,1672579106,1672580827,1721
3765,3533368789,3713784974,1672616800,1672617845,1045
3751,3912891315,3713517039,1672697303,1672698298,995
3729,3272096759,3667427125,1672655689,1672655925,236
3872,3520181148,3928511283,1672650009,1672652642,2633
3639,3730071479,3310125159,1672652180,1672653917,1737
3777,3448633776,3517288083,1672539408,1672541501,2093
3509,3311049964,3792274796,1672666239,1672668268,2029
3844,3463740710,3778926763,1672687767,1672688779,1012
3556,3817813340,3783340788,1672640772,1672644114,3342
3826,3236499444,3276003502,1672702663,1672703854,1191
3885,3515466096,3713941638,1672534277,1672534944,667
3586,3834631333,3710315160,1672663901,1672667219,3318
3654,3608232640,3518561777,1672666018,1672667765,1747
3503,3534179433,3791441520,1672568032,1672568136,104
3823,3512379024,3441703884,1672546233,1672548588,2355
3873,3510837901,3272716462,1672551977,1672552425,448
3856,3512946768,3399518841,1672635532,1672638384,2852
3796,3510642075,3609113156,1672618205,1672619411,1206
3528,3410160376,3208957949,1672535023,1672535963,940
3694,3534175249,3757332128,1672555915,1672557103,1188
3446,3770468980,3920497528,1672625176,1672625369,193
3752,3497808662,3774290799,1672677408,1672677941,533
3457,3605221116,3500857494,1672689374,1672690077,703
3757,3411515369,3757383891,1672599091,1672600235,1144
3445,3975717896,3371455553,1672555274,1672555925,651
3875,3756625818,3852533643,1672564889,1672568374,3485
3676,3231713082,3436025562,1672610043,1672612617,2574
3504,3611055563,3621184108,1672652143,1672653355,1212
3533,3415833929,3778040015,1672587980,1672588174,194
3897,3370227921,3296462324,1672633622,1672635243,1621
3759,3927403123,3667673649,1672552556,1672555795,3239
3761,3279475486,3780427126,1672560529,1672562799,2270
3515,3792389522,3517881647,1672622343,1672622451,108
3869,3455018347,3905899155,1672609530,1672610634,1104
3712,3774290799,3236354255,1672663429,1672664205,776
3744,3638660068,3485540729,1672544808,1672545261,453
3484,3312998540,3514956366,1672694811,1672696082,1271
3455,3737972328,3613899351,1672630137,1672632799,2662
3906,3310125159,3299443125,1672641522,1672645113,3591
3917,3501457103,3770704999,1672640455,1672643414,2959
3484,3792020993,3773735484,1672532484,1672535311,2827
3726,3792442597,3241914067,1672632706,1672635730,3024
3489,3509893027,3923420131,1672541434,1672542874,1440
3614,3713829743,3625174002,1672613310,1672614064,754
3904,3793175445,3519651506,1672640289,1672642130,1841
3857,3520560590,3289817992,1672537751,1672538089,338
3460,3487875183,3280268483,1672564066,1672566231,2165
3723,3382733096,3367111751,1672577384,1672579249,1865
3835,3793315718,3291933594,1672698966,1672701756,2790
3838,3824641227,3462158237,1672569423,1672572295,2872
3718,3902625986,3970558632,1672666363,1672668999,2636
3559,3517991730,3608232640,1672543404,1672545616,2212
3633,3492546679,3667673649,1672581558,1672583124,1566
3668,3777147510,3520355798,1672627339,1672630762,3423
3543,3441348818,3505283390,1672547033,1672550428,3395
3633,3777189898,3505434346,1672676466,1672677952,1486
3685,3509483172,3478114114,1672609601,1672610493,892
3673,3779532653,3730071479,1672551624,1672553811,2187
3624,3757348722,3510499038,1672551620,1672554756,3136
3894,3367509761,3852686295,1672640424,1672642479,2055
3875,3661447322,3551376095,1672659264,1672662087,2823
3543,3386758279,3556969573,1672666303,1672667555,1252
3568,3618697021,3463740710,1672575837,1672576740,903
3764,3515401243,3829822608,1672564668,1672567301,2633
3721,3305722859,3505178849,1672606539,1672609075,2536
3631,3557046880,3621683102,1672687739,1672690948,3209
3593,3772391882,3512379024,1672560066,1672561829,1763
3768,3793883863,3505434346,1672632163,1672635678,3515
3670,3831586487,3351866415,1672629867,1672630132,265
3475,3977148669,3384583385,1672590529,1672591363,834
3579,3205923620,3778040015,1672676422,1672679630,3208
3458,3688220326,3398198430,1672662836,1672664940,2104
3893,3627368399,3409114719,1672542250,1672544384,2134
3475,3760645796,3932478321,1672703440,1672705268,1828
3458,3225636215,3367111751,1672602354,1672605836,3482
3755,3812369928,3621461051,1672574712,1672577385,2673
3779,3928719932,3800257590,1672671120,1672672191,1071
3433,3611055563,3713768950,1672640631,1672641968,1337
3855,3201676087,3618489670,1672646675,1672648430,1755
3888,3689114185,3970603231,1672643710,1672646911,3201
3528,3347446226,3661583097,1672611500,1672614572,3072
3857,3755992176,3757193551,1672662488,1672664069,1581
3542,3756474459,3518229776,1672546796,1672548811,2015
3858,3793969543,3927403123,1672586732,1672586837,105
3540,3710854064,3668414677,1672676424,1672679266,2842
3543,3620292035,3533228966,1672697450,1672699558,2108
3660,3715443333,3776084820,1672652084,1672654669,2585
3849,3756789525,3899326793,1672695674,1672697251,1577
3528,3551389192,3236354255,1672533806,1672534099,293
3670,3713979100,3972083617,1672675571,1672677056,1485
3733,3664943873,3518229776,1672538577,1672541821,3244
3512,3757630221,3513345163,1672595343,1672598211,2868
3730,3756704774,3904867554,1672686641,1672688360,1719
3569,3609933747,3791106564,1672562850,1672563157,307
3843,3622357348,3938389661,1672620607,1672623007,2400
3503,3850911686,3449639012,1672697260,1672699872,2612
3891,3379143440,3622357348,1672668970,1672671442,2472
3445,3330340793,3202804048,1672602774,1672603141,367
3703,3783928182,3802932312,1672538407,1672540079,1672
3777,3613581796,3970909253,1672553620,1672554999,1379
3612,3900945856,3757863420,1672650670,1672653628,2958
3851,3715400486,3495911207,1672610264,1672613663,3399
3519,3793935736,3920898925,1672623851,1672627349,3498
3798,3226178937,3779613523,1672671824,1672672866,1042
3896,3779639983,3500109249,1672628932,1672632137,3205
3766,3408430195,3273981374,1672536061,1672538553,2492
3917,3701884158,3510767239,1672573782,1672574005,223
3653,3363162590,3668533536,1672534845,1672535150,305
3434,3618176292,3783771827,1672699632,1672700958,1326
3506,3491684096,3519909393,1672600637,1672603349,2712
3595,3429943738,3517881647,1672622090,1672623172,1082
3853,3488763230,3757332128,1672594523,1672596018,1495
3481,3480726047,3791128487,1672701341,1672703109,1768
3676,3551399764,3230135532,1672563073,1672565838,2765
3728,3416987084,3289114629,1672660919,1672663002,2083
3514,3497808662,3384583385,1672587799,1672591336,3537
3543,3774705415,3604867757,1672668352,1672670535,2183
3708,3472068734,3509483172,1672542135,1672544715,2580
3458,3236499444,3289114629,1672544924,1672548514,3590
3790,3935487534,3336627643,1672540417,1672542809,2392
3868,3716963089,3803389195,1672634847,1672638005,3158
3634,3209526819,3895285664,1672602269,1672602444,175
3921,3770624662,3711637255,1672610788,1672611648,860
3445,3668533536,3755404116,1672668146,1672671402,3256
3497,3505154885,3613581796,1672594518,1672597051,2533
3729,3424445495,3385323994,1672652546,1672655236,2690
3773,3511601997,3299781901,1672657382,1672659579,2197
3538,3501121099,3778640261,1672541162,1672541600,438
3491,3701136026,3411688875,1672649250,1672651411,2161
3643,3779438325,3533294425,1672698362,1672699173,811
3591,3279475486,3755222916,1672569225,1672570853,1628
3569,3814305099,3824215187,1672675480,1672678918,3438
3433,3371455553,3756474459,1672700153,1672700413,260
3860,3680810086,3716628503,1672603901,1672605910,2009
3639,3689114185,3713300120,1672681479,1672684398,2919
3693,3904867554,3626499450,1672619633,1672622015,2382
3666,3757383891,3715127070,1672628553,1672631673,3120
3603,3760651515,3715443333,1672696914,1672698210,1296
3922,3668533536,3303410628,1672699436,1672700473,1037
3766,3294747828,3701823816,1672630491,1672631795,1304
3580,3492959689,3229974066,1672577532,1672579123,1591
3516,3793583656,3755496114,1672552177,1672553782,1605
3803,3780872464,3779646172,1672694554,1672696722,2168
3470,3500857494,3808136029,1672620770,1672623043,2273
3571,3774605761,3626499450,1672545367,1672547434,2067
3541,3755496114,3510187271,1672597164,1672597295,131
3531,3892304880,3246370118,1672549166,1672549869,703
3674,3912891315,3760651515,1672588335,1672591617,3282
3771,3335694356,3516298579,1672599126,1672599905,779
3745,3559458968,3511883730,1672617843,1672620349,2506
3840,3792525861,3467988782,1672588566,1672589893,1327
3915,3366423342,3294703680,1672683578,1672685621,2043
3591,3392520516,3661583097,1672533477,1672536941,3464
3918,3298151889,3300818269,1672677302,1672679003,1701
3474,3711734586,3661447322,1672576062,1672578497,2435
3494,3667427125,3683113954,1672548162,1672549547,1385
3538,3354144091,3513296868,1672699717,1672701177,1460
3602,3500109249,3510554314,1672669404,1672672925,3521
3542,3467988782,3772078494,1672651612,1672655071,3459
3579,3400763927,3516513251,1672688279,1672688638,359
3601,3617392620,3755573472,1672544870,1672547872,3002
3593,3230868435,3374183227,1672603859,1672606727,2868
3458,3793969543,3534829213,1672638604,1672641174,2570
3428,3777814504,3829822608,1672636773,1672637569,796
3643,3626499450,3770468980,1672563742,1672564789,1047
3796,3715086894,3890739241,1672660118,1672663575,3457
3586,3450286949,3898314440,1672690612,1672694194,3582
3519,3209526819,3421385957,1672663563,1672665142,1579
3694,3885121158,3400763927,1672554932,1672555187,255
3810,3505521218,3732584121,1672605440,1672607292,1852
3496,3791246640,3208957949,1672587886,1672588232,346
3677,3734118023,3792538417,1672688463,1672690285,1822
3766,3770236215,3512958459,1672558021,1672561344,3323
3608,3609933747,3760694096,1672558578,1672558896,318
3789,3480991549,3375449013,1672588188,1672589086,898
3619,3380130228,3779465522,1672647164,1672649126,1962
3606,3500498112,3205985903,1672612360,1672613160,800
3895,3501525100,3608922867,1672590692,1672592975,2283
3601,3200308999,3505995057,1672604565,1672606585,2020
3832,3925979970,3757700712,1672594804,1672596343,1539
3494,3614740489,3834631333,1672683527,1672686715,3188
3865,3410160376,3500442734,1672674346,1672675259,913
3868,3446533960,3513545422,1672691763,1672693459,1696
3601,3500341755,3308760650,1672543547,1672543683,136
3568,3341893384,3500737582,1672588339,1672588776,437
3804,3755233658,3701247948,1672573797,1672576043,2246
3433,3772078494,3607882826,1672552275,1672552479,204
3790,3201629017,3772765746,1672642996,1672644381,1385
3887,3760651515,3337322736,1672667116,1672669674,2558
3809,3791106564,3774790271,1672600741,1672601960,1219
3856,3270697740,3271454397,1672600505,1672602186,1681
3867,3513360004,3505434346,1672580607,1672584060,3453
3631,3209481722,3519142371,1672647519,1672650051,2532
3703,3500672156,3387594369,1672628278,1672628607,329
3768,3467779445,3511317276,1672601652,1672602673,1021
3720,3757075324,3514246749,1672570642,1672571205,563
3470,3336627643,3778667336,1672696119,1672699152,3033
3890,3245232284,3621184108,1672690125,1672691081,956
3787,3920625129,3683113954,1672654991,1672656559,1568
3900,3715443333,3284932450,1672619726,1672622768,3042
3563,3904569677,3395201292,1672570379,1672570714,335
3583,3478114114,3755992176,1672550985,1672552538,1553
3893,3274831810,3689697817,1672660108,1672661905,1797
3823,3756789525,3711097754,1672666266,1672667501,1235
3502,3274906650,3289114629,1672550198,1672552958,2760
3677,3755737419,3390660440,1672544700,1672545822,1122
3548,3660887799,3701107228,1672664026,1672667422,3396
3858,3793743698,3731646673,1672684811,1672685659,848
3776,3533294425,3780909839,1672655808,1672658630,2822
3440,3411515369,3793743698,1672584830,1672586112,1282
3783,3615688740,3927403123,1672670105,1672673117,3012
3517,3780909839,3760651515,1672674788,1672675686,898
3739,3500613459,3366423342,1672549948,1672552567,2619
3762,3793969543,3534764451,1672646100,1672647277,1177
3433,3495911207,3817813340,1672585886,1672587137,1251
3846,3780571086,3604589802,1672588195,1672590822,2627
3451,3414940786,3732584121,1672595990,1672598244,2254
3839,3509893027,3226511603,1672618951,1672622317,3366
3452,3779465522,3625463628,1672614791,1672616784,1993
3771,3298151889,3716628503,1672692103,1672693651,1548
3624,3621184108,3463740710,1672629531,1672630564,1033
3817,3716963089,3934064792,1672598316,1672601790,3474
3653,3463849738,3733363628,1672560920,1672561637,717
3443,3970909253,3905196766,1672639387,1672642447,3060
3782,3885121158,3777779869,1672701872,1672705080,3208
3473,3468041839,3885155975,1672698943,1672700879,1936
3511,3792505974,3491469603,1672664583,1672665646,1063
3899,3613206049,3852533643,1672606328,1672607540,1212
3907,3774031303,3760263530,1672604263,1672605638,1375
3767,3460719322,3760694096,1672597034,1672599269,2235
3425,3783520186,3817813340,1672579194,1672581414,2220
3873,3927165965,3398198430,1672604548,1672605552,1004
3431,3478114114,3793740407,1672679776,1672681054,1278
3747,3975717896,3701664364,1672553356,1672555411,2055
3825,3609113156,3481640525,1672601066,1672603915,2849
3770,3500915908,3514512367,1672701695,1672702715,1020
3772,3711853996,3515890966,1672655541,1672658067,2526
3895,3410538749,3357864626,1672542361,1672545555,3194
3893,3309314379,3505923418,1672695336,1672696691,1355
3765,3304155815,3853629553,1672591070,1672591606,536
3437,3853629553,3501567772,1672599971,1672600837,866
3448,3780472203,3824641227,1672660935,1672662607,1672
3698,3660887799,3921648519,1672573767,1672576780,3013
3630,3408498208,3776988674,1672580886,1672581511,625
3802,3777189898,3272716462,1672655144,1672657574,2430
3575,3739154408,3401496246,1672671600,1672673445,1845
3821,3554186380,3500841914,1672698730,1672701922,3192
3467,3385323994,3739661856,1672590665,1672591290,625
3672,3270697740,3897456874,1672558422,1672558926,504
3569,3510499038,3276217799,1672701135,1672704279,3144
3773,3306175858,3439673892,1672545309,1672548800,3491
3584,3509366311,3500827202,1672618108,1672621530,3422
3795,3735374579,3517697722,1672610043,1672613035,2992
3668,3756704774,3399472693,1672662749,1672664382,1633
3776,3311085279,3738026330,1672676517,1672676912,395
3529,3778926763,3517590837,1672686795,1672690019,3224
3571,3688796737,3490214516,1672642667,1672643719,1052
3825,3921648519,3626499450,1672596193,1672598130,1937
3828,3755573472,3772078494,1672596500,1672597082,582
3576,3232208416,3495911207,1672560584,1672560707,123
3578,3533090502,3534126409,1672665983,1672667442,1459
3528,3755233658,3360069849,1672565707,1672568092,2385
3437,3773124276,3362641275,1672701266,1672702637,1371
3783,3714185969,3480726047,1672587922,1672588410,488
3770,3367509761,3756385685,1672581693,1672582288,595
3603,3520873221,3615115210,1672586937,1672588948,2011
3582,3900945856,3409114719,1672633599,1672636305,2706
3544,3343816795,3505995057,1672637044,1672639729,2685
3912,3734915241,3229822507,1672633733,1672635647,1914
3649,3891672228,3208957949,1672582794,1672584089,1295
3673,3778640261,3330340793,1672554008,1672555344,1336
3758,3668747074,3271752081,1672601820,1672603616,1796
3684,3357289672,3228888030,1672694382,1672695689,1307
3888,3711218296,3778040015,1672680769,1672681070,301
3604,3615113018,3899326793,1672584656,1672584987,331
3639,3501459390,3897456874,1672555690,1672556922,1232
3651,3470454332,3608922867,1672653807,1672654950,1143
3572,3831586487,3449639012,1672532787,1672535712,2925
3510,3501786419,3245232284,1672703179,1672705077,1898
3767,3780872464,3511843593,1672695221,1672695665,444
3873,3792801638,3774705415,1672561303,1672564768,3465
3789,3793781065,3927165965,1672538536,1672539780,1244
3464,3618489670,3392520516,1672591449,1672591988,539
3650,3462636434,3334993594,1672674616,1672675639,1023
3561,3306412634,3470454332,1672540169,1672540566,397
3453,3835985172,3661583097,1672597244,1672598797,1553
3913,3716628503,3244004456,1672625910,1672628103,2193
3482,3224811762,3501121099,1672678983,1672681009,2026
3901,3923220461,3510818674,1672552201,1672555261,3060
3531,3351866415,3304971369,1672564685,1672565307,622
3548,3737112297,3638204468,1672630671,1672633599,2928
3821,3412006598,3739154408,1672596741,1672598663,1922
3734,3755737419,3315279093,1672582684,1672583092,408
3873,3337362061,3685816610,1672598514,1672601805,3291
3675,3713517039,3505481368,1672686615,1672687565,950
3699,3734915241,3373089838,1672608734,1672611428,2694
3474,3778899160,3349739136,1672645412,1672648280,2868
3533,3800257590,3510798825,1672667151,1672668596,1445
3553,3760362417,3462273042,1672686759,1672689246,2487
3830,3310125159,3972083617,1672605395,1672607192,1797
3745,3513296868,3778667336,1672628102,1672630776,2674
3544,3501567772,3519028898,1672654355,1672656646,2291
3850,3513081354,3776988674,1672678419,1672681678,3259
3453,3396726504,3306412634,1672640721,1672643645,2924
3762,3230135532,3755737419,1672642460,1672644286,1826
3596,3783919913,3337362061,1672630115,1672630523,408
3477,3232208416,3279475486,1672557864,1672560576,2712
3607,3513065217,3731646673,1672558556,1672559831,1275
3801,3500703304,3777814504,1672621520,1672622671,1151
3460,3701107228,3505481368,1672610679,1672610760,81
3680,3711006062,3205923620,1672576387,1672577966,1579
3526,3505923418,3512383699,1672664084,1672665885,1801
3745,3885157459,3778134418,1672658916,1672662161,3245
3920,3517991730,3520873221,1672662192,1672665035,2843
3823,3855583256,3770704999,1672643918,1672647506,3588
3902,3311049964,3371455553,1672631533,1672633904,2371
3712,3783373154,3880926355,1672692642,1672695693,3051
3523,3220031931,3793781065,1672572968,1672575652,2684
3584,3774718695,3621461051,1672585858,1672585932,74
3594,3554944414,3505198734,1672540640,1672542694,2054
3474,3202141727,3778926763,1672674239,1672676460,2221
3582,3479851674,3780872464,1672663462,1672665715,2253
3531,3770624662,3715400486,1672580892,1672582326,1434
3908,3306175858,3757193307,1672597109,1672598372,1263
3770,3689697817,3383138270,1672532126,1672534065,1939
3760,3284932450,3715854030,1672670059,1672673531,3472
3919,3714233826,3815250107,1672650046,1672652373,2327
3887,3780115155,3819767045,1672701555,1672702294,739
3426,3519142371,3205985903,1672632925,1672633561,636
3538,3783340788,3779465522,1672628931,1672630014,1083
3432,3755065949,3225029895,1672538120,1672538610,490
3725,3715707380,3757193551,1672690133,1672692918,2785
3546,3777184389,3773121782,1672617392,1672618018,626
3549,3660887799,3783433404,1672594166,1672597601,3435
3531,3927165965,3739911441,1672664313,1672664862,549
3538,3379143440,3514324011,1672620667,1672621893,1226
3899,3777091903,3241914067,1672601400,1672602793,1393
3467,3608855425,3713517039,1672631398,1672632805,1407
3479,3333403880,3513360004,1672635077,1672636504,1427
3567,3518565331,3421385957,1672566402,1672567113,711
3918,3613899351,3791613604,1672616849,1672618651,1802
3881,3638204468,3701424609,1672617711,1672619046,1335
3893,3511601997,3757294769,1672647958,1672649638,1680
3458,3534543776,3224330592,1672612875,1672613206,331
3536,3755756564,3241914067,1672649526,1672651458,1932
3624,3500109249,3774641380,1672565859,1672568704,2845
3867,3617489344,3514512367,1672546042,1672549507,3465
3633,3500442734,3835985172,1672703065,1672703606,541
3566,3833217041,3202804048,1672573910,1672575725,1815
3638,3351866415,3439673892,1672677972,1672678472,500
3584,3517887477,3389634034,1672659927,1672660546,619
3578,3500915665,3780115155,1672553437,1672553833,396
3585,3855583256,3459681410,1672557885,1672558596,711
3899,3834960360,3793935736,1672685275,1672688104,2829
3875,3500302272,3757348722,1672686176,1672688749,2573
3817,3783771827,3520560590,1672554109,1672555257,1148
3482,3779301501,3931627862,1672645443,1672648351,2908
3836,3245232284,3374183227,1672702773,1672703125,352
3680,3509366311,3487875183,1672533367,1672534551,1184
3540,3520991398,3618697021,1672561245,1672561432,187
3912,3701322924,3512830734,1672645919,1672646999,1080
3451,3895285664,3398731252,1672532144,1672532957,813
3614,3792072681,3514275974,1672570732,1672573658,2926
3661,3351696332,3783433404,1672560148,1672562410,2262
3535,3773735484,3923754072,1672700041,1672703151,3110
3495,3885155975,3893912331,1672655832,1672657873,2041
3478,3714666884,3711637255,1672692474,1672694875,2401
3766,3305336154,3441348818,1672545149,1672545840,691
3596,3972083617,3414275042,1672621915,1672623975,2060
3517,3793868716,3447672935,1672558169,1672560966,2797
3475,3661447322,3513327337,1672632747,1672634780,2033
3618,3621461051,3512882178,1672562853,1672564810,1957
3424,3511791953,3927599181,1672652986,1672653476,490
3466,3774718695,3614740489,1672584467,1672587310,2843
3818,3513360004,3298151889,1672601815,1672604930,3115
3461,3912891315,3609933747,1672561727,1672563831,2104
3446,3511288998,3500072204,1672564788,1672567438,2650
3645,3520639768,3757318448,1672671938,1672673274,1336
3485,3932478321,3856606678,1672623103,1672624321,1218
3624,3711000597,3714233826,1672582815,1672584721,1906
3503,3783373154,3807212280,1672564022,1672566695,2673
3552,3774155692,3683113954,1672538227,1672540652,2425
3840,3512337405,3605221116,1672614768,1672614879,111
3536,3783340788,3554186380,1672624728,1672626231,1503
3443,3518229776,3609113156,1672592600,1672594181,1581
3707,3515525630,3472068734,1672565645,1672568254,2609
3512,3793935736,3835985172,1672617550,1672618114,564
3921,3897456874,3713517039,1672699798,1672702778,2980
3905,3757193307,3834963772,1672575410,1672576547,1137
3647,3241790910,3512722110,1672639157,1672641223,2066
3802,3824215187,3400069268,1672638489,1672639444,955
3551,3485540729,3514308235,1672555158,1672556270,1112
3546,3513041785,3501459390,1672603062,1672605324,2262
3815,3557046880,3457960571,1672613732,1672615941,2209
3839,3511317276,3347446226,1672628545,1672630417,1872
3542,3505178849,3517697722,1672625783,1672627662,1879
3546,3480991549,3514741348,1672628484,1672628874,390
3788,3826238375,3200308999,1672677970,1672681549,3579
3869,3518561777,3772236797,1672575795,1672577261,1466
3814,3713784974,3230135532,1672601339,1672602668,1329
3619,3618489670,3792072681,1672697789,1672699425,1636
3699,3520181148,3418448389,1672663592,1672663928,336
3565,3773902805,3554944414,1672681359,1672682488,1129
3782,3927403123,3380767040,1672614942,1672616338,1396
3463,3685816610,3520416075,1672650688,1672653220,2532
3903,3622357348,3920898925,1672629975,1672632029,2054
3879,3440107959,3711077927,1672629781,1672631779,1998
3900,3625463628,3714670620,1672650315,1672653247,2932
3456,3273981374,3611055563,1672579990,1672583025,3035
3776,3715854030,3533079336,1672652616,1672653047,431
3751,3517590837,3311049964,1672602930,1672604663,1733
3583,3414049538,3906536154,1672632983,1672634781,1798
3583,3778040015,3500044458,1672652410,1672655522,3112
3811,3512337405,3928719932,1672550354,1672551769,1415
3493,3488763230,3552824113,1672661456,1672663860,2404
3678,3780872464,3688220326,1672534655,1672535474,819
3895,3755992176,3428725843,1672638381,1672640599,2218
3528,3617392620,3516513251,1672671655,1672673424,1769
3821,3520322124,3416987084,1672569160,1672571147,1987
3651,3240394404,3513853403,1672650837,1672651067,230
3746,3777485931,3398731252,1672669330,1672671060,1730
3765,3459681410,3773027597,1672554786,1672556179,1393
3912,3241914067,3893912331,1672687468,1672687876,408
3866,3288762795,3770236215,1672600102,1672602557,2455
3915,3480726047,3385323994,1672541024,1672543871,2847
3738,3230135532,3774718695,1672590801,1672593287,2486
3695,3274906650,3491469603,1672652630,1672653386,756
3648,3512383699,3780909839,1672602708,1672602838,130
3911,3770704999,3201629017,1672634411,1672637559,3148
3542,3773902805,3770520359,1672702171,1672704620,2449
3834,3755992176,3519077659,1672624067,1672624418,351
3530,3467779445,3341893384,1672558381,1672559662,1281
3441,3462158237,3773124276,1672582901,1672583105,204
3446,3755230952,3933894942,1672589363,1672591433,2070
3677,3711097754,3500341755,1672680042,1672682902,2860
3872,3438078818,3608855425,1672590503,1672590990,487
3700,3780680950,3756746867,1672619540,1672623083,3543
3525,3619922891,3622665543,1672610725,1672611814,1089
3778,3774907131,3511442562,1672663456,1672664034,578
3677,3283492940,3793407963,1672535597,1672537921,2324
3880,3779465522,3638204468,1672556443,1672557888,1445
3440,3716679950,3516903528,1672683696,1672686654,2958
3691,3402697190,3792801638,1672668369,1672669112,743
3879,3394401087,3551376095,1672591034,1672593479,2445
3632,3608232640,3972192593,1672563899,1672564289,390
3662,3711097754,3772078494,1672616165,1672619725,3560
3496,3839245934,3270042456,1672688254,1672688747,493
3632,3680810086,3511883730,1672677646,1672679731,2085
3708,3418448389,3505634634,1672549201,1672551015,1814
3770,3341893384,3777694660,1672692627,1672695110,2483
3518,3773009828,3200308999,1672640790,1672643613,2823
3605,3770676872,3335694356,1672597059,1672600054,2995
3692,3349856820,3279339278,1672665010,1672668251,3241
3579,3852533643,3701664364,1672671961,1672674072,2111
3491,3609659642,3737972328,1672676856,1672678946,2090
3842,3469254160,3516703758,1672593926,1672597371,3445
3428,3793583656,3710008361,1672656246,1672658057,1811
3541,3773332082,3638660068,1672615349,1672617199,1850
3825,3551389192,3923220461,1672552351,1672554556,2205
3463,3515402792,3490029863,1672658994,1672661762,2768
3564,3512282789,3208957949,1672674692,1672677225,2533
3453,3618354185,3669146016,1672560953,1672563970,3017
3591,3920625129,3974674109,1672634638,1672636647,2009
3721,3500672156,3505521218,1672597767,1672597880,113
3856,3617116290,3500208903,1672634950,1672637075,2125
3487,3680810086,3783373154,1672622063,1672624989,2926
3429,3713768950,3756625818,1672667528,1672669588,2060
3752,3500442734,3511150845,1672662671,1672663605,934
3670,3711853996,3715974659,1672673183,1672673811,628
3826,3276217799,3970603231,1672548249,1672551098,2849
3547,3472312341,3513410578,1672666281,1672669762,3481
3786,3792442597,3272716462,1672548607,1672550769,2162
3888,3920497528,3853629553,1672674206,1672675332,1126
3662,3296462324,3500317969,1672601701,1672604789,3088
3538,3617116290,3916490839,1672597982,1672599494,1512
3806,3386758279,3852686295,1672667757,1672670905,3148
3907,3308760650,3716272919,1672548732,1672550085,1353
3775,3770704999,3793781065,1672613090,1672615254,2164
3506,3336339664,3772391882,1672546112,1672547928,1816
3665,3201676087,3517881647,1672563101,1672564623,1522
3671,3293835352,3241790910,1672629811,1672632425,2614
3476,3711000597,3316800320,1672573173,1672573608,435
3473,3714233826,3773027597,1672695057,1672697070,2013
3435,3774790271,3516513251,1672620078,1672621667,1589
3920,3421385957,3935399379,1672585990,1672589129,3139
3601,3979802715,3614740489,1672682250,1672682545,295
3514,3736231757,3500302272,1672690253,1672692054,1801
3460,3793175445,3500341755,1672658467,1672661688,3221
3789,3505154885,3294747828,1672670151,1672670766,615
3462,3500841914,3490214516,1672660329,1672661172,843
3848,3713300120,3631090677,1672649965,1672653039,3074
3427,3493017654,3777184389,1672630116,1672633669,3553
3502,3755065949,3774876004,1672648822,1672652307,3485
3836,3733558985,3783373154,1672659102,1672660510,1408
3457,3824641227,3715854030,1672562544,1672564500,1956
3713,3615688740,3517687662,1672690418,1672693206,2788
3770,3711006062,3970909253,1672568898,1672572298,3400
3452,3783340788,3351696332,1672628078,1672630410,2332
3818,3779532653,3517737088,1672597059,1672600333,3274
3624,3501786419,3390660440,1672608299,1672608593,294
3638,3665998641,3409114719,1672683709,1672684987,1278
3441,3517737088,3469254160,1672587518,1672590665,3147
3659,3534764451,3688796737,1672560002,1672562932,2930
3732,3783801141,3279242917,1672552741,1672555401,2660
3607,3779854934,3783801141,1672694322,1672694925,603
3753,3757863420,3505154885,1672551099,1672552486,1387
3843,3480100311,3410538749,1672600979,1672602678,1699
3635,3511601997,3514818819,1672600460,1672602575,2115
3774,3460719322,3755573472,1672608341,1672609788,1447
3591,3310125159,3780253901,1672564500,1672567646,3146
3655,3300979975,3500613493,1672654572,1672658119,3547
3735,3783801141,3334647380,1672567708,1672570219,2511
3837,3231713082,3760651515,1672700835,1672703984,3149
3445,3756789525,3298151889,1672605037,1672606976,1939
3836,3970909253,3622357348,1672590913,1672592736,1823
3670,3736705719,3701424609,1672562539,1672565083,2544
3495,3492959689,3714670620,1672577248,1672578639,1391
3821,3394401087,3519077659,1672700921,1672701602,681
3571,3835985172,3703348097,1672650963,1672653289,2326
3634,3703396825,3231494505,1672632803,1672634300,1497
3887,3632814465,3778597171,1672571865,1672572893,1028
3917,3783801141,3516444201,1672544471,1672545998,1527
3496,3500341755,3500827202,1672667740,1672670258,2518
3786,3739911441,3621184108,1672534464,1672536819,2355
3806,3703383853,3300229945,1672533360,1672536918,3558
3780,3209481722,3792014516,1672615883,1672617742,1859
3559,3713829743,3517881647,1672575726,1672576312,586
3804,3773572967,3436257398,1672544188,1672544979,791
3689,3776244398,3791106564,1672572173,1672573401,1228
3684,3777624586,3609113156,1672648121,1672648642,521
3903,3703396825,3417191856,1672556117,1672556973,856
3891,3517288083,3730071479,1672542019,1672545281,3262
3657,3625463628,3519416013,1672653217,1672656548,3331
3628,3401793306,3780253901,1672621540,1672623286,1746
3652,3905196766,3554944414,1672701436,1672704898,3462
3701,3510641433,3773939399,1672634953,1672636433,1480
3508,3500841914,3292147449,1672672427,1672673333,906
3469,3205985903,3714827719,1672558141,1672561161,3020
3758,3370227921,3701664364,1672691434,1672692883,1449
3605,3505154885,3240394404,1672697560,1672699001,1441
3899,3501121099,3716628503,1672641782,1672642753,971
3593,3661903000,3468041839,1672646492,1672647856,1364
3724,3505283390,3713768950,1672605301,1672608766,3465
3908,3274831810,3534357694,1672673734,1672674578,844
3794,3713691388,3783801141,1672601389,1672604483,3094
3804,3520560590,3512379024,1672635824,1672637194,1370
3638,3500347447,3360813161,1672687672,1672689875,2203
3851,3774155692,3613899351,1672588348,1672589360,1012
3496,3512392431,3516703758,1672677753,1672679169,1416
3728,3792538417,3303410628,1672672286,1672674143,1857
3780,3711077927,3517737088,1672699884,1672700945,1061
3734,3392836218,3534175249,1672643367,1672643503,136
3693,3701884158,3505995057,1672648715,1672650730,2015
3874,3518561777,3311085279,1672677266,1672679933,2667
3468,3437286517,3394401087,1672693686,1672696272,2586
3786,3512946768,3774243020,1672592881,1672595857,2976
3667,3516444201,3363162590,1672610620,1672611927,1307
3453,3428725843,3421877923,1672598937,1672599343,406
3474,3431460073,3776034743,1672551524,1672552699,1175
3883,3661903000,3770624662,1672549019,1672550123,1104
3598,3755915206,3511317276,1672605669,1672608210,2541
3652,3935487534,3609881958,1672572164,1672574770,2606
3719,3300818269,3519282716,1672687846,1672687928,82
3888,3893912331,3519416013,1672694646,1672695095,449
3744,3979802715,3501281016,1672562673,1672563251,578
3835,3467988782,3755404116,1672561273,1672563021,1748
3479,3520991398,3921648519,1672601040,1672601394,354
3866,3462158237,3511791953,1672697558,1672697626,68
3907,3780253901,3248058676,1672687259,1672689732,2473
3531,3401940259,3517288083,1672638634,1672642015,3381
3874,3501786419,3515402792,1672570269,1672572656,2387
3664,3202141727,3412006598,1672552151,1672555108,2957
3800,3209526819,3305336154,1672685612,1672687651,2039
3806,3449639012,3755065949,1672576176,1672577917,1741
3525,3970603231,3454277788,1672679716,1672680695,979
3668,3238288884,3776559988,1672569969,1672572837,2868
3857,3360616538,3834963772,1672545948,1672546366,418
3670,3244004456,3505283390,1672600635,1672604095,3460
3589,3270042456,3623266256,1672608611,1672610494,1883
3753,3439673892,3757193551,1672601626,1672603087,1461
3465,3440107959,3792020993,1672646625,1672648659,2034
3913,3760094385,3739661856,1672627096,1672629905,2809
3789,3817813340,3515402792,1672633786,1672634564,778
3865,3814305099,3500317969,1672607911,1672610276,2365
3804,3480490124,3334647380,1672626785,1672629427,2642
3508,3534357694,3931627862,1672687930,1672689597,1667
3696,3885157459,3533090502,1672650888,1672654443,3555
3916,3505179890,3401940259,1672641970,1672645497,3527
3853,3505634634,3793407963,1672538609,1672539420,811
3617,3512800570,3792442597,1672571065,1672574074,3009
3880,3732131656,3609113156,1672548327,1672551127,2800
3900,3757193551,3774790271,1672531506,1672533043,1537
3848,3513295938,3517737088,1672689979,1672691469,1490
3731,3803389195,3480991549,1672702223,1672705579,3356
3615,3229974066,3895285664,1672690197,1672692328,2131
3444,3780322355,3500613493,1672546124,1672549425,3301
3893,3783919913,3512392431,1672550385,1672550804,419
3838,3779639983,3792505974,1672654572,1672655422,850
3879,3711734586,3517687662,1672600866,1672603493,2627
3873,3803389195,3517590837,1672595808,1672598399,2591
3593,3818575661,3457620713,1672545064,1672548543,3479
3528,3891672228,3389634034,1672584532,1672585622,1090
3679,3225636215,3516903528,1672701130,1672702981,1851
3786,3510187271,3783169442,1672658215,1672658837,622
3651,3833217041,3512499658,1672570681,1672572861,2180
3685,3834963772,3737112297,1672607248,1672608097,849
3787,3684523966,3306175858,1672674330,1672675229,899
3864,3533649454,3713517039,1672584559,1672587823,3264
3913,3276217799,3202141727,1672535867,1672537144,1277
3890,3512499658,3757332128,1672663389,1672665156,1767
3919,3505228454,3299443125,1672601445,1672602077,632
3667,3517887477,3814305099,1672668672,1672669747,1075
3591,3916490839,3776559988,1672638321,1672641378,3057
3535,3715545685,3491684096,1672680357,1672681178,821
3564,3633735593,3493017654,1672664045,1672665938,1893
3449,3609933747,3231494505,1672677224,1672679142,1918
3827,3701823816,3710735406,1672621129,1672623145,2016
3611,3793407963,3347419520,1672696324,1672697017,693
3678,3776559988,3897456874,1672571550,1672574067,2517
3434,3612689556,3713768950,1672547841,1672550560,2719
3794,3519028898,3714185969,1672538095,1672539792,1697
3526,3500044458,3818575661,1672592758,1672593082,324
3741,3510187271,3475349791,1672689961,1672691664,1703
3428,3316800320,3384583385,1672623684,1672626087,2403
3438,3755230952,3604867757,1672600935,1672603627,2692
3467,3533423872,3436257398,1672547112,1672550160,3048
3523,3667673649,3519087371,1672633783,1672634607,824
3746,3770520359,3975717896,1672579631,1672580047,416
3848,3776988674,3887243870,1672616074,1672618707,2633
3473,3975717896,3703396825,1672586269,1672588195,1926
3623,3715707380,3311085279,1672603387,1672605319,1932
3540,3633735593,3299781901,1672649637,1672652536,2899
3662,3533004959,3357864626,1672546031,1672546091,60
3585,3716628503,3613206049,1672544260,1672547699,3439
3888,3731646673,3509483172,1672686822,1672688153,1331
3868,3776034743,3520991398,1672628709,1672630143,1434
3682,3533294425,3783433404,1672544652,1672545521,869
3622,3515401243,3435167810,1672624002,1672625589,1587
3849,3401793306,3364378127,1672539073,1672540915,1842
3555,3520873221,3236354255,1672539542,1672541873,2331
3618,3661903000,3534357694,1672535448,1672536871,1423
3674,3770438122,3501567772,1672702396,1672705744,3348
3710,3773027597,3236458894,1672618633,1672621123,2490
3830,3778667336,3904412440,1672601107,1672602227,1120
3443,3701322924,3438078818,1672602154,1672605217,3063
3474,3500841914,3791046864,1672544267,1672546971,2704
3846,3509366311,3620292035,1672686497,1672689277,2780
3517,3757294769,3500949309,1672683145,1672683314,169
3673,3779532653,3739911441,1672691351,1672691788,437
3596,3778134418,3900898992,1672615011,1672617705,2694
3611,3713691388,3779786641,1672594001,1672597180,3179
3892,3639050419,3500777439,1672559144,1672561487,2343
3712,3703139663,3972192593,1672683596,1672683887,291
3617,3780834916,3777240360,1672555950,1672556471,521
3645,3349856820,3505807416,1672583351,1672585529,2178
3643,3431460073,3551399764,1672580354,1672583823,3469
3848,3760263530,3791441520,1672628679,1672631455,2776
3628,3938389661,3605221116,1672614675,1672614949,274
3881,3462273042,3780115155,1672563266,1672564684,1418
3728,3399518841,3716110860,1672623902,1672624561,659
3563,3779656423,3793935736,1672647029,1672647482,453
3844,3380130228,3512882178,1672598666,1672601161,2495
3559,3512946768,3680843171,1672674389,1672675153,764
3839,3394401087,3938389661,1672581524,1672582224,700
3750,3618697021,3272096759,1672609361,1672609677,316
3484,3755344363,3288762795,1672665132,1672666753,1621
3729,3519416013,3520115090,1672576733,1672578475,1742
3635,3520355798,3630353876,1672555871,1672556296,425
3916,3509893027,3500302272,1672675744,1672677042,1298
3472,3935913584,3609659642,1672639122,1672639235,113
3887,3780209375,3410600350,1672693123,1672696366,3243
3662,3713163045,3357689359,1672535191,1672536685,1494
3882,3517222913,3499217428,1672550825,1672551998,1173
3792,3755848152,3780338697,1672680959,1672683995,3036
3516,3904412440,3514275974,1672673450,1672674680,1230
3919,3715086894,3500604680,1672574444,1672576492,2048
3857,3512383699,3972192593,1672593152,1672595302,2150
3752,3928511283,3334993594,1672538000,1672541048,3048
3581,3716272919,3294747828,1672634007,1672634075,68
3477,3205985903,3225636215,1672620611,1672622994,2383
3606,3701107228,3500317969,1672629654,1672631945,2291
3609,3760694096,3778597171,1672545093,1672545597,504
3690,3711919537,3780209375,1672561809,1672563238,1429
3693,3431502855,3716272919,1672569270,1672571907,2637
3682,3306412634,3505725706,1672558446,1672560372,1926
3909,3236499444,3623266256,1672660517,1672660687,170
3524,3755915206,3783919913,1672695938,1672696234,296
3831,3379143440,3310125159,1672536097,1672537335,1238
3692,3818575661,3715086894,1672644446,1672646413,1967
3745,3351696332,3668533536,1672668752,1672669595,843
3443,3510499038,3400069268,1672676268,1672676829,561
3653,3639050419,3689114185,1672662408,1672663353,945
3654,3927599181,3615737355,1672631879,1672633444,1565
3594,3779301501,3512502036,1672561382,1672564876,3494
3616,3457620713,3300511067,1672664459,1672667088,2629
3495,3665998641,3736231757,1672638851,1672641313,2462
3580,3501786419,3520873221,1672583384,1672585190,1806
3721,3733363628,3490214516,1672607075,1672610586,3511
3898,3760263530,3488686442,1672690820,1672694020,3200
3478,3760842815,3906536154,1672562169,1672565374,3205
3594,3703798634,3467988782,1672673103,1672675256,2153
3506,3756625818,3713784974,1672686168,1672689298,3130
3889,3519077659,3279339278,1672692048,1672694199,2151
3821,3731646673,3792389522,1672600870,1672603798,2928
3518,3791046864,3500915665,1672616934,1672617007,73
3697,3512282789,3357689359,1672631750,1672632085,335
3623,3716272919,3791796585,1672542205,1672543923,1718
3707,3792525861,3294747828,1672658065,1672658739,674
3690,3533747868,3853629553,1672562902,1672564794,1892
3705,3501457103,3905899155,1672689058,1672690259,1201
3887,3415833929,3778597171,1672598723,1672599927,1204
3793,3505847380,3512958459,1672620626,1672623971,3345
3563,3776244398,3609933747,1672654080,1672656965,2885
3793,3500525825,3626499450,1672610306,1672613488,3182
3566,3480991549,3512722110,1672696449,1672697897,1448
3878,3514308235,3615939504,1672604194,1672606530,2336
3606,3682133690,3421385957,1672587607,1672590511,2904
3459,3500208903,3364726656,1672684556,1672685860,1304
3918,3500604680,3921648519,1672638491,1672639434,943
3430,3519416013,3823084403,1672693402,1672694062,660
3433,3505923418,3500604680,1672541962,1672543216,1254
3790,3500208903,3735374579,1672627128,1672629392,2264
3914,3418448389,3511317276,1672543068,1672546092,3024
3790,3793922324,3604589802,1672611392,1672611643,251
3748,3715086894,3757348722,1672680852,1672682545,1693
3762,3410538749,3933894942,1672611147,1672612725,1578
3701,3730071479,3661447322,1672681623,1672683080,1457
3890,3357289672,3935399379,1672556687,1672557134,447
3824,3389634034,3774178201,1672703343,1672705002,1659
3501,3633735593,3713517039,1672663660,1672667064,3404
3879,3520578796,3394401087,1672693218,1672694151,933
3602,3895285664,3395201292,1672576795,1672577831,1036
3568,3454277788,3716679950,1672690766,1672694170,3404
3739,3343132529,3927165965,1672591007,1672592319,1312
3895,3715545685,3418448389,1672699128,1672702479,3351
3437,3714666884,3715854030,1672691764,1672693698,1934
3718,3516444201,3414049538,1672678123,1672679790,1667
3681,3400069268,3500317969,1672574849,1672577280,2431
3608,3201676087,3711097754,1672601850,1672602411,561
3606,3780338697,3772078494,1672551000,1672552699,1699
3878,3300511067,3481640525,1672623285,1672626596,3311
3620,3713784974,3520657891,1672655910,1672657559,1649
3901,3735374579,3357689359,1672611783,1672614153,2370
3437,3367111751,3713979100,1672642878,1672644394,1516
3616,3935399379,3533228966,1672691899,1672693278,1379
3431,3418448389,3438489358,1672560509,1672562985,2476
3505,3462273042,3680843171,1672644724,1672645796,1072
3873,3554186380,3271752081,1672604391,1672605861,1470
3813,3703396825,3783147088,1672673558,1672675929,2371
3920,3774705415,3416987084,1672587035,1672588350,1315
3875,3272096759,3604589802,1672596224,1672596434,210
3686,3755496114,3228888030,1672614580,1672616118,1538
3498,3776084820,3636329663,1672643026,1672645831,2805
3850,3778667336,3638204468,1672553226,1672554980,1754
3826,3513410578,3774876004,1672591860,1672594656,2796
3591,3669146016,3935399379,1672589878,1672592515,2637
3545,3505111292,3884596900,1672672497,1672672916,419
3584,3519651506,3500672156,1672647208,1672647779,571
3647,3334647380,3311420950,1672539916,1672540839,923
3668,3517687662,3461119815,1672642508,1672643618,1110
3685,3773572967,3621461051,1672694260,1672697436,3176
3746,3480726047,3270697740,1672601452,1672602411,959
3883,3900945856,3737112297,1672564153,1672567146,2993
3692,3776084820,3774733620,1672614632,1672616275,1643
3577,3439673892,3897134762,1672603540,1672606881,3341
3525,3935913584,3408498208,1672582831,1672584175,1344
3753,3554944414,3515439826,1672629928,1672632740,2812
3702,3889780657,3463740710,1672541144,1672544506,3362
3739,3516513251,3279242917,1672666908,1672668233,1325
3764,3514246749,3557046880,1672600975,1672603693,2718
3460,3703798634,3441348818,1672642804,1672646394,3590
3751,3229822507,3510818674,1672622424,1672625312,2888
3724,3756746867,3701664364,1672625045,1672626337,1292
3541,3755915206,3710048469,1672606683,1672608853,2170
3556,3715986185,3446533960,1672602551,1672605125,2574
3693,3701247948,3452016771,1672653129,1672654185,1056
3806,3621184108,3710315160,1672569568,1672570809,1241
3916,3244004456,3311049964,1672691030,1672691423,393
3498,3920625129,3511005395,1672631818,1672632754,936
3620,3617304541,3807212280,1672595990,1672597274,1284
3743,3516513251,3617392620,1672631781,1672632831,1050
3700,3511317276,3480100311,1672688374,1672691328,2954
3431,3310039260,3272096759,1672703174,1672704958,1784
3717,3779301501,3394297564,1672642999,1672644021,1022
3595,3683113954,3895285664,1672681321,1672683356,2035
3836,3909094917,3778640261,1672659244,1672660226,982
3778,3834960360,3517600136,1672582106,1672585555,3449
3759,3505995057,3312998540,1672700038,1672701623,1585
3728,3520355798,3755532873,1672538631,1672539412,781
3904,3270056120,3777814504,1672538644,1672541807,3163
3557,3834960360,3755532873,1672631867,1672635394,3527
3710,3509764635,3710489491,1672563242,1672564557,1315
3893,3238288884,3859868849,1672566449,1672568778,2329
3529,3505111292,3515402792,1672564414,1672565587,1173
3829,3435116799,3733558985,1672633038,1672633528,490
3674,3224968597,3513296868,1672616441,1672619283,2842
3556,3774907131,3834963772,1672638079,1672641313,3234
3476,3516513251,3500949309,1672587581,1672588948,1367
3758,3611055563,3615939504,1672585063,1672587376,2313
3655,3500703304,3715545685,1672629583,1672633167,3584
3881,3713784974,3500347447,1672533748,1672535564,1816
3607,3400069268,3793883863,1672583488,1672585421,1933
3866,3624297844,3625463628,1672673941,1672677094,3153
3561,3441348818,3500208903,1672615621,1672616451,830
3522,3435116799,3516513251,1672547921,1672550293,2372
3720,3533649454,3618697021,1672641067,1672643203,2136
3838,3711000597,3686227677,1672556312,1672559620,3308
3770,3683113954,3686227677,1672546836,1672547103,267
3430,3512499658,3410600350,1672607334,1672608622,1288
3638,3974674109,3500915908,1672566830,1672567993,1163
3557,3462636434,3451726367,1672601781,1672603134,1353
3849,3517600136,3357289672,1672533246,1672533405,159
3902,3448633776,3271454397,1672564334,1672566681,2347
3497,3270697740,3500208903,1672588852,1672589142,290
3805,3400763927,3668533536,1672640231,1672641030,799
3799,3315279093,3686227677,1672662284,1672664382,2098
3633,3517172354,3441348818,1672599305,1672601753,2448
3493,3710562338,3760694096,1672658636,1672659195,559
3880,3735374579,3238288884,1672636639,1672640148,3509
3686,3688220326,3519142371,1672701074,1672704436,3362
3638,3773033649,3337322736,1672662199,1672664221,2022
3693,3710008361,3280268483,1672663065,1672665883,2818
3811,3511843593,3756127300,1672535877,1672536352,475
3487,3926643445,3240394404,1672590656,1672594123,3467
3886,3701373490,3509366311,1672582596,1672585572,2976
3724,3760263530,3436257398,1672588267,1672589232,965
3734,3776117322,3501384020,1672627081,1672628967,1886
3643,3232208416,3637313265,1672644647,1672645476,829
3583,3774031303,3505434346,1672656353,1672658326,1973
3684,3710008361,3514324011,1672604950,1672605898,948
3843,3938503547,3509764635,1672578202,1672579717,1515
3873,3517600136,3938389661,1672620048,1672622221,2173
3861,3710562338,3509756823,1672680152,1672681631,1479
3560,3315703693,3900945856,1672590531,1672592057,1526
3816,3514818819,3792525861,1672641133,1672643233,2100
3738,3793315718,3778640261,1672644666,1672646095,1429
3721,3711812325,3510837901,1672674861,1672675025,164
3794,3439673892,3200308999,1672536403,1672536854,451
3595,3739895284,3803389195,1672666655,1672667852,1197
3531,3613899351,3513081354,1672545823,1672547572,1749
3671,3505634634,3510964997,1672655032,1672658216,3184
3921,3880926355,3271454397,1672581473,1672581639,166
3817,3972192593,3779738691,1672557777,1672557984,207
3906,3792538417,3897376951,1672607475,1672609374,1899
3842,3770468980,3270056120,1672550327,1672551821,1494
3887,3293835352,3512800570,1672680384,1672681512,1128
3472,3783373154,3398198430,1672640503,1672640956,453
3785,3730071479,3713561276,1672645067,1672645512,445
3693,3777037426,3710496785,1672612994,1672614279,1285
3443,3703139663,3224811762,1672605033,1672606292,1259
3879,3757193307,3230135532,1672607911,1672608441,530
3783,3500044458,3713163045,1672588155,1672589050,895
3485,3661447322,3462636434,1672586112,1672588198,2086
3581,3367971170,3932478321,1672569340,1672570941,1601
3780,3518194482,3668414677,1672634720,1672638041,3321
3701,3274831810,3513853403,1672581409,1672583309,1900
3651,3792020993,3834960360,1672675883,1672677219,1336
3685,3661903000,3470454332,1672613989,1672616602,2613
3922,3612689556,3713829743,1672548579,1672548682,103
3585,3512295534,3446533960,1672635623,1672636402,779
3772,3755532873,3393063657,1672696124,1672697601,1477
3865,3938503547,3755737419,1672549703,1672552732,3029
3506,3831586487,3780322355,1672660283,1672662689,2406
3607,3292147449,3779613523,1672550971,1672554294,3323
3770,3505807416,3617304541,1672634327,1672636298,1971
3753,3774733620,3609933747,1672691635,1672694993,3358
3689,3274831810,3371455553,1672598340,1672601120,2780
3813,3312998540,3716963089,1672653774,1672657184,3410
3854,3776084820,3510499038,1672623487,1672625981,2494
3796,3756746867,3300511067,1672604916,1672605741,825
3599,3294747828,3902760230,1672598622,1672602021,3399
3833,3519142371,3396980894,1672654270,1672656742,2472
3642,3533090502,3396980894,1672561750,1672563168,1418
3618,3833217041,3357289672,1672667271,1672669655,2384
3463,3970909253,3335694356,1672601859,1672605052,3193
3596,3780209375,3467988782,1672604374,1672606030,1656
3870,3776084820,3462273042,1672531594,1672534335,2741
3460,3410538749,3927403123,1672555311,1672557959,2648
3833,3938389661,3228888030,1672558949,1672561421,2472
3663,3384583385,3520115090,1672538891,1672540665,1774
3841,3511288998,3312998540,1672591709,1672591836,127
3727,3367111751,3519651506,1672548752,1672549942,1190
3700,3226024417,3824641227,1672562176,1672564756,2580
3468,3446533960,3319167958,1672533457,1672535693,2236
3902,3760040019,3774733620,1672557304,1672558715,1411
3851,3713941638,3231713082,1672662149,1672663990,1841
3502,3514285803,3792442597,1672664753,1672666158,1405
3482,3445206685,3270697740,1672636805,1672638664,1859
3786,3639050419,3334951866,1672587515,1672588340,825
3764,3236499444,3338083680,1672631531,1672634307,2776
3579,3909094917,3885537225,1672625839,1672627648,1809
3514,3755915206,3513545422,1672670213,1672673151,2938
3778,3855583256,3778134418,1672622307,1672624910,2603
3740,3703348097,3500302272,1672640364,1672643514,3150
3719,3780427126,3500442734,1672566470,1672569474,3004
3574,3533188828,3814305099,1672544523,1672546419,1896
3872,3660887799,3220031931,1672668878,1672671930,3052
3693,3311420950,3885537225,1672579941,1672582784,2843
3659,3446533960,3834963772,1672543768,1672546398,2630
3809,3557046880,3770438122,1672535729,1672538218,2489
3840,3273981374,3615115210,1672699941,1672701872,1931
3590,3970558632,3779465522,1672604776,1672605416,640
3580,3500302272,3480100311,1672553368,1672555328,1960
3427,3205923620,3463740710,1672653117,1672654802,1685
3820,3236499444,3792020993,1672558068,1672559551,1483
3435,3248058676,3715127070,1672575756,1672577117,1361
3435,3500949309,3756385685,1672614207,1672616254,2047
3583,3638204468,3500317969,1672603477,1672603912,435
3778,3517600136,3510641433,1672647196,1672647829,633
3810,3505198734,3411515369,1672553330,1672555466,2136
3587,3609933747,3737972328,1672537301,1672537675,374
3504,3533274994,3688220326,1672532995,1672534522,1527
3875,3783641602,3783771827,1672700162,1672702964,2802
3757,3505434346,3803389195,1672662925,1672663052,127
3743,3533929349,3449333754,1672539892,1672541114,1222
3898,3773009828,3779639983,1672638156,1672638309,153
3612,3711637255,3500341755,1672702959,1672705770,2811
3575,3386758279,3779639983,1672582994,1672585454,2460
3772,3389634034,3623266256,1672660174,1672663584,3410
3703,3608232640,3618176292,1672676645,1672678971,2326
3813,3689114185,3311498666,1672663927,1672664084,157
3700,3552824113,3509764635,1672551234,1672553996,2762
3597,3818575661,3370227921,1672552307,1672554437,2130
3439,3783136330,3315279093,1672619970,1672622135,2165
3439,3736705719,3517172354,1672538804,1672540206,1402
3837,3774705415,3774243020,1672607887,1672609805,1918
3617,3500915908,3316798920,1672671968,1672673374,1406
3804,3755230952,3410160376,1672533644,1672536594,2950
3437,3791106564,3802932312,1672631881,1672633456,1575
3733,3661583097,3513296868,1672609928,1672610625,697
3574,3824641227,3501121099,1672557397,1672560590,3193
3757,3885155975,3814677862,1672585230,1672586535,1305
3540,3701136026,3382733096,1672676335,1672677818,1483
3513,3777240360,3488763230,1672611707,1672612818,1111
3497,3440107959,3201629017,1672594968,1672597088,2120
3818,3240994288,3289817992,1672546460,1672548380,1920
3575,3414049538,3512830734,1672583812,1672587337,3525
3642,3715619259,3757323954,1672684206,1672686873,2667
3883,3385323994,3309314379,1672543139,1672544204,1065
3573,3505521218,3760694096,1672556638,1672558968,2330
3893,3509366311,3533090502,1672555466,1672558520,3054
3836,3311085279,3715127070,1672568134,1672570290,2156
3787,3823084403,3803517637,1672634293,1672637261,2968
3664,3710489491,3755573472,1672670044,1672673509,3465
3484,3367509761,3512882178,1672609227,1672612255,3028
3799,3517590837,3517737088,1672608471,1672609174,703
3862,3618354185,3755496114,1672688499,1672689351,852
3778,3664943873,3367111751,1672657117,1672658021,904
3428,3505995057,3366423342,1672697874,1672698313,439
3440,3383138270,3632814465,1672596671,1672598562,1891
3897,3403370192,3292147449,1672582931,1672584291,1360
3905,3229822507,3368283077,1672590031,1672593616,3585
3452,3333918941,3304155815,1672567912,1672570861,2949
3505,3776559988,3517881647,1672650838,1672652890,2052
3533,3398731252,3512337405,1672688589,1672690580,1991
3870,3710048469,3713768950,1672677666,1672680499,2833
3741,3622357348,3487875183,1672534114,1672535252,1138
3891,3778640261,3979784676,1672598747,1672598866,119
3708,3833217041,3534179433,1672662013,1672664220,2207
3762,3703383853,3734118023,1672597562,1672598666,1104
3702,3500347447,3436025562,1672601073,1672603140,2067
3644,3231494505,3755404116,1672606386,1672608659,2273
3525,3757863420,3511442562,1672564109,1672566249,2140
3660,3779646172,3236458894,1672677468,1672678669,1201
3520,3510499038,3733558985,1672617779,1672618393,614
3658,3488686442,3513360004,1672697751,1672700768,3017
3835,3711812325,3511732493,1672558951,1672561471,2520
3871,3511442562,3457620713,1672662071,1672663076,1005
3922,3774178201,3280054198,1672631438,1672633482,2044
3525,3224330592,3660063072,1672648113,1672650678,2565
3502,3855583256,3283770991,1672616237,1672619794,3557
3910,3440107959,3274906650,1672535499,1672536715,1216
3725,3414940786,3512800570,1672636583,1672639348,2765
3830,3501215099,3505725706,1672624266,1672626860,2594
3862,3518194482,3280054198,1672699405,1672701742,2337
3718,3480100311,3520657891,1672569950,1672573239,3289
3648,3622665543,3701005527,1672574137,1672575110,973
3841,3552824113,3384068080,1672544603,1672544890,287
3549,3462636434,3783136330,1672549001,1672552528,3527
3696,3792505974,3399472693,1672610229,1672610637,408
3473,3335694356,3500302272,1672595134,1672596734,1600
3834,3890739241,3385323994,1672569724,1672573228,3504
3856,3703348097,3792525861,1672694758,1672697095,2337
3688,3511317276,3380982774,1672700142,1672702727,2585
3449,3534179433,3512722110,1672672157,1672673681,1524
3664,3773121782,3505228454,1672657066,1672660626,3560
3642,3376467719,3909094917,1672551778,1672552019,241
3863,3230135532,3773121782,1672700056,1672701527,1471
3745,3515890966,3279475486,1672640953,1672642537,1584
3754,3819767045,3384583385,1672636201,1672637373,1172
3755,3306412634,3622357348,1672659587,1672661084,1497
3684,3858172636,3360616538,1672619147,1672620919,1772
3580,3513065217,3491469603,1672627240,1672629619,2379
3686,3791128487,3773572967,1672617904,1672619863,1959
3720,3823084403,3459681410,1672642559,1672646068,3509
3591,3703348097,3463740710,1672667248,1672669084,1836
3828,3479851674,3510964997,1672582312,1672585440,3128
3544,3835985172,3807212280,1672590953,1672591254,301
3759,3921648519,3364726656,1672644587,1672646278,1691
3631,3514285803,3760645796,1672619995,1672621703,1708
3768,3516444201,3500737582,1672674282,1672677552,3270
3662,3520416075,3514246749,1672646973,1672647569,596
3821,3208452238,3793740407,1672588515,1672590411,1896
3658,3926643445,3703383853,1672558529,1672559634,1105
3904,3373089838,3480991549,1672634813,1672637260,2447
3667,3396726504,3451726367,1672591796,1672592875,1079
3780,3909094917,3732584121,1672565572,1672567404,1832
3537,3770438122,3609881958,1672564443,1672566504,2061
3609,3501786419,3341893384,1672673388,1672673586,198
3686,3776244398,3514971533,1672555380,1672557197,1817
3633,3279473441,3517590837,1672688966,1672689854,888
3739,3970909253,3755848152,1672592014,1672593633,1619
3693,3833217041,3791613604,1672605042,1672606069,1027
3840,3517737088,3757323954,1672649663,1672652028,2365
3609,3793418209,3689697817,1672700483,1672700560,77
3855,3241790910,3701107228,1672691778,1672695038,3260
3752,3514308235,3517887477,1672659870,1672661207,1337
3621,3713941638,3755532873,1672700812,1672701932,1120
3501,3773124276,3428027649,1672619575,1672619973,398
3738,3384068080,3620292035,1672534153,1672536693,2540
3745,3791436104,3519818818,1672546278,1672546798,520
3574,3971806004,3229822507,1672562013,1672564829,2816
3737,3364726656,3448875382,1672679678,1672682273,2595
3431,3501215099,3400069268,1672595062,1672597536,2474
3584,3757193307,3710562338,1672681942,1672683280,1338
3698,3518561777,3793935736,1672560124,1672563506,3382
3593,3517358573,3517687662,1672659280,1672661063,1783
3726,3756704774,3245232284,1672701153,1672701738,585
3875,3460719322,3510554314,1672587949,1672588580,631
3609,3201629017,3520657891,1672603432,1672605451,2019
3627,3513018485,3807212280,1672645674,1672645765,91
3687,3732131656,3791693821,1672617294,1672619044,1750
3686,3481640525,3244004456,1672542955,1672545158,2203
3768,3777189898,3716628503,1672676347,1672678684,2337
3548,3201676087,3615688740,1672670454,1672673949,3495
3593,3773837847,3779438325,1672610347,1672612909,2562
3826,3440107959,3298151889,1672589431,1672592177,2746
3841,3892304880,3551376095,1672562267,1672563163,896
3750,3511791953,3368283077,1672632359,1672634707,2348
3684,3319167958,3274831810,1672573632,1672576846,3214
3778,3757383891,3774178201,1672657566,1672658710,1144
3827,3509483172,3635169815,1672558583,1672560571,1988
3581,3517222913,3448875382,1672696367,1672699932,3565
3916,3336627643,3855583256,1672687694,1672690370,2676
3801,3898314440,3241790910,1672615528,1672616831,1303
3851,3625174002,3367509761,1672663640,1672664417,777
3831,3773837847,3516703758,1672605960,1672606458,498
3586,3270056120,3814677862,1672623487,1672625906,2419
3726,3438489358,3315703693,1672692966,1672695488,2522
3459,3372223551,3443357683,1672606064,1672606763,699
3460,3519077659,3505402439,1672551891,1672552013,122
3555,3779465522,3392836218,1672699523,1672700514,991
3596,3711097754,3414049538,1672641955,1672643824,1869
3894,3512502036,3511288998,1672615575,1672617399,1824
3514,3780680950,3533747868,1672535094,1672536035,941
3787,3520991398,3780872464,1672661448,1672664294,2846
3899,3272096759,3400763927,1672574595,1672577394,2799
3507,3462636434,3231713082,1672532054,1672534180,2126
3761,3505634634,3490029863,1672701680,1672704750,3070
3458,3462636434,3668747074,1672664392,1672666878,2486
3687,3270056120,3230135532,1672539115,1672541948,2833
3492,3607882826,3792072681,1672613724,1672615449,1725
3690,3513081354,3783147088,1672613238,1672613835,597
3886,3626499450,3512946768,1672679681,1672683167,3486
3885,3241914067,3517881647,1672533781,1672536410,2629
3895,3362641275,3519850727,1672618086,1672619295,1209
3576,3447672935,3823084403,1672577946,1672580655,2709
3835,3512499658,3232208416,1672615303,1672617453,2150
3858,3755496114,3505888598,1672545319,1672545394,75
3434,3701664364,3273981374,1672568179,1672570659,2480
3501,3774733620,3370227921,1672614775,1672615053,278
3456,3240994288,3373028638,1672701887,1672702260,373
3835,3512392431,3791796585,1672609494,1672612787,3293
3830,3440107959,3760694096,1672604640,1672606009,1369
3892,3684523966,3779854934,1672619407,1672622243,2836
3525,3303410628,3636329663,1672570095,1672571814,1719
3878,3783169442,3774031303,1672570805,1672574011,3206
3541,3783919913,3755496114,1672636103,1672637201,1098
3899,3416987084,3510642075,1672640566,1672643688,3122
3486,3450969839,3774031303,1672610581,1672612925,2344
3601,3755404116,3684523966,1672667806,1672670665,2859
3856,3756385685,3232208416,1672601129,1672602617,1488
3623,3710315160,3230135532,1672609420,1672612313,2893
3484,3501457103,3515525630,1672537997,1672538454,457
3773,3299781901,3338390596,1672696747,1672698392,1645
3551,3493017654,3418448389,1672652599,1672653863,1264
3784,3400069268,3668747074,1672659852,1672662364,2512
3673,3608855425,3618176292,1672681611,1672684353,2742
3526,3899786664,3893912331,1672675279,1672675598,319
3520,3551389192,3493017654,1672655330,1672658930,3600
3584,3517991730,3515559913,1672691878,1672694409,2531
3794,3334993594,3299443125,1672575768,1672577199,1431
3607,3230868435,3979802715,1672543802,1672544511,709
3584,3400763927,3618697021,1672556394,1672556811,417
3660,3236458894,3774031303,1672562622,1672565034,2412
3490,3735374579,3734118023,1672543752,1672544143,391
3613,3885121158,3241914067,1672563797,1672565238,1441
3425,3441348818,3928511283,1672609494,1672611501,2007
3469,3850911686,3715854030,1672694888,1672698418,3530
3755,3713163045,3451691949,1672540298,1672543298,3000
3643,3971806004,3733558985,1672571425,1672573624,2199
3531,3905899155,3755065949,1672576079,1672576997,918
3661,3791106564,3334951866,1672570798,1672571159,361
3446,3238288884,3518565331,1672673189,1672674485,1296
3729,3792538417,3428725843,1672588998,1672590197,1199
3773,3499217428,3756746867,1672677745,1672679334,1589
3866,3347419520,3714666884,1672648744,1672650095,1351
3442,3686227677,3520639768,1672677558,1672677738,180
3677,3932478321,3885157459,1672578740,1672580381,1641
3699,3512392431,3337322736,1672674005,1672676285,2280
3732,3774790271,3773124276,1672648099,1672651315,3216
3586,3445206685,3783340788,1672677291,1672680890,3599
3730,3715854030,3283770991,1672676734,1672678363,1629
3572,3500915665,3480490124,1672630882,1672630944,62
3904,3669146016,3714185969,1672654845,1672656570,1725
3687,3435167810,3372223551,1672562204,1672565413,3209
3871,3774705415,3229974066,1672649298,1672652008,2710
3918,3386758279,3938389661,1672587655,1672588593,938
3910,3811075491,3773572967,1672557631,1672558754,1123
3740,3791128487,3792525861,1672637134,1672637568,434
3624,3906536154,3970603231,1672660613,1672661562,949
3522,3773735484,3516444201,1672677477,1672680931,3454
3517,3815250107,3492959689,1672669151,1672669963,812
3525,3517358573,3734915241,1672699636,1672702654,3018
3867,3783641602,3891672228,1672599215,1672602213,2998
3723,3512722110,3225636215,1672697687,1672700291,2604
3429,3373028638,3402697190,1672536259,1672536689,430
3486,3791441520,3372223551,1672561394,1672564037,2643
3539,3311085279,3208452238,1672563874,1672566171,2297
3815,3559731671,3773027597,1672547562,1672548689,1127
3713,3757332128,3618354185,1672642800,1672643825,1025
3649,3371455553,3533368789,1672676515,1672677396,881
3618,3737972328,3510837901,1672677709,1672679185,1476
3900,3757323954,3914691363,1672576107,1672576286,179
3686,3714120857,3791613604,1672629192,1672631388,2196
3529,3516321888,3755992176,1672622138,1672624743,2605
3522,3737972328,3607882826,1672606459,1672606706,247
3456,3276348699,3757323954,1672610622,1672612783,2161
3700,3394297564,3509756823,1672644511,1672648105,3594
3701,3713589994,3900898992,1672599701,1672602650,2949
3882,3773913680,3306412634,1672647870,1672651440,3570
3659,3920625129,3783615982,1672654682,1672656863,2181
3672,3760651515,3316798920,1672594396,1672594899,503
3688,3895285664,3500857494,1672691525,1672694474,2949
3595,3505434346,3384583385,1672603377,1672603976,599
3797,3236458894,3439673892,1672683227,1672685431,2204
3789,3887243870,3636329663,1672544930,1672548292,3362
3869,3519909393,3667673649,1672571279,1672573730,2451
3882,3505847380,3793583656,1672556956,1672558595,1639
3892,3311498666,3777091903,1672676436,1672676786,350
3593,3774907131,3512882178,1672604539,1672605661,1122
3722,3229974066,3360069849,1672634260,1672636627,2367
3439,3779301501,3852686295,1672656949,1672660023,3074
3697,3534179433,3513041785,1672697504,1672699589,2085
3767,3739154408,3780909839,1672656454,1672658095,1641
3592,3710496785,3812369928,1672694518,1672695533,1015
3532,3514246749,3383138270,1672560807,1672562748,1941
3801,3410538749,3605221116,1672651701,1672652317,616
3498,3852533643,3500341755,1672685425,1672687365,1940
3588,3469254160,3892304880,1672555021,1672555774,753
3456,3534566651,3660063072,1672577756,1672578663,907
3507,3612689556,3241790910,1672592801,1672595317,2516
3499,3665998641,3505807416,1672534757,1672536831,2074
3705,3447514821,3520560590,1672700063,1672701524,1461
3835,3500827202,3497671225,1672570572,1672571460,888
3790,3449333754,3424660806,1672671540,1672673695,2155
3767,3272096759,3230868435,1672628396,1672630661,2265
3589,3488686442,3500347447,1672679965,1672682986,3021
3562,3711077927,3357864626,1672635992,1672639468,3476
3465,3622665543,3801645328,1672593719,1672597114,3395
3437,3774718695,3450969839,1672549869,1672552726,2857
3509,3686227677,3825881598,1672573532,1672574339,807
3591,3338390596,3514285803,1672580221,1672582513,2292
3579,3811040565,3469254160,1672601657,1672604962,3305
3790,3450286949,3398198430,1672582294,1672583400,1106
3589,3533747868,3429943738,1672557500,1672557931,431
3910,3480991549,3734451191,1672684607,1672687050,2443
3576,3490214516,3514956366,1672650078,1672650943,865
3748,3777147510,3777184389,1672618904,1672619548,644
3645,3513545422,3519142371,1672557697,1672558024,327
3440,3780769110,3756746867,1672659607,1672661781,2174
3885,3338083680,3714120857,1672657111,1672657574,463
3641,3777624586,3505179890,1672628088,1672628432,344
3733,3625463628,3462158237,1672649448,1672652835,3387
3921,3509893027,3500442734,1672542455,1672545390,2935
3661,3774876004,3392943173,1672544331,1672547500,3169
3822,3347446226,3500317969,1672539871,1672542341,2470
3809,3354144091,3534566651,1672671323,1672672108,785
3611,3710735406,3514971533,1672688813,1672690733,1920
3473,3341893384,3336627643,1672671611,1672675203,3592
3691,3757193551,3229822507,1672536179,1672539279,3100
3526,3615087943,3777779869,1672599099,1672599858,759
3476,3505888598,3238288884,1672659439,1672661044,1605
3875,3500347447,3461119815,1672612714,1672615051,2337
3813,3371455553,3900898992,1672640806,1672641080,274
3611,3636329663,3774290799,1672645452,1672646252,800
3728,3792801638,3500777439,1672702881,1672704766,1885
3425,3509756823,3730071479,1672680008,1672682294,2286
3825,3734915241,3402697190,1672626463,1672628273,1810
3850,3280268483,3757383891,1672554588,1672556412,1824
3805,3776559988,3518565331,1672583058,1672584565,1507
3431,3520355798,3276003502,1672638199,1672638578,379
3458,3887243870,3551389192,1672643905,1672646778,2873
3805,3783615982,3350095157,1672702586,1672704654,2068
3762,3669146016,3715707380,1672535147,1672537981,2834
3791,3315703693,3617304541,1672652624,1672655526,2902
3727,3897376951,3793315718,1672681212,1672682471,1259
3775,3533188828,3609659642,1672648431,1672649177,746
3741,3438078818,3613581796,1672576693,1672578486,1793
3846,3733363628,3755992176,1672609523,1672612849,3326
3730,3638660068,3783928182,1672534455,1672537929,3474
3504,3224968597,3512383699,1672650459,1672651391,932
3742,3905899155,3885121158,1672662439,1672665162,2723
3453,3226511603,3227799827,1672688506,1672688768,262
3648,3380130228,3374183227,1672664614,1672665756,1142
3725,3514971533,3972083617,1672662824,1672663044,220
3427,3384068080,3200543880,1672678969,1672682530,3561
3487,3495911207,3289114629,1672676154,1672679507,3353
3861,3608232640,3791106564,1672600966,1672601063,97
3729,3395201292,3554944414,1672548810,1672550902,2092
3536,3755230952,3446533960,1672575792,1672577505,1713
3878,3468041839,3404025196,1672545555,1672548011,2456
3684,3783928182,3240394404,1672622223,1672622540,317
3539,3510554314,3792442597,1672566887,1672567379,492
3513,3400069268,3739154408,1672572692,1672574544,1852
3759,3793922324,3733558985,1672666379,1672668392,2013
3807,3933894942,3274831810,1672563261,1672563794,533
3616,3505228454,3394297564,1672632212,1672633317,1105
3837,3516741440,3780769110,1672644607,1672644816,209
3471,3271752081,3414940786,1672636411,1672638568,2157
3718,3534175249,3833217041,1672685187,1672687852,2665
3575,3791796585,3631090677,1672550097,1672550705,608
3515,3435167810,3351866415,1672652304,1672655619,3315
3486,3667673649,3773124276,1672542254,1672544330,2076
3563,3972192593,3713300120,1672654017,1672655608,1591
3431,3441348818,3554944414,1672676340,1672676998,658
3442,3618808151,3517687662,1672664300,1672667702,3402
3638,3517222913,3755756564,1672664219,1672664499,280
3610,3701373490,3428725843,1672577358,1672580131,2773
3797,3226178937,3734451191,1672533939,1672537229,3290
3725,3757863420,3613416045,1672536909,1672538892,1983
3771,3791128487,3371455553,1672618827,1672620354,1527
3895,3435116799,3491684096,1672669848,1672672536,2688
3747,3703383853,3600876425,1672565613,1672566302,689
3912,3299781901,3774031303,1672569864,1672572887,3023
3714,3512958459,3501457103,1672697371,1672698287,916
3657,3512295534,3513360004,1672640788,1672641652,864
3598,3279473441,3417679834,1672587423,1672588967,1544
3735,3711000597,3927403123,1672674989,1672677903,2914
3841,3970198861,3715127070,1672549554,1672551839,2285
3592,3514275974,3711006062,1672565309,1672567191,1882
3564,3760263530,3293835352,1672644657,1672646555,1898
3630,3773033649,3396726504,1672554246,1672557197,2951
3637,3480991549,3703383853,1672660618,1672661356,738
3531,3891672228,3835985172,1672663984,1672665145,1161
3911,3463740710,3389634034,1672550164,1672552884,2720
3650,3299443125,3777037426,1672536936,1672538446,1510
3636,3276003502,3638204468,1672622234,1672623695,1461
3569,3241790910,3850911686,1672650756,1672652320,1564
3732,3373028638,3859868849,1672679368,1672682003,2635
3565,3462636434,3513327337,1672532253,1672532977,724
3797,3701424609,3755992176,1672650575,1672652192,1617
3620,3730071479,3534179433,1672665119,1672665867,748
3873,3664943873,3714120857,1672635103,1672638161,3058
3747,3778640261,3300818269,1672574508,1672578075,3567
3483,3755737419,3610358027,1672613706,1672615493,1787
3532,3772236797,3520657891,1672681990,1672682593,603
3740,3715986185,3715545685,1672574830,1672576201,1371
3686,3501384020,3783433404,1672599116,1672602704,3588
3571,3505923418,3421877923,1672646852,1672650144,3292
3819,3311085279,3668533536,1672612399,1672614396,1997
3570,3240394404,3513545422,1672532048,1672534821,2773
3746,3401496246,3274831810,1672628215,1672628911,696
3787,3713517039,3803389195,1672640054,1672641918,1864
3898,3421877923,3509893027,1672587369,1672590100,2731
3845,3711853996,3457620713,1672678088,1672680175,2087
3583,3783373154,3304155815,1672559971,1672562923,2952
3573,3685681577,3505481368,1672534282,1672535937,1655
3712,3534357694,3970558632,1672674626,1672676613,1987
3670,3514741348,3780834916,1672685016,1672688073,3057
3640,3315703693,3850911686,1672542019,1672544989,2970
3731,3637313265,3899326793,1672602588,1672603406,818
3532,3970603231,3398198430,1672582805,1672583481,676
3695,3497808662,3774876004,1672656301,1672659301,3000
3685,3229822507,3701247948,1672576015,1672576407,392
3624,3514308235,3977148669,1672650873,1672653628,2755
3739,3900276517,3755915206,1672663427,1672665917,2490
3892,3818575661,3393063657,1672685269,1672686704,1435
3749,3500317969,3206837348,1672633762,1672633945,183
3648,3774733620,3373089838,1672625374,1672626213,839
3480,3357864626,3715854030,1672652557,1672654419,1862
3709,3519028898,3826238375,1672646267,1672646731,464
3624,3514703118,3276348699,1672635392,1672638880,3488
3485,3209526819,3232208416,1672613271,1672615251,1980
3457,3774705415,3927403123,1672663467,1672664118,651
3708,3515890966,3514308235,1672695755,1672698962,3207
3857,3556969573,3780338697,1672567280,1672568940,1660
3540,3514512367,3627368399,1672621032,1672621117,85
3626,3463849738,3500737582,1672621818,1672624195,2377
3483,3512379024,3334951866,1672644523,1672647627,3104
3772,3770146716,3467988782,1672536049,1672538725,2676
3725,3336339664,3818575661,1672571471,1672571787,316
3835,3926643445,3512282789,1672675029,1672678224,3195
3919,3927165965,3512958459,1672682645,1672684083,1438
3906,3815250107,3414940786,1672685038,1672686636,1598
3485,3202804048,3773009828,1672544928,1672545784,856
3467,3534126409,3514512367,1672539930,1672541600,1670
3461,3520416075,3390660440,1672680606,1672682437,1831
3886,3783136330,3447514821,1672571406,1672574837,3431
3710,3713589994,3315279093,1672546139,1672546564,425
3455,3923754072,3710048469,1672602654,1672605101,2447
3802,3410600350,3855583256,1672625608,1672626456,848
3843,3638204468,3414049538,1672566122,1672566969,847
3685,3475349791,3533090502,1672601029,1672603474,2445
3532,3364378127,3714120857,1672659848,1672661293,1445
3437,3625463628,3511843593,1672571420,1672574518,3098
3816,3449333754,3299781901,1672567870,1672571378,3508
3503,3410538749,3246370118,1672541216,1672542365,1149
3726,3520639768,3520657891,1672641127,1672643505,2378
3902,3774178201,3791753345,1672686756,1672687071,315
3784,3792745809,3299781901,1672545040,1672547123,2083
3771,3306412634,3736705719,1672536297,1672537045,748
3640,3559731671,3519142371,1672574003,1672575585,1582
3575,3440137407,3293835352,1672626623,1672629570,2947
3685,3815392801,3500604680,1672677493,1672680434,2941
3807,3505178849,3518561777,1672649666,1672651987,2321
3836,3927165965,3438078818,1672687758,1672690311,2553
3499,3935399379,3757383891,1672630503,1672632906,2403
3473,3760364383,3497671225,1672583458,1672585380,1922
3584,3276269264,3519446663,1672686471,1672687516,1045
3521,3770296583,3276348699,1672560415,1672562981,2566
3591,3972083617,3305722859,1672557932,1672558163,231
3595,3975717896,3467988782,1672628605,1672629332,727
3746,3793740407,3776831527,1672599729,1672600610,881
3879,3519651506,3831586487,1672570833,1672571116,283
3494,3383138270,3811040565,1672613499,1672616744,3245
3625,3334951866,3612689556,1672625708,1672628694,2986
3921,3621790707,3274906650,1672534150,1672536395,2245
3760,3661903000,3737972328,1672627694,1672629517,1823
3497,3411688875,3757294769,1672563516,1672565417,1901
3679,3428027649,3774605761,1672569305,1672572061,2756
3794,3815392801,3902625986,1672593056,1672594717,1661
3869,3513018485,3460719322,1672564929,1672566833,1904
3543,3715986185,3239617320,1672655956,1672656510,554
3859,3791106564,3713768950,1672664111,1672666190,2079
3498,3421877923,3448633776,1672622453,1672625628,3175
3675,3284932450,3515439826,1672590191,1672590505,314
3531,3435116799,3714678331,1672615620,1672615821,201
3529,3824641227,3519087371,1672594923,1672596473,1550
3579,3680810086,3636329663,1672666710,1672668783,2073
3644,3928719932,3757193307,1672570125,1672571159,1034
3911,3716628503,3711812325,1672702333,1672703331,998
3793,3780209375,3792020993,1672686829,1672688730,1901
3783,3445206685,3731646673,1672605434,1672608644,3210
3920,3501786419,3246370118,1672595913,1672599217,3304
3581,3224968597,3778640261,1672681442,1672681595,153
3783,3514246749,3703396825,1672622844,1672624819,1975
3609,3885121158,3520764926,1672695737,1672699103,3366
3424,3292147449,3791046864,1672663889,1672665619,1730
3875,3932478321,3315279093,1672646584,1672647526,942
3444,3392520516,3779656423,1672541783,1672544328,2545
3499,3714678331,3304155815,1672569320,1672572818,3498
3744,3935399379,3780680950,1672578119,1672578655,536
3431,3499217428,3505154885,1672598756,1672601247,2491
3430,3792745809,3713163045,1672642996,1672644192,1196
3737,3755230952,3518194482,1672674589,1672675014,425
3537,3236499444,3495911207,1672606094,1672607801,1707
3604,3970198861,3780680950,1672537683,1672538978,1295
3543,3511005395,3683113954,1672597275,1672600001,2726
3711,3511317276,3500347447,1672676345,1672677115,770
3778,3500442734,3271752081,1672701816,1672702784,968
3786,3501459390,3238288884,1672577365,1672580953,3588
3917,3928719932,3738026330,1672584773,1672586972,2199
3699,3289114629,3488763230,1672602449,1672603426,977
3783,3660063072,3760721303,1672584602,1672587156,2554
3824,3367509761,3513360004,1672604934,1672605377,443
3838,3618697021,3515559913,1672667675,1672668898,1223
3770,3334993594,3635169815,1672551225,1672552862,1637
3602,3276217799,3481640525,1672672420,1672673828,1408
3766,3285204083,3467779445,1672540351,1672541487,1136
3869,3456430614,3428027649,1672656956,1672659214,2258
3532,3518561777,3514971533,1672672164,1672672359,195
3685,3515401243,3408430195,1672540864,1672544314,3450
3843,3512499658,3622665543,1672671142,1672672318,1176
3734,3510798825,3510964997,1672587371,1672589862,2491
3533,3831586487,3779854934,1672633405,1672634207,802
3785,3516903528,3336339664,1672683116,1672686385,3269
3830,3711853996,3734451191,1672654054,1672655196,1142
3837,3928511283,3514419100,1672647641,1672649715,2074
3801,3793315718,3818575661,1672613384,1672614136,752
3508,3512800570,3457960571,1672557978,1672559354,1376
3795,3310039260,3291933594,1672604684,1672604916,232
3623,3817813340,3299781901,1672562546,1672562990,444
3846,3294747828,3610358027,1672577558,1672578740,1182
3874,3512958459,3714666884,1672693580,1672695965,2385
3648,3411688875,3495911207,1672569130,1672570525,1395
3605,3298151889,3511791953,1672555212,1672558788,3576
3629,3826238375,3938389661,1672609543,1672610138,595
3734,3402697190,3283770991,1672699574,1672702425,2851
3652,3716110860,3229974066,1672648301,1672649820,1519
3689,3792546035,3661583097,1672568398,1672570382,1984
3811,3519416013,3392520516,1672592253,1672593033,780
3570,3716963089,3834963772,1672653058,1672654852,1794
3612,3757383891,3755344363,1672585931,1672587532,1601
3775,3821054646,3701373490,1672545567,1672548760,3193
3635,3780253901,3449333754,1672703585,1672704983,1398
3667,3270042456,3226511603,1672609284,1672609913,629
3442,3559731671,3370227921,1672534722,1672536198,1476
3498,3292147449,3500347447,1672547075,1672548209,1134
3921,3516513251,3421877923,1672546669,1672548001,1332
3652,3612689556,3970603231,1672688076,1672691306,3230
3782,3515466096,3384068080,1672597303,1672599577,2274
3858,3515401243,3779738691,1672583303,1672586781,3478
3692,3514308235,3713768950,1672640453,1672643734,3281
3667,3517697722,3203538212,1672634570,1672636360,1790
3799,3701373490,3399472693,1672678210,1672679302,1092
3429,3773124276,3510554314,1672599151,1672602513,3362
3553,3500525825,3972192593,1672656553,1672659438,2885
3537,3280054198,3447672935,1672638800,1672641706,2906
3545,3715986185,3488686442,1672610771,1672614355,3584
3647,3533274994,3780712350,1672607895,1672608844,949
3623,3757383891,3807212280,1672687855,1672690529,2674
3719,3410160376,3512337405,1672634878,1672637288,2410
3759,3715545685,3462158237,1672554134,1672554688,554
3921,3779465522,3467988782,1672667492,1672670125,2633
3543,3774705415,3829822608,1672563886,1672565317,1431
3428,3770438122,3915162005,1672634106,1672635398,1292
3628,3349739136,3755848152,1672603368,1672605797,2429
3491,3500044458,3801645328,1672550088,1672552531,2443
3635,3610358027,3710048469,1672626595,1672627050,455
3703,3853629553,3441703884,1672648781,1672651053,2272
3497,3757348722,3701823816,1672585456,1672586087,631
3801,3777184389,3970909253,1672637893,1672640594,2701
3487,3450286949,3515525630,1672637270,1672638997,1727
3620,3885155975,3229822507,1672655758,1672657774,2016
3905,3515439826,3627368399,1672630582,1672633265,2683
3714,3374183227,3270697740,1672667327,1672668731,1404
3911,3435167810,3491469603,1672535383,1672537774,2391
3521,3533423872,3370068529,1672688302,1672689785,1483
3800,3510642075,3501215099,1672574678,1672576703,2025
3708,3518194482,3608232640,1672609613,1672610531,918
3589,3520764926,3224811762,1672644979,1672645145,166
3690,3360616538,3624297844,1672599818,1672601298,1480
3864,3773027597,3713691388,1672585125,1672588256,3131
3823,3500703304,3770296583,1672582486,1672583597,1111
3865,3439673892,3200543880,1672676121,1672677105,984
3711,3360813161,3780427126,1672638823,1672639724,901
3907,3501121099,3893912331,1672636309,1672638588,2279
3480,3760040019,3308760650,1672567309,1672570240,2931
3616,3513018485,3773027597,1672668009,1672669107,1098
3447,3480490124,3244004456,1672557772,1672560981,3209
3450,3343816795,3713911104,1672635288,1672638798,3510
3785,3715086894,3485540729,1672694170,1672697197,3027
3848,3609659642,3609881958,1672703631,1672705914,2283
3848,3245232284,3203538212,1672582710,1672584249,1539
3539,3231494505,3783340788,1672656570,1672657385,815
3570,3511005395,3520181148,1672573951,1672574538,587
3716,3701247948,3972083617,1672625066,1672628007,2941
3450,3711812325,3310125159,1672536129,1672538088,1959
3737,3515890966,3395201292,1672631625,1672635220,3595
3430,3226511603,3777147510,1672691596,1672691811,215
3849,3774178201,3760721303,1672533355,1672535273,1918
3453,3363162590,3757075324,1672650023,1672651087,1064
3893,3792274796,3513081354,1672637192,1672638070,878
3839,3716110860,3970603231,1672581346,1672584371,3025
3837,3737112297,3334951866,1672635640,1672637278,1638
3488,3226024417,3408430195,1672693349,1672693821,472
3604,3637313265,3411515369,1672651944,1672652058,114
3464,3779854934,3505228454,1672592405,1672592686,281
3597,3777814504,3338083680,1672574995,1672578264,3269
3709,3833217041,3776084820,1672684939,1672687647,2708
3825,3618808151,3800257590,1672619258,1672622644,3386
3873,3294747828,3510837901,1672588186,1672589319,1133
3871,3885537225,3491469603,1672700762,1672701331,569
3536,3382733096,3931627862,1672619874,1672620415,541
3700,3533079336,3776244398,1672552903,1672556387,3484
3849,3770146716,3402385957,1672687959,1672690771,2812
3710,3783641602,3284932450,1672632633,1672636109,3476
3770,3630353876,3463849738,1672648035,1672648732,697
3455,3554186380,3421877923,1672604297,1672606677,2380
3489,3893912331,3755065949,1672555815,1672557089,1274
3836,3271454397,3608855425,1672620761,1672623064,2303
3502,3739661856,3773735484,1672682371,1672683770,1399
3443,3461119815,3343816795,1672558258,1672561487,3229
3691,3447514821,3923754072,1672532196,1672533228,1032
3629,3515466096,3448633776,1672621464,1672624736,3272
3851,3509756823,3516489668,1672613471,1672613901,430
3454,3776988674,3455018347,1672642479,1672644480,2001
3450,3732584121,3481640525,1672605117,1672607126,2009
3711,3770676872,3283492940,1672535562,1672537097,1535
3543,3608922867,3714233826,1672687328,1672689106,1778
3556,3935913584,3390660440,1672582425,1672585487,3062
3893,3715854030,3516298579,1672592140,1672593502,1362
3635,3897376951,3755915206,1672668449,1672671878,3429
3864,3515439826,3443357683,1672614589,1672615138,549
3475,3271454397,3733558985,1672615344,1672617558,2214
3876,3680843171,3300511067,1672616286,1672618618,2332
3502,3783136330,3362641275,1672701722,1672702505,783
3730,3632814465,3336339664,1672671852,1672673837,1985
3742,3609933747,3449333754,1672593717,1672595979,2262
3701,3276269264,3793883863,1672539318,1672542323,3005
3762,3783641602,3519850727,1672647646,1672650832,3186
3649,3240394404,3505198734,1672566500,1672568441,1941
3559,3774178201,3621683102,1672583274,1672585621,2347
3495,3755230952,3777240360,1672646355,1672648181,1826
3734,3513081354,3688490530,1672677125,1672678995,1870
3507,3556969573,3399472693,1672647320,1672648724,1404
3703,3272716462,3793315718,1672565651,1672567792,2141
3709,3364726656,3793583656,1672681262,1672684268,3006
3452,3515525630,3505847380,1672637997,1672639447,1450
3642,3733363628,3713300120,1672685576,1672688507,2931
3533,3337362061,3383138270,1672642782,1672644444,1662
3557,3309314379,3284947372,1672628758,1672631195,2437
3580,3610870949,3920625129,1672577549,1672578648,1099
3584,3622665543,3770146716,1672622725,1672625518,2793
3696,3777330107,3511317276,1672679299,1672681059,1760
3894,3514334067,3756746867,1672590571,1672592467,1896
3642,3409114719,3778597171,1672545784,1672545989,205
3872,3923754072,3777485931,1672650627,1672653406,2779
3843,3463849738,3515466096,1672607914,1672610624,2710
3490,3815250107,3500317969,1672601090,1672601638,548
3774,3902760230,3711637255,1672634520,1672637423,2903
3684,3783373154,3760094385,1672641513,1672642881,1368
3455,3441348818,3710315160,1672605631,1672606886,1255
3439,3478114114,3478114114,1672699785,1672701805,2020
3424,3755404116,3770296583,1672580004,1672582735,2731
3908,3701247948,3770676872,1672538913,1672540550,1637
3730,3513360004,3520764926,1672638687,1672641779,3092
3712,3401793306,3760721303,1672551009,1672551716,707
3789,3500341755,3777814504,1672639756,1672642119,2363
3914,3451691949,3311420950,1672688061,1672690986,2925
3493,3607768197,3394401087,1672618521,1672621437,2916
3713,3512383699,3505266860,1672554506,1672557963,3457
3506,3906536154,3792538417,1672643338,1672645231,1893
3453,3779301501,3386758279,1672609106,1672612233,3127
3865,3398731252,3977352557,1672587070,1672587928,858
3738,3517697722,3224811762,1672557026,1672560011,2985
3655,3205923620,3448633776,1672651019,1672652152,1133
3651,3533188828,3900276517,1672691931,1672694986,3055
3763,3394297564,3912891315,1672675729,1672677125,1396
3778,3520578796,3416987084,1672658083,1672661675,3592
3741,3357864626,3505888598,1672628441,1672629421,980
3755,3621790707,3551389192,1672634442,1672635259,817
3527,3713941638,3288762795,1672584106,1672585640,1534
3516,3517600136,3515525630,1672550813,1672552991,2178
3456,3760645796,3520657891,1672593690,1672597266,3576
3620,3773121782,3779639983,1672592560,1672593096,536
3867,3334974375,3518194482,1672651555,1672652135,580
3542,3689697817,3801645328,1672665932,1672668716,2784
3856,3271752081,3760645796,1672626448,1672628381,1933
3739,3362641275,3618808151,1672537008,1672538980,1972
3677,3899326793,3777240360,1672600634,1672602529,1895
3588,3902760230,3770468980,1672602132,1672605709,3577
3510,3479851674,3777091903,1672548737,1672552117,3380
3886,3711812325,3200308999,1672638809,1672639264,455
3590,3979802715,3512282789,1672672076,1672675387,3311
3490,3205985903,3514334067,1672602668,1672602859,191
3552,3510767239,3516321888,1672545052,1672546589,1537
3769,3505634634,3738026330,1672583304,1672584423,1119
3556,3416987084,3776117322,1672582154,1672583447,1293
3888,3513327337,3516741440,1672554600,1672555498,898
3638,3446533960,3714678331,1672548089,1672548989,900
3764,3517590837,3622357348,1672703662,1672704381,719
3732,3774155692,3757193307,1672588050,1672591521,3471
3855,3274831810,3667673649,1672660560,1672661551,991
3568,3811075491,3364378127,1672638757,1672640652,1895
3729,3292147449,3495911207,1672589171,1672591722,2551
3821,3436025562,3369708250,1672693967,1672694618,651
3872,3680810086,3333403880,1672531335,1672533991,2656
3695,3511791953,3305336154,1672552888,1672554703,1815
3572,3755992176,3811040565,1672671178,1672672246,1068
3870,3274906650,3803517637,1672668640,1672669144,504
3561,3309314379,3475349791,1672537587,1672537979,392
3816,3513041785,3469254160,1672623536,1672626853,3317
3573,3885537225,3757318448,1672534673,1672536063,1390
3846,3858172636,3631479562,1672682971,1672683472,501
3652,3452016771,3855583256,1672678521,1672681185,2664
3634,3715086894,3617489344,1672700897,1672702411,1514
3761,3732131656,3711000597,1672601964,1672604096,2132
3738,3311085279,3513327337,1672631814,1672633117,1303
3903,3716628503,3451726367,1672564478,1672567804,3326
3678,3337362061,3638204468,1672680882,1672681197,315
3622,3428725843,3382733096,1672634457,1672636976,2519
3709,3803389195,3519087371,1672595790,1672599238,3448
3904,3776518452,3682133690,1672583676,1672586469,2793
3546,3811040565,3783520186,1672590328,1672590823,495
3669,3512800570,3310125159,1672550094,1672553180,3086
3557,3533423872,3777624586,1672625282,1672625491,209
3509,3613206049,3500949309,1672650099,1672651085,986
3550,3520578796,3755158925,1672644204,1672646937,2733
3473,3517590837,3755344363,1672689659,1672692035,2376
3439,3202141727,3385323994,1672689203,1672689427,224
3759,3383138270,3979784676,1672641241,1672643467,2226
3533,3610870949,3505995057,1672631473,1672634907,3434
3805,3607882826,3713941638,1672595130,1672595845,715
3656,3688796737,3756789525,1672670236,1672671532,1296
3853,3891672228,3304155815,1672625636,1672626044,408
3689,3447514821,3429943738,1672556641,1672558085,1444
3871,3512379024,3463849738,1672623767,1672626589,2822
3474,3902760230,3366423342,1672595969,1672596747,778
3840,3926643445,3272030610,1672568497,1672569205,708
3879,3777147510,3880926355,1672573788,1672574964,1176
3797,3463849738,3208957949,1672589804,1672592049,2245
3816,3246370118,3715974659,1672549496,1672552658,3162
3765,3774876004,3533747868,1672672700,1672676115,3415
3834,3372223551,3815392801,1672695985,1672698991,3006
3449,3510818674,3429943738,1672584600,1672585412,812
3550,3480991549,3513410578,1672647951,1672649684,1733
3511,3438489358,3935487534,1672702762,1672703832,1070
3620,3631090677,3386758279,1672601218,1672604139,2921
3577,3495911207,3906536154,1672699497,1672702151,2654
3608,3511024016,3756704774,1672664483,1672666528,2045
3819,3777091903,3715707380,1672536444,1672536529,85
3849,3394401087,3615737355,1672664399,1672665722,1323
3856,3330340793,3515525630,1672612206,1672613066,860
3476,3310125159,3608855425,1672552388,1672553387,999
3714,3734118023,3421385957,1672657215,1672657676,461
3754,3791441520,3505437712,1672662072,1672663948,1876
3510,3505266860,3783147088,1672548551,1672551665,3114
3758,3831586487,3814305099,1672548404,1672551298,2894
3826,3935913584,3379143440,1672557296,1672558057,761
3552,3520639768,3826238375,1672563682,1672564305,623
3469,3757332128,3499217428,1672619995,1672623368,3373
3916,3512383699,3517887477,1672694638,1672696242,1604
3601,3793407963,3518229776,1672539702,1672541695,1993
3552,3383138270,3236458894,1672631691,1672635072,3381
3558,3783615982,3380130228,1672607772,1672610667,2895
3686,3760694096,3414049538,1672665126,1672667196,2070
3728,3501786419,3792745809,1672681210,1672683559,2349
3474,3455018347,3661903000,1672603924,1672606811,2887
3603,3505437712,3780253901,1672614489,1672616486,1997
3745,3372223551,3755230952,1672664362,1672665941,1579
3808,3800257590,3409114719,1672640097,1672642477,2380
3671,3411515369,3835985172,1672695335,1672697856,2521
3817,3621683102,3519142371,1672652108,1672652321,213
3900,3885537225,3203538212,1672550037,1672553098,3061
3594,3893912331,3351866415,1672581772,1672583322,1550
3905,3977352557,3620292035,1672591468,1672593272,1804
3792,3701664364,3368283077,1672541634,1672543313,1679
3907,3713979100,3505437712,1672668190,1672670904,2714
3596,3288224595,3760364383,1672536772,1672538686,1914
3692,3414275042,3512337405,1672558572,1672561332,2760
3497,3760362417,3774907131,1672562333,1672563183,850
3765,3793407963,3793781065,1672611885,1672612587,702
3797,3488686442,3424660806,1672583007,1672585532,2525
3915,3760924079,3938389661,1672540502,1672542994,2492
3749,3757348722,3755756564,1672701712,1672704116,2404
3446,3638204468,3684523966,1672626044,1672626126,82
3760,3974674109,3716628503,1672607469,1672609728,2259
3828,3304971369,3701884158,1672565211,1672567626,2415
3573,3520657891,3517462308,1672662881,1672663617,736
3538,3887243870,3272096759,1672631255,1672632750,1495
3762,3773033649,3225636215,1672558670,1672561773,3103
3910,3891672228,3926643445,1672697454,1672698448,994
3912,3435167810,3336339664,1672622367,1672624153,1786
3480,3394401087,3756704774,1672686342,1672689025,2683
3578,3711000597,3457960571,1672673564,1672675882,2318
3539,3610870949,3885537225,1672535498,1672538610,3112
3714,3615113018,3770296583,1672633987,1672636894,2907
3635,3514419100,3343816795,1672667348,1672669843,2495
3667,3783771827,3347419520,1672540606,1672541228,622
3904,3224330592,3923420131,1672624630,1672625474,844
3530,3825881598,3519416013,1672654710,1672655265,555
3860,3713589994,3501384020,1672617090,1672620279,3189
3510,3755222916,3636329663,1672559902,1672563318,3416
3713,3500613459,3500709774,1672603080,1672604950,1870
3761,3424445495,3613206049,1672610611,1672611505,894
3820,3783801141,3501459390,1672647576,1672648627,1051
3463,3733363628,3635169815,1672558726,1672560126,1400
3718,3770676872,3460719322,1672564071,1672566854,2783
3488,3791128487,3608855425,1672668816,1672669922,1106
3521,3362641275,3416987084,1672697474,1672697983,509
3905,3271454397,3371455553,1672597077,1672598796,1719
3663,3792538417,3500777439,1672596433,1672599037,2604
3515,3792274796,3713768950,1672616884,1672617626,742
3564,3534126409,3480726047,1672629331,1672630917,1586
3811,3904412440,3509483172,1672640421,1672641644,1223
3908,3834963772,3557046880,1672618657,1672619449,792
3522,3777485931,3511843593,1672673781,1672674489,708
3454,3500841914,3520322124,1672649747,1672652857,3110
3874,3668414677,3710008361,1672589497,1672592920,3423
3660,3480991549,3715974659,1672694761,1672695908,1147
3517,3500302272,3710315160,1672586388,1672589917,3529
3721,3770468980,3812369928,1672606639,1672607194,555
3733,3685816610,3756789525,1672671378,1672672540,1162
3674,3232208416,3779532653,1672586243,1672587898,1655
3658,3760645796,3350095157,1672657437,1672659768,2331
3899,3757383891,3715974659,1672655455,1672657878,2423
3425,3683113954,3777624586,1672553510,1672556385,2875
3562,3757193551,3557046880,1672559978,1672562622,2644
3805,3824641227,3499217428,1672593733,1672595790,2057
3746,3533423872,3246370118,1672653900,1672655508,1608
3604,3500672156,3311085279,1672624576,1672627458,2882
3828,3500703304,3623266256,1672683811,1672684990,1179
3547,3338390596,3516298579,1672623390,1672624997,1607
3887,3517172354,3452016771,1672583844,1672584896,1052
3892,3305722859,3783919913,1672568807,1672569376,569
3505,3501786419,3680843171,1672655497,1672655842,345
3785,3488763230,3836241528,1672562067,1672562529,462
3861,3510642075,3814677862,1672563643,1672565030,1387
3878,3703433819,3437286517,1672654639,1672654734,95
3597,3614740489,3271752081,1672598894,1672599213,319
3883,3755496114,3481640525,1672538481,1672539503,1022
3729,3713768950,3357289672,1672559611,1672562501,2890
3513,3533368789,3780769110,1672652529,1672654163,1634
3914,3512830734,3315703693,1672653171,1672654209,1038
3618,3755158925,3501457103,1672635860,1672637640,1780
3688,3463740710,3341893384,1672572324,1672574630,2306
3475,3520560590,3783550022,1672599541,1672599635,94
3755,3514246749,3633735593,1672539357,1672541523,2166
3675,3735374579,3770520359,1672661499,1672665043,3544
3660,3435167810,3756385685,1672612262,1672615455,3193
3854,3311098437,3533294425,1672601416,1672604699,3283
3482,3519651506,3793883863,1672636171,1672639211,3040
3874,3315703693,3533188828,1672598326,1672599612,1286
3649,3783136330,3245232284,1672563403,1672564937,1534
3701,3891672228,3201629017,1672665184,1672667176,1992
3474,3449639012,3226024417,1672654323,1672656313,1990
3611,3343132529,3437286517,1672557259,1672557330,71
3489,3793935736,3509756823,1672679329,1672682152,2823
3766,3284932450,3979784676,1672622658,1672623028,370
3892,3520764926,3755496114,1672699771,1672700030,259
3739,3680810086,3777624586,1672572591,1672573442,851
3823,3501215099,3715974659,1672699303,1672701032,1729
3660,3512946768,3780834916,1672569334,1672572632,3298
3679,3710496785,3773902805,1672642434,1672642716,282
3609,3613416045,3360069849,1672625748,1672627386,1638
3849,3500857494,3734118023,1672680263,1672681928,1665
3744,3613899351,3519416013,1672662612,1672665797,3185
3507,3534175249,3931627862,1672651969,1672654377,2408
3477,3520991398,3683113954,1672631020,1672634219,3199
3463,3635169815,3760362417,1672562338,1672564685,2347
3864,3793315718,3755344363,1672553600,1672556396,2796
3912,3807212280,3245232284,1672549874,1672552008,2134
3892,3514246749,3554825448,1672680963,1672683754,2791
3606,3514334067,3779301501,1672542707,1672544368,1661
3515,3685816610,3509764635,1672579631,1672582309,2678
3784,3452016771,3392836218,1672653499,1672655823,2324
3646,3757193551,3309314379,1672561265,1672562796,1531
3452,3516298579,3513410578,1672612506,1672615341,2835
3566,3777624586,3443357683,1672622300,1672623021,721
3608,3779532653,3972083617,1672590035,1672591698,1663
3479,3856606678,3271752081,1672644708,1672647698,2990
3471,3500672156,3515439826,1672603165,1672606604,3439
3488,3793583656,3517288083,1672673486,1672673701,215
3916,3288762795,3500302272,1672651943,1672652895,952
3811,3500915908,3755404116,1672536474,1672538618,2144
3805,3607768197,3887243870,1672587483,1672590833,3350
3727,3520560590,3777184389,1672617053,1672619853,2800
3615,3778640261,3776559988,1672652124,1672654310,2186
3897,3512882178,3303410628,1672659560,1672660236,676
3432,3757294769,3512383699,1672651242,1672654042,2800
3714,3370227921,3701373490,1672583314,1672586642,3328
3513,3686523546,3777184389,1672670751,1672674341,3590
3577,3811075491,3450286949,1672675781,1672678843,3062
3453,3701823816,3310125159,1672600247,1672601748,1501
3860,3970627281,3276348699,1672659219,1672662237,3018
3713,3428725843,3770236215,1672614734,1672616865,2131
3543,3224968597,3519077659,1672643874,1672643974,100
3910,3402385957,3899326793,1672615562,1672615737,175
3463,3452016771,3777091903,1672676858,1672679335,2477
3722,3824641227,3760842815,1672680890,1672682571,1681
3857,3512882178,3730071479,1672625736,1672627600,1864
3677,3779854934,3773572967,1672675060,1672675581,521
3460,3512392431,3970558632,1672631810,1672631934,124
3525,3760651515,3514512367,1672610169,1672612649,2480
3486,3209526819,3780427126,1672541727,1672542155,428
3920,3309314379,3660887799,1672691243,1672694481,3238
3685,3402385957,3710489491,1672616856,1672619213,2357
3582,3935487534,3304971369,1672614478,1672615451,973
3831,3500613459,3713829743,1672689231,1672691751,2520
3638,3618176292,3755230952,1672668393,1672671975,3582
3430,3534764451,3780472203,1672557192,1672560121,2929
3833,3701373490,3715127070,1672653926,1672654844,918
3595,3778899160,3777624586,1672635018,1672638097,3079
3764,3232208416,3893912331,1672549293,1672549964,671
3567,3661583097,3711637255,1672600085,1672603296,3211
3879,3660063072,3224968597,1672576947,1672578333,1386
3546,3902861231,3480726047,1672637652,1672638970,1318
3578,3200308999,3515890966,1672647803,1672651231,3428
3600,3514703118,3783147088,1672569529,1672571632,2103
3590,3701882224,3513360004,1672640480,1672643083,2603
3772,3551376095,3501786419,1672660961,1672663244,2283
3644,3739895284,3739895284,1672655046,1672656027,981
3529,3410160376,3885155975,1672621675,1672625206,3531
3498,3505179890,3447514821,1672703032,1672705688,2656
3846,3637313265,3445206685,1672661697,1672664143,2446
3832,3900898992,3201676087,1672579989,1672582414,2425
3784,3897376951,3394297564,1672564882,1672566118,1236
3861,3755848152,3500777439,1672671126,1672671886,760
3617,3411515369,3311498666,1672601736,1672605029,3293
3663,3513327337,3774031303,1672572307,1672574132,1825
3886,3373089838,3777779869,1672605819,1672607631,1812
3578,3773009828,3683113954,1672671156,1672672533,1377
3555,3310039260,3615939504,1672640411,1672641072,661
3920,3773735484,3451326054,1672606943,1672607586,643
3430,3296462324,3714128600,1672689905,1672691961,2056
3863,3284947372,3481640525,1672533183,1672533311,128
3501,3778040015,3773939399,1672647563,1672650323,2760
3482,3615939504,3230868435,1672605504,1672606909,1405
3812,3716628503,3380130228,1672578528,1672580316,1788
3837,3914691363,3309314379,1672629880,1672630395,515
3560,3385323994,3512379024,1672631245,1672632780,1535
3886,3757903168,3534126409,1672689254,1672692321,3067
3554,3638660068,3757332128,1672653130,1672654968,1838
3812,3935913584,3520991398,1672631281,1672633361,2080
3694,3389634034,3793583656,1672584386,1672586159,1773
3684,3363162590,3667427125,1672685071,1672686614,1543
3518,3777037426,3710008361,1672589014,1672589392,378
3874,3559731671,3452016771,1672600064,1672600144,80
3476,3495911207,3511791953,1672560371,1672561633,1262
3916,3793407963,3668747074,1672659084,1672662677,3593
3719,3533368789,3445206685,1672597279,1672598389,1110
3429,3495911207,3773837847,1672602196,1672603968,1772
3848,3780427126,3220031931,1672699369,1672702390,3021
3818,3512295534,3780338697,1672656885,1672659664,2779
3776,3500915908,3448875382,1672577663,1672580677,3014
3697,3773735484,3534179433,1672599087,1672601544,2457
3471,3450286949,3783771827,1672617448,1672618764,1316
3548,3511442562,3349856820,1672613208,1672615953,2745
3668,3505437712,3974674109,1672628104,1672629680,1576
3746,3392943173,3551399764,1672561777,1672564865,3088
3502,3970558632,3520181148,1672663952,1672666792,2840
3649,3617489344,3772078494,1672597101,1672598640,1539
3682,3760645796,3293835352,1672618788,1672621992,3204
3774,3380767040,3310125159,1672623025,1672624270,1245
3762,3481640525,3429943738,1672639271,1672640596,1325
3593,3770520359,3517991730,1672643349,1672646332,2983
3487,3710048469,3739154408,1672570354,1672571354,1000
3899,3202141727,3885155975,1672608456,1672608725,269
3570,3225636215,3773913680,1672548255,1672549572,1317
3848,3912891315,3495911207,1672668600,1672671994,3394
3642,3457960571,3475349791,1672688984,1672689576,592
3433,3975717896,3615113018,1672630057,1672633496,3439
3917,3226511603,3336339664,1672572449,1672574193,1744
3898,3774031303,3713941638,1672540342,1672543761,3419
3778,3900945856,3756625818,1672543181,1672546649,3468
3907,3513327337,3519651506,1672550830,1672554353,3523
3921,3853629553,3711218296,1672679287,1672681216,1929
3843,3608922867,3618489670,1672689469,1672690760,1291
3437,3617392620,3970198861,1672562578,1672565304,2726
3439,3533004959,3236354255,1672688706,1672691985,3279
3473,3777147510,3714670620,1672661622,1672663926,2304
3752,3733558985,3624297844,1672608502,1672611972,3470
3494,3462636434,3897376951,1672561206,1672563141,1935
3526,3224968597,3487875183,1672650760,1672653125,2365
3505,3455018347,3618808151,1672656430,1672659141,2711
3787,3411515369,3343816795,1672643769,1672646846,3077
3474,3209481722,3686227677,1672534878,1672536656,1778
3843,3491684096,3770520359,1672556557,1672559661,3104
3439,3776559988,3410600350,1672597519,1672600099,2580
3683,3509893027,3701247948,1672685144,1672685228,84
3888,3811075491,3774243020,1672702086,1672705256,3170
3740,3607768197,3414940786,1672694442,1672697504,3062
3592,3403370192,3294703680,1672616821,1672616883,62
3721,3505111292,3559731671,1672606269,1672608913,2644
3529,3777330107,3512502036,1672585405,1672587592,2187
3858,3778040015,3686227677,1672696038,1672699186,3148
3878,3554944414,3779425804,1672542598,1672543968,1370
3572,3915162005,3519028898,1672667723,1672669774,2051
3441,3497095254,3335694356,1672594635,1672594896,261
3865,3714666884,3756704774,1672663049,1672666218,3169
3568,3715619259,3493017654,1672677674,1672679707,2033
3649,3774641380,3834963772,1672646247,1672648360,2113
3893,3807212280,3367509761,1672610525,1672612627,2102
3711,3760040019,3497095254,1672676312,1672676971,659
3448,3272030610,3604867757,1672686751,1672689531,2780
3506,3445206685,3780209375,1672694965,1672697858,2893
3577,3372223551,3621461051,1672614905,1672617381,2476
3833,3343816795,3384068080,1672684064,1672684347,283
3607,3928719932,3783163143,1672692111,1672693314,1203
3724,3974674109,3715400486,1672659540,1672661082,1542
3758,3497671225,3480991549,1672540083,1672541400,1317
3520,3783615982,3505634634,1672553632,1672553847,215
3638,3440137407,3518561777,1672610981,1672612560,1579
3855,3311085279,3889780657,1672599067,1672601231,2164
3427,3533274994,3401940259,1672588684,1672591304,2620
3518,3792949946,3299443125,1672621550,1672624867,3317
3707,3897134762,3272716462,1672541445,1672544321,2876
3608,3520657891,3793969543,1672575016,1672576162,1146
3522,3480726047,3633735593,1672627166,1672627448,282
3671,3638660068,3490214516,1672537522,1672538824,1302
3668,3778040015,3909094917,1672593248,1672593489,241
3761,3777240360,3283492940,1672585618,1672586937,1319
3762,3783520186,3755848152,1672681583,1672684172,2589
3862,3480991549,3636329663,1672625479,1672628287,2808
3455,3772391882,3904867554,1672553283,1672556287,3004
3656,3491684096,3791106564,1672532230,1672534662,2432
3680,3360616538,3347446226,1672538530,1672541869,3339
3671,3276003502,3821054646,1672618846,1672621093,2247
3775,3680843171,3390660440,1672556685,1672556778,93
3542,3811075491,3227799827,1672682974,1672683084,110
3669,3518653080,3516703758,1672659181,1672660018,837
3604,3372223551,3436257398,1672639216,1672642270,3054
3464,3333403880,3760640999,1672564968,1672566107,1139
3829,3509893027,3440107959,1672640670,1672641332,662
3507,3208452238,3347446226,1672641138,1672641395,257
3858,3516703758,3467988782,1672680864,1672682427,1563
3536,3306412634,3793743698,1672671514,1672671665,151
3689,3392943173,3792505974,1672694408,1672697618,3210
3663,3792020993,3513853403,1672673371,1672675233,1862
3443,3780680950,3839245934,1672697994,1672699088,1094
3705,3497808662,3520991398,1672558923,1672559470,547
3661,3334647380,3337322736,1672677409,1672678777,1368
3775,3791106564,3779738691,1672681141,1672684616,3475
3841,3755496114,3519909393,1672547200,1672547769,569
3575,3757332128,3315279093,1672585952,1672587802,1850
3645,3624297844,3463740710,1672588979,1672592440,3461
3648,3737972328,3513345163,1672580064,1672580972,908
3455,3436257398,3518653080,1672680435,1672681232,797
3533,3239617320,3618489670,1672594064,1672596371,2307
3437,3500827202,3446533960,1672625858,1672628162,2304
3796,3817813340,3271752081,1672585519,1672585900,381
3838,3513296868,3270056120,1672626249,1672629484,3235
3566,3757903168,3500915665,1672651356,1672654360,3004
3470,3416987084,3779425804,1672651222,1672651629,407
3520,3711812325,3336339664,1672576668,1672576743,75
3543,3224968597,3803517637,1672565214,1672565461,247
3750,3793407963,3783163143,1672562950,1672563020,70
3686,3773913680,3291933594,1672574898,1672575900,1002
3852,3755848152,3315279093,1672686663,1672687763,1100
3919,3447672935,3669146016,1672548828,1672551133,2305
3789,3890739241,3351866415,1672621441,1672622114,673
3854,3682133690,3780338697,1672703589,1672704413,824
3714,3534829213,3516513251,1672548839,1672549937,1098
3683,3777330107,3437286517,1672591017,1672593332,2315
3829,3774705415,3480726047,1672684900,1672687490,2590
3774,3517288083,3755532873,1672636439,1672639597,3158
3896,3774155692,3534126409,1672686372,1672687601,1229
3435,3231494505,3770676872,1672703348,1672704064,716
3453,3311498666,3509893027,1672590268,1672592164,1896
3523,3893912331,3556969573,1672665289,1672667475,2186
3706,3304971369,3711812325,1672603400,1672605125,1725
3539,3760362417,3279475486,1672548223,1672549896,1673
3590,3734915241,3609881958,1672547636,1672550132,2496
3814,3417679834,3298151889,1672573040,1672573921,881
3654,3770676872,3513545422,1672701344,1672702662,1318
3682,3402385957,3927165965,1672692392,1672693570,1178
3648,3791128487,3774243020,1672610098,1672611066,968
3615,3760640999,3520873221,1672683458,1672686828,3370
3542,3408430195,3520657891,1672540659,1672543905,3246
3787,3900898992,3774290799,1672649388,1672651804,2416
3707,3972083617,3615113018,1672540066,1672542323,2257
3783,3793583656,3773332082,1672630706,1672632192,1486
3834,3501525100,3826238375,1672673281,1672675629,2348
3814,3274831810,3711734586,1672569598,1672571948,2350
3862,3778597171,3200543880,1672620921,1672622259,1338
3680,3710496785,3551376095,1672595612,1672598050,2438
3801,3777184389,3703396825,1672594700,1672596250,1550
3894,3972192593,3533747868,1672663873,1672664382,509
3492,3440137407,3319167958,1672547807,1672548839,1032
3905,3514818819,3236499444,1672651070,1672653025,1955
3462,3938389661,3512392431,1672545155,1672547157,2002
3636,3680810086,3622357348,1672594546,1672596205,1659
3660,3283770991,3701322924,1672703074,1672703845,771
3589,3428725843,3311049964,1672611903,1672612432,529
3579,3899786664,3609933747,1672562993,1672566172,3179
3592,3480100311,3897456874,1672656927,1672659732,2805
3664,3776988674,3621683102,1672600536,1672601383,847
3766,3680843171,3511317276,1672542841,1672545136,2295
3656,3711077927,3375449013,1672584441,1672586683,2242
3757,3500703304,3467779445,1672577875,1672579396,1521
3726,3357689359,3533294425,1672544759,1672546201,1442
3898,3756704774,3624297844,1672548789,1672549300,511
3735,3334951866,3715086894,1672657379,1672659280,1901
3670,3685816610,3714128600,1672595184,1672598661,3477
3523,3533929349,3230135532,1672632618,1672635910,3292
3702,3609881958,3520991398,1672599646,1672599986,340
3865,3660887799,3501459390,1672644479,1672645130,651
3476,3934064792,3760040019,1672536172,1672537062,890
3483,3757903168,3774290799,1672667192,1672667922,730
3425,3638204468,3398731252,1672587197,1672587656,459
3587,3618176292,3970558632,1672533923,1672536608,2685
3461,3512383699,3533294425,1672617162,1672618865,1703
3753,3779613523,3392836218,1672681218,1672684621,3403
3615,3834631333,3737147209,1672603313,1672605892,2579
3894,3756127300,3755992176,1672633533,1672635167,1634
3617,3394401087,3755065949,1672688145,1672689840,1695
3528,3551376095,3510798825,1672561072,1672563852,2780
3697,3618808151,3374183227,1672580893,1672582491,1598
3818,3271454397,3833217041,1672613623,1672615695,2072
3881,3437286517,3451726367,1672578523,1672581552,3029
3648,3755222916,3288762795,1672592397,1672595214,2817
3498,3379143440,3774733620,1672681890,1672683128,1238
3608,3533004959,3970603231,1672677457,1672677994,537
3603,3626499450,3714666884,1672634692,1672638060,3368
3776,3232208416,3734451191,1672582772,1672586012,3240
3492,3711812325,3393063657,1672679100,1672679492,392
3692,3519850727,3979802715,1672680199,1672683024,2825
3637,3280054198,3817428320,1672697304,1672700055,2751
3490,3669146016,3296462324,1672566304,1672568174,1870
3832,3305722859,3756789525,1672624889,1672627065,2176
3876,3274831810,3347446226,1672637294,1672639630,2336
3852,3779301501,3288762795,1672613786,1672614017,231
3554,3372223551,3711812325,1672554250,1672554605,355
3801,3812534508,3773902805,1672670255,1672671448,1193
3819,3734915241,3714185969,1672654799,1672656966,2167
3549,3488763230,3551389192,1672536441,1672539194,2753
3503,3791046864,3716679950,1672569011,1672569953,942
3627,3713691388,3780680950,1672583496,1672586015,2519
3808,3500857494,3468041839,1672657522,1672658886,1364
3436,3807212280,3505888598,1672653181,1672653505,324
3559,3201676087,3299443125,1672687648,1672689727,2079
3733,3534829213,3755496114,1672609749,1672610216,467
3525,3514334067,3791613604,1672594403,1672597951,3548
3901,3505434346,3755756564,1672553360,1672555702,2342
3716,3510641433,3737972328,1672599830,1672601304,1474
3430,3779465522,3380130228,1672684886,1672687970,3084
3530,3551389192,3774705415,1672606693,1672609705,3012
3886,3736231757,3760364383,1672620249,1672620855,606
3741,3497808662,3624297844,1672538825,1672542228,3403
3499,3276003502,3814677862,1672680587,1672682233,1646
3848,3517991730,3756474459,1672663133,1672666521,3388
3494,3457960571,3306175858,1672565722,1672566407,685
3689,3783771827,3970558632,1672675538,1672677651,2113
3709,3515890966,3780115155,1672539967,1672541343,1376
3710,3756385685,3497095254,1672688510,1672689391,881
3469,3510837901,3415833929,1672647965,1672651144,3179
3445,3511442562,3716110860,1672682444,1672685667,3223
3735,3311049964,3511883730,1672668440,1672670804,2364
3655,3622357348,3231713082,1672556013,1672557913,1900
3910,3817813340,3497671225,1672550902,1672553868,2966
3621,3792014516,3512800570,1672601738,1672604214,2476
3868,3701247948,3757700712,1672548450,1672549307,857
3870,3774907131,3497671225,1672575187,1672575785,598
3544,3303410628,3533079336,1672546724,1672549218,2494
3774,3920898925,3505283390,1672571506,1672571566,60
3719,3711218296,3824641227,1672636832,1672638525,1693
3754,3777485931,3812369928,1672669692,1672672206,2514
3541,3401496246,3783550022,1672616785,1672617679,894
3795,3689114185,3792745809,1672625861,1672626427,566
3902,3780322355,3429943738,1672555502,1672556155,653
3768,3499217428,3557046880,1672687839,1672690055,2216
3809,3505437712,3899326793,1672673557,1672676892,3335
3858,3774641380,3463740710,1672559296,1672562810,3514
3790,3467988782,3770520359,1672630936,1672633534,2598
3704,3519142371,3351696332,1672648387,1672648769,382
3611,3774155692,3373028638,1672564248,1672567170,2922
3750,3374183227,3347419520,1672563535,1672563693,158
3599,3488686442,3711919537,1672624176,1672624887,711
3600,3209526819,3347446226,1672628930,1672629739,809
3642,3499217428,3617116290,1672571982,1672573664,1682
3733,3490029863,3808136029,1672701845,1672704155,2310
3860,3270042456,3511442562,1672535182,1672536380,1198
3645,3885155975,3475349791,1672693271,1672694052,781
3851,3779656423,3701884158,1672547343,1672549955,2612
3606,3276269264,3618489670,1672675852,1672678742,2890
3764,3310125159,3817813340,1672592607,1672593133,526
3682,3225029895,3492959689,1672674013,1672676363,2350
3523,3480100311,3792525861,1672598797,1672601815,3018
3819,3472312341,3776559988,1672653821,1672657126,3305
3573,3520322124,3826238375,1672592699,1672593260,561
3441,3792274796,3514246749,1672544229,1672547704,3475
3851,3500072204,3367971170,1672632718,1672634882,2164
3605,3811075491,3517358573,1672702783,1672706220,3437
3636,3736705719,3833217041,1672684841,1672685210,369
3755,3452016771,3500827202,1672655600,1672658292,2692
3485,3773027597,3455018347,1672678102,1672679394,1292
3715,3401793306,3773124276,1672617812,1672619805,1993
3486,3703139663,3534566651,1672677280,1672678729,1449
3603,3783520186,3241914067,1672587531,1672590322,2791
3875,3511601997,3354144091,1672558472,1672561910,3438
3718,3501786419,3777624586,1672551692,1672554518,2826
3752,3613416045,3435167810,1672625225,1672626548,1323
3635,3505888598,3817428320,1672565209,1672567242,2033
3732,3779639983,3711000597,1672576376,1672579518,3142
3809,3497095254,3500604680,1672683123,1672683478,355
3677,3517222913,3462158237,1672540311,1672541629,1318
3838,3387594369,3505198734,1672660302,1672661923,1621
3740,3349856820,3776244398,1672613510,1672616545,3035
3849,3710315160,3225029895,1672662795,1672665499,2704
3535,3534566651,3773027597,1672678454,1672679398,944
3676,3792442597,3288224595,1672546911,1672548055,1144
3790,3884596900,3509756823,1672614846,1672616425,1579
3562,3736705719,3773121782,1672633943,1672635040,1097
3921,3337362061,3637313265,1672634368,1672634960,592
3804,3510641433,3350095157,1672628542,1672630914,2372
3548,3834963772,3757383891,1672672385,1672675657,3272
3701,3783641602,3291933594,1672578308,1672579438,1130
3778,3448633776,3793969543,1672687751,1672688021,270
3565,3793583656,3551399764,1672633387,1672636607,3220
3773,3611055563,3774790271,1672619497,1672620943,1446
3882,3520416075,3609933747,1672688060,1672690494,2434
3807,3379143440,3897435944,1672601769,1672604538,2769
3510,3360813161,3823084403,1672582131,1672582510,379
3838,3512383699,3520560590,1672581194,1672582208,1014
3658,3703348097,3300818269,1672567261,1672570583,3322
3494,3703396825,3509764635,1672606152,1672608306,2154
3752,3971806004,3682133690,1672549806,1672551289,1483
3512,3500302272,3306412634,1672649085,1672649966,881
3734,3408498208,3515890966,1672576587,1672577834,1247
3568,3511601997,3515439826,1672618475,1672618846,371
3720,3905899155,3468041839,1672558877,1672561199,2322
3776,3633735593,3200308999,1672580348,1672583403,3055
3425,3710048469,3491684096,1672660692,1672661427,735
3482,3457620713,3774155692,1672614590,1672617482,2892
3692,3285204083,3620292035,1672670310,1672673821,3511
3775,3343132529,3914691363,1672681861,1672682958,1097
3758,3300818269,3770624662,1672558320,1672559809,1489
3843,3551389192,3760651515,1672550226,1672551886,1660
3457,3293835352,3514285803,1672685200,1672686989,1789
3426,3470454332,3272096759,1672586637,1672589475,2838
3907,3401940259,3512882178,1672667468,1672669546,2078
3731,3889780657,3620292035,1672646284,1672649043,2759
3678,3755573472,3808136029,1672587511,1672590167,2656
3893,3330340793,3379143440,1672655577,1672657819,2242
3500,3938389661,3897456874,1672564040,1672567449,3409
3658,3713941638,3921648519,1672547634,1672551074,3440
3821,3635169815,3470454332,1672588445,1672588543,98
3864,3716272919,3617489344,1672566300,1672568203,1903
3703,3505437712,3755065949,1672690773,1672693534,2761
3694,3500613493,3734451191,1672593900,1672594044,144
3774,3607882826,3711218296,1672617639,1672620519,2880
3582,3703433819,3703396825,1672628018,1672630754,2736
3504,3715619259,3730071479,1672686223,1672687936,1713
3582,3497095254,3774705415,1672634974,1672638486,3512
3658,3520355798,3311085279,1672580617,1672583386,2769
3795,3271752081,3792546035,1672617828,1672618267,439
3583,3505481368,3617304541,1672699355,1672700804,1449
3750,3803517637,3633735593,1672554196,1672554559,363
3487,3779786641,3774718695,1672634222,1672637690,3468
3425,3757383891,3928511283,1672562508,1672564361,1853
3666,3408430195,3500044458,1672636018,1672639108,3090
3486,3311098437,3668747074,1672573090,1672574382,1292
3683,3375449013,3333918941,1672609063,1672611237,2174
3644,3773572967,3714678331,1672688760,1672690737,1977
3678,3773121782,3475349791,1672535855,1672537167,1312
3646,3970627281,3912891315,1672576630,1672578099,1469
3425,3520764926,3416987084,1672657176,1672659902,2726
3622,3713784974,3783919913,1672593391,1672595979,2588
3551,3518561777,3472068734,1672580940,1672583553,2613
3461,3853629553,3780872464,1672692449,1672693121,672
3504,3774290799,3829822608,1672541877,1672541959,82
3495,3226178937,3792801638,1672598156,1672599297,1141
3572,3685816610,3516444201,1672585732,1672585937,205
3844,3559458968,3792072681,1672552879,1672553850,971
3837,3770236215,3774243020,1672558675,1672559599,924
3616,3711637255,3534175249,1672679637,1672682440,2803
3540,3394401087,3518561777,1672582679,1672582862,183
3711,3440137407,3225631197,1672581149,1672581905,756
3741,3774907131,3661447322,1672576542,1672577342,800
3700,3459681410,3923420131,1672655196,1672656468,1272
3465,3421877923,3208957949,1672650757,1672651119,362
3542,3774178201,3897435944,1672683796,1672685544,1748
3803,3510767239,3618176292,1672606819,1672607497,678
3727,3421385957,3454277788,1672687347,1672690898,3551
3782,3757383891,3424445495,1672600670,1672603583,2913
3557,3515890966,3852533643,1672578452,1672579240,788
3576,3392943173,3835985172,1672589158,1672591581,2423
3754,3757903168,3229822507,1672538827,1672542161,3334
3427,3225631197,3312998540,1672538327,1672540006,1679
3479,3912891315,3774718695,1672579273,1672581186,1913
3895,3621790707,3760694096,1672687337,1672689468,2131
3667,3511843593,3462273042,1672590976,1672592183,1207
3675,3755992176,3833217041,1672555084,1672557203,2119
3734,3900945856,3899786664,1672686365,1672689414,3049
3598,3461119815,3895285664,1672534925,1672536412,1487
3658,3927165965,3279475486,1672660143,1672660526,383
3891,3475349791,3920625129,1672603428,1672605835,2407
3921,3368283077,3792546035,1672611385,1672612382,997
3812,3803389195,3519416013,1672678458,1672679410,952
3589,3481640525,3514971533,1672576503,1672578335,1832
3622,3409114719,3334974375,1672651599,1672654083,2484
3774,3412006598,3410538749,1672559273,1672562725,3452
3898,3334647380,3609659642,1672532196,1672534423,2227
3573,3716963089,3551389192,1672586250,1672588080,1830
3632,3779656423,3760362417,1672536182,1672537351,1169
3866,3885121158,3500613493,1672535892,1672539087,3195
3621,3604867757,3831586487,1672551265,1672553200,1935
3523,3505888598,3701005527,1672591999,1672594841,2842
3646,3534566651,3238288884,1672698185,1672700168,1983
3874,3975717896,3276269264,1672652313,1672654509,2196
3746,3774155692,3514971533,1672532867,1672535571,2704
3759,3276269264,3669146016,1672638734,1672640490,1756
3545,3438078818,3414940786,1672603973,1672604694,721
3474,3921648519,3757332128,1672684638,1672686248,1610
3739,3777037426,3393063657,1672539297,1672542651,3354
3527,3505228454,3510028805,1672547521,1672548986,1465
3454,3617392620,3394297564,1672626546,1672628480,1934
3794,3225631197,3501384020,1672682840,1672684891,2051
3826,3533929349,3760842815,1672597759,1672601027,3268
3915,3341893384,3334974375,1672613974,1672615070,1096
3823,3736231757,3343816795,1672631889,1672634381,2492
3744,3892304880,3248058676,1672572158,1672572494,336
3676,3338083680,3510187271,1672643550,1672645512,1962
3536,3793781065,3819767045,1672607665,1672610853,3188
3430,3519282716,3201629017,1672537598,1672539500,1902
3487,3279475486,3534764451,1672534917,1672536331,1414
3626,3411688875,3793935736,1672589660,1672592940,3280
3917,3755158925,3418448389,1672652651,1672655617,2966
3572,3710854064,3371455553,1672629124,1672629507,383
3599,3230868435,3635169815,1672570483,1672571775,1292
3515,3834631333,3757075324,1672692144,1672695655,3511
3667,3904412440,3711734586,1672645381,1672646407,1026
3614,3520355798,3491469603,1672560802,1672563745,2943
3782,3618176292,3534357694,1672643620,1672645513,1893
3486,3701322924,3280054198,1672680479,1672682805,2326
3748,3202141727,3516703758,1672641488,1672642076,588
3825,3760263530,3501459390,1672563306,1672563494,188
3604,3772236797,3383138270,1672697891,1672698740,849
3793,3739154408,3684523966,1672633269,1672633457,188
3601,3682133690,3520560590,1672534718,1672537174,2456
3653,3335694356,3451326054,1672658605,1672658688,83
3606,3461119815,3240394404,1672608150,1672609150,1000
3546,3757630221,3512337405,1672647937,1672649197,1260
3803,3755573472,3710008361,1672638282,1672640979,2697
3783,3793883863,3360813161,1672631620,1672631953,333
3470,3623266256,3519909393,1672609341,1672611617,2276
3664,3509764635,3660063072,1672662178,1672665630,3452
3564,3533747868,3238288884,1672566608,1672567017,409
3473,3514334067,3770236215,1672662749,1672665120,2371
3858,3500044458,3519446663,1672692173,1672692787,614
3546,3517590837,3891672228,1672656844,1672657685,841
3500,3609659642,3755532873,1672670378,1672672244,1866
3471,3517697722,3736705719,1672573107,1672574946,1839
3561,3834960360,3615115210,1672690579,1672691311,732
3744,3667427125,3760721303,1672649880,1672650781,901
3736,3715854030,3515890966,1672619889,1672620516,627
3804,3283144118,3500613459,1672678383,1672681252,2869
3503,3972083617,3733363628,1672658592,1672659174,582
3693,3774178201,3462273042,1672647662,1672650344,2682
3663,3756385685,3791128487,1672648340,1672648619,279
3591,3285204083,3369708250,1672551237,1672554710,3473
3599,3783771827,3689697817,1672649844,1672652059,2215
3847,3519651506,3777485931,1672658568,1672660112,1544
3634,3399518841,3792505974,1672605302,1672606584,1282
3582,3515525630,3448875382,1672570713,1672572056,1343
3462,3270056120,3793175445,1672598013,1672598085,72
3787,3912891315,3225631197,1672656029,1672657343,1314
3716,3633735593,3792274796,1672673182,1672675075,1893
3517,3770676872,3520639768,1672564611,1672568067,3456
3574,3900945856,3512946768,1672661990,1672662578,588
3700,3757193307,3774155692,1672643690,1672647269,3579
3436,3517687662,3683113954,1672574635,1672574834,199
3750,3972083617,3638204468,1672541164,1672544557,3393
3919,3714128600,3446533960,1672589654,1672592882,3228
3825,3513296868,3731646673,1672618809,1672619138,329
3884,3934064792,3773009828,1672643680,1672644049,369
3909,3615087943,3774290799,1672626430,1672628143,1713
3809,3778926763,3711097754,1672690111,1672693666,3555
3910,3467779445,3713784974,1672619897,1672623369,3472
3448,3783340788,3364378127,1672680240,1672682727,2487
3560,3898314440,3511150845,1672671714,1672674033,2319
3542,3336339664,3231494505,1672545260,1672545387,127
3858,3511601997,3774718695,1672661325,1672661603,278
3603,3501215099,3440137407,1672618065,1672619504,1439
3717,3755573472,3715127070,1672584290,1672587500,3210
3647,3515402792,3791246640,1672668254,1672668613,359
3539,3791106564,3618808151,1672542421,1672543683,1262
3591,3711853996,3505266860,1672643586,1672646929,3343
3864,3248058676,3492546679,1672673278,1672675148,1870
3610,3739661856,3801645328,1672631968,1672633450,1482
3560,3303410628,3780115155,1672620443,1672620572,129
3902,3481640525,3447514821,1672616468,1672619973,3505
3808,3512392431,3772391882,1672603946,1672605129,1183
3871,3624297844,3604867757,1672594615,1672597343,2728
3706,3812369928,3755233658,1672537940,1672538032,92
3558,3779786641,3755573472,1672630825,1672631441,616
3429,3228888030,3478114114,1672605815,1672605974,159
3798,3858172636,3783771827,1672608622,1672611164,2542
3724,3834631333,3294747828,1672679329,1672681553,2224
3507,3604867757,3778134418,1672673183,1672673538,355
3843,3734451191,3520764926,1672533477,1672533857,380
3720,3859868849,3436025562,1672689914,1672693028,3114
3620,3618176292,3701322924,1672543985,1672544052,67
3428,3927599181,3511024016,1672700893,1672703868,2975
3429,3760362417,3225636215,1672576707,1672577740,1033
3529,3701882224,3812534508,1672615320,1672615426,106
3612,3683113954,3517358573,1672654681,1672656547,1866
3763,3438078818,3490214516,1672600653,1672603126,2473
3672,3236499444,3515890966,1672584258,1672585042,784
3762,3510554314,3280268483,1672660411,1672660546,135
3425,3518565331,3501121099,1672664418,1672665599,1181
3572,3517697722,3517462308,1672595264,1672596999,1735
3473,3505228454,3519416013,1672677804,1672679832,2028
3453,3514956366,3512830734,1672561375,1672564742,3367
3858,3511791953,3510554314,1672667259,1672667832,573
3739,3362641275,3779938251,1672646446,1672649040,2594
3837,3736705719,3428027649,1672585123,1672587311,2188
3735,3972083617,3505179890,1672659140,1672660731,1591
3658,3288762795,3556969573,1672599247,1672602480,3233
3830,3792442597,3780253901,1672688988,1672690307,1319
3442,3515525630,3414049538,1672608109,1672611047,2938
3752,3517358573,3617489344,1672610756,1672614078,3322
3801,3559731671,3713517039,1672664394,1672666174,1780
3767,3607768197,3812369928,1672577003,1672579476,2473
3454,3755065949,3938503547,1672648004,1672649779,1775
3851,3200308999,3933894942,1672545839,1672549302,3463
3475,3783169442,3622357348,1672587686,1672590119,2433
3863,3778597171,3713561276,1672544166,1672545312,1146
3651,3760094385,3783641602,1672692606,1672693149,543
3663,3500613459,3605221116,1672538153,1672538666,513
3732,3500703304,3520639768,1672551810,1672554074,2264
3896,3511317276,3613206049,1672699580,1672702342,2762
3914,3443357683,3224968597,1672643426,1672646642,3216
3880,3485540729,3513065217,1672666545,1672666782,237
3681,3449639012,3974674109,1672663298,1672664382,1084
3425,3519651506,3514246749,1672681411,1672684328,2917
3869,3774705415,3379143440,1672581077,1672583056,1979
3719,3852686295,3814305099,1672665287,1672668252,2965
3429,3369708250,3511883730,1672579717,1672581969,2252
3682,3661447322,3772078494,1672641940,1672643149,1209
3481,3792801638,3512392431,1672656932,1672657342,410
3805,3972083617,3834631333,1672583709,1672586555,2846
3865,3774031303,3514512367,1672589596,1672591682,2086
3671,3500317969,3505228454,1672648197,1672649889,1692
3643,3338083680,3774290799,1672697460,1672698835,1375
3520,3201800997,3501215099,1672564718,1672564908,190
3635,3311498666,3270056120,1672671182,1672673742,2560
3446,3713163045,3248058676,1672609128,1672609477,349
3504,3500949309,3793418209,1672584713,1672584863,150
3693,3780680950,3895285664,1672701703,1672702545,842
3826,3638660068,3819767045,1672702789,1672705277,2488
3618,3619922891,3777814504,1672538733,1672540501,1768
3555,3520873221,3392943173,1672687480,1672688665,1185
3711,3710048469,3240394404,1672582514,1672583765,1251
3695,3852533643,3904412440,1672560360,1672563585,3225
3842,3399518841,3556969573,1672652993,1672654727,1734
3662,3921648519,3510818674,1672549152,1672551683,2531
3501,3711218296,3412006598,1672638479,1672639463,984
3650,3351696332,3823084403,1672642674,1672644711,2037
3677,3201629017,3385323994,1672582775,1672585635,2860
3548,3505888598,3334951866,1672619620,1672622999,3379
3504,3357864626,3604867757,1672689722,1672691174,1452
3471,3446533960,3970627281,1672623611,1672627188,3577
3829,3220031931,3225029895,1672690045,1672692177,2132
3897,3279473441,3370068529,1672550005,1672551881,1876
3876,3229974066,3467988782,1672554250,1672556957,2707
3778,3511843593,3713163045,1672557006,1672557455,449
3765,3280268483,3715619259,1672588877,1672591390,2513
3741,3511791953,3715545685,1672637397,1672640441,3044
3901,3920898925,3270042456,1672648951,1672650708,1757
3455,3899786664,3512379024,1672577726,1672579842,2116
3455,3713589994,3756789525,1672692247,1672695240,2993
3593,3505481368,3631479562,1672558348,1672558995,647
3551,3336339664,3505111292,1672549136,1672552034,2898
3645,3792020993,3370068529,1672695277,1672695386,109
3640,3818575661,3605221116,1672567358,1672567418,60
3903,3736231757,3613899351,1672596052,1672598014,1962
3504,3500442734,3774155692,1672615355,1672616437,1082
3727,3772078494,3938389661,1672595092,1672597688,2596
3754,3519028898,3200543880,1672599592,1672601455,1863
3889,3501281016,3394401087,1672580809,1672581184,375
3853,3885155975,3760694096,1672696607,1672696679,72
3577,3688796737,3511150845,1672621926,1672625395,3469
3817,3791128487,3783163143,1672543889,1672547039,3150
3453,3783550022,3505154885,1672700841,1672702486,1645
3446,3625463628,3680810086,1672688608,1672690876,2268
3897,3431502855,3773913680,1672695611,1672698488,2877
3775,3284932450,3930242012,1672623577,1672624642,1065
3554,3390660440,3701107228,1672558537,1672559515,978
3549,3497671225,3777779869,1672636206,1672637053,847
3653,3755756564,3703383853,1672543576,1672543791,215
3634,3638660068,3497671225,1672542577,1672543441,864
3524,3303410628,3516741440,1672582334,1672585388,3054
3617,3203538212,3890739241,1672620910,1672622475,1565
3827,3904412440,3792538417,1672644595,1672646616,2021
3557,3710735406,3938503547,1672583069,1672584368,1299
3431,3478114114,3554186380,1672637445,1672638037,592
3561,3780209375,3710315160,1672605717,1672608193,2476
3607,3605221116,3792745809,1672537226,1672539381,2155
3473,3715986185,3756746867,1672627241,1672630374,3133
3461,3510818674,3791613604,1672584269,1672585497,1228
3856,3779613523,3757700712,1672600497,1672603018,2521
3794,3780322355,3738026330,1672546053,1672549628,3575
3616,3510499038,3438489358,1672636839,1672638224,1385
3467,3829864515,3501121099,1672629467,1672631214,1747
3877,3715986185,3791613604,1672577624,1672579209,1585
3814,3713300120,3505402439,1672650286,1672652017,1731
3817,3779738691,3513360004,1672684551,1672684746,195
3536,3436257398,3778597171,1672604898,1672608137,3239
3489,3739911441,3372223551,1672654706,1672657989,3283
3807,3715086894,3600876425,1672703744,1672706933,3189
3850,3517881647,3387594369,1672645259,1672648124,2865
3818,3347419520,3713941638,1672547569,1672548048,479
3760,3899326793,3201800997,1672628909,1672629418,509
3860,3272096759,3739911441,1672626510,1672627191,681
3690,3912891315,3839245934,1672551278,1672553577,2299
3636,3757700712,3783147088,1672559307,1672561969,2662
3546,3533188828,3364726656,1672684189,1672687216,3027
3902,3367971170,3625463628,1672663830,1672666395,2565
3507,3415833929,3779646172,1672639046,1672642407,3361
3674,3617304541,3791693821,1672687488,1672690785,3297
3856,3517358573,3309314379,1672634739,1672638317,3578
3729,3734915241,3334951866,1672651236,1672651968,732
3425,3520322124,3715986185,1672650431,1672653573,3142
3675,3621461051,3479851674,1672691935,1672694488,2553
3459,3224811762,3200543880,1672651583,1672653346,1763
3899,3615939504,3201629017,1672654870,1672658210,3340
3448,3399518841,3240394404,1672540946,1672541815,869
3893,3505178849,3511732493,1672594599,1672596561,1962
3516,3534543776,3778597171,1672568296,1672569679,1383
3456,3776084820,3902625986,1672664869,1672665049,180
3624,3835422146,3932478321,1672701859,1672704762,2903
3593,3716110860,3288762795,1672581909,1672584096,2187
3561,3710562338,3812534508,1672595239,1672598177,2938
3629,3701005527,3462636434,1672557661,1672560863,3202
3513,3319167958,3757630221,1672560211,1672562108,1897
3738,3443357683,3914691363,1672656072,1672656631,559
3708,3309314379,3829822608,1672540708,1672541731,1023
3903,3517697722,3225631197,1672682071,1672684649,2578
3586,3977352557,3308760650,1672685712,1672688760,3048
3862,3793883863,3440137407,1672583443,1672585664,2221
3624,3343132529,3780834916,1672676794,1672679027,2233
3842,3817428320,3517222913,1672622172,1672623643,1471
3539,3713561276,3505111292,1672594812,1672596011,1199
3687,3774155692,3516513251,1672597842,1672600460,2618
3753,3387594369,3516741440,1672593831,1672597047,3216
3458,3510499038,3511883730,1672659125,1672662627,3502
3587,3299125059,3232208416,1672603101,1672605990,2889
3486,3792020993,3399472693,1672604820,1672608241,3421
3531,3815250107,3779646172,1672557096,1672559162,2066
3468,3776117322,3823084403,1672620673,1672622614,1941
3842,3373089838,3279242917,1672534210,1672536799,2589
3450,3511883730,3514956366,1672689763,1672690098,335
3672,3272030610,3517600136,1672554667,1672557986,3319
3523,3512800570,3688490530,1672618266,1672619629,1363
3819,3780472203,3384583385,1672556500,1672559920,3420
3485,3226511603,3772236797,1672552042,1672553717,1675
3717,3500777439,3639050419,1672556078,1672557612,1534
3776,3509764635,3399518841,1672612768,1672615759,2991
3693,3608855425,3513327337,1672629630,1672631810,2180
3540,3756746867,3300511067,1672564346,1672565341,995
3433,3511288998,3438078818,1672661895,1672662369,474
3657,3500072204,3757348722,1672672439,1672672616,177
3618,3534175249,3615688740,1672578206,1672580672,2466
3893,3500317969,3757193551,1672657503,1672660393,2890
3805,3755915206,3713768950,1672646520,1672648115,1595
3829,3468041839,3436257398,1672691710,1672694884,3174
3771,3306175858,3755992176,1672621896,1672623191,1295
3527,3736705719,3511732493,1672573583,1672575582,1999
3711,3450286949,3713163045,1672684495,1672686858,2363
3889,3755496114,3226511603,1672566420,1672568909,2489
3648,3497095254,3783433404,1672648421,1672650793,2372
3575,3608922867,3821054646,1672654899,1672657424,2525
3860,3284932450,3920898925,1672570302,1672571065,763
3821,3791128487,3732584121,1672576167,1672578453,2286
3815,3920497528,3736705719,1672563525,1672566281,2756
3534,3778667336,3783615982,1672612606,1672613422,816
3429,3715443333,3835985172,1672578816,1672580647,1831
3495,3334993594,3505725706,1672662939,1672664258,1319
3473,3714827719,3773332082,1672628874,1672629532,658
3722,3511024016,3241914067,1672692805,1672695580,2775
3462,3311420950,3228888030,1672614349,1672615248,899
3450,3376467719,3270697740,1672701119,1672703138,2019
3885,3773009828,3384583385,1672610710,1672612611,1901
3558,3760094385,3779438325,1672630561,1672631910,1349
3626,3779938251,3776559988,1672549599,1672552710,3111
3900,3512946768,3274906650,1672562833,1672564412,1579
3763,3515402792,3205923620,1672586692,1672588235,1543
3430,3703433819,3792949946,1672672310,1672673705,1395
3660,3462273042,3935913584,1672612661,1672613949,1288
3828,3755344363,3206837348,1672543046,1672545012,1966
3462,3270056120,3505437712,1672619009,1672621462,2453
3603,3311098437,3517881647,1672583125,1672583541,416
3853,3713691388,3793175445,1672620945,1672624087,3142
3724,3513065217,3369708250,1672626205,1672626459,254
3850,3451691949,3505847380,1672692684,1672694735,2051
3438,3900276517,3304155815,1672682553,1672683574,1021
3535,3977352557,3206837348,1672638234,1672641137,2903
3623,3357289672,3480991549,1672674517,1672675361,844
3650,3366423342,3755532873,1672554412,1672554755,343
3856,3341893384,3792949946,1672680039,1672682699,2660
3742,3904412440,3517358573,1672658608,1672659589,981
3759,3201676087,3783520186,1672686850,1672689410,2560
3485,3615113018,3330340793,1672576128,1672576668,540
3680,3715443333,3500208903,1672531222,1672533644,2422
3495,3716272919,3316798920,1672549606,1672549937,331
3656,3505995057,3236499444,1672553203,1672556080,2877
3876,3449639012,3394401087,1672627910,1672628573,663
3763,3680810086,3770468980,1672642696,1672643512,816
3872,3757700712,3294703680,1672594416,1672597265,2849
3548,3372223551,3513081354,1672657030,1672658166,1136
3729,3276217799,3283770991,1672555681,1672556965,1284
3880,3519416013,3505198734,1672677839,1672678191,352
3686,3510919821,3450286949,1672645165,1672646876,1711
3816,3226178937,3734118023,1672689284,1672689909,625
3912,3714120857,3401496246,1672614510,1672617666,3156
3609,3513296868,3783919913,1672567070,1672568725,1655
3559,3926643445,3520873221,1672674722,1672677561,2839
3515,3384068080,3404025196,1672690034,1672690759,725
3779,3604589802,3792389522,1672686074,1672688335,2261
3689,3802932312,3488686442,1672645348,1672645687,339
3436,3836241528,3793781065,1672595567,1672598686,3119
3857,3446533960,3779646172,1672643706,1672644018,312
3819,3404025196,3533294425,1672626661,1672629916,3255
3670,3773027597,3448633776,1672573409,1672575235,1826
3647,3380767040,3382733096,1672598290,1672599945,1655
3442,3518194482,3239617320,1672651405,1672653619,2214
3732,3823084403,3511005395,1672574524,1672576658,2134
3892,3756704774,3514308235,1672680978,1672683953,2975
3492,3380982774,3462273042,1672546973,1672547387,414
3910,3930242012,3517697722,1672549315,1672552394,3079
3717,3516489668,3351866415,1672698721,1672699886,1165
3534,3618808151,3456430614,1672621030,1672621562,532
3528,3779854934,3774718695,1672594661,1672596448,1787
3470,3760694096,3600876425,1672695272,1672698736,3464
3903,3271752081,3514275974,1672605127,1672607836,2709
3747,3500737582,3802932312,1672632734,1672633370,636
3888,3203538212,3713979100,1672678206,1672678468,262
3787,3779892400,3777147510,1672535807,1672536698,891
3697,3512383699,3779639983,1672616974,1672617959,985
3867,3772765746,3793935736,1672608350,1672608604,254
3607,3510641433,3276348699,1672551208,1672553823,2615
3844,3783147088,3600876425,1672677327,1672679498,2171
3568,3710048469,3517600136,1672689495,1672692930,3435
3595,3701247948,3852686295,1672667619,1672670861,3242
3592,3303410628,3501121099,1672639705,1672643019,3314
3828,3776117322,3912891315,1672543108,1672543234,126
3643,3404025196,3906536154,1672549353,1672550614,1261
3514,3330340793,3513296868,1672615403,1672617443,2040
3800,3557046880,3760040019,1672679316,1672680246,930
3785,3554186380,3756704774,1672608182,1672609591,1409
3500,3927165965,3774290799,1672659332,1672660797,1465
3488,3533079336,3241790910,1672562974,1672566057,3083
3848,3776244398,3774155692,1672588619,1672591474,2855
3855,3755496114,3520873221,1672691555,1672693388,1833
3868,3236458894,3513065217,1672540797,1672544351,3554
3900,3510837901,3930242012,1672592961,1672595883,2922
3881,3793315718,3774243020,1672553388,1672553472,84
3735,3270042456,3520560590,1672606768,1672606978,210
3657,3517737088,3227799827,1672656333,1672658530,2197
3490,3755344363,3852533643,1672608261,1672611005,2744
3811,3513360004,3200543880,1672639369,1672642761,3392
3840,3716272919,3757294769,1672698515,1672700468,1953
3530,3505179890,3304155815,1672697220,1672698341,1121
3692,3774243020,3891672228,1672682387,1672685281,2894
3482,3904867554,3713561276,1672691441,1672693100,1659
3717,3780769110,3500442734,1672556239,1672556785,546
3832,3456430614,3713517039,1672644191,1672647287,3096
3741,3341893384,3757700712,1672550044,1672552981,2937
3720,3912891315,3895285664,1672582341,1672582545,204
3645,3206837348,3711006062,1672613012,1672613211,199
3839,3446533960,3495911207,1672651371,1672652655,1284
3786,3713941638,3703396825,1672622427,1672624087,1660
3819,3970909253,3600876425,1672660033,1672660337,304
3681,3401496246,3710315160,1672603962,1672605927,1965
3653,3884596900,3979802715,1672644373,1672647838,3465
3429,3501384020,3455018347,1672681626,1672682959,1333
3823,3201676087,3778597171,1672620892,1672621383,491
3852,3793418209,3273981374,1672661489,1672664235,2746
3679,3900898992,3756704774,1672597981,1672601355,3374
3476,3934064792,3811075491,1672701256,1672701996,740
3809,3608855425,3800257590,1672647147,1672650473,3326
3754,3757323954,3730071479,1672617058,1672618496,1438
3756,3279242917,3519909393,1672623145,1672623786,641
3486,3668414677,3276003502,1672567949,1672571353,3404
3571,3778040015,3337322736,1672595842,1672596322,480
3858,3554186380,3791046864,1672534570,1672537156,2586
3600,3513018485,3283492940,1672606948,1672609643,2695
3757,3931627862,3294703680,1672645841,1672647291,1450
3804,3608232640,3783928182,1672661951,1672664354,2403
3839,3793935736,3701884158,1672538344,1672540856,2512
3813,3783373154,3516741440,1672612032,1672613334,1302
3574,3518561777,3293835352,1672673395,1672676152,2757
3635,3514971533,3902861231,1672682984,1672685527,2543
3592,3839245934,3777147510,1672627499,1672628242,743
3706,3793743698,3500857494,1672599338,1672600335,997
3530,3779854934,3715127070,1672607024,1672610530,3506
3747,3661447322,3533079336,1672621333,1672621795,462
3539,3514246749,3757193307,1672569484,1672570270,786
3694,3716963089,3299125059,1672582339,1672585383,3044
3523,3533294425,3711097754,1672587791,1672589853,2062
3476,3224811762,3783771827,1672600579,1672602056,1477
3458,3205923620,3276003502,1672656369,1672659758,3389
3525,3618808151,3380130228,1672658117,1672660582,2465
3861,3436257398,3885155975,1672578403,1672580155,1752
3566,3815250107,3817813340,1672638382,1672639727,1345
3858,3621683102,3975717896,1672602425,1672605714,3289
3541,3299125059,3715986185,1672634955,1672637459,2504
3867,3513545422,3511843593,1672580198,1672580864,666
3505,3783520186,3916490839,1672655614,1672656812,1198
3497,3856606678,3375449013,1672668049,1672668321,272
3808,3516741440,3316798920,1672692482,1672695338,2856
3659,3756474459,3298151889,1672581113,1672582828,1715
3648,3902625986,3517358573,1672531369,1672533194,1825
3630,3220031931,3203538212,1672670055,1672671196,1141
3617,3387594369,3534543776,1672638212,1672640031,1819
3689,3778134418,3715707380,1672617676,1672618688,1012
3460,3893912331,3701322924,1672539881,1672543075,3194
3755,3923420131,3615688740,1672559781,1672562161,2380
3546,3792274796,3441703884,1672616362,1672618061,1699
3590,3760645796,3912891315,1672670840,1672673486,2646
3505,3414940786,3885155975,1672560237,1672563284,3047
3753,3710735406,3608232640,1672558277,1672561150,2873
3591,3375449013,3305722859,1672651891,1672653653,1762
3803,3276269264,3783520186,1672632052,1672632117,65
3480,3438489358,3230135532,1672636981,1672637224,243
3597,3778640261,3757332128,1672646009,1672648794,2785
3805,3501121099,3755737419,1672640545,1672642366,1821
3880,3783136330,3770624662,1672644130,1672647262,3132
3747,3779786641,3689114185,1672548626,1672549117,491
3914,3760645796,3375449013,1672666059,1672666395,336
3788,3505266860,3316798920,1672623473,1672624155,682
3488,3518229776,3515439826,1672574619,1672575392,773
3482,3609659642,3472312341,1672661040,1672661649,609
3536,3713941638,3500208903,1672550808,1672551632,824
3630,3899786664,3505178849,1672605158,1672607896,2738
3428,3500109249,3226178937,1672537881,1672539606,1725
3919,3451691949,3515466096,1672700954,1672704415,3461
3860,3630353876,3783520186,1672684724,1672686304,1580
3716,3236354255,3780571086,1672627541,1672630451,2910
3739,3831586487,3272716462,1672614353,1672614496,143
3864,3703139663,3454277788,1672690752,1672693651,2899
3681,3779301501,3519282716,1672532932,1672533464,532
3505,3680810086,3703348097,1672619889,1672621140,1251
3521,3703433819,3817813340,1672659256,1672661955,2699
3464,3478114114,3279473441,1672629609,1672632378,2769
3673,3912891315,3713768950,1672650883,1672654065,3182
3524,3475349791,3823084403,1672676263,1672676509,246
3611,3714670620,3815250107,1672632987,1672633143,156
3747,3774243020,3492546679,1672615073,1672617217,2144
3834,3343816795,3451326054,1672534296,1672536137,1841
3915,3511150845,3248058676,1672675992,1672677904,1912
3692,3226178937,3777694660,1672659827,1672660120,293
3803,3970558632,3972192593,1672552391,1672552595,204
3597,3501786419,3812534508,1672590163,1672590281,118
3820,3739154408,3774876004,1672685156,1672687059,1903
3781,3499217428,3341893384,1672618980,1672619110,130
3555,3668414677,3772236797,1672553227,1672553301,74
3508,3534179433,3778640261,1672592235,1672593223,988
3434,3755065949,3490029863,1672559222,1672562044,2822
3472,3793743698,3613416045,1672673551,1672676511,2960
3436,3224968597,3362641275,1672616498,1672618726,2228
3833,3437286517,3711077927,1672615909,1672618471,2562
3869,3920625129,3622665543,1672682008,1672682894,886
3663,3701373490,3793175445,1672655126,1672656668,1542
3578,3270056120,3343816795,1672651598,1672653410,1812
3569,3701664364,3755404116,1672700878,1672703287,2409
3522,3739895284,3501121099,1672582836,1672583392,556
3752,3774790271,3511150845,1672640089,1672641281,1192
3447,3716272919,3792546035,1672586023,1672588032,2009
3828,3511442562,3517881647,1672619799,1672620221,422
3454,3513296868,3779738691,1672581646,1672584993,3347
3650,3617116290,3739895284,1672550253,1672553686,3433
3669,3505198734,3520578796,1672601975,1672605494,3519
3650,3500613459,3396726504,1672675489,1672677519,2030
3845,3833217041,3780115155,1672614538,1672615820,1282
3743,3772391882,3935487534,1672539132,1672539769,637
3798,3392836218,3472068734,1672624986,1672628133,3147
3481,3468041839,3470454332,1672561353,1672561699,346
3850,3780427126,3621683102,1672652679,1672653786,1107
3804,3497671225,3551389192,1672577796,1672577963,167
3849,3774641380,3684523966,1672600516,1672603542,3026
3897,3514956366,3779892400,1672582172,1672582711,539
3718,3515525630,3934064792,1672591985,1672594252,2267
3907,3283492940,3414940786,1672639441,1672640537,1096
3909,3904867554,3514419100,1672633761,1672636416,2655
3425,3519446663,3621683102,1672681765,1672684605,2840
3556,3777147510,3793315718,1672593012,1672596099,3087
3700,3604867757,3500525825,1672615452,1672618183,2731
3750,3776117322,3552824113,1672609744,1672611294,1550
3519,3551399764,3551389192,1672703707,1672706892,3185
3714,3517288083,3703348097,1672668374,1672669883,1509
3539,3715707380,3291933594,1672694783,1672697633,2850
3587,3208957949,3390660440,1672585643,1672586946,1303
3897,3792274796,3497671225,1672566700,1672567178,478
3456,3520322124,3520115090,1672577895,1672581339,3444
3771,3512383699,3501786419,1672690311,1672692364,2053
3766,3755222916,3932478321,1672661193,1672663119,1926
3668,3224330592,3469254160,1672603538,1672604457,919
3675,3394401087,3835985172,1672668347,1672669248,901
3775,3683113954,3885155975,1672625356,1672626102,746
3608,3399472693,3668533536,1672694857,1672697510,2653
3907,3760263530,3428027649,1672594256,1672596540,2284
3775,3755532873,3520657891,1672590394,1672592201,1807
3873,3440137407,3755230952,1672676625,1672677611,986
3881,3516444201,3500777439,1672664856,1672665007,151
3847,3200308999,3334974375,1672559881,1672562023,2142
3660,3609659642,3296462324,1672666158,1672666365,207
3487,3711006062,3516741440,1672620243,1672623346,3103
3615,3533423872,3974674109,1672553413,1672555068,1655
3598,3271752081,3683113954,1672632880,1672634638,1758
3695,3533079336,3803517637,1672567507,1672567825,318
3495,3899326793,3780712350,1672531689,1672534377,2688
3646,3510554314,3414049538,1672541194,1672544437,3243
3660,3772236797,3703798634,1672584805,1672586716,1911
3507,3520115090,3533004959,1672560421,1672561361,940
3867,3300979975,3516703758,1672560285,1672562489,2204
3748,3897435944,3839245934,1672565308,1672565435,127
3634,3319167958,3369708250,1672537891,1672538315,424
3502,3715974659,3760721303,1672623560,1672627074,3514
3874,3935913584,3519028898,1672674656,1672675233,577
3739,3403370192,3975717896,1672535368,1672538590,3222
3907,3333403880,3836241528,1672592024,1672595525,3501
3571,3829822608,3703348097,1672572532,1672575341,2809
3652,3410538749,3410160376,1672682016,1672684844,2828
3656,3925979970,3736231757,1672624933,1672626467,1534
3795,3410160376,3661447322,1672546596,1672547126,530
3663,3668533536,3279475486,1672698493,1672699182,689
3473,3201629017,3201676087,1672590595,1672591457,862
3786,3511317276,3551389192,1672587767,1672588394,627
3424,3780834916,3241914067,1672646428,1672649854,3426
3533,3514818819,3398731252,1672550085,1672552051,1966
3844,3604589802,3311098437,1672691284,1672693803,2519
3600,3500672156,3517881647,1672628054,1672629851,1797
3446,3915162005,3737112297,1672598263,1672599792,1529
3682,3791613604,3457960571,1672632219,1672635152,2933
3878,3505283390,3304971369,1672563803,1672565860,2057
3782,3518565331,3283492940,1672600114,1672602390,2276
3898,3513345163,3500857494,1672548272,1672549247,975
3470,3311420950,3736231757,1672543545,1672545428,1883
3425,3271454397,3618697021,1672645055,1672646401,1346
3712,3774733620,3520416075,1672573644,1672577016,3372
3755,3520764926,3774733620,1672703600,1672704044,444
3904,3733558985,3815250107,1672605794,1672606656,862
3599,3779738691,3778597171,1672580488,1672580890,402
3911,3517590837,3284947372,1672570205,1672572099,1894
3630,3469254160,3349739136,1672638205,1672639730,1525
3882,3770146716,3793969543,1672700555,1672701297,742
3583,3447514821,3777184389,1672667221,1672670381,3160
3850,3773027597,3713517039,1672641447,1672642971,1524
3678,3518653080,3859868849,1672575679,1672578045,2366
3910,3285204083,3618354185,1672684523,1672687272,2749
3631,3447672935,3710489491,1672597381,1672597460,79
3659,3783928182,3972083617,1672603602,1672604455,853
3702,3500777439,3231713082,1672541074,1672541981,907
3670,3777694660,3604589802,1672680855,1672683152,2297
3491,3236354255,3363162590,1672598213,1672599756,1543
3855,3783373154,3780115155,1672623573,1672627153,3580
3536,3760651515,3711637255,1672646001,1672648695,2694
3861,3660887799,3505663516,1672609592,1672611954,2362
3617,3270697740,3270697740,1672700304,1672702914,2610
3699,3792801638,3354144091,1672698002,1672700580,2578
3862,3701664364,3500302272,1672662631,1672665211,2580
3483,3904867554,3517590837,1672654841,1672657008,2167
3630,3834960360,3770676872,1672642402,1672644032,1630
3612,3711006062,3534543776,1672628314,1672631611,3297
3741,3824215187,3887243870,1672698149,1672700731,2582
3671,3463849738,3347446226,1672675648,1672676749,1101
3832,3519282716,3792274796,1672557734,1672558388,654
3441,3756127300,3497095254,1672675847,1672677999,2152
3693,3833217041,3818575661,1672614347,1672617123,2776
3528,3792745809,3201629017,1672674542,1672677578,3036
3475,3518194482,3897134762,1672549012,1672551118,2106
3755,3855583256,3638660068,1672594335,1672597051,2716
3811,3470454332,3815392801,1672672501,1672673847,1346
3447,3773121782,3515402792,1672676066,1672676645,579
3829,3779425804,3892304880,1672657803,1672660537,2734
3822,3780115155,3497095254,1672534064,1672536802,2738
3665,3239617320,3500613493,1672688238,1672689016,778
3707,3779938251,3516741440,1672577017,1672579296,2279
3804,3756474459,3271454397,1672608753,1672612022,3269
3491,3533649454,3710854064,1672550506,1672551837,1331
3799,3396726504,3895285664,1672553271,1672555176,1905
3582,3610358027,3819767045,1672627951,1672629592,1641
3837,3774641380,3294747828,1672587577,1672590031,2454
3716,3300229945,3514308235,1672542931,1672545025,2094
3555,3770704999,3760842815,1672624272,1672625185,913
3431,3334993594,3713829743,1672551130,1672553620,2490
3749,3411688875,3793883863,1672690912,1672691259,347
3898,3343132529,3480726047,1672645940,1672646806,866
3900,3436257398,3778640261,1672540199,1672543293,3094
3519,3455018347,3273981374,1672630880,1672633582,2702
3860,3608855425,3779532653,1672576524,1672576621,97
3687,3755848152,3501121099,1672694363,1672694932,569
3581,3688220326,3337362061,1672696054,1672698064,2010
3579,3520560590,3515439826,1672668898,1672671225,2327
3894,3885121158,3974674109,1672551555,1672554734,3179
3836,3512800570,3513081354,1672544019,1672544284,265
3627,3902760230,3510837901,1672678390,1672681452,3062
3865,3514334067,3512499658,1672676943,1672677560,617
3795,3701247948,3472312341,1672577861,1672578950,1089
3790,3925979970,3891672228,1672618173,1672620035,1862
3793,3316798920,3898314440,1672566635,1672567462,827
3909,3500109249,3714185969,1672572569,1672575109,2540
3775,3296462324,3360616538,1672696370,1672698636,2266
3722,3631090677,3554186380,1672588066,1672589661,1595
3441,3779425804,3208957949,1672621369,1672622847,1478
3877,3774876004,3236499444,1672543643,1672544823,1180
3903,3661583097,3774718695,1672698181,1672700999,2818
3814,3770236215,3274906650,1672596057,1672596601,544
3441,3779854934,3633735593,1672536972,1672538834,1862
3855,3777624586,3780209375,1672668936,1672672383,3447
3531,3357689359,3835985172,1672683994,1672685116,1122
3711,3294703680,3905196766,1672696682,1672698606,1924
3813,3505888598,3772391882,1672674991,1672677963,2972
3884,3463849738,3500442734,1672621492,1672622121,629
3596,3510642075,3374183227,1672603985,1672604797,812
3874,3630353876,3384583385,1672701233,1672703600,2367
3429,3398731252,3517991730,1672606961,1672608634,1673
3520,3713941638,3891672228,1672677863,1672679729,1866
3609,3520991398,3240994288,1672625948,1672628385,2437
3722,3500915908,3230135532,1672668269,1672671081,2812
3626,3615939504,3902760230,1672626696,1672628914,2218
3600,3421877923,3779786641,1672701494,1672703442,1948
3568,3501786419,3299443125,1672557163,1672557945,782
3671,3637313265,3424445495,1672544938,1672546070,1132
3552,3300511067,3635169815,1672668984,1672672541,3557
3744,3299125059,3889780657,1672662860,1672663776,916
3452,3500072204,3480991549,1672547001,1672549609,2608
3524,3511843593,3631090677,1672618572,1672621386,2814
3857,3392836218,3296462324,1672668770,1672670128,1358
3792,3711637255,3638660068,1672609230,1672611112,1882
3617,3289817992,3773009828,1672539864,1672540143,279
3814,3516298579,3661903000,1672536123,1672537274,1151
3702,3713561276,3760040019,1672569634,1672571398,1764
3863,3490029863,3713941638,1672611043,1672611738,695
3793,3737147209,3230135532,1672613914,1672617489,3575
3522,3387594369,3501525100,1672614107,1672616819,2712
3676,3780680950,3730071479,1672672657,1672674631,1974
3603,3289817992,3512502036,1672640653,1672641794,1141
3897,3501786419,3757863420,1672533540,1672535366,1826
3799,3384583385,3241914067,1672646298,1672649360,3062
3624,3519651506,3906536154,1672638524,1672641087,2563
3680,3384583385,3500525825,1672693837,1672694588,751
3505,3534179433,3930242012,1672679276,1672680973,1697
3821,3505923418,3209526819,1672537661,1672540706,3045
3841,3300818269,3668533536,1672687961,1672690923,2962
3435,3363162590,3305722859,1672657508,1672660531,3023
3724,3755532873,3760842815,1672656928,1672659864,2936
3900,3778667336,3792546035,1672535632,1672538394,2762
3806,3299125059,3756704774,1672634135,1672636107,1972
3531,3226024417,3792389522,1672623215,1672625424,2209
3869,3604867757,3770704999,1672569271,1672572225,2954
3792,3889780657,3517687662,1672533753,1672535346,1593
3634,3661447322,3272096759,1672555646,1672558972,3326
3733,3511601997,3518561777,1672546182,1672549752,3570
3624,3713768950,3289114629,1672594470,1672595452,982
3467,3392943173,3934064792,1672609631,1672612531,2900
3710,3778040015,3935913584,1672628702,1672629669,967
3528,3515559913,3480991549,1672645644,1672647891,2247
3468,3760364383,3755737419,1672693089,1672695502,2413
3462,3500672156,3779301501,1672656548,1672657440,892
3601,3713163045,3793868716,1672562754,1672566178,3424
3755,3424445495,3682133690,1672539493,1672542797,3304
3455,3819767045,3511732493,1672623756,1672625853,2097
3693,3337362061,3515890966,1672599103,1672600284,1181
3718,3402385957,3220031931,1672567192,1672568059,867
3688,3280268483,3518194482,1672650610,1672652775,2165
3784,3209526819,3777624586,1672607085,1672610129,3044
3505,3500737582,3497671225,1672543632,1672546405,2773
3527,3245232284,3383138270,1672653774,1672654745,971
3435,3505481368,3688490530,1672696186,1672697925,1739
3532,3923420131,3533274994,1672664873,1672665957,1084
3658,3757323954,3514818819,1672641335,1672643240,1905
3826,3368283077,3515466096,1672668993,1672671078,2085
3662,3680810086,3608855425,1672569233,1672570908,1675
3908,3236458894,3417191856,1672696148,1672699470,3322
3765,3776831527,3755344363,1672579321,1672581382,2061
3538,3774790271,3776117322,1672641359,1672642790,1431
3494,3701247948,3512282789,1672651314,1672654643,3329
3438,3972192593,3714233826,1672673432,1672676565,3133
3907,3664943873,3437286517,1672571819,1672573170,1351
3740,3300979975,3792014516,1672662741,1672664223,1482
3885,3756704774,3885121158,1672589485,1672591478,1993
3607,3732584121,3737112297,1672658263,1672660414,2151
3854,3757332128,3516513251,1672584346,1672585910,1564
3696,3514246749,3409114719,1672672248,1672675568,3320
3914,3773121782,3760651515,1672659846,1672660639,793
3543,3300979975,3757863420,1672674024,1672676214,2190
3495,3370227921,3519028898,1672653235,1672653575,340
3883,3394401087,3925979970,1672672252,1672672422,170
3719,3415833929,3533294425,1672607584,1672608748,1164
3726,3711218296,3505995057,1672572758,1672574170,1412
3544,3516741440,3756746867,1672582673,1672582974,301
3686,3236354255,3374183227,1672615025,1672617758,2733
3570,3334974375,3772391882,1672538594,1672541172,2578
3504,3792442597,3713911104,1672546483,1672548458,1975
3906,3350095157,3514741348,1672574374,1672574459,85
3507,3279242917,3714678331,1672651190,1672651755,565
3482,3330340793,3668414677,1672610122,1672610921,799
3469,3514956366,3885537225,1672608357,1672611094,2737
3503,3688220326,3923420131,1672567434,1672569284,1850
3824,3817428320,3897435944,1672604447,1672604957,510
3639,3500302272,3792745809,1672670659,1672673662,3003
3732,3505402439,3739895284,1672589400,1672591478,2078
3887,3514818819,3756385685,1672672369,1672672519,150
3626,3462636434,3205923620,1672534152,1672537240,3088
3918,3200543880,3311049964,1672659185,1672660713,1528
3799,3428027649,3518561777,1672542394,1672545753,3359
3472,3500208903,3510187271,1672602888,1672603256,368
3452,3512499658,3360813161,1672577078,1672578684,1606
3752,3310039260,3631479562,1672655702,1672658247,2545
3519,3626499450,3772391882,1672635880,1672638954,3074
3811,3713561276,3831586487,1672696610,1672700048,3438
3540,3280054198,3272030610,1672577674,1672579883,2209
3742,3510767239,3370068529,1672692484,1672692838,354
3692,3755992176,3887243870,1672662020,1672664995,2975
3760,3276003502,3551376095,1672533915,1672535988,2073
3519,3300511067,3306175858,1672667980,1672669690,1710
3666,3500341755,3401793306,1672613870,1672617409,3539
3441,3511005395,3248058676,1672569835,1672570299,464
3765,3220031931,3791441520,1672678841,1672680835,1994
3496,3899326793,3273981374,1672641556,1672644014,2458
3444,3410600350,3337322736,1672532046,1672535565,3519
3599,3770438122,3604589802,1672604353,1672606399,2046
3887,3520181148,3680810086,1672700086,1672702837,2751
3544,3755230952,3557046880,1672664312,1672666730,2418
3718,3520991398,3472312341,1672697964,1672700489,2525
3437,3756746867,3516489668,1672668691,1672670185,1494
3460,3399518841,3711637255,1672567405,1672568708,1303
3453,3689114185,3467988782,1672599301,1672600808,1507
3671,3401496246,3449639012,1672623300,1672623710,410
3912,3412968120,3239617320,1672633011,1672633468,457
3461,3779438325,3446533960,1672594581,1672595967,1386
3909,3551399764,3319167958,1672665974,1672669160,3186
3581,3773332082,3500072204,1672573516,1672576506,2990
3581,3510499038,3792538417,1672635371,1672638007,2636
3591,3226024417,3618697021,1672547206,1672548782,1576
3469,3891672228,3510641433,1672696419,1672699732,3313
3836,3933894942,3404025196,1672577622,1672577840,218
3736,3283492940,3225029895,1672537248,1672538051,803
3871,3224968597,3497095254,1672675179,1672675899,720
3462,3231494505,3715707380,1672663394,1672664156,762
3770,3500613493,3900276517,1672636685,1672638249,1564
3860,3731646673,3534357694,1672577069,1672580418,3349
3608,3772236797,3757903168,1672652990,1672653902,912
3603,3306175858,3710854064,1672700488,1672700982,494
3605,3299781901,3755233658,1672659558,1672660035,477
3557,3520578796,3686227677,1672576978,1672579348,2370
3477,3926643445,3793868716,1672536000,1672539591,3591
3655,3500109249,3362641275,1672555871,1672558200,2329
3540,3619922891,3934064792,1672614479,1672617863,3384
3880,3509756823,3510818674,1672549685,1672551727,2042
3587,3977148669,3770676872,1672694664,1672697756,3092
3829,3554186380,3739895284,1672685366,1672688836,3470
3693,3296462324,3380130228,1672646766,1672649603,2837
3512,3226024417,3276269264,1672604885,1672607696,2811
3553,3715854030,3774243020,1672601738,1672603197,1459
3711,3410160376,3618489670,1672644277,1672647275,2998
3491,3933894942,3829864515,1672666093,1672667765,1672
3571,3443357683,3336339664,1672540431,1672544019,3588
3786,3224330592,3831586487,1672625032,1672627972,2940
3608,3512295534,3711077927,1672699644,1672702141,2497
3571,3220031931,3493017654,1672567647,1672568959,1312
3752,3979784676,3515525630,1672622561,1672624036,1475
3583,3440107959,3756625818,1672532618,1672535981,3363
3598,3778640261,3902861231,1672666537,1672666703,166
3848,3271752081,3770520359,1672544333,1672546102,1769
3877,3480991549,3932478321,1672631833,1672634250,2417
3654,3904867554,3661447322,1672671481,1672674818,3337
3548,3224811762,3835422146,1672664331,1672666941,2610
3702,3713768950,3201800997,1672669596,1672672036,2440
3841,3279242917,3338390596,1672648804,1672652085,3281
3430,3472068734,3510837901,1672581115,1672582276,1161
3871,3904867554,3897134762,1672679119,1672680325,1206
3763,3500604680,3421877923,1672673944,1672674636,692
3898,3733558985,3229822507,1672693907,1672697284,3377
3682,3921648519,3661583097,1672692460,1672695898,3438
3723,3609113156,3777240360,1672537954,1672541263,3309
3795,3755404116,3977352557,1672693138,1672695555,2417
3469,3398198430,3713829743,1672636495,1672638553,2058
3652,3334951866,3779786641,1672635298,1672636782,1484
3608,3615087943,3938389661,1672669306,1672671392,2086
3452,3225636215,3770704999,1672544191,1672545912,1721
3712,3774243020,3680810086,1672636455,1672638197,1742
3570,3304155815,3826238375,1672693568,1672696193,2625
3704,3905196766,3515401243,1672565731,1672568715,2984
3841,3812534508,3559458968,1672583916,1672585601,1685
3472,3445206685,3791613604,1672555350,1672558082,2732
3894,3520115090,3343816795,1672606946,1672609435,2489
3752,3517590837,3303410628,1672537607,1672538675,1068
3659,3517222913,3500703304,1672589478,1672590322,844
3874,3711812325,3206837348,1672574421,1672575843,1422
3736,3468041839,3777037426,1672693218,1672694294,1076
3469,3755222916,3357289672,1672670955,1672672667,1712
3733,3760924079,3389634034,1672567677,1672568329,652
3587,3500703304,3239617320,1672679497,1672679933,436
3816,3360616538,3512499658,1672585715,1672585956,241
3920,3773902805,3376467719,1672659302,1672662888,3586
3828,3501384020,3639050419,1672691105,1672693479,2374
3685,3777779869,3780769110,1672608145,1672609445,1300
3818,3490214516,3710048469,1672609808,1672611836,2028
3629,3732584121,3519416013,1672588065,1672589136,1071
3767,3778640261,3279473441,1672611622,1672614191,2569
3567,3608922867,3300229945,1672560268,1672562698,2430
3921,3360069849,3780680950,1672574700,1672574808,108
3443,3500208903,3224811762,1672540524,1672541219,695
3693,3288224595,3491469603,1672558775,1672560543,1768
3669,3902760230,3515890966,1672658628,1672662143,3515
3753,3519416013,3424660806,1672542072,1672545217,3145
3463,3772078494,3300818269,1672613960,1672615206,1246
3830,3225631197,3715707380,1672542416,1672543236,820
3757,3499217428,3513081354,1672539276,1672541901,2625
3511,3792442597,3716110860,1672627432,1672628329,897
3569,3505228454,3534764451,1672699077,1672699502,425
3632,3780322355,3600876425,1672534817,1672537217,2400
3456,3462636434,3815250107,1672555207,1672557599,2392
3887,3367971170,3285204083,1672596904,1672597963,1059
3768,3737147209,3517687662,1672630089,1672632807,2718
3534,3402697190,3779613523,1672561826,1672563913,2087
3850,3734915241,3807212280,1672671546,1672673401,1855
3853,3271752081,3201800997,1672687846,1672688123,277
3920,3732131656,3512800570,1672558820,1672561003,2183
3536,3815250107,3500208903,1672575769,1672577711,1942
3593,3703139663,3701823816,1672680616,1672684035,3419
3700,3412006598,3505807416,1672655143,1672656665,1522
3521,3515401243,3500857494,1672559974,1672561500,1526
3668,3490029863,3519446663,1672563986,1672565423,1437
3867,3618489670,3500442734,1672619569,1672619807,238
3841,3716272919,3462273042,1672546443,1672549219,2776
3553,3779465522,3714666884,1672688326,1672689781,1455
3448,3928719932,3514275974,1672635416,1672637262,1846
3484,3224968597,3514741348,1672673317,1672673378,61
3706,3396726504,3664943873,1672651567,1672653462,1895
3599,3412968120,3457960571,1672635224,1672636630,1406
3509,3224968597,3971806004,1672604552,1672608013,3461
3796,3334647380,3733558985,1672595393,1672597349,1956
3448,3516444201,3387594369,1672577621,1672580272,2651
3564,3701823816,3461119815,1672558276,1672560612,2336
3466,3505111292,3791753345,1672666021,1672667169,1148
3865,3934064792,3714233826,1672616086,1672618335,2249
3807,3778134418,3279242917,1672616038,1672616263,225
3661,3792072681,3500841914,1672590540,1672593617,3077
3920,3451326054,3618697021,1672678949,1672681381,2432
3522,3500915908,3240994288,1672611064,1672613051,1987
3680,3452016771,3305336154,1672535846,1672537418,1572
3585,3791753345,3534175249,1672639445,1672641966,2521
3464,3897376951,3395201292,1672681272,1672681394,122
3773,3780338697,3480100311,1672552546,1672553559,1013
3512,3774290799,3514246749,1672699792,1672701313,1521
3846,3756746867,3396980894,1672574347,1672575859,1512
3639,3779738691,3360616538,1672614445,1672615812,1367
3548,3399472693,3933894942,1672684477,1672686375,1898
3610,3299781901,3394297564,1672688361,1672690463,2102
3513,3437286517,3713517039,1672645742,1672647410,1668
3815,3776117322,3711077927,1672531970,1672532232,262
3603,3411515369,3773033649,1672567572,1672569216,1644
3532,3206837348,3716679950,1672564833,1672565065,232
3776,3757193551,3279473441,1672587556,1672590627,3071
3526,3357689359,3637313265,1672641381,1672642032,651
3823,3372223551,3897376951,1672672659,1672673234,575
3878,3276217799,3436257398,1672617356,1672619951,2595
3727,3520991398,3621790707,1672550291,1672552578,2287
3811,3639050419,3270697740,1672569868,1672570181,313
3637,3514512367,3511732493,1672592267,1672593754,1487
3597,3367111751,3481640525,1672692111,1672692535,424
3609,3930242012,3925979970,1672659867,1672660688,821
3805,3889780657,3760645796,1672542341,1672545678,3337
3630,3209526819,3774907131,1672561796,1672563191,1395
3552,3552824113,3614740489,1672546219,1672547459,1240
3581,3773735484,3713768950,1672654673,1672655748,1075
3882,3333403880,3417679834,1672655120,1672658614,3494
3828,3757318448,3624297844,1672637026,1672637549,523
3747,3701882224,3513295938,1672662631,1672666190,3559
3631,3493017654,3480726047,1672539232,1672540596,1364
3801,3349856820,3512946768,1672569446,1672570779,1333
3524,3777091903,3713589994,1672572791,1672575116,2325
3845,3736231757,3783373154,1672684074,1672686666,2592
3855,3618697021,3801645328,1672656737,1672657125,388
3720,3390660440,3363162590,1672582792,1672583552,760
3847,3608922867,3505178849,1672609510,1672612587,3077
3479,3904569677,3760651515,1672605181,1672608231,3050
3626,3512383699,3519416013,1672588412,1672591449,3037
3853,3772236797,3800257590,1672669154,1672669532,378
3741,3271454397,3800257590,1672559018,1672561099,2081
3742,3517172354,3201629017,1672625622,1672626857,1235
3445,3739911441,3714067076,1672533730,1672537052,3322
3689,3825881598,3364726656,1672642940,1672643942,1002
3833,3685816610,3777189898,1672649056,1672649965,909
3849,3457960571,3792949946,1672573466,1672573585,119
3676,3511288998,3487875183,1672606392,1672609455,3063
3637,3733363628,3732584121,1672590531,1672592666,2135
3761,3488686442,3370068529,1672615865,1672618274,2409
3766,3783801141,3414940786,1672643948,1672645033,1085
3784,3510767239,3630353876,1672572198,1672575222,3024
3622,3511883730,3411688875,1672546824,1672546978,154
3708,3638204468,3757630221,1672541601,1672542248,647
3656,3909094917,3511601997,1672630441,1672633548,3107
3495,3334974375,3455018347,1672688339,1672688702,363
3701,3300229945,3916490839,1672649044,1672651116,2072
3492,3609113156,3897435944,1672688143,1672688212,69
3510,3350095157,3714233826,1672534703,1672536231,1528
3672,3279475486,3774790271,1672683511,1672684016,505
3541,3517600136,3463740710,1672614146,1672614759,613
3699,3485540729,3701424609,1672651400,1672654122,2722
3496,3534126409,3801645328,1672552108,1672552982,874
3717,3774907131,3783615982,1672605404,1672606064,660
3803,3520115090,3497671225,1672687403,1672690177,2774
3478,3668747074,3519028898,1672587706,1672589134,1428
3644,3780571086,3792538417,1672587154,1672589714,2560
3502,3467779445,3772765746,1672648125,1672649391,1266
3899,3780472203,3311498666,1672572626,1672576158,3532
3804,3836241528,3777147510,1672614629,1672614974,345
3785,3367111751,3604867757,1672622789,1672625978,3189
3571,3557046880,3505481368,1672692451,1672692856,405
3624,3885121158,3776117322,1672612760,1672615677,2917
3440,3452016771,3716272919,1672668379,1672671895,3516
3461,3402697190,3757193307,1672662920,1672665975,3055
3507,3385323994,3384068080,1672591220,1672592650,1430
3861,3364378127,3792274796,1672620842,1672622337,1495
3570,3755230952,3661903000,1672577863,1672579738,1875
3448,3755222916,3514334067,1672535838,1672536940,1102
3864,3770438122,3668414677,1672551013,1672552264,1251
3641,3518229776,3885537225,1672538698,1672539219,521
3640,3779465522,3505481368,1672541582,1672543038,1456
3684,3902760230,3970603231,1672671004,1672671223,219
3675,3337362061,3713561276,1672673579,1672674965,1386
3657,3756385685,3512502036,1672531899,1672534018,2119
3547,3273981374,3209481722,1672612800,1672615867,3067
3730,3236499444,3272716462,1672672949,1672674589,1640
3867,3270056120,3834963772,1672571450,1672573682,2232
3485,3511317276,3923420131,1672611326,1672613368,2042
3526,3394401087,3510499038,1672583574,1672585272,1698
3589,3510798825,3779892400,1672543828,1672547421,3593
3755,3360616538,3734451191,1672573836,1672576633,2797
3752,3304155815,3534126409,1672542692,1672546288,3596
3761,3774641380,3396726504,1672549316,1672551298,1982
3647,3736705719,3780322355,1672670860,1672672551,1691
3741,3520560590,3779854934,1672655337,1672658857,3520
3510,3520639768,3513345163,1672627741,1672630170,2429
3736,3713829743,3780472203,1672551651,1672552857,1206
3756,3714067076,3500525825,1672547385,1672547449,64
3894,3714185969,3773913680,1672624229,1672625984,1755
3692,3711637255,3779639983,1672586976,1672588841,1865
3461,3622357348,3375449013,1672549658,1672549927,269
3872,3285204083,3760364383,1672648371,1672649043,672
3525,3770520359,3609113156,1672679757,1672682404,2647
3589,3517172354,3711919537,1672562363,1672565888,3525
3807,3399472693,3334993594,1672642988,1672643970,982
3900,3238288884,3772391882,1672562693,1672565288,2595
3898,3970198861,3501457103,1672591718,1672593090,1372
3646,3739911441,3772236797,1672581153,1672582393,1240
3562,3232208416,3429943738,1672586948,1672589317,2369
3503,3609933747,3245232284,1672676575,1672678154,1579
3875,3898314440,3739895284,1672635587,1672635907,320
3831,3289817992,3621461051,1672545264,1672546238,974
3431,3515439826,3686523546,1672569213,1672570572,1359
3704,3774733620,3776518452,1672647350,1672650506,3156
3872,3715400486,3970627281,1672581162,1672583731,2569
3792,3774718695,3514324011,1672681181,1672681752,571
3787,3299443125,3755158925,1672630200,1672630590,390
3883,3793868716,3511150845,1672699403,1672702516,3113
3637,3533228966,3792546035,1672666701,1672669793,3092
3797,3347446226,3512722110,1672546184,1672547375,1191
3677,3926643445,3505198734,1672549841,1672553261,3420
3848,3315279093,3852533643,1672585289,1672585917,628
3443,3855583256,3283492940,1672558635,1672558737,102
3675,3390660440,3520873221,1672542549,1672542896,347
3822,3505111292,3519909393,1672596717,1672598088,1371
3467,3779854934,3773033649,1672703798,1672703865,67
3693,3534126409,3414049538,1672600841,1672603022,2181
3835,3815392801,3402385957,1672662199,1672664939,2740
3557,3334951866,3818575661,1672693947,1672697416,3469
3520,3757332128,3500915908,1672640605,1672641730,1125
3605,3774718695,3783771827,1672679298,1672682635,3337
3785,3970603231,3778134418,1672565356,1672565696,340
3727,3852533643,3783163143,1672646600,1672648346,1746
3795,3777779869,3779786641,1672631682,1672632383,701
3620,3783550022,3622357348,1672589150,1672590856,1706
3854,3773121782,3513018485,1672563135,1672566429,3294
3778,3516444201,3630353876,1672667944,1672668054,110
3470,3309314379,3497671225,1672549192,1672552701,3509
3887,3399518841,3931627862,1672670405,1672670596,191
3442,3817813340,3792949946,1672615966,1672619050,3084
3851,3451726367,3757332128,1672557358,1672559728,2370
3798,3793743698,3533228966,1672604504,1672607393,2889
3748,3436257398,3515890966,1672687551,1672690009,2458
3707,3808136029,3701005527,1672538662,1672542166,3504
3578,3715619259,3774876004,1672702350,1672705537,3187
3914,3509483172,3757075324,1672665749,1672667646,1897
3510,3554186380,3618354185,1672646551,1672646620,69
3778,3481640525,3714233826,1672575812,1672579195,3383
3770,3519077659,3515466096,1672636387,1672638796,2409
3672,3241790910,3462636434,1672594163,1672596955,2792
3877,3512800570,3880926355,1672621968,1672622710,742
3631,3513345163,3514285803,1672619941,1672620549,608
3895,3311498666,3289817992,1672665967,1672668180,2213
3467,3928719932,3272030610,1672694543,1672697330,2787
3738,3500827202,3227799827,1672676716,1672676873,157
3488,3512958459,3274906650,1672661543,1672662981,1438
3719,3472068734,3400069268,1672535741,1672536883,1142
3602,3711853996,3201629017,1672583635,1672586513,2878
3812,3226511603,3755158925,1672591013,1672594097,3084
3635,3689114185,3701424609,1672629890,1672632977,3087
3828,3459681410,3516321888,1672562418,1672564986,2568
3491,3505179890,3513345163,1672574210,1672576678,2468
3676,3792801638,3780209375,1672556655,1672559190,2535
3578,3613416045,3336627643,1672532556,1672535728,3172
3629,3516513251,3305336154,1672563484,1672565996,2512
3535,3509366311,3897134762,1672552897,1672553195,298
3513,3757318448,3897456874,1672657850,1672659673,1823
3859,3410600350,3938503547,1672633105,1672635031,1926
3501,3280054198,3337362061,1672665007,1672667535,2528
3730,3689114185,3774155692,1672658480,1672661512,3032
3694,3906536154,3279242917,1672543717,1672544255,538
3769,3713768950,3500709774,1672606696,1672607770,1074
3741,3559731671,3236354255,1672699857,1672700972,1115
3809,3220031931,3305336154,1672671904,1672674703,2799
3792,3445206685,3520115090,1672639841,1672641930,2089
3618,3513065217,3803517637,1672646821,1672650162,3341
3706,3500208903,3755915206,1672673556,1672675676,2120
3595,3421385957,3971806004,1672660562,1672662762,2200
3446,3685816610,3367971170,1672536849,1672539468,2619
3560,3500915665,3885157459,1672642915,1672646340,3425
3504,3710008361,3392943173,1672680819,1672683347,2528
3712,3509756823,3513296868,1672688527,1672690354,1827
3676,3604867757,3829864515,1672702013,1672703444,1431
3700,3511150845,3305336154,1672696153,1672699461,3308
3903,3780571086,3276217799,1672531431,1672533613,2182
3644,3533929349,3632814465,1672662203,1672662628,425
3693,3357289672,3554825448,1672582010,1672582982,972
3463,3505521218,3500709774,1672603104,1672604880,1776
3768,3225631197,3554825448,1672649739,1672651344,1605
3461,3887243870,3817813340,1672680005,1672682060,2055
3725,3384068080,3760645796,1672604836,1672605974,1138
3799,3715545685,3757193307,1672630795,1672633820,3025
3678,3780115155,3375449013,1672695829,1672699155,3326
3896,3510767239,3793315718,1672666136,1672668422,2286
3731,3515402792,3739154408,1672646686,1672649063,2377
3827,3488763230,3735374579,1672690128,1672692257,2129
3912,3505481368,3202141727,1672671559,1672674451,2892
3571,3977148669,3772391882,1672618649,1672621201,2552
3700,3517881647,3755532873,1672641178,1672643645,2467
3696,3701424609,3510554314,1672680558,1672682690,2132
3654,3792546035,3823084403,1672588953,1672590819,1866
3578,3245232284,3735374579,1672543177,1672546258,3081
3689,3756127300,3511883730,1672617665,1672618228,563
3439,3770624662,3276003502,1672555588,1672557454,1866
3445,3624297844,3376467719,1672561618,1672561730,112
3698,3517462308,3772078494,1672644712,1672646431,1719
3573,3779613523,3904867554,1672691518,1672694371,2853
3680,3500915908,3793407963,1672607146,1672608442,1296
3438,3885121158,3512379024,1672668688,1672670500,1812
3489,3713517039,3714827719,1672550427,1672553425,2998
3510,3229974066,3610870949,1672675994,1672676870,876
3539,3773009828,3448633776,1672689553,1672689844,291
3492,3791613604,3380767040,1672612502,1672614127,1625
3848,3831586487,3665998641,1672552136,1672553137,1001
3922,3734451191,3435167810,1672585282,1672587916,2634
3819,3834963772,3533079336,1672568858,1672571046,2188
3584,3519416013,3710735406,1672687934,1672688885,951
3432,3360616538,3209526819,1672645056,1672645256,200
3521,3756385685,3510187271,1672576357,1672578832,2475
3858,3505481368,3311420950,1672607449,1672608173,724
3843,3354144091,3519087371,1672624937,1672627083,2146
3901,3760263530,3791613604,1672606220,1672609639,3419
3649,3703383853,3613899351,1672670763,1672671595,832
3593,3792745809,3475349791,1672630012,1672632937,2925
3502,3905899155,3505198734,1672683052,1672686349,3297
3883,3516321888,3416987084,1672579918,1672580155,237
3710,3447672935,3514324011,1672692303,1672693200,897
3534,3534175249,3375449013,1672583734,1672585030,1296
3592,3710562338,3488763230,1672613751,1672617041,3290
3878,3714666884,3244004456,1672585738,1672588174,2436
3883,3777189898,3927599181,1672631051,1672634282,3231
3648,3970558632,3500857494,1672671386,1672673606,2220
3797,3756385685,3776117322,1672562511,1672564040,1529
3462,3791246640,3755573472,1672623370,1672623474,104
3913,3904569677,3739154408,1672632013,1672635042,3029
3473,3349739136,3272030610,1672691045,1672691180,135
3481,3711006062,3636329663,1672564304,1672564628,324
3793,3710048469,3480100311,1672693153,1672694982,1829
3570,3773913680,3793740407,1672666541,1672668671,2130
3616,3511883730,3774790271,1672563440,1672566129,2689
3654,3510642075,3927403123,1672671598,1672674597,2999
3596,3859868849,3431460073,1672616986,1672618832,1846
3774,3778040015,3451326054,1672671397,1672672613,1216
3806,3226178937,3208452238,1672599817,1672602731,2914
3604,3380767040,3435116799,1672684781,1672687391,2610
3661,3403370192,3470454332,1672601459,1672602198,739
3631,3305336154,3777184389,1672552955,1672553422,467
3839,3686227677,3734118023,1672609981,1672612497,2516
3645,3510767239,3770624662,1672678804,1672680751,1947
3457,3824641227,3509764635,1672573134,1672575759,2625
3894,3739911441,3715400486,1672567010,1672567753,743
3906,3760362417,3512946768,1672703758,1672707264,3506
3574,3618697021,3559458968,1672541756,1672541834,78
3817,3519028898,3505995057,1672570561,1672570964,403
3616,3912891315,3773902805,1672635957,1672638242,2285
3664,3517590837,3330340793,1672547600,1672551000,3400
3805,3491684096,3515439826,1672640569,1672641158,589
3844,3500347447,3664943873,1672553075,1672553193,118
3876,3520578796,3238288884,1672568807,1672569554,747
3861,3380130228,3713300120,1672673050,1672676311,3261
3622,3711734586,3783373154,1672554233,1672556238,2005
3642,3619922891,3436025562,1672581438,1672582509,1071
3771,3808136029,3520181148,1672659123,1672659594,471
3643,3463740710,3774733620,1672561584,1672562835,1251
3454,3364726656,3208957949,1672599526,1672601021,1495
3857,3711097754,3801645328,1672687926,1672690229,2303
3777,3776518452,3519087371,1672569275,1672572040,2765
3437,3793781065,3774718695,1672542280,1672543322,1042
3826,3701005527,3783433404,1672604357,1672607721,3364
3577,3711853996,3376467719,1672591549,1672594895,3346
3663,3622665543,3714827719,1672668735,1672671654,2919
3604,3713163045,3710048469,1672591027,1672591474,447
3455,3713561276,3920625129,1672546331,1672548950,2619
3897,3513360004,3512295534,1672576625,1672577297,672
3838,3928511283,3534764451,1672678959,1672682549,3590
3583,3833217041,3793175445,1672570077,1672573673,3596
3534,3755344363,3792505974,1672587014,1672589321,2307
3809,3715854030,3793781065,1672634726,1672636712,1986
3713,3514285803,3414049538,1672671587,1672674816,3229
3713,3451691949,3272030610,1672647920,1672648604,684
3532,3362641275,3399518841,1672535431,1672535578,147
3475,3623266256,3780872464,1672657814,1672658168,354
3579,3402385957,3209526819,1672599978,1672602557,2579
3700,3514308235,3236354255,1672571289,1672574056,2767
3460,3417679834,3701823816,1672681932,1672682309,377
3821,3271454397,3283492940,1672616324,1672618034,1710
3517,3716272919,3773033649,1672610070,1672613639,3569
3735,3756474459,3511732493,1672570694,1672571705,1011
3540,3271454397,3793583656,1672574347,1672575802,1455
3466,3357864626,3505154885,1672590175,1672591428,1253
3426,3451726367,3835985172,1672589509,1672590125,616
3637,3776988674,3517687662,1672629908,1672630388,480
3445,3468041839,3514246749,1672542642,1672545366,2724
3446,3859868849,3755992176,1672568620,1672569986,1366
3536,3480991549,3757294769,1672700226,1672702705,2479
3767,3716679950,3299443125,1672542569,1672545019,2450
3600,3514285803,3923420131,1672543350,1672544086,736
3830,3791246640,3701136026,1672601721,1672602088,367
3479,3387594369,3554944414,1672688762,1672691492,2730
3892,3714128600,3710008361,1672611150,1672611673,523
3717,3710496785,3304971369,1672641262,1672642225,963
3765,3533079336,3513081354,1672586703,1672587912,1209
3491,3713768950,3520764926,1672552693,1672552773,80
3767,3272096759,3755496114,1672531648,1672534165,2517
3437,3760694096,3431460073,1672599621,1672603160,3539
3874,3467779445,3791128487,1672680531,1672683592,3061
3604,3505154885,3459681410,1672635319,1672638682,3363
3477,3519282716,3491684096,1672626962,1672627075,113
3490,3519077659,3779892400,1672666258,1672668963,2705
3759,3500317969,3716628503,1672654122,1672657667,3545
3823,3510964997,3514308235,1672624895,1672628217,3322
3525,3971806004,3392520516,1672613499,1672615355,1856
3648,3904412440,3631090677,1672549995,1672553341,3346
3778,3386758279,3511601997,1672619002,1672620933,1931
3772,3300229945,3632814465,1672666369,1672668567,2198
3491,3533079336,3920625129,1672636160,1672637620,1460
3629,3773902805,3554944414,1672573372,1672573518,146
3774,3517590837,3667673649,1672663438,1672664233,795
3724,3232208416,3617392620,1672575196,1672576128,932
3571,3373089838,3792442597,1672621165,1672624572,3407
3825,3783919913,3760842815,1672630673,1672632876,2203
3705,3688490530,3661447322,1672628926,1672630368,1442
3907,3514419100,3885157459,1672597496,1672597963,467
3599,3615087943,3336339664,1672569263,1672570568,1305
3726,3783771827,3791106564,1672650959,1672652398,1439
3500,3777694660,3777814504,1672583455,1672584101,646
3825,3757903168,3505725706,1672703396,1672706634,3238
3599,3933894942,3710048469,1672665716,1672667232,1516
3777,3239617320,3760694096,1672559599,1672561959,2360
3721,3334647380,3463849738,1672550658,1672552923,2265
3493,3500613493,3779438325,1672539283,1672540135,852
3429,3625463628,3667673649,1672612397,1672615489,3092
3804,3368283077,3409114719,1672540244,1672540595,351
3903,3505179890,3274831810,1672639170,1672639280,110
3802,3783771827,3306175858,1672533076,1672536090,3014
3697,3512282789,3316798920,1672598771,1672599834,1063
3681,3930242012,3299443125,1672672333,1672674627,2294
3528,3533368789,3240394404,1672637759,1672639226,1467
3435,3773837847,3686227677,1672588729,1672588820,91
3593,3421385957,3357689359,1672628387,1672629477,1090
3767,3734451191,3334993594,1672574302,1672577806,3504
3816,3731646673,3276217799,1672538976,1672539701,725
3854,3979784676,3701373490,1672556243,1672558328,2085
3590,3367971170,3970909253,1672575581,1672575835,254
3582,3834631333,3441348818,1672619860,1672621733,1873
3439,3626499450,3512295534,1672628163,1672630409,2246
3795,3513853403,3457620713,1672651093,1672651198,105
3582,3338083680,3305722859,1672548655,1672548914,259
3748,3500442734,3793315718,1672680876,1672681483,607
3513,3760364383,3783615982,1672585883,1672587532,1649
3875,3618808151,3776518452,1672656088,1672659579,3491
3482,3625174002,3509764635,1672618539,1672619036,497
3895,3456430614,3512502036,1672643962,1672644668,706
3711,3350095157,3779425804,1672694985,1672698530,3545
3911,3613416045,3516321888,1672564343,1672566400,2057
3647,3480726047,3371455553,1672658638,1672660570,1932
3713,3701005527,3777091903,1672687517,1672690925,3408
3901,3505437712,3410160376,1672639669,1672642164,2495
3849,3710048469,3511732493,1672695395,1672697549,2154
3676,3617392620,3285204083,1672642712,1672644188,1476
3792,3519651506,3756385685,1672587882,1672591017,3135
3888,3402697190,3770438122,1672686518,1672687765,1247
3862,3770520359,3475349791,1672543768,1672547068,3300
3843,3713784974,3613581796,1672614051,1672614990,939
3680,3414940786,3780571086,1672627744,1672628749,1005
3826,3533188828,3887243870,1672595290,1672597075,1785
3445,3825881598,3755233658,1672631276,1672632937,1661
3847,3668533536,3231494505,1672683133,1672686513,3380
3692,3792072681,3517991730,1672623732,1672626187,2455
3642,3779656423,3791441520,1672656137,1672657153,1016
3650,3205985903,3793315718,1672666629,1672668595,1966
3569,3533228966,3713691388,1672596639,1672598389,1750
3635,3485540729,3885157459,1672615671,1672618240,2569
3450,3791106564,3514512367,1672610258,1672613665,3407
3784,3205923620,3793740407,1672657916,1672660869,2953
3458,3520764926,3777091903,1672547624,1672550860,3236
3746,3512379024,3716272919,1672582866,1672584612,1746
3737,3299443125,3516298579,1672596142,1672599399,3257
3715,3515525630,3231713082,1672548862,1672551841,2979
3570,3638660068,3778667336,1672673428,1672676100,2672
3453,3241914067,3229974066,1672673713,1672674682,969
3426,3715854030,3226511603,1672541122,1672544264,3142
3658,3514324011,3710008361,1672703030,1672706378,3348
3677,3441703884,3777779869,1672583933,1672585530,1597
3659,3776518452,3513545422,1672542058,1672543665,1607
3879,3373089838,3490214516,1672670572,1672671233,661
3429,3225636215,3370068529,1672686075,1672688704,2629
3907,3551399764,3773124276,1672664333,1672664621,288
3610,3510028805,3807212280,1672574918,1672577608,2690
3755,3518561777,3609659642,1672561358,1672561928,570
3835,3533294425,3380767040,1672621684,1672625196,3512
3747,3276348699,3932478321,1672563788,1672564060,272
3905,3770624662,3520115090,1672549468,1672552346,2878
3591,3739911441,3779532653,1672676407,1672678813,2406
3469,3755848152,3715127070,1672557206,1672559374,2168
3683,3714678331,3206837348,1672568489,1672570046,1557
3697,3517358573,3341893384,1672688675,1672689246,571
3910,3774290799,3283770991,1672640601,1672641107,506
3428,3780834916,3513065217,1672636575,1672637904,1329
3484,3505179890,3510187271,1672604958,1672606766,1808
3911,3608232640,3371455553,1672586750,1672588160,1410
3883,3518561777,3935913584,1672659959,1672661037,1078
3853,3533649454,3514703118,1672548516,1672551346,2830
3794,3341893384,3898314440,1672683242,1672685243,2001
3610,3898314440,3897435944,1672601915,1672605409,3494
3654,3500072204,3778597171,1672645429,1672646584,1155
3558,3533294425,3366423342,1672697631,1672698921,1290
3701,3231713082,3905899155,1672593406,1672596606,3200
3697,3461119815,3511024016,1672591737,1672594686,2949
3907,3770704999,3774155692,1672533359,1672536697,3338
3813,3357689359,3770624662,1672621262,1672624542,3280
3728,3780253901,3276003502,1672692061,1672692623,562
3847,3414049538,3534543776,1672573832,1672576686,2854
3455,3280054198,3515402792,1672577263,1672579274,2011
3873,3777485931,3310039260,1672702647,1672706092,3445
3869,3410600350,3227799827,1672625548,1672628113,2565
3907,3296462324,3613899351,1672636708,1672637030,322
3599,3513296868,3755496114,1672561700,1672562114,414
3850,3480726047,3793922324,1672692879,1672696367,3488
3735,3777240360,3906536154,1672637484,1672640287,2803
3692,3556969573,3661447322,1672566963,1672567849,886
3922,3756746867,3713768950,1672594363,1672595090,727
3810,3519909393,3779892400,1672654846,1672658130,3284
3441,3826238375,3760640999,1672541377,1672541705,328
3919,3711097754,3792949946,1672561756,1672563161,1405
3907,3819767045,3408430195,1672660373,1672662278,1905
3494,3779301501,3230868435,1672562010,1672564193,2183
3835,3440137407,3500709774,1672638402,1672638771,369
3788,3688796737,3770146716,1672550696,1672551251,555
3792,3461119815,3638204468,1672560310,1672563164,2854
3799,3779854934,3776988674,1672549128,1672551117,1989
3808,3776559988,3713589994,1672540855,1672541035,180
3607,3500072204,3622357348,1672629543,1672630764,1221
3856,3520639768,3701247948,1672619534,1672622012,2478
3605,3778926763,3514324011,1672677425,1672680200,2775
3622,3793315718,3274906650,1672670937,1672674057,3120
3871,3392520516,3289817992,1672587845,1672591065,3220
3825,3364378127,3792489602,1672663450,1672665686,2236
3647,3417679834,3310039260,1672615895,1672618483,2588
3469,3300818269,3274831810,1672550497,1672553540,3043
3699,3902861231,3200543880,1672691745,1672692419,674
3757,3505434346,3665998641,1672612638,1672612924,286
3459,3755233658,3897134762,1672681496,1672684753,3257
3909,3556969573,3627368399,1672657159,1672660044,2885
3586,3509366311,3600876425,1672671861,1672672108,247
3842,3368283077,3519282716,1672630244,1672630590,346
3703,3480991549,3449639012,1672697929,1672700938,3009
3623,3811040565,3791246640,1672703588,1672703915,327
3788,3394297564,3905196766,1672565977,1672567301,1324
3582,3205985903,3516903528,1672576918,1672580052,3134
3504,3783928182,3552824113,1672635364,1672638006,2642
3840,3792072681,3777091903,1672592742,1672593928,1186
3467,3488763230,3780338697,1672608931,1672610012,1081
3902,3814305099,3710735406,1672538748,1672540511,1763
3617,3236458894,3500613493,1672689751,1672692926,3175
3766,3713911104,3776988674,1672566539,1672566931,392
3433,3776988674,3510642075,1672625431,1672625844,413
3662,3511150845,3394297564,1672596793,1672599247,2454
3659,3513360004,3228888030,1672561687,1672563306,1619
3757,3429943738,3520322124,1672574510,1672576870,2360
3686,3617392620,3779938251,1672642777,1672644180,1403
3898,3778134418,3534179433,1672556197,1672557589,1392
3854,3680810086,3415833929,1672664780,1672667497,2717
3835,3500072204,3450286949,1672668129,1672670342,2213
3567,3418448389,3683113954,1672662998,1672666011,3013
3921,3824215187,3684523966,1672667170,1672669966,2796
3774,3468041839,3398731252,1672626431,1672628504,2073
3498,3714678331,3225636215,1672687118,1672687341,223
3856,3424445495,3711218296,1672666512,1672669918,3406
3536,3203538212,3514308235,1672573237,1672574102,865
3430,3517172354,3618808151,1672552091,1672552693,602
3847,3497671225,3511024016,1672656410,1672659491,3081
3541,3338390596,3349739136,1672658977,1672662082,3105
3897,3357864626,3701884158,1672668109,1672668961,852
3735,3435167810,3248058676,1672578497,1672581726,3229
3730,3505847380,3777184389,1672615337,1672618241,2904
3430,3399518841,3436025562,1672697297,1672699179,1882
3655,3499217428,3617304541,1672670618,1672672052,1434
3800,3429943738,3557046880,1672639861,1672642883,3022
3780,3715545685,3897456874,1672622540,1672625138,2598
3734,3839245934,3803517637,1672547789,1672549209,1420
3486,3421877923,3757383891,1672610712,1672610993,281
3684,3534566651,3306412634,1672624978,1672625386,408
3530,3206837348,3783136330,1672651468,1672653731,2263
3696,3615688740,3462636434,1672689781,1672691076,1295
3537,3515402792,3736705719,1672613296,1672616549,3253
3827,3780571086,3357864626,1672689967,1672690331,364
3785,3622357348,3624297844,1672700242,1672703634,3392
3544,3451326054,3488763230,1672624083,1672627062,2979
3722,3824641227,3350095157,1672685089,1672685310,221
3862,3920497528,3780712350,1672676499,1672677463,964
3626,3520991398,3517991730,1672651220,1672654334,3114
3629,3755158925,3205985903,1672569460,1672572067,2607
3895,3456430614,3604589802,1672564135,1672566134,1999
3596,3373089838,3812534508,1672560043,1672561309,1266
3881,3665998641,3898314440,1672688549,1672690705,2156
3907,3500604680,3384068080,1672546658,1672549909,3251
3602,3454277788,3834960360,1672692932,1672694131,1199
3533,3755756564,3811075491,1672646821,1672649877,3056
3918,3779892400,3711812325,1672595285,1672596111,826
3574,3730071479,3364726656,1672533608,1672535597,1989
3747,3559458968,3511150845,1672657943,1672658771,828
3458,3501281016,3505283390,1672576260,1672576946,686
3509,3975717896,3517697722,1672533157,1672535010,1853
3758,3829864515,3225029895,1672649266,1672651539,2273
3782,3897456874,3500604680,1672534421,1672535365,944
3442,3734118023,3756625818,1672587096,1672587875,779
3840,3793407963,3783520186,1672658205,1672659566,1361
3465,3205923620,3505634634,1672701998,1672702119,121
3910,3349739136,3923754072,1672582472,1672585227,2755
3508,3757903168,3534179433,1672603300,1672606121,2821
3624,3514275974,3284932450,1672668190,1672670173,1983
3604,3337322736,3202804048,1672589532,1672592824,3292
3687,3755344363,3715974659,1672690586,1672694124,3538
3550,3776988674,3905899155,1672670050,1672673199,3149
3641,3283492940,3226024417,1672543470,1672545745,2275
3851,3738026330,3294747828,1672679677,1672682967,3290
3518,3701322924,3200308999,1672678191,1672680427,2236
3728,3661903000,3338390596,1672613047,1672616419,3372
3876,3209526819,3618489670,1672600419,1672602424,2005
3572,3615939504,3755496114,1672666856,1672668364,1508
3425,3514324011,3757348722,1672562484,1672563971,1487
3529,3915162005,3315279093,1672573002,1672574401,1399
3449,3292147449,3513041785,1672552174,1672554641,2467
3441,3831586487,3773332082,1672633222,1672634211,989
3742,3792020993,3935913584,1672574186,1672575011,825
3595,3669146016,3793781065,1672645252,1672648816,3564
3723,3783147088,3713517039,1672613960,1672616351,2391
3631,3710315160,3468041839,1672696547,1672698332,1785
3757,3512722110,3511150845,1672622239,1672625075,2836
3694,3513853403,3454277788,1672695250,1672695320,70
3723,3513081354,3615115210,1672593585,1672593942,357
3735,3240994288,3777037426,1672593084,1672594224,1140
3716,3334993594,3510798825,1672540615,1672541020,405
3563,3600876425,3510798825,1672595282,1672597286,2004
3665,3311085279,3517687662,1672682178,1672684595,2417
3679,3500672156,3780769110,1672575351,1672576902,1551
3795,3713829743,3513345163,1672546343,1672546516,173
3639,3734118023,3760364383,1672605675,1672607455,1780
3541,3509764635,3974674109,1672604106,1672607203,3097
3841,3791693821,3774155692,1672664564,1672665777,1213
3784,3783520186,3660063072,1672633715,1672635217,1502
3529,3617489344,3501121099,1672557581,1672560004,2423
3743,3792274796,3519651506,1672670832,1672671324,492
3656,3373028638,3457620713,1672635449,1672636968,1519
3632,3778040015,3776034743,1672577244,1672577422,178
3876,3343816795,3703798634,1672636714,1672637813,1099
3566,3880926355,3621790707,1672561799,1672562242,443
3473,3431460073,3739911441,1672617080,1672617840,760
3539,3446533960,3755222916,1672701103,1672702124,1021
3493,3364726656,3559458968,1672700171,1672703512,3341
3763,3774243020,3505111292,1672593285,1672595783,2498
3846,3513295938,3367111751,1672622238,1672625097,2859
3645,3315703693,3519416013,1672570534,1672572855,2321
3750,3519909393,3792489602,1672587721,1672588622,901
3580,3230135532,3533274994,1672555711,1672558474,2763
3822,3463740710,3773939399,1672686390,1672688199,1809
3809,3467779445,3791436104,1672690152,1672692371,2219
3599,3511601997,3412968120,1672617106,1672619179,2073
3568,3777624586,3906536154,1672542967,1672543842,875
3580,3515401243,3773902805,1672645278,1672645904,626
3444,3336627643,3774705415,1672617993,1672621089,3096
3537,3899786664,3517462308,1672625015,1672625237,222
3901,3770438122,3755496114,1672534311,1672536786,2475
3627,3373089838,3505663516,1672682556,1672685636,3080
3624,3757903168,3299443125,1672587552,1672588632,1080
3875,3755230952,3895285664,1672679882,1672683454,3572
3553,3779465522,3511601997,1672567861,1672569136,1275
3508,3739154408,3500072204,1672568052,1672568568,516
3644,3488763230,3519077659,1672549395,1672551503,2108
3698,3288762795,3661903000,1672561055,1672562573,1518
3788,3927599181,3500604680,1672624238,1672625835,1597
3488,3760362417,3776034743,1672695109,1672695907,798
3498,3757332128,3615688740,1672649440,1672652065,2625
3624,3618489670,3510767239,1672650391,1672651955,1564
3751,3404025196,3367111751,1672645299,1672645922,623
3438,3737112297,3970603231,1672680488,1672682519,2031
3462,3362641275,3500498112,1672688342,1672688501,159
3896,3971806004,3716679950,1672622974,1672624517,1543
3606,3475349791,3779656423,1672561048,1672564017,2969
3890,3382733096,3885157459,1672633155,1672635796,2641
3457,3756704774,3399518841,1672585572,1672588293,2721
3764,3715986185,3519909393,1672682069,1672682935,866
3650,3520639768,3701664364,1672676241,1672678975,2734
3911,3701884158,3312998540,1672563034,1672565729,2695
3878,3330340793,3710489491,1672679839,1672683022,3183
3838,3200308999,3520639768,1672599529,1672600783,1254
3869,3885121158,3500044458,1672655409,1672656788,1379
3779,3756474459,3551399764,1672693041,1672695979,2938
3450,3505111292,3803389195,1672610899,1672610960,61
3647,3680810086,3500777439,1672692965,1672694524,1559
3629,3829822608,3757323954,1672671005,1672672486,1481
3915,3492546679,3232208416,1672608570,1672612147,3577
3907,3533423872,3315279093,1672592111,1672595639,3528
3501,3823084403,3607768197,1672628600,1672629071,471
3791,3715127070,3417679834,1672600963,1672603355,2392
3726,3272030610,3284932450,1672618975,1672620095,1120
3716,3610358027,3514703118,1672573552,1672576544,2992
3593,3369708250,3447672935,1672679845,1672680519,674
3595,3401793306,3500498112,1672562595,1672564232,1637
3876,3534126409,3608855425,1672623799,1672627059,3260
3636,3451691949,3467779445,1672679333,1672682836,3503
3531,3276269264,3512800570,1672700953,1672703396,2443
3622,3462636434,3500777439,1672645976,1672647380,1404
3813,3737147209,3299125059,1672686150,1672689742,3592
3862,3202804048,3367111751,1672694818,1672696883,2065
3574,3274906650,3514512367,1672615405,1672618618,3213
3576,3505402439,3852686295,1672633543,1672636671,3128
3574,3505807416,3834960360,1672671053,1672673661,2608
3901,3395201292,3559731671,1672680850,1672683637,2787
3851,3701882224,3500915908,1672656887,1672657948,1061
3716,3375449013,3613899351,1672560909,1672562801,1892
3574,3501567772,3501384020,1672686493,1672689284,2791
3920,3273981374,3755573472,1672584147,1672587151,3004
3861,3613416045,3490214516,1672699613,1672699847,234
3652,3229974066,3859868849,1672609117,1672609481,364
3809,3505481368,3661583097,1672635205,1672636180,975
3775,3793868716,3793868716,1672605396,1672608844,3448
3667,3284947372,3686227677,1672565152,1672566770,1618
3553,3333403880,3510641433,1672667443,1672670374,2931
3768,3505725706,3533274994,1672632725,1672635941,3216
3763,3933894942,3512946768,1672613747,1672614070,323
3706,3811040565,3792020993,1672588531,1672591130,2599
3706,3636329663,3505178849,1672562579,1672564893,2314
3779,3928719932,3852686295,1672697167,1672699007,1840
3915,3288762795,3684523966,1672566063,1672569015,2952
3873,3435116799,3792274796,1672696094,1672696323,229
3507,3757700712,3357289672,1672540158,1672542754,2596
3537,3858172636,3333918941,1672633928,1672636798,2870
3878,3431502855,3609933747,1672646681,1672649096,2415
3549,3931627862,3472312341,1672698783,1672699728,945
3654,3512499658,3927403123,1672579867,1672580808,941
3758,3272096759,3760651515,1672554228,1672554784,556
3769,3935487534,3916490839,1672703282,1672703981,699
3835,3500341755,3516903528,1672648988,1672649738,750
3911,3357289672,3467779445,1672693937,1672695280,1343
3669,3791613604,3783147088,1672535242,1672538456,3214
3787,3371455553,3500317969,1672665197,1672668503,3306
3868,3279475486,3703798634,1672541524,1672542730,1206
3673,3688796737,3299125059,1672675237,1672676110,873
3828,3711919537,3895285664,1672701599,1672703557,1958
3619,3519087371,3414049538,1672702631,1672704264,1633
3622,3792546035,3294703680,1672655007,1672655868,861
3487,3780769110,3380130228,1672681354,1672684374,3020
3504,3755222916,3248058676,1672674212,1672674464,252
3875,3793935736,3755222916,1672577628,1672578176,548
3431,3773837847,3350095157,1672649966,1672653304,3338
3542,3380982774,3435116799,1672647583,1672649451,1868
3739,3779613523,3716272919,1672603062,1672604336,1274
3700,3972083617,3613416045,1672588113,1672589058,945
3700,3438078818,3884596900,1672625654,1672628745,3091
3425,3621184108,3889780657,1672614800,1672615156,356
3644,3770438122,3779892400,1672633167,1672635174,2007
3756,3684523966,3688490530,1672696931,1672697481,550
3540,3780909839,3607768197,1672578109,1672580870,2761
3475,3824641227,3509366311,1672589423,1672590590,1167
3521,3224330592,3774876004,1672563439,1672566903,3464
3427,3463740710,3512295534,1672624517,1672625323,806
3479,3814677862,3817813340,1672628517,1672629323,806
3512,3689697817,3236354255,1672685195,1672685287,92
3667,3760640999,3760362417,1672639265,1672640991,1726
3568,3760645796,3351866415,1672639584,1672641878,2294
3699,3500857494,3904867554,1672544009,1672546158,2149
3885,3783147088,3224968597,1672619529,1672621618,2089
3777,3462158237,3710854064,1672648601,1672650759,2158
3909,3380982774,3505521218,1672632446,1672634431,1985
3705,3245232284,3551399764,1672542155,1672545447,3292
3585,3206837348,3689697817,1672603361,1672603742,381
3522,3622665543,3777091903,1672637827,1672639304,1477
3555,3760364383,3380767040,1672532476,1672535159,2683
3604,3415833929,3779425804,1672597513,1672598564,1051
3884,3513327337,3757075324,1672544068,1672544406,338
3621,3505923418,3274831810,1672600459,1672603223,2764
3458,3778134418,3299443125,1672639498,1672642750,3252
3454,3783550022,3554944414,1672690066,1672690153,87
3837,3403370192,3772078494,1672587408,1672589985,2577
3472,3367971170,3977352557,1672633936,1672636745,2809
3600,3284932450,3738026330,1672679908,1672681800,1892
3752,3500498112,3793315718,1672629386,1672631961,2575
3750,3490029863,3226178937,1672660155,1672660818,663
3550,3225631197,3519651506,1672698840,1672702409,3569
3695,3970627281,3205923620,1672691692,1672695106,3414
3907,3779301501,3272096759,1672548137,1672549523,1386
3676,3777091903,3714678331,1672674210,1672675376,1166
3484,3811075491,3774290799,1672596849,1672599452,2603
3657,3382733096,3979784676,1672581786,1672582477,691
3632,3779301501,3501567772,1672535234,1672536664,1430
3563,3447672935,3772391882,1672572450,1672572530,80
3722,3497671225,3514703118,1672561656,1672562847,1191
3585,3772391882,3777694660,1672561721,1672562049,328
3642,3513360004,3376467719,1672655024,1672655914,890
3864,3519282716,3880926355,1672539545,1672541353,1808
3704,3379143440,3852686295,1672554302,1672557570,3268
3582,3713691388,3380982774,1672702111,1672705499,3388
3604,3511442562,3736705719,1672679409,1672681120,1711
3749,3739154408,3714185969,1672561489,1672564938,3449
3669,3510964997,3513327337,1672572000,1672575094,3094
3542,3533188828,3734118023,1672661590,1672664819,3229
3434,3757075324,3852686295,1672605014,1672607342,2328
3445,3402697190,3514285803,1672619859,1672622972,3113
3467,3713691388,3398731252,1672664517,1672665620,1103
3809,3885155975,3517288083,1672588524,1672591158,2634
3766,3505634634,3777189898,1672649307,1672649439,132
3676,3683113954,3756704774,1672702046,1672704164,2118
3890,3415833929,3680843171,1672703295,1672704547,1252
3716,3513360004,3518561777,1672694239,1672694934,695
3696,3610870949,3519416013,1672568213,1672569725,1512
3795,3551376095,3778597171,1672581575,1672584112,2537
3914,3557046880,3520578796,1672631428,1672634613,3185
3481,3770296583,3534175249,1672536234,1672539107,2873
3614,3776831527,3240394404,1672566398,1672569640,3242
3494,3231494505,3534357694,1672648446,1672650112,1666
3463,3289114629,3505807416,1672690764,1672691379,615
3899,3343132529,3791106564,1672627790,1672628960,1170
3694,3627368399,3448875382,1672675645,1672677884,2239
3688,3296462324,3885537225,1672647043,1672647936,893
3491,3778667336,3513853403,1672576974,1672577249,275
3618,3515439826,3770520359,1672701582,1672703691,2109
3648,3505178849,3701247948,1672680398,1672681068,670
3652,3608232640,3448875382,1672684759,1672686295,1536
3830,3714067076,3392520516,1672596106,1672599319,3213
3656,3515401243,3904569677,1672551663,1672552959,1296
3441,3621184108,3370068529,1672557318,1672558730,1412
3469,3701107228,3330340793,1672653030,1672654902,1872
3647,3801645328,3777037426,1672580397,1672582651,2254
3772,3760362417,3935913584,1672574507,1672577489,2982
3667,3403370192,3241790910,1672643596,1672645699,2103
3793,3757193307,3500109249,1672556677,1672558125,1448
3756,3660887799,3732131656,1672593826,1672595513,1687
3777,3661447322,3834631333,1672637302,1672639424,2122
3572,3889780657,3500777439,1672557854,1672561422,3568
3644,3617392620,3605221116,1672551296,1672554761,3465
3749,3891672228,3711077927,1672604144,1672604995,851
3597,3513327337,3454277788,1672698141,1672698956,815
3850,3357864626,3737972328,1672548123,1672548596,473
3677,3230868435,3481640525,1672652591,1672653634,1043
3597,3755496114,3505634634,1672555320,1672558109,2789
3583,3661583097,3610870949,1672643900,1672645760,1860
3500,3684523966,3701882224,1672629030,1672629441,411
3628,3776559988,3470454332,1672627087,1672627523,436
3525,3519446663,3773121782,1672607923,1672608282,359
3845,3715127070,3689114185,1672683377,1672683682,305
3610,3895285664,3414049538,1672619987,1672621873,1886
3666,3393063657,3410538749,1672570653,1672573228,2575
3443,3934064792,3509483172,1672654521,1672655780,1259
3781,3512295534,3519850727,1672536123,1672538159,2036
3780,3711637255,3514512367,1672548126,1672550871,2745
3535,3439673892,3468041839,1672586272,1672586489,217
3919,3803389195,3505995057,1672593919,1672596823,2904
3789,3770624662,3500915908,1672540865,1672542284,1419
3711,3780472203,3510554314,1672658736,1672659532,796
3533,3774907131,3777624586,1672570728,1672571516,788
3548,3755158925,3701322924,1672656410,1672658543,2133
3704,3824215187,3515401243,1672682782,1672685480,2698
3496,3399518841,3293835352,1672580440,1672584002,3562
3445,3734118023,3417191856,1672623736,1672627201,3465
3732,3793868716,3713589994,1672673589,1672674649,1060
3591,3891672228,3713784974,1672659163,1672660144,981
3495,3393063657,3915162005,1672566797,1672567459,662
3854,3336627643,3360069849,1672632286,1672634994,2708
3428,3793315718,3225029895,1672702848,1672703787,939
3658,3880926355,3519087371,1672539419,1672540210,791
3753,3755532873,3392520516,1672655328,1672655661,333
3662,3500317969,3779646172,1672700218,1672703016,2798
3505,3979784676,3633735593,1672565915,1672566792,877
3538,3518561777,3520639768,1672660542,1672661994,1452
3828,3429943738,3792949946,1672661875,1672662991,1116
3471,3780472203,3392520516,1672693313,1672696599,3286
3842,3689697817,3770146716,1672572539,1672575121,2582
3783,3438489358,3757630221,1672537390,1672540007,2617
3821,3773837847,3445206685,1672572894,1672573895,1001
3523,3505154885,3858172636,1672545643,1672549003,3360
3900,3510499038,3779613523,1672643717,1672644029,312
3547,3520181148,3639050419,1672572641,1672576069,3428
3718,3626499450,3517172354,1672696764,1672697157,393
3743,3773033649,3613338363,1672607637,1672609406,1769
3864,3757193551,3793781065,1672621780,1672622067,287
3880,3793969543,3826238375,1672647015,1672650145,3130
3773,3773913680,3411515369,1672627890,1672630682,2792
3543,3637313265,3505888598,1672623089,1672624071,982
3559,3367111751,3512499658,1672659540,1672659874,334
3456,3793315718,3617116290,1672639169,1672641567,2398
3535,3208452238,3626499450,1672646914,1672647122,208
3899,3615087943,3309314379,1672648181,1672650353,2172
3818,3534566651,3760640999,1672690817,1672691221,404
3592,3559458968,3556969573,1672545158,1672548401,3243
3767,3382733096,3661903000,1672608663,1672610347,1684
3511,3793781065,3711218296,1672545039,1672546445,1406
3893,3715974659,3396726504,1672569324,1672572545,3221
3591,3614740489,3906536154,1672646591,1672648795,2204
3460,3557046880,3905196766,1672597369,1672598515,1146
3449,3500703304,3701884158,1672675074,1672678480,3406
3653,3518229776,3373089838,1672601905,1672604090,2185
3865,3610358027,3714120857,1672644102,1672647049,2947
3517,3480726047,3757318448,1672670952,1672673028,2076
3533,3513081354,3418448389,1672628653,1672629150,497
3538,3230135532,3923754072,1672623400,1672625872,2472
3551,3399472693,3511791953,1672638439,1672639065,626
3660,3780712350,3226024417,1672608870,1672612200,3330
3640,3713163045,3501457103,1672655694,1672658511,2817
3771,3776518452,3608855425,1672544957,1672548261,3304
3502,3938389661,3500208903,1672653015,1672656310,3295
3658,3778640261,3501215099,1672538153,1672538232,79
3634,3680843171,3513065217,1672637381,1672637752,371
3864,3310039260,3557046880,1672577930,1672578411,481
3755,3533649454,3780680950,1672548122,1672551673,3551
3640,3512295534,3276003502,1672671939,1672673157,1218
3865,3205923620,3421877923,1672683937,1672687026,3089
3819,3270056120,3330340793,1672612385,1672614588,2203
3921,3923420131,3306175858,1672610432,1672611638,1206
3526,3802932312,3512946768,1672653614,1672656438,2824
3833,3500709774,3682133690,1672647519,1672650261,2742
3541,3736231757,3480726047,1672663643,1672664460,817
3460,3556969573,3304971369,1672583278,1672586444,3166
3745,3689697817,3776117322,1672589601,1672592347,2746
3494,3236499444,3513018485,1672589794,1672591718,1924
3540,3774790271,3776988674,1672551534,1672551634,100
3873,3225029895,3412006598,1672585305,1672588206,2901
3652,3272716462,3890739241,1672572702,1672573697,995
3622,3885157459,3454277788,1672546463,1672548926,2463
3499,3517590837,3446533960,1672608526,1672608599,73
3431,3436257398,3398198430,1672693840,1672696100,2260
3726,3288762795,3479851674,1672600568,1672604041,3473
3712,3369708250,3777037426,1672672064,1672673306,1242
3706,3505283390,3533090502,1672564862,1672567184,2322
3674,3428027649,3414940786,1672683740,1672686231,2491
3451,3500613459,3631479562,1672682241,1672682346,105
3750,3448633776,3773033649,1672667945,1672670195,2250
3745,3283144118,3392836218,1672688435,1672689110,675
3455,3431460073,3668533536,1672588679,1672588795,116
3750,3928719932,3513853403,1672634501,1672636987,2486
3763,3780769110,3715385401,1672656697,1672659300,2603
3904,3373089838,3308760650,1672555459,1672557996,2537
3519,3311085279,3402697190,1672566087,1672568505,2418
3541,3303410628,3927165965,1672665290,1672668006,2716
3705,3904569677,3783340788,1672664241,1672666385,2144
3643,3783928182,3303410628,1672545285,1672547761,2476
3913,3668414677,3630353876,1672533799,1672535061,1262
3889,3839245934,3349856820,1672647829,1672649946,2117
3613,3519909393,3512830734,1672571441,1672574111,2670
3472,3793315718,3613206049,1672698721,1672701884,3163
3626,3770520359,3512800570,1672670287,1672671143,856
3470,3439673892,3667427125,1672549253,1672550551,1298
3500,3716272919,3459681410,1672649318,1672652797,3479
3846,3757323954,3513345163,1672588050,1672588254,204
3710,3505807416,3513853403,1672623566,1672625488,1922
3539,3668533536,3510641433,1672658900,1672660534,1634
3526,3815392801,3665998641,1672555706,1672558298,2592
3693,3811040565,3902861231,1672574005,1672575182,1177
3912,3791693821,3777184389,1672592634,1672595734,3100
3829,3780834916,3517697722,1672575485,1672577069,1584
3448,3468041839,3779938251,1672593221,1672594746,1525
3896,3510641433,3610358027,1672570225,1672573130,2905
3849,3668533536,3887243870,1672563784,1672566936,3152
3568,3791441520,3357289672,1672702269,1672703503,1234
3570,3421385957,3626499450,1672694114,1672695560,1446
3472,3311085279,3517697722,1672673749,1672675520,1771
3475,3856606678,3315279093,1672642976,1672643080,104
3913,3780769110,3732584121,1672605352,1672607073,1721
3739,3360616538,3312998540,1672651546,1672651804,258
3456,3608922867,3701664364,1672689609,1672691324,1715
3867,3713941638,3493017654,1672698138,1672701384,3246
3853,3914691363,3793418209,1672538758,1672541193,2435
3613,3236458894,3792014516,1672613803,1672617138,3335
3561,3515466096,3347446226,1672589582,1672590088,506
3633,3930242012,3686523546,1672690121,1672691601,1480
3848,3772391882,3935913584,1672543090,1672546626,3536
3540,3475349791,3779854934,1672595297,1672598829,3532
3659,3514741348,3379143440,1672573694,1672575775,2081
3596,3513853403,3201676087,1672551747,1672552081,334
3630,3220031931,3436025562,1672561210,1672563957,2747
3631,3220031931,3505888598,1672578596,1672580430,1834
3790,3289817992,3800257590,1672619695,1672620548,853
3841,3756704774,3438489358,1672668221,1672670691,2470
3603,3791441520,3478114114,1672649527,1672652079,2552
3675,3505634634,3814677862,1672568399,1672570199,1800
3484,3730071479,3505434346,1672593994,1672597331,3337
3707,3500857494,3792801638,1672663157,1672665880,2723
3463,3273981374,3779738691,1672645408,1672647306,1898
3608,3925979970,3972192593,1672633960,1672635622,1662
3512,3783136330,3757348722,1672673603,1672674308,705
3732,3452016771,3369708250,1672613925,1672614513,588
3535,3416987084,3934064792,1672638405,1672641973,3568
3917,3757903168,3500777439,1672570523,1672572152,1629
3555,3470454332,3715974659,1672544113,1672545990,1877
3606,3517697722,3380130228,1672698578,1672701673,3095
3509,3776559988,3511791953,1672634787,1672635578,791
3792,3232208416,3451326054,1672675857,1672676791,934
3442,3626499450,3510964997,1672587809,1672588917,1108
3560,3793781065,3456430614,1672698910,1672699365,455
3618,3621184108,3241914067,1672688662,1672692041,3379
3794,3520115090,3519651506,1672610030,1672611399,1369
3562,3463849738,3734451191,1672681897,1672683400,1503
3587,3792014516,3792274796,1672531218,1672531360,142
3528,3228888030,3711000597,1672574705,1672575108,403
3680,3792538417,3897435944,1672537696,1672540363,2667
3806,3756704774,3710048469,1672563389,1672565999,2610
3675,3611055563,3349739136,1672634433,1672637100,2667
3485,3668747074,3367111751,1672701739,1672703943,2204
3915,3501215099,3500915908,1672664563,1672667135,2572
3676,3777184389,3773837847,1672682223,1672684350,2127
3430,3733363628,3793922324,1672649711,1672651128,1417
3532,3534126409,3777485931,1672535809,1672536449,640
3742,3501281016,3710562338,1672615584,1672618076,2492
3639,3244004456,3779613523,1672686635,1672687192,557
3725,3711919537,3294703680,1672538604,1672539839,1235
3467,3300229945,3783919913,1672674761,1672677059,2298
3858,3905899155,3398731252,1672620633,1672623768,3135
3571,3972083617,3760924079,1672537149,1672537803,654
3740,3633735593,3609881958,1672610036,1672611490,1454
3457,3284947372,3891672228,1672655626,1672656469,843
3711,3519909393,3501786419,1672683434,1672685849,2415
3714,3618176292,3736231757,1672687619,1672689952,2333
3882,3450286949,3780769110,1672591040,1672592499,1459
3607,3241790910,3777779869,1672658405,1672660294,1889
3526,3757700712,3276269264,1672578598,1672580608,2010
3652,3510554314,3902625986,1672688500,1672690011,1511
3540,3780472203,3834631333,1672640660,1672641659,999
3922,3519142371,3703396825,1672679742,1672683175,3433
3573,3533423872,3714067076,1672607116,1672609421,2305
3464,3779301501,3897435944,1672689921,1672690788,867
3659,3229822507,3755915206,1672699826,1672702599,2773
3755,3807212280,3501121099,1672539987,1672542879,2892
3692,3533747868,3734451191,1672597976,1672598168,192
3666,3756746867,3417191856,1672628590,1672631242,2652
3549,3440107959,3739911441,1672658806,1672659657,851
3876,3451326054,3621790707,1672685306,1672686949,1643
3917,3341893384,3279339278,1672588468,1672590561,2093
3613,3283492940,3713768950,1672541425,1672544305,2880
3851,3624297844,3274831810,1672607544,1672609143,1599
3864,3341893384,3774290799,1672589817,1672592151,2334
3825,3229822507,3621790707,1672625859,1672629358,3499
3767,3513295938,3607768197,1672660238,1672663380,3142
3495,3938389661,3609659642,1672604339,1672605813,1474
3772,3311098437,3513410578,1672565200,1672565946,746
3761,3428027649,3783615982,1672608150,1672609419,1269
3733,3889780657,3905196766,1672649714,1672651390,1676
3805,3927165965,3497808662,1672582790,1672585405,2615
3789,3440107959,3517462308,1672694592,1672696440,1848
3450,3623266256,3394297564,1672671956,1672672779,823
3443,3481640525,3638660068,1672613767,1672617195,3428
3839,3534357694,3279339278,1672575743,1672577082,1339
3829,3229822507,3979784676,1672641741,1672642317,576
3822,3226024417,3505923418,1672696392,1672696488,96
3672,3814305099,3780571086,1672625518,1672626348,830
3698,3501525100,3360616538,1672626271,1672627839,1568
3531,3501384020,3384068080,1672689536,1672690895,1359
3525,3316798920,3428027649,1672676656,1672677942,1286
3449,3514956366,3791128487,1672531587,1672533504,1917
3836,3285204083,3520639768,1672563876,1672566418,2542
3476,3777330107,3618808151,1672531701,1672535253,3552
3810,3289817992,3209526819,1672669332,1672670717,1385
3892,3778667336,3609881958,1672560795,1672561327,532
3881,3935487534,3497095254,1672534808,1672535599,791
3914,3500737582,3428725843,1672684370,1672684677,307
3842,3367111751,3202141727,1672677184,1672680696,3512
3463,3779532653,3600876425,1672633257,1672634722,1465
3910,3661903000,3615087943,1672634613,1672635161,548
3485,3435116799,3791613604,1672640121,1672643461,3340
3721,3514818819,3414275042,1672692562,1672694536,1974
3625,3500949309,3711077927,1672598212,1672599407,1195
3901,3519416013,3505178849,1672700988,1672704101,3113
3636,3369708250,3760040019,1672605472,1672608469,2997
3723,3779892400,3756474459,1672655292,1672656538,1246
3828,3347446226,3398198430,1672638654,1672640709,2055
3579,3921648519,3514246749,1672649394,1672651123,1729
3790,3610358027,3208452238,1672691644,1672693312,1668
3606,3621461051,3935913584,1672533786,1672536885,3099
3451,3970558632,3636329663,1672626135,1672626305,170
3737,3360069849,3455018347,1672665998,1672668415,2417
3669,3441348818,3520416075,1672608950,1672609890,940
3739,3336627643,3520416075,1672697648,1672698470,822
3468,3713561276,3716628503,1672628782,1672628977,195
3813,3770624662,3638660068,1672571479,1672574841,3362
3521,3931627862,3336627643,1672573244,1672576752,3508
3470,3408430195,3916490839,1672599900,1672601610,1710
3874,3713691388,3610870949,1672575481,1672576321,840
3632,3441348818,3505481368,1672632354,1672634914,2560
3631,3711734586,3774790271,1672665654,1672666004,350
3603,3201800997,3923754072,1672548199,1672548879,680
3911,3920497528,3205923620,1672637215,1672637712,497
3781,3519142371,3534829213,1672580775,1672583130,2355
3532,3520639768,3516321888,1672539880,1672542564,2684
3885,3306175858,3779646172,1672633334,1672636309,2975
3661,3312998540,3793740407,1672601233,1672603314,2081
3854,3757075324,3310125159,1672552156,1672553375,1219
3475,3760040019,3661583097,1672702261,1672705017,2756
3545,3554186380,3927599181,1672610837,1672611890,1053
3917,3633735593,3934064792,1672640907,1672642167,1260
3458,3703383853,3384583385,1672558755,1672559285,530
3901,3660063072,3625463628,1672667747,1672668928,1181
3578,3516703758,3711097754,1672554051,1672554664,613
3492,3925979970,3505434346,1672675911,1672676485,574
3504,3803389195,3701882224,1672665626,1672667663,2037
3710,3209526819,3736705719,1672615103,1672618637,3534
3703,3615113018,3209481722,1672596125,1672596965,840
3638,3520416075,3398731252,1672536608,1672538562,1954
3668,3492959689,3773009828,1672564910,1672565407,497
3858,3615087943,3517590837,1672636909,1672639153,2244
3810,3315703693,3501786419,1672602985,1672606488,3503
3424,3386758279,3604867757,1672693284,1672694097,813
3646,3512722110,3291933594,1672629944,1672632331,2387
3779,3311049964,3306175858,1672626823,1672627734,911
3811,3512502036,3780209375,1672665962,1672667529,1567
3653,3517172354,3292147449,1672648163,1672650156,1993
3593,3238288884,3513545422,1672695698,1672698592,2894
3757,3783147088,3513295938,1672621440,1672624828,3388
3784,3927403123,3533929349,1672631908,1672632706,798
3700,3436025562,3852533643,1672555671,1672558574,2903
3615,3516489668,3500827202,1672560910,1672564255,3345
3437,3777091903,3481640525,1672702765,1672704580,1815
3609,3812369928,3230868435,1672565191,1672566505,1314
3454,3665998641,3534175249,1672682651,1672686204,3553
3740,3613581796,3756385685,1672628673,1672631183,2510
3497,3623266256,3777330107,1672543268,1672545047,1779
3718,3793781065,3500072204,1672603528,1672603680,152
3922,3685681577,3615737355,1672646386,1672649217,2831
3737,3610358027,3710008361,1672579889,1672583215,3326
3576,3829822608,3701136026,1672531336,1672532397,1061
3474,3783169442,3715974659,1672554582,1672555134,552
3696,3774243020,3835985172,1672670525,1672673686,3161
3888,3738026330,3807212280,1672652716,1672656093,3377
3907,3610358027,3505481368,1672583506,1672585233,1727
3458,3366423342,3923754072,1672639898,1672641636,1738
3671,3667427125,3756704774,1672552866,1672553352,486
3759,3392520516,3661583097,1672580151,1672581107,956
3795,3283492940,3615087943,1672586270,1672589081,2811
3657,3279242917,3315703693,1672587675,1672589434,1759
3517,3668414677,3315703693,1672689960,1672692478,2518
3804,3928719932,3736231757,1672561178,1672563163,1985
3496,3739911441,3499217428,1672550059,1672553178,3119
3424,3780322355,3756704774,1672634981,1672635969,988
3472,3520181148,3271752081,1672590923,1672591773,850
3718,3519028898,3898314440,1672540882,1672543751,2869
3635,3770676872,3511005395,1672619686,1672620696,1010
3911,3460719322,3380982774,1672573333,1672573936,603
3841,3362641275,3621461051,1672587536,1672589398,1862
3442,3374183227,3615939504,1672696352,1672697821,1469
3647,3715086894,3608232640,1672674917,1672676053,1136
3472,3783433404,3315703693,1672632844,1672635110,2266
3614,3467988782,3680843171,1672645298,1672647715,2417
3810,3713589994,3715619259,1672624504,1672627059,2555
3585,3783136330,3661583097,1672583185,1672585701,2516
3682,3912891315,3661583097,1672555066,1672558286,3220
3844,3389634034,3394297564,1672599235,1672602509,3274
3640,3280054198,3716679950,1672628428,1672631944,3516
3500,3370227921,3203538212,1672688333,1672690207,1874
3866,3829822608,3224811762,1672560068,1672561907,1839
3696,3364726656,3513295938,1672680051,1672682593,2542
3737,3480100311,3803517637,1672556249,1672557000,751
3481,3395201292,3774155692,1672550270,1672552681,2411
3519,3610358027,3814305099,1672577145,1672578547,1402
3647,3609881958,3276003502,1672585519,1672588304,2785
3626,3792489602,3311498666,1672561858,1672563518,1660
3644,3505888598,3836241528,1672572812,1672575350,2538
3612,3732131656,3711097754,1672621109,1672621514,405
3621,3514308235,3238288884,1672573552,1672576951,3399
3734,3732584121,3703383853,1672612281,1672615596,3315
3705,3716110860,3270042456,1672649359,1672651695,2336
3633,3792389522,3683113954,1672635598,1672637163,1565
3597,3513296868,3401496246,1672619587,1672623041,3454
3435,3315279093,3417191856,1672540743,1672540996,253
3505,3755344363,3520322124,1672544023,1672546306,2283
3542,3274831810,3516321888,1672624523,1672626442,1919
3789,3512830734,3513295938,1672588724,1672591446,2722
3489,3421877923,3826238375,1672588646,1672589346,700
3846,3792489602,3615115210,1672666696,1672669750,3054
3613,3892304880,3632814465,1672669493,1672672128,2635
3747,3487875183,3497095254,1672684421,1672685976,1555
3638,3624297844,3792949946,1672618921,1672622309,3388
3543,3516298579,3783340788,1672534971,1672536208,1237
3846,3512958459,3783801141,1672652849,1672653936,1087
3465,3273981374,3685816610,1672544410,1672545829,1419
3644,3713589994,3615087943,1672582501,1672585939,3438
3653,3516741440,3615939504,1672557717,1672558336,619
3729,3350095157,3408498208,1672543363,1672543601,238
3916,3608855425,3779786641,1672567015,1672568813,1798
3451,3394401087,3897376951,1672537942,1672541160,3218
3878,3756127300,3927165965,1672611894,1672614609,2715
3782,3623266256,3811040565,1672569312,1672572717,3405
3897,3885157459,3392836218,1672659008,1672662456,3448
3794,3772765746,3421877923,1672676030,1672677337,1307
3467,3625463628,3780209375,1672636342,1672638903,2561
3801,3777814504,3514703118,1672612814,1672615405,2591
3743,3792072681,3512337405,1672593143,1672595322,2179
3898,3516741440,3463740710,1672662773,1672663646,873
3538,3931627862,3519028898,1672665040,1672666244,1204
3602,3270697740,3770438122,1672681621,1672684497,2876
3445,3701247948,3730071479,1672589073,1672591938,2865
3733,3774790271,3834963772,1672703159,1672703948,789
3779,3884596900,3334647380,1672668929,1672670142,1213
3750,3515559913,3236354255,1672642404,1672644432,2028
3794,3512282789,3515401243,1672564105,1672566385,2280
3637,3715619259,3554186380,1672633586,1672636059,2473
3848,3703383853,3513360004,1672587218,1672589541,2323
3511,3713163045,3492959689,1672656292,1672656754,462
3860,3814305099,3897376951,1672648723,1672650836,2113
3768,3770236215,3755756564,1672609382,1672610975,1593
3605,3438489358,3448875382,1672550063,1672551498,1435
3434,3424660806,3801645328,1672624621,1672626761,2140
3688,3334974375,3779656423,1672619052,1672619608,556
3535,3823084403,3703396825,1672690155,1672691688,1533
3472,3615087943,3336339664,1672638737,1672641082,2345
3882,3511883730,3279339278,1672592064,1672594507,2443
3433,3300511067,3315703693,1672647059,1672649477,2418
3523,3783163143,3300229945,1672684728,1672685582,854
3837,3773033649,3513410578,1672582701,1672584942,2241
3558,3711919537,3770624662,1672635519,1672635895,376
3901,3757630221,3505266860,1672658563,1672660667,2104
3724,3773027597,3833217041,1672639420,1672640831,1411
3771,3367509761,3780909839,1672638452,1672641387,2935
3625,3512379024,3515439826,1672534532,1672536739,2207
3779,3400069268,3774718695,1672679856,1672682472,2616
3786,3354144091,3835985172,1672600794,1672603667,2873
3666,3668747074,3909094917,1672688809,1672689786,977
3525,3510767239,3201800997,1672625032,1672625568,536
3472,3534357694,3349856820,1672678032,1672678113,81
3630,3510554314,3760721303,1672580431,1672582802,2371
3638,3611055563,3411515369,1672630693,1672631421,728
3806,3554186380,3393063657,1672598755,1672598931,176
3827,3450286949,3239617320,1672666565,1672667608,1043
3690,3715086894,3770438122,1672684133,1672686976,2843
3485,3479851674,3240994288,1672585397,1672588931,3534
3696,3971806004,3755230952,1672598940,1672602490,3550
3812,3834960360,3710008361,1672564659,1672565158,499
3434,3510499038,3513410578,1672651737,1672652310,573
3847,3979784676,3780834916,1672566277,1672568763,2486
3893,3200543880,3972083617,1672701357,1672701678,321
3922,3774705415,3815392801,1672567166,1672570498,3332
3548,3716272919,3306175858,1672610541,1672612775,2234
3470,3512499658,3730071479,1672660625,1672663199,2574
3476,3514275974,3440107959,1672662983,1672664189,1206
3706,3533228966,3792949946,1672543325,1672546173,2848
3766,3311049964,3512946768,1672537493,1672538912,1419
3725,3299443125,3414049538,1672698815,1672700988,2173
3781,3736705719,3385323994,1672579826,1672582604,2778
3759,3897435944,3514334067,1672541071,1672544124,3053
3565,3351696332,3292147449,1672674769,1672676047,1278
3887,3777037426,3533090502,1672579764,1672579926,162
3909,3770704999,3293835352,1672556121,1672557230,1109
3428,3714128600,3970627281,1672581879,1672583709,1830
3889,3510964997,3783919913,1672601451,1672602608,1157
3771,3891672228,3516444201,1672666766,1672669595,2829
3839,3660063072,3519446663,1672572656,1672574983,2327
3686,3979802715,3760040019,1672554930,1672555227,297
3465,3554944414,3513345163,1672544916,1672544989,73
3585,3200308999,3517991730,1672538031,1672541571,3540
3484,3783433404,3665998641,1672651829,1672652319,490
3523,3534829213,3514971533,1672588346,1672590952,2606
3820,3501121099,3519077659,1672655702,1672656765,1063
3915,3793935736,3713163045,1672629959,1672633420,3461
3787,3410538749,3475349791,1672545869,1672548351,2482
3838,3891672228,3462636434,1672614379,1672614834,455
3509,3773837847,3600876425,1672573509,1672575959,2450
3684,3760364383,3834631333,1672698973,1672702430,3457
3641,3479851674,3205985903,1672620804,1672620907,103
3651,3516741440,3491469603,1672622462,1672624936,2474
3712,3900945856,3480991549,1672585514,1672588493,2979
3907,3505807416,3551399764,1672685348,1672687471,2123
3661,3915162005,3505266860,1672531821,1672533132,1311
3757,3480100311,3311498666,1672548577,1672550922,2345
3435,3885157459,3276217799,1672570602,1672571779,1177
3555,3979784676,3518653080,1672578487,1672580957,2470
3472,3349739136,3360616538,1672676202,1672678998,2796
3752,3279473441,3273981374,1672661976,1672664497,2521
3623,3760640999,3615688740,1672699515,1672701735,2220
3664,3500498112,3772078494,1672546993,1672549431,2438
3529,3773902805,3770624662,1672550900,1672552307,1407
3624,3284932450,3270056120,1672582563,1672584073,1510
3836,3760263530,3551389192,1672539272,1672541524,2252
3543,3793315718,3512958459,1672694011,1672695413,1402
3586,3533004959,3835985172,1672691295,1672693661,2366
3882,3834631333,3519446663,1672547801,1672550179,2378
3807,3552824113,3755915206,1672646923,1672649468,2545
3854,3200308999,3333918941,1672641497,1672644204,2707
3807,3773939399,3773902805,1672637667,1672640757,3090
3774,3363162590,3283770991,1672647111,1672648785,1674
3558,3668414677,3760362417,1672540500,1672541347,847
3768,3513410578,3779425804,1672562117,1672563972,1855
3694,3661583097,3755756564,1672538986,1672542399,3413
3755,3551389192,3836241528,1672541304,1672543336,2032
3832,3201676087,3916490839,1672638573,1672640610,2037
3804,3779613523,3517222913,1672629328,1672629926,598
3492,3514334067,3334993594,1672549903,1672551585,1682
3852,3604589802,3404025196,1672677767,1672679599,1832
3446,3793781065,3520416075,1672587692,1672589638,1946
3842,3711097754,3757630221,1672689715,1672691311,1596
3872,3772078494,3800257590,1672634931,1672636255,1324
3549,3341893384,3621683102,1672610920,1672613650,2730
3783,3505995057,3516489668,1672680125,1672680687,562
3623,3664943873,3513327337,1672552958,1672555862,2904
3824,3685816610,3236354255,1672556855,1672558220,1365
3537,3892304880,3220031931,1672593617,1672596532,2915
3577,3932478321,3512337405,1672534820,1672537976,3156
3629,3492546679,3505154885,1672547334,1672550140,2806
3648,3500949309,3895285664,1672641447,1672642896,1449
3433,3600876425,3760842815,1672687919,1672690111,2192
3636,3368283077,3500341755,1672565528,1672568199,2671
3593,3625174002,3449333754,1672555134,1672555710,576
3904,3688796737,3668533536,1672555997,1672558881,2884
3861,3783641602,3499217428,1672638053,1672640591,2538
3886,3779738691,3793883863,1672690448,1672694016,3568
3592,3493017654,3516321888,1672684926,1672688451,3525
3778,3779425804,3501567772,1672678614,1672680881,2267
3502,3793868716,3812369928,1672667947,1672668255,308
3875,3793969543,3511883730,1672649764,1672652815,3051
3575,3972192593,3276217799,1672645000,1672645807,807
3563,3279475486,3518194482,1672536780,1672537133,353
3794,3333918941,3516489668,1672696367,1672696444,77
3549,3435167810,3755496114,1672621448,1672621647,199
3822,3230868435,3777624586,1672566424,1672567747,1323
3918,3773572967,3274831810,1672699997,1672702628,2631
3874,3513295938,3450969839,1672650601,1672653725,3124
3919,3815250107,3520873221,1672696771,1672699194,2423
3516,3898314440,3505995057,1672646789,1672647794,1005
3599,3303410628,3500841914,1672637232,1672638405,1173
3856,3330340793,3774031303,1672550418,1672553598,3180
3768,3613581796,3515439826,1672622627,1672625211,2584
3574,3859868849,3885157459,1672657021,1672658955,1934
3734,3513410578,3273981374,1672556352,1672556836,484
3709,3519850727,3449333754,1672608338,1672610472,2134
3495,3384583385,3500737582,1672570099,1672572756,2657
3922,3934064792,3280268483,1672534732,1672536012,1280
3440,3733363628,3774733620,1672532222,1672535513,3291
3841,3500613493,3774733620,1672545289,1672546782,1493
3519,3975717896,3791441520,1672598963,1672602562,3599
3674,3773009828,3533747868,1672553777,1672557339,3562
3800,3311085279,3505283390,1672628898,1672630198,1300
3825,3713911104,3755344363,1672677473,1672678198,725
3648,3271454397,3505283390,1672623427,1672625715,2288
3551,3519416013,3392520516,1672558232,1672559185,953
3880,3730071479,3920497528,1672619600,1672620640,1040
3881,3385323994,3512337405,1672693075,1672694754,1679
3535,3791613604,3300818269,1672616135,1672617838,1703
3901,3703139663,3518561777,1672553505,1672555161,1656
3758,3461119815,3240394404,1672673495,1672676338,2843
3805,3455018347,3701136026,1672608601,1672610315,1714
3485,3703396825,3710315160,1672622821,1672622913,92
3873,3279475486,3793969543,1672689894,1672691728,1834
3469,3279475486,3410538749,1672578759,1672581040,2281
3612,3711734586,3228888030,1672569304,1672570167,863
3888,3513853403,3926643445,1672608395,1672609713,1318
3451,3500915665,3715545685,1672623084,1672625114,2030
3862,3808136029,3336339664,1672617942,1672618463,521
3777,3428725843,3510818674,1672663781,1672664580,799
3833,3402697190,3760364383,1672538601,1672540060,1459
3863,3610358027,3367111751,1672567759,1672567822,63
3692,3533747868,3512392431,1672572994,1672576523,3529
3509,3488686442,3780834916,1672694060,1672695874,1814
3873,3780769110,3607882826,1672547452,1672548083,631
3497,3279339278,3791436104,1672604798,1672606408,1610
3573,3682133690,3283492940,1672703952,1672705243,1291
3479,3276217799,3755737419,1672633551,1672635765,2214
3679,3625463628,3272716462,1672641012,1672643281,2269
3556,3236458894,3858172636,1672612502,1672612637,135
3689,3970627281,3915162005,1672649846,1672651871,2025
3488,3736705719,3760094385,1672562611,1672563695,1084
3776,3505228454,3793175445,1672634381,1672636292,1911
3776,3701322924,3770520359,1672693205,1672696353,3148
3563,3392836218,3501384020,1672591081,1672594096,3015
3771,3435116799,3349856820,1672546367,1672548682,2315
3565,3779425804,3755404116,1672632803,1672633223,420
3666,3773837847,3226024417,1672572981,1672574489,1508
3799,3909094917,3703396825,1672554040,1672555662,1622
3471,3928719932,3336627643,1672579940,1672581833,1893
3661,3360616538,3608922867,1672554757,1672556827,2070
3570,3829864515,3232208416,1672571579,1672575099,3520
3438,3755158925,3515525630,1672635119,1672638449,3330
3517,3631090677,3354144091,1672573482,1672576554,3072
3595,3467779445,3513081354,1672623649,1672624011,362
3552,3276217799,3757332128,1672612871,1672615949,3078
3829,3357289672,3979784676,1672629098,1672631306,2208
3679,3283492940,3279473441,1672551052,1672554045,2993
3708,3783136330,3755404116,1672690644,1672693918,3274
3748,3755915206,3396726504,1672632102,1672634628,2526
3632,3625174002,3303410628,1672649188,1672651456,2268
3622,3510642075,3401496246,1672661306,1672663060,1754
3598,3779738691,3513327337,1672645038,1672646634,1596
3876,3605221116,3688796737,1672674000,1672676192,2192
3650,3836241528,3201629017,1672588663,1672589076,413
3478,3833217041,3514818819,1672586111,1672587208,1097
3768,3288224595,3335694356,1672643100,1672644084,984
3554,3615087943,3396980894,1672682113,1672684664,2551
3669,3715974659,3379143440,1672543669,1672547192,3523
3425,3904867554,3533929349,1672667465,1672667864,399
3877,3791796585,3621184108,1672640227,1672641849,1622
3718,3520578796,3364378127,1672531821,1672534367,2546
3443,3774155692,3757323954,1672592551,1672596039,3488
3823,3755404116,3715443333,1672642790,1672645633,2843
3742,3520578796,3792442597,1672640464,1672641689,1225
3493,3534179433,3791441520,1672700707,1672703045,2338
3471,3511791953,3613899351,1672665620,1672666679,1059
3684,3783801141,3505725706,1672585289,1672586072,783
3658,3236458894,3610870949,1672557373,1672557780,407
3728,3977352557,3703348097,1672656667,1672657998,1331
3733,3713941638,3383138270,1672548439,1672548732,293
3875,3205985903,3905899155,1672576436,1672576552,116
3545,3610870949,3779532653,1672613775,1672614187,412
3712,3853629553,3904867554,1672652895,1672653839,944
3730,3505663516,3780209375,1672588108,1672590654,2546
3845,3703139663,3501281016,1672596150,1672596638,488
3814,3891672228,3792546035,1672689179,1672690488,1309
3649,3620292035,3714120857,1672671650,1672673850,2200
3525,3733363628,3923754072,1672637863,1672639732,1869
3884,3703798634,3500949309,1672583843,1672585171,1328
3813,3385323994,3418448389,1672638016,1672641298,3282
3761,3274831810,3411515369,1672680296,1672681062,766
3716,3715707380,3710854064,1672576234,1672577408,1174
3650,3701823816,3500044458,1672556849,1672560278,3429
3475,3739154408,3834631333,1672598351,1672600336,1985
3599,3778926763,3241790910,1672576802,1672580238,3436
3921,3349856820,3900276517,1672682876,1672684485,1609
3619,3856606678,3201800997,1672539670,1672541728,2058
3790,3534764451,3792442597,1672564174,1672566093,1919
3659,3451726367,3793868716,1672703718,1672705593,1875
3824,3833217041,3793883863,1672656454,1672658628,2174
3622,3885537225,3272096759,1672587760,1672590813,3053
3575,3517887477,3791753345,1672626344,1672628991,2647
3461,3821054646,3300511067,1672648105,1672651167,3062
3683,3755233658,3500709774,1672612920,1672615021,2101
3618,3803517637,3505663516,1672583920,1672584353,433
3704,3270697740,3760645796,1672545746,1672548006,2260
3668,3972192593,3436025562,1672543953,1672546178,2225
3648,3402385957,3715127070,1672603587,1672605783,2196
3786,3534764451,3380130228,1672574023,1672576317,2294
3681,3449333754,3703798634,1672597838,1672600334,2496
3874,3631090677,3627368399,1672548836,1672551288,2452
3862,3288762795,3505283390,1672631520,1672634102,2582
3535,3711637255,3373028638,1672538314,1672538711,397
3643,3449333754,3336627643,1672617635,1672620267,2632
3635,3513360004,3512958459,1672656534,1672658069,1535
3884,3668533536,3514334067,1672688597,1672689759,1162
3884,3271454397,3773121782,1672535065,1672537782,2717
3708,3711218296,3701823816,1672631607,1672632318,711
3867,3475349791,3902760230,1672627327,1672628455,1128
3609,3714185969,3792801638,1672550615,1672552706,2091
3739,3518561777,3515439826,1672695227,1672697997,2770
3716,3617116290,3343816795,1672650482,1672651541,1059
3566,3225631197,3505481368,1672701157,1672701314,157
3659,3792745809,3505437712,1672543595,1672544293,698
3506,3713829743,3452016771,1672703372,1672706100,2728
3777,3289817992,3373028638,1672538250,1672540964,2714
3678,3734915241,3298151889,1672533237,1672534658,1421
3542,3514246749,3818575661,1672627496,1672627859,363
3830,3505725706,3270042456,1672597967,1672601104,3137
3889,3505283390,3608922867,1672550134,1672552527,2393
3497,3515890966,3279242917,1672626624,1672630156,3532
3438,3793922324,3615087943,1672549837,1672550538,701
3913,3970198861,3755158925,1672555876,1672557517,1641
3575,3711218296,3304155815,1672577338,1672580063,2725
3773,3373089838,3472312341,1672690667,1672692497,1830
3595,3855583256,3472068734,1672592547,1672594025,1478
3861,3739911441,3534829213,1672665330,1672665623,293
3734,3772078494,3757630221,1672538827,1672540976,2149
3843,3505888598,3389634034,1672585042,1672586896,1854
3549,3240994288,3408498208,1672551829,1672555302,3473
3664,3462273042,3240394404,1672552983,1672555963,2980
3541,3294703680,3512800570,1672555078,1672555543,465
3710,3436257398,3533079336,1672658258,1672659870,1612
3506,3711919537,3500613459,1672614618,1672615296,678
3593,3481640525,3497671225,1672593451,1672594376,925
3727,3304155815,3515439826,1672547030,1672550347,3317
3796,3202804048,3497671225,1672671933,1672673753,1820
3880,3633735593,3367111751,1672645709,1672648874,3165
3503,3534175249,3438489358,1672537605,1672538795,1190
3467,3850911686,3792525861,1672538194,1672540229,2035
3684,3368283077,3533423872,1672641727,1672642713,986
3540,3454277788,3500841914,1672613024,1672614878,1854
3577,3459681410,3534566651,1672583790,1672585720,1930
3682,3515890966,3774790271,1672535409,1672538242,2833
3764,3500777439,3300511067,1672616246,1672616660,414
3482,3716628503,3757863420,1672696406,1672698220,1814
3843,3779938251,3500072204,1672616527,1672616706,179
3504,3411688875,3608855425,1672648244,1672650316,2072
3636,3622357348,3777240360,1672583031,1672584095,1064
3872,3755573472,3505923418,1672552740,1672555334,2594
3448,3933894942,3500347447,1672591213,1672593695,2482
3791,3440137407,3927599181,1672703377,1672705922,2545
3690,3792505974,3710496785,1672614751,1672617523,2772
3780,3511601997,3811075491,1672647342,1672650658,3316
3695,3680843171,3354144091,1672651319,1672652609,1290
3592,3505178849,3276003502,1672542770,1672544299,1529
3916,3367111751,3514324011,1672658763,1672659035,272
3520,3511005395,3294703680,1672580876,1672584153,3277
3841,3493017654,3853629553,1672624069,1672627198,3129
3459,3755992176,3783340788,1672622380,1672624313,1933
3914,3479851674,3774605761,1672676518,1672679588,3070
3536,3534829213,3516489668,1672580231,1672581696,1465
3653,3885155975,3703798634,1672600804,1672603544,2740
3794,3890739241,3977352557,1672542487,1672545367,2880
3886,3512379024,3513296868,1672547257,1672550406,3149
3916,3366423342,3757075324,1672561411,1672563702,2291
3583,3230868435,3757075324,1672626154,1672626874,720
3730,3900945856,3436257398,1672538785,1672540379,1594
3862,3755065949,3501457103,1672642821,1672645820,2999
3781,3505178849,3899786664,1672606057,1672609348,3291
3548,3890739241,3519818818,1672645794,1672645906,112
3828,3791441520,3438489358,1672653560,1672653806,246
3539,3230135532,3456430614,1672667020,1672667419,399
3896,3520764926,3493017654,1672570189,1672573391,3202
3571,3399518841,3932478321,1672615612,1672616296,684
3661,3793740407,3779613523,1672686205,1672688978,2773
3650,3625463628,3513065217,1672625283,1672625776,493
3762,3481640525,3812369928,1672595695,1672597138,1443
3744,3534829213,3512337405,1672567388,1672569236,1848
3772,3311498666,3276269264,1672687509,1672690771,3262
3424,3800257590,3513295938,1672666512,1672668722,2210
3757,3276217799,3271752081,1672646286,1672649609,3323
3843,3272716462,3228888030,1672564459,1672566953,2494
3453,3608922867,3490214516,1672585889,1672588660,2771
3827,3777147510,3385323994,1672645240,1672646084,844
3892,3900898992,3715854030,1672605495,1672607996,2501
3704,3760645796,3416987084,1672612005,1672613470,1465
3831,3777091903,3225636215,1672681148,1672684467,3319
3655,3853629553,3490214516,1672533417,1672534427,1010
3919,3300818269,3311420950,1672587805,1672588370,565
3477,3793969543,3970909253,1672668671,1672669567,896
3488,3300818269,3979784676,1672620972,1672623434,2462
3806,3416987084,3823084403,1672646067,1672649320,3253
3849,3289114629,3685681577,1672610475,1672612771,2296
3818,3500341755,3389634034,1672671665,1672671958,293
3692,3701823816,3779465522,1672620933,1672622717,1784
3718,3793922324,3770236215,1672603857,1672604597,740
3762,3410160376,3859868849,1672555965,1672559447,3482
3808,3630353876,3514308235,1672611269,1672614173,2904
3777,3283770991,3485540729,1672587512,1672590620,3108
3696,3770236215,3778640261,1672547183,1672547871,688
3537,3793175445,3703383853,1672703466,1672706493,3027
3706,3330340793,3505634634,1672671917,1672673354,1437
3582,3821054646,3514512367,1672571351,1672573955,2604
3524,3227799827,3554944414,1672641968,1672645275,3307
3586,3777814504,3812534508,1672639289,1672642204,2915
3625,3299443125,3410160376,1672625092,1672627793,2701
3677,3633735593,3755573472,1672660541,1672663352,2811
3768,3370068529,3773121782,1672593551,1672596314,2763
3543,3617304541,3899786664,1672537159,1672539811,2652
3732,3270042456,3774790271,1672636225,1672638801,2576
3913,3779656423,3801645328,1672615520,1672616891,1371
3770,3501786419,3607768197,1672540543,1672542727,2184
3598,3347419520,3855583256,1672623313,1672623625,312
3522,3363162590,3205923620,1672617339,1672618632,1293
3875,3515466096,3289817992,1672608410,1672611904,3494
3886,3668747074,3517887477,1672613834,1672613909,75
3520,3780115155,3517697722,1672657270,1672658906,1636
3655,3887243870,3853629553,1672555708,1672558465,2757
3916,3500341755,3370068529,1672629968,1672633208,3240
3795,3505634634,3921648519,1672560406,1672560609,203
3450,3685681577,3552824113,1672607499,1672610079,2580
3755,3380982774,3351866415,1672619294,1672619822,528
3689,3514285803,3792442597,1672674602,1672675823,1221
3636,3970198861,3201629017,1672581101,1672582514,1413
3732,3245232284,3773572967,1672589290,1672590911,1621
3791,3513410578,3757630221,1672588788,1672590496,1708
3484,3399472693,3680810086,1672569655,1672572881,3226
3463,3209481722,3373028638,1672615794,1672618178,2384
3532,3760721303,3411515369,1672669441,1672670075,634
3743,3273981374,3305336154,1672558447,1672559597,1150
3785,3905196766,3306412634,1672615301,1672616502,1201
3444,3736231757,3902760230,1672699879,1672702461,2582
3884,3224811762,3347419520,1672692982,1672696305,3323
3428,3617304541,3714670620,1672569644,1672570443,799
3610,3859868849,3906536154,1672694258,1672695911,1653
3851,3615737355,3703798634,1672557158,1672558529,1371
3637,3303410628,3735374579,1672603873,1672607239,3366
3794,3334974375,3520115090,1672625600,1672627113,1513
3424,3680843171,3925979970,1672625158,1672627463,2305
3509,3517288083,3272096759,1672634279,1672636680,2401
3879,3418448389,3926643445,1672695567,1672695712,145
3750,3757318448,3272096759,1672601070,1672603230,2160
3747,3772236797,3500109249,1672563131,1672566441,3310
3563,3783163143,3316798920,1672577684,1672579666,1982
3652,3624297844,3776084820,1672618013,1672618132,119
3621,3343816795,3512958459,1672580883,1672582843,1960
3891,3793418209,3975717896,1672622547,1672624483,1936
3867,3714670620,3701107228,1672547598,1672550966,3368
3798,3925979970,3505154885,1672674052,1672674245,193
3700,3467779445,3757193307,1672579527,1672580376,849
3621,3928511283,3439673892,1672575830,1672576351,521
3632,3450286949,3421385957,1672633044,1672633763,719
3607,3635169815,3618354185,1672572452,1672573044,592
3507,3714827719,3517687662,1672619588,1672619791,203
3852,3760362417,3731646673,1672540522,1672541603,1081
3823,3519446663,3333403880,1672540546,1672541972,1426
3672,3492546679,3664943873,1672611849,1672612830,981
3658,3783550022,3777147510,1672691469,1672693152,1683
3818,3715443333,3773009828,1672613848,1672617008,3160
3858,3760263530,3772236797,1672537624,1672540752,3128
3661,3884596900,3505634634,1672535427,1672538594,3167
3670,3688490530,3777240360,1672681707,1672682014,307
3694,3716679950,3710854064,1672651992,1672652645,653
3456,3500442734,3338390596,1672532675,1672533836,1161
3566,3829864515,3776988674,1672682923,1672684269,1346
3609,3792546035,3639050419,1672628620,1672629740,1120
3452,3363162590,3513410578,1672689880,1672690879,999
3469,3793175445,3711853996,1672560426,1672562569,2143
3549,3778926763,3834631333,1672636601,1672638063,1462
3853,3792020993,3505521218,1672613727,1672613791,64
3894,3294703680,3514334067,1672558337,1672558685,348
3797,3791613604,3715619259,1672701574,1672701912,338
3542,3970627281,3757294769,1672594853,1672596816,1963
3664,3446533960,3415833929,1672547322,1672547517,195
3555,3394297564,3371455553,1672654205,1672656930,2725
3882,3793868716,3303410628,1672654768,1672657742,2974
3512,3517600136,3519077659,1672693256,1672694024,768
3563,3610358027,3807212280,1672657847,1672658916,1069
3452,3715986185,3299781901,1672686511,1672689216,2705
3538,3972083617,3779854934,1672632559,1672635912,3353
3472,3500208903,3533649454,1672542237,1672544228,1991
3570,3884596900,3501457103,1672573405,1672574686,1281
3750,3385323994,3431460073,1672618851,1672621099,2248
3521,3556969573,3915162005,1672662515,1672665511,2996
3562,3390660440,3777485931,1672668862,1672670299,1437
3696,3609933747,3392836218,1672580234,1672582484,2250
3636,3755404116,3760924079,1672602151,1672605706,3555
3912,3460719322,3757863420,1672542950,1672545052,2102
3503,3756704774,3714670620,1672558859,1672561237,2378
3440,3500347447,3791106564,1672535178,1672536221,1043
3659,3783373154,3773572967,1672681122,1672682473,1351
3431,3357689359,3517288083,1672539885,1672540488,603
3794,3431460073,3780872464,1672540215,1672540542,327
3485,3556969573,3613206049,1672552681,1672555911,3230
3816,3511883730,3777037426,1672700780,1672700883,103
3770,3367111751,3780322355,1672616493,1672617862,1369
3863,3294703680,3773027597,1672676949,1672677331,382
3830,3905899155,3614740489,1672613784,1672614342,558
3800,3921648519,3294703680,1672623939,1672624324,385
3896,3701005527,3224811762,1672660686,1672662386,1700
3911,3310125159,3270042456,1672550374,1672552252,1878
3557,3382733096,3835985172,1672543447,1672546217,2770
3631,3280268483,3779613523,1672541769,1672542934,1165
3661,3310125159,3755737419,1672551086,1672551741,655
3694,3780769110,3660063072,1672582474,1672584377,1903
3543,3779646172,3760651515,1672636231,1672637524,1293
3768,3701136026,3515439826,1672634822,1672636011,1189
3793,3514818819,3621683102,1672657769,1672659663,1894
3691,3791753345,3755496114,1672605743,1672606559,816
3599,3505228454,3732131656,1672569833,1672571647,1814
3496,3793922324,3448875382,1672590595,1672591188,593
3792,3512800570,3760842815,1672679509,1672681131,1622
3761,3417191856,3812369928,1672586590,1672587477,887
3474,3793315718,3792014516,1672653897,1672656343,2446
3921,3500498112,3850911686,1672680769,1672684234,3465
3872,3613899351,3228888030,1672586959,1672590410,3451
3667,3608232640,3373089838,1672621354,1672621638,284
3460,3732131656,3608232640,1672637973,1672638552,579
3637,3774178201,3395201292,1672560906,1672562158,1252
3813,3220031931,3300979975,1672639303,1672642004,2701
3887,3774155692,3791246640,1672583359,1672585887,2528
3747,3774605761,3829822608,1672589959,1672591930,1971
3653,3500347447,3783136330,1672549088,1672552058,2970
3660,3932478321,3780209375,1672575094,1672576245,1151
3682,3783136330,3715854030,1672556714,1672557993,1279
3714,3923754072,3739911441,1672625909,1672627385,1476
3827,3513018485,3897376951,1672631702,1672633112,1410
3489,3777694660,3711637255,1672698780,1672701821,3041
3854,3518561777,3703139663,1672665067,1672667275,2208
3814,3493017654,3778899160,1672671998,1672674946,2948
3426,3780338697,3513345163,1672592587,1672594942,2355
3573,3760263530,3904569677,1672621542,1672624240,2698
3795,3308760650,3515402792,1672621841,1672624040,2199
3599,3615688740,3783373154,1672559148,1672562383,3235
3556,3757630221,3501525100,1672703812,1672705617,1805
3790,3900276517,3510028805,1672666081,1672668539,2458
3675,3513295938,3972083617,1672584400,1672587790,3390
3656,3439673892,3613581796,1672626105,1672629190,3085
3559,3412968120,3777624586,1672587863,1672588888,1025
3617,3760263530,3431502855,1672658081,1672660549,2468
3517,3774718695,3500949309,1672572355,1672573050,695
3699,3280268483,3689697817,1672695666,1672696043,377
3559,3270056120,3512295534,1672595632,1672596810,1178
3646,3232208416,3349856820,1672634997,1672638042,3045
3487,3516298579,3533294425,1672587722,1672588468,746
3788,3351696332,3660887799,1672645157,1672645727,570
3573,3357864626,3417679834,1672594483,1672595719,1236
3878,3505437712,3495911207,1672645195,1672648375,3180
3832,3333403880,3773913680,1672654882,1672657994,3112
3515,3370068529,3481640525,1672676258,1672679454,3196
3522,3209481722,3338083680,1672703721,1672707270,3549
3484,3514275974,3533649454,1672557055,1672558759,1704
3807,3756746867,3225029895,1672555870,1672557834,1964
3561,3791693821,3505725706,1672545697,1672546674,977
3526,3435116799,3293835352,1672687650,1672689074,1424
3689,3780338697,3500498112,1672602741,1672604822,2081
3817,3279339278,3284947372,1672640763,1672643075,2312
3869,3271454397,3777184389,1672693763,1672694644,881
3762,3815392801,3734118023,1672644548,1672644999,451
3740,3972192593,3808136029,1672547418,1672549780,2362
3732,3770468980,3920497528,1672600057,1672601402,1345
3758,3510837901,3791796585,1672557285,1672557678,393
3772,3605221116,3756127300,1672588678,1672589054,376
3434,3714666884,3635169815,1672620573,1672621679,1106
3570,3315279093,3783433404,1672605364,1672606068,704
3874,3246370118,3451726367,1672605692,1672609284,3592
3898,3792072681,3773913680,1672595329,1672598227,2898
3542,3776518452,3703139663,1672533166,1672533407,241
3834,3285204083,3311498666,1672577535,1672578849,1314
3691,3772078494,3756127300,1672560963,1672563452,2489
3741,3435167810,3757075324,1672659163,1672659366,203
3641,3296462324,3519850727,1672571237,1672574574,3337
3709,3669146016,3736231757,1672551167,1672552422,1255
3571,3639050419,3622357348,1672642502,1672642954,452
3456,3730071479,3607882826,1672567336,1672569820,2484
3824,3414940786,3783771827,1672531717,1672532149,432
3747,3511442562,3791441520,1672534731,1672536722,1991
3698,3462158237,3639050419,1672557050,1672557500,450
3894,3689114185,3774243020,1672571208,1672571747,539
3859,3780322355,3778899160,1672599915,1672602624,2709
3445,3793868716,3793740407,1672680443,1672680719,276
3763,3783163143,3613581796,1672541600,1672543288,1688
3742,3834960360,3701107228,1672575771,1672579206,3435
3811,3737147209,3319167958,1672639179,1672639769,590
3858,3500317969,3201800997,1672545183,1672548585,3402
3425,3776117322,3793868716,1672671948,1672674900,2952
3911,3367971170,3811075491,1672665413,1672668221,2808
3777,3408498208,3780322355,1672616649,1672618740,2091
3728,3515402792,3513296868,1672649721,1672653222,3501
3499,3711637255,3311085279,1672606270,1672607435,1165
3621,3685681577,3276003502,1672683067,1672683319,252
3469,3512499658,3971806004,1672585988,1672588593,2605
3913,3505847380,3757630221,1672617192,1672619960,2768
3827,3970909253,3417679834,1672551045,1672553680,2635
3474,3336627643,3461119815,1672556656,1672559650,2994
3657,3414049538,3770438122,1672636255,1672636640,385
3616,3505481368,3622665543,1672638404,1672639310,906
3466,3515402792,3757630221,1672611157,1672613932,2775
3541,3757193551,3710008361,1672553639,1672554382,743
3611,3201800997,3463849738,1672573696,1672575626,1930
3794,3972083617,3711734586,1672535936,1672537893,1957
3812,3505995057,3534566651,1672658551,1672662144,3593
3780,3899786664,3505437712,1672561856,1672565295,3439
3734,3515466096,3513853403,1672696968,1672697486,518
3922,3500341755,3970558632,1672655801,1672656607,806
3731,3559731671,3519077659,1672635243,1672635604,361
3693,3511601997,3685681577,1672574935,1672575796,861
3850,3710496785,3793935736,1672612690,1672614244,1554
3892,3435167810,3757630221,1672674716,1672676138,1422
3629,3926643445,3777091903,1672643460,1672645917,2457
3816,3713300120,3510837901,1672653715,1672655834,2119
3882,3501384020,3682133690,1672552244,1672555255,3011
3653,3714185969,3811040565,1672585170,1672585992,822
3849,3625463628,3372223551,1672630357,1672632528,2171
3629,3500109249,3915162005,1672697476,1672700999,3523
3671,3487875183,3446533960,1672613894,1672615879,1985
3618,3488686442,3505111292,1672615457,1672617085,1628
3472,3624297844,3755737419,1672699621,1672702529,2908
3589,3793418209,3514334067,1672669307,1672672433,3126
3709,3757294769,3755496114,1672638794,1672642132,3338
3454,3510642075,3734118023,1672607394,1672609486,2092
3451,3780712350,3927599181,1672580284,1672582113,1829
3436,3780338697,3923754072,1672594386,1672596970,2584
3838,3285204083,3517991730,1672627198,1672628046,848
3788,3380130228,3710008361,1672603565,1672605939,2374
3709,3514818819,3638204468,1672578062,1672581656,3594
3494,3900945856,3773837847,1672559137,1672559305,168
3884,3514246749,3316798920,1672649425,1672650090,665
3836,3236354255,3440137407,1672607369,1672609475,2106
3474,3408498208,3736231757,1672556959,1672559052,2093
3480,3618697021,3305722859,1672622495,1672625503,3008
3852,3935913584,3739661856,1672617819,1672619634,1815
3692,3711853996,3935399379,1672683900,1672684702,802
3528,3620292035,3793883863,1672613453,1672615681,2228
3445,3343816795,3505266860,1672631927,1672632236,309
3457,3517462308,3357689359,1672620673,1672623850,3177
3546,3685681577,3500777439,1672608555,1672609505,950
3539,3412968120,3319167958,1672561515,1672564052,2537
3898,3780472203,3334647380,1672624620,1672627414,2794
3510,3351866415,3500072204,1672674333,1672676374,2041
3473,3713768950,3510818674,1672634442,1672635340,898
3676,3270056120,3517881647,1672585765,1672586389,624
3831,3276269264,3366423342,1672558268,1672558907,639
3908,3623266256,3510767239,1672669197,1672672644,3447
3778,3610358027,3272716462,1672663864,1672666228,2364
3913,3514334067,3512383699,1672598628,1672601510,2882
3449,3613899351,3288224595,1672601186,1672604630,3444
3501,3293835352,3304971369,1672668031,1672668601,570
3443,3520181148,3808136029,1672541179,1672543948,2769
3814,3713163045,3373089838,1672596709,1672598032,1323
3703,3834963772,3349856820,1672687088,1672687679,591
3729,3778040015,3399472693,1672578622,1672578878,256
3488,3902760230,3815250107,1672686481,1672688322,1841
3445,3485540729,3421877923,1672569647,1672570149,502
3906,3774733620,3777814504,1672654757,1672657503,2746
3535,3772391882,3500841914,1672557954,1672558580,626
3804,3818575661,3777147510,1672578450,1672580767,2317
3472,3760263530,3240394404,1672649706,1672650581,875
3799,3713517039,3623266256,1672627688,1672629959,2271
3717,3772236797,3774641380,1672644449,1672647541,3092
3505,3514324011,3756474459,1672587869,1672590857,2988
3560,3923220461,3713941638,1672674923,1672676685,1762
3816,3760924079,3514741348,1672566944,1672568890,1946
3662,3614740489,3513018485,1672648526,1672648696,170
3572,3363162590,3783136330,1672630555,1672630857,302
3698,3777694660,3793883863,1672665635,1672667973,2338
3627,3780872464,3511843593,1672566873,1672567679,806
3473,3772236797,3609113156,1672615435,1672617422,1987
3791,3688490530,3551376095,1672660746,1672662962,2216
3833,3972192593,3517172354,1672603808,1672604574,766
3661,3774733620,3354144091,1672533598,1672534105,507
3674,3431502855,3338083680,1672597067,1672597614,547
3538,3500442734,3770520359,1672597436,1672600730,3294
3469,3927599181,3777330107,1672570093,1672572580,2487
3610,3241790910,3232208416,1672625665,1672626736,1071
3650,3534357694,3360616538,1672681686,1672685153,3467
3424,3289114629,3900898992,1672531991,1672533192,1201
3696,3360069849,3792949946,1672626100,1672628537,2437
3713,3512337405,3604589802,1672574541,1672574930,389
3866,3932478321,3206837348,1672634885,1672636722,1837
3631,3283492940,3730071479,1672627329,1672629265,1936
3633,3374183227,3512392431,1672536355,1672537770,1415
3732,3792745809,3625174002,1672555647,1672556819,1172
3797,3500857494,3501786419,1672671031,1672673934,2903
3744,3300979975,3279242917,1672615602,1672615691,89
3499,3778926763,3300229945,1672542397,1672544715,2318
3544,3885121158,3760640999,1672588367,1672591603,3236
3897,3500777439,3271752081,1672572282,1672573014,732
3686,3279475486,3714128600,1672625360,1672626458,1098
3449,3716679950,3770146716,1672533914,1672537505,3591
3814,3354144091,3470454332,1672694443,1672697345,2902
3499,3711000597,3713517039,1672618584,1672621924,3340
3748,3294747828,3468041839,1672556078,1672557474,1396
3579,3621683102,3777779869,1672604995,1672606677,1682
3529,3310125159,3510187271,1672609108,1672610459,1351
3459,3703396825,3533747868,1672557319,1672560492,3173
3553,3202804048,3970603231,1672566779,1672568913,2134
3569,3770520359,3793868716,1672675121,1672678403,3282
3745,3554186380,3349739136,1672539125,1672541919,2794
3501,3421877923,3512958459,1672638137,1672640237,2100
3675,3912891315,3609933747,1672597027,1672600457,3430
3518,3505807416,3505807416,1672666093,1672668229,2136
3894,3756385685,3500109249,1672627407,1672627529,122
3788,3315279093,3438078818,1672596567,1672597601,1034
3555,3713561276,3271752081,1672677757,1672679236,1479
3820,3757294769,3793418209,1672632270,1672632565,295
3737,3783340788,3779656423,1672648294,1672650242,1948
3498,3512337405,3777485931,1672573966,1672574129,163
3740,3715443333,3311085279,1672674590,1672676800,2210
3880,3393063657,3414049538,1672640999,1672642210,1211
3854,3618489670,3334974375,1672609912,1672610826,914
3894,3777184389,3334647380,1672640038,1672641067,1029
3751,3834960360,3609113156,1672547051,1672548195,1144
3787,3895285664,3236354255,1672644907,1672647289,2382
3812,3779892400,3412968120,1672580665,1672581270,605
3618,3824641227,3519142371,1672570237,1672572870,2633
3437,3480100311,3330340793,1672645368,1672645674,306
3764,3505995057,3392836218,1672570781,1672574188,3407
3567,3236354255,3792949946,1672699571,1672700416,845
3770,3904867554,3500341755,1672660884,1672661997,1113
3613,3440137407,3770704999,1672606354,1672609444,3090
3781,3490029863,3347419520,1672545856,1672547593,1737
3728,3777330107,3350095157,1672546186,1672549602,3416
3451,3713163045,3505179890,1672672602,1672674744,2142
3872,3755737419,3853629553,1672688302,1672688498,196
3747,3791693821,3505923418,1672550820,1672551884,1064
3654,3615688740,3520181148,1672677295,1672678085,790
3552,3505521218,3470454332,1672532430,1672534084,1654
3524,3821054646,3510642075,1672583267,1672584096,829
3688,3974674109,3897456874,1672603857,1672607337,3480
3893,3226024417,3516298579,1672536949,1672537498,549
3546,3517222913,3975717896,1672560412,1672561561,1149
3428,3927599181,3520355798,1672651792,1672654433,2641
3679,3738026330,3684523966,1672666670,1672667980,1310
3898,3618354185,3780253901,1672581684,1672583471,1787
3509,3202141727,3713911104,1672682333,1672684262,1929
3818,3284932450,3505995057,1672576319,1672578305,1986
3907,3710562338,3517462308,1672669234,1672670476,1242
3792,3414275042,3500613493,1672672678,1672673722,1044
3758,3710496785,3783550022,1672690286,1672692665,2379
3911,3505437712,3551389192,1672700382,1672701036,654
3713,3533004959,3757193307,1672656226,1672656409,183
3847,3513081354,3517881647,1672692799,1672695045,2246
3711,3490029863,3517991730,1672567448,1672569122,1674
3683,3777330107,3517222913,1672635516,1672638822,3306
3707,3760263530,3429943738,1672680208,1672682126,1918
3691,3770520359,3715443333,1672644304,1672646468,2164
3628,3614740489,3334993594,1672577806,1672579148,1342
3631,3701247948,3228888030,1672632931,1672636387,3456
3454,3533090502,3306175858,1672687186,1672688622,1436
3618,3520639768,3513345163,1672700723,1672700844,121
3486,3923754072,3669146016,1672643065,1672646153,3088
3880,3367971170,3780115155,1672611046,1672614076,3030
3704,3710048469,3711000597,1672658965,1672661603,2638
3463,3914691363,3683113954,1672643399,1672643570,171
3887,3520322124,3424660806,1672662850,1672664104,1254
3664,3229822507,3517881647,1672619817,1672620427,610
3856,3622665543,3714827719,1672692482,1672693593,1111
3583,3791246640,3780115155,1672675788,1672677046,1258
3524,3369708250,3516444201,1672565203,1672566227,1024
3517,3739911441,3779854934,1672537776,1672539592,1816
3666,3519416013,3513296868,1672659580,1672661057,1477
3540,3970909253,3511150845,1672560281,1672561163,882
3699,3773837847,3300229945,1672648699,1672650564,1865
3519,3713691388,3310125159,1672620458,1672620670,212
3623,3825881598,3770676872,1672605070,1672606571,1501
3817,3760924079,3714827719,1672633479,1672636499,3020
3532,3289114629,3930242012,1672612036,1672614439,2403
3489,3462158237,3500604680,1672539721,1672542483,2762
3614,3401793306,3517697722,1672661869,1672664564,2695
3602,3448875382,3435167810,1672697298,1672697853,555
3858,3399518841,3685816610,1672552669,1672555107,2438
3479,3497095254,3437286517,1672650960,1672651987,1027
3729,3305722859,3792949946,1672557542,1672559649,2107
3920,3491684096,3347419520,1672532138,1672533046,908
3793,3517222913,3703396825,1672622680,1672624184,1504
3589,3713691388,3554944414,1672568448,1672568700,252
3495,3688796737,3613899351,1672541659,1672542194,535
3793,3534357694,3688220326,1672653325,1672656720,3395
3716,3935487534,3485540729,1672576442,1672578508,2066
3579,3756789525,3480726047,1672575135,1672576872,1737
3624,3511843593,3450969839,1672582534,1672585330,2796
3853,3505198734,3613338363,1672628588,1672628782,194
3654,3715400486,3394401087,1672574997,1672577371,2374
3604,3905899155,3497671225,1672631751,1672632615,864
3858,3823084403,3511601997,1672679447,1672681189,1742
3827,3205985903,3972192593,1672682000,1672683587,1587
3696,3438078818,3933894942,1672566259,1672567147,888
3646,3516903528,3520639768,1672678416,1672679511,1095
3889,3776244398,3519077659,1672702864,1672706223,3359
3595,3927165965,3852533643,1672598671,1672600564,1893
3890,3714827719,3514703118,1672650370,1672652067,1697
3838,3713517039,3773913680,1672538806,1672540586,1780
3482,3817813340,3770296583,1672567731,1672571221,3490
3680,3904867554,3363162590,1672665624,1672666491,867
3724,3778134418,3621790707,1672667491,1672670224,2733
3618,3755222916,3400069268,1672535353,1672537789,2436
3846,3713829743,3776084820,1672687473,1672690520,3047
3798,3633735593,3512392431,1672677836,1672680939,3103
3651,3780253901,3711077927,1672622987,1672623148,161
3918,3505521218,3271752081,1672550121,1672552771,2650
3789,3817813340,3517881647,1672604791,1672605886,1095
3670,3773124276,3733363628,1672562356,1672565022,2666
3620,3897376951,3511288998,1672565832,1672569066,3234
3531,3974674109,3774733620,1672698454,1672698904,450
3628,3689697817,3622665543,1672677835,1672680216,2381
3883,3776988674,3770296583,1672620998,1672622074,1076
3865,3487875183,3373089838,1672629875,1672631978,2103
3486,3853629553,3660887799,1672539628,1672540315,687
3541,3909094917,3778899160,1672585169,1672586336,1167
3587,3517991730,3402697190,1672644009,1672645639,1630
3470,3500737582,3206837348,1672680241,1672682525,2284
3582,3500915665,3814677862,1672551768,1672552876,1108
3916,3303410628,3497808662,1672585561,1672587794,2233
3646,3229974066,3500302272,1672616964,1672620378,3414
3471,3505521218,3792538417,1672649956,1672652598,2642
3556,3625463628,3533228966,1672670364,1672672874,2510
3530,3370227921,3516298579,1672631601,1672632483,882
3493,3279339278,3774733620,1672560479,1672562284,1805
3628,3203538212,3739895284,1672675566,1672677874,2308
3573,3793315718,3248058676,1672535087,1672535511,424
3847,3661903000,3793743698,1672605187,1672605562,375
3709,3682133690,3715400486,1672666039,1672668524,2485
3494,3513360004,3935487534,1672579017,1672579632,615
3876,3772236797,3853629553,1672587757,1672591291,3534
3757,3703396825,3516703758,1672685464,1672687712,2248
3548,3713784974,3638660068,1672583741,1672586586,2845
3804,3609933747,3755915206,1672668319,1672668770,451
3710,3557046880,3783163143,1672672167,1672674446,2279
3714,3375449013,3904867554,1672645935,1672647001,1066
3526,3757193307,3620292035,1672562221,1672563580,1359
3533,3437286517,3393063657,1672572308,1672573171,863
3813,3757193307,3394401087,1672703958,1672704087,129
3648,3533929349,3308760650,1672580929,1672581172,243
3723,3387594369,3772391882,1672588049,1672590157,2108
3618,3777240360,3618697021,1672646249,1672649402,3153
3907,3520639768,3780253901,1672568259,1672569199,940
3546,3501567772,3625174002,1672635005,1672637987,2982
3919,3289817992,3505847380,1672633986,1672634736,750
3789,3225636215,3424445495,1672552174,1672552340,166
3899,3618489670,3783169442,1672561962,1672564905,2943
3555,3414275042,3424660806,1672615231,1672615464,233
3911,3923220461,3232208416,1672621363,1672622152,789
3592,3780769110,3618808151,1672625170,1672628428,3258
3833,3668533536,3505111292,1672611987,1672614719,2732
3917,3515525630,3779854934,1672691370,1672692021,651
3489,3436025562,3621184108,1672690429,1672690619,190
3860,3514818819,3514334067,1672575039,1672576139,1100
3679,3310125159,3757700712,1672558435,1672561535,3100
3656,3791106564,3612689556,1672595561,1672599149,3588
3434,3304155815,3512830734,1672678502,1672680048,1546
3531,3783550022,3559731671,1672679614,1672680310,696
3435,3457620713,3777779869,1672597426,1672597525,99
3558,3770520359,3300229945,1672587025,1672588433,1408
3769,3755573472,3703348097,1672668163,1672670722,2559
3815,3773913680,3734451191,1672561905,1672562917,1012
3555,3376467719,3505847380,1672558772,1672559732,960
3553,3296462324,3760645796,1672576292,1672579027,2735
3533,3613416045,3557046880,1672632085,1672632958,873
3753,3615939504,3714666884,1672635160,1672635616,456
3603,3299781901,3783919913,1672563055,1672563290,235
3594,3791436104,3736705719,1672657848,1672659607,1759
3665,3308760650,3245232284,1672540035,1672541111,1076
3837,3792525861,3510642075,1672549908,1672551466,1558
3550,3777091903,3638204468,1672553224,1672556176,2952
3491,3341893384,3516321888,1672670753,1672672246,1493
3586,3713829743,3370227921,1672643177,1672643795,618
3685,3619922891,3977148669,1672549127,1672551765,2638
3683,3533274994,3850911686,1672592770,1672594567,1797
3588,3791693821,3501459390,1672545673,1672547442,1769
3903,3791106564,3713561276,1672607496,1672609546,2050
3857,3520991398,3411515369,1672554413,1672556659,2246
3603,3271454397,3713561276,1672611361,1672611788,427
3489,3334647380,3778899160,1672595732,1672596787,1055
3665,3625463628,3533004959,1672638500,1672639542,1042
3681,3756704774,3518653080,1672683352,1672686386,3034
3830,3850911686,3514818819,1672640065,1672642069,2004
3458,3389634034,3791796585,1672622993,1672624442,1449
3848,3757700712,3418448389,1672657829,1672658451,622
3721,3551376095,3490029863,1672537153,1672540040,2887
3866,3831586487,3276348699,1672656414,1672659615,3201
3873,3518653080,3703798634,1672568452,1672571800,3348
3749,3291933594,3935487534,1672615807,1672617334,1527
3523,3505402439,3554825448,1672613822,1672616904,3082
3704,3509893027,3279475486,1672543982,1672546841,2859
3880,3519651506,3615939504,1672639135,1672641500,2365
3464,3612689556,3774907131,1672684923,1672686276,1353
3764,3510818674,3448875382,1672589643,1672592089,2446
3652,3714670620,3632814465,1672651038,1672652099,1061
3849,3757193551,3756474459,1672644010,1672647080,3070
3813,3791106564,3205985903,1672620691,1672621632,941
3596,3349856820,3424445495,1672662075,1672664184,2109
3698,3610870949,3701664364,1672685888,1672686094,206
3589,3605221116,3201629017,1672584624,1672587724,3100
3560,3774290799,3276217799,1672591656,1672592048,392
3553,3613581796,3367971170,1672574542,1672575874,1332
3654,3512295534,3819767045,1672661577,1672663780,2203
3723,3520991398,3514285803,1672568018,1672571418,3400
3618,3889780657,3780872464,1672550273,1672552328,2055
3686,3793922324,3755344363,1672614773,1672617982,3209
3666,3501215099,3366423342,1672600120,1672601156,1036
3486,3351866415,3757348722,1672541034,1672543366,2332
3825,3618697021,3885121158,1672701965,1672705378,3413
3620,3920497528,3236458894,1672676142,1672677990,1848
3643,3443357683,3241790910,1672609865,1672610791,926
3441,3777330107,3680843171,1672623055,1672624066,1011
3564,3511883730,3334974375,1672661806,1672663337,1531
3529,3689697817,3737112297,1672544021,1672545210,1189
3474,3914691363,3713941638,1672639760,1672640311,551
3791,3534764451,3534175249,1672656033,1672657131,1098
3443,3349739136,3450969839,1672637016,1672640234,3218
3525,3436025562,3852686295,1672596838,1672599340,2502
3618,3979784676,3385323994,1672659987,1672660788,801
3804,3793407963,3779613523,1672647374,1672647876,502
3501,3294703680,3760640999,1672611985,1672614590,2605
3742,3456430614,3711000597,1672569794,1672570265,471
3527,3274906650,3711919537,1672610228,1672612953,2725
3828,3885155975,3310125159,1672626622,1672630143,3521
3533,3638660068,3552824113,1672647959,1672648187,228
3439,3858172636,3701247948,1672581209,1672582664,1455
3503,3510641433,3520657891,1672580342,1672582632,2290
3527,3303410628,3510919821,1672614275,1672616189,1914
3490,3520991398,3791106564,1672640322,1672640977,655
3758,3510499038,3514334067,1672583047,1672583142,95
3727,3931627862,3734118023,1672608859,1672610468,1609
3621,3288762795,3737147209,1672643031,1672644050,1019
3494,3793740407,3776034743,1672646204,1672649752,3548
3680,3396726504,3280054198,1672610974,1672614367,3393
3646,3368283077,3438489358,1672550877,1672553034,2157
3549,3334647380,3774243020,1672594375,1672594537,162
3598,3516298579,3760364383,1672652382,1672653886,1504
3691,3272096759,3533274994,1672608902,1672610198,1296
3652,3757700712,3920898925,1672701281,1672704385,3104
3652,3774790271,3449333754,1672585979,1672589112,3133
3892,3294703680,3792442597,1672574044,1672575049,1005
3547,3414940786,3880926355,1672577967,1672579356,1389
3726,3777814504,3534764451,1672612912,1672616051,3139
3816,3783550022,3513295938,1672620934,1672622502,1568
3469,3711218296,3783550022,1672584137,1672584546,409
3432,3617116290,3509483172,1672599999,1672601616,1617
3566,3551376095,3480991549,1672654869,1672655987,1118
3827,3516703758,3414049538,1672623543,1672626616,3073
3858,3360069849,3403370192,1672561710,1672562264,554
3685,3898314440,3460719322,1672619214,1672619379,165
3486,3379143440,3668533536,1672682403,1672685283,2880
3497,3448875382,3780872464,1672606325,1672608509,2184
3446,3774705415,3733363628,1672571079,1672573696,2617
3538,3780834916,3792274796,1672702216,1672703197,981
3693,3833217041,3514419100,1672553440,1672554086,646
3853,3309314379,3701136026,1672660547,1672661083,536
3590,3701884158,3793969543,1672676286,1672679842,3556
3503,3897376951,3435116799,1672698155,1672698830,675
3793,3410538749,3823084403,1672663875,1672665882,2007
3781,3803517637,3885157459,1672619353,1672620859,1506
3854,3396726504,3505179890,1672543570,1672546519,2949
3425,3511024016,3400069268,1672621133,1672624727,3594
3581,3770146716,3316800320,1672534209,1672534360,151
3548,3906536154,3757383891,1672672835,1672675259,2424
3579,3716679950,3821054646,1672604681,1672606683,2002
3834,3299125059,3733558985,1672600055,1672602204,2149
3511,3807212280,3520355798,1672619942,1672622897,2955
3687,3510837901,3384583385,1672564361,1672567165,2804
3429,3920625129,3272030610,1672639574,1672642246,2672
3537,3607768197,3224968597,1672585202,1672587160,1958
3497,3517697722,3533649454,1672564839,1672568259,3420
3796,3780909839,3609113156,1672631959,1672632364,405
3763,3760651515,3609659642,1672687543,1672687931,388
3665,3518561777,3500317969,1672662657,1672664551,1894
3590,3905196766,3533649454,1672586192,1672589707,3515
3557,3776084820,3793407963,1672645248,1672646162,914
3490,3770676872,3451691949,1672538865,1672539002,137
3851,3972083617,3713911104,1672583534,1672586566,3032
3516,3516703758,3770236215,1672668853,1672670281,1428
3801,3897435944,3398731252,1672703852,1672706517,2665
3900,3660063072,3505521218,1672685327,1672686009,682
3717,3710496785,3411515369,1672559814,1672562342,2528
3674,3608855425,3273981374,1672594506,1672594778,272
3642,3402697190,3513853403,1672599242,1672601229,1987
3807,3783520186,3780338697,1672674171,1672677576,3405
3458,3501384020,3923420131,1672570500,1672573062,2562
3704,3774790271,3793935736,1672600074,1672602778,2704
3550,3279475486,3510767239,1672561810,1672564443,2633
3703,3905899155,3515525630,1672550446,1672551437,991
3711,3229822507,3241914067,1672687530,1672689918,2388
3444,3970909253,3497095254,1672605294,1672606766,1472
3648,3480726047,3461119815,1672547759,1672550429,2670
3851,3512946768,3793922324,1672596638,1672600046,3408
3467,3850911686,3779786641,1672699919,1672701236,1317
3770,3517697722,3904569677,1672685911,1672688662,2751
3774,3238288884,3783433404,1672586396,1672588095,1699
3694,3703348097,3534175249,1672619421,1672622396,2975
3704,3519818818,3449639012,1672579438,1672582592,3154
3473,3668747074,3779854934,1672631778,1672632932,1154
3819,3505663516,3625174002,1672558482,1672560247,1765
3774,3399518841,3330340793,1672616648,1672619629,2981
3462,3421877923,3357864626,1672534437,1672537935,3498
3453,3898314440,3756789525,1672623177,1672625763,2586
3665,3836241528,3715619259,1672639137,1672642506,3369
3742,3703798634,3792801638,1672638832,1672639737,905
3501,3757193551,3533423872,1672564388,1672564995,607
3459,3500341755,3272030610,1672652234,1672655348,3114
3799,3970603231,3668414677,1672653264,1672654660,1396
3921,3440107959,3518561777,1672531791,1672534844,3053
3805,3335694356,3834963772,1672700963,1672704167,3204
3786,3757193307,3703433819,1672532610,1672533205,595
3600,3510187271,3505402439,1672619618,1672621595,1977
3517,3512830734,3519077659,1672640435,1672641655,1220
3611,3510919821,3515439826,1672537563,1672539224,1661
3777,3613338363,3408430195,1672600489,1672602460,1971
3654,3497095254,3500857494,1672575265,1672576420,1155
3654,3818575661,3304155815,1672703198,1672705346,2148
3841,3514419100,3916490839,1672653318,1672653407,89
3905,3900276517,3520560590,1672694282,1672696909,2627
3624,3451726367,3382733096,1672578174,1672578504,330
3723,3661903000,3248058676,1672539625,1672540955,1330
3447,3208452238,3309314379,1672548789,1672551832,3043
3456,3446533960,3410160376,1672561482,1672563001,1519
3603,3680843171,3757075324,1672655332,1672655429,97
3436,3519087371,3236458894,1672542043,1672543810,1767
3802,3513360004,3783771827,1672697044,1672698254,1210
3568,3938389661,3481640525,1672694640,1672697126,2486
3695,3206837348,3510818674,1672642591,1672645863,3272
3818,3515439826,3270697740,1672607925,1672610642,2717
3573,3792525861,3619922891,1672702196,1672704616,2420
3574,3802932312,3713829743,1672650014,1672650462,448
3902,3780338697,3755404116,1672579468,1672581452,1984
3601,3773124276,3668533536,1672585146,1672586865,1719
3907,3289817992,3311085279,1672584058,1672585790,1732
3515,3755230952,3783163143,1672648642,1672651059,2417
3597,3517737088,3893912331,1672612512,1672614091,1579
3555,3517887477,3792442597,1672641817,1672644800,2983
3903,3500498112,3514419100,1672653067,1672653135,68
3510,3229822507,3446533960,1672618317,1672620193,1876
3762,3520560590,3520873221,1672694388,1672696857,2469
3817,3667427125,3534357694,1672595205,1672596552,1347
3658,3511843593,3858172636,1672542101,1672542279,178
3530,3236354255,3534764451,1672669547,1672669674,127
3759,3608855425,3334974375,1672671386,1672672481,1095
3503,3505995057,3792546035,1672647586,1672648309,723
3778,3793969543,3661903000,1672575317,1672576544,1227
3860,3905899155,3626499450,1672682911,1672685656,2745
3619,3920497528,3710735406,1672580098,1672582352,2254
3450,3534543776,3501384020,1672591521,1672591835,314
3777,3288762795,3714067076,1672588129,1672589755,1626
3671,3467779445,3714120857,1672700711,1672704005,3294
3809,3367509761,3791046864,1672590649,1672592329,1680
3573,3757318448,3497671225,1672671074,1672674298,3224
3768,3227799827,3513410578,1672587466,1672588180,714
3917,3760924079,3770236215,1672649731,1672650629,898
3908,3403370192,3684523966,1672562498,1672565652,3154
3795,3511732493,3776518452,1672680290,1672680360,70
3783,3517881647,3514703118,1672580436,1672583657,3221
3507,3513081354,3716110860,1672683375,1672683569,194
3821,3315703693,3660063072,1672549981,1672552698,2717
3427,3400763927,3636329663,1672597231,1672599543,2312
3875,3714185969,3360813161,1672663698,1672665352,1654
3652,3776988674,3225029895,1672702241,1672704333,2092
3852,3755222916,3667427125,1672621906,1672623712,1806
3866,3236499444,3534543776,1672569470,1672572304,2834
3474,3517172354,3505888598,1672674086,1672677292,3206
3559,3627368399,3772236797,1672700166,1672701768,1602
3444,3661903000,3289817992,1672639678,1672640566,888
3640,3276269264,3428027649,1672551480,1672553789,2309
3553,3517222913,3899326793,1672640025,1672641627,1602
3772,3450969839,3812369928,1672547983,1672548670,687
3623,3505481368,3773939399,1672618617,1672622100,3483
3665,3664943873,3777779869,1672600717,1672602904,2187
3755,3792442597,3778134418,1672677870,1672680522,2652
3774,3400763927,3519909393,1672537081,1672537423,342
3807,3200543880,3451691949,1672675879,1672678067,2188
3709,3615939504,3880926355,1672622189,1672625338,3149
3630,3760364383,3451326054,1672548502,1672551937,3435
3909,3895285664,3509483172,1672605556,1672606737,1181
3619,3316798920,3276003502,1672699978,1672702244,2266
3921,3850911686,3519818818,1672639498,1672640672,1174
3582,3370227921,3511442562,1672541648,1672544246,2598
3665,3272716462,3710735406,1672700995,1672704361,3366
3434,3445206685,3370227921,1672623710,1672627197,3487
3523,3225029895,3701322924,1672600822,1672601407,585
3804,3395201292,3927165965,1672613263,1672614127,864
3425,3520991398,3394297564,1672550177,1672552167,1990
3692,3773735484,3512722110,1672591819,1672593605,1786
3653,3449639012,3734118023,1672663719,1672663790,71
3513,3792538417,3777037426,1672689713,1672693052,3339
3614,3783615982,3713829743,1672651595,1672653327,1732
3672,3891672228,3534179433,1672636104,1672638476,2372
3888,3772078494,3501215099,1672646984,1672649301,2317
3751,3519028898,3685681577,1672560638,1672561793,1155
3456,3777147510,3399472693,1672655713,1672655896,183
3581,3354144091,3500672156,1672665427,1672665800,373
3638,3520322124,3308760650,1672637931,1672639221,1290
3908,3284932450,3755737419,1672591149,1672593125,1976
3708,3230135532,3517590837,1672623501,1672623962,461
3682,3240394404,3511005395,1672593589,1672596041,2452
3528,3770468980,3755065949,1672639662,1672642134,2472
3792,3701247948,3757863420,1672574738,1672576977,2239
3569,3311085279,3472068734,1672667494,1672669193,1699
3731,3977148669,3660063072,1672639028,1672640955,1927
3576,3241790910,3451726367,1672664210,1672665464,1254
3481,3733363628,3534175249,1672609858,1672613149,3291
3615,3421877923,3512282789,1672562193,1672562975,782
3764,3701107228,3731646673,1672622198,1672622561,363
3483,3205985903,3773837847,1672603062,1672604909,1847
3531,3315279093,3439673892,1672645722,1672648390,2668
3663,3448875382,3714128600,1672575612,1672578396,2784
3736,3713300120,3369708250,1672675680,1672676123,443
3625,3927403123,3380767040,1672611386,1672613867,2481
3702,3305336154,3931627862,1672605845,1672605978,133
3627,3880926355,3511791953,1672681179,1672682247,1068
3557,3617304541,3225636215,1672558927,1672561793,2866
3913,3510554314,3682133690,1672558425,1672559853,1428
3518,3518194482,3400069268,1672628175,1672628763,588
3474,3470454332,3505154885,1672579409,1672581322,1913
3610,3409114719,3774178201,1672563544,1672565125,1581
3581,3921648519,3392943173,1672564770,1672568131,3361
3573,3811040565,3780427126,1672662090,1672663946,1856
3740,3400763927,3631479562,1672564589,1672566625,2036
3580,3514285803,3274906650,1672599956,1672602773,2817
3709,3757863420,3756474459,1672546464,1672548344,1880
3741,3382733096,3715707380,1672610191,1672612065,1874
3463,3512282789,3520657891,1672617329,1672617876,547
3697,3858172636,3513081354,1672533346,1672534485,1139
3424,3688796737,3801645328,1672558558,1672560734,2176
3501,3934064792,3357864626,1672573081,1672574158,1077
3544,3638204468,3520639768,1672583924,1672584877,953
3536,3512502036,3312998540,1672594088,1672595934,1846
3909,3514971533,3626499450,1672538474,1672540688,2214
3448,3713300120,3271454397,1672586303,1672589170,2867
3657,3770676872,3703383853,1672629324,1672631885,2561
3671,3713829743,3236458894,1672687866,1672690784,2918
3821,3909094917,3777694660,1672539914,1672540131,217
3889,3683113954,3514512367,1672687339,1672689856,2517
3638,3276269264,3779786641,1672664932,1672666793,1861
3443,3533079336,3347446226,1672552377,1672555481,3104
3786,3513018485,3512499658,1672652135,1672654885,2750
3535,3772078494,3510028805,1672544632,1672547245,2613
3686,3618176292,3780571086,1672622573,1672625397,2824
3629,3776117322,3755233658,1672664793,1672666375,1582
3574,3389634034,3276003502,1672618002,1672618322,320
3478,3300818269,3783550022,1672672382,1672675157,2775
3632,3462158237,3500442734,1672627581,1672629344,1763
3919,3689697817,3408498208,1672646335,1672648778,2443
3697,3755532873,3783163143,1672565855,1672566142,287
3512,3669146016,3715619259,1672638651,1672641735,3084
3669,3225636215,3791128487,1672640078,1672640358,280
3600,3776518452,3701884158,1672533865,1672536646,2781
3918,3760645796,3773009828,1672664970,1672667631,2661
3660,3701424609,3773332082,1672577539,1672579861,2322
3896,3501567772,3467779445,1672553572,1672555370,1798
3869,3612689556,3818575661,1672651617,1672654779,3162
3681,3404025196,3834631333,1672645759,1672646612,853
3548,3380767040,3336339664,1672589673,1672589946,273
3689,3517462308,3915162005,1672619403,1672620298,895
3588,3300818269,3779425804,1672564007,1672566869,2862
3885,3479851674,3774718695,1672589781,1672591130,1349
3488,3400763927,3520560590,1672592623,1672596206,3583
3898,3272096759,3206837348,1672558946,1672559942,996
3918,3360069849,3310125159,1672622046,1672622622,576
3626,3779892400,3824215187,1672599814,1672603361,3547
3607,3668414677,3792014516,1672659102,1672660788,1686
3668,3755573472,3518561777,1672647361,1672648731,1370
3704,3760694096,3450286949,1672545872,1672549377,3505
3594,3501121099,3773735484,1672583186,1672586762,3576
3841,3517600136,3774243020,1672537026,1672539900,2874
3657,3517697722,3270042456,1672672287,1672672600,313
3549,3904867554,3715385401,1672599099,1672600686,1587
3704,3776559988,3512800570,1672648255,1672649521,1266
3819,3701882224,3520560590,1672580908,1672583747,2839
3682,3357289672,3793583656,1672570432,1672572471,2039
3830,3509483172,3780427126,1672604429,1672605291,862
3613,3772236797,3438489358,1672638242,1672640752,2510
3454,3283144118,3933894942,1672595553,1672597874,2321
3890,3512337405,3779639983,1672552648,1672554043,1395
3656,3760094385,3518565331,1672650016,1672651740,1724
3717,3517697722,3715707380,1672608730,1672610829,2099
3550,3449333754,3839245934,1672639559,1672642020,2461
3674,3480726047,3209526819,1672605113,1672607651,2538
3860,3756704774,3516298579,1672652828,1672654287,1459
3761,3201800997,3513065217,1672637151,1672637296,145
3493,3357689359,3623266256,1672696412,1672697101,689
3841,3778640261,3714678331,1672634492,1672635187,695
3614,3472068734,3488686442,1672626615,1672628217,1602
3806,3853629553,3793781065,1672620047,1672622937,2890
3727,3834960360,3276003502,1672620629,1672621101,472
3754,3791246640,3979802715,1672590239,1672593708,3469
3917,3920898925,3605221116,1672688281,1672690331,2050
3644,3500777439,3777240360,1672549783,1672552913,3130
3729,3899326793,3927599181,1672656853,1672660340,3487
3715,3757294769,3779532653,1672609079,1672611039,1960
3660,3715545685,3515401243,1672600928,1672602612,1684
3602,3887243870,3488686442,1672637714,1672638256,542
3912,3791436104,3514285803,1672605218,1672608799,3581
3587,3815250107,3485540729,1672668103,1672669788,1685
3579,3791693821,3279242917,1672563733,1672565279,1546
3910,3368283077,3401940259,1672698657,1672701786,3129
3530,3392836218,3272716462,1672534519,1672537766,3247
3696,3852533643,3514308235,1672673558,1672675664,2106
3635,3357289672,3660063072,1672655757,1672658072,2315
3819,3701136026,3463849738,1672693021,1672695215,2194
3765,3238288884,3379143440,1672621964,1672625418,3454
3670,3514956366,3392943173,1672684057,1672687428,3371
3695,3335694356,3394401087,1672623238,1672625993,2755
3424,3792538417,3435167810,1672660336,1672662083,1747
3853,3248058676,3664943873,1672645611,1672646341,730
3497,3773902805,3715400486,1672641920,1672645227,3307
3865,3417191856,3514324011,1672606950,1672608844,1894
3551,3686227677,3630353876,1672686543,1672686727,184
3914,3226511603,3232208416,1672681576,1672684802,3226
3458,3777624586,3533079336,1672671105,1672672628,1523
3490,3783615982,3556969573,1672549846,1672552163,2317
3888,3773033649,3897376951,1672559684,1672559779,95
3668,3774605761,3852533643,1672532093,1672533387,1294
3771,3515402792,3510642075,1672628161,1672629284,1123
3589,3511601997,3660887799,1672621362,1672624822,3460
3818,3760694096,3885157459,1672571010,1672573220,2210
3660,3510642075,3412006598,1672560227,1672563488,3261
3895,3517887477,3513345163,1672642880,1672644768,1888
3790,3417191856,3351696332,1672555357,1672556166,809
3903,3755233658,3401496246,1672689411,1672691814,2403
3811,3755222916,3360069849,1672567520,1672568702,1182
3528,3711077927,3624297844,1672543142,1672545620,2478
3463,3493017654,3360813161,1672685104,1672686795,1691
3500,3513018485,3757075324,1672621722,1672624867,3145
3433,3374183227,3200308999,1672554149,1672555763,1614
3891,3716963089,3713300120,1672660056,1672662289,2233
3835,3517172354,3856606678,1672598400,1672600222,1822
3892,3791046864,3511317276,1672544995,1672547029,2034
3716,3630353876,3776034743,1672674730,1672674896,166
3506,3783801141,3515439826,1672650738,1672650930,192
3892,3899326793,3271752081,1672531866,1672534955,3089
3744,3714666884,3283492940,1672588306,1672590624,2318
3647,3309314379,3777240360,1672700281,1672701329,1048
3687,3772391882,3636329663,1672568612,1672572028,3416
3596,3779639983,3734915241,1672681673,1672683024,1351
3745,3793315718,3621184108,1672583878,1672584239,361
3697,3395201292,3398198430,1672571041,1672573837,2796
3705,3739661856,3511843593,1672625679,1672626047,368
3516,3792489602,3438078818,1672630457,1672630681,224
3814,3283144118,3363162590,1672693206,1672693356,150
3456,3515401243,3791441520,1672634802,1672636659,1857
3695,3338390596,3225631197,1672537550,1672537770,220
3628,3360616538,3520115090,1672625091,1672627587,2496
3780,3779301501,3668414677,1672560557,1672561950,1393
3644,3513295938,3533294425,1672575837,1672576255,418
3434,3715854030,3497808662,1672635156,1672636740,1584
3482,3513018485,3533294425,1672609467,1672611179,1712
3870,3779613523,3889780657,1672571920,1672573669,1749
3435,3337362061,3490214516,1672561440,1672561796,356
3625,3401940259,3270056120,1672638343,1672639206,863
3839,3925979970,3970627281,1672678730,1672679430,700
3667,3792489602,3713941638,1672579427,1672580783,1356
3871,3336339664,3755992176,1672536091,1672537503,1412
3913,3519416013,3779613523,1672575122,1672577341,2219
3553,3977352557,3448633776,1672641545,1672643465,1920
3719,3284932450,3914691363,1672683485,1672686610,3125
3675,3756789525,3517358573,1672630800,1672633439,2639
3685,3410538749,3457620713,1672559913,1672561466,1553
3752,3757630221,3716679950,1672556432,1672559285,2853
3503,3774155692,3533649454,1672629988,1672632163,2175
3522,3500703304,3468041839,1672640308,1672641003,695
3880,3510642075,3431460073,1672581101,1672582363,1262
3534,3757630221,3821054646,1672569414,1672571016,1602
3877,3906536154,3408498208,1672582281,1672583767,1486
3615,3714067076,3274831810,1672555667,1672558018,2351
3439,3770468980,3394297564,1672559767,1672563039,3272
3855,3500044458,3470454332,1672548613,1672552169,3556
3863,3441348818,3713589994,1672546819,1672549605,2786
3613,3716963089,3713517039,1672671345,1672673438,2093
3713,3686227677,3305336154,1672701932,1672702919,987
3830,3627368399,3904867554,1672571777,1672573528,1751
3912,3891672228,3897456874,1672573414,1672573851,437
3500,3519282716,3509366311,1672599691,1672603023,3332
3613,3228888030,3900276517,1672618684,1672620832,2148
3800,3975717896,3716628503,1672671961,1672675403,3442
3613,3370227921,3436025562,1672571032,1672571382,350
3614,3514419100,3661447322,1672584974,1672587033,2059
3896,3779425804,3245232284,1672699089,1672699968,879
3484,3408498208,3618697021,1672640662,1672643772,3110
3522,3780571086,3224811762,1672694863,1672697166,2303
3663,3792389522,3440137407,1672633285,1672633543,258
3493,3284932450,3454277788,1672544516,1672547670,3154
3697,3760694096,3711637255,1672564964,1672565171,207
3646,3792538417,3435116799,1672694395,1672695510,1115
3716,3834963772,3305336154,1672690900,1672692970,2070
3766,3505437712,3715619259,1672595977,1672597644,1667
3847,3534357694,3835422146,1672555233,1672556942,1709
3542,3500703304,3385323994,1672700032,1672700979,947
3885,3511288998,3760842815,1672537251,1672538678,1427
3446,3460719322,3783801141,1672644761,1672647818,3057
3852,3803389195,3622357348,1672641514,1672644446,2932
3851,3554186380,3783919913,1672592180,1672594272,2092
3700,3979784676,3737112297,1672537746,1672539051,1305
3525,3734915241,3552824113,1672676881,1672680159,3278
3426,3793969543,3819767045,1672683152,1672685104,1952
3547,3276269264,3518653080,1672551218,1672552984,1766
3559,3513081354,3791796585,1672659144,1672659468,324
3634,3772765746,3912891315,1672606641,1672610217,3576
3703,3505437712,3778667336,1672636571,1672638710,2139
3554,3435116799,3834963772,1672699577,1672701078,1501
3795,3408430195,3716963089,1672666701,1672669176,2475
3492,3289114629,3395201292,1672652110,1672655356,3246
3908,3505198734,3770676872,1672623167,1672624574,1407
3826,3201629017,3373089838,1672550559,1672552426,1867
3518,3793315718,3605221116,1672700957,1672702596,1639
3702,3609659642,3737147209,1672539138,1672540348,1210
3737,3915162005,3445206685,1672665078,1672667714,2636
3524,3715400486,3611055563,1672686508,1672689374,2866
3443,3880926355,3554825448,1672589698,1672592447,2749
3740,3299125059,3923220461,1672556391,1672557101,710
3879,3205923620,3783928182,1672671511,1672673229,1718
3809,3889780657,3392836218,1672565345,1672566609,1264
3529,3780115155,3972192593,1672535077,1672538368,3291
3759,3757348722,3773735484,1672630334,1672633486,3152
3774,3375449013,3732584121,1672606093,1672607584,1491
3468,3715986185,3514334067,1672599133,1672601252,2119
3836,3357689359,3615688740,1672644741,1672645010,269
3726,3885157459,3713911104,1672539568,1672540933,1365
3650,3520578796,3792949946,1672620967,1672623678,2711
3798,3710496785,3710315160,1672614138,1672616788,2650
3784,3509756823,3791246640,1672602828,1672605667,2839
3549,3518194482,3509756823,1672609292,1672610489,1197
3731,3711812325,3366423342,1672577182,1672578021,839
3694,3618697021,3351696332,1672570307,1672571922,1615
3850,3608232640,3902861231,1672560301,1672561273,972
3870,3475349791,3510499038,1672617991,1672621399,3408
3432,3793868716,3517881647,1672680861,1672681161,300
3555,3701322924,3500604680,1672650528,1672653370,2842
3705,3515559913,3396980894,1672679845,1672682902,3057
3903,3756127300,3364726656,1672552291,1672552794,503
3457,3979784676,3760362417,1672583322,1672583667,345
3915,3481640525,3834963772,1672608045,1672611125,3080
3567,3815250107,3450286949,1672633366,1672636223,2857
3793,3834960360,3501525100,1672686693,1672690245,3552
3879,3232208416,3777779869,1672629403,1672631000,1597
3555,3396726504,3701247948,1672556773,1672558974,2201
3744,3608232640,3387594369,1672664741,1672665252,511
3672,3270697740,3925979970,1672638071,1672641091,3020
3615,3505111292,3739661856,1672608611,1672610662,2051
3837,3757630221,3779425804,1672567986,1672568946,960
3495,3970603231,3770676872,1672649105,1672651340,2235
3605,3360813161,3921648519,1672572472,1672573595,1123
3521,3276217799,3428027649,1672677158,1672679412,2254
3865,3412968120,3517590837,1672543596,1672544724,1128
3445,3554944414,3480726047,1672555023,1672556094,1071
3562,3979802715,3609113156,1672639978,1672642984,3006
3735,3897134762,3618489670,1672698620,1672699556,936
3470,3618697021,3855583256,1672685342,1672687433,2091
3791,3683113954,3227799827,1672614318,1672615119,801
3624,3760040019,3755915206,1672597939,1672598859,920
3887,3714128600,3778926763,1672608071,1672611078,3007
3802,3605221116,3515466096,1672569506,1672571353,1847
3859,3777694660,3401496246,1672677010,1672679821,2811
3572,3734451191,3902760230,1672568206,1672570483,2277
3483,3501567772,3435167810,1672597517,1672600211,2694
3797,3514308235,3518653080,1672573677,1672574723,1046
3893,3424445495,3739911441,1672627315,1672627814,499
3892,3300979975,3715854030,1672676153,1672679568,3415
3492,3308760650,3711919537,1672546032,1672546686,654
3440,3916490839,3923754072,1672697980,1672699133,1153
3777,3757700712,3972192593,1672622201,1672623695,1494
3462,3505283390,3520322124,1672586256,1672587831,1575
3863,3774907131,3623266256,1672672948,1672674641,1693
3864,3230868435,3618176292,1672649814,1672653084,3270
3653,3792546035,3710048469,1672677773,1672680718,2945
3909,3633735593,3714666884,1672631022,1672632472,1450
3638,3400763927,3412006598,1672701606,1672702339,733
3764,3310125159,3402697190,1672671078,1672673856,2778
3653,3714067076,3505111292,1672691508,1672694563,3055
3675,3621683102,3668533536,1672607328,1672608824,1496
3888,3733363628,3755992176,1672580087,1672581418,1331
3792,3436257398,3897376951,1672660136,1672661618,1482
3708,3710315160,3556969573,1672580798,1672583296,2498
3902,3617304541,3792546035,1672550014,1672550913,899
3694,3354144091,3443357683,1672610158,1672613040,2882
3847,3448875382,3622357348,1672538366,1672541935,3569
3605,3636329663,3780769110,1672597656,1672600187,2531
3823,3772078494,3776559988,1672654142,1672654864,722
3824,3392836218,3904867554,1672540710,1672541876,1166
3624,3757193551,3515890966,1672602779,1672603675,896
3762,3800257590,3780209375,1672600988,1672604238,3250
3639,3902861231,3780872464,1672681542,1672682444,902
3720,3610358027,3208452238,1672588210,1672590628,2418
3630,3411515369,3774876004,1672531280,1672534281,3001
3750,3392836218,3624297844,1672547010,1672547781,771
3600,3852686295,3337322736,1672576768,1672579268,2500
3848,3902861231,3380767040,1672657777,1672660617,2840
3661,3312998540,3739911441,1672580395,1672581862,1467
3912,3884596900,3357864626,1672592479,1672595291,2812
3585,3627368399,3335694356,1672602235,1672605176,2941
3634,3783928182,3916490839,1672560521,1672562513,1992
3827,3517687662,3826238375,1672593780,1672595756,1976
3443,3300229945,3312998540,1672703867,1672706759,2892
3756,3770676872,3490029863,1672543666,1672547033,3367
3630,3801645328,3776559988,1672676656,1672679198,2542
3871,3755915206,3512379024,1672662658,1672664875,2217
3673,3682133690,3777624586,1672656712,1672658814,2102
3451,3479851674,3200543880,1672603751,1672604286,535
3425,3500302272,3515466096,1672647156,1672648179,1023
3886,3505521218,3760040019,1672670231,1672670708,477
3679,3714678331,3772078494,1672600970,1672601073,103
3474,3514703118,3792389522,1672542353,1672545578,3225
3709,3520416075,3534764451,1672664753,1672665895,1142
3791,3309314379,3730071479,1672608188,1672609824,1636
3580,3410160376,3534764451,1672650774,1672652905,2131
3722,3554186380,3770236215,1672547941,1672550686,2745
3514,3516444201,3774178201,1672540095,1672542648,2553
3838,3780472203,3517600136,1672690619,1672692656,2037
3527,3200543880,3713768950,1672532364,1672533955,1591
3582,3931627862,3288224595,1672567739,1672569665,1926
3615,3773121782,3895285664,1672641144,1672641833,689
3516,3518653080,3776559988,1672542856,1672545151,2295
3741,3463849738,3801645328,1672532778,1672536271,3493
3765,3713561276,3367971170,1672669659,1672671202,1543
3463,3792546035,3779646172,1672583873,1672586102,2229
3892,3500208903,3755230952,1672672284,1672672618,334
3836,3347419520,3604589802,1672575147,1672575382,235
3761,3777624586,3791441520,1672532453,1672535656,3203
3806,3756746867,3739154408,1672641211,1672641434,223
3456,3279473441,3713768950,1672663815,1672667239,3424
3819,3330340793,3904412440,1672558211,1672560309,2098
3542,3513853403,3447672935,1672690888,1672690985,97
3613,3714185969,3755065949,1672661918,1672663349,1431
3658,3333403880,3438078818,1672643540,1672643623,83
3463,3760694096,3412968120,1672547242,1672549165,1923
3848,3815392801,3755756564,1672592849,1672595290,2441
3906,3774178201,3710315160,1672622738,1672623537,799
3876,3715127070,3274906650,1672531807,1672533305,1498
3891,3404025196,3304155815,1672583299,1672584304,1005
3921,3462273042,3792274796,1672576632,1672578709,2077
3438,3780253901,3632814465,1672680397,1672682596,2199
3642,3774031303,3780712350,1672557316,1672559384,2068
3870,3979802715,3905196766,1672605754,1672608672,2918
3837,3755233658,3815392801,1672594270,1672596232,1962
3872,3780209375,3516298579,1672676043,1672676835,792
3643,3926643445,3520578796,1672699390,1672701357,1967
3851,3513410578,3300511067,1672595184,1672595282,98
3840,3715127070,3272030610,1672669822,1672671528,1706
3458,3831586487,3488763230,1672596877,1672598238,1361
3844,3241790910,3472312341,1672696474,1672699968,3494
3510,3350095157,3777779869,1672616614,1672617086,472
3883,3770438122,3780115155,1672600176,1672600902,726
3668,3362641275,3812369928,1672599489,1672599976,487
3773,3703433819,3776518452,1672535025,1672535484,459
3519,3972192593,3793583656,1672614931,1672616350,1419
3682,3334993594,3383138270,1672540539,1672540644,105
3728,3497808662,3824215187,1672604400,1672606317,1917
3886,3554944414,3414275042,1672638885,1672641260,2375
3732,3710315160,3272030610,1672591511,1672593805,2294
3771,3208452238,3383138270,1672586178,1672588332,2154
3850,3461119815,3897376951,1672557953,1672558280,327
3853,3441348818,3609659642,1672663491,1672665391,1900
3915,3421877923,3934064792,1672611473,1672613815,2342
3471,3500109249,3505847380,1672537987,1672538498,511
3885,3778597171,3760364383,1672545219,1672545302,83
3689,3500604680,3715385401,1672574965,1672575761,796
3703,3510028805,3554825448,1672621060,1672621605,545
3468,3780872464,3898314440,1672558651,1672559432,781
3922,3756474459,3900945856,1672559071,1672559501,430
3665,3774641380,3520873221,1672548407,1672550316,1909
3494,3367509761,3448633776,1672543307,1672543426,119
3651,3792014516,3923420131,1672546654,1672549938,3284
3527,3311420950,3492959689,1672606009,1672607400,1391
3754,3380767040,3621184108,1672702200,1672702588,388
3614,3755737419,3517991730,1672651032,1672652399,1367
3790,3520560590,3349739136,1672532378,1672534394,2016
3872,3821054646,3472312341,1672546526,1672548393,1867
3806,3517222913,3777485931,1672598713,1672599483,770
3765,3926643445,3714827719,1672605417,1672607843,2426
3866,3755344363,3491684096,1672562739,1672563040,301
3830,3510798825,3774733620,1672603845,1672605886,2041
3766,3351696332,3780909839,1672580371,1672580711,340
3873,3520873221,3501215099,1672653119,1672653581,462
3687,3622357348,3510499038,1672580694,1672583887,3193
3839,3495911207,3501786419,1672682759,1672682878,119
3874,3428725843,3611055563,1672684840,1672685611,771
3461,3777485931,3392943173,1672583053,1672586129,3076
3635,3615939504,3516741440,1672655827,1672656967,1140
3888,3713589994,3604589802,1672590168,1672590228,60
3583,3776084820,3792014516,1672570085,1672571982,1897
3618,3516321888,3617489344,1672662540,1672665152,2612
3481,3505402439,3737972328,1672669808,1672670886,1078
3433,3714827719,3899326793,1672553278,1672555229,1951
3599,3791613604,3885121158,1672539618,1672542886,3268
3602,3760094385,3500613459,1672581380,1672583819,2439
3526,3621683102,3792014516,1672569885,1672570715,830
3768,3360813161,3534179433,1672664379,1672664559,180
3875,3680810086,3667427125,1672702141,1672702260,119
3583,3685681577,3492959689,1672617128,1672618141,1013
3763,3618354185,3783163143,1672573417,1672576804,3387
3868,3519818818,3783340788,1672606372,1672609158,2786
3773,3839245934,3308760650,1672650411,1672651304,893
3663,3701136026,3511442562,1672616809,1672618587,1778
3799,3306175858,3793175445,1672697535,1672699424,1889
3477,3778040015,3925979970,1672670689,1672671448,759
3518,3517687662,3300229945,1672559340,1672562031,2691
3713,3454277788,3905899155,1672596020,1672596389,369
3585,3505995057,3240394404,1672618912,1672619224,312
3746,3711734586,3774705415,1672646318,1672646891,573
3578,3436257398,3760924079,1672560300,1672563188,2888
3838,3777624586,3938503547,1672698823,1672701280,2457
3825,3203538212,3500613459,1672544345,1672545606,1261
3892,3780115155,3780712350,1672649979,1672650670,691
3782,3534175249,3480726047,1672691654,1672693637,1983
3817,3701884158,3774641380,1672549390,1672550886,1496
3610,3783641602,3271454397,1672596158,1672599023,2865
3895,3734915241,3971806004,1672628863,1672631966,3103
3831,3224330592,3512499658,1672687638,1672688818,1180
3846,3512392431,3935487534,1672593973,1672597230,3257
3904,3428725843,3488686442,1672660483,1672661070,587
3541,3315279093,3925979970,1672646771,1672647520,749
3859,3631090677,3441348818,1672666934,1672667535,601
3889,3714120857,3505111292,1672549123,1672552272,3149
3599,3815250107,3512830734,1672583933,1672587162,3229
3663,3778640261,3421877923,1672660517,1672661927,1410
3695,3285204083,3892304880,1672542542,1672545296,2754
3459,3509756823,3904867554,1672654727,1672655211,484
3667,3516489668,3975717896,1672596143,1672598057,1914
3850,3627368399,3443357683,1672531537,1672533015,1478
3734,3490029863,3334974375,1672703634,1672705930,2296
3640,3461119815,3773572967,1672661688,1672662288,600
3820,3469254160,3835422146,1672687944,1672690618,2674
3755,3519028898,3757323954,1672594822,1672598013,3191
3431,3617116290,3283770991,1672533083,1672535276,2193
3597,3935487534,3472068734,1672547914,1672550480,2566
3668,3624297844,3817813340,1672554696,1672556264,1568
3731,3760694096,3334647380,1672581009,1672581769,760
3898,3774876004,3403370192,1672601870,1672605160,3290
3526,3412968120,3760842815,1672677844,1672679129,1285
3703,3770236215,3276269264,1672584688,1672586788,2100
3710,3682133690,3783147088,1672654978,1672656149,1171
3836,3793418209,3519077659,1672579218,1672580828,1610
3745,3520560590,3682133690,1672633367,1672633501,134
3694,3778667336,3515890966,1672657820,1672659357,1537
3713,3755532873,3400069268,1672533705,1672537251,3546
3768,3513345163,3488763230,1672562907,1672563350,443
3490,3772765746,3399518841,1672532302,1672534371,2069
3615,3715385401,3533188828,1672565568,1672567153,1585
3746,3456430614,3757075324,1672595931,1672598780,2849
3711,3512337405,3209481722,1672651155,1672651250,95
3851,3369708250,3304155815,1672620872,1672621014,142
3461,3667673649,3780427126,1672626611,1672627991,1380
3424,3515525630,3421877923,1672574660,1672575804,1144
3858,3777184389,3777240360,1672684227,1672687102,2875
3888,3514285803,3513065217,1672692044,1672695205,3161
3607,3730071479,3514419100,1672538900,1672539857,957
3771,3927403123,3373089838,1672595699,1672595945,246
3847,3613206049,3374183227,1672674573,1672677042,2469
3808,3510919821,3500777439,1672636541,1672639558,3017
3692,3441703884,3276217799,1672533397,1672535831,2434
3878,3384068080,3512295534,1672536835,1672540198,3363
3796,3409114719,3609659642,1672655296,1672658422,3126
3643,3615115210,3612689556,1672637810,1672640945,3135
3864,3392943173,3456430614,1672549458,1672551127,1669
3687,3487875183,3713517039,1672653922,1672654095,173
3921,3713979100,3613206049,1672640213,1672641125,912
3587,3880926355,3661903000,1672663206,1672666798,3592
3517,3776518452,3515402792,1672606072,1672606326,254
3587,3408430195,3713979100,1672632701,1672636161,3460
3890,3669146016,3367509761,1672662404,1672664978,2574
3574,3669146016,3792505974,1672611004,1672611977,973
3842,3371455553,3780909839,1672554814,1672555745,931
3601,3349739136,3755915206,1672635444,1672636952,1508
3456,3396726504,3452016771,1672591464,1672593437,1973
3640,3780909839,3514818819,1672692799,1672693095,296
3491,3783340788,3452016771,1672555486,1672556089,603
3614,3225029895,3905196766,1672664121,1672667101,2980
3747,3923420131,3520181148,1672694312,1672697406,3094
3780,3505178849,3315703693,1672635188,1672637240,2052
3882,3622357348,3518565331,1672683700,1672685628,1928
3567,3441348818,3757383891,1672625235,1672625642,407
3625,3520355798,3685681577,1672560433,1672563690,3257
3622,3500072204,3516903528,1672602594,1672602842,248
3583,3617304541,3394401087,1672581230,1672583056,1826
3761,3688490530,3480991549,1672623016,1672624444,1428
3893,3472312341,3424660806,1672586241,1672588108,1867
3912,3299443125,3487875183,1672694150,1672695164,1014
3499,3776831527,3480490124,1672696060,1672697381,1321
3457,3730071479,3701005527,1672563852,1672565476,1624
3895,3480991549,3680810086,1672556802,1672557821,1019
3666,3343132529,3920497528,1672640907,1672641139,232
3911,3505179890,3424660806,1672642043,1672645281,3238
3765,3780909839,3500949309,1672684080,1672687512,3432
3489,3337322736,3446533960,1672562799,1672566118,3319
3638,3778040015,3626499450,1672575873,1672577911,2038
3578,3505266860,3774907131,1672550153,1672551151,998
3428,3517887477,3780338697,1672693753,1672694818,1065
3672,3399518841,3227799827,1672559565,1672560435,870
3433,3518229776,3773913680,1672629709,1672631150,1441
3552,3501215099,3228888030,1672601888,1672604759,2871
3816,3338083680,3519087371,1672633215,1672635261,2046
3838,3774876004,3755756564,1672584653,1672585339,686
3562,3916490839,3513295938,1672647547,1672650972,3425
3843,3454277788,3239617320,1672549463,1672549697,234
3810,3791128487,3501384020,1672579181,1672579660,479
3470,3715400486,3834631333,1672533964,1672537341,3377
3703,3351696332,3500072204,1672578647,1672582189,3542
3706,3850911686,3357864626,1672569032,1672572032,3000
3625,3774155692,3284932450,1672623963,1672626888,2925
3902,3770438122,3637313265,1672647035,1672648402,1367
3769,3760694096,3232208416,1672701573,1672702533,960
3727,3680843171,3887243870,1672578045,1672579141,1096
3521,3779425804,3363162590,1672676213,1672679110,2897
3694,3821054646,3479851674,1672622582,1672625627,3045
3919,3409114719,3480100311,1672574866,1672578223,3357
3452,3710008361,3792020993,1672698813,1672699098,285
3851,3274831810,3510187271,1672566897,1672566986,89
3688,3755737419,3803517637,1672688905,1672691895,2990
3678,3424445495,3505807416,1672568247,1672568523,276
3913,3518229776,3661903000,1672552619,1672554600,1981
3654,3970909253,3500208903,1672628703,1672629012,309
3814,3904867554,3974674109,1672703873,1672706585,2712
3724,3935399379,3497095254,1672558974,1672562539,3565
3796,3792489602,3393063657,1672607978,1672608926,948
3659,3774876004,3231713082,1672670547,1672670656,109
3560,3783771827,3533079336,1672696074,1672697392,1318
3904,3715974659,3367509761,1672586129,1672588032,1903
3475,3774705415,3755737419,1672684652,1672687037,2385
3552,3757193307,3511005395,1672654812,1672656657,1845
3519,3665998641,3520657891,1672562931,1672563339,408
3507,3534179433,3408430195,1672566799,1672570086,3287
3911,3512830734,3519077659,1672672182,1672673688,1506
3688,3412968120,3510554314,1672647118,1672647182,64
3503,3773124276,3803389195,1672590088,1672591867,1779
3588,3283144118,3812369928,1672691843,1672693989,2146
3490,3665998641,3909094917,1672685538,1672687124,1586
3515,3760362417,3501786419,1672692156,1672694305,2149
3918,3208957949,3310125159,1672668917,1672670503,1586
3527,3710496785,3491469603,1672589974,1672593286,3312
3465,3770438122,3774733620,1672644119,1672647615,3496
3897,3515890966,3500777439,1672598550,1672599385,835
3488,3284947372,3500737582,1672577407,1672577915,508
3456,3500347447,3621184108,1672614950,1672617801,2851
3493,3711637255,3500498112,1672642574,1672644512,1938
3485,3311085279,3661447322,1672667112,1672668939,1827
3595,3534357694,3513410578,1672584028,1672585478,1450
3884,3713829743,3403370192,1672577132,1672577491,359
3632,3792442597,3517697722,1672611023,1672612587,1564
3560,3703383853,3209526819,1672612349,1672612943,594
3432,3773913680,3836241528,1672678145,1672679642,1497
3429,3853629553,3772236797,1672610551,1672612723,2172
3878,3779301501,3617116290,1672545759,1672548376,2617
3440,3850911686,3519651506,1672669429,1672669527,98
3822,3773572967,3923220461,1672615824,1672616445,621
3457,3447514821,3800257590,1672598960,1672602438,3478
3501,3300818269,3772391882,1672673808,1672676844,3036
3623,3554186380,3686523546,1672593924,1672595408,1484
3904,3402697190,3450286949,1672656275,1672657024,749
3570,3347419520,3792442597,1672658323,1672661312,2989
3454,3609659642,3925979970,1672584832,1672588303,3471
3433,3500915665,3500498112,1672561431,1672562158,727
3568,3349739136,3774876004,1672598931,1672601989,3058
3430,3774641380,3225631197,1672565370,1672566737,1367
3796,3505725706,3429943738,1672644525,1672647068,2543
3897,3737112297,3351696332,1672551401,1672554145,2744
3799,3335694356,3776244398,1672645236,1672646085,849
3455,3534829213,3370227921,1672559367,1672559931,564
3705,3452016771,3283144118,1672622522,1672624413,1891
3560,3825881598,3855583256,1672539084,1672540963,1879
3442,3812534508,3552824113,1672567823,1672570978,3155
3735,3777189898,3512383699,1672566019,1672567904,1885
3618,3533274994,3760640999,1672565185,1672566808,1623
3839,3783340788,3852686295,1672599844,1672600578,734
3737,3760040019,3833217041,1672668778,1672669688,910
3818,3520355798,3821054646,1672659334,1672662209,2875
3533,3773913680,3736705719,1672659131,1672662371,3240
3476,3514308235,3351696332,1672607824,1672610051,2227
3847,3518653080,3777814504,1672582376,1672583684,1308
3812,3793935736,3621790707,1672682881,1672685848,2967
3640,3731646673,3915162005,1672536191,1672537628,1437
3651,3713589994,3715619259,1672560759,1672562728,1969
3661,3780322355,3732131656,1672555442,1672556165,723
3555,3701823816,3624297844,1672690718,1672691113,395
3706,3770236215,3505437712,1672685271,1672688648,3377
3711,3463849738,3776559988,1672571044,1672572707,1663
3660,3783550022,3773837847,1672548695,1672549629,934
3589,3351866415,3509756823,1672648003,1672650092,2089
3788,3755756564,3902760230,1672543486,1672545579,2093
3572,3517687662,3447514821,1672634249,1672634967,718
3565,3299781901,3283770991,1672547064,1672549823,2759
3728,3732584121,3457960571,1672641157,1672642468,1311
3615,3858172636,3618489670,1672631486,1672632124,638
3604,3512946768,3515439826,1672596716,1672598484,1768
3516,3770520359,3613416045,1672632579,1672633449,870
3790,3513081354,3513545422,1672572070,1672574204,2134
3743,3534829213,3500949309,1672594045,1672597282,3237
3822,3308760650,3887243870,1672651102,1672653688,2586
3509,3478114114,3500827202,1672611918,1672612940,1022
3466,3613899351,3618354185,1672664751,1672665325,574
3599,3612689556,3884596900,1672616011,1672617590,1579
3569,3970627281,3701664364,1672599419,1672600158,739
3500,3334647380,3319167958,1672674150,1672677738,3588
3627,3615688740,3512337405,1672679519,1672681216,1697
3875,3791693821,3336339664,1672658012,1672660526,2514
3751,3517462308,3337322736,1672639250,1672640721,1471
3456,3472312341,3755737419,1672640156,1672641096,940
3632,3713768950,3635169815,1672621393,1672624265,2872
3724,3760721303,3710854064,1672556744,1672558502,1758
3789,3398198430,3773121782,1672658210,1672658757,547
3772,3923220461,3902861231,1672552503,1672552918,415
3659,3812534508,3402385957,1672607366,1672607644,278
3730,3783919913,3505111292,1672563827,1672564916,1089
3847,3780834916,3299125059,1672612212,1672613644,1432
3812,3431460073,3396726504,1672701997,1672705579,3582
3465,3513345163,3791106564,1672662511,1672662577,66
3503,3912891315,3776244398,1672576775,1672577272,497
3603,3920497528,3447672935,1672642008,1672644030,2022
3920,3441348818,3730071479,1672660906,1672661820,914
3812,3738026330,3783550022,1672628687,1672630809,2122
3858,3306175858,3621184108,1672580078,1672582210,2132
3602,3736705719,3227799827,1672546487,1672549119,2632
3687,3512337405,3533929349,1672661906,1672663816,1910
3894,3773124276,3770438122,1672652932,1672655549,2617
3611,3316800320,3468041839,1672700132,1672700911,779
3600,3533294425,3850911686,1672640132,1672641613,1481
3433,3935399379,3825881598,1672575932,1672577749,1817
3481,3701664364,3613338363,1672653894,1672654788,894
3908,3557046880,3715986185,1672672062,1672674109,2047
3844,3512800570,3279473441,1672580064,1672580603,539
3847,3360813161,3791128487,1672682345,1672685178,2833
3733,3669146016,3609933747,1672678844,1672681797,2953
3562,3338390596,3739895284,1672606487,1672609912,3425
3730,3757348722,3774790271,1672543277,1672546223,2946
3449,3774290799,3621790707,1672608069,1672608656,587
3521,3618489670,3770468980,1672620190,1672620624,434
3898,3639050419,3480100311,1672551740,1672552634,894
3915,3757193551,3688490530,1672595655,1672598489,2834
3911,3902625986,3351696332,1672554039,1672554157,118
3869,3792546035,3755915206,1672610254,1672612491,2237
3654,3773837847,3755230952,1672550251,1672551850,1599
3664,3925979970,3783373154,1672586060,1672587749,1689
3809,3773033649,3315703693,1672678276,1672678515,239
3742,3756704774,3460719322,1672671810,1672672831,1021
3449,3617116290,3737112297,1672633992,1672636379,2387
3888,3889780657,3513545422,1672536035,1672536808,773
3711,3755230952,3711853996,1672539562,1672539722,160
3763,3884596900,3760721303,1672613193,1672613426,233
3696,3517462308,3467988782,1672686172,1672686305,133
3457,3500857494,3299125059,1672676056,1672677844,1788
3499,3739911441,3979802715,1672534713,1672535245,532
3808,3500915908,3824641227,1672595247,1672596920,1673
3700,3533274994,3904867554,1672544545,1672546925,2380
3834,3417191856,3934064792,1672591785,1672595055,3270
3470,3305336154,3713691388,1672564233,1672564780,547
3564,3818575661,3756127300,1672580417,1672583521,3104
3788,3505402439,3755992176,1672550987,1672551483,496
3831,3734118023,3776559988,1672603860,1672606827,2967
3914,3520322124,3448633776,1672691535,1672692235,700
3427,3905899155,3517590837,1672651012,1672653224,2212
3754,3760040019,3460719322,1672699842,1672701188,1346
3564,3811040565,3501121099,1672572857,1672574342,1485
3440,3791441520,3807212280,1672623853,1672626066,2213
3779,3890739241,3510818674,1672581155,1672582050,895
3807,3630353876,3701322924,1672700472,1672703368,2896
3639,3520639768,3373028638,1672575842,1672576066,224
3596,3779738691,3756474459,1672661947,1672665183,3236
3640,3514285803,3757075324,1672537409,1672538962,1553
3579,3783520186,3757348722,1672633245,1672636088,2843
3731,3505111292,3970909253,1672672165,1672674289,2124
3699,3364378127,3755756564,1672683511,1672686713,3202
3776,3246370118,3533090502,1672685814,1672687242,1428
3451,3711812325,3801645328,1672664870,1672666597,1727
3889,3310039260,3631090677,1672602021,1672603023,1002
3868,3533004959,3533228966,1672631422,1672633013,1591
3645,3819767045,3298151889,1672536907,1672538362,1455
3786,3418448389,3711919537,1672619455,1672620209,754
3738,3343132529,3505228454,1672685229,1672686162,933
3861,3500109249,3395201292,1672535920,1672536130,210
3763,3551376095,3791246640,1672564827,1672567309,2482
3470,3455018347,3480100311,1672593395,1672595987,2592
3749,3814305099,3802932312,1672611501,1672611882,381
3677,3316798920,3920898925,1672687892,1672690834,2942
3648,3932478321,3715974659,1672571365,1672573652,2287
3883,3829864515,3338083680,1672695441,1672697862,2421
3638,3472068734,3533079336,1672537408,1672538703,1295
3481,3509483172,3280054198,1672630801,1672631088,287
3427,3205923620,3887243870,1672547163,1672548372,1209
3455,3510964997,3515402792,1672659094,1672662543,3449
3613,3299443125,3617489344,1672541416,1672542463,1047
3469,3294703680,3333918941,1672558995,1672562571,3576
3557,3604589802,3509756823,1672657644,1672658077,433
3873,3755915206,3463849738,1672572859,1672575383,2524
3912,3756474459,3639050419,1672668339,1672669374,1035
3739,3467779445,3826238375,1672541748,1672544422,2674
3493,3716272919,3756474459,1672563095,1672564137,1042
3622,3755737419,3780472203,1672606906,1672609159,2253
3754,3631090677,3226511603,1672676645,1672677924,1279
3496,3757903168,3829822608,1672577202,1672579562,2360
3710,3688796737,3232208416,1672650362,1672651117,755
3567,3380130228,3410160376,1672679866,1672682924,3058
3904,3510554314,3435116799,1672597721,1672600557,2836
3541,3534829213,3303410628,1672586444,1672587042,598
3603,3272716462,3306175858,1672543865,1672546543,2678
3465,3703383853,3534764451,1672685317,1672687254,1937
3638,3783771827,3501281016,1672682662,1672683489,827
3475,3311498666,3803517637,1672596173,1672599383,3210
3702,3636329663,3701882224,1672683743,1672685731,1988
3658,3389634034,3890739241,1672689978,1672692602,2624
3579,3534179433,3713163045,1672562710,1672565109,2399
3628,3626499450,3716963089,1672616901,1672620370,3469
3913,3833217041,3884596900,1672584648,1672586854,2206
3759,3783615982,3780115155,1672696142,1672696662,520
3901,3711853996,3515466096,1672684550,1672686789,2239
3624,3780209375,3812534508,1672544121,1672545802,1681
3790,3236458894,3517887477,1672591370,1672593979,2609
3518,3393063657,3519087371,1672675914,1672678182,2268
3461,3819767045,3380982774,1672702817,1672704559,1742
3553,3638204468,3457620713,1672629096,1672632413,3317
3737,3490214516,3519087371,1672694337,1672695055,718
3440,3312998540,3791441520,1672666815,1672669629,2814
3513,3858172636,3710562338,1672564741,1672565117,376
3563,3755496114,3772078494,1672629054,1672629708,654
3738,3376467719,3773837847,1672659657,1672661703,2046
3593,3935399379,3977352557,1672562850,1672564482,1632
3545,3885157459,3880926355,1672602939,1672604949,2010
3682,3520322124,3449333754,1672604160,1672605397,1237
3855,3343816795,3511601997,1672643709,1672646846,3137
3730,3715619259,3893912331,1672698468,1672702058,3590
3437,3514324011,3776559988,1672643633,1672644605,972
3534,3396726504,3289114629,1672620980,1672622363,1383
3580,3776084820,3519087371,1672570290,1672572256,1966
3597,3220031931,3680810086,1672676374,1672677448,1074
3595,3701373490,3520873221,1672604368,1672607454,3086
3782,3424445495,3436025562,1672595388,1672596162,774
3735,3357289672,3435116799,1672600604,1672604025,3421
3834,3399472693,3615113018,1672579304,1672581700,2396
3500,3514741348,3396726504,1672545865,1672546185,320
3447,3519087371,3335694356,1672540510,1672542026,1516
3675,3505228454,3519818818,1672549363,1672550732,1369
3797,3852533643,3227799827,1672673452,1672674109,657
3801,3760645796,3438489358,1672689193,1672692642,3449
3448,3783615982,3817428320,1672570867,1672573481,2614
3725,3403370192,3380982774,1672617960,1672621536,3576
3718,3284947372,3505178849,1672629254,1672631780,2526
3530,3511732493,3517697722,1672623640,1672625858,2218
3660,3349856820,3360069849,1672650631,1672654225,3594
3850,3711077927,3621683102,1672547153,1672550574,3421
3608,3783520186,3351866415,1672608647,1672611655,3008
3649,3630353876,3220031931,1672545212,1672546728,1516
3499,3615688740,3447672935,1672671429,1672672385,956
3470,3777091903,3500442734,1672587122,1672587605,483
3906,3227799827,3232208416,1672668266,1672671258,2992
3575,3770296583,3367111751,1672701868,1672703779,1911
3915,3972083617,3685816610,1672664182,1672664446,264
3451,3310125159,3639050419,1672575668,1672576329,661
3629,3898314440,3500672156,1672691261,1672691675,414
3604,3834631333,3884596900,1672614258,1672617052,2794
3615,3885155975,3825881598,1672590274,1672591371,1097
3448,3492959689,3897435944,1672567745,1672567939,194
3612,3505437712,3927165965,1672631695,1672633847,2152
3550,3734915241,3620292035,1672570961,1672572811,1850
3547,3373089838,3515890966,1672543193,1672544790,1597
3439,3456430614,3300511067,1672685705,1672686433,728
3781,3435167810,3617392620,1672591969,1672594907,2938
3726,3668414677,3610870949,1672566113,1672569269,3156
3732,3455018347,3515466096,1672638154,1672641475,3321
3838,3226511603,3905899155,1672628438,1672630099,1661
3781,3304971369,3776084820,1672539534,1672541935,2401
3655,3500347447,3614740489,1672701372,1672702997,1625
3808,3808136029,3387594369,1672630821,1672633453,2632
3739,3779465522,3792801638,1672562444,1672564780,2336
3657,3206837348,3890739241,1672660699,1672662885,2186
3826,3773902805,3501786419,1672670843,1672671114,271
3804,3305722859,3270056120,1672642011,1672643334,1323
3827,3934064792,3755915206,1672557747,1672560325,2578
3500,3770624662,3755158925,1672543604,1672546945,3341
3450,3513041785,3776988674,1672588021,1672588945,924
3442,3622357348,3449333754,1672684359,1672685092,733
3871,3915162005,3793407963,1672599007,1672600729,1722
3749,3513410578,3902760230,1672638705,1672640966,2261
3772,3617304541,3808136029,1672611383,1672614659,3276
3438,3380982774,3470454332,1672593205,1672593338,133
3642,3757863420,3201629017,1672543372,1672545467,2095
3686,3304971369,3904412440,1672662728,1672664215,1487
3890,3627368399,3512800570,1672539153,1672542311,3158
3783,3770624662,3701005527,1672558583,1672561640,3057
3565,3347446226,3408498208,1672576990,1672577999,1009
3469,3850911686,3201629017,1672651623,1672653736,2113
3651,3296462324,3780427126,1672660601,1672661871,1270
3825,3209481722,3462636434,1672611193,1672611325,132
3491,3501786419,3315279093,1672606043,1672608071,2028
3495,3501384020,3610870949,1672585664,1672587228,1564
3893,3367111751,3500915665,1672591807,1672594246,2439
3646,3369708250,3618176292,1672532228,1672535819,3591
3662,3891672228,3334974375,1672594492,1672596835,2343
3659,3519142371,3488686442,1672678362,1672680587,2225
3708,3500341755,3703139663,1672639321,1672640401,1080
3551,3518653080,3202804048,1672602435,1672604104,1669
3874,3402697190,3383138270,1672556428,1672559533,3105
3922,3755404116,3791106564,1672617484,1672619145,1661
3601,3304971369,3402697190,1672633334,1672636043,2709
3648,3519651506,3783919913,1672558592,1672559801,1209
3571,3512946768,3777091903,1672547552,1672551053,3501
3620,3755230952,3409114719,1672564768,1672566581,1813
3631,3760362417,3440107959,1672543058,1672545863,2805
3779,3505111292,3710489491,1672659229,1672660079,850
3792,3500604680,3518653080,1672654356,1672656805,2449
3490,3500915908,3608922867,1672666120,1672669496,3376
3696,3404025196,3792020993,1672694862,1672697043,2181
3796,3859868849,3904412440,1672609283,1672610864,1581
3755,3710048469,3512282789,1672540528,1672542250,1722
3857,3779425804,3738026330,1672603537,1672606403,2866
3678,3236499444,3514246749,1672540327,1672542515,2188
3779,3935399379,3334647380,1672665919,1672667636,1717
3680,3715086894,3737112297,1672559653,1672560376,723
3772,3776244398,3519818818,1672585677,1672586172,495
3575,3915162005,3280268483,1672573179,1672576571,3392
3852,3938503547,3488763230,1672691088,1672694223,3135
3533,3517172354,3510818674,1672681055,1672681135,80
3706,3703396825,3779301501,1672675747,1672677602,1855
3763,3756625818,3436257398,1672553219,1672553549,330
3702,3510641433,3518565331,1672577989,1672578744,755
3514,3380130228,3617489344,1672660143,1672663176,3033
3560,3510499038,3360069849,1672640213,1672642713,2500
3608,3334974375,3510798825,1672605689,1672606370,681
3499,3777240360,3236499444,1672584844,1672586376,1532
3790,3516298579,3373089838,1672684498,1672686976,2478
3818,3783136330,3431460073,1672600632,1672603974,3342
3770,3360616538,3793315718,1672633513,1672634916,1403
3917,3835422146,3776988674,1672628746,1672631226,2480
3890,3447672935,3315703693,1672620046,1672620622,576
3482,3441703884,3500737582,1672577160,1672580027,2867
3730,3517737088,3778899160,1672578862,1672581848,2986
3660,3635169815,3777037426,1672674800,1672677659,2859
3900,3431460073,3772391882,1672565149,1672565908,759
3819,3615688740,3760094385,1672619704,1672620317,613
3630,3411515369,3480726047,1672561710,1672562959,1249
3799,3780427126,3480726047,1672672211,1672673185,974
3546,3533747868,3414049538,1672634744,1672636354,1610
3433,3636329663,3975717896,1672542103,1672543594,1491
3771,3737972328,3934064792,1672660822,1672663435,2613
3594,3895285664,3625463628,1672614845,1672616489,1644
3917,3701322924,3501121099,1672677229,1672678562,1333
3621,3459681410,3755737419,1672578871,1672580076,1205
3501,3778597171,3814677862,1672625811,1672626819,1008
3819,3760094385,3238288884,1672604872,1672608142,3270
3747,3431460073,3979784676,1672579246,1672579599,353
3661,3783550022,3431502855,1672591719,1672592147,428
3705,3713768950,3505266860,1672555195,1672558767,3572
3549,3897456874,3299781901,1672665530,1672668210,2680
3674,3559731671,3621790707,1672544834,1672545666,832
3504,3713979100,3505847380,1672686966,1672690117,3151
3727,3715086894,3289114629,1672686681,1672690149,3468
3485,3774641380,3814305099,1672652321,1672655018,2697
3761,3230135532,3773837847,1672543564,1672546730,3166
3555,3760924079,3938389661,1672537603,1672539562,1959
3484,3533004959,3501525100,1672676558,1672678740,2182
3510,3779892400,3756625818,1672659940,1672660150,210
3889,3360616538,3773332082,1672696413,1672699981,3568
3473,3497671225,3417679834,1672632642,1672633775,1133
3452,3519818818,3380982774,1672557347,1672559389,2042
3593,3480490124,3373089838,1672593982,1672597419,3437
3826,3773913680,3436025562,1672550693,1672553722,3029
3535,3478114114,3337322736,1672537230,1672539623,2393
3777,3711077927,3225631197,1672650176,1672650476,300
3545,3511288998,3514308235,1672656490,1672658650,2160
3863,3534357694,3760694096,1672592419,1672594051,1632
3749,3668747074,3783136330,1672686453,1672689162,2709
3456,3311498666,3480100311,1672586126,1672588605,2479
3511,3756704774,3478114114,1672682992,1672686446,3454
3593,3240394404,3518229776,1672623583,1672627130,3547
3795,3449333754,3776034743,1672703052,1672703698,646
3621,3303410628,3770468980,1672700474,1672702938,2464
3558,3791613604,3505725706,1672648262,1672650448,2186
3786,3970198861,3511317276,1672583072,1672584808,1736
3681,3505437712,3755222916,1672583270,1672583360,90
3577,3732584121,3890739241,1672593333,1672594708,1375
3728,3625463628,3824641227,1672620738,1672621946,1208
3662,3364726656,3312998540,1672651376,1672654227,2851
3804,3935487534,3500915665,1672548312,1672549593,1281
3517,3793922324,3710008361,1672622099,1672624856,2757
3814,3389634034,3770438122,1672660750,1672661561,811
3736,3520355798,3792745809,1672630763,1672633834,3071
3601,3520355798,3350095157,1672604118,1672604485,367
3577,3637313265,3776518452,1672549994,1672552337,2343
3581,3510499038,3316800320,1672672188,1672675276,3088
3812,3904867554,3619922891,1672550110,1672552873,2763
3549,3703383853,3792801638,1672617437,1672620841,3404
3890,3533649454,3414275042,1672606630,1672607783,1153
3857,3208957949,3241914067,1672565735,1672569146,3411
3600,3711218296,3224811762,1672676562,1672677240,678
3816,3711853996,3505847380,1672685399,1672687636,2237
3649,3772236797,3920625129,1672659007,1672662039,3032
3721,3520991398,3410538749,1672532702,1672536241,3539
3544,3756625818,3303410628,1672567137,1672569032,1895
3496,3774705415,3621184108,1672687386,1672688031,645
3468,3534543776,3349856820,1672641425,1672643287,1862
3538,3513295938,3792525861,1672597999,1672598577,578
3868,3414275042,3900276517,1672538954,1672541895,2941
3688,3793935736,3533423872,1672596687,1672596992,305
3623,3737112297,3916490839,1672553040,1672553465,425
3850,3713691388,3618354185,1672627734,1672630750,3016
3563,3505179890,3505923418,1672680475,1672682131,1656
3540,3755222916,3304155815,1672543486,1672545924,2438
3465,3554186380,3793175445,1672555507,1672555823,316
3473,3448633776,3336627643,1672588988,1672591526,2538
3878,3927599181,3609113156,1672690911,1672694352,3441
3853,3554944414,3306412634,1672623118,1672625095,1977
3652,3338390596,3410538749,1672555186,1672555619,433
3667,3245232284,3618354185,1672614766,1672618301,3535
3683,3927599181,3938389661,1672626140,1672627923,1783
3452,3757348722,3316798920,1672575178,1672575692,514
3437,3500857494,3289114629,1672602479,1672604353,1874
3554,3880926355,3517737088,1672572977,1672573184,207
3870,3500949309,3777779869,1672656065,1672658106,2041
3535,3304155815,3715086894,1672563475,1672565960,2485
3907,3779301501,3447672935,1672644992,1672647746,2754
3627,3793868716,3279473441,1672620909,1672623645,2736
3525,3824215187,3520115090,1672617524,1672620367,2843
3465,3510767239,3410600350,1672651268,1672654045,2777
3810,3923754072,3914691363,1672653244,1672655950,2706
3671,3688796737,3534179433,1672583472,1672584129,657
3848,3682133690,3783615982,1672686568,1672686749,181
3687,3920898925,3902861231,1672668905,1672670093,1188
3630,3755404116,3620292035,1672582727,1672584401,1674
3579,3517991730,3609659642,1672607054,1672609483,2429
3687,3517462308,3501457103,1672582005,1672584361,2356
3509,3481640525,3510798825,1672568827,1672570614,1787
3758,3520355798,3300979975,1672628155,1672631616,3461
3834,3757294769,3366423342,1672549628,1672550290,662
3504,3821054646,3774876004,1672584384,1672586576,2192
3453,3914691363,3333403880,1672556614,1672557580,966
3916,3839245934,3711006062,1672580283,1672580546,263
3647,3791106564,3410600350,1672646731,1672649284,2553
3628,3533228966,3897134762,1672626218,1672627778,1560
3725,3791046864,3793743698,1672687873,1672690121,2248
3660,3859868849,3920625129,1672631608,1672632009,401
3691,3772236797,3514741348,1672693324,1672693577,253
3502,3615939504,3299781901,1672624185,1672627530,3345
3658,3520115090,3890739241,1672536117,1672536622,505
3908,3224811762,3383138270,1672542279,1672543829,1550
3603,3369708250,3336339664,1672550638,1672553275,2637
3744,3373089838,3500827202,1672677065,1672678866,1801
3616,3615087943,3932478321,1672544134,1672545015,881
3906,3300229945,3271752081,1672667946,1672668770,824
3627,3774790271,3408430195,1672545835,1672547216,1381
3748,3500703304,3777694660,1672608668,1672609480,812
3533,3512800570,3517590837,1672551406,1672553968,2562
3482,3451326054,3272716462,1672577080,1672580068,2988
3887,3853629553,3501525100,1672543562,1672545229,1667
3818,3515525630,3334647380,1672689461,1672692157,2696
3869,3920497528,3389634034,1672569182,1672572120,2938
3821,3701005527,3200543880,1672600558,1672601878,1320
3527,3514334067,3513327337,1672544839,1672545147,308
3448,3667427125,3638204468,1672599706,1672600316,610
3428,3970627281,3231494505,1672541154,1672544156,3002
3853,3385323994,3613416045,1672682527,1672683516,989
3516,3520181148,3360069849,1672668709,1672671829,3120
3532,3774155692,3701882224,1672663288,1672666484,3196
3919,3831586487,3734915241,1672603145,1672604188,1043
3502,3668533536,3617489344,1672590060,1672591963,1903
3563,3760640999,3509893027,1672547459,1672548047,588
3918,3757700712,3298151889,1672563835,1672563914,79
3726,3491469603,3517358573,1672687852,1672688236,384
3546,3534764451,3300229945,1672666274,1672667109,835
3737,3505995057,3411688875,1672686685,1672689896,3211
3581,3890739241,3780571086,1672604582,1672606339,1757
3741,3776117322,3803389195,1672680627,1672681109,482
3609,3225631197,3661447322,1672591859,1672594693,2834
3588,3777091903,3755573472,1672588653,1672591061,2408
3568,3300229945,3514818819,1672599264,1672601197,1933
3531,3428027649,3897456874,1672536893,1672539719,2826
3618,3510187271,3488763230,1672693403,1672696731,3328
3575,3272716462,3710496785,1672699611,1672700683,1072
3431,3923220461,3271752081,1672641138,1672643245,2107
3755,3337322736,3517358573,1672537381,1672539045,1664
3505,3520657891,3710048469,1672571022,1672571153,131
3436,3404025196,3773572967,1672675939,1672678713,2774
3617,3715707380,3614740489,1672586270,1672588838,2568
3853,3412006598,3793407963,1672596137,1672599138,3001
3911,3514512367,3714185969,1672554146,1672557192,3046
3710,3520355798,3739661856,1672690862,1672691723,861
3912,3792014516,3774790271,1672626115,1672629615,3500
3856,3401496246,3793743698,1672571671,1672572212,541
3510,3713300120,3509366311,1672601499,1672602976,1477
3614,3239617320,3905899155,1672544108,1672545162,1054
3506,3490029863,3711218296,1672619925,1672621225,1300
3441,3760694096,3208452238,1672643635,1672647064,3429
3690,3938503547,3515890966,1672632174,1672635685,3511
3675,3371455553,3270697740,1672689612,1672690222,610
3756,3783520186,3371455553,1672578382,1672579649,1267
3440,3512379024,3205985903,1672627627,1672630092,2465
3615,3517172354,3791246640,1672570145,1672572733,2588
3872,3501281016,3311098437,1672589448,1672591969,2521
3562,3770704999,3835985172,1672596397,1672598685,2288
3879,3510798825,3394401087,1672557729,1672559660,1931
3753,3912891315,3311420950,1672598636,1672600214,1578
3448,3533423872,3311085279,1672668700,1672668846,146
3864,3357289672,3244004456,1672700165,1672701829,1664
3424,3778134418,3850911686,1672556515,1672557630,1115
3721,3885537225,3622357348,1672627561,1672630722,3161
3586,3512499658,3773572967,1672670159,1672673027,2868
3691,3512882178,3367509761,1672596769,1672597093,324
3787,3757193551,3770704999,1672640968,1672644211,3243
3487,3972192593,3715545685,1672573384,1672574244,860
3719,3372223551,3779613523,1672663488,1672666245,2757
3585,3400069268,3445206685,1672633361,1672634150,789
3623,3900898992,3757863420,1672604742,1672608113,3371
3780,3410600350,3505402439,1672606388,1672608859,2471
3573,3757318448,3757863420,1672599044,1672601072,2028
3616,3505521218,3856606678,1672657071,1672659127,2056
3865,3500672156,3892304880,1672584081,1672585030,949
3761,3246370118,3755915206,1672596283,1672598202,1919
3917,3384583385,3517358573,1672532574,1672533320,746
3917,3970558632,3685681577,1672546371,1672548064,1693
3565,3478114114,3735374579,1672660006,1672663438,3432
3646,3930242012,3501121099,1672697756,1672701176,3420
3767,3417679834,3757863420,1672679361,1672681183,1822
3740,3779613523,3617489344,1672672035,1672672512,477
3509,3497095254,3613581796,1672568431,1672570260,1829
3818,3201629017,3450969839,1672660489,1672662001,1512
3916,3710496785,3773913680,1672643513,1672646590,3077
3664,3337322736,3618808151,1672639667,1672640450,783
3564,3793868716,3777485931,1672544043,1672546298,2255
3680,3475349791,3393063657,1672541863,1672543555,1692
3533,3412006598,3615115210,1672579560,1672580444,884
3802,3739911441,3401496246,1672539288,1672540718,1430
3688,3923220461,3703348097,1672672684,1672674615,1931
3908,3534543776,3306175858,1672545947,1672548101,2154
3743,3270056120,3392836218,1672673204,1672674129,925
3499,3279475486,3979784676,1672552087,1672552670,583
3669,3248058676,3774155692,1672664672,1672665543,871
3595,3271752081,3755344363,1672548449,1672551091,2642
3879,3393063657,3780253901,1672543109,1672543522,413
3820,3928719932,3351696332,1672605956,1672609153,3197
3442,3515525630,3890739241,1672670406,1672671235,829
3551,3516513251,3613581796,1672630886,1672633687,2801
3654,3757294769,3499217428,1672627414,1672629863,2449
3891,3520764926,3505888598,1672615591,1672617669,2078
3760,3970909253,3428725843,1672702995,1672704464,1469
3556,3299443125,3736231757,1672614098,1672616959,2861
3790,3715854030,3783928182,1672598886,1672601645,2759
3465,3511883730,3201676087,1672553359,1672555774,2415
3800,3501457103,3792274796,1672558419,1672559039,620
3914,3701322924,3500044458,1672629202,1672629270,68
3845,3533294425,3793868716,1672595301,1672596373,1072
3670,3689697817,3487875183,1672627931,1672630669,2738
3565,3895285664,3390660440,1672660730,1672662785,2055
3702,3793315718,3755532873,1672532956,1672535816,2860
3445,3370068529,3501384020,1672603534,1672604816,1282
3846,3270697740,3621683102,1672541241,1672542336,1095
3542,3617304541,3333918941,1672582543,1672584023,1480
3580,3291933594,3485540729,1672648982,1672650860,1878
3849,3930242012,3292147449,1672700808,1672704386,3578
3866,3793868716,3480991549,1672639216,1672642097,2881
3855,3505198734,3713784974,1672584474,1672585084,610
3464,3710496785,3509893027,1672610436,1672613221,2785
3590,3779532653,3462158237,1672613162,1672614882,1720
3814,3513545422,3360069849,1672535488,1672537864,2376
3527,3783147088,3755992176,1672622259,1672625625,3366
3794,3224811762,3437286517,1672637402,1672639556,2154
3714,3343132529,3220031931,1672650482,1672652294,1812
3686,3304155815,3505847380,1672596710,1672597509,799
3851,3248058676,3398731252,1672649018,1672652103,3085
3464,3793418209,3737112297,1672532999,1672535720,2721
3501,3760040019,3783641602,1672607671,1672608990,1319
3437,3618489670,3501786419,1672633077,1672635186,2109
3485,3514246749,3383138270,1672619454,1672621598,2144
3684,3714678331,3409114719,1672533060,1672533930,870
3851,3780115155,3778597171,1672587178,1672589058,1880
3496,3226178937,3713163045,1672677390,1672680753,3363
3835,3920898925,3463740710,1672629515,1672630335,820
3777,3310125159,3455018347,1672631782,1672635245,3463
3722,3270056120,3208452238,1672600715,1672604013,3298
3618,3516513251,3715707380,1672695161,1672696986,1825
3444,3607882826,3299125059,1672611199,1672613316,2117
3746,3309314379,3241914067,1672591961,1672592971,1010
3680,3933894942,3619922891,1672665779,1672668094,2315
3788,3554944414,3505283390,1672599964,1672602228,2264
3844,3401496246,3780209375,1672622390,1672623588,1198
3497,3311420950,3357864626,1672675301,1672676641,1340
3615,3938389661,3935913584,1672568140,1672568730,590
3906,3380982774,3514512367,1672644023,1672645535,1512
3898,3779786641,3448633776,1672566308,1672569745,3437
3811,3739895284,3791128487,1672620852,1672622658,1806
3567,3367509761,3462158237,1672625346,1672625934,588
3691,3892304880,3431460073,1672643011,1672644161,1150
3906,3451726367,3669146016,1672534347,1672535361,1014
3804,3510187271,3780209375,1672635336,1672638591,3255
3702,3421877923,3682133690,1672699193,1672699496,303
3480,3701664364,3288762795,1672587619,1672589100,1481
3724,3619922891,3512958459,1672630885,1672632981,2096
3646,3814305099,3518194482,1672553452,1672553528,76
3475,3757318448,3756704774,1672657022,1672658166,1144
3826,3200543880,3856606678,1672634129,1672636734,2605
3636,3776084820,3713691388,1672670415,1672673384,2969
3907,3760040019,3893912331,1672587087,1672587873,786
3469,3668414677,3516489668,1672629032,1672629459,427
3738,3638204468,3623266256,1672546648,1672548000,1352
3804,3755532873,3710315160,1672631113,1672632761,1648
3581,3517887477,3300511067,1672667159,1672667519,360
3657,3398198430,3777037426,1672652505,1672652964,459
3497,3621790707,3927403123,1672618081,1672618164,83
3647,3974674109,3802932312,1672533556,1672535403,1847
3659,3533274994,3481640525,1672587470,1672587836,366
3538,3284947372,3800257590,1672573667,1672574122,455
3918,3514285803,3379143440,1672571442,1672572298,856
3723,3814677862,3815392801,1672565491,1672567531,2040
3839,3435167810,3360813161,1672681944,1672685539,3595
3535,3711812325,3513081354,1672622749,1672624612,1863
3464,3519651506,3793740407,1672684468,1672687717,3249
3452,3713517039,3338390596,1672619616,1672621526,1910
3545,3534829213,3609113156,1672683101,1672684362,1261
3671,3715545685,3334647380,1672668568,1672671202,2634
3735,3714128600,3435116799,1672676476,1672677585,1109
3518,3793883863,3415833929,1672537553,1672540055,2502
3663,3755756564,3807212280,1672580068,1672582713,2645
3796,3791613604,3276269264,1672609645,1672610533,888
3505,3613416045,3424660806,1672690182,1672692666,2484
3508,3760640999,3776034743,1672600521,1672603203,2682
3791,3515401243,3274831810,1672701373,1672703047,1674
3625,3351866415,3418448389,1672639480,1672641552,2072
3919,3513545422,3779438325,1672642413,1672645034,2621
3803,3793883863,3316800320,1672564708,1672565322,614
3615,3778597171,3928511283,1672652036,1672654483,2447
3545,3783340788,3774733620,1672578625,1672579260,635
3618,3777330107,3367509761,1672680836,1672683103,2267
3825,3609933747,3776117322,1672565082,1672566731,1649
3693,3517288083,3230868435,1672640833,1672642618,1785
3444,3510187271,3534357694,1672597516,1672597662,146
3573,3500841914,3372223551,1672537793,1672539442,1649
3647,3927599181,3615737355,1672560646,1672564083,3437
3650,3772765746,3285204083,1672543654,1672545773,2119
3431,3609113156,3776034743,1672659097,1672659957,860
3505,3773902805,3404025196,1672670949,1672671298,349
3690,3294703680,3632814465,1672644169,1672647661,3492
3678,3411688875,3514956366,1672542845,1672545796,2951
3496,3516489668,3713589994,1672548737,1672549902,1165
3783,3711218296,3300818269,1672618703,1672621298,2595
3738,3505228454,3505995057,1672638218,1672638752,534
3900,3505725706,3534357694,1672581683,1672583995,2312
3886,3905899155,3310125159,1672569433,1672571183,1750
3820,3716272919,3757294769,1672620240,1672622359,2119
3494,3512830734,3516513251,1672555960,1672557875,1915
3704,3714067076,3772236797,1672631835,1672633257,1422
3496,3389634034,3201800997,1672593019,1672594710,1691
3523,3500777439,3516513251,1672573173,1672575627,2454
3892,3938503547,3505434346,1672637836,1672639936,2100
3788,3850911686,3783520186,1672594146,1672594621,475
3650,3792525861,3735374579,1672683475,1672684717,1242
3729,3773124276,3518565331,1672592568,1672595544,2976
3849,3970198861,3792489602,1672553449,1672553733,284
3889,3514956366,3892304880,1672591958,1672592448,490
3562,3382733096,3505179890,1672673104,1672675258,2154
3757,3905196766,3680843171,1672677564,1672680161,2597
3787,3904569677,3224968597,1672674000,1672675653,1653
3437,3714678331,3511843593,1672693954,1672696546,2592
3488,3283492940,3403370192,1672670393,1672671520,1127
3718,3272716462,3509366311,1672684734,1672685903,1169
3504,3715127070,3701107228,1672651890,1672653570,1680
3732,3505228454,3757630221,1672531465,1672534398,2933
3818,3424445495,3777184389,1672634588,1672636161,1573
3889,3895285664,3533004959,1672698289,1672701594,3305
3806,3510641433,3779639983,1672644488,1672645858,1370
3874,3713768950,3623266256,1672544354,1672545587,1233
3741,3519028898,3935913584,1672562303,1672564769,2466
3909,3505847380,3360813161,1672563239,1672565218,1979
3564,3396980894,3225631197,1672648840,1672650636,1796
3700,3783550022,3897134762,1672598890,1672601524,2634
3479,3780712350,3783771827,1672667626,1672669279,1653
3556,3500777439,3478114114,1672625121,1672628325,3204
3447,3513345163,3780872464,1672696296,1672696866,570
3773,3497095254,3500841914,1672553755,1672554825,1070
3855,3802932312,3834960360,1672689291,1672690925,1634
3862,3441703884,3770146716,1672555645,1672557991,2346
3756,3970909253,3715400486,1672651919,1672652902,983
3574,3615087943,3770704999,1672671978,1672674530,2552
3692,3779438325,3424445495,1672571957,1672574215,2258
3812,3470454332,3895285664,1672679659,1672682032,2373
3498,3431502855,3285204083,1672570705,1672574174,3469
3905,3734915241,3607768197,1672644262,1672646573,2311
3692,3732131656,3447672935,1672617121,1672617456,335
3580,3554825448,3311098437,1672594714,1672596824,2110
3629,3884596900,3512282789,1672635861,1672638815,2954
3591,3276348699,3519087371,1672544783,1672547213,2430
3677,3520764926,3667427125,1672535293,1672538406,3113
3468,3793922324,3224968597,1672574172,1672576540,2368
3660,3441703884,3811075491,1672581397,1672584322,2925
3742,3517172354,3680843171,1672626753,1672628020,1267
3579,3205923620,3778667336,1672695631,1672697176,1545
3657,3621184108,3636329663,1672540086,1672542519,2433
3885,3715974659,3300979975,1672651442,1672654295,2853
3614,3511601997,3792442597,1672691533,1672692868,1335
3680,3850911686,3316798920,1672545936,1672547578,1642
3580,3773009828,3780427126,1672662352,1672665882,3530
3687,3772391882,3387594369,1672626224,1672629545,3321
3611,3977148669,3714827719,1672600327,1672602385,2058
3619,3347446226,3792546035,1672689134,1672691384,2250
3917,3517288083,3617116290,1672606780,1672609201,2421
3864,3714670620,3303410628,1672638978,1672641639,2661
3790,3755573472,3791613604,1672592320,1672595679,3359
3753,3688490530,3303410628,1672548198,1672550784,2586
3574,3520355798,3783928182,1672611402,1672611509,107
3661,3738026330,3408430195,1672700461,1672703254,2793
3814,3402385957,3334974375,1672688271,1672689202,931
3632,3802932312,3305722859,1672531427,1672533109,1682
3648,3336339664,3208957949,1672606768,1672610112,3344
3896,3774718695,3905196766,1672703323,1672703516,193
3748,3309314379,3899786664,1672613410,1672615984,2574
3715,3970558632,3774705415,1672632031,1672634604,2573
3891,3637313265,3613206049,1672632542,1672634826,2284
3545,3710489491,3417191856,1672545762,1672547723,1961
3740,3534764451,3703798634,1672675511,1672679005,3494
3700,3512392431,3714185969,1672699167,1672702234,3067
3660,3513296868,3515559913,1672651919,1672653796,1877
3842,3514285803,3514818819,1672624916,1672625932,1016
3460,3418448389,3905196766,1672636514,1672638479,1965
3660,3509893027,3463849738,1672652255,1672652535,280
3444,3534179433,3626499450,1672558169,1672560170,2001
3719,3279475486,3497671225,1672548142,1672549142,1000
3451,3735374579,3509756823,1672655855,1672656790,935
3585,3609881958,3928719932,1672619897,1672621722,1825
3849,3774718695,3534543776,1672694025,1672696448,2423
3903,3703383853,3367971170,1672598038,1672600597,2559
3560,3928511283,3520764926,1672542422,1672543427,1005
3758,3613416045,3520355798,1672559365,1672560772,1407
3459,3626499450,3792274796,1672673212,1672674059,847
3565,3500525825,3412968120,1672599487,1672599868,381
3820,3519028898,3518565331,1672668421,1672668721,300
3784,3534764451,3780115155,1672674005,1672676951,2946
3672,3452016771,3777037426,1672661784,1672663618,1834
3595,3418448389,3495911207,1672607195,1672607766,571
3512,3600876425,3497808662,1672616076,1672617402,1326
3502,3392943173,3757383891,1672535513,1672538581,3068
3607,3779425804,3491684096,1672681644,1672684364,2720
3515,3975717896,3309314379,1672574693,1672575488,795
3672,3519087371,3710562338,1672661441,1672663860,2419
3865,3520991398,3713911104,1672544680,1672544896,216
3659,3833217041,3399518841,1672700892,1672703491,2599
3464,3505923418,3505266860,1672534731,1672536807,2076
3840,3617304541,3972192593,1672618155,1672621638,3483
3616,3792949946,3449333754,1672683976,1672684625,649
3822,3363162590,3734915241,1672701248,1672704450,3202
3746,3392520516,3604589802,1672623636,1672625797,2161
3921,3916490839,3817428320,1672625841,1672625965,124
3726,3515401243,3505179890,1672544679,1672547615,2936
3860,3270056120,3306175858,1672694749,1672697557,2808
3611,3711077927,3793922324,1672551923,1672554495,2572
3534,3431502855,3779301501,1672554732,1672557487,2755
3426,3510964997,3294703680,1672544915,1672546764,1849
3548,3732131656,3349856820,1672703658,1672706812,3154
3885,3773837847,3979784676,1672622486,1672623873,1387
3468,3232208416,3773027597,1672696861,1672698793,1932
3873,3231494505,3392943173,1672606661,1672607229,568
3741,3737147209,3510641433,1672682332,1672682440,108
3920,3380130228,3513853403,1672649143,1672651089,1946
3671,3885121158,3231494505,1672625195,1672625916,721
3812,3783163143,3270042456,1672625500,1672627850,2350
3460,3773009828,3411515369,1672577129,1672580062,2933
3778,3514703118,3240994288,1672609416,1672610687,1271
3910,3609659642,3488763230,1672566685,1672567595,910
3639,3779438325,3711853996,1672574099,1672576940,2841
3464,3518194482,3343816795,1672584459,1672586811,2352
3464,3500072204,3409114719,1672699251,1672699695,444
3447,3731646673,3274831810,1672582810,1672584841,2031
3463,3505266860,3520181148,1672628104,1672631090,2986
3732,3817428320,3429943738,1672649844,1672652288,2444
3892,3755532873,3701424609,1672601689,1672603729,2040
3884,3739895284,3791441520,1672598911,1672601688,2777
3599,3770296583,3334647380,1672669957,1672672354,2397
3468,3514818819,3711077927,1672575114,1672575826,712
3720,3613338363,3777184389,1672532969,1672534100,1131
3727,3311085279,3618808151,1672547965,1672548439,474
3661,3347446226,3202141727,1672696278,1672697402,1124
3724,3349739136,3739661856,1672592223,1672595742,3519
3442,3481640525,3824641227,1672646895,1672649387,2492
3729,3394297564,3755532873,1672662695,1672663197,502
3821,3608232640,3757863420,1672636677,1672639134,2457
3541,3231713082,3389634034,1672543149,1672544066,917
3670,3408498208,3500109249,1672701070,1672703301,2231
3616,3793922324,3520115090,1672663890,1672666252,2362
3801,3779639983,3783520186,1672656142,1672658681,2539
3446,3371455553,3239617320,1672537323,1672539813,2490
3780,3513018485,3776518452,1672562946,1672566498,3552
3683,3336627643,3240994288,1672633487,1672635516,2029
3759,3732131656,3209481722,1672579328,1672582472,3144
3606,3491684096,3737112297,1672663523,1672667077,3554
3549,3905899155,3515890966,1672663432,1672664552,1120
3737,3225636215,3930242012,1672628300,1672629524,1224
3778,3774876004,3402385957,1672534378,1672536522,2144
3807,3514818819,3703798634,1672637849,1672638636,787
3915,3757323954,3244004456,1672577983,1672579563,1580
3745,3520764926,3514275974,1672583544,1672586969,3425
3692,3424660806,3617116290,1672591691,1672592323,632
3529,3713784974,3777624586,1672670676,1672673228,2552
3840,3770676872,3491684096,1672681037,1672681835,798
3552,3834960360,3336339664,1672592884,1672593180,296
3453,3400763927,3336627643,1672544048,1672545395,1347
3553,3516903528,3839245934,1672535984,1672537188,1204
3731,3515402792,3510767239,1672604111,1672605167,1056
3615,3457960571,3701247948,1672567544,1672570298,2754
3876,3760842815,3770468980,1672559432,1672561738,2306
3902,3202804048,3510837901,1672578095,1672578503,408
3628,3776988674,3497095254,1672649883,1672650643,760
3680,3500613459,3685816610,1672658879,1672660322,1443
3761,3783771827,3534829213,1672586523,1672587403,880
3454,3780253901,3852686295,1672695879,1672698932,3053
3456,3335694356,3755496114,1672581853,1672582833,980
3748,3756746867,3783771827,1672692726,1672694344,1618
3602,3556969573,3516444201,1672606175,1672606946,771
3524,3520764926,3889780657,1672575999,1672578967,2968
3491,3703383853,3510642075,1672536860,1672536999,139
3917,3779854934,3296462324,1672533443,1672535804,2361
3507,3755756564,3279473441,1672697868,1672701324,3456
3727,3500498112,3779438325,1672542801,1672544554,1753
3791,3716110860,3777330107,1672574737,1672576939,2202
3535,3783641602,3685816610,1672658830,1672659261,431
3434,3511883730,3793922324,1672648306,1672650005,1699
3778,3497808662,3713163045,1672693735,1672695933,2198
3646,3379143440,3289114629,1672566426,1672566912,486
3479,3424445495,3884596900,1672579907,1672581881,1974
3606,3792949946,3615113018,1672674663,1672675243,580
3509,3689697817,3225631197,1672658796,1672659501,705
3534,3441348818,3505111292,1672577600,1672579150,1550
3462,3514324011,3441703884,1672590875,1672591243,368
3739,3510554314,3711006062,1672531988,1672532817,829
3584,3779532653,3715707380,1672605893,1672607861,1968
3573,3683113954,3609933747,1672687407,1672688874,1467
3836,3618176292,3395201292,1672657481,1672657622,141
3514,3757700712,3777624586,1672616664,1672618327,1663
3754,3220031931,3500827202,1672657505,1672660184,2679
3454,3500709774,3248058676,1672582927,1672583974,1047
3860,3755158925,3512722110,1672689979,1672690184,205
3649,3513081354,3392836218,1672547336,1672549452,2116
3735,3714666884,3514818819,1672626359,1672627050,691
3605,3793740407,3311085279,1672542888,1672544526,1638
3682,3424445495,3360069849,1672631575,1672632410,835
3631,3519087371,3513296868,1672550379,1672553154,2775
3624,3300818269,3777184389,1672554996,1672555591,595
3758,3613206049,3533004959,1672568528,1672568625,97
3876,3393063657,3609933747,1672651392,1672654497,3105
3687,3272096759,3776117322,1672681830,1672685157,3327
3466,3701005527,3777694660,1672553889,1672557328,3439
3654,3449333754,3201800997,1672556415,1672559094,2679
3767,3776559988,3533368789,1672551958,1672552951,993
3744,3534126409,3617304541,1672677498,1672678498,1000
3500,3559731671,3776034743,1672635890,1672638260,2370
3757,3480726047,3920898925,1672606729,1672607106,377
3605,3778040015,3756474459,1672693628,1672696027,2399
3900,3760040019,3500857494,1672560891,1672564213,3322
3615,3710008361,3334647380,1672659178,1672662640,3462
3846,3516703758,3716628503,1672603998,1672605929,1931
3459,3509764635,3209526819,1672592080,1672593362,1282
3553,3519282716,3783136330,1672652599,1672654031,1432
3594,3517881647,3311085279,1672652164,1672655699,3535
3897,3779301501,3517288083,1672701937,1672704551,2614
3439,3839245934,3912891315,1672571214,1672573242,2028
3434,3714827719,3513327337,1672543602,1672547173,3571
3797,3792020993,3713784974,1672654451,1672657830,3379
3788,3380982774,3396980894,1672634191,1672636688,2497
3773,3306175858,3661903000,1672640837,1672643399,2562
3811,3316800320,3505725706,1672597168,1672597383,215
3770,3885121158,3246370118,1672638959,1672639062,103
3670,3923220461,3803517637,1672701484,1672703240,1756
3669,3630353876,3514308235,1672664773,1672664868,95
3607,3714670620,3350095157,1672661922,1672662830,908
3572,3462273042,3621461051,1672583593,1672585092,1499
3575,3902861231,3900276517,1672654422,1672655359,937
3467,3614740489,3660887799,1672587600,1672589616,2016
3490,3773572967,3514971533,1672595995,1672599387,3392
3628,3703798634,3393063657,1672634710,1672636241,1531
3641,3701882224,3834960360,1672570910,1672571641,731
3795,3902861231,3713691388,1672595120,1672596546,1426
3906,3701823816,3379143440,1672643527,1672645403,1876
3914,3270697740,3774790271,1672621941,1672625100,3159
3530,3701373490,3370227921,1672699798,1672702591,2793
3710,3360813161,3819767045,1672656662,1672657896,1234
3495,3300229945,3412006598,1672594179,1672596080,1901
3803,3293835352,3232208416,1672654348,1672657858,3510
3728,3500827202,3450286949,1672616857,1672620284,3427
3797,3519909393,3774641380,1672637503,1672638401,898
3647,3779639983,3517590837,1672541429,1672541864,435
3633,3520639768,3902760230,1672610059,1672613190,3131
3547,3520764926,3780322355,1672535871,1672536934,1063
3634,3512830734,3505888598,1672649829,1672652136,2307
3610,3519850727,3514703118,1672700867,1672703107,2240
3594,3972192593,3817813340,1672589419,1672591634,2215
3509,3400763927,3638204468,1672611079,1672612515,1436
3623,3778667336,3683113954,1672614981,1672615846,865
3854,3271752081,3517991730,1672687046,1672689774,2728
3428,3783169442,3274906650,1672537132,1672539714,2582
3719,3668747074,3977352557,1672611692,1672614792,3100
3746,3701107228,3487875183,1672599060,1672601443,2383
3821,3505923418,3815250107,1672692490,1672693056,566
3813,3533423872,3713300120,1672656714,1672659169,2455
3484,3367509761,3403370192,1672586308,1672586739,431
3430,3384583385,3824641227,1672571620,1672573668,2048
3558,3730071479,3517288083,1672677030,1672678787,1757
3568,3701882224,3511005395,1672697436,1672699077,1641
3439,3770296583,3306412634,1672545722,1672549097,3375
3861,3514246749,3932478321,1672663225,1672663984,759
3440,3513327337,3605221116,1672688713,1672689502,789
3816,3792538417,3408498208,1672562804,1672563561,757
3482,3791046864,3448875382,1672656413,1672659113,2700
3566,3515559913,3334993594,1672537445,1672540735,3290
3876,3510554314,3688220326,1672556842,1672559857,3015
3626,3225636215,3783520186,1672605196,1672606274,1078
3668,3241914067,3312998540,1672676480,1672679050,2570
3734,3736231757,3284947372,1672678945,1672679047,102
3890,3280054198,3445206685,1672544991,1672546481,1490
3653,3755915206,3410160376,1672595168,1672597353,2185
3448,3447514821,3630353876,1672541039,1672542262,1223
3771,3500442734,3915162005,1672564040,1672567364,3324
3470,3383138270,3390660440,1672631942,1672632781,839
3622,3711000597,3533090502,1672587094,1672587546,452
3797,3821054646,3364378127,1672701630,1672704383,2753
3830,3777814504,3559458968,1672560235,1672563108,2873
3597,3360616538,3225631197,1672593715,1672594179,464
3583,3500827202,3730071479,1672562873,1672565573,2700
3450,3803389195,3792442597,1672623293,1672624133,840
3551,3755737419,3732131656,1672560890,1672561583,693
3504,3776988674,3514275974,1672596758,1672598333,1575
3551,3384583385,3390660440,1672640992,1672643100,2108
3625,3511883730,3518565331,1672640218,1672641040,822
3502,3552824113,3928511283,1672672614,1672676187,3573
3711,3631090677,3501384020,1672622125,1672623117,992
3811,3904412440,3334647380,1672622661,1672623543,882
3451,3774718695,3710562338,1672687431,1672687820,389
3819,3517687662,3609881958,1672576663,1672578112,1449
3786,3366423342,3447672935,1672698226,1672700403,2177
3725,3209526819,3776084820,1672701418,1672702527,1109
3564,3360069849,3793407963,1672599065,1672599834,769
3551,3511843593,3714128600,1672691095,1672693067,1972
3433,3445206685,3710496785,1672651643,1672653748,2105
3715,3517222913,3808136029,1672608302,1672609964,1662
3807,3757193551,3461119815,1672539745,1672542901,3156
3624,3201676087,3912891315,1672548909,1672549625,716
3477,3519087371,3703348097,1672652226,1672654774,2548
3644,3401793306,3885537225,1672622909,1672623488,579
3655,3300979975,3760721303,1672610109,1672613408,3299
3572,3500915908,3626499450,1672662423,1672665931,3508
3742,3519077659,3613206049,1672595592,1672596380,788
3544,3514703118,3441348818,1672564683,1672568258,3575
3878,3613581796,3510767239,1672609983,1672610531,548
3430,3534829213,3783136330,1672656424,1672657702,1278
3520,3779613523,3487875183,1672591720,1672591972,252
3788,3715707380,3383138270,1672537406,1672537540,134
3573,3904867554,3231494505,1672650250,1672651091,841
3611,3737112297,3373089838,1672562671,1672564554,1883
3746,3755737419,3811040565,1672671106,1672673443,2337
3606,3755222916,3792546035,1672657754,1672661169,3415
3537,3757903168,3801645328,1672617119,1672618981,1862
3830,3931627862,3715619259,1672666804,1672668265,1461
3676,3714185969,3773572967,1672664948,1672665306,358
3539,3776034743,3517687662,1672653026,1672654642,1616
3660,3710489491,3617392620,1672542394,1672544173,1779
3877,3375449013,3890739241,1672636883,1672638001,1118
3672,3226511603,3360069849,1672567664,1672571160,3496
3723,3392520516,3497095254,1672583772,1672586481,2709
3491,3618697021,3618808151,1672549175,1672552511,3336
3770,3462636434,3441703884,1672596290,1672597992,1702
3842,3850911686,3225636215,1672600626,1672602220,1594
3919,3500072204,3778134418,1672595309,1672595639,330
3704,3701424609,3236499444,1672568706,1672572098,3392
3762,3459681410,3609113156,1672659406,1672660443,1037
3478,3520657891,3276217799,1672545829,1672546409,580
3529,3288224595,3299443125,1672697639,1672700288,2649
3450,3276269264,3533649454,1672547431,1672549760,2329
3715,3500302272,3518561777,1672670260,1672672185,1925
3798,3807212280,3271752081,1672697895,1672698187,292
3877,3783919913,3338390596,1672703927,1672705765,1838
3752,3715854030,3824215187,1672694972,1672697125,2153
3852,3551376095,3615688740,1672606861,1672609850,2989
3791,3501384020,3276348699,1672663559,1672666740,3181
3911,3815250107,3308760650,1672537681,1672540618,2937
3764,3776518452,3418448389,1672628026,1672630499,2473
3863,3511601997,3757903168,1672550062,1672551954,1892
3632,3890739241,3792014516,1672548517,1672551630,3113
3490,3760640999,3713941638,1672676403,1672677003,600
3766,3367111751,3516298579,1672694049,1672695187,1138
3542,3461119815,3710048469,1672557303,1672558963,1660
3610,3834960360,3360069849,1672689921,1672692296,2375
3502,3780322355,3467779445,1672588648,1672590244,1596
3716,3309314379,3703798634,1672644342,1672647090,2748
3536,3403370192,3283492940,1672538905,1672542321,3416
3769,3224968597,3885121158,1672620371,1672622777,2406
3473,3283144118,3513345163,1672584312,1672586976,2664
3672,3517697722,3511150845,1672658146,1672661374,3228
3521,3467988782,3373089838,1672619976,1672621169,1193
3669,3309314379,3660063072,1672633910,1672635973,2063
3783,3624297844,3979802715,1672607475,1672607798,323
3775,3852533643,3701884158,1672654352,1672655988,1636
3678,3621790707,3885121158,1672640289,1672642953,2664
3466,3516513251,3897134762,1672677947,1672679574,1627
3921,3389634034,3501457103,1672628454,1672629615,1161
3457,3509893027,3311049964,1672589070,1672591153,2083
3638,3770520359,3774605761,1672663530,1672665212,1682
3648,3829822608,3803517637,1672700626,1672702178,1552
3618,3475349791,3915162005,1672668969,1672671376,2407
3756,3777037426,3710735406,1672574183,1672575586,1403
3708,3460719322,3792072681,1672671736,1672674161,2425
3570,3738026330,3276003502,1672549110,1672551786,2676
3832,3505481368,3293835352,1672605077,1672606529,1452
3499,3819767045,3688220326,1672620544,1672623192,2648
3919,3757348722,3534357694,1672627500,1672628906,1406
3848,3518653080,3202141727,1672703515,1672705365,1850
3863,3478114114,3688220326,1672672038,1672673812,1774
3469,3639050419,3778134418,1672611918,1672615125,3207
3512,3714827719,3399472693,1672552897,1672553455,558
3595,3793883863,3783615982,1672615275,1672617578,2303
3791,3612689556,3488686442,1672666404,1672667069,665
3845,3618489670,3686227677,1672624762,1672625346,584
3662,3667673649,3778597171,1672579941,1672582007,2066
3593,3512958459,3615737355,1672687518,1672689113,1595
3512,3505198734,3480991549,1672599887,1672602977,3090
3538,3777694660,3276348699,1672636194,1672637013,819
3856,3337322736,3755222916,1672701755,1672704275,2520
3546,3773027597,3240994288,1672587489,1672590628,3139
3839,3632814465,3756127300,1672594171,1672597390,3219
3720,3500302272,3291933594,1672668005,1672671310,3305
3888,3390660440,3938503547,1672659310,1672660671,1361
3911,3501567772,3299443125,1672553143,1672553375,232
3915,3825881598,3736231757,1672572390,1672574048,1658
3652,3780472203,3604589802,1672660498,1672662849,2351
3795,3201676087,3703383853,1672633238,1672635751,2513
3813,3229974066,3520416075,1672598217,1672599171,954
3642,3316800320,3608922867,1672678904,1672680494,1590
3575,3638660068,3520764926,1672571336,1672574871,3535
3619,3774705415,3534566651,1672676247,1672676898,651
3780,3715854030,3505228454,1672695740,1672697322,1582
3853,3779646172,3703798634,1672587363,1672589023,1660
3480,3777814504,3470454332,1672596282,1672597328,1046
3455,3336339664,3757903168,1672669159,1672669326,167
3841,3514419100,3609113156,1672591571,1672592073,502
3493,3885121158,3534357694,1672646685,1672647833,1148
3869,3608232640,3887243870,1672665280,1672665951,671
3501,3777184389,3772236797,1672658962,1672660390,1428
3575,3480490124,3979784676,1672693734,1672693925,191
3585,3609933747,3500827202,1672614738,1672615997,1259
3586,3885155975,3604589802,1672551599,1672551700,101
3427,3271752081,3336339664,1672654200,1672656745,2545
3839,3512882178,3756746867,1672602344,1672604014,1670
3689,3239617320,3711734586,1672563203,1672566622,3419
3733,3428725843,3928719932,1672701774,1672703469,1695
3662,3834631333,3661903000,1672633399,1672633728,329
3785,3615115210,3246370118,1672599233,1672601026,1793
3858,3513345163,3231713082,1672694845,1672698092,3247
3552,3467988782,3429943738,1672536770,1672540069,3299
3914,3421385957,3737112297,1672584339,1672587655,3316
3830,3384583385,3701136026,1672620183,1672623367,3184
3643,3490029863,3533090502,1672579362,1672581316,1954
3482,3701424609,3518194482,1672639237,1672640192,955
3838,3402697190,3505178849,1672703190,1672706137,2947
3554,3380767040,3772391882,1672597738,1672597839,101
3577,3701424609,3733363628,1672619154,1672619334,180
3889,3912891315,3475349791,1672559607,1672560902,1295
3575,3343816795,3734915241,1672568363,1672568576,213
3661,3448875382,3288224595,1672613769,1672617044,3275
3862,3534764451,3520115090,1672630871,1672632194,1323
3867,3299781901,3270056120,1672627060,1672628915,1855
3542,3777330107,3349856820,1672698626,1672700946,2320
3856,3511005395,3517991730,1672536956,1672538366,1410
3851,3779646172,3513018485,1672642187,1672642676,489
3596,3760721303,3636329663,1672615198,1672616166,968
3428,3519282716,3428725843,1672584944,1672587556,2612
3680,3783520186,3817813340,1672697286,1672699210,1924
3439,3935913584,3824641227,1672533388,1672533920,532
3769,3770704999,3404025196,1672555722,1672558873,3151
3855,3701424609,3793418209,1672621254,1672622683,1429
3451,3512958459,3505402439,1672684814,1672687316,2502
3812,3738026330,3774790271,1672565986,1672569101,3115
3585,3906536154,3513410578,1672584464,1672586876,2412
3807,3495911207,3783928182,1672567175,1672568109,934
3588,3375449013,3774641380,1672569209,1672570654,1445
3656,3791046864,3364726656,1672693409,1672694325,916
3832,3819767045,3887243870,1672535334,1672538611,3277
3861,3248058676,3774876004,1672691912,1672695327,3415
3756,3244004456,3534179433,1672668523,1672671126,2603
3801,3935913584,3895285664,1672554167,1672555372,1205
3786,3730071479,3534357694,1672549190,1672550937,1747
3911,3512502036,3710489491,1672615261,1672618115,2854
3714,3711077927,3509764635,1672574112,1672576822,2710
3759,3760924079,3505402439,1672531488,1672532943,1455
3607,3778134418,3829864515,1672656329,1672656911,582
3795,3310039260,3638204468,1672553273,1672553910,637
3647,3779465522,3283770991,1672581686,1672581829,143
3504,3231494505,3906536154,1672550357,1672553608,3251
3698,3801645328,3451326054,1672576227,1672576859,632
3582,3459681410,3500109249,1672609024,1672610709,1685
3727,3512882178,3270056120,1672677303,1672678981,1678
3686,3920625129,3772765746,1672578032,1672578442,410
3854,3734451191,3792745809,1672626801,1672630267,3466
3616,3778134418,3684523966,1672683969,1672687092,3123
3840,3685681577,3715707380,1672617929,1672619136,1207
3877,3793969543,3621461051,1672656816,1672657326,510
3445,3232208416,3778667336,1672684251,1672686682,2431
3787,3778926763,3410600350,1672579126,1672579643,517
3861,3780209375,3774876004,1672648965,1672650274,1309
3742,3923754072,3780322355,1672573756,1672574797,1041
3886,3711734586,3777779869,1672559721,1672560550,829
3756,3308760650,3793868716,1672672847,1672673617,770
3666,3760263530,3404025196,1672532816,1672536297,3481
3578,3500442734,3755992176,1672674556,1672676463,1907
3854,3620292035,3305722859,1672565203,1672567047,1844
3748,3920625129,3347446226,1672681606,1672682381,775
3577,3905899155,3311498666,1672615882,1672619000,3118
3618,3500672156,3559458968,1672551248,1672554198,2950
3719,3770236215,3509483172,1672553058,1672555434,2376
3651,3436257398,3533294425,1672561825,1672563656,1831
3570,3510798825,3240394404,1672659752,1672662512,2760
3516,3520115090,3500709774,1672660435,1672662204,1769
3544,3520355798,3979802715,1672584365,1672584448,83
3545,3516703758,3714067076,1672639037,1672642614,3577
3671,3856606678,3713768950,1672592687,1672595922,3235
3542,3755158925,3915162005,1672641707,1672642604,897
3515,3511442562,3605221116,1672576374,1672576929,555
3450,3334647380,3495911207,1672634850,1672638303,3453
3426,3368283077,3970627281,1672614901,1672615552,651
3556,3714120857,3895285664,1672659003,1672659126,123
3447,3711077927,3238288884,1672565166,1672566846,1680
3434,3792525861,3351866415,1672615371,1672617638,2267
3894,3399472693,3826238375,1672669978,1672670928,950
3684,3783771827,3783136330,1672615840,1672618729,2889
3424,3631479562,3500604680,1672574942,1672576973,2031
3432,3617489344,3715400486,1672551919,1672554780,2861
3626,3519446663,3414275042,1672601444,1672601864,420
3819,3755573472,3715619259,1672650052,1672652156,2104
3587,3335694356,3500857494,1672602770,1672603924,1154
3630,3792546035,3520639768,1672602449,1672605052,2603
3818,3757863420,3783433404,1672659724,1672659956,232
3499,3756474459,3370227921,1672657971,1672658115,144
3776,3739911441,3925979970,1672540355,1672541394,1039
3586,3714120857,3715400486,1672607994,1672610297,2303
3773,3930242012,3600876425,1672546805,1672548711,1906
3466,3621790707,3607768197,1672587658,1672588290,632
3566,3270697740,3792525861,1672695061,1672696257,1196
3764,3755573472,3360069849,1672664008,1672664754,746
3831,3779613523,3421877923,1672666848,1672667715,867
3508,3791441520,3232208416,1672686880,1672690149,3269
3737,3240394404,3510798825,1672697092,1672697969,877
3561,3509764635,3311085279,1672702752,1672705817,3065
3762,3833217041,3270056120,1672570844,1672573533,2689
3756,3551389192,3241790910,1672686895,1672687211,316
3674,3622357348,3512337405,1672696463,1672698124,1661
3556,3736231757,3635169815,1672574184,1672575917,1733
3867,3639050419,3755158925,1672665350,1672668468,3118
3626,3853629553,3912891315,1672676193,1672677156,963
3551,3330340793,3780253901,1672581703,1672583052,1349
3457,3351696332,3711853996,1672536908,1672537258,350
3617,3534357694,3793407963,1672614214,1672615105,891
3900,3272716462,3774605761,1672657155,1672658226,1071
3660,3669146016,3760364383,1672631270,1672632497,1227
3676,3710854064,3792546035,1672579506,1672581237,1731
3799,3311498666,3409114719,1672578423,1672581645,3222
3520,3604589802,3534829213,1672539091,1672541086,1995
3724,3338083680,3398198430,1672647543,1672647987,444
3574,3774641380,3534566651,1672550585,1672552284,1699
3778,3519909393,3688796737,1672632531,1672635367,2836
3737,3208452238,3774907131,1672703786,1672706829,3043
3763,3513410578,3310125159,1672549439,1672551394,1955
3863,3505111292,3835422146,1672550481,1672551660,1179
3574,3292147449,3607768197,1672540754,1672543925,3171
3685,3823084403,3780834916,1672568927,1672571348,2421
3459,3783550022,3472068734,1672618245,1672619917,1672
3748,3374183227,3390660440,1672626455,1672626990,535
3864,3773121782,3715086894,1672566932,1672567119,187
3556,3284947372,3311420950,1672561584,1672564849,3265
3880,3480991549,3517222913,1672654889,1672655800,911
3604,3533747868,3505434346,1672535588,1672538619,3031
3706,3756625818,3776117322,1672542836,1672544220,1384
3839,3733363628,3661583097,1672580107,1672583385,3278
3779,3926643445,3791796585,1672633861,1672634983,1122
3598,3856606678,3500737582,1672642827,1672644635,1808
3505,3517991730,3756704774,1672621886,1672624574,2688
3804,3205923620,3294703680,1672611151,1672612188,1037
3478,3685816610,3520181148,1672559552,1672560618,1066
3751,3437286517,3618808151,1672678761,1672678864,103
3528,3780571086,3517737088,1672568813,1672571420,2607
3882,3779639983,3443357683,1672575232,1672576031,799
3835,3516489668,3279475486,1672606160,1672607945,1785
3428,3777147510,3757630221,1672571631,1672571887,256
3824,3812534508,3410600350,1672674747,1672675929,1182
3483,3333403880,3447672935,1672549857,1672550098,241
3788,3814305099,3618354185,1672668831,1672668957,126
3695,3520991398,3505283390,1672691129,1672693890,2761
3581,3451691949,3618176292,1672579746,1672581280,1534
3608,3490029863,3711077927,1672577582,1672580243,2661
3526,3488686442,3510964997,1672638752,1672639519,767
3818,3703383853,3380982774,1672637297,1672640210,2913
3856,3701823816,3770520359,1672699613,1672699693,80
3707,3470454332,3856606678,1672684080,1672684564,484
3557,3713768950,3455018347,1672687024,1672687376,352
3471,3347446226,3774243020,1672575239,1672578793,3554
3473,3336627643,3716963089,1672608649,1672611413,2764
3583,3411515369,3279475486,1672626543,1672628987,2444
3503,3417191856,3509366311,1672586169,1672587969,1800
3686,3462158237,3826238375,1672651218,1672652829,1611
3452,3468041839,3315703693,1672556233,1672556350,117
3906,3780769110,3505923418,1672684508,1672685400,892
3463,3333403880,3792489602,1672558233,1672558398,165
3826,3757323954,3315703693,1672698905,1672699205,300
3915,3613338363,3336627643,1672650935,1672652748,1813
3704,3205985903,3632814465,1672546439,1672547742,1303
3857,3618354185,3773121782,1672584394,1672584711,317
3751,3715086894,3225029895,1672552016,1672553671,1655
3824,3240394404,3637313265,1672535172,1672537788,2616
3659,3779738691,3501786419,1672571442,1672574528,3086
3555,3439673892,3468041839,1672668003,1672668574,571
3722,3296462324,3421877923,1672698959,1672702534,3575
3776,3510818674,3505178849,1672534973,1672538200,3227
3701,3793935736,3236354255,1672656429,1672659725,3296
3824,3757075324,3500613493,1672679394,1672679862,468
3533,3303410628,3513065217,1672598400,1672598570,170
3629,3511024016,3519077659,1672589281,1672590363,1082
3570,3792072681,3414275042,1672602594,1672605834,3240
3880,3780571086,3519282716,1672689052,1672691177,2125
3429,3793743698,3533423872,1672619032,1672621701,2669
3482,3450286949,3773735484,1672645707,1672648318,2611
3638,3512337405,3703396825,1672581805,1672583862,2057
3660,3853629553,3770520359,1672563877,1672566836,2959
3672,3512502036,3920625129,1672621985,1672624187,2202
3581,3416987084,3533294425,1672569317,1672571278,1961
3720,3931627862,3928719932,1672671885,1672672596,711
3564,3710562338,3408498208,1672597628,1672599789,2161
3432,3229974066,3497808662,1672614435,1672615720,1285
3723,3902760230,3755404116,1672600470,1672602197,1727
3424,3236499444,3510028805,1672629969,1672631684,1715
3915,3520181148,3205985903,1672564248,1672565422,1174
3720,3274831810,3515402792,1672598724,1672600723,1999
3527,3505521218,3505283390,1672556011,1672559368,3357
3822,3509756823,3511791953,1672609630,1672610862,1232
3530,3755848152,3777694660,1672632765,1672634425,1660
3429,3519142371,3755992176,1672637488,1672640800,3312
3635,3618354185,3288224595,1672659681,1672662331,2650
3889,3514703118,3970558632,1672569951,1672570159,208
3426,3686523546,3231494505,1672613955,1672617279,3324
3749,3617489344,3803517637,1672666191,1672668537,2346
3703,3512499658,3337362061,1672622643,1672625919,3276
3821,3551376095,3757630221,1672601289,1672604606,3317
3507,3500672156,3519818818,1672696831,1672699328,2497
3785,3760362417,3716679950,1672683505,1672685616,2111
3471,3613338363,3900898992,1672668255,1672671748,3493
3856,3792072681,3534764451,1672652692,1672655187,2495
3755,3414940786,3734915241,1672656792,1672660313,3521
3717,3330340793,3970198861,1672546121,1672547520,1399
3440,3306412634,3608922867,1672572450,1672574980,2530
3874,3338390596,3497808662,1672584964,1672586096,1132
3513,3554186380,3501525100,1672683112,1672683774,662
3484,3928719932,3618176292,1672603058,1672606126,3068
3860,3385323994,3500109249,1672560427,1672562928,2501
3805,3450969839,3367971170,1672578164,1672581339,3175
3820,3436257398,3462273042,1672660361,1672661231,870
3763,3756704774,3304971369,1672564779,1672567723,2944
3754,3615688740,3971806004,1672575311,1672576250,939
3462,3231713082,3448875382,1672617391,1672619086,1695
3817,3487875183,3783373154,1672570106,1672570809,703
3576,3512800570,3272096759,1672621406,1672623632,2226
3687,3668533536,3499217428,1672646944,1672649910,2966
3751,3772391882,3519651506,1672569949,1672573347,3398
3917,3779465522,3421877923,1672540999,1672542636,1637
3450,3533294425,3773837847,1672677011,1672678292,1281
3813,3533274994,3792546035,1672591507,1672592595,1088
3472,3608922867,3737147209,1672561698,1672565094,3396
3694,3509893027,3972192593,1672699235,1672700861,1626
3464,3272030610,3834960360,1672620291,1672622722,2431
3754,3383138270,3897134762,1672667223,1672670075,2852
3556,3610870949,3551376095,1672554832,1672555972,1140
3867,3938389661,3279475486,1672584639,1672587964,3325
3808,3680810086,3517462308,1672640372,1672640777,405
3785,3793935736,3792538417,1672682404,1672682513,109
3799,3375449013,3880926355,1672618818,1672622349,3531
3540,3791046864,3513296868,1672550296,1672552560,2264
3663,3467779445,3638660068,1672578056,1672578567,511
3729,3554186380,3825881598,1672594707,1672596815,2108
3907,3201800997,3514818819,1672563713,1672565043,1330
3692,3773121782,3343132529,1672628841,1672632112,3271
3427,3668533536,3334647380,1672546072,1672548834,2762
3832,3450286949,3336339664,1672661756,1672662299,543
3611,3815392801,3800257590,1672594951,1672595789,838
3541,3511150845,3897134762,1672575188,1672577244,2056
3839,3515402792,3440107959,1672569201,1672570123,922
3514,3491684096,3710496785,1672676807,1672678775,1968
3730,3735374579,3885121158,1672672368,1672672722,354
3576,3289817992,3310125159,1672598362,1672601237,2875
3449,3291933594,3638204468,1672688345,1672690510,2165
3852,3511732493,3914691363,1672669144,1672669773,629
3581,3791436104,3607882826,1672535881,1672537699,1818
3706,3533004959,3715854030,1672555608,1672558753,3145
3743,3756385685,3890739241,1672651009,1672653600,2591
3472,3487875183,3779438325,1672581394,1672582914,1520
3507,3625463628,3619922891,1672623141,1672624720,1579
3807,3792525861,3367971170,1672697666,1672698399,733
3780,3334951866,3500841914,1672633374,1672634975,1601
3670,3715545685,3783771827,1672565351,1672568065,2714
3602,3373089838,3492959689,1672532541,1672535479,2938
3678,3778597171,3410538749,1672700712,1672701591,879
3845,3500841914,3375449013,1672542441,1672545212,2771
3865,3689114185,3836241528,1672606044,1672609399,3355
3858,3791693821,3755496114,1672642367,1672645573,3206
3898,3829822608,3710562338,1672694598,1672696053,1455
3674,3414275042,3773124276,1672655787,1672658279,2492
3584,3773572967,3491684096,1672697890,1672700758,2868
3479,3774178201,3421877923,1672544911,1672544987,76
3630,3500841914,3500302272,1672632935,1672636380,3445
3848,3533188828,3401793306,1672541365,1672544942,3577
3701,3451326054,3793781065,1672674441,1672677403,2962
3692,3414940786,3500949309,1672545478,1672546827,1349
3792,3890739241,3500044458,1672655105,1672657013,1908
3503,3938503547,3505634634,1672562777,1672564445,1668
3845,3823084403,3773009828,1672609799,1672612843,3044
3700,3791441520,3757075324,1672685605,1672687560,1955
3432,3613581796,3668414677,1672533334,1672533770,436
3478,3934064792,3756746867,1672682045,1672684606,2561
3466,3461119815,3533090502,1672680098,1672681342,1244
3572,3360069849,3505923418,1672561786,1672564351,2565
3726,3519028898,3808136029,1672674789,1672675003,214
3624,3853629553,3501459390,1672613731,1672616210,2479
3612,3885537225,3778667336,1672611625,1672611790,165
3586,3304971369,3711812325,1672572446,1672574206,1760
3675,3274831810,3760842815,1672684596,1672685748,1152
3624,3501786419,3760094385,1672688930,1672692165,3235
3856,3793583656,3777330107,1672542942,1672545353,2411
3866,3248058676,3974674109,1672580517,1672583311,2794
3803,3714067076,3928719932,1672589620,1672590715,1095
3837,3516903528,3513018485,1672702802,1672705029,2227
3779,3774641380,3454277788,1672646796,1672648337,1541
3556,3349739136,3410600350,1672700385,1672701833,1448
3921,3510767239,3516444201,1672593263,1672594190,927
3796,3783550022,3757903168,1672591203,1672593484,2281
3428,3518565331,3791753345,1672586074,1672589005,2931
3654,3517172354,3935487534,1672580755,1672583855,3100
3742,3638204468,3977148669,1672566976,1672569122,2146
3919,3783136330,3714827719,1672531452,1672534903,3451
3648,3688220326,3783163143,1672685870,1672686642,772
3465,3518229776,3716679950,1672679580,1672681294,1714
3610,3520560590,3756789525,1672651578,1672652749,1171
3849,3621790707,3513081354,1672556991,1672559796,2805
3638,3337362061,3773332082,1672623125,1672624474,1349
3759,3248058676,3284932450,1672675325,1672678822,3497
3584,3505228454,3792745809,1672627236,1672630819,3583
3850,3336627643,3517881647,1672635039,1672636101,1062
3612,3310039260,3371455553,1672582816,1672583501,685
3840,3889780657,3512946768,1672689493,1672690690,1197
3865,3776034743,3512295534,1672585935,1672588737,2802
3480,3514334067,3779656423,1672586347,1672588227,1880
3818,3935487534,3755756564,1672661975,1672663153,1178
3424,3902861231,3500613459,1672616632,1672618847,2215
3501,3777485931,3299125059,1672662812,1672663957,1145
3904,3893912331,3755344363,1672682155,1672682885,730
3460,3925979970,3363162590,1672580478,1672583304,2826
3787,3621461051,3557046880,1672571198,1672573825,2627
3858,3667673649,3409114719,1672689420,1672690242,822
3728,3351866415,3399518841,1672703375,1672703856,481
3893,3557046880,3812369928,1672536970,1672538327,1357
3436,3475349791,3625174002,1672625438,1672626625,1187
3540,3928719932,3793868716,1672622343,1672622844,501
3483,3333403880,3385323994,1672624971,1672628096,3125
3625,3770438122,3792274796,1672605329,1672607570,2241
3862,3306175858,3839245934,1672596128,1672598544,2416
3855,3902625986,3505725706,1672566108,1672569700,3592
3874,3779854934,3510964997,1672665870,1672666499,629
3894,3385323994,3779738691,1672537253,1672538120,867
3808,3398731252,3457960571,1672562930,1672565714,2784
3866,3889780657,3557046880,1672651396,1672651766,370
3891,3680810086,3491469603,1672626960,1672628161,1201
3578,3812534508,3774641380,1672585561,1672588236,2675
3696,3511601997,3791046864,1672531773,1672534589,2816
3882,3817813340,3505521218,1672681533,1672683839,2306
3598,3774907131,3713691388,1672561965,1672563467,1502
3611,3760040019,3304971369,1672693655,1672695590,1935
3476,3410600350,3392520516,1672701858,1672704381,2523
3769,3534829213,3246370118,1672657399,1672657682,283
3833,3272716462,3279242917,1672575514,1672578408,2894
3635,3519909393,3776117322,1672569652,1672571613,1961
3737,3448633776,3510798825,1672679722,1672682972,3250
3765,3618176292,3776084820,1672598025,1672598780,755
3478,3384583385,3920497528,1672604090,1672605429,1339
3533,3716679950,3500525825,1672552123,1672554198,2075
3769,3783550022,3780571086,1672576301,1672576376,75
3622,3505923418,3396726504,1672540656,1672541503,847
3599,3400069268,3756625818,1672635103,1672635713,610
3534,3617116290,3363162590,1672689010,1672689772,762
3898,3512722110,3554944414,1672674575,1672676153,1578
3521,3780338697,3514818819,1672670933,1672673123,2190
3882,3351696332,3511150845,1672539735,1672540570,835
3820,3791693821,3930242012,1672670105,1672672615,2510
3634,3902760230,3755158925,1672548855,1672550666,1811
3522,3774790271,3793175445,1672632596,1672634480,1884
3694,3885121158,3783801141,1672534274,1672534909,635
3440,3414049538,3480991549,1672677198,1672680783,3585
3665,3516741440,3920898925,1672545059,1672545174,115
3833,3770520359,3737112297,1672680434,1672680614,180
3825,3975717896,3347446226,1672597457,1672599163,1706
3768,3449333754,3889780657,1672619472,1672621964,2492
3841,3928719932,3621683102,1672582884,1672584306,1422
3439,3777091903,3300818269,1672625717,1672627404,1687
3457,3774907131,3780571086,1672582484,1672585239,2755
3750,3441348818,3447672935,1672541946,1672542923,977
3661,3511150845,3512946768,1672617162,1672617577,415
3558,3792801638,3779938251,1672683329,1672683422,93
3658,3701107228,3792525861,1672605901,1672606316,415
3817,3510818674,3505437712,1672573554,1672575760,2206
3646,3703139663,3389634034,1672684826,1672686175,1349
3554,3713691388,3938503547,1672665820,1672667616,1796
3524,3519142371,3791106564,1672672937,1672673554,617
3836,3636329663,3776244398,1672692160,1672693750,1590
3785,3518194482,3514703118,1672686951,1672688461,1510
3617,3680843171,3755756564,1672605398,1672607316,1918
3862,3779786641,3760651515,1672565940,1672567596,1656
3571,3793922324,3811075491,1672663820,1672665194,1374
3740,3770520359,3780571086,1672559536,1672561961,2425
3730,3440107959,3615737355,1672585843,1672588625,2782
3834,3902760230,3475349791,1672623563,1672626243,2680
3723,3284947372,3497808662,1672546135,1672549046,2911
3709,3715545685,3688796737,1672655433,1672656011,578
3478,3443357683,3760364383,1672666388,1672669401,3013
3584,3534175249,3776518452,1672651698,1672651941,243
3818,3501459390,3685816610,1672583900,1672586890,2990
3646,3512383699,3757700712,1672693683,1672694482,799
3650,3791436104,3853629553,1672600987,1672601274,287
3821,3777694660,3510798825,1672544391,1672545004,613
3886,3890739241,3760040019,1672595619,1672596867,1248
3635,3371455553,3451726367,1672551967,1672553936,1969
3815,3236354255,3701005527,1672616608,1672618136,1528
3743,3930242012,3501459390,1672678496,1672681838,3342
3426,3415833929,3205985903,1672597379,1672597976,597
3775,3757630221,3889780657,1672657813,1672660696,2883
3903,3390660440,3517358573,1672685594,1672686568,974
3864,3701005527,3779854934,1672676056,1672676931,875
3672,3505663516,3927403123,1672544260,1672546577,2317
3785,3402385957,3520181148,1672550282,1672553600,3318
3652,3383138270,3770236215,1672620132,1672620799,667
3793,3424445495,3792389522,1672543278,1672546528,3250
3471,3515439826,3715619259,1672616869,1672617561,692
3546,3613581796,3492546679,1672541036,1672543434,2398
3732,3510798825,3689114185,1672605826,1672609110,3284
3451,3661583097,3623266256,1672686240,1672688654,2414
3890,3760640999,3818575661,1672564639,1672566850,2211
3902,3711919537,3511601997,1672640250,1672641527,1277
3607,3660063072,3734915241,1672649355,1672652587,3232
3491,3780338697,3714128600,1672553627,1672555190,1563
3894,3792801638,3817428320,1672699152,1672702589,3437
3744,3228888030,3511005395,1672686899,1672690217,3318
3917,3517462308,3492959689,1672541823,1672543915,2092
3504,3783615982,3760651515,1672597299,1672598648,1349
3845,3495911207,3928511283,1672651553,1672651878,325
3577,3520322124,3715619259,1672584161,1672584814,653
3534,3500442734,3462158237,1672532593,1672535646,3053
3792,3309314379,3734915241,1672549943,1672551054,1111
3489,3792389522,3399518841,1672635779,1672636865,1086
3762,3533274994,3276003502,1672631440,1672633787,2347
3875,3520578796,3613581796,1672629829,1672633384,3555
3466,3755344363,3792505974,1672641441,1672642210,769
3722,3777330107,3792505974,1672537297,1672539636,2339
3890,3490029863,3897376951,1672539089,1672541486,2397
3427,3778640261,3285204083,1672580942,1672582976,2034
3862,3441348818,3621790707,1672633192,1672635767,2575
3714,3923754072,3791753345,1672651787,1672655308,3521
3655,3791796585,3500672156,1672599152,1672599889,737
3540,3510919821,3760645796,1672638430,1672641980,3550
3812,3760694096,3792274796,1672532008,1672535392,3384
3917,3792538417,3734451191,1672685524,1672686629,1105
3866,3802932312,3773902805,1672657684,1672658257,573
3461,3511843593,3384068080,1672589846,1672592966,3120
3463,3380767040,3780253901,1672691232,1672694278,3046
3805,3372223551,3515401243,1672667312,1672668739,1427
3709,3839245934,3833217041,1672633068,1672636225,3157
3650,3437286517,3490029863,1672626240,1672628564,2324
3882,3280054198,3292147449,1672596327,1672599018,2691
3822,3780680950,3497095254,1672574474,1672575557,1083
3859,3783771827,3203538212,1672573582,1672575218,1636
3885,3703383853,3607768197,1672623855,1672625443,1588
3591,3500109249,3914691363,1672586189,1672589301,3112
3717,3710735406,3730071479,1672559738,1672561074,1336
3541,3398198430,3517600136,1672587588,1672590130,2542
3887,3402697190,3515466096,1672569701,1672571627,1926
3681,3202804048,3367111751,1672560485,1672563537,3052
3532,3296462324,3552824113,1672701106,1672702158,1052
3624,3793969543,3972192593,1672616646,1672620134,3488
3826,3756385685,3925979970,1672565685,1672568643,2958
3825,3390660440,3780322355,1672578653,1672582098,3445
3733,3760640999,3685816610,1672660913,1672662096,1183
3442,3897435944,3777779869,1672673764,1672674475,711
3506,3793868716,3685816610,1672566086,1672566158,72
3844,3517881647,3510919821,1672658568,1672660837,2269
3603,3436257398,3793740407,1672543135,1672544552,1417
3855,3783136330,3885155975,1672535604,1672537364,1760
3657,3500857494,3393063657,1672569022,1672570852,1830
3843,3288224595,3457620713,1672538694,1672541607,2913
3654,3501121099,3245232284,1672595526,1672597896,2370
3432,3230868435,3311420950,1672654593,1672657392,2799
3665,3756474459,3306412634,1672550708,1672553705,2997
3684,3480991549,3779532653,1672576143,1672576310,167
3693,3779639983,3412006598,1672548524,1672550648,2124
3485,3518565331,3517288083,1672585840,1672588282,2442
3556,3914691363,3711637255,1672686112,1672688364,2252
3555,3488763230,3500604680,1672657246,1672659754,2508
3426,3923754072,3974674109,1672652318,1672652885,567
3514,3519818818,3755158925,1672666022,1672667004,982
3732,3622665543,3757294769,1672541900,1672542105,205
3862,3737972328,3607768197,1672633327,1672636856,3529
3466,3627368399,3276348699,1672625739,1672627655,1916
3558,3271454397,3791106564,1672587767,1672588916,1149
3534,3770676872,3336627643,1672534528,1672535124,596
3589,3519087371,3509893027,1672610480,1672610885,405
3688,3226178937,3279473441,1672582932,1672586320,3388
3804,3291933594,3412968120,1672634816,1672638354,3538
3913,3511024016,3710315160,1672614909,1672618436,3527
3691,3624297844,3760640999,1672597674,1672600415,2741
3878,3609881958,3773124276,1672565445,1672568836,3391
3608,3716110860,3505437712,1672659067,1672659788,721
3778,3779656423,3513345163,1672692664,1672694546,1882
3766,3280054198,3435116799,1672554125,1672557112,2987
3448,3510554314,3231713082,1672554489,1672555152,663
3448,3396980894,3409114719,1672553748,1672554594,846
3754,3792274796,3773332082,1672553568,1672556233,2665
3428,3357864626,3513065217,1672668791,1672672193,3402
3912,3519850727,3392520516,1672541741,1672543425,1684
3615,3689114185,3408430195,1672671043,1672673329,2286
3455,3534829213,3791246640,1672662727,1672665454,2727
3534,3703348097,3500442734,1672560660,1672563573,2913
3539,3970909253,3447514821,1672635072,1672637561,2489
3462,3292147449,3462273042,1672661622,1672663466,1844
3481,3505283390,3639050419,1672641173,1672644076,2903
3779,3938389661,3791436104,1672612703,1672615513,2810
3816,3779738691,3711637255,1672654165,1672657108,2943
3467,3517288083,3776559988,1672588921,1672592504,3583
3664,3812369928,3462636434,1672560176,1672562383,2207
3575,3836241528,3289114629,1672603849,1672606789,2940
3440,3779646172,3512499658,1672591229,1672594624,3395
3617,3611055563,3271752081,1672653393,1672654271,878
3586,3357864626,3505807416,1672692464,1672694960,2496
3824,3396726504,3520657891,1672593016,1672595964,2948
3724,3443357683,3357289672,1672548101,1672550897,2796
3537,3513296868,3902625986,1672665427,1672667010,1583
3749,3735374579,3774641380,1672692075,1672692519,444
3802,3513295938,3739911441,1672691546,1672694812,3266
3634,3272096759,3689114185,1672664481,1672668033,3552
3882,3779854934,3490214516,1672549262,1672551689,2427
3451,3715385401,3500442734,1672588884,1672589531,647
3428,3792801638,3779301501,1672631372,1672631797,425
3859,3446533960,3294703680,1672590675,1672592156,1481
3626,3773027597,3402697190,1672596386,1672598228,1842
3694,3791246640,3777330107,1672647598,1672647665,67
3688,3710008361,3613581796,1672671131,1672673491,2360
3600,3421877923,3514741348,1672550982,1672551080,98
3532,3333403880,3376467719,1672546567,1672548210,1643
3729,3519077659,3220031931,1672627906,1672628137,231
3646,3520578796,3733363628,1672567668,1672569027,1359
3652,3310125159,3511843593,1672584082,1672586801,2719
3892,3755756564,3279339278,1672687587,1672690395,2808
3511,3510499038,3500703304,1672537604,1672539920,2316
3814,3349856820,3511601997,1672533996,1672536654,2658
3485,3835985172,3853629553,1672604678,1672605468,790
3501,3904412440,3534357694,1672639904,1672641497,1593
3663,3621184108,3755915206,1672541202,1672542288,1086
3524,3713561276,3284947372,1672590201,1672592281,2080
3495,3495911207,3757383891,1672655620,1672657506,1886
3643,3517697722,3505725706,1672605213,1672605832,619
3502,3515525630,3756625818,1672652357,1672654974,2617
3650,3792745809,3778597171,1672661986,1672663891,1905
3692,3611055563,3311498666,1672678930,1672679466,536
3662,3347419520,3429943738,1672542678,1672545422,2744
3622,3803517637,3617392620,1672610511,1672611800,1289
3726,3270056120,3779786641,1672692637,1672692954,317
3807,3509756823,3417191856,1672649081,1672650910,1829
3801,3776117322,3776559988,1672582812,1672584424,1612
3452,3779425804,3202141727,1672551663,1672553045,1382
3503,3773033649,3392836218,1672587720,1672591100,3380
3471,3623266256,3772765746,1672556527,1672558770,2243
3582,3703348097,3513545422,1672610977,1672614168,3191
3749,3450286949,3812369928,1672648104,1672648674,570
3451,3885157459,3701373490,1672599918,1672602849,2931
3625,3793935736,3505154885,1672629569,1672631033,1464
3712,3793883863,3296462324,1672586150,1672586553,403
3887,3511317276,3792274796,1672649752,1672653021,3269
3860,3615087943,3839245934,1672617933,1672620143,2210
3660,3760924079,3617392620,1672544199,1672545799,1600
3771,3711097754,3501457103,1672605079,1672606956,1877
3858,3366423342,3445206685,1672608509,1672609159,650
3684,3710854064,3513345163,1672590135,1672591909,1774
3499,3668747074,3777184389,1672588513,1672592033,3520
3818,3623266256,3715400486,1672690110,1672690299,189
3786,3780680950,3512502036,1672584069,1672584675,606
3680,3500777439,3622665543,1672692436,1672694812,2376
3445,3534357694,3617489344,1672570571,1672570822,251
3748,3631479562,3490214516,1672580137,1672581627,1490
3461,3714678331,3512337405,1672652388,1672652640,252
3907,3615113018,3236354255,1672572017,1672574619,2602
3757,3491469603,3714670620,1672669421,1672670132,711
3821,3330340793,3303410628,1672588454,1672591780,3326
3846,3410160376,3500302272,1672531231,1672531859,628
3659,3668747074,3518653080,1672609403,1672611284,1881
3518,3372223551,3608232640,1672618205,1672620396,2191
3869,3793883863,3793740407,1672539012,1672541622,2610
3766,3392520516,3892304880,1672684341,1672687129,2788
3846,3220031931,3441348818,1672621059,1672623208,2149
3834,3446533960,3357864626,1672548799,1672550912,2113
3467,3396726504,3517590837,1672565456,1672566065,609
3683,3779892400,3245232284,1672658447,1672659053,606
3540,3283770991,3685816610,1672561711,1672563133,1422
3485,3779656423,3514308235,1672633510,1672636204,2694
3844,3815250107,3793175445,1672593503,1672596386,2883
3640,3773332082,3351866415,1672587153,1672587636,483
3893,3613338363,3446533960,1672638480,1672641540,3060
3910,3226024417,3380767040,1672586243,1672587628,1385
3920,3338390596,3341893384,1672696770,1672697065,295
3818,3770146716,3368283077,1672635231,1672638794,3563
3828,3401940259,3755756564,1672693583,1672697025,3442
3830,3834960360,3779656423,1672650119,1672650284,165
3643,3226178937,3791106564,1672586097,1672587235,1138
3564,3912891315,3551399764,1672596008,1672596917,909
3723,3668747074,3739154408,1672653966,1672654118,152
3855,3817428320,3622357348,1672664410,1672665491,1081
3905,3618354185,3441703884,1672590603,1672593708,3105
3649,3890739241,3505283390,1672673522,1672673616,94
3472,3779613523,3514246749,1672576035,1672577833,1798
3896,3714678331,3713979100,1672568064,1672568277,213
3504,3780680950,3885121158,1672535432,1672537189,1757
3633,3201676087,3511317276,1672655532,1672656110,578
3835,3885537225,3300229945,1672634275,1672634370,95
3593,3441348818,3209481722,1672642040,1672642552,512
3665,3756625818,3514275974,1672547153,1672549692,2539
3721,3780680950,3241790910,1672672344,1672674764,2420
3722,3505847380,3299443125,1672546839,1672547626,787
3457,3737112297,3500317969,1672555726,1672556658,932
3913,3778134418,3373089838,1672673174,1672673615,441
3491,3773837847,3637313265,1672541189,1672544168,2979
3616,3931627862,3778899160,1672649350,1672651009,1659
3581,3757863420,3375449013,1672617367,1672619609,2242
3902,3622357348,3701107228,1672621359,1672621629,270
3456,3360813161,3518653080,1672659997,1672660149,152
3786,3279339278,3777240360,1672646164,1672648026,1862
3751,3533274994,3500604680,1672672109,1672675380,3271
3915,3236354255,3715086894,1672563474,1672566738,3264
3502,3270697740,3711077927,1672637610,1672637796,186
3519,3689114185,3808136029,1672617438,1672620904,3466
3662,3384583385,3618489670,1672625129,1672628705,3576
3654,3975717896,3497095254,1672677082,1672677848,766
3543,3239617320,3630353876,1672651511,1672651968,457
3660,3403370192,3236499444,1672684861,1672686163,1302
3433,3364726656,3360616538,1672600541,1672603127,2586
3534,3501459390,3716628503,1672653813,1672657010,3197
3886,3880926355,3351696332,1672700867,1672703782,2915
3670,3776988674,3300511067,1672654651,1672656190,1539
3651,3505198734,3686523546,1672675937,1672677914,1977
3555,3451726367,3905196766,1672669707,1672673047,3340
3912,3714678331,3818575661,1672638099,1672638506,407
3485,3713979100,3701247948,1672655039,1672657083,2044
3593,3893912331,3928511283,1672604924,1672604992,68
3885,3778134418,3383138270,1672679453,1672680733,1280
3709,3357689359,3773939399,1672652182,1672653869,1687
3505,3938503547,3479851674,1672664212,1672664498,286
3806,3772236797,3931627862,1672580488,1672583390,2902
3777,3783641602,3505179890,1672609380,1672611240,1860
3795,3625174002,3513545422,1672667480,1672669878,2398
3680,3437286517,3829864515,1672662827,1672663644,817
3444,3201676087,3271752081,1672650117,1672652415,2298
3917,3793883863,3436257398,1672645670,1672645819,149
3719,3208957949,3512830734,1672686250,1672688875,2625
3676,3446533960,3757348722,1672559703,1672561063,1360
3739,3505228454,3500072204,1672653123,1672655179,2056
3890,3783340788,3774705415,1672673488,1672673766,278
3692,3367971170,3533649454,1672601997,1672603970,1973
3888,3755848152,3534357694,1672593195,1672594392,1197
3880,3510818674,3509756823,1672662386,1672665370,2984
3532,3605221116,3517737088,1672598701,1672599868,1167
3525,3757348722,3514246749,1672657934,1672660842,2908
3820,3970558632,3511005395,1672636466,1672640042,3576
3794,3970603231,3792505974,1672602929,1672605372,2443
3682,3632814465,3513545422,1672582535,1672585046,2511
3831,3760645796,3773121782,1672692661,1672693064,403
3530,3885155975,3369708250,1672618422,1672619001,579
3806,3821054646,3783771827,1672693795,1672694122,327
3733,3533649454,3343132529,1672610006,1672613392,3386
3601,3755737419,3714067076,1672667334,1672670744,3410
3572,3205985903,3517887477,1672549668,1672553190,3522
3887,3500341755,3793175445,1672582782,1672583353,571
3553,3760924079,3688220326,1672637460,1672639603,2143
3886,3490029863,3487875183,1672699330,1672701950,2620
3630,3627368399,3777814504,1672641405,1672642469,1064
3829,3792505974,3511732493,1672626721,1672629627,2906
3731,3974674109,3520639768,1672687325,1672688024,699
3704,3288224595,3293835352,1672691509,1672693706,2197
3638,3417679834,3229822507,1672617140,1672617923,783
3623,3756127300,3500347447,1672632695,1672636156,3461
3652,3311420950,3760094385,1672601981,1672603078,1097
3919,3772765746,3711006062,1672618329,1672621516,3187
3590,3777814504,3684523966,1672671399,1672671499,100
3731,3974674109,3607768197,1672591505,1672593624,2119
3842,3462158237,3777240360,1672551267,1672554102,2835
3820,3689114185,3703348097,1672629513,1672630609,1096
3462,3394401087,3412006598,1672693525,1672695656,2131
3535,3289114629,3534357694,1672612078,1672613604,1526
3899,3298151889,3510641433,1672638404,1672640246,1842
3783,3610870949,3772236797,1672702866,1672704387,1521
3918,3274906650,3500072204,1672580672,1672582555,1883
3440,3517590837,3505179890,1672688216,1672689366,1150
3818,3276003502,3633735593,1672651089,1672653400,2311
3681,3621461051,3780872464,1672698750,1672702318,3568
3723,3509756823,3715443333,1672692351,1672694963,2612
3798,3511317276,3780209375,1672625981,1672627625,1644
3663,3668533536,3440137407,1672540892,1672540996,104
3617,3520560590,3680843171,1672558958,1672559436,478
3838,3393063657,3739895284,1672701851,1672702236,385
3699,3392520516,3450286949,1672544426,1672545929,1503
3853,3897376951,3713163045,1672611024,1672613252,2228
3437,3617304541,3457960571,1672535918,1672537934,2016
3832,3938503547,3421877923,1672545552,1672545928,376
3570,3452016771,3885121158,1672598023,1672600709,2686
3449,3811075491,3436025562,1672586329,1672588718,2389
3484,3231494505,3757323954,1672702818,1672703410,592
3707,3399472693,3685816610,1672562481,1672564070,1589
3820,3774733620,3517172354,1672646226,1672647606,1380
3885,3371455553,3774178201,1672634673,1672637738,3065
3845,3776117322,3715127070,1672557935,1672560406,2471
3905,3514512367,3772391882,1672633567,1672636733,3166
3833,3714185969,3208452238,1672670479,1672672221,1742
3919,3928719932,3715854030,1672636622,1672637317,695
3838,3755532873,3889780657,1672553923,1672555201,1278
3912,3757700712,3517358573,1672589222,1672591439,2217
3824,3457960571,3774907131,1672671305,1672673873,2568
3565,3715707380,3778926763,1672539959,1672543157,3198
3515,3517288083,3456430614,1672585894,1672588557,2663
3781,3551389192,3300229945,1672683311,1672684061,750
3599,3834631333,3792949946,1672635483,1672636244,761
3852,3469254160,3408498208,1672601545,1672602922,1377
3803,3513295938,3780472203,1672699405,1672701250,1845
3885,3716628503,3428725843,1672607042,1672609725,2683
3682,3779786641,3500857494,1672635984,1672637092,1108
3440,3715619259,3334647380,1672545609,1672548902,3293
3425,3288762795,3815392801,1672655968,1672656376,408
3670,3280268483,3803389195,1672638571,1672641725,3154
3793,3614740489,3688796737,1672639646,1672641269,1623
3895,3780680950,3336339664,1672655516,1672657166,1650
3725,3835985172,3424445495,1672545709,1672547753,2044
3718,3511843593,3510554314,1672618856,1672621604,2748
3498,3357289672,3513360004,1672667424,1672668036,612
3469,3396980894,3479851674,1672664793,1672665516,723
3851,3756385685,3920625129,1672621248,1672621524,276
3467,3777037426,3490214516,1672555366,1672558692,3326
3495,3783928182,3429943738,1672597002,1672599517,2515
3447,3701322924,3279339278,1672544276,1672547801,3525
3734,3449333754,3792546035,1672634305,1672637555,3250
3556,3509366311,3518194482,1672703120,1672705117,1997
3777,3511005395,3225636215,1672581342,1672583604,2262
3569,3270056120,3447514821,1672637520,1672640763,3243
3821,3772391882,3711919537,1672618089,1672619031,942
3812,3802932312,3701424609,1672699775,1672701276,1501
3775,3777189898,3780209375,1672585142,1672585511,369
3799,3604867757,3514419100,1672544206,1672546333,2127
3606,3533929349,3770520359,1672565563,1672568926,3363
3902,3680810086,3241914067,1672565761,1672567609,1848
3897,3779892400,3780427126,1672674170,1672676273,2103
3566,3933894942,3814677862,1672694295,1672696934,2639
3680,3777189898,3511601997,1672576056,1672578802,2746
3752,3818575661,3834631333,1672682271,1672684772,2501
3441,3714128600,3613416045,1672628573,1672629157,584
3826,3490029863,3823084403,1672654296,1672655623,1327
3820,3396980894,3347446226,1672637330,1672640493,3163
3856,3520322124,3779639983,1672659685,1672662076,2391
3712,3635169815,3899326793,1672545633,1672545997,364
3564,3627368399,3279242917,1672624003,1672625572,1569
3893,3617392620,3793935736,1672619570,1672620455,885
3922,3668414677,3424660806,1672631655,1672634262,2607
3791,3779438325,3756746867,1672651789,1672654707,2918
3461,3488763230,3274831810,1672582755,1672586024,3269
3713,3770146716,3701005527,1672589206,1672590395,1189
3750,3779639983,3201800997,1672635232,1672636699,1467
3500,3792072681,3833217041,1672679759,1672680987,1228
3441,3337362061,3424445495,1672636659,1672637640,981
3604,3516298579,3272096759,1672567257,1672567997,740
3717,3711919537,3818575661,1672671288,1672674068,2780
3859,3514971533,3462273042,1672599852,1672602125,2273
3578,3779438325,3715545685,1672700076,1672700225,149
3664,3402385957,3227799827,1672600870,1672601880,1010
3588,3895285664,3714666884,1672589719,1672591756,2037
3683,3283144118,3755230952,1672543595,1672546505,2910
3493,3760094385,3513065217,1672609094,1672610170,1076
3547,3757348722,3890739241,1672567721,1672571221,3500
3853,3930242012,3501457103,1672556290,1672556385,95
3877,3456430614,3774790271,1672576977,1672580523,3546
3876,3501121099,3510964997,1672605708,1672607444,1736
3879,3513410578,3760694096,1672597007,1672597670,663
3670,3300511067,3500072204,1672601377,1672602457,1080
3682,3316798920,3829864515,1672647539,1672650435,2896
3644,3713979100,3714185969,1672592272,1672592663,391
3632,3349856820,3296462324,1672583942,1672585606,1664
3775,3505154885,3559731671,1672666401,1672668446,2045
3527,3897376951,3509483172,1672616739,1672619660,2921
3504,3770624662,3505481368,1672581577,1672584173,2596
3516,3514334067,3739895284,1672624352,1672625889,1537
3878,3902760230,3395201292,1672620640,1672623502,2862
3732,3554944414,3520764926,1672596107,1672596379,272
3453,3760924079,3459681410,1672633476,1672636588,3112
3573,3928511283,3336339664,1672644083,1672644387,304
3900,3630353876,3509483172,1672557445,1672558190,745
3663,3519087371,3970558632,1672582049,1672584490,2441
3631,3460719322,3777485931,1672587586,1672590085,2499
3496,3224811762,3701136026,1672652789,1672655581,2792
3618,3551389192,3338390596,1672673365,1672674629,1264
3444,3757332128,3518653080,1672633443,1672635934,2491
3465,3510919821,3615939504,1672571224,1672574199,2975
3738,3780909839,3312998540,1672681783,1672682239,456
3610,3760362417,3684523966,1672615626,1672617148,1522
3861,3792389522,3916490839,1672563900,1672566113,2213
3673,3501384020,3505178849,1672636379,1672637748,1369
3487,3715385401,3512958459,1672556487,1672559871,3384
3461,3510767239,3410538749,1672541129,1672542943,1814
3465,3756385685,3395201292,1672572192,1672572618,426
3638,3383138270,3513065217,1672589290,1672591183,1893
3689,3319167958,3414275042,1672618411,1672620656,2245
3838,3660063072,3517172354,1672574927,1672577422,2495
3778,3354144091,3780338697,1672611351,1672613441,2090
3920,3793418209,3272030610,1672557045,1672559118,2073
3634,3515559913,3513410578,1672595509,1672596974,1465
3609,3900276517,3510964997,1672639784,1672641098,1314
3456,3783340788,3556969573,1672600768,1672603666,2898
3445,3230135532,3279475486,1672675304,1672678439,3135
3438,3757700712,3306175858,1672703283,1672703863,580
3729,3516298579,3509893027,1672641960,1672644774,2814
3865,3533079336,3500949309,1672682183,1672683958,1775
3623,3519282716,3614740489,1672630405,1672631791,1386
3524,3512882178,3533929349,1672634224,1672635590,1366
3690,3737972328,3519028898,1672633052,1672636624,3572
3484,3516444201,3755065949,1672576920,1672577236,316
3589,3272096759,3500072204,1672531897,1672534676,2779
3561,3533294425,3716110860,1672585262,1672588351,3089
3876,3518194482,3914691363,1672602704,1672602823,119
3430,3737972328,3334993594,1672643744,1672646410,2666
3604,3392836218,3452016771,1672669666,1672672720,3054
3703,3457620713,3733558985,1672584227,1672587240,3013
3530,3412968120,3512392431,1672683875,1672684036,161
3557,3689114185,3713829743,1672606191,1672609563,3372
3710,3755573472,3916490839,1672590617,1672592269,1652
3839,3398198430,3685681577,1672675415,1672675707,292
3501,3714233826,3792072681,1672608144,1672608751,607
3520,3299443125,3201629017,1672628900,1672631964,3064
3672,3760362417,3904569677,1672539327,1672540277,950
3433,3316800320,3920898925,1672671389,1672674579,3190
3674,3739661856,3509756823,1672536176,1672537944,1768
3479,3716110860,3229822507,1672550067,1672552424,2357
3485,3501384020,3398198430,1672568569,1672571350,2781
3749,3780909839,3791046864,1672622871,1672623335,464
3745,3510499038,3792949946,1672682844,1672686220,3376
3510,3517462308,3467779445,1672602726,1672604865,2139
3563,3792014516,3825881598,1672697279,1672697668,389
3722,3890739241,3534764451,1672638066,1672638725,659
3844,3467988782,3776034743,1672567616,1672570944,3328
3442,3736231757,3435116799,1672669830,1672671810,1980
3583,3364726656,3755065949,1672699627,1672700403,776
3724,3311049964,3311049964,1672675034,1672675324,290
3786,3897134762,3394297564,1672566755,1672567120,365
3661,3711853996,3739661856,1672576411,1672576970,559
3483,3399518841,3485540729,1672590175,1672591101,926
3496,3441348818,3279475486,1672532160,1672532392,232
3458,3770624662,3515401243,1672561022,1672561934,912
3667,3410600350,3500841914,1672645291,1672648161,2870
3862,3515525630,3893912331,1672572225,1672573390,1165
3826,3835422146,3904867554,1672672959,1672673863,904
3879,3900276517,3364378127,1672577936,1672580699,2763
3466,3505111292,3688796737,1672615885,1672617757,1872
3571,3224811762,3436025562,1672648367,1672650846,2479
3491,3701664364,3756625818,1672615416,1672616381,965
3783,3519909393,3224330592,1672567261,1672567334,73
3817,3615688740,3500347447,1672697073,1672697450,377
3565,3480100311,3514308235,1672548819,1672550837,2018
3625,3757294769,3412006598,1672627997,1672628290,293
3453,3792072681,3623266256,1672598689,1672600897,2208
3519,3343816795,3885121158,1672653155,1672656408,3253
3856,3240994288,3488686442,1672591061,1672593541,2480
3539,3514818819,3416987084,1672666956,1672669593,2637
3521,3288224595,3513327337,1672546059,1672546607,548
3486,3615939504,3272716462,1672695438,1672696394,956
3480,3852686295,3730071479,1672618878,1672619199,321
3889,3491684096,3711077927,1672597311,1672598879,1568
3719,3556969573,3300511067,1672593018,1672595438,2420
3591,3459681410,3792745809,1672698886,1672699866,980
3878,3231713082,3897376951,1672695947,1672698993,3046
3830,3858172636,3429943738,1672647272,1672649396,2124
3719,3755222916,3621461051,1672675767,1672678821,3054
3481,3915162005,3451726367,1672669892,1672672372,2480
3540,3897435944,3667673649,1672699884,1672703012,3128
3887,3780427126,3414275042,1672555643,1672557898,2255
3684,3757323954,3499217428,1672574409,1672577001,2592
3573,3927165965,3760721303,1672579225,1672581781,2556
3921,3776559988,3617392620,1672674557,1672676600,2043
3801,3364378127,3902625986,1672611779,1672612035,256
3459,3500709774,3414275042,1672577789,1672579375,1586
3710,3710854064,3450286949,1672531319,1672531549,230
3704,3224811762,3713941638,1672597992,1672598827,835
3547,3779854934,3202141727,1672577234,1672580710,3476
3825,3478114114,3514512367,1672658678,1672661141,2463
3708,3900945856,3224811762,1672594483,1672595528,1045
3450,3613581796,3363162590,1672694462,1672695430,968
3755,3770704999,3412968120,1672557701,1672559524,1823
3649,3552824113,3306412634,1672688675,1672692065,3390
3740,3279242917,3755233658,1672691763,1672693013,1250
3703,3615115210,3449333754,1672683024,1672685438,2414
3550,3514741348,3445206685,1672574895,1672577683,2788
3479,3682133690,3711000597,1672577233,1672579425,2192
3800,3431502855,3505521218,1672599601,1672599893,292
3790,3899326793,3755065949,1672542868,1672543893,1025
3527,3755532873,3488763230,1672621601,1672622828,1227
3666,3904569677,3801645328,1672605361,1672607546,2185
3814,3777779869,3334647380,1672547782,1672548130,348
3777,3757332128,3713163045,1672542230,1672543342,1112
3788,3686227677,3240394404,1672622317,1672624933,2616
3620,3618697021,3887243870,1672595289,1672598480,3191
3908,3510767239,3713979100,1672677690,1672680237,2547
3837,3450969839,3933894942,1672699816,1672702644,2828
3801,3490029863,3231713082,1672658557,1672660989,2432
3850,3713941638,3850911686,1672682074,1672682176,102
3440,3224330592,3923754072,1672580393,1672583206,2813
3729,3279339278,3421385957,1672645835,1672648951,3116
3470,3909094917,3520181148,1672569228,1672571233,2005
3900,3755915206,3512499658,1672618654,1672621244,2590
3860,3756746867,3289114629,1672628877,1672631254,2377
3859,3399518841,3755532873,1672590128,1672590849,721
3774,3311420950,3734118023,1672606007,1672606172,165
3426,3624297844,3440137407,1672549601,1672552604,3003
3481,3661583097,3686523546,1672678931,1672682331,3400
3652,3780872464,3512958459,1672555698,1672555860,162
3676,3893912331,3779738691,1672669335,1672670178,843
3437,3779613523,3428725843,1672546601,1672548682,2081
3841,3755222916,3713561276,1672682199,1672685645,3446
3555,3667673649,3793315718,1672675819,1672676714,895
3518,3619922891,3231494505,1672629648,1672629828,180
3692,3447672935,3756704774,1672535777,1672538372,2595
3844,3392836218,3613338363,1672565696,1672568092,2396
3791,3485540729,3609659642,1672672044,1672672666,622
3707,3925979970,3897134762,1672595869,1672599210,3341
3908,3897456874,3354144091,1672590170,1672591030,860
3626,3480991549,3439673892,1672587507,1672588591,1084
3832,3711812325,3660887799,1672669485,1672672085,2600
3449,3783147088,3621683102,1672648720,1672649549,829
3461,3468041839,3756385685,1672662155,1672664928,2773
3780,3835422146,3734451191,1672561639,1672561849,210
3426,3615113018,3395201292,1672652519,1672653879,1360
3827,3270056120,3304971369,1672642801,1672644607,1806
3835,3272096759,3661447322,1672673590,1672676351,2761
3454,3510919821,3780253901,1672645763,1672646315,552
3519,3551399764,3469254160,1672581142,1672584494,3352
3789,3760364383,3330340793,1672614690,1672615163,473
3651,3351696332,3770624662,1672565667,1672568285,2618
3828,3732131656,3783771827,1672691508,1672692070,562
3891,3330340793,3777485931,1672548504,1672549856,1352
3575,3710496785,3824641227,1672585009,1672587140,2131
3713,3514246749,3534175249,1672561565,1672563724,2159
3880,3231713082,3480490124,1672533597,1672534592,995
3747,3897456874,3505807416,1672563128,1672564823,1695
3573,3713163045,3617116290,1672611412,1672611927,515
3734,3776084820,3306175858,1672664389,1672665339,950
3907,3661903000,3773027597,1672697067,1672700520,3453
3512,3935399379,3780322355,1672641451,1672642247,796
3902,3757863420,3485540729,1672610306,1672612443,2137
3442,3515439826,3607768197,1672642270,1672644097,1827
3841,3400763927,3683113954,1672701710,1672704695,2985
3467,3387594369,3608922867,1672635381,1672636447,1066
3731,3533423872,3513545422,1672671701,1672673641,1940
3721,3369708250,3933894942,1672548042,1672548451,409
3551,3757323954,3970198861,1672571989,1672575492,3503
3583,3206837348,3757383891,1672578071,1672579768,1697
3697,3760040019,3347446226,1672609984,1672610819,835
3798,3493017654,3609881958,1672630720,1672632253,1533
3517,3461119815,3334647380,1672662695,1672664962,2267
3479,3780427126,3621683102,1672666120,1672666462,342
3639,3443357683,3517600136,1672679115,1672679776,661
3857,3520115090,3450969839,1672645098,1672647422,2324
3746,3779656423,3514818819,1672534775,1672535920,1145
3449,3505283390,3519087371,1672701968,1672705009,3041
3914,3412968120,3519028898,1672542537,1672544179,1642
3494,3309314379,3622357348,1672664116,1672666296,2180
3823,3776034743,3927599181,1672658695,1672662083,3388
3726,3716628503,3500317969,1672638602,1672642098,3496
3810,3512722110,3450969839,1672605723,1672608467,2744
3522,3284947372,3714128600,1672537678,1672538038,360
3712,3424660806,3760094385,1672576654,1672579456,2802
3678,3774641380,3403370192,1672684430,1672687126,2696
3768,3779639983,3392943173,1672562491,1672563235,744
3826,3970909253,3622665543,1672653766,1672654409,643
3515,3514818819,3513327337,1672582719,1672583855,1136
3586,3520355798,3351866415,1672563544,1672564966,1422
3547,3660887799,3511442562,1672669882,1672671754,1872
3528,3834960360,3774155692,1672548772,1672552287,3515
3577,3618489670,3774641380,1672593865,1672596735,2870
3726,3938503547,3296462324,1672626660,1672629529,2869
3489,3319167958,3732584121,1672541121,1672542500,1379
3568,3517222913,3519028898,1672583545,1672584007,462
3884,3380982774,3776244398,1672545162,1672547592,2430
3708,3500827202,3559731671,1672564064,1672566870,2806
3847,3932478321,3756704774,1672681491,1672683717,2226
3768,3309314379,3631090677,1672630559,1672633680,3121
3651,3780680950,3779786641,1672543778,1672546778,3000
3901,3334974375,3511601997,1672574563,1672576478,1915
3526,3792014516,3621461051,1672644358,1672645622,1264
3494,3392520516,3618176292,1672658691,1672660676,1985
3771,3511150845,3620292035,1672641880,1672644847,2967
3653,3461119815,3615737355,1672586945,1672587746,801
3440,3501525100,3701664364,1672639076,1672640447,1371
3816,3518565331,3618489670,1672569592,1672573063,3471
3581,3511005395,3791753345,1672641488,1672642435,947
3831,3923754072,3533004959,1672568722,1672569141,419
3752,3350095157,3304155815,1672561641,1672563896,2255
3518,3914691363,3970198861,1672648017,1672648295,278
3495,3713561276,3279475486,1672544105,1672544280,175
3775,3791693821,3299443125,1672669534,1672669694,160
3608,3505725706,3375449013,1672550932,1672553454,2522
3865,3510798825,3760721303,1672616267,1672619735,3468
3555,3227799827,3271752081,1672570959,1672572709,1750
3832,3296462324,3800257590,1672541007,1672542352,1345
3893,3760094385,3975717896,1672577306,1672578862,1556
3755,3514818819,3757318448,1672534213,1672535042,829
3887,3791753345,3229822507,1672597794,1672599447,1653
3906,3400069268,3533929349,1672562926,1672566346,3420
3644,3485540729,3710735406,1672544908,1672545024,116
3580,3711853996,3773027597,1672667878,1672669972,2094
3684,3891672228,3520764926,1672675892,1672679490,3598
3574,3518565331,3500737582,1672656903,1672657158,255
3681,3347446226,3357689359,1672628385,1672630654,2269
3426,3230135532,3514419100,1672538297,1672538726,429
3874,3760924079,3520873221,1672700722,1672701759,1037
3744,3614740489,3757630221,1672607365,1672610482,3117
3895,3970198861,3512337405,1672645356,1672646340,984
3780,3972083617,3337322736,1672625414,1672625681,267
3902,3517358573,3310039260,1672549975,1672550800,825
3703,3513018485,3501384020,1672695338,1672696072,734
3523,3713911104,3500703304,1672567676,1672568399,723
3469,3935487534,3791753345,1672600435,1672600841,406
3549,3360813161,3778899160,1672640475,1672642499,2024
3552,3688796737,3779639983,1672548902,1672552324,3422
3595,3480100311,3500857494,1672565795,1672568166,2371
3687,3520115090,3505663516,1672649527,1672649617,90
3485,3443357683,3710562338,1672625043,1672627757,2714
3606,3293835352,3520873221,1672629762,1672629960,198
3859,3248058676,3509366311,1672586937,1672589488,2551
3426,3429943738,3773332082,1672636113,1672637181,1068
3608,3776559988,3517991730,1672628647,1672629527,880
3500,3519416013,3714670620,1672677393,1672678291,898
3508,3462273042,3514324011,1672558366,1672561811,3445
3846,3710048469,3500341755,1672622559,1672622949,390
3620,3920898925,3755915206,1672629121,1672630608,1487
3515,3519446663,3512337405,1672684251,1672684587,336
3819,3885121158,3684523966,1672691760,1672695122,3362
3732,3514971533,3500442734,1672692972,1672694703,1731
3497,3382733096,3770676872,1672647635,1672648961,1326
3499,3347446226,3490214516,1672589971,1672590083,112
3567,3396980894,3608232640,1672579048,1672579374,326
3611,3885157459,3500827202,1672589114,1672592024,2910
3590,3614740489,3618489670,1672674255,1672676790,2535
3623,3392520516,3710854064,1672564915,1672566710,1795
3454,3533368789,3783641602,1672553062,1672556535,3473
3680,3773735484,3668747074,1672541306,1672543142,1836
3755,3510641433,3514285803,1672540287,1672541042,755
3638,3920625129,3755233658,1672630390,1672632963,2573
3779,3620292035,3615087943,1672579984,1672583362,3378
3535,3398731252,3755756564,1672558181,1672561645,3464
3576,3276003502,3283770991,1672572530,1672573462,932
3528,3300979975,3206837348,1672626138,1672629657,3519
3514,3710315160,3315703693,1672672925,1672673500,575
3575,3441703884,3440107959,1672677362,1672680062,2700
3649,3520181148,3607768197,1672643299,1672644688,1389
3657,3534829213,3777814504,1672573346,1672573774,428
3836,3225029895,3500703304,1672610766,1672612822,2056
3861,3500044458,3293835352,1672616779,1672619637,2858
3619,3274906650,3515466096,1672637522,1672641045,3523
3898,3500525825,3773913680,1672592705,1672594712,2007
3798,3661903000,3311420950,1672682994,1672686285,3291
3622,3615737355,3519142371,1672643406,1672644203,797
3680,3895285664,3783340788,1672642634,1672645157,2523
3909,3520355798,3829822608,1672645610,1672647912,2302
3893,3773837847,3793583656,1672563449,1672563753,304
3483,3852533643,3824641227,1672614969,1672618396,3427
3697,3509483172,3604867757,1672539755,1672542603,2848
3572,3783163143,3475349791,1672695740,1672696416,676
3433,3773027597,3711919537,1672588903,1672591489,2586
3869,3399472693,3757863420,1672615697,1672617807,2110
3446,3711637255,3512830734,1672590531,1672591494,963
3551,3760721303,3711077927,1672677399,1672680600,3201
3528,3792801638,3241914067,1672623635,1672625591,1956
3836,3554944414,3773033649,1672683603,1672687133,3530
3592,3315279093,3364726656,1672570946,1672571082,136
3664,3731646673,3757075324,1672610532,1672613899,3367
3577,3533274994,3402385957,1672678360,1672679320,960
3644,3710008361,3818575661,1672620920,1672622682,1762
3608,3617116290,3396980894,1672674892,1672678442,3550
3615,3660063072,3776988674,1672647276,1672647677,401
3632,3367509761,3304155815,1672668566,1672671601,3035
3597,3972192593,3512502036,1672608599,1672610086,1487
3657,3897435944,3660887799,1672673797,1672677070,3273
3504,3715443333,3770468980,1672616017,1672619071,3054
3887,3890739241,3783520186,1672655790,1672658508,2718
3767,3400069268,3500915908,1672664581,1672665950,1369
3519,3513545422,3384583385,1672643903,1672644031,128
3843,3500737582,3776831527,1672568798,1672570942,2144
3712,3714185969,3459681410,1672690108,1672693600,3492
3483,3435167810,3493017654,1672627227,1672628620,1393
3706,3380130228,3905899155,1672578005,1672580613,2608
3586,3315279093,3514703118,1672621818,1672624691,2873
3793,3755992176,3770146716,1672542568,1672543471,903
3754,3732584121,3815250107,1672574830,1672575774,944
3872,3244004456,3779639983,1672584328,1672586189,1861
3714,3241790910,3399472693,1672691135,1672692239,1104
3573,3818575661,3505481368,1672541420,1672544755,3335
3817,3780712350,3773124276,1672682794,1672684059,1265
3824,3737972328,3225636215,1672552378,1672553485,1107
3692,3760645796,3923220461,1672599777,1672601212,1435
3875,3833217041,3931627862,1672568291,1672569123,832
3747,3224330592,3895285664,1672557734,1672558159,425
3446,3519416013,3511150845,1672700932,1672704331,3399
3905,3334993594,3334974375,1672611609,1672612448,839
3539,3512722110,3285204083,1672677896,1672679543,1647
3755,3793418209,3811040565,1672587895,1672590621,2726
3558,3462636434,3224811762,1672583133,1672583905,772
3611,3497808662,3510187271,1672532759,1672533150,391
3849,3514324011,3938389661,1672531342,1672534600,3258
3817,3885155975,3609933747,1672544853,1672545464,611
3885,3410600350,3791796585,1672580520,1672581791,1271
3877,3778899160,3802932312,1672687922,1672690507,2585
3505,3902861231,3533929349,1672695811,1672696002,191
3909,3236458894,3923754072,1672638015,1672639661,1646
3830,3515466096,3850911686,1672559339,1672560122,783
3561,3701424609,3711097754,1672673298,1672676008,2710
3892,3792489602,3412968120,1672556011,1672556933,922
3516,3373089838,3462636434,1672615083,1672615347,264
3610,3920898925,3379143440,1672599021,1672599744,723
3856,3661903000,3311085279,1672588195,1672591040,2845
3745,3611055563,3770438122,1672593368,1672595283,1915
3897,3316798920,3338083680,1672602817,1672605300,2483
3626,3403370192,3898314440,1672668909,1672669197,288
3659,3292147449,3534566651,1672588754,1672589791,1037
3728,3716963089,3226178937,1672596790,1672598174,1384
3880,3512882178,3895285664,1672621814,1672624302,2488
3876,3272716462,3516444201,1672656880,1672658987,2107
3522,3497808662,3778899160,1672661431,1672661535,104
3457,3713691388,3308760650,1672607441,1672610730,3289
3785,3777485931,3779465522,1672548323,1672549162,839
3908,3311098437,3615737355,1672680643,1672683696,3053
3494,3516489668,3512379024,1672602440,1672605126,2686
3443,3815250107,3905899155,1672535808,1672538850,3042
3901,3500442734,3778040015,1672641730,1672642597,867
3611,3463740710,3770236215,1672700952,1672703301,2349
3881,3701005527,3472068734,1672676971,1672677417,446
3839,3615688740,3703396825,1672599482,1672603029,3547
3599,3774876004,3660887799,1672563911,1672567259,3348
3543,3226511603,3533747868,1672580287,1672580593,306
3663,3633735593,3208957949,1672618154,1672621458,3304
3466,3774790271,3701884158,1672629948,1672633356,3408
3862,3205923620,3701247948,1672673541,1672675237,1696
3765,3756704774,3205923620,1672666124,1672668153,2029
3881,3793583656,3686227677,1672585890,1672587459,1569
3481,3979802715,3711853996,1672686445,1672686760,315
3717,3897134762,3516298579,1672577808,1672578266,458
3804,3270042456,3615688740,1672614833,1672618064,3231
3845,3509366311,3559731671,1672624313,1672624910,597
3797,3777037426,3239617320,1672585071,1672586738,1667
3500,3770438122,3225631197,1672537331,1672537985,654
3518,3701882224,3793883863,1672567256,1672567900,644
3434,3776084820,3793175445,1672638738,1672640617,1879
3831,3316800320,3618489670,1672654711,1672655223,512
3840,3667673649,3755992176,1672540396,1672543710,3314
3719,3505807416,3682133690,1672584118,1672585572,1454
3627,3892304880,3617116290,1672613382,1672616394,3012
3773,3792020993,3760362417,1672545930,1672546483,553
3653,3500857494,3618489670,1672677728,1672681142,3414
3882,3512379024,3920625129,1672658108,1672658768,660
3899,3296462324,3737147209,1672671148,1672674592,3444
3474,3472312341,3777147510,1672543411,1672546227,2816
3814,3793740407,3418448389,1672635961,1672636301,340
3502,3505437712,3779532653,1672571805,1672573422,1617
3578,3520657891,3757193307,1672609606,1672610936,1330
3851,3613206049,3904867554,1672560891,1672561328,437
3806,3755992176,3791753345,1672578014,1672579738,1724
3882,3783136330,3438078818,1672672787,1672676167,3380
3730,3737147209,3760694096,1672605323,1672607245,1922
3900,3304155815,3513327337,1672628321,1672631128,2807
3751,3615939504,3351696332,1672596922,1672597937,1015
3786,3411688875,3609659642,1672689995,1672691775,1780
3699,3770704999,3512946768,1672551595,1672553724,2129
3786,3783919913,3739911441,1672673777,1672674479,702
3827,3438489358,3396980894,1672666245,1672669053,2808
3759,3401496246,3500915908,1672597954,1672598432,478
3917,3689114185,3452016771,1672537268,1672540079,2811
3639,3621461051,3631479562,1672570318,1672571819,1501
3735,3457960571,3517687662,1672677672,1672678386,714
3760,3516703758,3834631333,1672677613,1672679850,2237
3708,3382733096,3334993594,1672610778,1672613121,2343
3694,3899786664,3613338363,1672564492,1672565719,1227
3812,3515401243,3435167810,1672538151,1672541000,2849
3607,3231494505,3485540729,1672546395,1672548051,1656
3828,3366423342,3279242917,1672546911,1672548612,1701
3664,3791753345,3627368399,1672542545,1672545885,3340
3657,3638660068,3283144118,1672603349,1672605957,2608
3823,3500208903,3276348699,1672655271,1672657674,2403
3560,3791436104,3380130228,1672643345,1672644000,655
3546,3774178201,3703433819,1672563153,1672564087,934
3894,3701247948,3354144091,1672609448,1672611861,2413
3783,3390660440,3360069849,1672567857,1672570272,2415
3513,3783771827,3497095254,1672589566,1672592152,2586
3459,3438078818,3384068080,1672574962,1672577361,2399
3784,3500044458,3514512367,1672570287,1672573072,2785
3742,3509483172,3900945856,1672538120,1672541515,3395
3499,3360813161,3755915206,1672565698,1672565789,91
3804,3780872464,3714067076,1672637657,1672639254,1597
3750,3209481722,3791753345,1672697073,1672698771,1698
3479,3793969543,3436025562,1672667444,1672670986,3542
3675,3209526819,3393063657,1672669100,1672670770,1670
3602,3441703884,3501121099,1672648112,1672651446,3334
3601,3517697722,3229974066,1672573695,1672574052,357
3810,3480490124,3755065949,1672620436,1672622066,1630
3711,3793407963,3615115210,1672605487,1672607460,1973
3640,3774605761,3516513251,1672642669,1672643794,1125
3643,3935399379,3554825448,1672663734,1672665896,2162
3619,3757348722,3460719322,1672627648,1672628701,1053
3447,3613206049,3375449013,1672550835,1672552545,1710
3442,3520657891,3777189898,1672565001,1672565170,169
3804,3905196766,3441348818,1672559844,1672561875,2031
3544,3773124276,3792745809,1672627368,1672629368,2000
3833,3276217799,3714670620,1672674298,1672675435,1137
3745,3773332082,3801645328,1672675132,1672677855,2723
3434,3713561276,3512295534,1672577600,1672577921,321
3638,3772078494,3424445495,1672676575,1672677694,1119
3899,3617304541,3333403880,1672577564,1672580302,2738
3700,3774718695,3774907131,1672574691,1672575318,627
3880,3755992176,3904569677,1672533243,1672534284,1041
3529,3370068529,3395201292,1672693975,1672694884,909
3565,3856606678,3627368399,1672653707,1672656705,2998
3589,3370227921,3533423872,1672689897,1672690822,925
3773,3780571086,3500915665,1672549829,1672553251,3422
3538,3792525861,3610358027,1672658361,1672660973,2612
3540,3414275042,3780427126,1672583788,1672585256,1468
3658,3716679950,3512830734,1672612790,1672615127,2337
3448,3519818818,3500613459,1672611031,1672611347,316
3472,3774790271,3783433404,1672680998,1672681588,590
3599,3500208903,3757323954,1672630491,1672631387,896
3479,3515890966,3701107228,1672658860,1672659315,455
3604,3714067076,3855583256,1672599731,1672603063,3332
3775,3701005527,3514275974,1672639008,1672639912,904
3805,3669146016,3793743698,1672627718,1672629182,1464
3457,3680810086,3551399764,1672582406,1672584513,2107
3679,3617304541,3270056120,1672595885,1672597893,2008
3803,3272716462,3630353876,1672621883,1672624617,2734
3810,3836241528,3203538212,1672657083,1672657333,250
3427,3337362061,3500672156,1672676201,1672678366,2165
3648,3490214516,3636329663,1672546054,1672548391,2337
3489,3885121158,3436257398,1672667692,1672670820,3128
3559,3734118023,3760842815,1672665040,1672667450,2410
3727,3714185969,3779738691,1672568733,1672570900,2167
3906,3515402792,3403370192,1672539896,1672541868,1972
3729,3757332128,3516741440,1672608386,1672610381,1995
3553,3505481368,3311420950,1672662178,1672663779,1601
3651,3511005395,3770146716,1672620200,1672623024,2824
3531,3510554314,3774641380,1672685999,1672688417,2418
3613,3396726504,3713561276,1672676356,1672677106,750
3723,3732584121,3415833929,1672701017,1672704493,3476
3537,3279242917,3239617320,1672673085,1672673516,431
3770,3791246640,3533423872,1672666158,1672667206,1048
3774,3612689556,3500613459,1672680796,1672683648,2852
3723,3505111292,3500302272,1672678186,1672679483,1297
3451,3713589994,3619922891,1672627742,1672629712,1970
3839,3367971170,3905196766,1672608911,1672609786,875
3917,3618354185,3455018347,1672581985,1672583593,1608
3798,3500915908,3791246640,1672689943,1672691084,1141
3809,3757323954,3668533536,1672624110,1672624434,324
3696,3311049964,3410160376,1672639036,1672641053,2017
3829,3703433819,3512295534,1672626053,1672627159,1106
3727,3732584121,3511317276,1672636671,1672638548,1877
3824,3501121099,3205985903,1672698114,1672698528,414
3771,3305722859,3511024016,1672699704,1672702333,2629
3731,3770468980,3701823816,1672607517,1672609751,2234
3451,3509764635,3970909253,1672600921,1672603793,2872
3438,3517590837,3534175249,1672628431,1672630070,1639
3460,3512946768,3904412440,1672658257,1672658335,78
3723,3311498666,3288224595,1672639517,1672642368,2851
3806,3401940259,3349739136,1672588072,1672590260,2188
3846,3513081354,3814677862,1672600756,1672601643,887
3854,3229974066,3408430195,1672637742,1672638591,849
3775,3559731671,3513296868,1672666981,1672668259,1278
3868,3815250107,3793418209,1672661411,1672663994,2583
3636,3778640261,3224811762,1672675168,1672676529,1361
3826,3500709774,3510028805,1672645485,1672647053,1568
3635,3626499450,3823084403,1672632410,1672632836,426
3520,3776988674,3239617320,1672551845,1672552609,764
3742,3736231757,3479851674,1672680283,1672681236,953
3832,3814677862,3755737419,1672615865,1672616430,565
3922,3624297844,3757193307,1672643359,1672646746,3387
3537,3373089838,3897435944,1672545048,1672546159,1111
3858,3438078818,3309314379,1672633338,1672634596,1258
3447,3463740710,3904412440,1672631056,1672634265,3209
3500,3468041839,3373028638,1672630135,1672633718,3583
3784,3792442597,3289114629,1672591004,1672592288,1284
3775,3815392801,3414049538,1672571487,1672574015,2528
3631,3202804048,3299443125,1672581017,1672584128,3111
3778,3715854030,3310039260,1672574477,1672577596,3119
3439,3338390596,3777330107,1672637406,1672640575,3169
3857,3618808151,3509756823,1672691042,1672694265,3223
3809,3780115155,3520578796,1672674693,1672675410,717
3827,3732584121,3417679834,1672583231,1672584350,1119
3519,3311420950,3701373490,1672575508,1672575641,133
3603,3774605761,3770236215,1672531850,1672533817,1967
3724,3617304541,3270697740,1672599690,1672600056,366
3525,3520873221,3760640999,1672569567,1672572381,2814
3833,3834963772,3774031303,1672688828,1672691948,3120
3567,3534829213,3505521218,1672660959,1672664336,3377
3772,3520322124,3228888030,1672587888,1672588186,298
3467,3779656423,3630353876,1672653642,1672654872,1230
3737,3408430195,3610358027,1672587229,1672589833,2604
3594,3623266256,3349739136,1672591544,1672591988,444
3789,3516321888,3500703304,1672591592,1672592709,1117
3471,3292147449,3511843593,1672650645,1672653138,2493
3721,3505178849,3777694660,1672581470,1672582815,1345
3455,3511150845,3757700712,1672549756,1672549932,176
3458,3392520516,3618808151,1672593797,1672593954,157
3806,3604867757,3800257590,1672654170,1672655448,1278
3802,3778134418,3467988782,1672538615,1672541549,2934
3520,3734451191,3276348699,1672549124,1672549891,767
3840,3713163045,3686227677,1672686903,1672688736,1833
3494,3450969839,3505923418,1672619700,1672621618,1918
3658,3897134762,3513360004,1672657053,1672660639,3586
3763,3470454332,3715545685,1672688160,1672688254,94
3893,3780834916,3354144091,1672638967,1672641262,2295
3505,3604867757,3533929349,1672575278,1672575605,327
3506,3230135532,3500841914,1672604389,1672607371,2982
3825,3667673649,3776117322,1672554081,1672557228,3147
3559,3469254160,3513345163,1672688293,1672688788,495
3495,3613899351,3780427126,1672659209,1672662424,3215
3682,3622357348,3773121782,1672549633,1672551983,2350
3904,3500498112,3479851674,1672650255,1672653589,3334
3797,3970627281,3736231757,1672662687,1672665828,3141
3796,3610358027,3701884158,1672687056,1672689455,2399
3612,3505154885,3608232640,1672684698,1672688154,3456
3701,3511150845,3756789525,1672694225,1672695606,1381
3605,3609881958,3975717896,1672703879,1672706448,2569
3591,3773735484,3201629017,1672655159,1672655922,763
3654,3273981374,3689114185,1672535487,1672535768,281
3427,3733558985,3517737088,1672620442,1672622902,2460
3447,3755065949,3333918941,1672623016,1672625500,2484
3522,3510187271,3511150845,1672637248,1672639428,2180
3714,3248058676,3928719932,1672552146,1672555030,2884
3507,3533274994,3783641602,1672665812,1672666683,871
3497,3513853403,3533294425,1672681678,1672682877,1199
3555,3270056120,3635169815,1672545852,1672547015,1163
3431,3415833929,3505923418,1672691953,1672693562,1609
3831,3512722110,3512722110,1672597440,1672601039,3599
3437,3637313265,3812369928,1672631512,1672632435,923
3676,3733558985,3512337405,1672602019,1672602758,739
3670,3505437712,3793883863,1672571483,1672573742,2259
3660,3780338697,3436257398,1672683753,1672685613,1860
3430,3512882178,3514419100,1672545635,1672546754,1119
3589,3776559988,3756789525,1672624060,1672625753,1693
3542,3710489491,3774733620,1672676111,1672677044,933
3556,3836241528,3665998641,1672647633,1672647859,226
3894,3710735406,3791796585,1672655217,1672658692,3475
3439,3793583656,3306175858,1672611649,1672614087,2438
3822,3800257590,3330340793,1672613664,1672616054,2390
3748,3380130228,3898314440,1672595947,1672596262,315
3558,3512800570,3513410578,1672656127,1672656509,382
3467,3462636434,3730071479,1672618186,1672619866,1680
3849,3201800997,3757383891,1672532927,1672535577,2650
3476,3283770991,3757700712,1672585211,1672586552,1341
3665,3897456874,3389634034,1672536107,1672536841,734
3865,3774243020,3505923418,1672672075,1672673005,930
3858,3680843171,3661583097,1672663028,1672664293,1265
3860,3457620713,3713589994,1672543547,1672544773,1226
3707,3534543776,3932478321,1672647658,1672647876,218
3691,3209481722,3792525861,1672622239,1672625393,3154
3711,3777091903,3757323954,1672632113,1672635668,3555
3515,3791046864,3511883730,1672572580,1672575557,2977
3507,3497808662,3621790707,1672634637,1672637936,3299
3907,3462158237,3897435944,1672646586,1672648901,2315
3729,3512830734,3509756823,1672644154,1672645392,1238
3882,3610870949,3510818674,1672602863,1672606130,3267
3884,3923220461,3713691388,1672550204,1672550411,207
3437,3792546035,3774290799,1672656163,1672657112,949
3646,3609113156,3772236797,1672537414,1672539151,1737
3709,3341893384,3208452238,1672568265,1672569096,831
3890,3701424609,3456430614,1672653992,1672654447,455
3658,3617116290,3970909253,1672579867,1672581954,2087
3635,3306412634,3609881958,1672652110,1672653474,1364
3835,3500341755,3756385685,1672686000,1672688550,2550
3854,3351866415,3510767239,1672628623,1672631401,2778
3616,3509756823,3519142371,1672656963,1672660339,3376
3869,3557046880,3780712350,1672593790,1672595451,1661
3885,3703139663,3757193551,1672625687,1672629207,3520
3452,3716963089,3231713082,1672582371,1672583435,1064
3544,3514703118,3470454332,1672674267,1672676009,1742
3895,3462158237,3685816610,1672693807,1672696653,2846
3691,3505283390,3920898925,1672571614,1672574414,2800
3760,3283144118,3900898992,1672696987,1672697395,408
3460,3379143440,3513853403,1672679035,1672679191,156
3577,3777184389,3755065949,1672601091,1672603106,2015
3714,3410538749,3780427126,1672614970,1672616981,2011
3700,3500613459,3792801638,1672698562,1672700699,2137
3911,3280054198,3505807416,1672541973,1672543028,1055
3719,3534829213,3853629553,1672664061,1672665066,1005
3909,3385323994,3343132529,1672532284,1672535366,3082
3885,3684523966,3811040565,1672569386,1672570146,760
3718,3500915908,3824215187,1672548748,1672551632,2884
3818,3780834916,3780571086,1672564137,1672566226,2089
3807,3513545422,3534179433,1672632324,1672634910,2586
3797,3772765746,3226178937,1672678430,1672679248,818
3567,3792389522,3615939504,1672539595,1672540649,1054
3747,3757863420,3682133690,1672553093,1672554696,1603
3511,3623266256,3792014516,1672653373,1672653891,518
3575,3311420950,3891672228,1672664417,1672667427,3010
3600,3450286949,3283492940,1672624746,1672624958,212
3786,3389634034,3304971369,1672581473,1672583233,1760
3664,3310039260,3609113156,1672698961,1672702177,3216
3443,3244004456,3710489491,1672637140,1672638016,876
3824,3315703693,3435167810,1672701243,1672702599,1356
3860,3625174002,3715854030,1672548245,1672550390,2145
3879,3513041785,3622665543,1672673908,1672676520,2612
3785,3621184108,3618697021,1672663782,1672666177,2395
3641,3514275974,3733363628,1672594902,1672597600,2698
3769,3500341755,3370227921,1672535069,1672536644,1575
3746,3630353876,3773124276,1672639590,1672641781,2191
3775,3497671225,3510818674,1672694867,1672696975,2108
3565,3452016771,3533090502,1672605959,1672606739,780
3517,3463740710,3783771827,1672551495,1672554617,3122
3859,3716963089,3519087371,1672696015,1672699470,3455
3424,3248058676,3755737419,1672579626,1672580985,1359
3674,3360069849,3351866415,1672597267,1672599044,1777
3690,3505663516,3200543880,1672543090,1672546257,3167
3430,3338083680,3505228454,1672687115,1672690694,3579
3450,3517697722,3608855425,1672590325,1672593817,3492
3627,3400069268,3401940259,1672548610,1672548974,364
3613,3519446663,3360813161,1672622752,1672622859,107
3771,3392836218,3715385401,1672626157,1672627238,1081
3799,3495911207,3780322355,1672677428,1672677596,168
3696,3897435944,3834963772,1672617625,1672621189,3564
3537,3815392801,3512882178,1672658182,1672660560,2378
3920,3780769110,3701882224,1672615403,1672616030,627
3622,3462636434,3791436104,1672597076,1672599285,2209
3825,3505807416,3519818818,1672655219,1672656776,1557
3695,3370227921,3755344363,1672699716,1672700415,699
3478,3974674109,3783373154,1672556105,1672558294,2189
3509,3414940786,3366423342,1672613275,1672614625,1350
3547,3621184108,3272030610,1672553503,1672553864,361
3759,3792546035,3533079336,1672602046,1672602129,83
3686,3364378127,3225631197,1672630451,1672633462,3011
3588,3618697021,3608855425,1672621994,1672625214,3220
3455,3515401243,3500857494,1672624565,1672626623,2058
3448,3713768950,3501567772,1672685564,1672686471,907
3882,3319167958,3511442562,1672681711,1672682492,781
3549,3363162590,3516741440,1672655606,1672659196,3590
3430,3316798920,3756625818,1672605172,1672605562,390
3627,3755222916,3783163143,1672599955,1672602857,2902
3908,3739154408,3713163045,1672534023,1672534739,716
3741,3817428320,3385323994,1672629175,1672631459,2284
3536,3514324011,3510499038,1672595422,1672597013,1591
3607,3357864626,3514285803,1672555702,1672558832,3130
3741,3428027649,3383138270,1672639997,1672640736,739
3512,3927599181,3711853996,1672683953,1672686750,2797
3550,3371455553,3812369928,1672592498,1672595208,2710
3529,3306412634,3505111292,1672554676,1672556141,1465
3628,3443357683,3613206049,1672545349,1672546509,1160
3850,3230868435,3469254160,1672606576,1672607054,478
3717,3898314440,3283144118,1672538814,1672542096,3282
3690,3491684096,3401940259,1672547502,1672549571,2069
3428,3928511283,3779301501,1672539298,1672542555,3257
3800,3780115155,3231494505,1672623565,1672625192,1627
3613,3793740407,3636329663,1672606327,1672606610,283
3615,3402385957,3665998641,1672596392,1672599606,3214
3453,3201800997,3246370118,1672614059,1672617484,3425
3881,3510554314,3755573472,1672669594,1672670003,409
3686,3454277788,3533188828,1672607153,1672607632,479
3905,3512946768,3501525100,1672613122,1672613681,559
3443,3779301501,3488763230,1672683057,1672684746,1689
3536,3501459390,3520578796,1672620090,1672622641,2551
3527,3791106564,3779938251,1672690367,1672691664,1297
3647,3514334067,3779646172,1672579761,1672583195,3434
3868,3792020993,3760651515,1672662182,1672665442,3260
3789,3793868716,3615688740,1672652668,1672655083,2415
3689,3686227677,3927599181,1672638783,1672642342,3559
3500,3792274796,3715443333,1672625460,1672627535,2075
3513,3513018485,3755573472,1672611797,1672614291,2494
3702,3711637255,3533747868,1672675761,1672677621,1860
3496,3336627643,3975717896,1672617385,1672617932,547
3456,3778134418,3757700712,1672542821,1672544962,2141
3760,3686523546,3516298579,1672650790,1672651710,920
3604,3792274796,3825881598,1672538581,1672540517,1936
3677,3839245934,3925979970,1672590323,1672592570,2247
3513,3739895284,3834960360,1672595148,1672595471,323
3655,3500915908,3770520359,1672657537,1672659544,2007
3709,3276003502,3977148669,1672553188,1672555135,1947
3598,3363162590,3793315718,1672548614,1672551969,3355
3895,3383138270,3505521218,1672537677,1672538426,749
3911,3792801638,3554186380,1672668381,1672669899,1518
3623,3366423342,3402385957,1672581419,1672581690,271
3440,3515525630,3853629553,1672539135,1672542012,2877
3450,3299443125,3715619259,1672609950,1672610066,116
3885,3755848152,3370068529,1672559270,1672559999,729
3563,3667427125,3604867757,1672665046,1672666112,1066
3786,3514324011,3293835352,1672546831,1672547526,695
3777,3600876425,3456430614,1672602149,1672604415,2266
3503,3779425804,3778926763,1672548908,1672550666,1758
3558,3512282789,3226024417,1672621775,1672622549,774
3621,3485540729,3836241528,1672590430,1672593350,2920
3815,3757075324,3500317969,1672677405,1672679234,1829
3747,3518194482,3226024417,1672653690,1672655030,1340
3461,3631479562,3369708250,1672572692,1672572804,112
3878,3760694096,3513545422,1672676345,1672678028,1683
3607,3439673892,3783771827,1672623884,1672624036,152
3745,3755344363,3605221116,1672680386,1672682994,2608
3916,3512295534,3481640525,1672610254,1672611625,1371
3621,3637313265,3246370118,1672552774,1672553710,936
3513,3435167810,3428725843,1672589539,1672591429,1890
3567,3927165965,3276348699,1672620250,1672623468,3218
3851,3229974066,3398198430,1672637736,1672640458,2722
3699,3893912331,3618489670,1672579364,1672581270,1906
3513,3701884158,3834960360,1672593538,1672595547,2009
3461,3272716462,3661583097,1672547600,1672549323,1723
3739,3245232284,3300818269,1672569237,1672571549,2312
3625,3793781065,3505179890,1672640003,1672640490,487
3886,3364378127,3778597171,1672610269,1672613624,3355
3882,3716272919,3276348699,1672552865,1672554429,1564
3489,3686523546,3793407963,1672579704,1672581392,1688
3587,3500525825,3779738691,1672559930,1672562134,2204
3736,3600876425,3505266860,1672670059,1672673451,3392
3678,3337362061,3450969839,1672570104,1672571595,1491
3450,3791441520,3469254160,1672536552,1672538152,1600
3607,3519416013,3448633776,1672668014,1672671584,3570
3806,3533649454,3714120857,1672540359,1672543854,3495
3653,3780338697,3509366311,1672698246,1672700744,2498
3876,3492959689,3713561276,1672541104,1672543752,2648
3732,3231494505,3773572967,1672658574,1672661984,3410
3823,3904569677,3713979100,1672605753,1672609292,3539
3852,3203538212,3713561276,1672699943,1672701117,1174
3780,3500442734,3779425804,1672597796,1672599979,2183
3661,3776559988,3777694660,1672595824,1672598074,2250
3828,3774290799,3394401087,1672555603,1672557011,1408
3751,3622357348,3224968597,1672601364,1672604328,2964
3754,3605221116,3480100311,1672553619,1672553904,285
3511,3774290799,3756474459,1672567595,1672568036,441
3672,3283144118,3625174002,1672632430,1672635108,2678
3725,3209526819,3273981374,1672569826,1672571599,1773
3532,3604589802,3736705719,1672691940,1672694276,2336
3647,3713517039,3915162005,1672562198,1672564452,2254
3889,3370068529,3270056120,1672589536,1672591818,2282
3720,3516489668,3714678331,1672687299,1672688409,1110
3604,3402385957,3309314379,1672667812,1672670778,2966
3693,3505266860,3534175249,1672563332,1672565966,2634
3679,3511317276,3364726656,1672603065,1672603594,529
3877,3270056120,3755233658,1672577991,1672579276,1285
3654,3686523546,3509483172,1672586760,1672589559,2799
3773,3661903000,3403370192,1672601780,1672605260,3480
3902,3834963772,3977148669,1672539571,1672541293,1722
3533,3288762795,3756704774,1672679016,1672680724,1708
3711,3501121099,3778640261,1672640985,1672641307,322
3606,3236354255,3757700712,1672660894,1672664182,3288
3849,3386758279,3783771827,1672616092,1672616919,827
3875,3511317276,3610870949,1672621597,1672622841,1244
3789,3760645796,3533929349,1672690490,1672690963,473
3514,3773009828,3612689556,1672658965,1672661661,2696
3433,3711734586,3294703680,1672632258,1672634770,2512
3888,3311098437,3608232640,1672637477,1672640025,2548
3626,3793922324,3456430614,1672535525,1672537076,1551
3669,3225631197,3773913680,1672589673,1672590424,751
3631,3513545422,3772236797,1672675540,1672677358,1818
3548,3793418209,3977148669,1672571026,1672573477,2451
3534,3510187271,3802932312,1672620743,1672623442,2699
3428,3735374579,3703798634,1672565321,1672568687,3366
3734,3710854064,3246370118,1672542599,1672543239,640
3544,3392943173,3970909253,1672542944,1672545103,2159
3553,3800257590,3500347447,1672700184,1672701097,913
3904,3338390596,3902625986,1672657162,1672660146,2984
3633,3312998540,3792801638,1672560146,1672562538,2392
3526,3510837901,3309314379,1672629432,1672629851,419
3568,3710735406,3713941638,1672650370,1672651593,1223
3785,3410160376,3779425804,1672685779,1672686454,675
3545,3511883730,3514275974,1672601130,1672601786,656
3860,3414275042,3755737419,1672614549,1672615284,735
3737,3836241528,3780872464,1672681263,1672682669,1406
3655,3515466096,3534543776,1672643819,1672645149,1330
3774,3760924079,3835422146,1672552304,1672555277,2973
3546,3488763230,3895285664,1672607776,1672610014,2238
3869,3611055563,3970603231,1672591712,1672594383,2671
3842,3510028805,3429943738,1672620598,1672621614,1016
3626,3335694356,3776518452,1672589156,1672590020,864
3850,3457620713,3533004959,1672624807,1672626292,1485
3839,3334951866,3638204468,1672565830,1672568475,2645
3742,3236499444,3938503547,1672638891,1672641983,3092
3874,3613416045,3343816795,1672671940,1672672391,451
3702,3533368789,3510837901,1672545898,1672546958,1060
3783,3850911686,3516513251,1672557809,1672560308,2499
3885,3460719322,3713300120,1672689272,1672691920,2648
3642,3410600350,3512383699,1672584062,1672585140,1078
3853,3519651506,3421877923,1672658488,1672661226,2738
3625,3431460073,3404025196,1672546198,1672548477,2279
3611,3205985903,3509893027,1672687544,1672689438,1894
3759,3665998641,3792505974,1672597198,1672600101,2903
3832,3715854030,3808136029,1672596343,1672598154,1811
3635,3793868716,3715400486,1672671207,1672674771,3564
3475,3774790271,3777694660,1672559208,1672560936,1728
3478,3520355798,3371455553,1672547787,1672548181,394
3672,3360069849,3512958459,1672652559,1672656013,3454
3874,3793868716,3734118023,1672593755,1672596893,3138
3592,3931627862,3500109249,1672640488,1672643546,3058
3833,3710496785,3367111751,1672595969,1672599201,3232
3771,3554186380,3364726656,1672694445,1672696697,2252
3656,3715086894,3829822608,1672532072,1672532420,348
3651,3230135532,3299443125,1672538909,1672540360,1451
3845,3357689359,3824215187,1672543919,1672544015,96
3618,3757903168,3480490124,1672577920,1672579981,2061
3513,3519818818,3515401243,1672664766,1672666083,1317
3667,3777330107,3926643445,1672632523,1672634705,2182
3845,3613416045,3757332128,1672532413,1672534568,2155
3819,3412006598,3711637255,1672590692,1672591162,470
3578,3661447322,3793883863,1672658999,1672659559,560
3882,3304155815,3228888030,1672686675,1672687891,1216
3667,3972192593,3499217428,1672533259,1672535298,2039
3552,3734915241,3631479562,1672625658,1672627953,2295
3675,3701005527,3609659642,1672643370,1672646769,3399
3750,3412006598,3392836218,1672578761,1672581923,3162
3556,3310125159,3812369928,1672631947,1672634326,2379
3709,3304971369,3462158237,1672609982,1672612387,2405
3495,3533929349,3519077659,1672586064,1672587964,1900
3783,3701373490,3791246640,1672660298,1672662702,2404
3678,3520115090,3770146716,1672587436,1672590738,3302
3691,3613899351,3306412634,1672538297,1672540264,1967
3475,3517687662,3933894942,1672685372,1672688285,2913
3528,3756704774,3514308235,1672673019,1672675721,2702
3499,3701322924,3701247948,1672699175,1672700119,944
3605,3915162005,3284947372,1672569864,1672573328,3464
3896,3480100311,3970603231,1672650477,1672652014,1537
3767,3853629553,3512830734,1672553858,1672556854,2996
3701,3401940259,3410160376,1672594346,1672596117,1771
3873,3791128487,3792020993,1672610411,1672613178,2767
3850,3383138270,3713589994,1672575780,1672577028,1248
3427,3733363628,3636329663,1672597817,1672601168,3351
3697,3711077927,3622665543,1672609525,1672613102,3577
3674,3737972328,3428725843,1672652065,1672652737,672
3443,3783928182,3514419100,1672555700,1672556507,807
3444,3509483172,3636329663,1672550933,1672552365,1432
3438,3760364383,3240394404,1672653773,1672655490,1717
3741,3631090677,3897376951,1672540332,1672541866,1534
3922,3899786664,3394401087,1672534482,1672536281,1799
3779,3554944414,3472312341,1672686510,1672688386,1876
3914,3780909839,3773009828,1672587703,1672590144,2441
3788,3300229945,3682133690,1672656452,1672657067,615
3497,3793868716,3817813340,1672698528,1672699625,1097
3648,3480100311,3296462324,1672533952,1672537368,3416
3796,3688220326,3716963089,1672687248,1672688287,1039
3586,3500604680,3928719932,1672650631,1672653590,2959
3680,3714666884,3517687662,1672666535,1672668224,1689
3684,3349856820,3520115090,1672618634,1672620306,1672
3908,3715854030,3760364383,1672579712,1672582671,2959
3848,3932478321,3488763230,1672553862,1672554489,627
3892,3755230952,3914691363,1672587573,1672590945,3372
3582,3383138270,3685816610,1672564598,1672565499,901
3615,3236499444,3271454397,1672698649,1672700278,1629
3691,3431460073,3621790707,1672641798,1672644825,3027
3556,3897456874,3755532873,1672619278,1672619743,465
3488,3421385957,3394401087,1672568762,1672569840,1078
3755,3791436104,3899326793,1672582007,1672582786,779
3619,3756746867,3779656423,1672574292,1672577334,3042
3465,3515466096,3457960571,1672655861,1672658093,2232
3770,3200308999,3512722110,1672542348,1672542731,383
3833,3517222913,3902861231,1672603109,1672603557,448
3637,3311098437,3533294425,1672659591,1672661181,1590
3614,3757700712,3715545685,1672650653,1672653134,2481
3566,3519909393,3367111751,1672585356,1672588663,3307
3908,3823084403,3512383699,1672670155,1672673683,3528
3696,3716963089,3859868849,1672630787,1672633045,2258
3863,3885121158,3514275974,1672589664,1672592837,3173
3656,3831586487,3519087371,1672561973,1672563602,1629
3706,3279339278,3757348722,1672649916,1672652693,2777
3735,3505434346,3770676872,1672603911,1672605841,1930
3728,3440107959,3209481722,1672578797,1672579642,845
3628,3970909253,3714185969,1672582773,1672583924,1151
3521,3517172354,3814677862,1672577140,1672580703,3563
3560,3859868849,3688220326,1672567725,1672568219,494
3854,3774790271,3293835352,1672680177,1672680902,725
3725,3505481368,3890739241,1672601648,1672601921,273
3717,3236499444,3715385401,1672594941,1672595557,616
3702,3774155692,3404025196,1672661622,1672664771,3149
3780,3780338697,3315703693,1672656916,1672657804,888
3756,3516903528,3834631333,1672626784,1672627839,1055
3470,3513041785,3667673649,1672664453,1672667648,3195
3723,3815392801,3209481722,1672643023,1672643443,420
3522,3512337405,3533079336,1672555339,1672556870,1531
3683,3773735484,3607768197,1672644112,1672646256,2144
3484,3669146016,3533747868,1672649411,1672652359,2948
3802,3757700712,3512502036,1672545773,1672548998,3225
3801,3885157459,3703383853,1672675562,1672678421,2859
3566,3534543776,3376467719,1672565814,1672567034,1220
3506,3514334067,3533747868,1672694323,1672697111,2788
3594,3501281016,3783169442,1672667332,1672669108,1776
3863,3279242917,3792525861,1672574811,1672576489,1678
3585,3515402792,3271454397,1672544743,1672547935,3192
3507,3364378127,3410600350,1672667051,1672667883,832
3885,3701322924,3858172636,1672690767,1672691371,604
3685,3513410578,3533090502,1672596973,1672598644,1671
3542,3613206049,3244004456,1672536203,1672539221,3018
3779,3770438122,3618489670,1672556208,1672556969,761
3445,3972083617,3505179890,1672570747,1672571421,674
3678,3364726656,3412006598,1672650420,1672653225,2805
3690,3920898925,3224968597,1672597782,1672601316,3534
3444,3624297844,3777779869,1672597551,1672599229,1678
3648,3701322924,3520873221,1672639328,1672641952,2624
3871,3279339278,3319167958,1672624631,1672626851,2220
3716,3713691388,3792274796,1672619274,1672620938,1664
3720,3293835352,3814677862,1672674533,1672676471,1938
3476,3509756823,3505179890,1672559834,1672561774,1940
3425,3384068080,3773572967,1672575306,1672576546,1240
3869,3511317276,3701823816,1672629764,1672629934,170
3668,3783433404,3239617320,1672560221,1672562998,2777
3432,3618489670,3497808662,1672586706,1672587676,970
3497,3478114114,3895285664,1672617307,1672620205,2898
3893,3229822507,3914691363,1672688385,1672690481,2096
3871,3803389195,3716110860,1672555664,1672557261,1597
3824,3510554314,3402385957,1672536828,1672537035,207
3901,3394401087,3343816795,1672608157,1672611637,3480
3509,3500347447,3447672935,1672566889,1672569668,2779
3735,3512295534,3683113954,1672701020,1672702442,1422
3887,3514956366,3533294425,1672541925,1672545317,3392
3839,3270697740,3401793306,1672635723,1672638653,2930
3827,3272030610,3226178937,1672639999,1672643000,3001
3795,3398198430,3241914067,1672590221,1672591758,1537
3455,3382733096,3289114629,1672653874,1672657039,3165
3753,3514308235,3710854064,1672688412,1672688686,274
3793,3711097754,3621461051,1672546161,1672548615,2454
3889,3500737582,3408498208,1672540046,1672540752,706
3826,3311085279,3760842815,1672635732,1672638007,2275
3824,3520416075,3793740407,1672663401,1672664207,806
3708,3415833929,3780427126,1672595874,1672596794,920
3487,3684523966,3518565331,1672695781,1672697305,1524
3672,3513296868,3510818674,1672619126,1672619891,765
3499,3421877923,3736705719,1672663255,1672665864,2609
3439,3518229776,3926643445,1672569988,1672571904,1916
3902,3921648519,3615688740,1672671382,1672674798,3416
3555,3500208903,3755915206,1672637075,1672637930,855
3756,3638660068,3435167810,1672658399,1672659322,923
3646,3559731671,3793740407,1672567485,1672569967,2482
3466,3534179433,3760645796,1672660653,1672662674,2021
3695,3490214516,3793175445,1672548664,1672551761,3097
3484,3520115090,3792072681,1672676633,1672680051,3418
3638,3777147510,3511317276,1672582743,1672584080,1337
3847,3715545685,3517288083,1672627252,1672629123,1871
3548,3357689359,3288224595,1672638450,1672641999,3549
3454,3490214516,3414940786,1672626850,1672628266,1416
3425,3224811762,3500737582,1672633496,1672633968,472
3827,3615113018,3500613493,1672701312,1672704862,3550
3745,3833217041,3780472203,1672636657,1672637259,602
3654,3334647380,3283770991,1672585823,1672585906,83
3648,3777330107,3770236215,1672676442,1672679363,2921
3443,3510798825,3300229945,1672624294,1672627649,3355
3723,3510641433,3414049538,1672622681,1672623172,491
3689,3921648519,3505888598,1672631055,1672631304,249
3504,3905899155,3737147209,1672593554,1672593924,370
3515,3534566651,3382733096,1672625262,1672626992,1730
3803,3791796585,3977352557,1672626892,1672629567,2675
3604,3296462324,3703383853,1672578414,1672579046,632
3555,3900276517,3930242012,1672558699,1672558811,112
3851,3812534508,3240394404,1672693444,1672693628,184
3460,3970558632,3440137407,1672599506,1672602458,2952
3692,3739911441,3304155815,1672542629,1672543860,1231
3619,3885537225,3515559913,1672592522,1672593716,1194
3784,3514334067,3757332128,1672651555,1672655053,3498
3845,3417679834,3373028638,1672590826,1672593179,2353
3848,3755573472,3505634634,1672632085,1672635532,3447
3480,3777189898,3755915206,1672648478,1672651078,2600
3876,3777624586,3310039260,1672533517,1672534104,587
3825,3311420950,3373089838,1672555909,1672556944,1035
3922,3350095157,3304971369,1672598816,1672599363,547
3810,3357864626,3386758279,1672632267,1672632982,715
3741,3834960360,3701882224,1672695413,1672697316,1903
3810,3977352557,3630353876,1672568753,1672572126,3373
3759,3396726504,3410538749,1672534891,1672537506,2615
3497,3776559988,3226511603,1672566359,1672566867,508
3874,3934064792,3505634634,1672597329,1672597768,439
3891,3500672156,3715086894,1672604078,1672604987,909
3808,3780712350,3703348097,1672627572,1672627920,348
3478,3739661856,3534764451,1672652877,1672655504,2627
3798,3793922324,3631090677,1672668007,1672670539,2532
3844,3513295938,3757348722,1672600295,1672602698,2403
3575,3732131656,3505634634,1672596277,1672597058,781
3736,3715385401,3512295534,1672617941,1672618640,699
3608,3472312341,3732584121,1672534597,1672536420,1823
3747,3510187271,3897435944,1672598979,1672599110,131
3729,3276348699,3778899160,1672642680,1672645068,2388
3453,3793868716,3900945856,1672615962,1672619062,3100
3442,3384068080,3889780657,1672643304,1672644561,1257
3676,3622665543,3711853996,1672580068,1672581239,1171
3630,3520355798,3773033649,1672532274,1672533190,916
3858,3617489344,3512282789,1672581044,1672583837,2793
3571,3899786664,3893912331,1672559408,1672562719,3311
3481,3231713082,3780769110,1672561918,1672563252,1334
3723,3245232284,3505521218,1672628777,1672630159,1382
3426,3370227921,3280268483,1672616045,1672617389,1344
3604,3905196766,3398198430,1672597616,1672600842,3226
3917,3689114185,3276217799,1672598086,1672601578,3492
3673,3533004959,3779646172,1672631589,1672634200,2611
3466,3510028805,3757318448,1672681770,1672684899,3129
3764,3505847380,3783147088,1672536164,1672536354,190
3801,3364726656,3450286949,1672614325,1672615409,1084
3740,3517991730,3509764635,1672606994,1672608069,1075
3426,3512830734,3510767239,1672534027,1672537477,3450
3798,3492546679,3791436104,1672655995,1672657117,1122
3667,3931627862,3533649454,1672653012,1672656588,3576
3562,3818575661,3512337405,1672572732,1672574931,2199
3474,3783373154,3701424609,1672568987,1672569858,871
3558,3887243870,3760721303,1672607481,1672610312,2831
3503,3803389195,3514285803,1672628498,1672629454,956
3592,3500915665,3818575661,1672537235,1672539926,2691
3690,3905196766,3468041839,1672674714,1672678199,3485
3454,3617304541,3858172636,1672590692,1672592796,2104
3725,3714185969,3885537225,1672653405,1672655085,1680
3720,3757700712,3372223551,1672658983,1672661828,2845
3777,3755737419,3334993594,1672614165,1672617456,3291
3587,3226511603,3372223551,1672605977,1672607088,1111
3863,3436257398,3774290799,1672666819,1672670271,3452
3893,3927403123,3500317969,1672631210,1672633676,2466
3611,3755344363,3338390596,1672593149,1672594646,1497
3709,3792538417,3661903000,1672541501,1672544331,2830
3720,3880926355,3336339664,1672663393,1672666699,3306
3568,3685681577,3783615982,1672578132,1672579012,880
3920,3618808151,3511024016,1672567402,1672569446,2044
3833,3559731671,3791046864,1672611874,1672613992,2118
3441,3514971533,3631479562,1672696821,1672697681,860
3553,3481640525,3500709774,1672549467,1672552313,2846
3874,3446533960,3638204468,1672542578,1672544599,2021
3899,3384068080,3289817992,1672618700,1672620273,1573
3915,3349739136,3554944414,1672639661,1672642255,2594
3478,3330340793,3246370118,1672622047,1672623645,1598
3649,3779301501,3500672156,1672675088,1672677807,2719
3621,3635169815,3760645796,1672533791,1672534530,739
3558,3357289672,3686523546,1672698592,1672698689,97
3493,3446533960,3515466096,1672610184,1672612038,1854
3607,3755992176,3402697190,1672685828,1672688354,2526
3841,3517222913,3438489358,1672609992,1672612612,2620
3750,3660887799,3713691388,1672701308,1672703589,2281
3781,3511442562,3224330592,1672581902,1672584011,2109
3442,3510554314,3517172354,1672699948,1672701379,1431
3877,3500072204,3414275042,1672560390,1672561468,1078
3606,3821054646,3520115090,1672632242,1672633985,1743
3504,3520657891,3306412634,1672569936,1672573447,3511
3484,3510818674,3904867554,1672665426,1672666163,737
3523,3803389195,3636329663,1672541158,1672541676,518
3739,3778899160,3283492940,1672603297,1672604286,989
3879,3669146016,3713829743,1672558095,1672561534,3439
3841,3283492940,3511024016,1672703428,1672704318,890
3627,3515439826,3335694356,1672695919,1672697022,1103
3917,3710735406,3533747868,1672588936,1672591235,2299
3911,3513065217,3311498666,1672636978,1672638077,1099
3748,3367111751,3300229945,1672569350,1672571110,1760
3688,3770624662,3779425804,1672625000,1672628241,3241
3763,3783163143,3229974066,1672684695,1672685876,1181
3593,3617489344,3518229776,1672694982,1672697919,2937
3445,3370227921,3480991549,1672626215,1672628682,2467
3524,3791128487,3689114185,1672595029,1672597188,2159
3743,3241914067,3770676872,1672700087,1672701711,1624
3759,3436257398,3280268483,1672677354,1672677427,73
3524,3467988782,3202804048,1672611107,1672613326,2219
3887,3512295534,3554944414,1672639774,1672641406,1632
3823,3734118023,3490214516,1672609520,1672609603,83
3507,3689114185,3519818818,1672575985,1672579360,3375
3663,3402385957,3226178937,1672566557,1672567150,593
3774,3791693821,3447514821,1672591691,1672592214,523
3873,3755344363,3779438325,1672695651,1672696752,1101
3445,3429943738,3757075324,1672638234,1672639536,1302
3643,3512383699,3783928182,1672639479,1672640167,688
3888,3792442597,3276269264,1672576266,1672577279,1013
3772,3390660440,3739154408,1672594240,1672595981,1741
3502,3379143440,3780209375,1672598130,1672598913,783
3693,3283492940,3972192593,1672614508,1672617556,3048
3917,3351866415,3514512367,1672656430,1672659611,3181
3561,3755915206,3906536154,1672615520,1672616252,732
3741,3760924079,3505725706,1672571996,1672572852,856
3585,3774790271,3921648519,1672577976,1672579797,1821
3480,3514703118,3450969839,1672592210,1672593561,1351
3637,3892304880,3554186380,1672584581,1672584781,200
3876,3300818269,3777037426,1672615527,1672619047,3520
3485,3517687662,3974674109,1672601611,1672602298,687
3831,3688796737,3510642075,1672676936,1672678172,1236
3904,3241914067,3315279093,1672551926,1672553831,1905
3643,3800257590,3534543776,1672557397,1672558898,1501
3767,3336627643,3928719932,1672578055,1672579716,1661
3668,3440107959,3500613459,1672578566,1672581887,3321
3625,3714670620,3777037426,1672591369,1672592763,1394
3691,3534175249,3304971369,1672690034,1672693585,3551
3451,3760645796,3412006598,1672543520,1672545475,1955
3545,3457960571,3505228454,1672691770,1672693383,1613
3859,3518561777,3974674109,1672539491,1672541782,2291
3749,3735374579,3396980894,1672541435,1672541872,437
3763,3780322355,3205985903,1672597116,1672600002,2886
3559,3780712350,3772236797,1672700738,1672702522,1784
3919,3970198861,3701823816,1672609813,1672610976,1163
3883,3500737582,3431502855,1672605331,1672606332,1001
3466,3757075324,3512722110,1672605723,1672607507,1784
3451,3757700712,3534543776,1672554153,1672557379,3226
3761,3686227677,3779613523,1672538799,1672539492,693
3447,3613899351,3701136026,1672557561,1672557708,147
3869,3309314379,3757700712,1672673333,1672675508,2175
3764,3512722110,3855583256,1672614520,1672615855,1335
3505,3793922324,3556969573,1672642071,1672644423,2352
3432,3777485931,3370227921,1672676484,1672677587,1103
3534,3402697190,3500604680,1672539851,1672543057,3206
3786,3206837348,3835422146,1672590654,1672592682,2028
3455,3923420131,3514818819,1672626323,1672629005,2682
3487,3337362061,3823084403,1672605141,1672607540,2399
3629,3635169815,3778640261,1672550870,1672552704,1834
3859,3714185969,3450969839,1672609095,1672612480,3385
3714,3398198430,3501281016,1672693624,1672696995,3371
3740,3513041785,3938389661,1672627600,1672628560,960
3521,3291933594,3421385957,1672577501,1672578963,1462
3601,3688220326,3512800570,1672618453,1672620386,1933
3450,3897376951,3510554314,1672582634,1672585872,3238
3706,3435116799,3292147449,1672615828,1672616338,510
3470,3509764635,3416987084,1672599159,1672602313,3154
3772,3773572967,3334647380,1672552595,1672555012,2417
3767,3272030610,3897435944,1672539757,1672541642,1885
3702,3240994288,3511732493,1672536034,1672538886,2852
3457,3533929349,3500827202,1672638159,1672641049,2890
3542,3557046880,3299443125,1672546838,1672549150,2312
3821,3228888030,3399472693,1672655670,1672657017,1347
3675,3818575661,3311098437,1672639405,1672639470,65
3753,3793922324,3713163045,1672619329,1672621890,2561
3645,3613581796,3518565331,1672607418,1672609152,1734
3695,3241790910,3519028898,1672600134,1672603483,3349
3775,3793743698,3617392620,1672694671,1672697585,2914
3491,3505437712,3777184389,1672603747,1672605902,2155
3690,3710048469,3351866415,1672580273,1672583128,2855
3810,3608232640,3416987084,1672662298,1672664017,1719
3553,3229822507,3780472203,1672677629,1672680689,3060
3783,3501215099,3515559913,1672598435,1672599511,1076
3581,3448633776,3755573472,1672587734,1672590151,2417
3558,3778640261,3520322124,1672610476,1672611773,1297
3597,3631479562,3615939504,1672689329,1672692186,2857
3779,3884596900,3777624586,1672562060,1672563106,1046
3527,3491684096,3783550022,1672667753,1672671180,3427
3610,3618489670,3447672935,1672690027,1672691336,1309
3865,3415833929,3501457103,1672556310,1672557152,842
3581,3631090677,3449639012,1672644166,1672647589,3423
3835,3620292035,3505995057,1672532349,1672534562,2213
3859,3636329663,3246370118,1672569546,1672572101,2555
3730,3780253901,3315279093,1672681477,1672684409,2932
3649,3701373490,3519909393,1672611506,1672615072,3566
3834,3240394404,3711077927,1672630618,1672632520,1902
3645,3793740407,3615115210,1672647679,1672649302,1623
3844,3755737419,3835422146,1672553195,1672556257,3062
3775,3514703118,3512958459,1672663943,1672665978,2035
3510,3977148669,3501567772,1672613153,1672615762,2609
3455,3436025562,3276003502,1672618931,1672619539,608
3758,3613581796,3501281016,1672623913,1672627130,3217
3823,3457620713,3900898992,1672692991,1672696247,3256
3885,3225636215,3421385957,1672660669,1672662677,2008
3547,3732584121,3791753345,1672640873,1672644417,3544
3621,3633735593,3779738691,1672632474,1672634103,1629
3914,3660063072,3533423872,1672564340,1672566192,1852
3648,3519651506,3441348818,1672559312,1672562025,2713
3576,3520560590,3776034743,1672691330,1672693296,1966
3881,3513296868,3627368399,1672658572,1672661529,2957
3851,3613899351,3773735484,1672552857,1672553108,251
3703,3279475486,3801645328,1672671461,1672674842,3381
3722,3291933594,3451691949,1672595079,1672597728,2649
3437,3500044458,3636329663,1672698589,1672700590,2001
3649,3777485931,3607882826,1672684887,1672687222,2335
3517,3667673649,3533090502,1672685637,1672687863,2226
3738,3780209375,3402385957,1672602814,1672604189,1375
3665,3773913680,3715086894,1672614465,1672616183,1718
3459,3898314440,3972083617,1672634938,1672635504,566
3472,3505228454,3710048469,1672533254,1672534912,1658
3837,3715986185,3791693821,1672626747,1672628922,2175
3844,3755344363,3927403123,1672613662,1672614273,611
3498,3500703304,3554825448,1672570578,1672572645,2067
3605,3515466096,3556969573,1672578428,1672581427,2999
3779,3238288884,3710489491,1672655785,1672656341,556
3889,3516298579,3349739136,1672659824,1672662475,2651
3771,3774876004,3934064792,1672564133,1672566518,2385
3850,3485540729,3776244398,1672610197,1672612404,2207
3526,3505179890,3203538212,1672551493,1672555046,3553
3803,3409114719,3300511067,1672685792,1672687456,1664
3910,3500949309,3505283390,1672653959,1672657395,3436
3558,3668747074,3449333754,1672698001,1672698489,488
3852,3415833929,3303410628,1672630327,1672630724,397
3556,3487875183,3777814504,1672601160,1672604245,3085
3901,3201629017,3455018347,1672620657,1672622782,2125
3555,3711637255,3979784676,1672689486,1672691722,2236
3678,3478114114,3500317969,1672664150,1672666683,2533
3577,3777814504,3801645328,1672679736,1672681465,1729
3640,3829822608,3501384020,1672580690,1672581296,606
3782,3402385957,3293835352,1672678996,1672681101,2105
3755,3517737088,3773735484,1672701490,1672704693,3203
3882,3349739136,3711000597,1672608057,1672608694,637
3919,3902625986,3779613523,1672602370,1672605791,3421
3769,3604589802,3511288998,1672573616,1672576896,3280
3897,3776034743,3792489602,1672562041,1672563570,1529
3676,3664943873,3478114114,1672547037,1672548263,1226
3554,3780472203,3501786419,1672575391,1672576305,914
3456,3716272919,3777189898,1672531578,1672532094,516
3450,3500949309,3380767040,1672570135,1672571440,1305
3518,3668414677,3370227921,1672582553,1672585977,3424
3687,3756704774,3448875382,1672672846,1672674334,1488
3775,3928719932,3220031931,1672544395,1672545434,1039
3796,3793781065,3347446226,1672682132,1672685406,3274
3590,3394401087,3755230952,1672681644,1672684105,2461
3668,3272716462,3410600350,1672575219,1672578427,3208
3805,3739154408,3615939504,1672602400,1672604717,2317
3681,3488686442,3780322355,1672644800,1672647049,2249
3537,3285204083,3777485931,1672601335,1672604761,3426
3707,3272030610,3306412634,1672554430,1672557597,3167
3576,3505434346,3792546035,1672582809,1672584415,1606
3505,3457620713,3621790707,1672643410,1672646248,2838
3650,3927403123,3500525825,1672685101,1672687302,2201
3817,3368283077,3779656423,1672649778,1672650504,726
3720,3279242917,3621683102,1672535101,1672537374,2273
3500,3714120857,3664943873,1672567487,1672569146,1659
3903,3770704999,3714120857,1672690145,1672690764,619
3545,3688220326,3974674109,1672593283,1672594839,1556
3871,3305722859,3783641602,1672532780,1672532850,70
3887,3510837901,3333403880,1672701557,1672702926,1369
3779,3783163143,3920898925,1672599045,1672602178,3133
3771,3774155692,3621683102,1672677716,1672678519,803
3518,3500949309,3402385957,1672626879,1672628781,1902
3551,3636329663,3500442734,1672587748,1672588005,257
3633,3520181148,3533423872,1672636770,1672637293,523
3768,3904867554,3774705415,1672563060,1672565706,2646
3847,3756625818,3292147449,1672656941,1672657608,667
3521,3756746867,3350095157,1672608353,1672610562,2209
3794,3710489491,3610870949,1672639924,1672640635,711
3794,3360069849,3701247948,1672590252,1672593281,3029
3901,3516321888,3514275974,1672542897,1672545654,2757
3450,3512830734,3715854030,1672658453,1672658867,414
3919,3520322124,3897456874,1672576281,1672578447,2166
3876,3435167810,3514741348,1672616236,1672618236,2000
3616,3385323994,3970558632,1672652918,1672654285,1367
3509,3668747074,3429943738,1672564259,1672566502,2243
3915,3839245934,3755233658,1672616815,1672618233,1418
3730,3376467719,3518561777,1672653409,1672655531,2122
3629,3756789525,3780872464,1672620419,1672621819,1400
3691,3481640525,3915162005,1672552180,1672553711,1531
3529,3739895284,3755230952,1672697221,1672698598,1377
3620,3774031303,3834963772,1672696694,1672696780,86
3892,3509764635,3373089838,1672680145,1672682725,2580
3526,3715443333,3905899155,1672612459,1672615998,3539
3659,3664943873,3534357694,1672656027,1672659559,3532
3779,3760721303,3686227677,1672685738,1672686256,518
3546,3934064792,3970603231,1672625380,1672627580,2200
3669,3780115155,3438489358,1672602446,1672604958,2512
3454,3853629553,3713300120,1672656397,1672656950,553
3590,3811040565,3777240360,1672701291,1672703891,2600
3485,3360813161,3512383699,1672626176,1672629270,3094
3680,3514246749,3783928182,1672642795,1672645680,2885
3834,3897435944,3902760230,1672645021,1672645532,511
3463,3517590837,3614740489,1672625483,1672628544,3061
3443,3899786664,3231494505,1672662911,1672664268,1357
3689,3394401087,3505434346,1672560043,1672561714,1671
3442,3779532653,3551389192,1672615924,1672617805,1881
3500,3713768950,3701136026,1672664751,1672665484,733
3429,3880926355,3884596900,1672560023,1672560746,723
3883,3511005395,3276003502,1672636699,1672639604,2905
3625,3774243020,3689697817,1672559808,1672560141,333
3909,3520560590,3772236797,1672589279,1672590598,1319
3564,3280268483,3533090502,1672612629,1672614738,2109
3589,3778640261,3514512367,1672534706,1672535507,801
3466,3625463628,3513065217,1672591881,1672593620,1739
3591,3858172636,3604867757,1672692682,1672695929,3247
3667,3517590837,3701823816,1672624486,1672626560,2074
3813,3292147449,3334951866,1672664857,1672665538,681
3440,3783615982,3518229776,1672624497,1672624566,69
3523,3554944414,3714233826,1672638698,1672639614,916
3487,3270056120,3780115155,1672665530,1672668074,2544
3522,3858172636,3336339664,1672600464,1672602990,2526
3606,3780115155,3480991549,1672703440,1672704032,592
3515,3757193307,3834631333,1672540528,1672540891,363
3515,3739661856,3279475486,1672616151,1672617034,883
3754,3236458894,3443357683,1672573034,1672575095,2061
3634,3783136330,3791246640,1672607869,1672610826,2957
3752,3779532653,3554944414,1672572636,1672572889,253
3484,3834960360,3441348818,1672639959,1672643189,3230
3919,3774790271,3730071479,1672644324,1672647241,2917
3751,3774243020,3661583097,1672627789,1672629897,2108
3832,3780427126,3701107228,1672601333,1672604461,3128
3761,3711853996,3783615982,1672555267,1672557166,1899
3687,3509483172,3351696332,1672696592,1672698987,2395
3638,3904569677,3488686442,1672573244,1672574697,1453
3887,3520416075,3349739136,1672611675,1672614541,2866
3826,3276348699,3779854934,1672617552,1672620916,3364
3615,3688796737,3509366311,1672574857,1672575977,1120
3777,3823084403,3689114185,1672643667,1672645133,1466
3866,3792538417,3437286517,1672626004,1672628713,2709
3631,3777147510,3714128600,1672630668,1672634124,3456
3492,3510187271,3773027597,1672542182,1672543756,1574
3506,3617304541,3733363628,1672594663,1672596450,1787
3554,3202141727,3920625129,1672687120,1672687215,95
3446,3511442562,3619922891,1672639892,1672642906,3014
3733,3755233658,3756474459,1672696548,1672699698,3150
3768,3779646172,3404025196,1672534835,1672535194,359
3830,3411515369,3533423872,1672616872,1672618331,1459
3755,3495911207,3701424609,1672563526,1672565028,1502
3544,3519446663,3512499658,1672600595,1672601214,619
3636,3416987084,3505154885,1672574474,1672577100,2626
3512,3414049538,3319167958,1672671547,1672675033,3486
3633,3777184389,3773033649,1672681708,1672682671,963
3561,3757630221,3511883730,1672583632,1672584497,865
3644,3533228966,3635169815,1672556625,1672558016,1391
3592,3909094917,3511005395,1672669239,1672670549,1310
3883,3793883863,3778597171,1672646772,1672649737,2965
3525,3241914067,3774718695,1672651471,1672653722,2251
3592,3519850727,3404025196,1672663289,1672665422,2133
3777,3617392620,3923420131,1672612860,1672615586,2726
3532,3938503547,3900276517,1672569835,1672570630,795
3646,3668414677,3516489668,1672591743,1672594268,2525
3768,3410600350,3231494505,1672548992,1672549998,1006
3436,3610870949,3909094917,1672691829,1672694735,2906
3622,3703383853,3774907131,1672559611,1672562981,3370
3617,3710562338,3613899351,1672593028,1672593709,681
3865,3534543776,3755848152,1672573584,1672574071,487
3765,3447672935,3780209375,1672557629,1672559466,1837
3776,3730071479,3770676872,1672612460,1672614755,2295
3540,3380767040,3774876004,1672541372,1672543463,2091
3573,3452016771,3279475486,1672592655,1672595567,2912
3912,3970558632,3734118023,1672535564,1672538874,3310
3821,3493017654,3501121099,1672592118,1672594770,2652
3552,3236499444,3533274994,1672662712,1672665233,2521
3683,3714666884,3613338363,1672613800,1672616874,3074
3631,3757323954,3511005395,1672634355,1672637889,3534
3901,3316800320,3518653080,1672536327,1672539295,2968
3844,3791046864,3515559913,1672689546,1672691473,1927
3439,3927403123,3519818818,1672680653,1672682278,1625
3750,3412006598,3292147449,1672672911,1672674173,1262
3456,3402385957,3304971369,1672582784,1672583412,628
3636,3791128487,3777779869,1672550843,1672551113,270
3707,3497095254,3309314379,1672571751,1672574139,2388
3604,3701664364,3382733096,1672551764,1672554431,2667
3785,3510028805,3485540729,1672566871,1672567342,471
3558,3839245934,3454277788,1672654529,1672654981,452
3653,3614740489,3661903000,1672567601,1672569936,2335
3854,3451326054,3334974375,1672581417,1672584638,3221
3563,3412968120,3793868716,1672618339,1672620686,2347
3894,3225631197,3516703758,1672656638,1672657519,881
3829,3308760650,3885121158,1672655097,1672657476,2379
3720,3417191856,3701373490,1672695889,1672697785,1896
3457,3667427125,3772236797,1672538906,1672539811,905
3654,3462158237,3920625129,1672556127,1672557178,1051
3837,3472068734,3306175858,1672696638,1672700059,3421
3869,3773121782,3229974066,1672687421,1672689698,2277
3504,3778134418,3467988782,1672619951,1672623051,3100
3826,3793407963,3554825448,1672642349,1672644084,1735
3714,3533274994,3554186380,1672688001,1672690152,2151
3737,3512383699,3224330592,1672615809,1672616986,1177
3791,3710496785,3777814504,1672702496,1672705433,2937
3904,3513295938,3273981374,1672552839,1672553289,450
3600,3793583656,3451326054,1672568373,1672571801,3428
3675,3683113954,3818575661,1672689056,1672689296,240
3895,3915162005,3534543776,1672698989,1672701023,2034
3656,3505634634,3447514821,1672691238,1672693975,2737
3433,3364726656,3783641602,1672582475,1672582667,192
3842,3904867554,3511791953,1672674472,1672676206,1734
3610,3779656423,3511024016,1672640830,1672641912,1082
3818,3815392801,3979802715,1672673623,1672673987,364
3542,3409114719,3557046880,1672592551,1672593435,884
3704,3760364383,3774243020,1672605548,1672606891,1343
3869,3773009828,3512499658,1672544643,1672546449,1806
3745,3774733620,3225631197,1672663234,1672665231,1997
3662,3770296583,3276269264,1672700744,1672702852,2108
3880,3783801141,3780712350,1672616491,1672618630,2139
3512,3739661856,3505266860,1672539641,1672541303,1662
3850,3457620713,3607768197,1672559680,1672561631,1951
3471,3315703693,3779786641,1672558487,1672560784,2297
3764,3970909253,3920625129,1672625184,1672628577,3393
3838,3509756823,3520181148,1672636686,1672639388,2702
3873,3760362417,3897435944,1672646609,1672648353,1744
3665,3410160376,3500347447,1672703662,1672704358,696
3752,3819767045,3856606678,1672556634,1672559483,2849
3819,3779438325,3890739241,1672635597,1672635747,150
3540,3513081354,3514971533,1672558082,1672559947,1865
3463,3292147449,3979784676,1672553409,1672556900,3491
3428,3688796737,3920898925,1672620714,1672624083,3369
3558,3533368789,3460719322,1672551683,1672552204,521
3905,3779738691,3533188828,1672681576,1672683332,1756
3886,3330340793,3772078494,1672614616,1672615416,800
3711,3776117322,3330340793,1672535449,1672535516,67
3569,3369708250,3688490530,1672558087,1672558823,736
3691,3783147088,3774641380,1672663306,1672666081,2775
3446,3270056120,3431502855,1672687501,1672688329,828
3821,3514246749,3777240360,1672630958,1672633458,2500
3685,3703396825,3760842815,1672666150,1672667812,1662
3741,3972083617,3209481722,1672552122,1672554476,2354
3611,3209526819,3755404116,1672699962,1672701579,1617
3666,3755065949,3713784974,1672615436,1672615747,311
3916,3826238375,3274906650,1672689459,1672690157,698
3643,3760651515,3519818818,1672700115,1672702970,2855
3888,3511601997,3773033649,1672539558,1672541843,2285
3825,3510919821,3760924079,1672667138,1672669499,2361
3470,3938503547,3711919537,1672702120,1672705587,3467
3842,3817428320,3756385685,1672597163,1672598778,1615
3847,3228888030,3443357683,1672603083,1672605119,2036
3864,3714120857,3501786419,1672599052,1672600240,1188
3652,3451691949,3360069849,1672542336,1672543800,1464
3581,3852533643,3732131656,1672699473,1672700821,1348
3853,3777189898,3368283077,1672701834,1672703854,2020
3838,3437286517,3688220326,1672627648,1672628176,528
3565,3757075324,3515401243,1672618234,1672618560,326
3867,3515439826,3384583385,1672638254,1672641403,3149
3773,3520639768,3757863420,1672593202,1672594606,1404
3664,3610870949,3615688740,1672679558,1672681652,2094
3660,3280054198,3890739241,1672629430,1672630347,917
3562,3783771827,3714827719,1672625247,1672626298,1051
3816,3533423872,3971806004,1672662602,1672663791,1189
3778,3680843171,3493017654,1672648943,1672650684,1741
3856,3760094385,3514703118,1672611391,1672612827,1436
3578,3626499450,3520115090,1672575996,1672578359,2363
3483,3680810086,3783169442,1672578587,1672580888,2301
3553,3713300120,3783801141,1672660157,1672663395,3238
3543,3703798634,3824641227,1672626113,1672628655,2542
3761,3778667336,3241914067,1672617234,1672618517,1283
3914,3757075324,3710562338,1672687055,1672689222,2167
3447,3509764635,3374183227,1672584766,1672585707,941
3545,3338083680,3773902805,1672614433,1672617554,3121
3764,3316800320,3791246640,1672658232,1672659566,1334
3871,3701107228,3638660068,1672657279,1672660161,2882
3708,3271454397,3639050419,1672694030,1672697596,3566
3512,3411688875,3414049538,1672683670,1672685967,2297
3771,3505283390,3500841914,1672663156,1672664633,1477
3918,3757383891,3520181148,1672603069,1672604563,1494
3588,3511601997,3518229776,1672605162,1672607681,2519
3434,3513295938,3680843171,1672582947,1672583660,713
3887,3519142371,3392520516,1672608053,1672608406,353
3685,3491469603,3793935736,1672696629,1672697472,843
3874,3500498112,3395201292,1672542850,1672545403,2553
3530,3824215187,3703798634,1672566829,1672569018,2189
3798,3897134762,3970198861,1672584509,1672585195,686
3494,3884596900,3631479562,1672601821,1672604451,2630
3484,3779646172,3533649454,1672577431,1672578466,1035
3819,3511791953,3884596900,1672545382,1672548708,3326
3878,3711734586,3792072681,1672703144,1672705897,2753
3609,3780571086,3220031931,1672659784,1672660199,415
3645,3513296868,3770146716,1672689201,1672691917,2716
3851,3900945856,3613899351,1672635731,1672638631,2900
3428,3609881958,3823084403,1672601591,1672603239,1648
3529,3411688875,3401793306,1672599798,1672603054,3256
3633,3497671225,3533368789,1672540926,1672542220,1294
3710,3534179433,3293835352,1672561657,1672562184,527
3779,3780680950,3229974066,1672628578,1672631902,3324
3481,3802932312,3885537225,1672559566,1672562945,3379
3595,3338083680,3835985172,1672621824,1672622184,360
3779,3792949946,3310039260,1672596180,1672598084,1904
3789,3436257398,3501525100,1672690109,1672693179,3070
3581,3518194482,3812534508,1672594752,1672596610,1858
3543,3505154885,3836241528,1672579604,1672581028,1424
3849,3713163045,3230135532,1672563918,1672565856,1938
3543,3904569677,3402697190,1672579806,1672579934,128
3547,3410160376,3736705719,1672601463,1672603846,2383
3812,3757323954,3274831810,1672576113,1672576348,235
3717,3505198734,3505923418,1672635644,1672638946,3302
3574,3500841914,3780909839,1672678144,1672681725,3581
3551,3505663516,3689697817,1672634234,1672637316,3082
3669,3793883863,3710562338,1672543579,1672544421,842
3495,3703139663,3520873221,1672695474,1672695870,396
3450,3615115210,3334993594,1672666270,1672666562,292
3616,3779613523,3559731671,1672647042,1672650455,3413
3770,3510919821,3514275974,1672645548,1672646839,1291
3588,3360069849,3370068529,1672585457,1672586224,767
3784,3513545422,3777814504,1672605572,1672606514,942
3757,3306412634,3500341755,1672678344,1672681132,2788
3821,3373028638,3463740710,1672582215,1672585239,3024
3489,3792014516,3713561276,1672584593,1672585935,1342
3424,3979784676,3897456874,1672572745,1672574291,1546
3448,3630353876,3737147209,1672594604,1672595139,535
3705,3617489344,3792014516,1672623971,1672626097,2126
3754,3621184108,3445206685,1672549705,1672551874,2169
3879,3364378127,3619922891,1672565766,1672567356,1590
3468,3774876004,3686523546,1672570634,1672574181,3547
3699,3292147449,3756127300,1672665725,1672667104,1379
3870,3520639768,3316798920,1672600639,1672602230,1591
3521,3819767045,3909094917,1672697888,1672700042,2154
3808,3612689556,3972192593,1672624823,1672628135,3312
3480,3853629553,3505725706,1672563434,1672563690,256
3523,3517687662,3516741440,1672563191,1672564593,1402
3438,3755915206,3463740710,1672675319,1672677957,2638
3555,3209481722,3897456874,1672609672,1672609810,138
3688,3296462324,3412006598,1672671547,1672671818,271
3447,3638660068,3373089838,1672684925,1672685202,277
3610,3343816795,3424445495,1672656068,1672657108,1040
3630,3979784676,3220031931,1672629415,1672630115,700
3792,3338390596,3713691388,1672607648,1672610349,2701
3581,3714670620,3414275042,1672571423,1672573594,2171
3812,3500857494,3668414677,1672672863,1672673570,707
3503,3931627862,3774790271,1672619065,1672621786,2721
3739,3396980894,3793418209,1672650407,1672651645,1238
3793,3441703884,3305722859,1672613298,1672616479,3181
3742,3892304880,3505663516,1672547286,1672550793,3507
3859,3495911207,3774907131,1672696570,1672699559,2989
3809,3514971533,3935399379,1672604886,1672606077,1191
3654,3631090677,3518565331,1672647537,1672647874,337
3804,3618697021,3793743698,1672557653,1672560526,2873
3459,3520873221,3533294425,1672628533,1672629179,646
3862,3515401243,3779786641,1672687585,1672691066,3481
3437,3760842815,3772391882,1672548227,1672550379,2152
3753,3512882178,3417679834,1672596684,1672597242,558
3588,3515401243,3513065217,1672537184,1672540105,2921
3460,3300229945,3979784676,1672698625,1672698901,276
3680,3780769110,3436025562,1672587965,1672589478,1513
3751,3852533643,3774705415,1672557748,1672561181,3433
3584,3500347447,3514308235,1672682661,1672683826,1165
3694,3909094917,3839245934,1672544645,1672545090,445
3487,3757075324,3375449013,1672671822,1672674343,2521
3900,3635169815,3383138270,1672565784,1672568498,2714
3546,3513018485,3468041839,1672565728,1672566849,1121
3483,3760040019,3792489602,1672565914,1672568548,2634
3671,3500857494,3776034743,1672549048,1672549457,409
3849,3515466096,3519416013,1672606946,1672608414,1468
3438,3490029863,3520657891,1672547918,1672550862,2944
3426,3398731252,3975717896,1672573596,1672575635,2039
3728,3285204083,3240394404,1672698895,1672702414,3519
3513,3410538749,3306175858,1672625798,1672628400,2602
3732,3895285664,3514275974,1672625444,1672628909,3465
3451,3225631197,3773009828,1672701888,1672702594,706
3520,3514275974,3450286949,1672656550,1672656782,232
3761,3551376095,3904569677,1672607051,1672608622,1571
3626,3778040015,3770624662,1672585303,1672587380,2077
3740,3783641602,3316800320,1672688121,1672688497,376
3708,3533274994,3660887799,1672582004,1672583489,1485
3803,3774733620,3622665543,1672595754,1672596253,499
3877,3701107228,3371455553,1672612185,1672615694,3509
3874,3311049964,3739154408,1672658220,1672659300,1080
3593,3520416075,3310039260,1672559204,1672561654,2450
3633,3533368789,3510964997,1672703471,1672703759,288
3513,3513853403,3409114719,1672625888,1672627548,1660
3835,3205985903,3497671225,1672549239,1672550566,1327
3824,3518565331,3517462308,1672604018,1672605291,1273
3555,3669146016,3899326793,1672676032,1672678846,2814
3847,3500442734,3380767040,1672665966,1672668290,2324
3667,3289817992,3614740489,1672627877,1672629084,1207
3814,3770520359,3734451191,1672603581,1672603752,171
3869,3734451191,3624297844,1672545605,1672549090,3485
3711,3402697190,3714678331,1672691859,1672694528,2669
3859,3480100311,3710562338,1672539132,1672540208,1076
3779,3513410578,3369708250,1672688537,1672690949,2412
3867,3500604680,3927165965,1672672272,1672673841,1569
3678,3974674109,3443357683,1672531304,1672532803,1499
3692,3710735406,3362641275,1672670573,1672672472,1899
3606,3773332082,3900898992,1672575320,1672575571,251
3714,3792525861,3414940786,1672547623,1672548363,740
3888,3757348722,3824641227,1672615731,1672616131,400
3521,3515890966,3511150845,1672597698,1672600006,2308
3753,3620292035,3511843593,1672697786,1672698586,800
3833,3557046880,3501567772,1672643995,1672644637,642
3543,3512722110,3614740489,1672676989,1672677816,827
3432,3632814465,3773837847,1672552431,1672556026,3595
3856,3716628503,3509366311,1672641695,1672642715,1020
3753,3519651506,3279475486,1672634384,1672637292,2908
3680,3347446226,3660887799,1672565262,1672568564,3302
3831,3779646172,3791436104,1672605561,1672607895,2334
3659,3480490124,3773735484,1672614812,1672615975,1163
3463,3770438122,3605221116,1672570140,1672573333,3193
3841,3330340793,3773837847,1672668427,1672671246,2819
3593,3701664364,3505228454,1672549439,1672549845,406
3871,3510767239,3779854934,1672662523,1672664178,1655
3922,3770468980,3779438325,1672655169,1672657088,1919
3564,3514818819,3480100311,1672639817,1672642308,2491
3693,3756789525,3300229945,1672653434,1672656284,2850
3904,3620292035,3335694356,1672628808,1672631027,2219
3758,3780872464,3818575661,1672613511,1672614426,915
3652,3300818269,3833217041,1672543625,1672547189,3564
3610,3415833929,3755222916,1672692704,1672695861,3157
3425,3404025196,3852533643,1672538664,1672539245,581
3720,3505283390,3714827719,1672627749,1672629796,2047
3606,3519446663,3244004456,1672702423,1672704471,2048
3922,3505198734,3309314379,1672648037,1672648758,721
3786,3927599181,3686227677,1672616001,1672619076,3075
3466,3515525630,3368283077,1672611761,1672612329,568
3665,3224968597,3927599181,1672608244,1672610317,2073
3531,3533929349,3279473441,1672624450,1672624672,222
3518,3517991730,3319167958,1672661861,1672664837,2976
3588,3884596900,3220031931,1672639498,1672641191,1693
3655,3518229776,3487875183,1672622165,1672624312,2147
3882,3401793306,3395201292,1672579484,1672579769,285
3669,3899326793,3668414677,1672593227,1672595300,2073
3589,3714185969,3792014516,1672663875,1672664348,473
3451,3305336154,3272030610,1672666915,1672670219,3304
3873,3559458968,3835422146,1672587244,1672587975,731
3450,3791796585,3501459390,1672616209,1672616742,533
3706,3689114185,3517222913,1672552885,1672554399,1514
3642,3688796737,3773939399,1672611779,1672613781,2002
3524,3779786641,3703139663,1672653268,1672653887,619
3476,3500703304,3780253901,1672578854,1672580037,1183
3875,3902625986,3923220461,1672640258,1672640508,250
3582,3412968120,3511024016,1672633526,1672634642,1116
3557,3783801141,3283770991,1672682254,1672683521,1267
3660,3347446226,3514419100,1672629752,1672630997,1245
3447,3824215187,3501281016,1672643430,1672645624,2194
3647,3715619259,3831586487,1672591251,1672594305,3054
3764,3756789525,3478114114,1672570021,1672572391,2370
3698,3916490839,3372223551,1672633185,1672635101,1916
3494,3611055563,3515401243,1672540958,1672541829,871
3800,3311085279,3505228454,1672698684,1672701031,2347
3893,3792745809,3780322355,1672545735,1672547968,2233
3888,3449333754,3516513251,1672620782,1672624176,3394
3609,3514419100,3315703693,1672552419,1672554571,2152
3635,3755158925,3835985172,1672581149,1672581917,768
3475,3710489491,3283144118,1672586004,1672589002,2998
3755,3244004456,3770624662,1672560935,1672562150,1215
3826,3490029863,3777240360,1672700729,1672702214,1485
3822,3311049964,3661583097,1672640682,1672643693,3011
3870,3627368399,3409114719,1672575226,1672577701,2475
3440,3429943738,3713911104,1672592697,1672595894,3197
3633,3906536154,3757348722,1672538011,1672541113,3102
3755,3823084403,3701247948,1672641395,1672644159,2764
3907,3934064792,3410160376,1672605900,1672606957,1057
3655,3884596900,3424445495,1672591639,1672592829,1190
3638,3688490530,3226178937,1672587695,1672589075,1380
3680,3505437712,3382733096,1672602629,1672603411,782
3542,3776034743,3773572967,1672595210,1672595851,641
3689,3232208416,3248058676,1672646618,1672649556,2938
3640,3891672228,3384583385,1672565566,1672569141,3575
3808,3343132529,3756385685,1672669413,1672670188,775
3902,3880926355,3835422146,1672690336,1672693502,3166
3786,3778597171,3208957949,1672649362,1672651926,2564
3612,3294747828,3513018485,1672622395,1672623113,718
3694,3481640525,3928511283,1672588219,1672589865,1646
3811,3480726047,3298151889,1672641781,1672644787,3006
3501,3684523966,3774733620,1672561784,1672563112,1328
3785,3921648519,3512958459,1672559861,1672560885,1024
3832,3438078818,3411515369,1672657351,1672660769,3418
3570,3711000597,3902760230,1672616476,1672618244,1768
3564,3703348097,3481640525,1672645445,1672647194,1749
3491,3512946768,3513065217,1672676365,1672679182,2817
3578,3780472203,3366423342,1672609247,1672611448,2201
3712,3792538417,3776117322,1672696359,1672699904,3545
3835,3760640999,3859868849,1672615668,1672617493,1825
3897,3520639768,3739154408,1672581589,1672582489,900
3871,3398731252,3829864515,1672703059,1672705063,2004
3887,3933894942,3512392431,1672688535,1672689029,494
3823,3517737088,3308760650,1672659907,1672660742,835
3535,3779738691,3756704774,1672623877,1672626752,2875
3449,3736705719,3238288884,1672551985,1672552282,297
3825,3824215187,3454277788,1672532739,1672534559,1820
3648,3970627281,3688490530,1672567653,1672570071,2418
3756,3203538212,3890739241,1672672781,1672675585,2804
3788,3668533536,3757193551,1672643659,1672646077,2418
3873,3500347447,3501567772,1672687945,1672688990,1045
3897,3512392431,3450286949,1672658099,1672660622,2523
3575,3479851674,3935913584,1672551736,1672554597,2861
3918,3685681577,3732131656,1672677367,1672679953,2586
3507,3513327337,3519446663,1672641289,1672644598,3309
3899,3710562338,3831586487,1672577441,1672580512,3071
3618,3791128487,3792538417,1672590304,1672591289,985
3594,3979784676,3668414677,1672688968,1672692394,3426
3829,3512722110,3686523546,1672599910,1672601163,1253
3727,3613581796,3607882826,1672651441,1672654660,3219
3833,3236499444,3935487534,1672642929,1672643887,958
3805,3513360004,3609933747,1672546345,1672548718,2373
3556,3505154885,3817428320,1672604091,1672604368,277
3848,3739895284,3776559988,1672620353,1672621704,1351
3628,3755233658,3201629017,1672637854,1672639139,1285
3659,3500915908,3505111292,1672544567,1672548008,3441
3636,3664943873,3514419100,1672690498,1672692238,1740
3868,3760263530,3665998641,1672619825,1672621658,1833
3789,3777240360,3615087943,1672580642,1672581634,992
3668,3779786641,3534829213,1672670703,1672671278,575
3722,3760640999,3520873221,1672653683,1672655801,2118
3748,3852533643,3713589994,1672632291,1672633641,1350
3496,3780769110,3715443333,1672570402,1672573562,3160
3718,3774031303,3285204083,1672676753,1672679348,2595
3739,3520560590,3780712350,1672574372,1672577377,3005
3577,3777240360,3773572967,1672627127,1672628123,996
3818,3774718695,3791796585,1672668050,1672669256,1206
3667,3791106564,3202804048,1672699953,1672703156,3203
3798,3776084820,3686227677,1672566129,1672568944,2815
3647,3757630221,3783169442,1672697639,1672698510,871
3748,3793935736,3518565331,1672584432,1672585428,996
3693,3512502036,3885121158,1672702081,1672704608,2527
3821,3777091903,3533079336,1672626906,1672630460,3554
3650,3701882224,3757348722,1672558112,1672559184,1072
3620,3770236215,3732131656,1672544336,1672547902,3566
3873,3701247948,3835422146,1672587184,1672587767,583
3546,3772391882,3711006062,1672678592,1672681351,2759
3624,3755756564,3614740489,1672576728,1672578186,1458
3736,3201800997,3357864626,1672581309,1672582753,1444
3664,3470454332,3760721303,1672567604,1672570319,2715
3657,3619922891,3510499038,1672587135,1672587286,151
3655,3776831527,3835422146,1672604009,1672604789,780
3817,3791436104,3497095254,1672638928,1672642371,3443
3494,3517991730,3517590837,1672564335,1672565485,1150
3447,3756746867,3713768950,1672684149,1672686015,1866
3893,3534179433,3209526819,1672655162,1672658358,3196
3468,3618176292,3895285664,1672553727,1672555165,1438
3514,3793407963,3244004456,1672681176,1672683478,2302
3788,3456430614,3834963772,1672629110,1672632093,2983
3912,3449639012,3814677862,1672573642,1672573964,322
3479,3443357683,3334647380,1672683174,1672685537,2363
3719,3626499450,3330340793,1672561081,1672564223,3142
3746,3714678331,3512499658,1672568257,1672571204,2947
3917,3909094917,3463740710,1672651086,1672651682,596
3563,3711218296,3814677862,1672648996,1672649857,861
3879,3354144091,3501281016,1672598872,1672599549,677
3900,3236499444,3895285664,1672695366,1672695645,279
3645,3970627281,3773332082,1672587860,1672590267,2407
3865,3514334067,3534764451,1672672496,1672673464,968
3472,3710496785,3934064792,1672646335,1672647877,1542
3734,3520991398,3520560590,1672662927,1672664913,1986
3846,3500341755,3711853996,1672559007,1672562532,3525
3636,3630353876,3689697817,1672578730,1672579577,847
3661,3551399764,3932478321,1672699106,1672699830,724
3514,3392836218,3778667336,1672566677,1672567697,1020
3919,3829864515,3370068529,1672535789,1672536577,788
3506,3200543880,3777694660,1672701031,1672704088,3057
3878,3713911104,3730071479,1672591109,1672593632,2523
3725,3279339278,3478114114,1672681464,1672684934,3470
3461,3735374579,3710489491,1672599830,1672600956,1126
3811,3773033649,3777694660,1672550433,1672551434,1001
3582,3774718695,3280268483,1672644759,1672646156,1397
3912,3972192593,3403370192,1672692272,1672694467,2195
3692,3514703118,3711919537,1672672175,1672673436,1261
3526,3770146716,3516903528,1672577846,1672580158,2312
3460,3760364383,3520416075,1672635218,1672637517,2299
3516,3305336154,3923220461,1672636851,1672636952,101
3609,3457620713,3334647380,1672573338,1672575284,1946
3563,3812369928,3711919537,1672687929,1672689468,1539
3735,3778667336,3755992176,1672551955,1672554012,2057
3801,3730071479,3401940259,1672568055,1672569593,1538
3668,3636329663,3914691363,1672591201,1672594015,2814
3880,3225631197,3900898992,1672697200,1672698335,1135
3909,3638660068,3300229945,1672560945,1672563475,2530
3734,3384068080,3617392620,1672670270,1672673625,3355
3732,3792949946,3512722110,1672587039,1672588139,1100
3745,3451726367,3755737419,1672689543,1672691524,1981
3886,3515559913,3501281016,1672541494,1672544514,3020
3497,3518229776,3711637255,1672541451,1672542248,797
3676,3273981374,3923754072,1672679485,1672681545,2060
3916,3770624662,3777037426,1672549288,1672551549,2261
3891,3534126409,3501281016,1672677742,1672678358,616
3912,3686523546,3500777439,1672666728,1672666894,166
3921,3777037426,3905196766,1672651602,1672653371,1769
3823,3533079336,3208452238,1672589456,1672591576,2120
3754,3511791953,3714120857,1672612822,1672614944,2122
3586,3792072681,3715986185,1672556218,1672558818,2600
3704,3757193307,3557046880,1672580196,1672583003,2807
3540,3615939504,3451726367,1672671451,1672674307,2856
3883,3488763230,3520355798,1672534078,1672534810,732
3429,3559458968,3904412440,1672699192,1672701458,2266
3505,3513545422,3500317969,1672599638,1672602396,2758
3657,3755573472,3512882178,1672668537,1672668849,312
3898,3858172636,3245232284,1672557121,1672559064,1943
3907,3793418209,3900945856,1672582456,1672583004,548
3829,3274831810,3779639983,1672538113,1672539235,1122
3742,3716963089,3626499450,1672595548,1672597969,2421
3546,3803389195,3770520359,1672602460,1672604945,2485
3797,3779738691,3774155692,1672578866,1672582374,3508
3485,3615115210,3776518452,1672606538,1672610136,3598
3481,3519416013,3774243020,1672607665,1672608405,740
3430,3311085279,3780712350,1672572373,1672573539,1166
3754,3513018485,3392520516,1672674742,1672675775,1033
3860,3517358573,3920625129,1672685220,1672685623,403
3802,3513018485,3501786419,1672604972,1672607383,2411
3838,3780680950,3791046864,1672538252,1672540403,2151
3650,3380982774,3273981374,1672689367,1672690452,1085
3887,3271752081,3294703680,1672696724,1672700182,3458
3634,3850911686,3779301501,1672541800,1672543188,1388
3889,3505111292,3774705415,1672536046,1672536653,607
3612,3500498112,3201676087,1672577698,1672578467,769
3851,3710489491,3500072204,1672531446,1672534928,3482
3433,3276269264,3492959689,1672588205,1672588467,262
3698,3774178201,3791441520,1672567851,1672569467,1616
3614,3513545422,3534179433,1672625276,1672627744,2468
3743,3779854934,3688490530,1672626721,1672629843,3122
3762,3512800570,3230868435,1672604785,1672607776,2991
3727,3757075324,3623266256,1672603742,1672606407,2665
3662,3399472693,3630353876,1672629234,1672632039,2805
3843,3783919913,3756474459,1672660918,1672663237,2319
3564,3713300120,3501215099,1672591992,1672595185,3193
3566,3239617320,3610870949,1672558992,1672561335,2343
3520,3756474459,3760924079,1672621177,1672624601,3424
3494,3778899160,3411688875,1672648030,1672650215,2185
3584,3394401087,3408430195,1672679397,1672680741,1344
3692,3779532653,3505847380,1672586110,1672588338,2228
3866,3852533643,3834960360,1672574912,1672575802,890
3470,3514956366,3927599181,1672662636,1672665000,2364
3516,3462273042,3229822507,1672622625,1672624942,2317
3836,3520639768,3534357694,1672682837,1672683538,701
3508,3517288083,3792014516,1672630054,1672630187,133
3801,3305336154,3858172636,1672532191,1672533258,1067
3736,3360813161,3688796737,1672637828,1672637995,167
3435,3977352557,3336627643,1672696565,1672700011,3446
3823,3773033649,3516703758,1672658289,1672659819,1530
3765,3714067076,3480490124,1672545575,1672546007,432
3509,3814305099,3367971170,1672549661,1672550763,1102
3496,3500915908,3533274994,1672659938,1672662066,2128
3703,3401496246,3511442562,1672607369,1672609543,2174
3758,3755496114,3312998540,1672683825,1672685599,1774
3895,3270056120,3513360004,1672611069,1672611729,660
3628,3661583097,3421385957,1672581111,1672583457,2346
3630,3225029895,3834631333,1672532923,1672536191,3268
3568,3739911441,3533228966,1672616026,1672619150,3124
3844,3398731252,3505995057,1672551593,1672551738,145
3855,3793175445,3398731252,1672604144,1672605275,1131
3796,3462273042,3812534508,1672541208,1672542560,1352
3816,3480991549,3803389195,1672546128,1672546712,584
3607,3472068734,3383138270,1672653692,1672655681,1989
3541,3366423342,3715385401,1672684938,1672687467,2529
3486,3760842815,3779613523,1672664369,1672666084,1715
3862,3418448389,3715086894,1672623384,1672624461,1077
3705,3467779445,3756789525,1672661021,1672664477,3456
3621,3617304541,3885155975,1672569393,1672570908,1515
3744,3689114185,3779656423,1672617983,1672618257,274
3732,3770296583,3770146716,1672572450,1672573800,1350
3761,3372223551,3208452238,1672580370,1672580564,194
3483,3791613604,3514956366,1672680607,1672680933,326
3823,3517881647,3639050419,1672550685,1672554185,3500
3857,3793922324,3713768950,1672609759,1672612272,2513
3724,3279473441,3779438325,1672607150,1672609108,1958
3614,3711919537,3623266256,1672677502,1672678214,712
3741,3513041785,3776117322,1672617509,1672620052,2543
3676,3480726047,3617116290,1672671557,1672674114,2557
3533,3689114185,3633735593,1672604389,1672607025,2636
3638,3516513251,3617489344,1672698067,1672698968,901
3831,3755496114,3779301501,1672648709,1672650592,1883
3578,3756474459,3452016771,1672556878,1672558254,1376
3657,3343132529,3819767045,1672554953,1672557742,2789
3747,3514741348,3792745809,1672555941,1672558298,2357
3810,3685681577,3284932450,1672631587,1672632273,686
3530,3713691388,3274906650,1672619141,1672619703,562
3553,3614740489,3902861231,1672653082,1672655314,2232
3638,3462273042,3408430195,1672614124,1672616431,2307
3453,3272030610,3414940786,1672564468,1672567578,3110
3794,3791128487,3401793306,1672611838,1672613336,1498
3552,3783169442,3357864626,1672539296,1672540870,1574
3490,3510919821,3306412634,1672532380,1672534318,1938
3607,3497671225,3401793306,1672574864,1672575875,1011
3567,3972192593,3315703693,1672593666,1672593804,138
3444,3514275974,3516321888,1672690034,1672690958,924
3511,3617489344,3757903168,1672594036,1672595164,1128
3531,3613206049,3779646172,1672531218,1672531424,206
3608,3638660068,3760651515,1672537079,1672537651,572
3679,3885155975,3701005527,1672667679,1672668584,905
3809,3834631333,3354144091,1672621445,1672622763,1318
3471,3400069268,3303410628,1672548547,1672551494,2947
3784,3604867757,3791753345,1672700702,1672700849,147
3472,3400069268,3777147510,1672665461,1672667483,2022
3914,3205923620,3625463628,1672603785,1672606850,3065
3515,3791106564,3780209375,1672555928,1672558335,2407
3471,3632814465,3889780657,1672577462,1672578201,739
3477,3416987084,3230135532,1672648568,1672651380,2812
3466,3311420950,3914691363,1672691428,1672692588,1160
3669,3205985903,3620292035,1672583454,1672583565,111
3567,3783520186,3779646172,1672624518,1672625777,1259
3669,3533188828,3350095157,1672542483,1672544846,2363
3649,3777147510,3516741440,1672561967,1672564037,2070
3847,3517887477,3714666884,1672650422,1672652582,2160
3661,3609881958,3492959689,1672688579,1672688938,359
3918,3773027597,3792801638,1672643552,1672644867,1315
3428,3447514821,3293835352,1672604931,1672607652,2721
3446,3783136330,3839245934,1672554493,1672558028,3535
3635,3905899155,3972192593,1672698179,1672699550,1371
3763,3341893384,3520181148,1672664661,1672668150,3489
3876,3347419520,3288762795,1672657653,1672660796,3143
3814,3853629553,3389634034,1672681383,1672683764,2381
3650,3779738691,3612689556,1672635833,1672637022,1189
3762,3514512367,3733363628,1672632817,1672633115,298
3425,3310039260,3703348097,1672650221,1672651010,789
3729,3792801638,3734451191,1672625535,1672627854,2319
3706,3815250107,3733363628,1672649971,1672650987,1016
3798,3621683102,3757193551,1672647694,1672649142,1448
3576,3447514821,3638660068,1672648622,1672649634,1012
3780,3501121099,3619922891,1672572685,1672573104,419
3734,3373089838,3928719932,1672643618,1672644096,478
3522,3975717896,3505521218,1672611357,1672613190,1833
3654,3774733620,3505402439,1672608508,1672609305,797
3659,3338083680,3617116290,1672690243,1672691961,1718
3899,3613416045,3516903528,1672649917,1672653436,3519
3785,3248058676,3736705719,1672651241,1672653489,2248
3648,3505111292,3783147088,1672548927,1672549790,863
3768,3514419100,3621790707,1672678127,1672679183,1056
3424,3755404116,3208957949,1672559065,1672561166,2101
3847,3363162590,3511791953,1672581025,1672581969,944
3764,3557046880,3514971533,1672635852,1672636678,826
3493,3783520186,3635169815,1672600199,1672602130,1931
3643,3293835352,3772391882,1672685393,1672686550,1157
3565,3824215187,3757630221,1672532544,1672535808,3264
3438,3915162005,3334951866,1672695943,1672697264,1321
3685,3519850727,3732131656,1672596728,1672600267,3539
3584,3402385957,3480490124,1672703784,1672704470,686
3668,3626499450,3517697722,1672627368,1672627490,122
3771,3812369928,3534126409,1672600325,1672600501,176
3448,3533274994,3418448389,1672655214,1672657201,1987
3756,3885537225,3734451191,1672654358,1672657093,2735
3717,3491684096,3367111751,1672559294,1672561981,2687
3631,3517462308,3393063657,1672635303,1672638220,2917
3456,3715385401,3500915665,1672578361,1672580526,2165
3778,3230135532,3938503547,1672607030,1672609650,2620
3458,3284932450,3774705415,1672670677,1672673923,3246
3861,3519850727,3283492940,1672644646,1672647270,2624
3760,3514703118,3514971533,1672680049,1672680497,448
3752,3296462324,3791046864,1672602478,1672603993,1515
3454,3626499450,3927165965,1672673062,1672674890,1828
3552,3716110860,3514285803,1672696810,1672699943,3133
3501,3779656423,3360813161,1672556610,1672559438,2828
3712,3772078494,3660887799,1672677087,1672679550,2463
3818,3817428320,3897376951,1672590009,1672590653,644
3575,3773735484,3505228454,1672557814,1672559577,1763
3457,3604867757,3513853403,1672543353,1672544548,1195
3805,3479851674,3492959689,1672533723,1672534694,971
3912,3711637255,3510767239,1672532848,1672533309,461
3482,3904867554,3933894942,1672591948,1672594401,2453
3489,3279473441,3834631333,1672537121,1672538243,1122
3567,3710489491,3520355798,1672640912,1672643996,3084
3873,3520416075,3360813161,1672554932,1672556908,1976
3856,3501121099,3970558632,1672698172,1672699124,952
3443,3516903528,3309314379,1672591842,1672594725,2883
3839,3710048469,3551389192,1672627250,1672629336,2086
3659,3633735593,3512722110,1672676782,1672679970,3188
3715,3757383891,3971806004,1672683549,1672686676,3127
3607,3835422146,3350095157,1672636124,1672638452,2328
3526,3500208903,3351696332,1672685559,1672685868,309
3477,3774178201,3638660068,1672548683,1672550746,2063
3744,3395201292,3513295938,1672570337,1672572488,2151
3671,3615688740,3715127070,1672684787,1672686264,1477
3803,3833217041,3514512367,1672689952,1672692495,2543
3747,3369708250,3755848152,1672567218,1672567469,251
3688,3683113954,3920625129,1672628090,1672628504,414
3731,3701823816,3829822608,1672647555,1672649310,1755
3469,3520578796,3780680950,1672685639,1672687638,1999
3719,3519850727,3467779445,1672684936,1672687881,2945
3862,3505111292,3351696332,1672565335,1672568416,3081
3447,3777694660,3736705719,1672635394,1672636537,1143
3905,3300511067,3431502855,1672630316,1672631095,779
3670,3780769110,3401496246,1672602779,1672604618,1839
3831,3756625818,3437286517,1672649567,1672652325,2758
3892,3779738691,3897376951,1672680595,1672683607,3012
3438,3380982774,3479851674,1672662020,1672662971,951
3601,3501121099,3701322924,1672612613,1672613932,1319
3453,3925979970,3783801141,1672616153,1672618883,2730
3766,3933894942,3778134418,1672651486,1672653894,2408
3661,3755496114,3279473441,1672555146,1672558541,3395
3874,3783163143,3414049538,1672590886,1672594373,3487
3548,3505923418,3780872464,1672598914,1672599074,160
3588,3514419100,3701136026,1672662147,1672664207,2060
3525,3479851674,3776831527,1672636263,1672639732,3469
3650,3935913584,3660887799,1672655589,1672658110,2521
3606,3776559988,3516513251,1672576390,1672577143,753
3706,3774031303,3711919537,1672641586,1672643693,2107
3904,3367111751,3500777439,1672563212,1672565436,2224
3770,3491684096,3505179890,1672698867,1672701575,2708
3799,3206837348,3970198861,1672673925,1672676491,2566
3659,3916490839,3402697190,1672609837,1672611051,1214
3511,3533004959,3779646172,1672571088,1672571900,812
3762,3513041785,3783340788,1672532571,1672534314,1743
3485,3931627862,3245232284,1672692906,1672696039,3133
3439,3512337405,3713829743,1672606477,1672607049,572
3641,3511791953,3505663516,1672699674,1672702747,3073
3915,3689114185,3777037426,1672531710,1672534514,2804
3468,3451691949,3776831527,1672686505,1672689947,3442
3509,3402697190,3350095157,1672664974,1672665255,281
3779,3812369928,3480490124,1672598046,1672599353,1307
3551,3835985172,3450286949,1672571359,1672573365,2006
3682,3778040015,3928511283,1672649318,1672652555,3237
3431,3505402439,3440107959,1672598975,1672600993,2018
3803,3393063657,3373028638,1672545475,1672547622,2147
3880,3777091903,3454277788,1672533034,1672533718,684
3616,3501525100,3834960360,1672602378,1672602640,262
3650,3276269264,3824215187,1672541500,1672544170,2670
3553,3756385685,3625463628,1672684961,1672685549,588
3464,3711097754,3773572967,1672668391,1672669642,1251
3582,3814305099,3500737582,1672612569,1672612709,140
3767,3783373154,3445206685,1672648775,1672651620,2845
3790,3895285664,3512379024,1672572479,1672575016,2537
3902,3501457103,3497671225,1672641333,1672642568,1235
3720,3770146716,3713561276,1672677552,1672679531,1979
3435,3205985903,3774290799,1672632221,1672632359,138
3813,3520873221,3703348097,1672650586,1672653234,2648
3735,3621790707,3608922867,1672534484,1672537258,2774
3478,3244004456,3467988782,1672675600,1672678316,2716
3789,3232208416,3238288884,1672558198,1672558418,220
3777,3779639983,3714233826,1672616016,1672617672,1656
3652,3897376951,3299781901,1672565779,1672566557,778
3916,3472068734,3898314440,1672593156,1672596177,3021
3531,3711919537,3337322736,1672598931,1672599871,940
3532,3826238375,3399518841,1672662558,1672664338,1780
3612,3534179433,3492546679,1672699555,1672701839,2284
3577,3738026330,3306175858,1672581636,1672583164,1528
3550,3385323994,3621683102,1672537123,1672537898,775
3657,3855583256,3979802715,1672677849,1672678836,987
3887,3760645796,3715385401,1672694542,1672697838,3296
3648,3367509761,3757294769,1672650754,1672651348,594
3576,3711097754,3410160376,1672680596,1672682033,1437
3434,3710562338,3511317276,1672547515,1672549284,1769
3552,3220031931,3517172354,1672540552,1672542685,2133
3896,3446533960,3333403880,1672590360,1672592263,1903
3877,3516903528,3774155692,1672571182,1672574390,3208
3877,3492546679,3335694356,1672589200,1672589272,72
3552,3777485931,3501525100,1672676420,1672678659,2239
3894,3512946768,3779738691,1672607023,1672608306,1283
3597,3609881958,3928719932,1672565725,1672567856,2131
3641,3515525630,3793969543,1672654414,1672654997,583
3541,3621683102,3713517039,1672545982,1672547884,1902
3517,3534126409,3203538212,1672671625,1672674011,2386
3851,3737112297,3514512367,1672629620,1672632410,2790
3620,3635169815,3448633776,1672531214,1672532246,1032
3796,3783433404,3336339664,1672669234,1672669395,161
3467,3520991398,3449639012,1672631773,1672634055,2282
3744,3393063657,3688796737,1672671772,1672672395,623
3904,3225631197,3899326793,1672596774,1672598116,1342
3589,3515439826,3970627281,1672595197,1672596836,1639
3688,3757294769,3225631197,1672588131,1672590116,1985
3607,3533649454,3500604680,1672660076,1672660202,126
3767,3520657891,3289817992,1672622710,1672624418,1708
3826,3614740489,3245232284,1672540574,1672543755,3181
3459,3519077659,3773735484,1672552618,1672553630,1012
3574,3510818674,3927599181,1672607958,1672611389,3431
3661,3755756564,3819767045,1672701230,1672703718,2488
3523,3777147510,3534543776,1672657852,1672658272,420
3814,3893912331,3294747828,1672695559,1672696484,925
3813,3770468980,3279339278,1672566570,1672568826,2256
3812,3777091903,3517887477,1672641417,1672642933,1516
3922,3510641433,3668747074,1672669071,1672669743,672
3795,3780571086,3755230952,1672645022,1672646207,1185
3782,3450286949,3776988674,1672548963,1672550468,1505
3457,3755230952,3792014516,1672665481,1672668557,3076
3722,3755496114,3661903000,1672603470,1672603815,345
3676,3401793306,3760645796,1672567043,1672568719,1676
3509,3400763927,3450286949,1672560392,1672562363,1971
3687,3435167810,3710315160,1672616122,1672619079,2957
3574,3711853996,3777091903,1672685501,1672685748,247
3706,3418448389,3520873221,1672680572,1672681437,865
3511,3514703118,3513295938,1672616144,1672619095,2951
3759,3224968597,3703139663,1672543492,1672545234,1742
3430,3389634034,3289114629,1672652514,1672655986,3472
3907,3760640999,3834963772,1672697615,1672698952,1337
3502,3730071479,3715545685,1672653159,1672656710,3551
3726,3817428320,3209526819,1672670259,1672672323,2064
3766,3817813340,3395201292,1672687541,1672690337,2796
3671,3401793306,3410160376,1672689441,1672691619,2178
3922,3713941638,3479851674,1672603261,1672604807,1546
3585,3360069849,3276217799,1672536088,1672537153,1065
3902,3793883863,3736231757,1672542207,1672545711,3504
3862,3459681410,3732584121,1672654708,1672657791,3083
3715,3463740710,3472312341,1672623398,1672625699,2301
3713,3421877923,3660063072,1672618401,1672621398,2997
3666,3270697740,3701882224,1672599725,1672601087,1362
3735,3509366311,3500044458,1672557093,1672558911,1818
3462,3760263530,3686523546,1672634561,1672637893,3332
3509,3513345163,3411688875,1672697815,1672698031,216
3606,3713829743,3475349791,1672699764,1672700094,330
3808,3774243020,3512958459,1672613645,1672613763,118
3455,3202141727,3615087943,1672599262,1672600505,1243
3493,3517288083,3793740407,1672596701,1672597988,1287
3533,3472312341,3229974066,1672545274,1672546127,853
3655,3631479562,3517358573,1672635160,1672638413,3253
3867,3783373154,3685681577,1672607756,1672609477,1721
3475,3349856820,3493017654,1672668716,1672670534,1818
3645,3446533960,3710489491,1672583068,1672584296,1228
3514,3239617320,3914691363,1672595965,1672598769,2804
3582,3533079336,3710854064,1672670931,1672671030,99
3695,3480490124,3661903000,1672636795,1672636978,183
3748,3932478321,3454277788,1672676514,1672677606,1092
3464,3205985903,3559731671,1672532062,1672533599,1537
3615,3308760650,3613416045,1672691576,1672692466,890
3921,3448875382,3372223551,1672565394,1672565552,158
3479,3415833929,3520764926,1672676983,1672680367,3384
3850,3347419520,3334647380,1672609069,1672610167,1098
3516,3626499450,3505228454,1672534152,1672534453,301
3540,3513545422,3755573472,1672552055,1672555312,3257
3438,3451726367,3904412440,1672577838,1672580684,2846
3645,3669146016,3608855425,1672647067,1672649009,1942
3677,3505402439,3686523546,1672663195,1672666597,3402
3921,3774641380,3351696332,1672697569,1672700068,2499
3814,3303410628,3510187271,1672667490,1672671032,3542
3642,3382733096,3817428320,1672584250,1672586664,2414
3853,3619922891,3349856820,1672699978,1672702060,2082
3707,3225029895,3610870949,1672552943,1672553063,120
3515,3615115210,3773837847,1672628773,1672631801,3028
3857,3509366311,3509483172,1672621981,1672624692,2711
3456,3885157459,3283492940,1672635714,1672637513,1799
3432,3480490124,3229822507,1672548271,1672548508,237
3808,3499217428,3914691363,1672604457,1672604932,475
3709,3510818674,3777240360,1672639873,1672641414,1541
3543,3491684096,3512379024,1672613369,1672614660,1291
3512,3807212280,3618808151,1672557098,1672559565,2467
3776,3770468980,3200308999,1672553164,1672553954,790
3747,3970909253,3710008361,1672532036,1672534970,2934
3445,3493017654,3613206049,1672642126,1672645529,3403
3560,3292147449,3755230952,1672582358,1672585836,3478
3715,3858172636,3701882224,1672599220,1672601151,1931
3916,3533079336,3501459390,1672651411,1672653040,1629
3465,3311085279,3739154408,1672636542,1672639045,2503
3435,3792072681,3230135532,1672561236,1672562127,891
3742,3533747868,3373028638,1672641406,1672643772,2366
3686,3711734586,3800257590,1672550746,1672553862,3116
3506,3206837348,3891672228,1672534503,1672536108,1605
3835,3783340788,3773027597,1672652719,1672654663,1944
3669,3316800320,3382733096,1672624122,1672625061,939
3807,3779465522,3505521218,1672700268,1672702433,2165
3639,3715619259,3385323994,1672539447,1672539713,266
3618,3895285664,3972192593,1672614300,1672617127,2827
3721,3236499444,3369708250,1672601303,1672604548,3245
3465,3501525100,3311085279,1672660614,1672662786,2172
3665,3791441520,3226024417,1672559262,1672559368,106
3656,3519028898,3505995057,1672614057,1672616232,2175
3813,3772236797,3777189898,1672541449,1672541940,491
3619,3514956366,3454277788,1672598452,1672598830,378
3752,3773033649,3979784676,1672555674,1672557059,1385
3504,3791246640,3511024016,1672608011,1672609432,1421
3604,3338083680,3773027597,1672599324,1672602314,2990
3836,3520639768,3511005395,1672599324,1672602865,3541
3796,3559458968,3783340788,1672621315,1672623593,2278
3896,3710496785,3760651515,1672611030,1672612382,1352
3822,3271454397,3514285803,1672541429,1672544405,2976
3780,3272096759,3200543880,1672684369,1672686137,1768
3648,3399518841,3711218296,1672561052,1672561503,451
3901,3792505974,3500827202,1672573053,1672575351,2298
3518,3500347447,3778667336,1672680911,1672682269,1358
3859,3934064792,3776518452,1672578671,1672582154,3483
3547,3779301501,3609659642,1672659804,1672661812,2008
3762,3367509761,3511150845,1672545299,1672545506,207
3433,3304971369,3710854064,1672701465,1672702667,1202
3449,3923754072,3737147209,1672690573,1672693162,2589
3837,3357289672,3385323994,1672607585,1672610503,2918
3463,3500915908,3510964997,1672538093,1672538953,860
3481,3898314440,3661447322,1672620989,1672623535,2546
3552,3357689359,3298151889,1672592534,1672595705,3171
3887,3424660806,3520181148,1672546711,1672548115,1404
3913,3760040019,3608232640,1672571814,1672573227,1413
3440,3793315718,3617304541,1672563296,1672565616,2320
3588,3202804048,3757323954,1672595310,1672596738,1428
3793,3409114719,3349856820,1672613724,1672617156,3432
3548,3623266256,3497095254,1672635564,1672639048,3484
3457,3421877923,3774290799,1672568671,1672571898,3227
3828,3451691949,3501525100,1672581037,1672582127,1090
3649,3393063657,3711919537,1672681472,1672684000,2528
3722,3516703758,3311085279,1672608972,1672611665,2693
3730,3510767239,3621790707,1672628237,1672630914,2677
3757,3814305099,3333403880,1672589971,1672592077,2106
3732,3714120857,3733558985,1672540616,1672542570,1954
3676,3823084403,3793407963,1672554435,1672557880,3445
3887,3703383853,3835422146,1672677180,1672678430,1250
3539,3733363628,3451691949,1672543484,1672545970,2486
3550,3533188828,3770704999,1672540279,1672543548,3269
3560,3714678331,3520181148,1672595886,1672596384,498
3448,3756385685,3497808662,1672595915,1672598939,3024
3860,3615113018,3921648519,1672653422,1672656761,3339
3514,3757700712,3441703884,1672680982,1672681205,223
3566,3773902805,3760040019,1672673432,1672677021,3589
3593,3609881958,3299125059,1672550117,1672552127,2010
3632,3773572967,3343132529,1672596048,1672596460,412
3657,3557046880,3285204083,1672612678,1672613660,982
3768,3760651515,3737147209,1672576959,1672577684,725
3609,3713829743,3347419520,1672663213,1672664701,1488
3513,3779465522,3517288083,1672599147,1672602268,3121
3625,3552824113,3755573472,1672679719,1672682275,2556
3659,3519850727,3613899351,1672627458,1672629280,1822
3915,3835985172,3351696332,1672596338,1672596542,204
3569,3821054646,3802932312,1672676170,1672677815,1645
3561,3443357683,3533079336,1672675550,1672678377,2827
3689,3517590837,3513041785,1672570291,1672571063,772
3749,3621184108,3972192593,1672606076,1672608606,2530
3448,3520115090,3429943738,1672583067,1672583918,851
3724,3394297564,3411688875,1672645166,1672648395,3229
3869,3533004959,3970198861,1672622833,1672624134,1301
3668,3492546679,3970627281,1672619723,1672622625,2902
3575,3777147510,3774641380,1672641444,1672642853,1409
3505,3370068529,3667427125,1672531205,1672533858,2653
3698,3834631333,3897435944,1672542515,1672543080,565
3855,3446533960,3520322124,1672598932,1672601853,2921
3910,3487875183,3815250107,1672574200,1672576073,1873
3590,3757903168,3480726047,1672687539,1672688736,1197
3455,3424445495,3793922324,1672640289,1672643573,3284
3502,3516703758,3783147088,1672550265,1672553338,3073
3863,3410538749,3774031303,1672695176,1672696957,1781
3735,3375449013,3285204083,1672560098,1672560716,618
3730,3920898925,3516513251,1672589325,1672590746,1421
3524,3808136029,3757903168,1672557546,1672557781,235
3503,3935399379,3370068529,1672698349,1672700206,1857
3610,3667673649,3505634634,1672556243,1672559817,3574
3739,3519077659,3714670620,1672675422,1672678147,2725
3799,3311085279,3500827202,1672563036,1672563649,613
3603,3669146016,3776988674,1672690598,1672693366,2768
3578,3780472203,3311498666,1672631518,1672632271,753
3752,3899786664,3891672228,1672693980,1672695467,1487
3755,3778667336,3392520516,1672586305,1672588769,2464
3546,3619922891,3773033649,1672539772,1672542793,3021
3592,3710735406,3505847380,1672592119,1672592568,449
3534,3618354185,3306412634,1672637144,1672637592,448
3626,3791128487,3615688740,1672617959,1672619009,1050
3528,3777184389,3605221116,1672663159,1672664958,1799
3879,3757903168,3271752081,1672543358,1672546769,3411
3492,3780680950,3884596900,1672583485,1672585117,1632
3500,3231494505,3902861231,1672668913,1672670477,1564
3488,3283492940,3926643445,1672532087,1672534020,1933
3671,3294747828,3755915206,1672666174,1672667139,965
3470,3457960571,3791246640,1672576172,1672578703,2531
3633,3505888598,3288224595,1672585563,1672587161,1598
3499,3533188828,3505481368,1672619852,1672621475,1623
3561,3608922867,3897134762,1672575022,1672575667,645
3742,3716679950,3274831810,1672573948,1672575937,1989
3672,3517881647,3621790707,1672551869,1672552062,193
3576,3715545685,3618697021,1672638720,1672640371,1651
3436,3451726367,3401793306,1672583645,1672583899,254
3682,3703348097,3780834916,1672578761,1672581812,3051
3841,3517600136,3455018347,1672661585,1672661803,218
3728,3756746867,3779301501,1672533890,1672535700,1810
3695,3516703758,3756474459,1672618544,1672621509,2965
3831,3772236797,3510641433,1672669958,1672670534,576
3885,3791796585,3829864515,1672545783,1672546832,1049
3588,3688490530,3774790271,1672547969,1672548819,850
3496,3509756823,3512499658,1672577085,1672580666,3581
3566,3617489344,3520991398,1672627148,1672628053,905
3716,3227799827,3410160376,1672639035,1672640125,1090
3506,3437286517,3760651515,1672549049,1672552378,3329
3703,3366423342,3513041785,1672653567,1672655835,2268
3785,3505888598,3850911686,1672612846,1672615546,2700
3613,3284932450,3380767040,1672698753,1672698833,80
3571,3500672156,3614740489,1672546100,1672549323,3223
3458,3757323954,3703433819,1672555382,1672558200,2818
3763,3755065949,3520578796,1672693571,1672694120,549
3506,3203538212,3823084403,1672630706,1672634129,3423
3515,3517288083,3636329663,1672592191,1672593707,1516
3847,3710048469,3824641227,1672665535,1672666145,610
3887,3417191856,3923220461,1672574682,1672576589,1907
3535,3618697021,3514308235,1672665435,1672668429,2994
3889,3605221116,3928511283,1672663913,1672667512,3599
3687,3505847380,3283144118,1672651429,1672651599,170
3494,3895285664,3685816610,1672621165,1672624101,2936
3513,3711919537,3923420131,1672539252,1672542845,3593
3424,3480991549,3201629017,1672578180,1672580428,2248
3909,3518561777,3757193551,1672568060,1672569839,1779
3889,3447514821,3772391882,1672679353,1672680607,1254
3757,3905899155,3296462324,1672545080,1672546684,1604
3825,3512502036,3232208416,1672617450,1672620924,3474
3850,3201629017,3932478321,1672654278,1672657797,3519
3705,3366423342,3831586487,1672576728,1672577633,905
3593,3661447322,3780253901,1672645562,1672648357,2795
3860,3414049538,3510641433,1672635937,1672636333,396
3873,3501459390,3970627281,1672637914,1672639760,1846
3647,3493017654,3811075491,1672674744,1672675824,1080
3873,3757383891,3462636434,1672552730,1672554954,2224
3867,3667673649,3772078494,1672658724,1672659644,920
3762,3534179433,3834631333,1672553529,1672554298,769
3772,3633735593,3533004959,1672587281,1672587603,322
3463,3227799827,3306412634,1672667360,1672670374,3014
3839,3201676087,3505178849,1672598527,1672600447,1920
3866,3626499450,3711000597,1672556045,1672558719,2674
3794,3757294769,3780338697,1672564282,1672567594,3312
3585,3520322124,3451726367,1672631347,1672633094,1747
3688,3305722859,3710048469,1672624804,1672625201,397
3828,3480100311,3625174002,1672635492,1672635588,96
3726,3780680950,3686523546,1672595094,1672596885,1791
3854,3668747074,3379143440,1672545761,1672547831,2070
3632,3240394404,3880926355,1672595068,1672597889,2821
3885,3398731252,3819767045,1672651264,1672653573,2309
3578,3701373490,3975717896,1672693257,1672694532,1275
3688,3703798634,3710496785,1672662724,1672665219,2495
3567,3792745809,3451326054,1672583642,1672587077,3435
3470,3701107228,3792949946,1672586733,1672589837,3104
3605,3935487534,3200308999,1672603028,1672603311,283
3846,3757332128,3461119815,1672700673,1672703154,2481
3551,3977352557,3520578796,1672574449,1672574702,253
3609,3334974375,3755992176,1672654144,1672655464,1320
3670,3778640261,3778640261,1672577788,1672580248,2460
3795,3480100311,3895285664,1672680812,1672683735,2923
3427,3501121099,3411688875,1672540024,1672540711,687
3919,3680810086,3772391882,1672667497,1672670250,2753
3888,3380982774,3505178849,1672561687,1672563855,2168
3525,3773332082,3505154885,1672689822,1672691847,2025
3734,3770676872,3621461051,1672596291,1672597111,820
3586,3880926355,3777485931,1672541128,1672543721,2593
3893,3224811762,3520639768,1672574167,1672576003,1836
3663,3500498112,3778926763,1672581310,1672584232,2922
3578,3800257590,3500703304,1672559511,1672562722,3211
3901,3801645328,3661447322,1672557865,1672558053,188
3680,3760640999,3713784974,1672637174,1672639890,2716
3467,3715443333,3357864626,1672681732,1672682263,531
3608,3793583656,3779738691,1672589323,1672589788,465
3795,3858172636,3402697190,1672559708,1672561414,1706
3547,3300979975,3713768950,1672607930,1672608340,410
3439,3620292035,3817813340,1672652756,1672656303,3547
3857,3615737355,3557046880,1672545816,1672547370,1554
3447,3792801638,3401496246,1672669083,1672672445,3362
3774,3440107959,3912891315,1672608635,1672610457,1822
3602,3448875382,3505923418,1672600212,1672601676,1464
3922,3500442734,3428027649,1672640350,1672643884,3534
3920,3510554314,3814677862,1672580126,1672583118,2992
3855,3440137407,3488686442,1672574369,1672576750,2381
3587,3270042456,3334974375,1672679303,1672682648,3345
3668,3932478321,3791753345,1672670230,1672671185,955
3822,3387594369,3517590837,1672698678,1672700183,1505
3807,3516741440,3392836218,1672655279,1672657033,1754
3578,3773009828,3618697021,1672656247,1672658233,1986
3518,3380767040,3500525825,1672561601,1672563445,1844
3439,3280054198,3225636215,1672555642,1672558067,2425
3862,3510964997,3505402439,1672581959,1672583404,1445
3540,3773902805,3665998641,1672557228,1672560725,3497
3881,3513296868,3495911207,1672681533,1672684292,2759
3721,3270056120,3604867757,1672668147,1672670619,2472
3774,3772236797,3513410578,1672653452,1672654589,1137
3900,3206837348,3737972328,1672637384,1672640393,3009
3482,3773027597,3283492940,1672597399,1672598039,640
3448,3711919537,3398731252,1672580097,1672582233,2136
3481,3513345163,3793868716,1672640045,1672642272,2227
3586,3411688875,3701322924,1672621276,1672623490,2214
3594,3839245934,3364726656,1672675165,1672678182,3017
3614,3739911441,3517590837,1672597613,1672598061,448
3837,3885155975,3682133690,1672617109,1672619597,2488
3451,3285204083,3501281016,1672555846,1672558396,2550
3642,3505266860,3517172354,1672585359,1672587673,2314
3606,3889780657,3792389522,1672549726,1672550308,582
3679,3515890966,3780872464,1672580697,1672582399,1702
3463,3341893384,3517288083,1672625049,1672625366,317
3432,3615688740,3400763927,1672537928,1672539770,1842
3780,3773572967,3756127300,1672677509,1672679555,2046
3891,3760842815,3369708250,1672570002,1672572989,2987
3908,3900898992,3519087371,1672583410,1672583833,423
3879,3756127300,3315279093,1672694187,1672695121,934
3890,3480726047,3938503547,1672534865,1672534947,82
3693,3448633776,3778667336,1672554254,1672557181,2927
3806,3410160376,3480100311,1672587404,1672590820,3416
3794,3792505974,3206837348,1672589749,1672590654,905
3836,3777624586,3512337405,1672680947,1672681104,157
3736,3711077927,3923754072,1672575468,1672578582,3114
3625,3463849738,3303410628,1672657231,1672659363,2132
3449,3428027649,3780834916,1672666490,1672666682,192
3893,3533294425,3927599181,1672605900,1672607700,1800
3460,3511005395,3713589994,1672575006,1672576083,1077
3435,3715443333,3375449013,1672652993,1672653237,244
3655,3774178201,3755222916,1672571360,1672572012,652
3622,3515525630,3608232640,1672692056,1672694789,2733
3683,3890739241,3793175445,1672568768,1672569732,964
3610,3309314379,3772078494,1672565681,1672566685,1004
3523,3778926763,3334974375,1672620105,1672622637,2532
3805,3779613523,3755233658,1672622903,1672625692,2789
3701,3500737582,3491469603,1672598979,1672599609,630
3605,3449333754,3396726504,1672575533,1672577661,2128
3472,3414940786,3703396825,1672640661,1672643825,3164
3654,3774718695,3276269264,1672669056,1672671688,2632
3706,3777184389,3449333754,1672555138,1672557353,2215
3829,3512337405,3739661856,1672699466,1672702953,3487
3480,3300818269,3334993594,1672580727,1672581487,760
3806,3517462308,3916490839,1672692056,1672695085,3029
3543,3519909393,3906536154,1672540820,1672542211,1391
3577,3414049538,3520657891,1672684385,1672685619,1234
3428,3270697740,3468041839,1672624911,1672625140,229
3601,3637313265,3815250107,1672576511,1672576899,388
3648,3777485931,3337362061,1672660063,1672662061,1998
3451,3755848152,3756746867,1672641089,1672642960,1871
3754,3511791953,3772236797,1672561660,1672562570,910
3437,3201800997,3915162005,1672582319,1672582979,660
3614,3227799827,3737972328,1672588872,1672591410,2538
3669,3716110860,3520560590,1672688854,1672689986,1132
3704,3760645796,3364378127,1672537993,1672539756,1763
3599,3519818818,3661447322,1672575825,1672576892,1067
3529,3462636434,3519077659,1672597226,1672597876,650
3673,3518653080,3512800570,1672541316,1672543909,2593
3579,3703383853,3518653080,1672702879,1672706241,3362
3774,3364378127,3902625986,1672545143,1672545445,302
3795,3734451191,3779639983,1672589674,1672590191,517
3659,3272030610,3505725706,1672544126,1672546860,2734
3566,3979784676,3892304880,1672595903,1672596301,398
3425,3755737419,3714827719,1672539318,1672542636,3318
3581,3279242917,3516903528,1672545423,1672548032,2609
3911,3783771827,3817428320,1672539718,1672540498,780
3704,3500841914,3800257590,1672533440,1672534788,1348
3921,3517590837,3792949946,1672686811,1672688878,2067
3921,3755992176,3372223551,1672544282,1672544516,234
3433,3514512367,3757348722,1672536954,1672537687,733
3860,3520578796,3225636215,1672643357,1672645024,1667
3729,3512502036,3534179433,1672609821,1672611392,1571
3598,3778040015,3231494505,1672599663,1672601359,1696
3792,3279473441,3755158925,1672594262,1672595983,1721
3543,3490029863,3736231757,1672687784,1672689222,1438
3792,3773124276,3713300120,1672679744,1672682667,2923
3581,3667673649,3509756823,1672546803,1672547294,491
3744,3755915206,3240394404,1672630071,1672633540,3469
3751,3773837847,3818575661,1672619353,1672620739,1386
3468,3621184108,3501215099,1672664058,1672665504,1446
3842,3551389192,3792072681,1672561810,1672564989,3179
3737,3711077927,3241914067,1672625181,1672628647,3466
3610,3668414677,3793315718,1672702810,1672705834,3024
3873,3701424609,3380982774,1672589509,1672592467,2958
3897,3283770991,3701882224,1672591336,1672593807,2471
3753,3499217428,3617489344,1672553868,1672554204,336
3699,3299781901,3350095157,1672584707,1672587973,3266
3657,3398198430,3930242012,1672613129,1672614870,1741
3494,3309314379,3926643445,1672691374,1672693569,2195
3874,3517737088,3517687662,1672573902,1672576048,2146
3847,3773735484,3928511283,1672655657,1672656917,1260
3804,3319167958,3715400486,1672630362,1672633896,3534
3696,3509366311,3363162590,1672693700,1672696735,3035
3427,3710854064,3501121099,1672538058,1672541279,3221
3726,3501567772,3852686295,1672673456,1672676428,2972
3809,3272716462,3338390596,1672602794,1672603145,351
3799,3711006062,3920898925,1672681657,1672682216,559
3690,3774733620,3279242917,1672621394,1672624044,2650
3450,3770520359,3200308999,1672571657,1672574272,2615
3562,3609881958,3701136026,1672603959,1672606823,2864
3660,3510641433,3279242917,1672664712,1672665029,317
3530,3835422146,3225631197,1672690065,1672693201,3136
3841,3298151889,3774733620,1672607193,1672607889,696
3751,3974674109,3793743698,1672667474,1672668780,1306
3505,3900276517,3505725706,1672551384,1672552754,1370
3794,3713941638,3513853403,1672674865,1672677054,2189
3747,3513853403,3701884158,1672612211,1672615547,3336
3894,3512502036,3755496114,1672609309,1672611391,2082
3677,3454277788,3467779445,1672551225,1672554792,3567
3697,3756385685,3755496114,1672666175,1672668393,2218
3482,3970198861,3737972328,1672607491,1672607746,255
3891,3505663516,3638660068,1672655553,1672656695,1142
3658,3905899155,3774705415,1672629241,1672632672,3431
3825,3513327337,3239617320,1672591297,1672592724,1427
3428,3778899160,3533188828,1672597844,1672600858,3014
3710,3736231757,3428725843,1672575396,1672578633,3237
3525,3637313265,3776559988,1672604106,1672605196,1090
3514,3412006598,3715986185,1672621456,1672623935,2479
3601,3500777439,3380982774,1672645748,1672647003,1255
3634,3515466096,3490214516,1672614080,1672615099,1019
3703,3755158925,3505283390,1672540134,1672543488,3354
3424,3773902805,3515466096,1672565573,1672567302,1729
3853,3791106564,3615113018,1672693206,1672693270,64
3572,3475349791,3514956366,1672628835,1672632120,3285
3562,3205923620,3559458968,1672685383,1672688487,3104
3846,3757193551,3512882178,1672632875,1672633403,528
3540,3715974659,3777240360,1672652090,1672652388,298
3901,3510187271,3792745809,1672568839,1672569665,826
3462,3343816795,3513360004,1672663869,1672664585,716
3761,3335694356,3899786664,1672607558,1672608323,765
3469,3236499444,3835985172,1672550496,1672552601,2105
3460,3715854030,3533294425,1672691356,1672691925,569
3794,3512337405,3283770991,1672534312,1672534994,682
3528,3225631197,3436257398,1672669743,1672670060,317
3471,3777091903,3364378127,1672661827,1672664427,2600
3455,3333403880,3770468980,1672576387,1672576639,252
3776,3714185969,3500737582,1672648075,1672648468,393
3900,3636329663,3220031931,1672670502,1672672484,1982
3425,3900276517,3835422146,1672583064,1672584788,1724
3909,3793740407,3779646172,1672555735,1672556812,1077
3426,3417191856,3450969839,1672628623,1672632069,3446
3911,3244004456,3683113954,1672562570,1672565886,3316
3430,3757700712,3383138270,1672655750,1672657937,2187
3664,3362641275,3513327337,1672556450,1672558747,2297
3635,3773033649,3510641433,1672673587,1672674487,900
3594,3288224595,3853629553,1672585708,1672588537,2829
3555,3912891315,3349856820,1672620644,1672620881,237
3632,3971806004,3487875183,1672674909,1672678412,3503
3657,3236499444,3776559988,1672672489,1672675114,2625
3782,3492959689,3421877923,1672590433,1672590549,116
3496,3271454397,3469254160,1672532718,1672536256,3538
3769,3853629553,3792745809,1672647213,1672649758,2545
3501,3715974659,3920625129,1672675913,1672677357,1444
3919,3621683102,3757193551,1672643637,1672645583,1946
3475,3783147088,3510187271,1672594744,1672596312,1568
3804,3777147510,3501567772,1672558548,1672561847,3299
3652,3736231757,3935913584,1672644837,1672645586,749
3621,3803517637,3777779869,1672652122,1672653798,1676
3822,3755065949,3774178201,1672622587,1672624785,2198
3830,3734915241,3755737419,1672553884,1672555390,1506
3855,3834960360,3757630221,1672642020,1672644021,2001
3557,3285204083,3270697740,1672683418,1672684888,1470
3574,3245232284,3497671225,1672694474,1672695440,966
3524,3755915206,3791693821,1672683113,1672683953,840
3455,3501459390,3240994288,1672536285,1672536784,499
3916,3773837847,3774705415,1672540992,1672541471,479
3556,3609659642,3303410628,1672561085,1672562893,1808
3534,3512499658,3815250107,1672559533,1672559921,388
3664,3398731252,3685816610,1672576573,1672577651,1078
3665,3760362417,3368283077,1672602748,1672604920,2172
3775,3509893027,3518194482,1672661818,1672662825,1007
3454,3755404116,3617304541,1672601712,1672602215,503
3439,3711077927,3904569677,1672630907,1672633703,2796
3549,3777694660,3514285803,1672697492,1672700173,2681
3821,3513410578,3814305099,1672584970,1672588265,3295
3519,3370227921,3500737582,1672666476,1672668024,1548
3641,3970909253,3450286949,1672656259,1672657186,927
3781,3512882178,3713691388,1672675443,1672678620,3177
3907,3533649454,3777694660,1672586696,1672589232,2536
3909,3404025196,3668414677,1672659855,1672662804,2949
3729,3715854030,3735374579,1672604884,1672607159,2275
3632,3938503547,3424445495,1672620066,1672621878,1812
3902,3760094385,3403370192,1672679672,1672682669,2997
3841,3451326054,3370227921,1672657268,1672658129,861
3449,3618354185,3791796585,1672598644,1672599717,1073
3720,3755573472,3519142371,1672677856,1672680210,2354
3918,3773027597,3393063657,1672537657,1672537862,205
3756,3977352557,3609659642,1672680337,1672680475,138
3874,3446533960,3774876004,1672671093,1672673865,2772
3896,3516298579,3513410578,1672678461,1672680411,1950
3431,3773121782,3283144118,1672547148,1672549469,2321
3771,3970198861,3551389192,1672692541,1672694021,1480
3771,3360616538,3780253901,1672549838,1672552649,2811
3682,3517991730,3500857494,1672669041,1672672334,3293
3880,3384583385,3979784676,1672595211,1672598411,3200
3689,3716963089,3714128600,1672592014,1672593842,1828
3435,3280054198,3776518452,1672637507,1672639869,2362
3738,3311498666,3777814504,1672679604,1672680141,537
3886,3500841914,3505283390,1672672300,1672673397,1097
3682,3839245934,3559731671,1672597122,1672600695,3573
3911,3389634034,3363162590,1672535550,1672538192,2642
3432,3714678331,3457620713,1672685793,1672686406,613
3462,3668533536,3462273042,1672564194,1672565726,1532
3442,3716628503,3512383699,1672648250,1672648339,89
3618,3280268483,3772391882,1672565845,1672566833,988
3717,3505923418,3979802715,1672575158,1672578649,3491
3473,3777091903,3500442734,1672637365,1672637621,256
3657,3300979975,3793883863,1672652908,1672653022,114
3848,3783169442,3731646673,1672673383,1672676536,3153
3612,3480726047,3402385957,1672564270,1672567355,3085
3901,3770520359,3462273042,1672692252,1672694613,2361
3796,3793922324,3513081354,1672674925,1672677857,2932
3915,3505434346,3902861231,1672549744,1672550393,649
3544,3417191856,3793922324,1672577763,1672579398,1635
3892,3757332128,3203538212,1672553859,1672557416,3557
3893,3467988782,3271752081,1672610430,1672610716,286
3504,3520764926,3899786664,1672697365,1672699500,2135
3769,3400069268,3770676872,1672531660,1672534645,2985
3783,3756127300,3791106564,1672544233,1672547789,3556
3520,3774178201,3898314440,1672593294,1672596335,3041
3751,3337362061,3776244398,1672672550,1672675165,2615
3637,3899326793,3399472693,1672598164,1672601361,3197
3570,3803389195,3615939504,1672602096,1672603362,1266
3507,3713517039,3710854064,1672593709,1672594779,1070
3431,3801645328,3776831527,1672630177,1672631355,1178
3823,3520181148,3792014516,1672555492,1672555670,178
3800,3228888030,3500777439,1672627634,1672630693,3059
3432,3812369928,3412968120,1672543348,1672544477,1129
3500,3909094917,3500915665,1672688776,1672689756,980
3521,3776518452,3513081354,1672536895,1672540176,3281
3427,3970627281,3518561777,1672642774,1672643507,733
3627,3462273042,3418448389,1672703326,1672704134,808
3890,3284947372,3400763927,1672603304,1672603911,607
3907,3792949946,3970603231,1672559856,1672562946,3090
3447,3711853996,3469254160,1672620055,1672621309,1254
3578,3379143440,3755915206,1672698747,1672700656,1909
3506,3347419520,3505198734,1672556622,1672557553,931
3906,3935399379,3447672935,1672682400,1672684245,1845
3908,3777091903,3825881598,1672650146,1672651340,1194
3753,3783919913,3514956366,1672660706,1672662784,2078
3764,3914691363,3774718695,1672533236,1672534467,1231
3608,3777330107,3369708250,1672604392,1672606296,1904
3524,3757630221,3334951866,1672557860,1672559695,1835
3619,3892304880,3396726504,1672700874,1672702322,1448
3571,3511883730,3617304541,1672582885,1672586019,3134
3528,3401793306,3618489670,1672657095,1672658756,1661
3885,3272716462,3534357694,1672599513,1672601093,1580
3713,3812534508,3834960360,1672669622,1672669817,195
3691,3617304541,3312998540,1672624176,1672625769,1593
3779,3770438122,3520560590,1672690831,1672694270,3439
3738,3417679834,3200308999,1672691454,1672691728,274
3918,3349739136,3680843171,1672656345,1672656976,631
3697,3316800320,3273981374,1672677497,1672680978,3481
3722,3779854934,3609113156,1672641857,1672642483,626
3846,3241914067,3774705415,1672558164,1672559614,1450
3604,3312998540,3416987084,1672684742,1672685909,1167
3855,3783147088,3497808662,1672677954,1672678062,108
3553,3737147209,3370227921,1672644257,1672645786,1529
3611,3505434346,3354144091,1672543473,1672545255,1782
3748,3617304541,3778640261,1672588953,1672590780,1827
3537,3680843171,3283770991,1672545080,1672545233,153
3439,3500613459,3551399764,1672581494,1672581831,337
3585,3418448389,3773939399,1672667301,1672668879,1578
3843,3739911441,3770468980,1672603212,1672604600,1388
3591,3811075491,3732131656,1672549822,1672552620,2798
3805,3792274796,3760040019,1672641257,1672642184,927
3674,3201676087,3779938251,1672593344,1672593608,264
3524,3305336154,3774790271,1672629371,1672629915,544
3838,3779465522,3711218296,1672547559,1672548776,1217
3666,3501459390,3450969839,1672549592,1672552809,3217
3921,3441703884,3347419520,1672669416,1672672261,2845
3909,3551376095,3779438325,1672595811,1672599394,3583
3860,3829864515,3755532873,1672685673,1672688875,3202
3873,3511317276,3821054646,1672645336,1672646849,1513
3665,3449333754,3209526819,1672677950,1672679110,1160
3914,3711000597,3791613604,1672531261,1672531901,640
3767,3613338363,3408498208,1672534753,1672537054,2301
3768,3792546035,3897435944,1672643125,1672644898,1773
3878,3272716462,3533079336,1672689733,1672691251,1518
3539,3755344363,3533004959,1672590934,1672592406,1472
3860,3701664364,3366423342,1672586079,1672589146,3067
3867,3835422146,3241790910,1672641032,1672644325,3293
3648,3688796737,3715086894,1672595707,1672596134,427
3495,3615087943,3370227921,1672666286,1672669677,3391
3541,3517590837,3716272919,1672577861,1672580082,2221
3608,3757318448,3779301501,1672552770,1672554366,1596
3646,3793781065,3710496785,1672582550,1672584719,2169
3899,3497808662,3270042456,1672626534,1672626784,250
3763,3792442597,3779656423,1672548039,1672548250,211
3862,3374183227,3449639012,1672698152,1672698419,267
3548,3300511067,3402697190,1672546603,1672547761,1158
3549,3835422146,3714233826,1672600591,1672601020,429
3737,3710048469,3680810086,1672605067,1672607304,2237
3888,3780769110,3511150845,1672581818,1672582615,797
3629,3783771827,3511317276,1672626842,1672628791,1949
3691,3688796737,3852533643,1672547910,1672550223,2313
3873,3551389192,3755737419,1672611682,1672613158,1476
3559,3505521218,3661447322,1672683333,1672686569,3236
3686,3739911441,3703348097,1672608735,1672610658,1923
3485,3834960360,3515466096,1672635138,1672638218,3080
3894,3710854064,3533004959,1672637776,1672640173,2397
3844,3711919537,3773124276,1672588560,1672591348,2788
3756,3515890966,3284932450,1672596637,1672597438,801
3868,3711097754,3711637255,1672603242,1672603629,387
3425,3711077927,3931627862,1672676044,1672679015,2971
3425,3225631197,3613338363,1672544541,1672545299,758
3582,3515559913,3505847380,1672683427,1672684387,960
3631,3685681577,3501459390,1672633562,1672635927,2365
3569,3791753345,3517687662,1672605339,1672608475,3136
3540,3803389195,3457960571,1672598782,1672599732,950
3475,3713163045,3755158925,1672576845,1672578153,1308
3466,3915162005,3773735484,1672653389,1672655869,2480
3642,3791128487,3912891315,1672601777,1672602593,816
3664,3517222913,3533747868,1672615201,1672618208,3007
3857,3445206685,3511883730,1672641506,1672641616,110
3852,3428725843,3793969543,1672576394,1672577812,1418
3795,3347419520,3201800997,1672584737,1672587558,2821
3725,3208957949,3935399379,1672626589,1672627127,538
3554,3279475486,3931627862,1672575593,1672578902,3309
3471,3760263530,3783615982,1672655743,1672657454,1711
3849,3203538212,3445206685,1672669734,1672673023,3289
3891,3518653080,3836241528,1672579291,1672580964,1673
3760,3710735406,3512830734,1672560924,1672561649,725
3878,3280054198,3620292035,1672686876,1672687970,1094
3794,3460719322,3239617320,1672580513,1672581053,540
3803,3517358573,3475349791,1672592437,1672593594,1157
3633,3898314440,3736231757,1672637175,1672640449,3274
3813,3714670620,3703433819,1672565379,1672568854,3475
3620,3900898992,3760645796,1672698962,1672699249,287
3814,3380130228,3898314440,1672685535,1672687204,1669
3712,3915162005,3289817992,1672659545,1672660630,1085
3502,3619922891,3760651515,1672663056,1672666389,3333
3700,3516321888,3386758279,1672627227,1672627664,437
3476,3500044458,3513345163,1672551377,1672552374,997
3642,3733558985,3224330592,1672553729,1672557085,3356
3781,3703348097,3517172354,1672699618,1672702399,2781
3426,3611055563,3510641433,1672612619,1672614231,1612
3693,3467988782,3902625986,1672578409,1672580441,2032
3794,3779438325,3689114185,1672561075,1672562684,1609
3665,3609933747,3823084403,1672619677,1672623180,3503
3486,3461119815,3481640525,1672612018,1672612120,102
3490,3515466096,3631479562,1672691249,1672693637,2388
3753,3686523546,3701823816,1672634009,1672634788,779
3661,3357689359,3446533960,1672635933,1672639082,3149
3689,3780872464,3402697190,1672631345,1672634403,3058
3436,3735374579,3783163143,1672547047,1672549709,2662
3900,3490214516,3517222913,1672583805,1672583966,161
3597,3815250107,3730071479,1672602717,1672603956,1239
3918,3730071479,3817813340,1672696024,1672698691,2667
3518,3338390596,3623266256,1672592661,1672593431,770
3704,3276003502,3779656423,1672599071,1672599661,590
3732,3403370192,3457620713,1672643523,1672643602,79
3832,3556969573,3777091903,1672658737,1672661120,2383
3527,3783919913,3613206049,1672593849,1672595828,1979
3786,3515402792,3826238375,1672601264,1672602914,1650
3638,3930242012,3621790707,1672642332,1672642721,389
3701,3885537225,3448875382,1672682080,1672682591,511
3757,3734915241,3366423342,1672648850,1672650839,1989
3540,3274906650,3511005395,1672702639,1672704745,2106
3833,3300511067,3756704774,1672561046,1672563623,2577
3436,3512502036,3501457103,1672589147,1672591498,2351
3486,3516489668,3505481368,1672694198,1672694526,328
3641,3505888598,3927165965,1672575342,1672576667,1325
3567,3519651506,3398731252,1672586169,1672587067,898
3804,3500498112,3773027597,1672671480,1672673055,1575
3877,3793407963,3448633776,1672698789,1672701938,3149
3770,3299781901,3701664364,1672643217,1672646506,3289
3665,3303410628,3824215187,1672572984,1672574144,1160
3785,3428725843,3435167810,1672539607,1672540863,1256
3579,3460719322,3688490530,1672544771,1672545325,554
3778,3515525630,3409114719,1672641721,1672642700,979
3494,3715127070,3533090502,1672536185,1672536684,499
3585,3513345163,3272716462,1672671766,1672674920,3154
3511,3779639983,3701247948,1672555452,1672556706,1254
3608,3408430195,3487875183,1672700934,1672702301,1367
3606,3621790707,3380130228,1672676046,1672676579,533
3710,3906536154,3701136026,1672586658,1672588972,2314
3632,3826238375,3779786641,1672603313,1672605157,1844
3846,3923420131,3688796737,1672616361,1672617131,770
3434,3701664364,3520578796,1672595751,1672597613,1862
3890,3206837348,3501215099,1672632602,1672635719,3117
3566,3276003502,3909094917,1672698125,1672701487,3362
3911,3703433819,3513041785,1672535800,1672538499,2699
3861,3779646172,3834631333,1672617814,1672618299,485
3692,3898314440,3703798634,1672608933,1672612247,3314
3474,3817813340,3239617320,1672647597,1672648933,1336
3445,3625174002,3226024417,1672592148,1672595145,2997
3525,3220031931,3777184389,1672611207,1672611433,226
3534,3512379024,3802932312,1672576789,1672578485,1696
3445,3519077659,3792546035,1672583101,1672585470,2369
3812,3511732493,3979802715,1672595465,1672596747,1282
3508,3760640999,3509764635,1672634593,1672636786,2193
3740,3511288998,3424660806,1672552803,1672553380,577
3559,3778134418,3382733096,1672551722,1672554590,2868
3567,3714233826,3305336154,1672618273,1672620948,2675
3559,3511005395,3505847380,1672657838,1672660303,2465
3616,3512830734,3737972328,1672641707,1672642935,1228
3890,3372223551,3615737355,1672676845,1672677452,607
3528,3402385957,3815250107,1672630961,1672631591,630
3910,3970603231,3613899351,1672553699,1672555640,1941
3622,3512337405,3792389522,1672560168,1672561648,1480
3869,3912891315,3238288884,1672600014,1672603487,3473
3471,3294703680,3791436104,1672600116,1672601029,913
3891,3920625129,3817428320,1672605343,1672607461,2118
3489,3220031931,3551389192,1672640060,1672642128,2068
3787,3970558632,3711097754,1672621598,1672625196,3598
3633,3306175858,3510919821,1672561722,1672561864,142
3645,3774876004,3923754072,1672572428,1672573562,1134
3852,3607882826,3501525100,1672576552,1672579443,2891
3763,3716628503,3920497528,1672585290,1672587736,2446
3901,3533188828,3791106564,1672584145,1672585858,1713
3897,3735374579,3505923418,1672615897,1672617022,1125
3491,3315703693,3516444201,1672649166,1672650808,1642
3446,3276269264,3505923418,1672628125,1672628364,239
3815,3793418209,3367971170,1672546594,1672547701,1107
3803,3534543776,3505437712,1672666080,1672668124,2044
3736,3390660440,3776117322,1672609426,1672609927,501
3830,3505663516,3515559913,1672607424,1672607514,90
3496,3469254160,3734451191,1672577560,1672578951,1391
3841,3613338363,3905196766,1672585019,1672588229,3210
3475,3513041785,3511601997,1672548241,1672550153,1912
3807,3772236797,3224968597,1672677469,1672680435,2966
3651,3501567772,3835422146,1672656652,1672658694,2042
3612,3501457103,3347419520,1672549176,1672552013,2837
3638,3773009828,3770296583,1672643776,1672647321,3545
3694,3379143440,3505437712,1672687066,1672690214,3148
3588,3514308235,3239617320,1672625119,1672626745,1626
3536,3310125159,3343132529,1672624434,1672624568,134
3501,3467779445,3623266256,1672613125,1672614616,1491
3746,3897456874,3713829743,1672626295,1672628119,1824
3754,3774605761,3501384020,1672664143,1672664717,574
3457,3404025196,3299781901,1672600355,1672600763,408
3813,3500841914,3230135532,1672545504,1672548267,2763
3788,3613416045,3384068080,1672597264,1672599903,2639
3566,3612689556,3791106564,1672660854,1672660934,80
3479,3505283390,3737112297,1672657011,1672659010,1999
3765,3817428320,3710562338,1672542445,1672543758,1313
3493,3512722110,3376467719,1672567576,1672570806,3230
3635,3711919537,3732584121,1672682765,1672683451,686
3803,3715385401,3224811762,1672650043,1672650962,919
3482,3615737355,3780209375,1672583691,1672586344,2653
3793,3777485931,3517172354,1672694135,1672694302,167
3479,3779656423,3703798634,1672607281,1672607708,427
3692,3793922324,3780872464,1672568861,1672570074,1213
3671,3680843171,3688796737,1672655732,1672657243,1511
3453,3638660068,3225029895,1672632421,1672632740,319
3617,3380767040,3914691363,1672629375,1672632720,3345
3771,3513295938,3792546035,1672534371,1672537875,3504
3881,3904569677,3714827719,1672588347,1672588675,328
3546,3417191856,3333403880,1672621617,1672623448,1831
3510,3299443125,3515401243,1672690718,1672693624,2906
3665,3920625129,3760721303,1672542477,1672542864,387
3620,3716110860,3505402439,1672641280,1672643935,2655
3618,3773121782,3713300120,1672531202,1672532380,1178
3579,3755573472,3780769110,1672626527,1672627236,709
3434,3756789525,3780680950,1672607447,1672608194,747
3595,3485540729,3920497528,1672639813,1672640318,505
3712,3715974659,3514956366,1672559623,1672561629,2006
3647,3714067076,3970909253,1672647060,1672647273,213
3493,3617392620,3299443125,1672646691,1672649563,2872
3818,3380130228,3791753345,1672539559,1672541238,1679
3728,3783771827,3520416075,1672634482,1672637152,2670
3688,3448633776,3338390596,1672696336,1672698128,1792
3729,3776559988,3938389661,1672590252,1672593661,3409
3856,3625463628,3621683102,1672609695,1672611221,1526
3631,3800257590,3779301501,1672543559,1672545644,2085
3917,3835422146,3715619259,1672573748,1672574342,594
3529,3443357683,3710315160,1672702335,1672704038,1703
3551,3780909839,3793740407,1672576918,1672577087,169
3592,3757193551,3519909393,1672679710,1672680029,319
3715,3703798634,3459681410,1672674859,1672674989,130
3577,3927599181,3701136026,1672662776,1672664044,1268
3659,3835985172,3410600350,1672566470,1672568483,2013
3651,3793743698,3611055563,1672629421,1672631254,1833
3678,3417679834,3551389192,1672689443,1672691784,2341
3518,3836241528,3710008361,1672655157,1672656745,1588
3858,3710854064,3533004959,1672686989,1672689564,2575
3510,3774605761,3517687662,1672671557,1672672893,1336
3584,3472068734,3902625986,1672587265,1672589575,2310
3916,3780322355,3783340788,1672693868,1672695382,1514
3807,3390660440,3824641227,1672689394,1672691741,2347
3830,3514956366,3385323994,1672616317,1672619819,3502
3895,3783928182,3776559988,1672695054,1672696149,1095
3619,3354144091,3661903000,1672569614,1672573101,3487
3542,3499217428,3792020993,1672685806,1672687888,2082
3877,3618808151,3520560590,1672654215,1672655102,887
3696,3716963089,3533090502,1672533085,1672535562,2477
3596,3443357683,3533090502,1672546601,1672548269,1668
3899,3510499038,3853629553,1672617764,1672618812,1048
3670,3926643445,3915162005,1672692500,1672693167,667
3769,3701136026,3517590837,1672694667,1672695896,1229
3650,3811075491,3783433404,1672648648,1672650895,2247
3501,3454277788,3556969573,1672679997,1672681519,1522
3861,3632814465,3773033649,1672578480,1672578572,92
3586,3734915241,3773939399,1672638281,1672639280,999
3810,3493017654,3520639768,1672678455,1672679692,1237
3765,3206837348,3500613459,1672630647,1672632777,2130
3829,3621790707,3921648519,1672613342,1672615161,1819
3449,3443357683,3404025196,1672702346,1672703864,1518
3868,3512337405,3711077927,1672678323,1672678546,223
3813,3793743698,3500672156,1672554410,1672556276,1866
3511,3202141727,3627368399,1672627395,1672629759,2364
3913,3715086894,3776988674,1672569199,1672571113,1914
3804,3408498208,3276217799,1672578638,1672581197,2559
3566,3661447322,3505847380,1672650535,1672650898,363
3656,3899786664,3733558985,1672567176,1672568147,971
3499,3461119815,3403370192,1672666065,1672669466,3401
3544,3615113018,3505634634,1672622833,1672624552,1719
3479,3392520516,3716628503,1672650820,1672653815,2995
3652,3338390596,3520416075,1672640243,1672641934,1691
3796,3636329663,3451326054,1672693101,1672694841,1740
3812,3607768197,3556969573,1672604789,1672605217,428
3748,3372223551,3412006598,1672549185,1672552594,3409
3593,3858172636,3778899160,1672553122,1672555588,2466
3440,3899786664,3926643445,1672645924,1672648335,2411
3670,3760364383,3609113156,1672574467,1672575747,1280
3576,3774243020,3716110860,1672567611,1672568416,805
3821,3615737355,3357864626,1672692695,1672694036,1341
3599,3715854030,3363162590,1672652760,1672654072,1312
3914,3369708250,3780338697,1672531885,1672532895,1010
3721,3288762795,3760094385,1672615983,1672617538,1555
3608,3814677862,3533228966,1672614789,1672617317,2528
3921,3533188828,3856606678,1672535412,1672538436,3024
3602,3772391882,3791613604,1672646890,1672649785,2895
3427,3500072204,3512282789,1672532513,1672535802,3289
3559,3770704999,3715986185,1672685934,1672688812,2878
3588,3517172354,3607768197,1672690325,1672691672,1347
3487,3516444201,3343816795,1672541064,1672543765,2701
3745,3621461051,3680810086,1672692692,1672694004,1312
3648,3734915241,3238288884,1672676241,1672678667,2426
3790,3227799827,3770438122,1672618286,1672618716,430
3814,3880926355,3516741440,1672661240,1672661701,461
3829,3520873221,3551389192,1672685978,1672687724,1746
3484,3501457103,3893912331,1672577874,1672580619,2745
3831,3755222916,3369708250,1672617743,1672621092,3349
3561,3755158925,3517687662,1672541060,1672541545,485
3845,3684523966,3792489602,1672587378,1672588443,1065
3651,3270697740,3343816795,1672531885,1672532311,426
3645,3710048469,3514275974,1672660122,1672662655,2533
3724,3533423872,3371455553,1672617411,1672618393,982
3505,3357864626,3774155692,1672683524,1672684485,961
3611,3557046880,3370227921,1672550866,1672552101,1235
3856,3347419520,3513345163,1672572938,1672575609,2671
3607,3812534508,3501121099,1672627683,1672629684,2001
3777,3770624662,3618176292,1672673746,1672674501,755
3487,3977352557,3933894942,1672583240,1672585720,2480
3514,3401940259,3284932450,1672689381,1672692961,3580
3747,3288762795,3757903168,1672657752,1672661204,3452
3662,3479851674,3293835352,1672673637,1672676288,2651
3846,3975717896,3202804048,1672532710,1672535369,2659
3745,3609933747,3480100311,1672644080,1672647515,3435
3643,3852533643,3517288083,1672632562,1672634679,2117
3444,3202804048,3927599181,1672549586,1672550541,955
3729,3793922324,3305722859,1672620088,1672622846,2758
3811,3289114629,3831586487,1672608088,1672609337,1249
3737,3755233658,3710048469,1672606199,1672607279,1080
3539,3392520516,3701882224,1672535974,1672537906,1932
3453,3468041839,3402697190,1672611308,1672612472,1164
3538,3615115210,3783928182,1672636901,1672637426,525
3608,3713911104,3777330107,1672541663,1672544910,3247
3867,3808136029,3493017654,1672650613,1672653012,2399
3799,3284932450,3621184108,1672613459,1672616892,3433
3702,3780769110,3773009828,1672536030,1672538765,2735
3642,3970909253,3501459390,1672665882,1672667426,1544
3889,3621683102,3533747868,1672638141,1672641650,3509
3834,3791753345,3367509761,1672675711,1672677710,1999
3457,3778667336,3520115090,1672679118,1672679870,752
3573,3300818269,3618489670,1672555677,1672557223,1546
3693,3688490530,3395201292,1672627101,1672628749,1648
3921,3554944414,3500613493,1672625459,1672627987,2528
3669,3351696332,3505663516,1672531650,1672532996,1346
3712,3756127300,3701247948,1672585435,1672587486,2051
3818,3714666884,3294747828,1672601537,1672603457,1920
3538,3513410578,3898314440,1672663002,1672665203,2201
3762,3300511067,3714827719,1672609648,1672611722,2074
3588,3711812325,3241914067,1672533243,1672533610,367
3621,3414940786,3273981374,1672665018,1672666023,1005
3584,3757903168,3895285664,1672698030,1672701175,3145
3607,3792525861,3228888030,1672683886,1672684992,1106
3528,3463740710,3396980894,1672666465,1672667219,754
3442,3755915206,3756127300,1672555070,1672557793,2723
3874,3701247948,3621184108,1672693246,1672693866,620
3826,3770704999,3858172636,1672532997,1672534084,1087
3681,3791106564,3624297844,1672640050,1672643301,3251
3917,3516903528,3621790707,1672600368,1672601828,1460
3550,3773939399,3615737355,1672568559,1672569968,1409
3836,3774876004,3710496785,1672613619,1672615300,1681
3719,3270042456,3715974659,1672641953,1672642849,896
3655,3714670620,3511791953,1672612428,1672614527,2099
3845,3224968597,3360616538,1672682309,1672683232,923
3918,3556969573,3463849738,1672672265,1672673786,1521
3472,3385323994,3480490124,1672581933,1672584365,2432
3488,3783169442,3779438325,1672606334,1672607001,667
3617,3714827719,3512499658,1672587885,1672590160,2275
3780,3927599181,3393063657,1672536889,1672538533,1644
3843,3912891315,3417679834,1672652267,1672654432,2165
3570,3777091903,3338390596,1672569104,1672571956,2852
3544,3461119815,3609881958,1672621310,1672623121,1811
3865,3777485931,3500109249,1672674417,1672677719,3302
3807,3774907131,3757318448,1672686796,1672687603,807
3445,3367111751,3360813161,1672650571,1672651755,1184
3749,3379143440,3511791953,1672630863,1672633164,2301
3581,3779465522,3417191856,1672657316,1672660723,3407
3674,3757863420,3533294425,1672591771,1672595200,3429
3915,3609113156,3905899155,1672655708,1672656548,840
3666,3334647380,3780712350,1672682375,1672683156,781
3455,3534126409,3885537225,1672675436,1672677355,1919
3712,3622665543,3501281016,1672645063,1672647175,2112
3515,3614740489,3777779869,1672665805,1672667382,1577
3573,3710496785,3436257398,1672686726,1672687785,1059
3486,3777624586,3971806004,1672572898,1672573095,197
3582,3338390596,3270042456,1672567172,1672567658,486
3853,3703433819,3710489491,1672626065,1672626717,652
3770,3716272919,3231713082,1672542606,1672546061,3455
3777,3777037426,3393063657,1672593706,1672595601,1895
3469,3757193551,3330340793,1672585814,1672587301,1487
3537,3600876425,3428725843,1672599278,1672600205,927
3837,3825881598,3451726367,1672700793,1672702154,1361
3898,3533228966,3512800570,1672547525,1672550740,3215
3582,3770236215,3271454397,1672661580,1672664988,3408
3813,3715854030,3435167810,1672597385,1672598018,633
3462,3200543880,3518565331,1672618127,1672618624,497
3912,3294747828,3429943738,1672565893,1672567285,1392
3794,3833217041,3231713082,1672683225,1672684660,1435
3509,3600876425,3500208903,1672692506,1672694079,1573
3823,3497808662,3438078818,1672693649,1672694115,466
3703,3811040565,3373089838,1672639510,1672641793,2283
3574,3230868435,3374183227,1672632100,1672632435,335
3775,3512383699,3467988782,1672674251,1672677048,2797
3660,3289114629,3418448389,1672640453,1672642723,2270
3627,3814677862,3710489491,1672554028,1672556167,2139
3809,3500109249,3927403123,1672637917,1672641210,3293
3479,3533649454,3703383853,1672656391,1672657732,1341
3728,3439673892,3669146016,1672584283,1672585339,1056
3533,3229822507,3612689556,1672567003,1672570426,3423
3875,3814677862,3772391882,1672541137,1672542157,1020
3548,3631479562,3618697021,1672629934,1672631437,1503
3834,3500604680,3757348722,1672641418,1672643668,2250
3808,3935913584,3516489668,1672680816,1672684277,3461
3763,3777779869,3224968597,1672641810,1672643800,1990
3618,3517687662,3895285664,1672599086,1672599998,912
3571,3357864626,3417679834,1672653225,1672655813,2588
3434,3686523546,3518194482,1672554825,1672554945,120
3669,3773837847,3347446226,1672675091,1672677498,2407
3498,3791246640,3500709774,1672698553,1672698783,230
3518,3384068080,3715545685,1672600470,1672602066,1596
3912,3415833929,3510818674,1672697882,1672698342,460
3442,3701247948,3755915206,1672651645,1672655234,3589
3527,3757318448,3398731252,1672602126,1672604201,2075
3560,3716963089,3239617320,1672601782,1672604873,3091
3677,3404025196,3710854064,1672643959,1672646311,2352
3817,3451726367,3713163045,1672628036,1672631516,3480
3563,3780115155,3701373490,1672667801,1672669297,1496
3583,3856606678,3760040019,1672672789,1672674440,1651
3808,3289114629,3511791953,1672653802,1672656177,2375
3688,3773735484,3399518841,1672596355,1672597198,843
3532,3779656423,3664943873,1672576458,1672577137,679
3486,3760263530,3460719322,1672627861,1672627924,63
3541,3774605761,3240394404,1672538403,1672540861,2458
3733,3970909253,3668533536,1672621494,1672624428,2934
3790,3938503547,3815392801,1672574060,1672575001,941
3781,3511288998,3505663516,1672551766,1672552322,556
3585,3927403123,3777485931,1672568287,1672571553,3266
3839,3927599181,3773027597,1672674499,1672677046,2547
3539,3299443125,3891672228,1672691112,1672691553,441
3735,3902625986,3533079336,1672636230,1672636712,482
3529,3554186380,3505434346,1672545217,1672546470,1253
3877,3408430195,3605221116,1672541339,1672541878,539
3813,3520322124,3491684096,1672543826,1672546768,2942
3812,3777240360,3438489358,1672580582,1672580781,199
3471,3341893384,3826238375,1672587628,1672588071,443
3742,3499217428,3333403880,1672691086,1672694181,3095
3881,3309314379,3793418209,1672652906,1672656302,3396
3630,3755756564,3779639983,1672646628,1672648291,1663
3731,3470454332,3780338697,1672536953,1672538260,1307
3757,3294703680,3604867757,1672699405,1672700923,1518
3920,3435116799,3511843593,1672632444,1672635255,2811
3835,3885537225,3703396825,1672622811,1672626004,3193
3798,3777330107,3777694660,1672641634,1672641906,272
3574,3517222913,3756789525,1672646277,1672649744,3467
3436,3501457103,3519077659,1672647542,1672649077,1535
3849,3714233826,3289114629,1672591601,1672594843,3242
3430,3334951866,3710048469,1672680678,1672682063,1385
3857,3351866415,3760694096,1672652044,1672653499,1455
3605,3310039260,3756127300,1672679022,1672682050,3028
3659,3615737355,3514275974,1672690868,1672694282,3414
3526,3783169442,3491469603,1672541852,1672542583,731
3538,3417679834,3373028638,1672616906,1672618400,1494
3752,3665998641,3703433819,1672686289,1672689851,3562
3709,3714120857,3823084403,1672617907,1672619201,1294
3618,3620292035,3457620713,1672629785,1672631033,1248
3641,3669146016,3668414677,1672677958,1672680626,2668
3704,3933894942,3713911104,1672577412,1672579123,1711
3841,3505154885,3792389522,1672564897,1672565700,803
3861,3226511603,3732131656,1672623466,1672625696,2230
3880,3780115155,3733363628,1672550732,1672551437,705
3844,3933894942,3533649454,1672567303,1672570658,3355
3718,3294747828,3791246640,1672665429,1672668133,2704
3552,3631090677,3600876425,1672574334,1672577441,3107
3571,3293835352,3756789525,1672536990,1672537497,507
3508,3716272919,3631090677,1672588227,1672588489,262
3751,3421877923,3713561276,1672632189,1672635550,3361
3441,3533079336,3739911441,1672646635,1672646855,220
3778,3551376095,3757700712,1672636565,1672638827,2262
3663,3512830734,3852533643,1672691328,1672693073,1745
3577,3885157459,3756474459,1672686819,1672688517,1698
3877,3779639983,3906536154,1672564824,1672567626,2802
3624,3892304880,3716110860,1672639809,1672642503,2694
3594,3793883863,3309314379,1672617013,1672619867,2854
3471,3972192593,3509483172,1672647243,1672648169,926
3820,3513327337,3631090677,1672651660,1672653876,2216
3787,3517172354,3515890966,1672665435,1672665917,482
3695,3773124276,3472068734,1672539074,1672539220,146
3861,3736231757,3552824113,1672607799,1672611087,3288
3915,3505437712,3200543880,1672676735,1672678472,1737
3760,3970198861,3793583656,1672655982,1672657204,1222
3734,3516741440,3462273042,1672625977,1672627362,1385
3498,3776084820,3793868716,1672578844,1672579011,167
3598,3915162005,3730071479,1672662125,1672663189,1064
3612,3351696332,3499217428,1672587492,1672590667,3175
3544,3701107228,3306412634,1672621528,1672623479,1951
3637,3792072681,3485540729,1672578270,1672581126,2856
3711,3739661856,3519142371,1672668048,1672670115,2067
3586,3480991549,3520873221,1672666329,1672668691,2362
3897,3399472693,3780680950,1672545975,1672549481,3506
3659,3774155692,3783147088,1672655214,1672656387,1173
3469,3500703304,3533649454,1672579498,1672581122,1624
3448,3511005395,3897456874,1672625288,1672627339,2051
3623,3713589994,3792442597,1672606699,1672610154,3455
3532,3534179433,3777624586,1672663262,1672664777,1515
3821,3703383853,3457960571,1672593262,1672595414,2152
3435,3505402439,3815392801,1672552991,1672555881,2890
3795,3294747828,3801645328,1672638004,1672639803,1799
3688,3399518841,3760924079,1672703912,1672704157,245
3620,3633735593,3229822507,1672579844,1672583115,3271
3533,3979784676,3715974659,1672691481,1672691892,411
3610,3232208416,3669146016,1672674577,1672676226,1649
3867,3615115210,3885121158,1672676906,1672679618,2712
3543,3979784676,3414275042,1672692530,1672693415,885
3509,3505521218,3780253901,1672581198,1672582718,1520
3496,3623266256,3817428320,1672685238,1672687736,2498
3658,3510919821,3514956366,1672551791,1672554469,2678
3580,3534126409,3516513251,1672594227,1672596255,2028
3722,3668747074,3294747828,1672548121,1672549926,1805
3722,3520873221,3418448389,1672575660,1672577366,1706
3889,3760924079,3515401243,1672546507,1672549806,3299
3600,3812369928,3399518841,1672564522,1672564596,74
3672,3300511067,3400763927,1672553424,1672553861,437
3715,3757075324,3780209375,1672700532,1672702049,1517
3675,3370068529,3760842815,1672676942,1672678069,1127
3900,3515401243,3467779445,1672608187,1672611259,3072
3748,3343132529,3451326054,1672561098,1672561786,688
3711,3974674109,3319167958,1672631367,1672631636,269
3823,3792389522,3891672228,1672611006,1672613859,2853
3509,3757294769,3773572967,1672633560,1672636746,3186
3713,3516321888,3755756564,1672565441,1672568552,3111
3703,3778899160,3900276517,1672681323,1672684300,2977
3809,3385323994,3513295938,1672673061,1672674888,1827
3624,3814677862,3450969839,1672600665,1672602550,1885
3795,3611055563,3488763230,1672533315,1672536236,2921
3703,3238288884,3859868849,1672658560,1672660163,1603
3609,3850911686,3279339278,1672539608,1672541043,1435
3495,3470454332,3900898992,1672678024,1672679797,1773
3514,3613581796,3513345163,1672531277,1672531345,68
3452,3660063072,3554944414,1672619332,1672622071,2739
3550,3885121158,3311085279,1672687485,1672688800,1315
3907,3972083617,3497671225,1672599905,1672601435,1530
3641,3417191856,3621184108,1672666736,1672668737,2001
3859,3431502855,3372223551,1672649051,1672650806,1755
3888,3618354185,3497671225,1672651213,1672651521,308
3623,3334993594,3202804048,1672601507,1672601913,406
3464,3500777439,3701664364,1672677903,1672679356,1453
3507,3441703884,3500613459,1672610395,1672613182,2787
3669,3373089838,3701136026,1672604161,1672607498,3337
3521,3533004959,3979802715,1672628127,1672631630,3503
3518,3501459390,3209526819,1672681356,1672684643,3287
3685,3610358027,3898314440,1672568826,1672569430,604
3882,3778667336,3834960360,1672575880,1672576548,668
3694,3360616538,3622665543,1672631724,1672631818,94
3624,3714067076,3777485931,1672553879,1672555017,1138
3498,3621461051,3818575661,1672659974,1672660836,862
3548,3414940786,3715400486,1672549017,1672549356,339
3580,3915162005,3760842815,1672618893,1672619695,802
3576,3608922867,3517590837,1672612849,1672614592,1743
3807,3770296583,3240394404,1672569977,1672570353,376
3552,3791128487,3512958459,1672632772,1672633831,1059
3615,3618808151,3938503547,1672626236,1672629155,2919
3705,3713768950,3240394404,1672696203,1672698043,1840
3590,3513296868,3280268483,1672551228,1672551966,738
3724,3710735406,3889780657,1672698046,1672698982,936
3517,3665998641,3500302272,1672591787,1672591951,164
3745,3680810086,3755233658,1672610034,1672611724,1690
3914,3236499444,3774243020,1672693309,1672694563,1254
3748,3462158237,3904412440,1672671570,1672675055,3485
3489,3791753345,3334951866,1672624271,1672625634,1363
3634,3451326054,3514703118,1672621716,1672622673,957
3893,3288762795,3410600350,1672591927,1672592147,220
3450,3480100311,3834960360,1672557968,1672560546,2578
3822,3899326793,3515525630,1672545014,1672546320,1306
3806,3441703884,3389634034,1672638110,1672639243,1133
3683,3755992176,3347419520,1672689409,1672690688,1279
3446,3755222916,3618489670,1672679158,1672680953,1795
3578,3755737419,3773572967,1672647002,1672647891,889
3731,3300229945,3499217428,1672616611,1672618760,2149
3429,3510798825,3815392801,1672582531,1672584519,1988
3743,3632814465,3902760230,1672630228,1672630519,291
3445,3778667336,3920898925,1672669626,1672672014,2388
3879,3682133690,3401496246,1672543859,1672545850,1991
3484,3793883863,3311498666,1672576529,1672576699,170
3609,3333403880,3979802715,1672639789,1672639936,147
3551,3898314440,3516903528,1672602667,1672604112,1445
3703,3774733620,3533423872,1672539162,1672541968,2806
3702,3621790707,3783641602,1672558295,1672560821,2526
3522,3512882178,3757075324,1672608852,1672611956,3104
3863,3772078494,3448875382,1672688673,1672692015,3342
3837,3807212280,3338390596,1672649277,1672651566,2289
3745,3770296583,3478114114,1672613901,1672614559,658
3712,3859868849,3897134762,1672553853,1672556707,2854
3787,3500613459,3520416075,1672606387,1672607634,1247
3580,3970627281,3791613604,1672654783,1672655753,970
3527,3412006598,3472312341,1672570714,1672571775,1061
3708,3682133690,3293835352,1672626562,1672627255,693
3490,3793315718,3288224595,1672614265,1672617485,3220
3570,3500302272,3900898992,1672616564,1672617804,1240
3736,3710854064,3513327337,1672601572,1672604560,2988
3658,3431502855,3363162590,1672632766,1672633647,881
3494,3852686295,3501567772,1672623933,1672626134,2201
3535,3776084820,3201800997,1672568783,1672571556,2773
3896,3887243870,3373089838,1672628818,1672629980,1162
3667,3357689359,3517697722,1672607335,1672608144,809
3788,3401940259,3492546679,1672583076,1672586639,3563
3473,3386758279,3613581796,1672540359,1672541280,921
3511,3760842815,3512502036,1672573544,1672574270,726
3547,3202804048,3713691388,1672580251,1672582172,1921
3446,3783520186,3792274796,1672628566,1672631372,2806
3521,3686227677,3774705415,1672680435,1672680578,143
3444,3732131656,3776117322,1672592555,1672594532,1977
3764,3468041839,3454277788,1672602398,1672604856,2458
3755,3912891315,3774243020,1672661339,1672662115,776
3472,3607882826,3270697740,1672690325,1672691861,1536
3561,3621790707,3534175249,1672549651,1672550434,783
3545,3900276517,3780909839,1672563946,1672565810,1864
3606,3519416013,3757294769,1672583551,1672584043,492
3741,3665998641,3755344363,1672613417,1672615104,1687
3863,3757383891,3533368789,1672638441,1672638751,310
3759,3519028898,3833217041,1672691284,1672692363,1079
3665,3777037426,3493017654,1672532484,1672532735,251
3578,3715619259,3403370192,1672696281,1672697934,1653
3470,3511288998,3780834916,1672609983,1672612990,3007
3467,3756789525,3225631197,1672546859,1672549035,2176
3565,3418448389,3739154408,1672550023,1672551687,1664
3485,3517737088,3334974375,1672568556,1672571631,3075
3862,3760694096,3501281016,1672531336,1672532098,762
3432,3459681410,3500347447,1672624161,1672627526,3365
3445,3780872464,3288224595,1672558379,1672561944,3565
3515,3773572967,3613206049,1672618558,1672621879,3321
3660,3497671225,3341893384,1672561711,1672564386,2675
3826,3411515369,3614740489,1672610618,1672613904,3286
3620,3270697740,3792745809,1672534392,1672535160,768
3443,3336339664,3519142371,1672686862,1672690264,3402
3722,3661903000,3512392431,1672661332,1672663685,2353
3535,3366423342,3627368399,1672567809,1672568308,499
3442,3500317969,3510767239,1672682024,1672682147,123
3703,3272716462,3410160376,1672585097,1672586401,1304
3721,3370227921,3637313265,1672573884,1672575020,1136
3533,3850911686,3511288998,1672602927,1672604109,1182
3837,3732584121,3511288998,1672646591,1672647231,640
3517,3499217428,3887243870,1672620201,1672621307,1106
3553,3304155815,3385323994,1672557517,1672560199,2682
3691,3271752081,3814677862,1672635444,1672636762,1318
3447,3734451191,3469254160,1672697917,1672698755,838
3775,3462158237,3424660806,1672625021,1672626087,1066
3881,3792949946,3935913584,1672607003,1672609771,2768
3568,3517600136,3716963089,1672570842,1672574257,3415
3445,3774907131,3772765746,1672664207,1672667310,3103
3564,3897435944,3396980894,1672610222,1672611083,861
3703,3902760230,3206837348,1672583826,1672584793,967
3567,3604589802,3308760650,1672585032,1672588207,3175
3800,3517358573,3227799827,1672596379,1672597216,837
3767,3410538749,3230135532,1672682153,1672685322,3169
3839,3755344363,3757193551,1672585598,1672588994,3396
3611,3505995057,3850911686,1672662810,1672663397,587
3831,3505178849,3711812325,1672533615,1672533768,153
3447,3713561276,3732584121,1672554390,1672555030,640
3735,3757348722,3715986185,1672635950,1672636231,281
3523,3780909839,3200308999,1672696093,1672698312,2219
3517,3755233658,3783928182,1672534876,1672538352,3476
3433,3283144118,3441703884,1672604304,1672606049,1745
3599,3441703884,3779892400,1672639096,1672642695,3599
3549,3288762795,3613206049,1672610619,1672611236,617
3472,3604589802,3927599181,1672558486,1672561564,3078
3452,3367971170,3777240360,1672702870,1672706362,3492
3886,3202141727,3514419100,1672691106,1672692015,909
3449,3613416045,3912891315,1672671799,1672673758,1959
3906,3490029863,3270697740,1672673669,1672676947,3278
3910,3614740489,3757294769,1672627248,1672629888,2640
3683,3367111751,3480726047,1672631259,1672632306,1047
3511,3890739241,3756704774,1672535912,1672537916,2004
3734,3519087371,3515466096,1672700084,1672702923,2839
3795,3639050419,3815392801,1672567750,1672567814,64
3738,3386758279,3401793306,1672559376,1672562828,3452
3896,3680843171,3755915206,1672542363,1672545552,3189
3444,3512830734,3497095254,1672581310,1672583911,2601
3510,3977148669,3490214516,1672614092,1672617309,3217
3859,3449333754,3631090677,1672579470,1672579977,507
3861,3272716462,3505437712,1672575437,1672577030,1593
3899,3513296868,3534175249,1672555575,1672556262,687
3544,3756625818,3668747074,1672675853,1672677942,2089
3762,3380130228,3513853403,1672617708,1672619240,1532
3607,3897376951,3511601997,1672589832,1672591185,1353
3600,3514818819,3403370192,1672582448,1672586012,3564
3862,3792546035,3514971533,1672563335,1672564976,1641
3539,3783550022,3928719932,1672693969,1672695328,1359
3722,3884596900,3777184389,1672593891,1672597295,3404
3680,3501567772,3455018347,1672560084,1672561471,1387
3884,3431460073,3897376951,1672623939,1672627317,3378
3855,3631479562,3791436104,1672698390,1672699710,1320
3593,3638204468,3514246749,1672672745,1672675790,3045
3759,3770624662,3500498112,1672633465,1672635380,1915
3862,3668747074,3201629017,1672579577,1672581452,1875
3462,3510554314,3791753345,1672631572,1672632976,1404
3824,3626499450,3516444201,1672698291,1672699654,1363
3430,3505481368,3438078818,1672674637,1672674766,129
3760,3814305099,3450286949,1672633711,1672633807,96
3545,3615688740,3505923418,1672571889,1672573592,1703
3887,3776034743,3436025562,1672590837,1672592002,1165
3681,3715619259,3710496785,1672656523,1672659030,2507
3884,3880926355,3821054646,1672587704,1672589880,2176
3647,3774790271,3288762795,1672645258,1672647053,1795
3603,3793935736,3970909253,1672649114,1672650857,1743
3783,3514512367,3288762795,1672690075,1672692823,2748
3711,3774705415,3516741440,1672594494,1672597880,3386
3437,3520657891,3780338697,1672560626,1672563865,3239
3726,3520560590,3511024016,1672587488,1672590782,3294
3598,3711218296,3831586487,1672657584,1672659930,2346
3913,3492959689,3333918941,1672532714,1672534394,1680
3448,3818575661,3505521218,1672581020,1672583208,2188
3536,3927165965,3469254160,1672683065,1672685980,2915
3805,3755848152,3755233658,1672532646,1672534620,1974
3820,3617392620,3638204468,1672585151,1672588261,3110
3672,3703433819,3520873221,1672605028,1672605498,470
3805,3533188828,3714827719,1672611566,1672613490,1924
3559,3928511283,3613899351,1672632251,1672635273,3022
3537,3938389661,3500347447,1672562305,1672564384,2079
3699,3441348818,3915162005,1672676838,1672680395,3557
3708,3970909253,3667427125,1672566527,1672566820,293
3437,3501384020,3417191856,1672573756,1672576449,2693
3454,3462636434,3770468980,1672572393,1672572830,437
3704,3615939504,3366423342,1672581275,1672582199,924
3426,3613206049,3711919537,1672699806,1672702076,2270
3823,3511601997,3370068529,1672657033,1672658515,1482
3511,3739154408,3836241528,1672623384,1672625142,1758
3854,3276217799,3511288998,1672601447,1672602406,959
3715,3858172636,3850911686,1672546378,1672549882,3504
3574,3515402792,3815392801,1672667932,1672668097,165
3679,3826238375,3791693821,1672590238,1672591855,1617
3575,3618489670,3370068529,1672693356,1672696478,3122
3500,3711853996,3510187271,1672650582,1672650754,172
3673,3683113954,3399472693,1672620179,1672623667,3488
3705,3791046864,3517881647,1672567009,1672567302,293
3683,3817813340,3309314379,1672695929,1672696091,162
3525,3739661856,3500044458,1672555604,1672555848,244
3714,3815250107,3660887799,1672594418,1672597575,3157
3493,3505725706,3515439826,1672604484,1672605944,1460
3524,3614740489,3360069849,1672641859,1672642322,463
3581,3206837348,3780909839,1672659680,1672659748,68
3652,3808136029,3831586487,1672587318,1672587913,595
3442,3792745809,3783373154,1672702597,1672704564,1967
3684,3463740710,3500949309,1672569310,1672571939,2629
3857,3912891315,3815250107,1672539136,1672540604,1468
3593,3512282789,3369708250,1672602204,1672604198,1994
3780,3770468980,3757903168,1672590432,1672593558,3126
3698,3776988674,3664943873,1672567409,1672570427,3018
3546,3311420950,3519909393,1672686370,1672689663,3293
3733,3904569677,3279339278,1672619477,1672622056,2579
3525,3792505974,3505923418,1672607410,1672607523,113
3876,3512295534,3293835352,1672644233,1672647315,3082
3773,3431502855,3803389195,1672556078,1672557714,1636
3776,3773009828,3783169442,1672552982,1672556055,3073
3713,3711006062,3208452238,1672585815,1672587167,1352
3528,3713941638,3793740407,1672578628,1672582217,3589
3591,3517600136,3626499450,1672696308,1672696663,355
3752,3774907131,3604589802,1672605953,1672606088,135
3466,3928719932,3923420131,1672689501,1672692310,2809
3460,3238288884,3757903168,1672696453,1672699212,2759
3548,3921648519,3892304880,1672673009,1672673724,715
3868,3701373490,3793935736,1672564621,1672565943,1322
3890,3373089838,3505266860,1672696022,1672696573,551
3646,3517697722,3780427126,1672580228,1672580744,516
3840,3373028638,3737112297,1672696299,1672696491,192
3812,3824215187,3668747074,1672641473,1672643524,2051
3688,3276003502,3305336154,1672633963,1672636943,2980
3842,3336627643,3792525861,1672579423,1672581203,1780
3474,3394401087,3902861231,1672628279,1672630110,1831
3892,3520355798,3778667336,1672674872,1672676775,1903
3594,3897134762,3500317969,1672576421,1672579089,2668
3916,3283492940,3780571086,1672568204,1672569200,996
3880,3625174002,3660063072,1672701186,1672701562,376
3840,3480726047,3938503547,1672560126,1672562062,1936
3715,3669146016,3779532653,1672591294,1672592148,854
3845,3518229776,3492959689,1672590142,1672593345,3203
3486,3970198861,3757294769,1672647101,1672650192,3091
3692,3518561777,3711000597,1672613909,1672616376,2467
3450,3710854064,3713941638,1672676296,1672677917,1621
3667,3683113954,3688220326,1672576082,1672577799,1717
3647,3713300120,3665998641,1672640046,1672643629,3583
3725,3610870949,3203538212,1672629426,1672630394,968
3781,3554825448,3228888030,1672539757,1672540476,719
3571,3760362417,3760694096,1672577372,1672580378,3006
3583,3899786664,3770438122,1672618921,1672620497,1576
3852,3622665543,3500703304,1672590135,1672593218,3083
3569,3636329663,3240394404,1672537972,1672538924,952
3915,3505111292,3777330107,1672683613,1672686942,3329
3581,3367111751,3605221116,1672658155,1672659646,1491
3651,3514275974,3817428320,1672676301,1672677092,791
3624,3534543776,3760651515,1672538313,1672541226,2913
3818,3448875382,3510964997,1672664288,1672665008,720
3692,3779639983,3394401087,1672678160,1672679419,1259
3808,3284932450,3490214516,1672632302,1672635680,3378
3687,3783340788,3392836218,1672582803,1672585319,2516
3435,3520181148,3414275042,1672691493,1672694373,2880
3791,3505663516,3778899160,1672541046,1672544121,3075
3665,3316798920,3511442562,1672685802,1672687133,1331
3640,3792442597,3931627862,1672694377,1672694696,319
3542,3791753345,3311049964,1672623120,1672625031,1911
3715,3431460073,3884596900,1672533768,1672534233,465
3470,3760842815,3311420950,1672646485,1672646802,317
3921,3604867757,3370068529,1672589514,1672590531,1017
3568,3755848152,3714233826,1672635981,1672636059,78
3708,3716110860,3783928182,1672671239,1672673416,2177
3650,3756789525,3520181148,1672554107,1672555872,1765
3592,3710562338,3613416045,1672613936,1672615942,2006
3722,3510554314,3398198430,1672653895,1672655320,1425
3497,3783340788,3739661856,1672690284,1672691529,1245
3435,3487875183,3803389195,1672609630,1672609804,174
3841,3621184108,3516489668,1672628190,1672630552,2362
3604,3970198861,3450286949,1672668935,1672670222,1287
3452,3773939399,3900276517,1672565855,1672568052,2197
3453,3500302272,3500777439,1672609194,1672612128,2934
3731,3792014516,3927165965,1672533001,1672534647,1646
3600,3792801638,3362641275,1672626756,1672629758,3002
3763,3621790707,3500072204,1672630254,1672631580,1326
3813,3514308235,3400069268,1672531746,1672535089,3343
3747,3779425804,3755573472,1672652009,1672652378,369
3505,3501459390,3505437712,1672564052,1672566680,2628
3744,3514956366,3615113018,1672663503,1672663670,167
3695,3400763927,3637313265,1672597373,1672597836,463
3717,3892304880,3480100311,1672643358,1672644404,1046
3513,3774733620,3513296868,1672584414,1672586144,1730
3502,3738026330,3812534508,1672639518,1672640791,1273
3640,3514703118,3272096759,1672566498,1672566857,359
3621,3515525630,3456430614,1672661068,1672662753,1685
3792,3757332128,3714666884,1672665296,1672668429,3133
3728,3519416013,3515401243,1672595943,1672597627,1684
3896,3783340788,3793175445,1672546554,1672548075,1521
3622,3384068080,3711853996,1672666070,1672669038,2968
3823,3510187271,3714233826,1672684904,1672685793,889
3775,3826238375,3904867554,1672674351,1672674438,87
3604,3490029863,3501567772,1672574603,1672577315,2712
3743,3777814504,3792274796,1672552197,1672554558,2361
3585,3760640999,3505402439,1672551278,1672551511,233
3915,3760842815,3780712350,1672633328,1672635518,2190
3539,3757323954,3710735406,1672531552,1672533447,1895
3435,3627368399,3909094917,1672657921,1672660610,2689
3734,3519850727,3783919913,1672597602,1672598692,1090
3632,3311085279,3777624586,1672625826,1672625940,114
3769,3300511067,3241790910,1672635961,1672639372,3411
3895,3817428320,3238288884,1672690805,1672693407,2602
3477,3684523966,3715127070,1672558022,1672558092,70
3602,3757294769,3780872464,1672668471,1672670338,1867
3584,3757332128,3622357348,1672678837,1672679225,388
3610,3760263530,3801645328,1672683999,1672686261,2262
3844,3478114114,3296462324,1672700080,1672701889,1809
3673,3899326793,3392836218,1672563450,1672563612,162
3558,3714666884,3714067076,1672552791,1672552987,196
3919,3516513251,3732131656,1672634088,1672634768,680
3894,3401496246,3357289672,1672651773,1672654428,2655
3579,3778899160,3900276517,1672677464,1672678630,1166
3656,3701247948,3619922891,1672625996,1672626865,869
3896,3621683102,3398198430,1672681759,1672685066,3307
3877,3512392431,3701664364,1672633471,1672634628,1157
3907,3772765746,3783928182,1672611382,1672612606,1224
3649,3390660440,3396980894,1672580586,1672581356,770
3654,3289817992,3510818674,1672662680,1672662748,68
3589,3500915665,3739661856,1672646967,1672649794,2827
3667,3885537225,3514308235,1672621342,1672623734,2392
3543,3244004456,3239617320,1672559966,1672563437,3471
3460,3452016771,3445206685,1672698463,1672699840,1377
3792,3934064792,3972083617,1672602578,1672604604,2026
3875,3450969839,3778597171,1672650439,1672653035,2596
3615,3833217041,3343816795,1672691309,1672692314,1005
3825,3201629017,3783433404,1672608646,1672608728,82
3914,3613899351,3514334067,1672684220,1672684634,414
3513,3500072204,3225631197,1672691557,1672691746,189
3553,3736231757,3737112297,1672681178,1672684217,3039
3486,3793969543,3688220326,1672640488,1672643966,3478
3574,3971806004,3500613493,1672645457,1672645820,363
3656,3792489602,3730071479,1672578733,1672581314,2581
3479,3398198430,3665998641,1672558284,1672558426,142
3765,3283492940,3713784974,1672535440,1672535889,449
3588,3970909253,3793740407,1672604983,1672605540,557
3603,3667427125,3436025562,1672603909,1672606417,2508
3694,3618354185,3779786641,1672603022,1672606501,3479
3650,3613206049,3519416013,1672624747,1672625371,624
3724,3505725706,3510641433,1672616083,1672616325,242
3554,3770520359,3970198861,1672700244,1672702923,2679
3865,3500777439,3417679834,1672535827,1672536990,1163
3449,3412968120,3225636215,1672671209,1672673590,2381
3778,3510837901,3488686442,1672660601,1672661442,841
3665,3933894942,3777814504,1672633278,1672634007,729
3899,3273981374,3208957949,1672660788,1672661267,479
3454,3309314379,3839245934,1672591220,1672591358,138
3862,3757075324,3605221116,1672556327,1672558309,1982
3451,3776831527,3500208903,1672669020,1672670935,1915
3695,3792505974,3501525100,1672661996,1672665373,3377
3479,3779738691,3665998641,1672649741,1672650138,397
3511,3367111751,3285204083,1672596687,1672597793,1106
3512,3778134418,3480490124,1672693757,1672695062,1305
3837,3491684096,3533294425,1672627895,1672629357,1462
3612,3714670620,3203538212,1672538806,1672540863,2057
3889,3209481722,3500525825,1672557660,1672558264,604
3561,3310039260,3443357683,1672677558,1672680578,3020
3740,3755496114,3515401243,1672619664,1672622280,2616
3742,3637313265,3777240360,1672556663,1672557496,833
3819,3773027597,3316798920,1672577451,1672577965,514
3668,3774718695,3500613493,1672615333,1672618776,3443
3602,3445206685,3291933594,1672534435,1672534715,280
3467,3520764926,3238288884,1672538816,1672541982,3166
3686,3492546679,3408498208,1672584490,1672587648,3158
3746,3310125159,3734118023,1672693635,1672697222,3587
3712,3505178849,3814305099,1672544209,1672547580,3371
3673,3398731252,3622665543,1672592651,1672593103,452
3539,3899326793,3272716462,1672613637,1672616320,2683
3867,3660063072,3512392431,1672545304,1672548162,2858
3727,3703396825,3375449013,1672604109,1672606468,2359
3743,3821054646,3288224595,1672617770,1672620536,2766
3574,3738026330,3330340793,1672609390,1672611257,1867
3533,3890739241,3520322124,1672666488,1672669245,2757
3711,3497808662,3280268483,1672621243,1672621546,303
3491,3688220326,3501459390,1672651951,1672654568,2617
3675,3701884158,3505995057,1672577765,1672579825,2060
3904,3756789525,3757630221,1672690174,1672690348,174
3840,3686227677,3757630221,1672572066,1672574700,2634
3699,3780909839,3701247948,1672679021,1672680578,1557
3860,3513410578,3793315718,1672597502,1672599045,1543
3771,3760640999,3412006598,1672549504,1672550432,928
3482,3793315718,3349856820,1672620438,1672621865,1427
3896,3315279093,3514512367,1672552353,1672555122,2769
3897,3637313265,3923220461,1672564814,1672566723,1909
3809,3779938251,3627368399,1672540049,1672542364,2315
3658,3770624662,3800257590,1672694663,1672696922,2259
3649,3505663516,3627368399,1672698318,1672698560,242
3832,3777814504,3519818818,1672591839,1672592900,1061
3763,3623266256,3292147449,1672611295,1672611969,674
3904,3713911104,3514285803,1672541890,1672544277,2387
3829,3245232284,3801645328,1672608457,1672611655,3198
3586,3510641433,3500737582,1672642457,1672642532,75
3535,3608922867,3899786664,1672544656,1672548112,3456
3459,3285204083,3773332082,1672651924,1672652932,1008
3682,3635169815,3905899155,1672599638,1672602445,2807
3448,3351866415,3283770991,1672572255,1672572405,150
3861,3270697740,3970627281,1672613141,1672616505,3364
3633,3835985172,3505178849,1672690547,1672691412,865
3699,3457960571,3497095254,1672576766,1672579012,2246
3432,3610358027,3715385401,1672679870,1672683446,3576
3683,3500109249,3773009828,1672623541,1672625136,1595
3436,3520639768,3364378127,1672648185,1672649639,1454
3449,3533188828,3773009828,1672668978,1672670059,1081
3671,3807212280,3510818674,1672651293,1672652198,905
3778,3887243870,3615087943,1672534291,1672537369,3078
3432,3685816610,3779786641,1672576457,1672579632,3175
3578,3772765746,3793781065,1672581596,1672582542,946
3892,3737147209,3812369928,1672590269,1672591658,1389
3680,3225636215,3343132529,1672552988,1672555888,2900
3624,3480991549,3618489670,1672589370,1672590041,671
3528,3412968120,3244004456,1672612700,1672615704,3004
3602,3792505974,3513065217,1672697442,1672700346,2904
3428,3757193307,3618489670,1672631518,1672634670,3152
3584,3823084403,3354144091,1672666293,1672668853,2560
3681,3636329663,3668533536,1672694461,1672697703,3242
3728,3619922891,3974674109,1672575877,1672576160,283
3617,3276217799,3755573472,1672593875,1672595055,1180
3459,3928719932,3424660806,1672641051,1672642950,1899
3469,3500044458,3977148669,1672574602,1672575801,1199
3497,3501281016,3517881647,1672599793,1672600885,1092
3805,3300979975,3703383853,1672636517,1672638106,1589
3538,3755915206,3890739241,1672691402,1672693299,1897
3529,3226024417,3519028898,1672669593,1672671383,1790
3889,3604589802,3885121158,1672534988,1672535676,688
3809,3463849738,3928511283,1672542735,1672545082,2347
3582,3714670620,3517172354,1672681269,1672683327,2058
3595,3500777439,3394297564,1672617253,1672619181,1928
3765,3439673892,3920497528,1672654418,1672657911,3493
3503,3617392620,3760364383,1672665496,1672668110,2614
3732,3236458894,3272096759,1672687776,1672689622,1846
3689,3900898992,3206837348,1672592705,1672595024,2319
3832,3557046880,3811075491,1672688511,1672689164,653
3706,3408498208,3600876425,1672540171,1672541137,966
3490,3500915665,3389634034,1672608232,1672611715,3483
3679,3891672228,3757348722,1672678481,1672681131,2650
3823,3304971369,3793583656,1672691649,1672692791,1142
3598,3500525825,3613581796,1672697480,1672698725,1245
3708,3760694096,3757193551,1672574297,1672575101,804
3580,3736231757,3779938251,1672622920,1672625639,2719
3626,3440107959,3385323994,1672627182,1672629683,2501
3465,3512383699,3512958459,1672672276,1672674781,2505
3501,3512383699,3713163045,1672625911,1672629037,3126
3689,3511732493,3285204083,1672580946,1672583512,2566
3651,3513360004,3770468980,1672563493,1672565171,1678
3775,3509764635,3778926763,1672558549,1672561188,2639
3662,3514956366,3373089838,1672573216,1672575847,2631
3506,3607768197,3779656423,1672574997,1672576233,1236
3854,3228888030,3716628503,1672638333,1672641342,3009
3815,3513545422,3780712350,1672695806,1672699366,3560
3526,3364378127,3774178201,1672643396,1672646404,3008
3757,3519818818,3276003502,1672668894,1672670176,1282
3780,3515525630,3315703693,1672687349,1672689964,2615
3508,3208452238,3600876425,1672673548,1672673921,373
3828,3500044458,3779425804,1672687073,1672687859,786
3698,3448875382,3921648519,1672596420,1672598934,2514
3656,3497095254,3756704774,1672541101,1672541493,392
3668,3316798920,3711006062,1672600603,1672604025,3422
3626,3533274994,3500709774,1672548045,1672549627,1582
3636,3623266256,3392943173,1672546775,1672548460,1685
3491,3711853996,3773735484,1672564128,1672565334,1206
3735,3783136330,3310125159,1672642891,1672644203,1312
3734,3227799827,3716679950,1672553430,1672555926,2496
3473,3755344363,3436257398,1672652831,1672656186,3355
3735,3206837348,3501525100,1672533158,1672535316,2158
3532,3974674109,3920625129,1672545401,1672547882,2481
3505,3733363628,3311420950,1672658530,1672662018,3488
3646,3396980894,3772391882,1672536578,1672539565,2987
3786,3773124276,3760842815,1672574823,1672575798,975
3597,3201629017,3688796737,1672675639,1672678033,2394
3612,3514246749,3517358573,1672686764,1672688795,2031
3571,3519087371,3436025562,1672639927,1672640556,629
3802,3401793306,3515402792,1672623988,1672626987,2999
3540,3383138270,3756704774,1672657245,1672657774,529
3893,3791106564,3431502855,1672641391,1672642781,1390
3487,3514741348,3665998641,1672635148,1672636672,1524
3701,3284932450,3491469603,1672669543,1672671299,1756
3624,3514512367,3516444201,1672677489,1672677664,175
3621,3428027649,3510837901,1672552119,1672552355,236
3578,3461119815,3534179433,1672634654,1672634838,184
3557,3380982774,3970558632,1672616544,1672618193,1649
3577,3512295534,3512383699,1672536163,1672539025,2862
3915,3774031303,3932478321,1672640865,1672642440,1575
3661,3811075491,3626499450,1672589311,1672590598,1287
3712,3225636215,3511317276,1672545999,1672546242,243
3479,3625463628,3760263530,1672537177,1672539135,1958
3889,3793781065,3446533960,1672548282,1672548468,186
3580,3713589994,3710315160,1672590483,1672592066,1583
3583,3514334067,3713941638,1672675138,1672677136,1998
3640,3514703118,3773332082,1672600151,1672601226,1075
3689,3773124276,3414049538,1672616678,1672618309,1631
3795,3970198861,3520416075,1672686925,1672688153,1228
3473,3276003502,3927165965,1672546030,1672549244,3214
3513,3480726047,3710562338,1672564677,1672565792,1115
3565,3979802715,3935913584,1672703213,1672705245,2032
3834,3533274994,3620292035,1672585279,1672587733,2454
3697,3715127070,3621184108,1672561700,1672565018,3318
3855,3711077927,3736705719,1672646179,1672646305,126
3819,3885155975,3370068529,1672545231,1672545316,85
3863,3304155815,3807212280,1672586109,1672587806,1697
3524,3897134762,3757193307,1672544511,1672546285,1774
3891,3225636215,3374183227,1672674916,1672675983,1067
3434,3201800997,3778667336,1672578672,1672581941,3269
3466,3519909393,3334647380,1672587375,1672588998,1623
3688,3379143440,3891672228,1672608874,1672610827,1953
3917,3715974659,3448875382,1672610762,1672611843,1081
3815,3500737582,3510641433,1672654279,1672655573,1294
3531,3462636434,3608922867,1672686509,1672686575,66
3671,3755992176,3897456874,1672656909,1672660095,3186
3578,3970627281,3438078818,1672542190,1672542603,413
3441,3533274994,3780253901,1672671453,1672674350,2897
3686,3609659642,3519850727,1672647717,1672648034,317
3707,3399518841,3276348699,1672677758,1672681345,3587
3574,3285204083,3701884158,1672556983,1672559354,2371
3639,3701247948,3685816610,1672666009,1672669110,3101
3677,3970198861,3441348818,1672537050,1672537865,815
3521,3421385957,3756704774,1672538970,1672540208,1238
3482,3333918941,3829864515,1672551567,1672555039,3472
3470,3716272919,3334993594,1672614767,1672617872,3105
3453,3500703304,3279242917,1672609807,1672611003,1196
3665,3505434346,3343816795,1672607893,1672608662,769
3664,3608922867,3517172354,1672594436,1672595320,884
3836,3711637255,3369708250,1672643981,1672645548,1567
3460,3533188828,3511883730,1672629219,1672631552,2333
3512,3395201292,3533368789,1672661409,1672664280,2871
3863,3711853996,3347446226,1672651311,1672652350,1039
3912,3289114629,3711000597,1672676712,1672677813,1101
3642,3757348722,3667673649,1672614921,1672617876,2955
3538,3454277788,3791436104,1672564995,1672566393,1398
3602,3511843593,3300818269,1672641067,1672641768,701
3557,3500525825,3330340793,1672545146,1672548141,2995
3597,3970627281,3774290799,1672559135,1672560162,1027
3476,3202141727,3505888598,1672597945,1672600172,2227
3864,3300979975,3893912331,1672576530,1672576867,337
3483,3716628503,3772078494,1672600733,1672603500,2767
3770,3515559913,3824641227,1672640577,1672644003,3426
3658,3970198861,3499217428,1672595943,1672596968,1025
3786,3815392801,3517697722,1672652736,1672653588,852
3843,3449639012,3445206685,1672559228,1672561326,2098
3632,3714678331,3760651515,1672549971,1672553093,3122
3709,3200308999,3516513251,1672550788,1672553441,2653
3433,3449639012,3357864626,1672653346,1672656398,3052
3435,3390660440,3478114114,1672618949,1672622292,3343
3487,3449639012,3905196766,1672685840,1672688296,2456
3497,3622665543,3930242012,1672539361,1672539749,388
3511,3774718695,3414940786,1672603000,1672606433,3433
3562,3457960571,3770704999,1672581904,1672582106,202
3712,3921648519,3618354185,1672544476,1672546755,2279
3588,3897456874,3622357348,1672687035,1672690610,3575
3460,3793935736,3518653080,1672696406,1672699235,2829
3713,3517991730,3367509761,1672628380,1672629944,1564
3592,3661583097,3372223551,1672579916,1672583175,3259
3433,3713829743,3621790707,1672586443,1672589101,2658
3826,3519028898,3927599181,1672643525,1672646580,3055
3826,3909094917,3552824113,1672692133,1672694472,2339
3435,3793922324,3615113018,1672646018,1672648265,2247
3705,3920625129,3760645796,1672561172,1672562146,974
3749,3793743698,3373028638,1672652191,1672654130,1939
3673,3701322924,3520991398,1672627751,1672629753,2002
3651,3534179433,3445206685,1672606275,1672607370,1095
3916,3224811762,3791436104,1672648377,1672651479,3102
3688,3773939399,3817813340,1672629882,1672631305,1423
3724,3711218296,3885157459,1672613826,1672615843,2017
3467,3510642075,3559458968,1672607051,1672610133,3082
3802,3229822507,3757863420,1672695683,1672697336,1653
3579,3449333754,3633735593,1672632434,1672634279,1845
3600,3511150845,3755915206,1672591292,1672594169,2877
3595,3414049538,3608922867,1672566607,1672569047,2440
3640,3715545685,3505111292,1672572082,1672573543,1461
3646,3773572967,3500777439,1672614933,1672616985,2052
3483,3505807416,3713517039,1672701453,1672701847,394
3526,3780680950,3436257398,1672703866,1672704563,697
3585,3516703758,3935913584,1672636140,1672638747,2607
3424,3773009828,3701247948,1672694918,1672696476,1558
3590,3279242917,3513296868,1672595351,1672597911,2560
3442,3534543776,3500949309,1672643617,1672645761,2144
3741,3920497528,3514308235,1672543592,1672545165,1573
3496,3661903000,3834963772,1672552127,1672554884,2757
3790,3667673649,3517462308,1672582340,1672584609,2269
3766,3370227921,3716963089,1672581085,1672582157,1072
3908,3534543776,3701882224,1672672740,1672675614,2874
3755,3760842815,3463740710,1672622228,1672625625,3397
3716,3760362417,3514419100,1672583351,1672586771,3420
3687,3400069268,3710315160,1672648214,1672648453,239
3901,3272096759,3808136029,1672567314,1672569927,2613
3884,3509764635,3755404116,1672553572,1672556143,2571
3722,3516903528,3777091903,1672654221,1672655454,1233
3653,3463740710,3912891315,1672628158,1672629039,881
3919,3899786664,3534566651,1672629725,1672631872,2147
3450,3970627281,3351696332,1672542490,1672543157,667
3724,3382733096,3534764451,1672536779,1672538131,1352
3514,3475349791,3615939504,1672700561,1672702791,2230
3878,3776831527,3792014516,1672651106,1672652648,1542
3652,3779465522,3417679834,1672573810,1672576348,2538
3905,3554186380,3773033649,1672697996,1672701253,3257
3676,3386758279,3920625129,1672617839,1672618531,692
3485,3779465522,3500915908,1672561219,1672561711,492
3493,3668533536,3755344363,1672536993,1672540444,3451
3531,3773572967,3815392801,1672556497,1672557073,576
3542,3500341755,3520639768,1672603013,1672604095,1082
3760,3783550022,3713517039,1672621553,1672623430,1877
3555,3604589802,3225636215,1672693708,1672694329,621
3839,3776518452,3351696332,1672655814,1672658725,2911
3707,3823084403,3928511283,1672583348,1672583560,212
3653,3480991549,3491684096,1672603804,1672607404,3600
3750,3701882224,3309314379,1672599280,1672602799,3519
3851,3519651506,3505179890,1672697564,1672697856,292
3556,3512337405,3778926763,1672599978,1672602473,2495
3503,3852686295,3500442734,1672626024,1672628094,2070
3782,3511601997,3777814504,1672655168,1672656618,1450
3596,3360069849,3500777439,1672669581,1672670052,471
3688,3792072681,3351866415,1672655585,1672656831,1246
3439,3853629553,3715854030,1672574101,1672576741,2640
3452,3514419100,3935399379,1672622250,1672623399,1149
3919,3421877923,3226024417,1672665565,1672668662,3097
3472,3497671225,3519077659,1672693718,1672696676,2958
3651,3241914067,3415833929,1672668193,1672670966,2773
3426,3710562338,3701884158,1672669123,1672671514,2391
3758,3612689556,3779738691,1672676463,1672678331,1868
3686,3497671225,3715127070,1672661353,1672664797,3444
3449,3312998540,3505154885,1672589733,1672590895,1162
3508,3739661856,3824641227,1672549384,1672550291,907
3453,3410538749,3669146016,1672636189,1672636833,644
3635,3689697817,3780322355,1672627517,1672627625,108
3481,3534543776,3686523546,1672666164,1672669451,3287
3842,3791753345,3421385957,1672641961,1672644786,2825
3769,3710735406,3519282716,1672571455,1672572088,633
3742,3461119815,3384068080,1672587098,1672587950,852
3554,3533228966,3817813340,1672578247,1672578826,579
3474,3668414677,3517887477,1672651628,1672651999,371
3604,3621790707,3411688875,1672540949,1672541084,135
3502,3626499450,3760362417,1672543908,1672546462,2554
3741,3755344363,3516741440,1672673917,1672677163,3246
3702,3780712350,3380982774,1672571928,1672572783,855
3666,3351696332,3774718695,1672665732,1672666079,347
3685,3270056120,3500341755,1672583727,1672585074,1347
3615,3780472203,3480726047,1672586005,1672589561,3556
3780,3447672935,3512800570,1672642965,1672645532,2567
3585,3515466096,3608232640,1672676901,1672677033,132
3860,3485540729,3818575661,1672585776,1672587269,1493
3434,3487875183,3780834916,1672547578,1672550884,3306
3744,3710489491,3710854064,1672614078,1672614874,796
3598,3354144091,3311420950,1672664338,1672664761,423
3711,3517590837,3500841914,1672571658,1672573193,1535
3756,3732131656,3783615982,1672549894,1672551892,1998
3479,3715385401,3505888598,1672543550,1672544728,1178
3514,3757193307,3733363628,1672593593,1672594385,792
3531,3633735593,3880926355,1672587148,1672588144,996
3748,3428725843,3811075491,1672588285,1672588446,161
3920,3615115210,3716679950,1672654498,1672655335,837
3836,3519651506,3714827719,1672550225,1672552545,2320
3723,3311420950,3774907131,1672604651,1672606854,2203
3756,3236354255,3455018347,1672589730,1672591331,1601
3760,3517737088,3770296583,1672604888,1672605570,682
3691,3791128487,3410600350,1672548669,1672549396,727
3768,3815250107,3501525100,1672642153,1672642486,333
3492,3793743698,3337362061,1672625543,1672626750,1207
3756,3686227677,3713941638,1672697897,1672700663,2766
3629,3783373154,3534764451,1672670690,1672673142,2452
3539,3791613604,3335694356,1672694713,1672695535,822
3557,3779892400,3533228966,1672623370,1672624735,1365
3438,3711853996,3294747828,1672565366,1672565590,224
3777,3357864626,3492546679,1672532205,1672534735,2530
3772,3448875382,3618808151,1672699808,1672701547,1739
3612,3755573472,3519282716,1672604978,1672606883,1905
3639,3500709774,3398198430,1672700698,1672701980,1282
3879,3512946768,3914691363,1672616332,1672616599,267
3921,3824641227,3515401243,1672666290,1672667213,923
3634,3462273042,3920898925,1672694975,1672697420,2445
3721,3246370118,3815392801,1672588522,1672588631,109
3842,3205923620,3226024417,1672567147,1672569650,2503
3460,3627368399,3520560590,1672568784,1672569335,551
3645,3755573472,3701322924,1672595087,1672598612,3525
3565,3428027649,3311085279,1672658247,1672661467,3220
3831,3774790271,3739911441,1672617778,1672621288,3510
3459,3920898925,3757332128,1672578943,1672581900,2957
3476,3739911441,3760263530,1672558727,1672561530,2803
3800,3856606678,3312998540,1672701556,1672702989,1433
3509,3533004959,3411515369,1672635018,1672638360,3342
3497,3971806004,3783771827,1672668993,1672671818,2825
3429,3739154408,3834631333,1672590557,1672593131,2574
3724,3300818269,3311049964,1672622601,1672625234,2633
3896,3938389661,3351696332,1672604697,1672605084,387
3710,3497808662,3773124276,1672538882,1672541625,2743
3623,3292147449,3510028805,1672667568,1672667785,217
3866,3201676087,3668414677,1672554820,1672555139,319
3514,3451326054,3734451191,1672673261,1672676508,3247
3690,3891672228,3201676087,1672685318,1672686155,837
3922,3755344363,3385323994,1672649815,1672651844,2029
3649,3779465522,3236354255,1672697595,1672698989,1394
3611,3793583656,3668414677,1672584572,1672586971,2399
3703,3501384020,3347419520,1672641170,1672641284,114
3670,3711097754,3337322736,1672589002,1672591549,2547
3861,3614740489,3447672935,1672629575,1672632030,2455
3826,3755496114,3517172354,1672632327,1672632677,350
3594,3667427125,3517358573,1672550333,1672551810,1477
3755,3688220326,3609113156,1672666178,1672667175,997
3588,3776518452,3559731671,1672639916,1672642778,2862
3458,3395201292,3923754072,1672575047,1672575486,439
3687,3791436104,3783615982,1672604363,1672604448,85
3890,3935399379,3772236797,1672548142,1672549871,1729
3717,3834960360,3516489668,1672554276,1672556835,2559
3533,3305336154,3519818818,1672588045,1672590558,2513
3890,3715854030,3415833929,1672638845,1672640778,1933
3753,3519651506,3284947372,1672684706,1672685512,806
3788,3661903000,3505807416,1672625511,1672626052,541
3679,3310039260,3710496785,1672614122,1672616684,2562
3475,3439673892,3551389192,1672641495,1672641998,503
3819,3703396825,3534126409,1672632340,1672633869,1529
3698,3271454397,3736705719,1672598086,1672601470,3384
3836,3792538417,3618489670,1672671811,1672674279,2468
3459,3272716462,3777814504,1672601298,1672604120,2822
3441,3228888030,3975717896,1672628945,1672631726,2781
3610,3776831527,3366423342,1672689684,1672690645,961
3834,3270056120,3362641275,1672575343,1672576259,916
3443,3667673649,3519446663,1672648600,1672649857,1257
3756,3783340788,3451691949,1672649343,1672650928,1585
3728,3371455553,3300229945,1672624498,1672624722,224
3585,3792014516,3311098437,1672647677,1672648747,1070
3801,3756385685,3632814465,1672533241,1672535632,2391
3868,3500072204,3505995057,1672553748,1672554598,850
3826,3510028805,3205985903,1672665911,1672669195,3284
3694,3469254160,3428027649,1672683301,1672683976,675
3446,3500498112,3711853996,1672596569,1672598696,2127
3912,3236354255,3770624662,1672678480,1672678764,284
3792,3897456874,3513041785,1672699682,1672701982,2300
3901,3463740710,3774641380,1672689300,1672692221,2921
3645,3225029895,3814305099,1672602663,1672604320,1657
3819,3517222913,3288224595,1672701078,1672703351,2273
3610,3435116799,3510554314,1672619852,1672621340,1488
3455,3369708250,3410600350,1672600426,1672603963,3537
3649,3205985903,3517590837,1672666992,1672669110,2118
3479,3850911686,3713561276,1672570477,1672570969,492
3574,3783147088,3773027597,1672657793,1672657867,74
3544,3311085279,3732131656,1672683668,1672686757,3089
3855,3505847380,3755065949,1672634099,1672637259,3160
3800,3755158925,3611055563,1672635147,1672638714,3567
3719,3499217428,3834963772,1672557501,1672558004,503
3896,3732131656,3906536154,1672618701,1672620854,2153
3796,3793740407,3517358573,1672584909,1672586026,1117
3846,3716110860,3732584121,1672572778,1672574588,1810
3662,3480490124,3906536154,1672621687,1672624598,2911
3752,3780209375,3791106564,1672698609,1672698912,303
3522,3793781065,3200543880,1672613515,1672616127,2612
3885,3927599181,3715974659,1672541750,1672542356,606
3633,3755496114,3459681410,1672669885,1672671560,1675
3882,3520181148,3559458968,1672671757,1672673990,2233
3601,3760364383,3512379024,1672626655,1672629042,2387
3875,3701322924,3792020993,1672633886,1672634986,1100
3752,3556969573,3505807416,1672671781,1672674270,2489
3631,3209526819,3631479562,1672570772,1672570849,77
3835,3904569677,3481640525,1672674428,1672674552,124
3707,3289114629,3622665543,1672580564,1672583141,2577
3430,3505111292,3688796737,1672618746,1672619853,1107
3847,3315279093,3613206049,1672654734,1672657769,3035
3558,3513018485,3710315160,1672570660,1672572377,1717
3719,3519087371,3731646673,1672701793,1672704319,2526
3516,3899786664,3396726504,1672559332,1672562735,3403
3479,3513360004,3500737582,1672650647,1672651125,478
3580,3500302272,3206837348,1672596123,1672598384,2261
3622,3460719322,3510767239,1672661202,1672663634,2432
3661,3411515369,3801645328,1672540191,1672542957,2766
3779,3826238375,3451326054,1672593780,1672594498,718
3644,3776559988,3520560590,1672613570,1672616500,2930
3563,3811040565,3777779869,1672668085,1672668281,196
3833,3776117322,3514324011,1672608156,1672608656,500
3770,3428725843,3621683102,1672696913,1672698772,1859
3632,3621790707,3511288998,1672638382,1672639495,1113
3424,3396980894,3927165965,1672558795,1672561929,3134
3600,3757863420,3241914067,1672598914,1672601131,2217
3469,3909094917,3414940786,1672648797,1672649181,384
3482,3686523546,3373028638,1672620034,1672620954,920
3662,3793583656,3416987084,1672663119,1672666684,3565
3490,3518653080,3777240360,1672643606,1672645939,2333
3767,3334974375,3447672935,1672623419,1672626851,3432
3865,3783433404,3418448389,1672584667,1672586794,2127
3640,3501525100,3714120857,1672579692,1672581552,1860
3611,3902625986,3682133690,1672544832,1672546401,1569
3747,3316798920,3334647380,1672594484,1672594928,444
3565,3410160376,3279475486,1672596644,1672598526,1882
3615,3514818819,3497671225,1672571753,1672572326,573
3550,3429943738,3932478321,1672605022,1672605175,153
3517,3605221116,3514703118,1672611396,1672614227,2831
3724,3515559913,3517462308,1672634522,1672636792,2270
3619,3808136029,3711637255,1672590178,1672591890,1712
3541,3783801141,3683113954,1672603968,1672606438,2470
3838,3311085279,3551399764,1672671043,1672671293,250
3876,3357689359,3779938251,1672632715,1672635887,3172
3596,3411688875,3689697817,1672644607,1672644824,217
3445,3495911207,3904867554,1672603277,1672606584,3307
3784,3624297844,3688220326,1672567904,1672568342,438
3785,3520764926,3387594369,1672686895,1672689865,2970
3573,3517222913,3435167810,1672652144,1672653853,1709
3536,3299125059,3501567772,1672539402,1672542853,3451
3603,3757193307,3270042456,1672637066,1672640354,3288
3637,3463740710,3621790707,1672535675,1672538235,2560
3821,3551399764,3515559913,1672665171,1672667041,1870
3677,3439673892,3334951866,1672638683,1672639704,1021
3671,3349856820,3533294425,1672569216,1672570586,1370
3922,3276348699,3713911104,1672546507,1672549015,2508
3821,3475349791,3713300120,1672586105,1672589183,3078
3835,3520416075,3880926355,1672680397,1672683647,3250
3452,3777330107,3500777439,1672583587,1672584484,897
3736,3618489670,3833217041,1672586610,1672589653,3043
3718,3618176292,3517590837,1672594090,1672596682,2592
3507,3200543880,3770520359,1672540475,1672543755,3280
3765,3791128487,3970603231,1672558163,1672559009,846
3522,3309314379,3928511283,1672539240,1672541957,2717
3758,3780680950,3618808151,1672548690,1672550042,1352
3915,3399472693,3711000597,1672579379,1672581801,2422
3886,3760694096,3393063657,1672612848,1672615965,3117
3853,3500703304,3615939504,1672677275,1672678222,947
3691,3283144118,3300511067,1672601527,1672602963,1436
3510,3343816795,3780872464,1672636030,1672639026,2996
3917,3284932450,3514308235,1672630008,1672631532,1524
3730,3757294769,3904867554,1672597960,1672598448,488
3444,3510499038,3774705415,1672677944,1672678263,319
3812,3933894942,3774705415,1672553707,1672555099,1392
3708,3515401243,3505111292,1672671474,1672674962,3488
3712,3774718695,3501384020,1672646415,1672649532,3117
3708,3338083680,3755233658,1672550489,1672551726,1237
3431,3637313265,3500072204,1672551451,1672552890,1439
3853,3512800570,3778597171,1672700424,1672703914,3490
3911,3811075491,3777814504,1672556089,1672557082,993
3509,3500703304,3780769110,1672624623,1672625546,923
3916,3291933594,3716628503,1672643992,1672645214,1222
3543,3613581796,3512383699,1672570811,1672572865,2054
3904,3396726504,3516741440,1672546734,1672548387,1653
3441,3534126409,3289817992,1672604603,1672606950,2347
3632,3631479562,3897134762,1672652894,1672654673,1779
3690,3534175249,3514285803,1672653970,1672656946,2976
3856,3505111292,3512800570,1672590876,1672592678,1802
3787,3792525861,3793969543,1672647713,1672648348,635
3896,3205985903,3495911207,1672663903,1672664643,740
3494,3760694096,3500498112,1672546195,1672546462,267
3610,3885537225,3462273042,1672552556,1672554509,1953
3779,3505434346,3618176292,1672660913,1672662008,1095
3732,3414275042,3499217428,1672609340,1672612128,2788
3516,3478114114,3534829213,1672535562,1672538111,2549
3905,3270697740,3412006598,1672653686,1672656887,3201
3760,3513065217,3245232284,1672645523,1672648984,3461
3627,3515525630,3513545422,1672534808,1672536359,1551
3613,3373028638,3499217428,1672548474,1672550178,1704
3920,3501384020,3793781065,1672556855,1672558970,2115
3532,3711919537,3479851674,1672558950,1672559786,836
3915,3972192593,3404025196,1672675638,1672677740,2102
3817,3777779869,3480726047,1672614850,1672617861,3011
3685,3392943173,3625174002,1672637381,1672640151,2770
3902,3609113156,3372223551,1672657521,1672660116,2595
3533,3421385957,3451726367,1672664188,1672665145,957
3833,3610870949,3293835352,1672660377,1672662935,2558
3702,3739154408,3783433404,1672548114,1672549755,1641
3806,3927165965,3512379024,1672548715,1672550167,1452
3747,3520873221,3604589802,1672589870,1672592378,2508
3812,3367111751,3897134762,1672543442,1672546529,3087
3785,3779301501,3534357694,1672568665,1672569805,1140
3882,3518565331,3438078818,1672611114,1672613068,1954
3436,3927165965,3480726047,1672595230,1672596019,789
3733,3793315718,3416987084,1672536453,1672537117,664
3860,3615113018,3337322736,1672674629,1672675615,986
3535,3513360004,3780427126,1672646157,1672649621,3464
3433,3756789525,3276348699,1672660626,1672663669,3043
3811,3512882178,3551389192,1672606944,1672608165,1221
3526,3387594369,3793743698,1672703550,1672705087,1537
3503,3299125059,3711097754,1672624468,1672627709,3241
3578,3386758279,3514512367,1672623434,1672623947,513
3815,3490214516,3505807416,1672627965,1672628915,950
3450,3500109249,3737147209,1672671515,1672672882,1367
3727,3512958459,3701136026,1672681620,1672682191,571
3685,3511601997,3475349791,1672549380,1672551456,2076
3668,3367509761,3792546035,1672567731,1672568801,1070
3884,3383138270,3288224595,1672681047,1672682207,1160
3646,3685681577,3977148669,1672645605,1672645841,236
3765,3500672156,3757630221,1672678740,1672680225,1485
3908,3661583097,3493017654,1672620232,1672623683,3451
3890,3534357694,3856606678,1672680474,1672683540,3066
3590,3505179890,3732131656,1672621157,1672622102,945
3613,3515525630,3900898992,1672540937,1672541683,746
3439,3818575661,3364378127,1672561610,1672561878,268
3448,3533274994,3780115155,1672650951,1672653324,2373
3474,3757323954,3811040565,1672630561,1672633672,3111
3913,3480100311,3401496246,1672675869,1672678358,2489
3474,3777240360,3241790910,1672577998,1672580744,2746
3848,3730071479,3338083680,1672559021,1672561449,2428
3594,3889780657,3760924079,1672658563,1672661280,2717
3494,3791246640,3711097754,1672691741,1672694119,2378
3476,3500347447,3376467719,1672532811,1672535526,2715
3796,3792274796,3517172354,1672611782,1672613285,1503
3832,3304155815,3760040019,1672549332,1672549662,330
3815,3364726656,3280268483,1672651970,1672654122,2152
3761,3613416045,3520873221,1672581802,1672583849,2047
3602,3424445495,3793583656,1672691094,1672692924,1830
3502,3505807416,3367509761,1672623071,1672626415,3344
3659,3468041839,3534543776,1672688475,1672691959,3484
3916,3779938251,3284932450,1672647633,1672649294,1661
3433,3737112297,3311098437,1672592509,1672594700,2191
3859,3202804048,3446533960,1672666442,1672667899,1457
3602,3812369928,3224968597,1672595472,1672597753,2281
3754,3512722110,3338083680,1672596329,1672598137,1808
3699,3436025562,3448633776,1672667826,1672670010,2184
3806,3625463628,3294703680,1672613903,1672614041,138
3791,3757294769,3209526819,1672651569,1672651763,194
3544,3274906650,3231713082,1672561650,1672562190,540
3655,3510187271,3776988674,1672627557,1672630337,2780
3713,3441703884,3688796737,1672685865,1672687101,1236
3562,3779854934,3225631197,1672702680,1672704496,1816
3835,3296462324,3618489670,1672539933,1672540672,739
3433,3294747828,3470454332,1672578791,1672581256,2465
3857,3715707380,3228888030,1672603577,1672604752,1175
3602,3220031931,3274831810,1672640331,1672641465,1134
3769,3380767040,3231713082,1672535592,1672536533,941
3554,3711637255,3808136029,1672555614,1672557418,1804
3722,3715986185,3808136029,1672639204,1672641649,2445
3682,3520639768,3800257590,1672662311,1672665103,2792
3769,3505434346,3462158237,1672586282,1672586904,622
3467,3410538749,3500857494,1672625584,1672625781,197
3465,3231713082,3519077659,1672592419,1672592502,83
3476,3364378127,3731646673,1672570074,1672572009,1935
3804,3364726656,3731646673,1672620635,1672621498,863
3438,3714827719,3714827719,1672533133,1672534992,1859
3825,3551389192,3456430614,1672622753,1672622820,67
3807,3203538212,3755756564,1672628791,1672630445,1654
3652,3500442734,3900276517,1672697995,1672701062,3067
3440,3246370118,3472068734,1672588349,1672588984,635
3822,3300511067,3208957949,1672531866,1672531929,63
3583,3731646673,3811040565,1672609120,1672610639,1519
3661,3892304880,3904569677,1672598223,1672600643,2420
3756,3817813340,3619922891,1672628081,1672630077,1996
3808,3505178849,3902625986,1672655535,1672656384,849
3754,3608855425,3224811762,1672682944,1672683125,181
3529,3792546035,3505725706,1672580306,1672583626,3320
3536,3914691363,3208452238,1672700918,1672702483,1565
3506,3499217428,3445206685,1672591928,1672592194,266
3717,3760094385,3792020993,1672589863,1672591603,1740
3469,3773572967,3511791953,1672628036,1672628369,333
3594,3614740489,3682133690,1672621011,1672621487,476
3701,3519651506,3357289672,1672572875,1672573780,905
3605,3814305099,3312998540,1672613911,1672614736,825
3737,3900276517,3338390596,1672605414,1672607806,2392
3441,3510641433,3394297564,1672532116,1672535507,3391
3820,3979784676,3713300120,1672593455,1672596031,2576
3690,3713911104,3380982774,1672551843,1672554704,2861
3752,3905196766,3783801141,1672575878,1672578010,2132
3569,3793407963,3714067076,1672667473,1672668494,1021
3768,3551376095,3780338697,1672651593,1672653217,1624
3811,3669146016,3777779869,1672533171,1672535851,2680
3822,3488686442,3856606678,1672691194,1672694207,3013
3622,3469254160,3617116290,1672638897,1672640863,1966
3708,3977352557,3371455553,1672582511,1672585304,2793
3821,3404025196,3713829743,1672689554,1672690656,1102
3438,3519416013,3756127300,1672655036,1672656903,1867
3741,3429943738,3711853996,1672534553,1672537160,2607
3540,3618808151,3621461051,1672593722,1672595322,1600
3842,3777037426,3925979970,1672652555,1672656063,3508
3560,3715986185,3713911104,1672670958,1672671637,679
3693,3737112297,3385323994,1672613186,1672614203,1017
3429,3304155815,3279475486,1672669967,1672671622,1655
3529,3773124276,3449639012,1672550703,1672551154,451
3616,3715986185,3713163045,1672534249,1672534620,371
3675,3618489670,3970909253,1672575792,1672576802,1010
3734,3417679834,3330340793,1672676867,1672680460,3593
3897,3915162005,3780680950,1672659676,1672661464,1788
3496,3520181148,3411688875,1672589047,1672589509,462
3705,3777485931,3979784676,1672667879,1672668759,880
3829,3416987084,3236354255,1672549833,1672551333,1500
3814,3447514821,3934064792,1672654701,1672656441,1740
3761,3305336154,3638204468,1672564152,1672566086,1934
3587,3501121099,3505434346,1672694224,1672696187,1963
3686,3755158925,3756474459,1672593994,1672597161,3167
3773,3779854934,3774641380,1672574686,1672576845,2159
3833,3668533536,3684523966,1672569616,1672571818,2202
3627,3713691388,3559731671,1672554320,1672557116,2796
3525,3534829213,3517288083,1672531690,1672532215,525
3570,3660887799,3500317969,1672583917,1672584444,527
3771,3273981374,3510642075,1672656776,1672658086,1310
3753,3410160376,3792489602,1672640053,1672640326,273
3687,3511791953,3534357694,1672687991,1672688099,108
3622,3500949309,3236354255,1672632498,1672635394,2896
3901,3284947372,3617489344,1672702231,1672704467,2236
3880,3715385401,3970603231,1672617290,1672620885,3595
3785,3519446663,3509764635,1672541670,1672542770,1100
3633,3417191856,3518565331,1672696078,1672698791,2713
3909,3780427126,3511442562,1672630876,1672633635,2759
3817,3665998641,3408430195,1672684158,1672686680,2522
3857,3516903528,3443357683,1672588506,1672592036,3530
3840,3514512367,3757903168,1672544040,1672544146,106
3789,3779438325,3505402439,1672646929,1672649258,2329
3916,3333918941,3610358027,1672668696,1672671987,3291
3898,3714128600,3703433819,1672623024,1672625649,2625
3628,3225636215,3462273042,1672590562,1672591180,618
3869,3349856820,3393063657,1672578943,1672581742,2799
3707,3732584121,3480100311,1672696162,1672697439,1277
3571,3551399764,3511442562,1672625033,1672628615,3582
3487,3517590837,3306175858,1672648314,1672649239,925
3884,3756625818,3625174002,1672640979,1672641148,169
3887,3777694660,3240394404,1672660164,1672661052,888
3601,3305722859,3779425804,1672532429,1672533611,1182
3575,3334974375,3710489491,1672622583,1672623602,1019
3870,3411515369,3410600350,1672551948,1672552099,151
3642,3711919537,3783169442,1672631308,1672631887,579
3573,3501786419,3793743698,1672575425,1672578828,3403
3607,3680843171,3519651506,1672691699,1672693256,1557
3570,3400763927,3688796737,1672671734,1672673133,1399
3430,3516703758,3509893027,1672623697,1672626316,2619
3738,3906536154,3364726656,1672660492,1672663553,3061
3775,3733558985,3737112297,1672560044,1672561667,1623
3912,3500777439,3393063657,1672653918,1672656669,2751
3665,3617304541,3414275042,1672544646,1672544934,288
3801,3337362061,3511317276,1672599273,1672602579,3306
3472,3240994288,3713829743,1672605862,1672608150,2288
3813,3225631197,3817813340,1672671471,1672672287,816
3867,3814305099,3451326054,1672542387,1672544210,1823
3499,3534126409,3337322736,1672586750,1672588705,1955
3820,3770520359,3686523546,1672626999,1672629655,2656
3775,3755065949,3337362061,1672645660,1672648617,2957
3697,3510964997,3414940786,1672559254,1672560996,1742
3489,3404025196,3783550022,1672676040,1672677575,1535
3702,3711077927,3792949946,1672641382,1672644449,3067
3624,3715385401,3501121099,1672660579,1672661189,610
3654,3411515369,3779854934,1672544656,1672546059,1403
3639,3514956366,3514308235,1672579588,1672579992,404
3865,3516513251,3774243020,1672692913,1672695652,2739
3734,3756704774,3412006598,1672555890,1672558730,2840
3917,3977352557,3240394404,1672615229,1672615358,129
3848,3783919913,3367971170,1672695483,1672698856,3373
3872,3230868435,3500525825,1672623751,1672623921,170
3847,3778899160,3441703884,1672588093,1672588974,881
3560,3360813161,3701664364,1672599880,1672601105,1225
3442,3783136330,3783163143,1672624872,1672627445,2573
3825,3520578796,3979802715,1672631968,1672632209,241
3679,3534126409,3757075324,1672543663,1672544887,1224
3491,3777091903,3793583656,1672672583,1672675635,3052
3896,3362641275,3367509761,1672641246,1672641993,747
3748,3757318448,3906536154,1672674666,1672677191,2525
3436,3500208903,3760364383,1672685214,1672688535,3321
3770,3668533536,3497095254,1672573218,1672576651,3433
3634,3517222913,3509366311,1672568588,1672572149,3561
3865,3513081354,3900945856,1672583071,1672583713,642
3747,3834631333,3509764635,1672542187,1672542912,725
3459,3478114114,3710562338,1672656070,1672658552,2482
3906,3755496114,3613338363,1672632333,1672632795,462
3611,3367971170,3520560590,1672564636,1672566792,2156
3701,3703433819,3755404116,1672534792,1672537696,2904
3790,3392943173,3315279093,1672611055,1672613852,2797
3627,3402385957,3970909253,1672593812,1672596460,2648
3614,3615688740,3410538749,1672561768,1672564899,3131
3722,3836241528,3760263530,1672674458,1672676758,2300
3683,3271752081,3412968120,1672536087,1672538144,2057
3599,3357689359,3501121099,1672671248,1672674420,3172
3768,3776988674,3431460073,1672541912,1672543835,1923
3751,3516741440,3760263530,1672594650,1672596822,2172
3425,3491684096,3716110860,1672592533,1672595603,3070
3835,3362641275,3777091903,1672570649,1672573325,2676
3735,3780209375,3270697740,1672640908,1672644327,3419
3658,3238288884,3533929349,1672544852,1672547651,2799
3749,3505111292,3414940786,1672691938,1672694730,2792
3897,3852686295,3334951866,1672703221,1672704318,1097
3909,3824215187,3510499038,1672637474,1672640841,3367
3847,3713911104,3714120857,1672581415,1672583016,1601
3480,3615087943,3517687662,1672565618,1672566316,698
3440,3459681410,3513410578,1672613642,1672616056,2414
3487,3710854064,3933894942,1672634358,1672637006,2648
3883,3783771827,3904867554,1672680292,1672681258,966
3566,3513545422,3711812325,1672694961,1672696578,1617
3643,3756127300,3604589802,1672552965,1672556094,3129
3775,3350095157,3909094917,1672639866,1672640713,847
3488,3519077659,3714128600,1672557328,1672557824,496
3641,3385323994,3334951866,1672647695,1672649717,2022
3577,3512502036,3777037426,1672622875,1672623296,421
3483,3224811762,3621790707,1672647037,1672648074,1037
3714,3780909839,3514703118,1672570869,1672573115,2246
3487,3481640525,3793175445,1672611062,1672614333,3271
3501,3774243020,3533188828,1672694247,1672695579,1332
3443,3505437712,3793175445,1672586495,1672587849,1354
3919,3512946768,3514324011,1672558912,1672560749,1837
3597,3938389661,3500857494,1672545711,1672545778,67
3602,3230135532,3533423872,1672689663,1672691269,1606
3884,3335694356,3627368399,1672680162,1672682803,2641
3519,3619922891,3713300120,1672640463,1672643493,3030
3635,3510919821,3231494505,1672609164,1672610600,1436
3442,3240394404,3793935736,1672623019,1672624072,1053
3783,3757193307,3776559988,1672577138,1672578259,1121
3511,3497671225,3829864515,1672691167,1672691565,398
3583,3460719322,3501525100,1672660065,1672660698,633
3794,3270056120,3773027597,1672612130,1672614749,2619
3780,3435116799,3238288884,1672656337,1672659335,2998
3573,3617116290,3610358027,1672664403,1672667587,3184
3716,3684523966,3792274796,1672550676,1672550911,235
3507,3510964997,3617489344,1672684218,1672684876,658
3639,3825881598,3780253901,1672579378,1672579818,440
3917,3291933594,3716679950,1672582134,1672583843,1709
3484,3497808662,3897376951,1672551573,1672554250,2677
3565,3244004456,3283492940,1672578791,1672580146,1355
3525,3554944414,3710048469,1672647134,1672648618,1484
3880,3792505974,3408430195,1672536716,1672536897,181
3583,3701884158,3512499658,1672667584,1672669991,2407
3532,3884596900,3448875382,1672653020,1672653763,743
3862,3513545422,3660063072,1672690403,1672693507,3104
3661,3609933747,3410538749,1672554605,1672555084,479
3665,3711637255,3783550022,1672651647,1672653491,1844
3881,3609933747,3436257398,1672592628,1672592944,316
3463,3755233658,3776518452,1672622938,1672623651,713
3490,3304155815,3354144091,1672610176,1672610370,194
3871,3622357348,3394401087,1672613800,1672614270,470
3436,3294747828,3516703758,1672629190,1672631555,2365
3438,3431460073,3461119815,1672572303,1672572745,442
3649,3449639012,3519818818,1672639315,1672640782,1467
3842,3513065217,3897134762,1672696826,1672699929,3103
3476,3701107228,3480490124,1672582904,1672584356,1452
3797,3760651515,3449639012,1672633643,1672636665,3022
3855,3417679834,3457620713,1672689247,1672689652,405
3787,3364726656,3300229945,1672580874,1672580995,121
3469,3891672228,3710562338,1672655208,1672657036,1828
3677,3520416075,3730071479,1672628525,1672630314,1789
3668,3897134762,3552824113,1672555257,1672557620,2363
3471,3408430195,3668533536,1672547407,1672550871,3464
3819,3490214516,3520639768,1672534266,1672535985,1719
3682,3779738691,3209526819,1672642400,1672643523,1123
3634,3457620713,3713784974,1672655250,1672658705,3455
3497,3774243020,3686227677,1672632336,1672633329,993
3780,3294703680,3509366311,1672580209,1672582638,2429
3757,3224811762,3505437712,1672556540,1672556722,182
3604,3909094917,3509366311,1672534656,1672535438,782
3871,3638204468,3534179433,1672612787,1672614992,2205
3860,3350095157,3401940259,1672578064,1672579697,1633
3656,3774733620,3757193551,1672672042,1672672958,916
3488,3501281016,3364378127,1672565839,1672565969,130
3606,3791128487,3792014516,1672560269,1672561447,1178
3758,3516321888,3622665543,1672544025,1672546188,2163
3611,3625174002,3487875183,1672669681,1672670642,961
3495,3778640261,3760094385,1672641348,1672644637,3289
3522,3755496114,3779892400,1672622046,1672622876,830
3462,3684523966,3414940786,1672698275,1672700039,1764
3697,3416987084,3814677862,1672654886,1672655775,889
3814,3617304541,3812369928,1672573457,1672574412,955
3701,3734451191,3701322924,1672669395,1672670353,958
3672,3505402439,3714233826,1672690096,1672693671,3575
3718,3511883730,3604589802,1672560959,1672561525,566
3614,3280054198,3349739136,1672639006,1672639534,528
3471,3315703693,3284947372,1672677451,1672678166,715
3512,3755737419,3970909253,1672610160,1672611464,1304
3445,3757294769,3889780657,1672582482,1672583927,1445
3754,3517222913,3935399379,1672621273,1672623879,2606
3573,3621683102,3757193307,1672575918,1672578520,2602
3711,3514419100,3336339664,1672594223,1672597490,3267
3559,3755532873,3519028898,1672635590,1672635742,152
3662,3715443333,3792389522,1672638853,1672639531,678
3909,3711006062,3495911207,1672630560,1672633267,2707
3699,3533294425,3780834916,1672614736,1672615790,1054
3812,3680810086,3783373154,1672628008,1672629864,1856
3858,3711218296,3701107228,1672645002,1672646676,1674
3549,3736705719,3514741348,1672590418,1672592607,2189
3548,3533747868,3520657891,1672545540,1672545910,370
3424,3773837847,3618808151,1672544098,1672544945,847
3667,3459681410,3514818819,1672598443,1672600937,2494
3765,3274831810,3518561777,1672635007,1672637704,2697
3879,3826238375,3770438122,1672615615,1672618994,3379
3735,3776831527,3914691363,1672637432,1672639494,2062
3464,3208452238,3716272919,1672637515,1672638116,601
3838,3446533960,3817428320,1672644204,1672645783,1579
3564,3311498666,3777694660,1672690878,1672692302,1424
3846,3756474459,3772765746,1672685482,1672686078,596
3524,3665998641,3439673892,1672639717,1672643034,3317
3571,3501457103,3773124276,1672672072,1672675054,2982
3633,3780472203,3630353876,1672697997,1672698200,203
3631,3703433819,3505923418,1672692269,1672695441,3172
3895,3490214516,3438078818,1672619325,1672620260,935
3467,3680810086,3755532873,1672545336,1672546738,1402
3602,3514419100,3818575661,1672693720,1672695076,1356
3545,3534357694,3779646172,1672584008,1672587409,3401
3809,3520873221,3713768950,1672609624,1672610775,1151
3751,3362641275,3755915206,1672651583,1672652379,796
3727,3514324011,3760040019,1672551727,1672553339,1612
3489,3620292035,3607882826,1672668007,1672671074,3067
3428,3517881647,3604867757,1672638744,1672639686,942
3765,3462636434,3509756823,1672564727,1672567671,2944
3760,3757323954,3757863420,1672581901,1672584546,2645
3466,3284947372,3457960571,1672647987,1672649204,1217
3448,3460719322,3703383853,1672636444,1672636681,237
3481,3513853403,3533090502,1672676993,1672679372,2379
3424,3834960360,3711097754,1672620816,1672622258,1442
3651,3294747828,3977352557,1672572356,1672574853,2497
3693,3778134418,3364726656,1672562103,1672564096,1993
3759,3312998540,3240394404,1672675347,1672676286,939
3523,3793781065,3792442597,1672649566,1672650658,1092
3810,3316798920,3834963772,1672700464,1672701528,1064
3852,3513041785,3856606678,1672605599,1672607845,2246
3771,3279473441,3756746867,1672697472,1672700561,3089
3438,3510187271,3392520516,1672676429,1672678208,1779
3522,3510767239,3701247948,1672676960,1672680021,3061
3544,3551389192,3500613459,1672666745,1672668457,1712
3916,3755344363,3713691388,1672570690,1672572310,1620
3526,3289114629,3914691363,1672645113,1672645716,603
3589,3609113156,3711218296,1672572135,1672575284,3149
3518,3501215099,3614740489,1672597414,1672599938,2524
3807,3716272919,3394401087,1672661289,1672663532,2243
3515,3230135532,3289817992,1672617713,1672619121,1408
3520,3701005527,3688796737,1672695947,1672698518,2571
3459,3772391882,3668747074,1672615087,1672615550,463
3821,3716679950,3755222916,1672664346,1672667003,2657
3741,3421385957,3306412634,1672582564,1672585559,2995
3870,3834631333,3380130228,1672569558,1672572176,2618
3857,3755404116,3780427126,1672652956,1672654525,1569
3570,3683113954,3770676872,1672583350,1672585408,2058
3788,3480726047,3462158237,1672639360,1672640062,702
3702,3791796585,3347446226,1672564604,1672565322,718
3750,3511732493,3520657891,1672557944,1672560539,2595
3688,3293835352,3899326793,1672637560,1672640524,2964
3842,3279473441,3236458894,1672561598,1672563236,1638
3445,3488686442,3730071479,1672686200,1672687273,1073
3533,3511883730,3859868849,1672567295,1672570394,3099
3453,3533929349,3793969543,1672584430,1672587237,2807
3685,3501215099,3534566651,1672652310,1672652403,93
3539,3783919913,3905196766,1672558822,1672561027,2205
3460,3370227921,3701823816,1672632965,1672635330,2365
3450,3757630221,3715974659,1672598225,1672599007,782
3499,3500498112,3970558632,1672632758,1672634861,2103
3520,3739911441,3613338363,1672692627,1672696104,3477
3513,3501121099,3780338697,1672602194,1672603389,1195
3589,3970909253,3492546679,1672678475,1672680660,2185
3570,3512502036,3783169442,1672626061,1672628607,2546
3869,3231494505,3688220326,1672570753,1672571010,257
3425,3770676872,3779438325,1672684966,1672686485,1519
3883,3920625129,3304971369,1672597163,1672597315,152
3474,3814305099,3294747828,1672562319,1672565840,3521
3515,3792546035,3760263530,1672572210,1672575366,3156
3449,3773121782,3362641275,1672681569,1672683057,1488
3580,3615737355,3972083617,1672601968,1672603046,1078
3497,3509366311,3517222913,1672622544,1672624145,1601
3840,3760694096,3517881647,1672604468,1672606039,1571
3589,3315703693,3520355798,1672639612,1672639753,141
3841,3514334067,3515890966,1672654337,1672655049,712
3920,3412968120,3337362061,1672664403,1672664835,432
3729,3276348699,3470454332,1672574412,1672576661,2249
3620,3853629553,3439673892,1672606824,1672607901,1077
3588,3514956366,3505481368,1672656551,1672659645,3094
3463,3448633776,3551376095,1672552366,1672555956,3590
3906,3856606678,3776988674,1672584827,1672588057,3230
3631,3686523546,3401496246,1672595300,1672598696,3396
3473,3757863420,3730071479,1672598329,1672601723,3394
3830,3713941638,3517288083,1672698140,1672701298,3158
3500,3517887477,3620292035,1672645520,1672647778,2258
3449,3792072681,3792525861,1672546160,1672548101,1941
3621,3373028638,3618489670,1672623752,1672626361,2609
3769,3821054646,3392520516,1672669960,1672673348,3388
3452,3815392801,3777240360,1672558941,1672562267,3326
3567,3398731252,3512882178,1672581054,1672581279,225
3566,3974674109,3774290799,1672654764,1672655216,452
3893,3519142371,3559731671,1672650950,1672653388,2438
3439,3505198734,3349856820,1672603816,1672607142,3326
3603,3760263530,3236354255,1672575103,1672576589,1486
3553,3935913584,3703798634,1672592542,1672592910,368
3826,3793583656,3714120857,1672657081,1672660510,3429
3555,3428027649,3757294769,1672544472,1672547676,3204
3841,3512392431,3604589802,1672611759,1672612219,460
3431,3715707380,3915162005,1672628631,1672630213,1582
3786,3274906650,3613206049,1672629859,1672632872,3013
3628,3668414677,3510642075,1672674411,1672677672,3261
3620,3480100311,3779532653,1672631456,1672634033,2577
3491,3899786664,3516703758,1672540973,1672541680,707
3534,3779438325,3773033649,1672531419,1672532468,1049
3686,3343816795,3516903528,1672571531,1672574924,3393
3597,3412006598,3515401243,1672595774,1672598375,2601
3709,3884596900,3505266860,1672560752,1672561115,363
3501,3755158925,3688796737,1672593985,1672594655,670
3804,3885537225,3739895284,1672703746,1672706346,2600
3911,3240394404,3299125059,1672581165,1672583543,2378
3658,3755233658,3408430195,1672699662,1672699834,172
3532,3609113156,3513327337,1672648679,1672651937,3258
3767,3414940786,3505178849,1672604039,1672605793,1754
3856,3279473441,3272030610,1672585882,1672589284,3402
3831,3505725706,3270056120,1672578230,1672578410,180
3632,3701107228,3533274994,1672668789,1672670964,2175
3696,3711734586,3357689359,1672693929,1672694945,1016
3886,3772765746,3410600350,1672582413,1672584122,1709
3589,3557046880,3609113156,1672657789,1672659310,1521
3670,3284947372,3825881598,1672598731,1672602240,3509
3427,3514741348,3618176292,1672673230,1672673312,82
3554,3733363628,3517600136,1672585246,1672585507,261
3543,3495911207,3900945856,1672623108,1672625269,2161
3557,3492959689,3552824113,1672536768,1672538287,1519
3788,3435167810,3833217041,1672629805,1672633082,3277
3842,3711919537,3897456874,1672533372,1672534231,859
3834,3364378127,3688220326,1672690980,1672693098,2118
3664,3755573472,3780769110,1672580909,1672582589,1680
3687,3613416045,3777091903,1672629824,1672632857,3033
3876,3880926355,3713691388,1672624574,1672625175,601
3749,3902625986,3757863420,1672688555,1672691369,2814
3806,3347419520,3773902805,1672646966,1672648261,1295
3689,3972083617,3774243020,1672643866,1672647433,3567
3675,3400069268,3404025196,1672676026,1672677288,1262
3435,3778899160,3776117322,1672580226,1672582460,2234
3700,3703383853,3490029863,1672670911,1672674088,3177
3814,3501567772,3732584121,1672702421,1672703190,769
3565,3773939399,3500208903,1672678304,1672680111,1807
3600,3209481722,3668533536,1672607022,1672609914,2892
3472,3779613523,3713829743,1672545452,1672548581,3129
3523,3512337405,3512295534,1672641160,1672641975,815
3622,3783771827,3779892400,1672558268,1672560108,1840
3763,3514419100,3291933594,1672547581,1672549934,2353
3629,3288762795,3516298579,1672610687,1672611113,426
3882,3714185969,3512958459,1672635323,1672638096,2773
3451,3510642075,3970909253,1672687229,1672688460,1231
3794,3461119815,3703383853,1672697256,1672700437,3181
3575,3899786664,3513295938,1672703946,1672704986,1040
3740,3756746867,3776559988,1672612144,1672613666,1522
3678,3500208903,3512800570,1672534337,1672536103,1766
3520,3334974375,3515401243,1672659316,1672659593,277
3860,3713941638,3755915206,1672597772,1672600083,2311
3625,3900898992,3513327337,1672560184,1672560868,684
3635,3783919913,3501567772,1672594558,1672595683,1125
3426,3923220461,3514419100,1672690337,1672693825,3488
3552,3777147510,3231713082,1672614309,1672615269,960
3461,3294747828,3776084820,1672604559,1672605553,994
3502,3500525825,3783928182,1672697516,1672697734,218
3612,3311085279,3611055563,1672537541,1672539047,1506
3613,3408430195,3617304541,1672688394,1672691753,3359
3725,3714128600,3858172636,1672565316,1672565625,309
3646,3310125159,3279473441,1672645535,1672646179,644
3783,3481640525,3604867757,1672545298,1672547749,2451
3667,3737147209,3372223551,1672626147,1672627206,1059
3526,3452016771,3710854064,1672547366,1672548319,953
3776,3369708250,3515439826,1672612228,1672613581,1353
3890,3685681577,3776518452,1672550482,1672552863,2381
3812,3509893027,3639050419,1672614147,1672617218,3071
3876,3812534508,3462273042,1672678685,1672681431,2746
3545,3505807416,3710496785,1672642994,1672644444,1450
3694,3470454332,3400763927,1672537970,1672538834,864
3501,3500525825,3509756823,1672689559,1672692700,3141
3876,3821054646,3792745809,1672670723,1672673395,2672
3671,3852533643,3500072204,1672556342,1672557227,885
3656,3615087943,3505154885,1672556311,1672556940,629
3671,3383138270,3631479562,1672663889,1672667475,3586
3568,3610358027,3200543880,1672674348,1672676662,2314
3794,3505228454,3398731252,1672638013,1672638881,868
3510,3369708250,3774907131,1672560769,1672561883,1114
3687,3618489670,3713300120,1672593571,1672595754,2183
3724,3517172354,3509483172,1672604071,1672606551,2480
3495,3520657891,3304155815,1672692794,1672695500,2706
3729,3515439826,3970198861,1672653934,1672654791,857
3562,3812534508,3605221116,1672567194,1672569241,2047
3850,3627368399,3713784974,1672555603,1672558745,3142
3921,3779613523,3701823816,1672693972,1672695382,1410
3834,3205985903,3755756564,1672648648,1672651582,2934
3577,3774605761,3513360004,1672611840,1672613430,1590
3872,3231494505,3829864515,1672683134,1672683998,864
3484,3730071479,3900276517,1672573169,1672576347,3178
3815,3398731252,3792505974,1672578540,1672581382,2842
3741,3520657891,3902861231,1672688160,1672688746,586
3670,3513545422,3757863420,1672679190,1672679659,469
3738,3791441520,3515890966,1672564509,1672565072,563
3756,3360616538,3505888598,1672700936,1672701026,90
3846,3505178849,3514334067,1672642687,1672643072,385
3895,3389634034,3240994288,1672550185,1672551960,1775
3649,3519446663,3608232640,1672534401,1672536467,2066
3894,3296462324,3612689556,1672622469,1672624649,2180
3618,3438489358,3240394404,1672630426,1672630984,558
3855,3271454397,3731646673,1672570131,1672573494,3363
3473,3777184389,3815250107,1672603038,1672605982,2944
3802,3505725706,3501786419,1672539815,1672542338,2523
3725,3512722110,3734118023,1672630147,1672633643,3496
3596,3368283077,3514275974,1672589292,1672591948,2656
3439,3633735593,3500341755,1672635540,1672637760,2220
3818,3335694356,3509483172,1672617099,1672620113,3014
3549,3533368789,3783136330,1672647630,1672648621,991
3823,3824215187,3505521218,1672688736,1672689208,472
3893,3461119815,3755573472,1672663440,1672663753,313
3764,3337322736,3500841914,1672572765,1672575499,2734
3907,3899326793,3713561276,1672612947,1672615993,3046
3882,3757318448,3224811762,1672634223,1672636399,2176
3920,3368283077,3294703680,1672561051,1672563994,2943
3521,3661903000,3637313265,1672642583,1672643493,910
3538,3551399764,3604589802,1672700609,1672702272,1663
3617,3904569677,3791246640,1672636324,1672638182,1858
3862,3334993594,3396980894,1672542514,1672545784,3270
3653,3600876425,3304155815,1672602602,1672604970,2368
3540,3515559913,3814305099,1672655766,1672657164,1398
3672,3518194482,3755992176,1672644018,1672646839,2821
3530,3970603231,3517222913,1672635535,1672637536,2001
3825,3300229945,3431502855,1672534404,1672535048,644
3646,3710315160,3276217799,1672632294,1672634656,2362
3678,3890739241,3701882224,1672685302,1672685873,571
3476,3701823816,3491469603,1672703023,1672703865,842
3693,3604589802,3520322124,1672589799,1672591284,1485
3713,3206837348,3500827202,1672621889,1672623991,2102
3732,3774178201,3511288998,1672635799,1672636738,939
3900,3457960571,3512958459,1672676782,1672677156,374
3512,3757193551,3772391882,1672611932,1672613027,1095
3432,3371455553,3363162590,1672611095,1672612908,1813
3440,3200308999,3668414677,1672562148,1672564646,2498
3545,3780769110,3900898992,1672690896,1672692836,1940
3657,3393063657,3515559913,1672559194,1672562190,2996
3600,3970627281,3390660440,1672596505,1672597390,885
3565,3333403880,3835422146,1672654322,1672654918,596
3580,3733558985,3520322124,1672656565,1672657230,665
3813,3615113018,3774031303,1672703461,1672704354,893
3450,3516903528,3500827202,1672626158,1672626486,328
3591,3757323954,3306412634,1672621417,1672623445,2028
3513,3280054198,3738026330,1672540788,1672542386,1598
3865,3713979100,3975717896,1672614336,1672615110,774
3446,3511005395,3450969839,1672663200,1672666196,2996
3667,3401940259,3414049538,1672682234,1672683043,809
3914,3520991398,3511442562,1672621873,1672622750,877
3814,3300229945,3500109249,1672624493,1672625284,791
3504,3435167810,3240994288,1672608082,1672610339,2257
3546,3714827719,3897435944,1672626563,1672628887,2324
3899,3534566651,3756704774,1672543002,1672545391,2389
3891,3735374579,3311098437,1672691956,1672695521,3565
3579,3534179433,3622357348,1672553900,1672557146,3246
3469,3399518841,3306175858,1672687746,1672688613,867
3447,3499217428,3890739241,1672561411,1672564255,2844
3697,3783163143,3710048469,1672585846,1672589059,3213
3433,3890739241,3923754072,1672678530,1672681309,2779
3721,3309314379,3680843171,1672615337,1672618068,2731
3641,3231494505,3714185969,1672572644,1672576015,3371
3692,3778926763,3311085279,1672621876,1672625365,3489
3772,3517462308,3779938251,1672666982,1672668158,1176
3500,3715619259,3938503547,1672646436,1672649066,2630
3529,3518653080,3367971170,1672667054,1672668489,1435
3694,3510642075,3779786641,1672699709,1672701165,1456
3779,3757323954,3615688740,1672576255,1672578841,2586
3791,3904412440,3516444201,1672611831,1672614098,2267
3744,3452016771,3893912331,1672569555,1672569778,223
3460,3792389522,3686523546,1672610466,1672611549,1083
3582,3280268483,3608232640,1672696099,1672696300,201
3826,3617489344,3613338363,1672661732,1672662273,541
3623,3812534508,3892304880,1672624369,1672624829,460
3817,3517590837,3737972328,1672659347,1672660194,847
3910,3777485931,3811075491,1672543626,1672545311,1685
3524,3713911104,3279475486,1672587585,1672587760,175
3646,3608855425,3509483172,1672665720,1672668019,2299
3879,3500604680,3296462324,1672697907,1672699696,1789
3588,3623266256,3411688875,1672579069,1672582498,3429
3762,3615737355,3835985172,1672641168,1672641565,397
3690,3900898992,3519028898,1672634351,1672635995,1644
3707,3517172354,3711734586,1672636499,1672640033,3534
3596,3500044458,3512722110,1672636368,1672638683,2315
3630,3457960571,3513018485,1672600630,1672602059,1429
3783,3311420950,3454277788,1672575865,1672576030,165
3605,3756385685,3852686295,1672559010,1672562105,3095
3761,3337322736,3703396825,1672558664,1672559236,572
3837,3686227677,3384583385,1672609537,1672612598,3061
3430,3793883863,3336627643,1672596233,1672599824,3591
3552,3289114629,3970558632,1672668995,1672669912,917
3460,3492959689,3885537225,1672682991,1672683607,616
3657,3513081354,3436257398,1672676607,1672679366,2759
3497,3850911686,3399472693,1672540619,1672541296,677
3466,3379143440,3501567772,1672610089,1672613568,3479
3646,3501567772,3783340788,1672547339,1672550235,2896
3692,3826238375,3362641275,1672648162,1672651611,3449
3797,3793969543,3500613459,1672701514,1672704271,2757
3676,3380130228,3736705719,1672598506,1672598720,214
3427,3710008361,3668414677,1672692168,1672692486,318
3732,3236354255,3732584121,1672638938,1672641220,2282
3656,3347419520,3755756564,1672623245,1672624096,851
3635,3225631197,3780909839,1672657314,1672659284,1970
3618,3291933594,3509893027,1672593364,1672593743,379
3880,3701823816,3510499038,1672687326,1672688695,1369
3745,3777189898,3375449013,1672679287,1672680749,1462
3495,3404025196,3488686442,1672575130,1672577574,2444
3731,3755573472,3889780657,1672614433,1672617529,3096
3442,3500341755,3371455553,1672557321,1672559221,1900
3677,3755344363,3814677862,1672534581,1672537711,3130
3596,3757348722,3285204083,1672567388,1672568535,1147
3541,3610358027,3520416075,1672597053,1672598920,1867
3564,3773913680,3792274796,1672621732,1672624661,2929
3682,3414275042,3739895284,1672592420,1672594415,1995
3886,3475349791,3350095157,1672694451,1672696079,1628
3886,3783373154,3880926355,1672687344,1672687970,626
3443,3452016771,3604867757,1672660562,1672661485,923
3917,3734118023,3979802715,1672588652,1672590943,2291
3466,3513081354,3930242012,1672677508,1672677731,223
3834,3756746867,3930242012,1672534862,1672535786,924
3463,3533274994,3501786419,1672639027,1672639775,748
3670,3619922891,3906536154,1672605699,1672608275,2576
3740,3779738691,3932478321,1672540436,1672541790,1354
3546,3513345163,3376467719,1672699675,1672701808,2133
3514,3505481368,3279339278,1672666002,1672666168,166
3496,3783373154,3511442562,1672626285,1672629396,3111
3429,3362641275,3779532653,1672678143,1672681227,3084
3907,3923220461,3274906650,1672688026,1672688969,943
3461,3915162005,3774605761,1672587937,1672589022,1085
3539,3833217041,3505437712,1672622443,1672623157,714
3813,3622357348,3271454397,1672656432,1672658112,1680
3582,3779854934,3680810086,1672643479,1672646438,2959
3777,3480490124,3389634034,1672568233,1672569593,1360
3655,3793583656,3711000597,1672536757,1672537820,1063
3513,3977148669,3912891315,1672601711,1672603797,2086
3827,3735374579,3755496114,1672537831,1672540322,2491
3856,3609933747,3520873221,1672668496,1672671344,2848
3497,3716679950,3224330592,1672698871,1672702116,3245
3842,3505198734,3306412634,1672680664,1672682487,1823
3727,3783615982,3755737419,1672610529,1672613027,2498
3554,3774243020,3774705415,1672594069,1672595259,1190
3729,3711077927,3227799827,1672627907,1672629598,1691
3542,3225636215,3511150845,1672535043,1672538306,3263
3724,3757332128,3279475486,1672634313,1672636386,2073
3642,3515439826,3398198430,1672560121,1672560976,855
3562,3902760230,3373028638,1672609212,1672610538,1326
3532,3505481368,3330340793,1672559172,1672560110,938
3464,3703348097,3505198734,1672540233,1672541256,1023
3712,3370227921,3533188828,1672601273,1672602867,1594
3872,3334647380,3776559988,1672599604,1672602767,3163
3488,3364378127,3791693821,1672587122,1672590471,3349
3839,3501281016,3500442734,1672603011,1672606054,3043
3622,3665998641,3811040565,1672567992,1672570292,2300
3737,3756789525,3280268483,1672664831,1672666674,1843
3725,3500777439,3927165965,1672682231,1672683198,967
3845,3516513251,3451726367,1672701773,1672703966,2193
3594,3347446226,3519142371,1672680211,1672682168,1957
3635,3779465522,3713691388,1672689488,1672690318,830
3673,3400069268,3500613493,1672576978,1672577624,646
3792,3834960360,3755848152,1672592199,1672592716,517
3482,3792489602,3512882178,1672619501,1672620315,814
3804,3905196766,3607768197,1672674041,1672677488,3447
3563,3756704774,3438489358,1672626064,1672626882,818
3795,3774178201,3236458894,1672598547,1672601602,3055
3751,3370227921,3755756564,1672657494,1672658669,1175
3451,3734451191,3825881598,1672537522,1672539397,1875
3789,3773837847,3513081354,1672691723,1672692409,686
3617,3927599181,3428027649,1672650328,1672653742,3414
3542,3927599181,3701823816,1672550755,1672553174,2419
3808,3374183227,3449639012,1672572079,1672574639,2560
3879,3514512367,3615087943,1672677830,1672680541,2711
3763,3500498112,3793743698,1672608638,1672610167,1529
3492,3972192593,3470454332,1672613688,1672616837,3149
3775,3783136330,3617304541,1672561101,1672563667,2566
3708,3509483172,3518561777,1672674995,1672676204,1209
3484,3716963089,3276003502,1672551620,1672551851,231
3816,3401496246,3410538749,1672640486,1672642966,2480
3887,3403370192,3202804048,1672592411,1672593489,1078
3586,3501457103,3715086894,1672584815,1672588004,3189
3619,3714233826,3893912331,1672632305,1672633227,922
3752,3852686295,3431502855,1672538756,1672538827,71
3680,3803389195,3793740407,1672618364,1672621846,3482
3475,3492959689,3226178937,1672550867,1672550939,72
3749,3615688740,3357864626,1672673307,1672674346,1039
3540,3513360004,3780322355,1672635130,1672636687,1557
3497,3480490124,3792949946,1672638405,1672641065,2660
3697,3414049538,3451726367,1672698968,1672701512,2544
3862,3776831527,3833217041,1672612503,1672613438,935
3469,3792505974,3304155815,1672693995,1672696531,2536
3492,3512499658,3824215187,1672576171,1672576935,764
3913,3711097754,3615737355,1672577424,1672577486,62
3740,3661447322,3519282716,1672567479,1672570249,2770
3909,3631479562,3501525100,1672637358,1672637934,576
3649,3783801141,3330340793,1672644416,1672646176,1760
3738,3716628503,3533079336,1672651379,1672652876,1497
3729,3272716462,3244004456,1672544708,1672547270,2562
3434,3630353876,3417191856,1672635259,1672637845,2586
3509,3839245934,3773121782,1672550400,1672551448,1048
3539,3783550022,3351696332,1672568909,1672569245,336
3695,3467988782,3337322736,1672578151,1672580263,2112
3655,3739154408,3534179433,1672587643,1672587771,128
3771,3905899155,3515559913,1672539985,1672540217,232
3662,3783615982,3711097754,1672547074,1672549219,2145
3433,3756704774,3362641275,1672681904,1672684522,2618
3520,3449639012,3791106564,1672614981,1672615637,656
3572,3730071479,3714185969,1672684745,1672685734,989
3895,3778040015,3505198734,1672683645,1672686691,3046
3440,3336627643,3607882826,1672633965,1672636207,2242
3900,3402697190,3638204468,1672664812,1672667727,2915
3916,3853629553,3505663516,1672561138,1672562873,1735
3777,3618697021,3512502036,1672553838,1672555507,1669
3736,3467988782,3791128487,1672652854,1672654127,1273
3615,3273981374,3457960571,1672681139,1672682337,1198
3506,3770438122,3839245934,1672608559,1672611933,3374
3428,3368283077,3776988674,1672669104,1672671139,2035
3732,3791753345,3607882826,1672696308,1672698446,2138
3441,3533090502,3622357348,1672582923,1672584986,2063
3843,3777147510,3835422146,1672570423,1672572086,1663
3763,3519850727,3436257398,1672537674,1672539808,2134
3505,3770676872,3505521218,1672671177,1672672905,1728
3671,3520873221,3733363628,1672537741,1672539197,1456
3478,3308760650,3512722110,1672583601,1672586697,3096
3877,3714120857,3680810086,1672630981,1672633678,2697
3752,3792525861,3850911686,1672537482,1672541010,3528
3603,3451726367,3713784974,1672643358,1672644931,1573
3917,3512337405,3408430195,1672680662,1672683012,2350
3501,3780571086,3511317276,1672613959,1672616622,2663
3642,3755848152,3519077659,1672689920,1672691542,1622
3481,3510499038,3926643445,1672611030,1672613593,2563
3569,3927165965,3468041839,1672655867,1672658152,2285
3637,3518561777,3715619259,1672547792,1672551319,3527
3815,3928719932,3793175445,1672535734,1672536913,1179
3767,3505179890,3533649454,1672657365,1672658665,1300
3672,3300818269,3462273042,1672549501,1672552303,2802
3543,3770146716,3500302272,1672614691,1672616398,1707
3737,3511024016,3505481368,1672546182,1672547984,1802
3482,3618697021,3501121099,1672563512,1672566159,2647
3734,3284947372,3710048469,1672687488,1672689028,1540
3581,3608855425,3470454332,1672650041,1672651355,1314
3630,3518229776,3923220461,1672685312,1672687171,1859
3479,3770296583,3510499038,1672537176,1672538392,1216
3838,3533368789,3337362061,1672666962,1672668411,1449
3715,3755992176,3283144118,1672622067,1672622917,850
3472,3638660068,3200543880,1672625789,1672626379,590
3433,3736705719,3501281016,1672554744,1672555370,626
3869,3635169815,3780872464,1672615699,1672617509,1810
3807,3510187271,3793868716,1672559920,1672562079,2159
3784,3387594369,3515402792,1672577221,1672580394,3173
3785,3715443333,3500044458,1672690891,1672691980,1089
3734,3604867757,3514285803,1672598198,1672600637,2439
3764,3683113954,3517590837,1672671277,1672672713,1436
3665,3713941638,3755915206,1672647724,1672650279,2555
3639,3779301501,3509366311,1672535680,1672537959,2279
3739,3534764451,3480490124,1672567313,1672568160,847
3686,3636329663,3512830734,1672545070,1672547090,2020
3906,3930242012,3774733620,1672605173,1672608529,3356
3631,3394297564,3792389522,1672553152,1672556307,3155
3755,3443357683,3492546679,1672649405,1672652302,2897
3863,3715400486,3362641275,1672578189,1672578329,140
3634,3779938251,3684523966,1672572745,1672573510,765
3750,3802932312,3520578796,1672660563,1672662581,2018
3427,3510499038,3791128487,1672617877,1672619675,1798
3558,3609881958,3512502036,1672585016,1672585738,722
3860,3401496246,3511883730,1672671342,1672672676,1334
3469,3516903528,3509893027,1672692727,1672693892,1165
3789,3770624662,3777624586,1672552768,1672555115,2347
3732,3824641227,3403370192,1672643822,1672647014,3192
3747,3777147510,3311085279,1672644925,1672645384,459
3468,3791796585,3773572967,1672624728,1672627727,2999
3461,3510028805,3791753345,1672682397,1672683154,757
3807,3711919537,3467779445,1672563285,1672566356,3071
3723,3793418209,3230868435,1672651807,1672655027,3220
3643,3974674109,3773332082,1672571572,1672571635,63
3535,3701136026,3777091903,1672631129,1672633602,2473
3911,3783919913,3450286949,1672592146,1672595256,3110
3666,3783373154,3898314440,1672678514,1672680113,1599
3744,3701884158,3500827202,1672563002,1672565350,2348
3708,3755230952,3336339664,1672606635,1672607701,1066
3499,3902861231,3618808151,1672599259,1672602167,2908
3549,3609933747,3715707380,1672598370,1672598918,548
3473,3904867554,3334974375,1672569519,1672571172,1653
3798,3410160376,3613581796,1672610787,1672613911,3124
3834,3206837348,3760362417,1672660992,1672661760,768
3714,3609659642,3230135532,1672689776,1672692434,2658
3785,3824215187,3374183227,1672694759,1672696274,1515
3915,3512502036,3513296868,1672575789,1672577533,1744
3736,3311498666,3733558985,1672648220,1672649663,1443
3741,3414049538,3713517039,1672597959,1672599591,1632
3834,3343816795,3755404116,1672620935,1672621835,900
3454,3520873221,3534829213,1672577217,1672580558,3341
3634,3514285803,3714670620,1672569578,1672569772,194
3720,3519909393,3977148669,1672639405,1672642009,2604
3633,3500777439,3777779869,1672694118,1672697178,3060
3621,3770520359,3364726656,1672614345,1672615989,1644
3831,3402697190,3399518841,1672583305,1672584877,1572
3806,3316798920,3305722859,1672534468,1672536342,1874
3851,3520416075,3495911207,1672565198,1672568426,3228
3613,3534126409,3513410578,1672553773,1672555465,1692
3829,3792274796,3755065949,1672559607,1672559802,195
3780,3338083680,3661583097,1672604020,1672605423,1403
3810,3224330592,3396726504,1672552608,1672553249,641
3759,3739895284,3497671225,1672662063,1672664768,2705
3831,3396726504,3760645796,1672546496,1672549861,3365
3460,3500613493,3715127070,1672560337,1672562892,2555
3892,3760924079,3392520516,1672657105,1672658216,1111
3869,3280054198,3500949309,1672677138,1672679424,2286
3561,3715127070,3343816795,1672671337,1672674631,3294
3911,3927403123,3780872464,1672671475,1672673118,1643
3783,3480100311,3400069268,1672613668,1672614081,413
3580,3779786641,3505111292,1672547940,1672549329,1389
3627,3519446663,3225636215,1672665262,1672665493,231
3476,3520578796,3737972328,1672546260,1672548074,1814
3714,3631479562,3737972328,1672574675,1672575660,985
3549,3449639012,3509764635,1672605072,1672607707,2635
3562,3241790910,3435167810,1672648660,1672649363,703
3859,3621184108,3610870949,1672533629,1672534051,422
3445,3780712350,3231494505,1672556592,1672559114,2522
3633,3891672228,3467988782,1672542830,1672543209,379
3455,3337362061,3935399379,1672597286,1672600509,3223
3766,3739661856,3246370118,1672658335,1672660923,2588
3909,3501384020,3517172354,1672690048,1672692826,2778
3522,3608922867,3336339664,1672659040,1672661062,2022
3689,3273981374,3623266256,1672617413,1672619584,2171
3778,3714185969,3773033649,1672569758,1672571562,1804
3494,3632814465,3774290799,1672606308,1672608063,1755
3447,3404025196,3467779445,1672553827,1672555536,1709
3670,3755756564,3501459390,1672653965,1672656768,2803
3562,3890739241,3972192593,1672679780,1672680162,382
3660,3201676087,3688220326,1672631730,1672634694,2964
3846,3200543880,3711919537,1672558506,1672559822,1316
3678,3737112297,3703396825,1672677941,1672678807,866
3813,3772078494,3755915206,1672562022,1672564966,2944
3666,3783919913,3308760650,1672590835,1672591537,702
3714,3818575661,3363162590,1672556729,1672559394,2665
3641,3520560590,3505807416,1672674121,1672674893,772
3495,3390660440,3513065217,1672565079,1672567105,2026
3560,3480490124,3392520516,1672676425,1672678455,2030
3628,3783771827,3512800570,1672600322,1672602895,2573
3427,3364378127,3757318448,1672558105,1672561500,3395
3861,3760694096,3520873221,1672578716,1672581045,2329
3619,3519028898,3380982774,1672628188,1672630061,1873
3714,3511442562,3715127070,1672591048,1672593228,2180
3920,3374183227,3513853403,1672531404,1672534253,2849
3598,3519028898,3241914067,1672578565,1672579677,1112
3783,3934064792,3777624586,1672562795,1672566016,3221
3483,3774705415,3661903000,1672657817,1672658922,1105
3454,3755848152,3783433404,1672575442,1672576852,1410
3888,3500709774,3610358027,1672656403,1672658136,1733
3831,3715086894,3902760230,1672592556,1672592654,98
3642,3520560590,3774243020,1672555429,1672557657,2228
3911,3923420131,3303410628,1672697183,1672700674,3491
3822,3730071479,3774155692,1672643829,1672644926,1097
3650,3885157459,3517737088,1672653237,1672656789,3552
3562,3241914067,3714185969,1672583994,1672585256,1262
3854,3334647380,3534566651,1672622437,1672623344,907
3467,3970198861,3374183227,1672636071,1672637854,1783
3770,3226511603,3343132529,1672663898,1672667490,3592
3579,3517590837,3421385957,1672688796,1672689649,853
3637,3609113156,3412006598,1672584676,1672585983,1307
3895,3826238375,3514512367,1672567710,1672570277,2567
3896,3533649454,3802932312,1672688682,1672691588,2906
3902,3815392801,3505725706,1672617306,1672617918,612
3676,3395201292,3710489491,1672619919,1672620575,656
3554,3375449013,3520322124,1672569288,1672572511,3223
3772,3777189898,3780712350,1672629424,1672629965,541
3585,3394297564,3773124276,1672632237,1672633846,1609
3497,3304155815,3510642075,1672678750,1672681953,3203
3472,3734915241,3399472693,1672556317,1672558285,1968
3831,3852686295,3780427126,1672542071,1672544797,2726
3637,3715854030,3713691388,1672623457,1672626808,3351
3495,3777814504,3777330107,1672701674,1672702042,368
3445,3334951866,3615939504,1672686165,1672689268,3103
3617,3979784676,3612689556,1672582586,1672583778,1192
3818,3500442734,3711097754,1672620497,1672621898,1401
3713,3517600136,3300229945,1672620220,1672621118,898
3750,3499217428,3776831527,1672702023,1672703007,984
3755,3283144118,3385323994,1672666037,1672667520,1483
3787,3703433819,3533649454,1672615570,1672617990,2420
3742,3429943738,3380767040,1672587005,1672589078,2073
3649,3783919913,3834960360,1672650872,1672653513,2641
3521,3449333754,3280054198,1672587296,1672589340,2044
3847,3619922891,3519818818,1672664871,1672665082,211
3617,3519446663,3618808151,1672539053,1672539593,540
3545,3511601997,3613416045,1672658514,1672661689,3175
3726,3934064792,3431502855,1672623631,1672624011,380
3751,3760263530,3224330592,1672598977,1672599048,71
3825,3779738691,3661447322,1672545754,1672548514,2760
3666,3395201292,3512379024,1672637176,1672638264,1088
3602,3516489668,3757903168,1672636009,1672636839,830
3669,3617116290,3510798825,1672650630,1672654051,3421
3506,3779465522,3515401243,1672641143,1672642076,933
3760,3661583097,3736705719,1672669079,1672671988,2909
3832,3239617320,3755532873,1672576596,1672578325,1729
3577,3240394404,3412006598,1672665552,1672668790,3238
3823,3617489344,3363162590,1672645109,1672647097,1988
3873,3632814465,3814305099,1672563027,1672565653,2626
3760,3713589994,3467988782,1672584403,1672585922,1519
3544,3887243870,3779465522,1672678180,1672680850,2670
3604,3792745809,3637313265,1672618981,1672621756,2775
3424,3793315718,3392520516,1672532903,1672535647,2744
3692,3711097754,3623266256,1672544770,1672545025,255
3736,3760721303,3904569677,1672660794,1672663123,2329
3437,3501281016,3417679834,1672583724,1672583880,156
3896,3283492940,3510919821,1672542109,1672543496,1387
3721,3791753345,3505179890,1672605130,1672607260,2130
3709,3515466096,3231494505,1672663721,1672666035,2314
3716,3783340788,3774641380,1672619118,1672620311,1193
3731,3457620713,3688220326,1672645045,1672646099,1054
3843,3737972328,3311049964,1672555141,1672555270,129
3859,3519818818,3509764635,1672623734,1672626420,2686
3639,3512958459,3667427125,1672566976,1672569321,2345
3699,3362641275,3518653080,1672578546,1672579972,1426
3870,3734451191,3736705719,1672698946,1672701067,2121
3588,3930242012,3517887477,1672683016,1672686038,3022
3628,3834631333,3783373154,1672665237,1672666449,1212
3670,3533079336,3713784974,1672559148,1672560301,1153
3434,3517887477,3701322924,1672650268,1672652585,2317
3794,3778667336,3410600350,1672662966,1672664149,1183
3479,3885157459,3520639768,1672602434,1672603039,605
3543,3554944414,3778040015,1672662493,1672663686,1193
3844,3793315718,3683113954,1672615793,1672617888,2095
3888,3394401087,3927599181,1672612917,1672614173,1256
3693,3396980894,3500442734,1672618066,1672621023,2957
3791,3500109249,3505266860,1672682068,1672682980,912
3796,3714666884,3349856820,1672688369,1672691230,2861
3528,3280268483,3898314440,1672572461,1672575668,3207
3796,3501786419,3970198861,1672532281,1672534928,2647
3866,3414275042,3431460073,1672580039,1672581483,1444
3594,3305722859,3780909839,1672664333,1672666279,1946
3855,3517172354,3770438122,1672584082,1672585466,1384
3863,3808136029,3276348699,1672693939,1672696256,2317
3488,3414049538,3399518841,1672551959,1672552336,377
3700,3479851674,3241790910,1672583249,1672585921,2672
3772,3456430614,3711006062,1672676694,1672678477,1783
3630,3812369928,3462273042,1672603591,1672605927,2336
3480,3270697740,3760651515,1672539749,1672541998,2249
3479,3792389522,3393063657,1672665661,1672666485,824
3909,3512282789,3500827202,1672575131,1672578546,3415
3742,3338390596,3393063657,1672631800,1672633940,2140
3798,3448633776,3500857494,1672701180,1672701879,699
3546,3608922867,3777240360,1672549856,1672551388,1532
3894,3600876425,3783433404,1672546035,1672548431,2396
3875,3713163045,3711097754,1672575320,1672578455,3135
3753,3902760230,3760651515,1672677080,1672680517,3437
3896,3436257398,3457620713,1672691995,1672692731,736
3743,3630353876,3513018485,1672628004,1672630707,2703
3893,3533747868,3236499444,1672649254,1672650005,751
3809,3517222913,3716963089,1672546031,1672546982,951
3791,3367971170,3533423872,1672670827,1672671035,208
3426,3770146716,3756625818,1672698982,1672700499,1517
3564,3714067076,3811040565,1672567817,1672568190,373
3875,3500442734,3392520516,1672559729,1672561736,2007
3742,3783147088,3808136029,1672644947,1672646368,1421
3798,3205923620,3500613459,1672588668,1672590945,2277
3692,3513018485,3534764451,1672539018,1672540470,1452
3731,3516298579,3384583385,1672629692,1672630179,487
3899,3515466096,3512958459,1672551086,1672553967,2881
3570,3668533536,3500498112,1672573013,1672574109,1096
3773,3732584121,3756474459,1672562286,1672565343,3057
3768,3311498666,3398198430,1672604925,1672606490,1565
3433,3613581796,3715086894,1672557032,1672557932,900
3546,3776034743,3792801638,1672679752,1672680020,268
3597,3400069268,3534829213,1672561546,1672561828,282
3441,3714128600,3375449013,1672696346,1672696458,112
3729,3380982774,3510641433,1672599055,1672599397,342
3866,3715854030,3439673892,1672677465,1672680103,2638
3614,3511288998,3834960360,1672699390,1672701345,1955
3841,3517222913,3520764926,1672596700,1672599583,2883
3433,3457960571,3776244398,1672591309,1672592395,1086
3780,3858172636,3710008361,1672679975,1672680715,740
3692,3779613523,3791441520,1672533558,1672535380,1822
3491,3276348699,3462273042,1672620178,1672622942,2764
3801,3612689556,3701823816,1672595893,1672597925,2032
3745,3292147449,3774031303,1672548285,1672549089,804
3883,3715974659,3305722859,1672621168,1672621586,418
3464,3520578796,3779738691,1672561060,1672562916,1856
3649,3755496114,3852533643,1672546733,1672547710,977
3546,3467779445,3756704774,1672588567,1672591708,3141
3762,3772765746,3472068734,1672602453,1672605163,2710
3453,3206837348,3518565331,1672593415,1672596795,3380
3508,3703433819,3713768950,1672654546,1672656545,1999
3778,3500841914,3734451191,1672672088,1672672499,411
3845,3792014516,3834960360,1672571166,1672571690,524
3545,3777330107,3557046880,1672542546,1672543615,1069
3545,3511883730,3783928182,1672649318,1672650663,1345
3922,3792274796,3495911207,1672694209,1672695996,1787
3740,3305336154,3500737582,1672633868,1672634479,611
3859,3488763230,3501457103,1672687178,1672690448,3270
3499,3609113156,3500317969,1672553440,1672554705,1265
3725,3773121782,3638204468,1672549337,1672550847,1510
3830,3245232284,3793583656,1672694244,1672697432,3188
3783,3517172354,3357689359,1672702157,1672703308,1151
3811,3501121099,3760263530,1672548293,1672548713,420
3763,3501457103,3834631333,1672563738,1672566990,3252
3744,3624297844,3462158237,1672687466,1672690139,2673
3564,3608855425,3779656423,1672606507,1672609801,3294
3666,3713829743,3428027649,1672581832,1672582742,910
3837,3202141727,3891672228,1672652318,1672652410,92
3533,3756746867,3638204468,1672591067,1672592739,1672
3650,3357289672,3245232284,1672536061,1672536389,328
3900,3631090677,3757903168,1672618053,1672620676,2623
3675,3773124276,3979784676,1672677121,1672677324,203
3617,3715545685,3511601997,1672599913,1672603472,3559
3436,3613338363,3480490124,1672585321,1672587392,2071
3652,3385323994,3716110860,1672569443,1672571674,2231
3632,3621184108,3514334067,1672631067,1672631379,312
3542,3791246640,3773939399,1672533362,1672535922,2560
3746,3485540729,3201629017,1672585834,1672586262,428
3463,3835985172,3780115155,1672624065,1672625451,1386
3657,3927403123,3364378127,1672542616,1672545936,3320
3860,3404025196,3819767045,1672691054,1672692359,1305
3783,3609659642,3783641602,1672570804,1672574203,3399
3778,3411515369,3710496785,1672532659,1672533749,1090
3503,3203538212,3272030610,1672640560,1672640695,135
3445,3390660440,3779786641,1672602616,1672605096,2480
3583,3779646172,3244004456,1672674011,1672677126,3115
3430,3802932312,3778926763,1672649331,1672651064,1733
3707,3688220326,3760362417,1672619507,1672621126,1619
3743,3511732493,3755344363,1672552077,1672552733,656
3752,3510818674,3412968120,1672538089,1672538910,821
3585,3505725706,3492959689,1672572519,1672576057,3538
3883,3513296868,3780115155,1672626411,1672627720,1309
3580,3912891315,3516513251,1672678535,1672681357,2822
3524,3511601997,3711077927,1672699621,1672702910,3289
3778,3360616538,3552824113,1672615494,1672617020,1526
3794,3711097754,3240994288,1672569334,1672572553,3219
3863,3441703884,3823084403,1672548463,1672551967,3504
3856,3505179890,3714067076,1672624776,1672626188,1412
3511,3972192593,3226024417,1672606136,1672606902,766
3876,3975717896,3202804048,1672531231,1672533823,2592
3689,3441348818,3338083680,1672605265,1672605795,530
3427,3512383699,3371455553,1672600851,1672602327,1476
3784,3610870949,3780253901,1672553427,1672556228,2801
3872,3511150845,3701373490,1672551922,1672552715,793
3846,3615113018,3410600350,1672698316,1672698713,397
3440,3500915908,3970909253,1672587205,1672590244,3039
3606,3449333754,3410160376,1672578973,1672582180,3207
3435,3510964997,3291933594,1672606911,1672608306,1395
3775,3454277788,3701882224,1672622673,1672623508,835
3807,3512383699,3770468980,1672696182,1672699736,3554
3891,3608855425,3793922324,1672634316,1672636683,2367
3701,3777091903,3554944414,1672606466,1672607733,1267
3814,3824641227,3511732493,1672684705,1672686185,1480
3583,3906536154,3773009828,1672656530,1672659202,2672
3699,3451726367,3701884158,1672541350,1672544598,3248
3538,3777814504,3714233826,1672550818,1672554110,3292
3448,3710562338,3308760650,1672537722,1672540566,2844
3641,3780322355,3897376951,1672619552,1672620314,762
3741,3518565331,3779532653,1672625783,1672626477,694
3655,3519416013,3783163143,1672536975,1672540270,3295
3733,3900898992,3925979970,1672634057,1672636881,2824
3761,3505266860,3228888030,1672551844,1672552239,395
3815,3360616538,3510798825,1672696269,1672699602,3333
3806,3977148669,3780115155,1672641781,1672643037,1256
3780,3500703304,3835422146,1672552205,1672553877,1672
3608,3468041839,3791106564,1672541736,1672544248,2512
3691,3273981374,3513360004,1672653191,1672656289,3098
3864,3334647380,3357689359,1672671626,1672673106,1480
3856,3688796737,3410600350,1672684557,1672687531,2974
3499,3203538212,3792546035,1672620377,1672623709,3332
3497,3533423872,3511150845,1672538405,1672539763,1358
3747,3835985172,3774907131,1672605866,1672606277,411
3643,3334647380,3515466096,1672685825,1672687415,1590
3731,3621683102,3773735484,1672547147,1672548401,1254
3671,3756746867,3370227921,1672646521,1672649805,3284
3866,3468041839,3777189898,1672672925,1672673072,147
3853,3351866415,3660063072,1672678158,1672679952,1794
3516,3716272919,3793418209,1672535162,1672536980,1818
3709,3510767239,3772236797,1672555727,1672556159,432
3694,3533929349,3375449013,1672664375,1672666679,2304
3860,3493017654,3513410578,1672604945,1672606231,1286
3482,3613416045,3760640999,1672688605,1672688819,214
3916,3716963089,3205985903,1672629401,1672632833,3432
3544,3516298579,3533649454,1672535118,1672537771,2653
3499,3757332128,3783163143,1672537651,1672538111,460
3543,3467779445,3511732493,1672655621,1672657602,1981
3658,3811075491,3701424609,1672597625,1672600756,3131
3851,3776084820,3885155975,1672654622,1672656284,1662
3884,3516444201,3534175249,1672563729,1672566105,2376
3601,3500498112,3737147209,1672566861,1672569747,2886
3573,3703383853,3701373490,1672643503,1672644980,1477
3594,3511601997,3773735484,1672700313,1672701927,1614
3436,3305722859,3780712350,1672666484,1672666902,418
3519,3450286949,3834960360,1672661589,1672664264,2675
3573,3703798634,3757383891,1672612918,1672615796,2878
3639,3776034743,3619922891,1672644251,1672645468,1217
3581,3773009828,3731646673,1672574034,1672577085,3051
3712,3230135532,3438489358,1672545542,1672545713,171
3582,3513345163,3756385685,1672689052,1672691885,2833
3438,3703433819,3513410578,1672550505,1672551847,1342
3664,3479851674,3449333754,1672650493,1672653054,2561
3910,3774790271,3921648519,1672567877,1672569642,1765
3795,3760651515,3928719932,1672598936,1672600590,1654
3866,3292147449,3713911104,1672669833,1672673350,3517
3718,3895285664,3923420131,1672639402,1672640919,1517
3555,3505179890,3336339664,1672582805,1672585775,2970
3448,3760721303,3625463628,1672626219,1672627559,1340
3434,3520181148,3824215187,1672671959,1672675280,3321
3830,3760263530,3512337405,1672616804,1672617813,1009
3857,3515439826,3478114114,1672684851,1672687072,2221
3583,3520639768,3904867554,1672568053,1672570646,2593
3737,3338390596,3714233826,1672543290,1672543802,512
3475,3902760230,3230135532,1672701317,1672704601,3284
3628,3303410628,3336627643,1672537098,1672538185,1087
3475,3970558632,3500044458,1672641464,1672642953,1489
3857,3515439826,3367509761,1672534544,1672537928,3384
3537,3230135532,3715127070,1672619335,1672621871,2536
3775,3733558985,3906536154,1672569197,1672570806,1609
3637,3519818818,3462273042,1672700083,1672702295,2212
3670,3757348722,3347446226,1672610317,1672612339,2022
3735,3445206685,3451726367,1672642999,1672645654,2655
3791,3685816610,3385323994,1672678008,1672679413,1405
3649,3497671225,3305722859,1672579774,1672581044,1270
3586,3500044458,3501525100,1672630359,1672632542,2183
3703,3680810086,3776559988,1672639607,1672642778,3171
3816,3777189898,3772236797,1672686662,1672688215,1553
3686,3505283390,3604589802,1672606184,1672609436,3252
3594,3689697817,3791106564,1672684240,1672686059,1819
3915,3518653080,3793969543,1672641883,1672645265,3382
3810,3556969573,3505725706,1672632023,1672634506,2483
3511,3772391882,3510554314,1672567214,1672568071,857
3721,3516903528,3501281016,1672569073,1672570882,1809
3810,3688220326,3505634634,1672617306,1672618915,1609
3586,3240394404,3414049538,1672693549,1672696308,2759
3565,3714827719,3386758279,1672606394,1672608877,2483
3668,3520560590,3492959689,1672624984,1672626970,1986
3534,3209526819,3296462324,1672587974,1672589170,1196
3827,3639050419,3735374579,1672648592,1672649979,1387
3700,3617116290,3898314440,1672692195,1672693669,1474
3795,3364726656,3382733096,1672595621,1672596793,1172
3537,3410538749,3773124276,1672566687,1672567573,886
3604,3505437712,3520578796,1672669834,1672672968,3134
3481,3618697021,3778899160,1672606695,1672608231,1536
3492,3520764926,3792525861,1672596553,1672598719,2166
3785,3773027597,3437286517,1672631922,1672633850,1928
3685,3774290799,3680810086,1672677348,1672677591,243
3765,3812369928,3737112297,1672583731,1672584612,881
3427,3755404116,3441348818,1672691445,1672692611,1166
3715,3716628503,3513327337,1672552258,1672552623,365
3599,3554186380,3683113954,1672618781,1672622363,3582
3738,3443357683,3604867757,1672549689,1672553029,3340
3655,3226024417,3618808151,1672565201,1672565838,637
3617,3429943738,3773027597,1672697590,1672699170,1580
3845,3895285664,3338390596,1672598529,1672600533,2004
3517,3776244398,3505923418,1672629804,1672632788,2984
3655,3609881958,3923220461,1672703287,1672704119,832
3547,3500317969,3244004456,1672613285,1672614077,792
3515,3777330107,3421385957,1672658275,1672660866,2591
3852,3774155692,3780680950,1672662231,1672664158,1927
3563,3793418209,3514703118,1672623456,1672625807,2351
3616,3501121099,3975717896,1672550827,1672552747,1920
3718,3621461051,3293835352,1672627286,1672627899,613
3568,3792505974,3792274796,1672624914,1672628163,3249
3462,3457620713,3715385401,1672670572,1672673729,3157
3455,3296462324,3513081354,1672563691,1672564427,736
3840,3773121782,3823084403,1672628525,1672631584,3059
3754,3404025196,3710562338,1672587015,1672589495,2480
3919,3463849738,3970558632,1672666997,1672667764,767
3460,3349739136,3501215099,1672651556,1672654238,2682
3787,3505725706,3238288884,1672541898,1672544061,2163
3488,3554186380,3757700712,1672665493,1672666197,704
3590,3488763230,3299125059,1672649525,1672652461,2936
3844,3226178937,3230135532,1672572207,1672572375,168
3731,3897134762,3533929349,1672672479,1672675168,2689
3529,3617392620,3460719322,1672560404,1672562098,1694
3736,3510818674,3392836218,1672563089,1672565018,1929
3532,3608855425,3716679950,1672540487,1672541922,1435
3751,3410600350,3970909253,1672599772,1672600757,985
3499,3472068734,3408498208,1672581688,1672582553,865
3750,3497095254,3777624586,1672541440,1672542705,1265
3485,3510187271,3516741440,1672568348,1672571075,2727
3434,3770236215,3739911441,1672603105,1672603622,517
3454,3380130228,3441703884,1672641436,1672642820,1384
3509,3383138270,3618489670,1672570088,1672573393,3305
3658,3756746867,3927403123,1672626952,1672629575,2623
3512,3714670620,3513296868,1672698338,1672700052,1714
3437,3343132529,3518229776,1672622911,1672623989,1078
3447,3229974066,3382733096,1672574902,1672577634,2732
3909,3456430614,3510554314,1672555255,1672558023,2768
3629,3291933594,3853629553,1672665275,1672667064,1789
3717,3451726367,3701136026,1672599791,1672602347,2556
3470,3519028898,3337362061,1672586780,1672590118,3338
3817,3445206685,3437286517,1672670170,1672670393,223
3624,3780769110,3607882826,1672533292,1672533497,205
3837,3778040015,3404025196,1672634635,1672635033,398
3589,3505663516,3512295534,1672607146,1672609924,2778
3539,3414275042,3757700712,1672561343,1672562053,710
3693,3299125059,3228888030,1672581241,1672582110,869
3510,3410538749,3500109249,1672678989,1672682523,3534
3550,3371455553,3533649454,1672627789,1672629975,2186
3496,3364378127,3617116290,1672570484,1672570890,406
3873,3227799827,3441348818,1672628279,1672628433,154
3456,3893912331,3505634634,1672543496,1672544605,1109
3881,3636329663,3505437712,1672571365,1672571583,218
3439,3852686295,3360069849,1672651131,1672654340,3209
3810,3436257398,3299125059,1672659109,1672661842,2733
3623,3779438325,3779938251,1672550120,1672551561,1441
3511,3511150845,3517358573,1672693260,1672694152,892
3455,3500857494,3856606678,1672612674,1672614526,1852
3573,3660063072,3791613604,1672556835,1672559151,2316
3483,3970627281,3511843593,1672650926,1672652869,1943
3619,3664943873,3451726367,1672643759,1672645176,1417
3431,3403370192,3305722859,1672627965,1672631081,3116
3870,3757323954,3825881598,1672545038,1672548512,3474
3477,3733558985,3514741348,1672685495,1672688749,3254
3584,3510187271,3380767040,1672604888,1672605444,556
3591,3500827202,3792389522,1672689876,1672693353,3477
3891,3488686442,3380767040,1672569382,1672572020,2638
3803,3783136330,3734118023,1672668987,1672672301,3314
3477,3778134418,3443357683,1672550813,1672554371,3558
3522,3689697817,3510818674,1672688067,1672689033,966
3514,3923220461,3829822608,1672592227,1672593315,1088
3922,3836241528,3457620713,1672700494,1672701259,765
3598,3893912331,3517600136,1672635908,1672639399,3491
3857,3920898925,3912891315,1672544957,1672547084,2127
3798,3713911104,3551389192,1672609683,1672610054,371
3893,3703139663,3834963772,1672634500,1672636545,2045
3894,3755756564,3520578796,1672623196,1672626356,3160
3897,3780909839,3480991549,1672644097,1672646078,1981
3526,3701664364,3402697190,1672607009,1672608554,1545
3873,3783136330,3511732493,1672551429,1672554954,3525
3472,3760694096,3680810086,1672575014,1672576169,1155
3921,3909094917,3500915908,1672702790,1672704015,1225
3778,3685816610,3416987084,1672681984,1672684504,2520
3462,3209481722,3556969573,1672547417,1672549950,2533
3458,3554825448,3776034743,1672647322,1672650482,3160
3557,3755496114,3517590837,1672625607,1672625738,131
3485,3515439826,3756385685,1672653896,1672654556,660
3772,3533368789,3773124276,1672588548,1672591558,3010
3911,3500072204,3970909253,1672534198,1672537653,3455
3471,3715443333,3357689359,1672680460,1672680714,254
3617,3534179433,3773332082,1672549519,1672552936,3417
3545,3636329663,3500915908,1672583374,1672584654,1280
3701,3928511283,3398198430,1672563039,1672566478,3439
3552,3226511603,3510499038,1672584757,1672585011,254
3741,3500317969,3778134418,1672542256,1672542439,183
3445,3382733096,3755404116,1672602386,1672603055,669
3533,3829822608,3778040015,1672693318,1672696575,3257
3768,3501281016,3793883863,1672700011,1672703032,3021
3563,3777814504,3637313265,1672686543,1672689228,2685
3501,3511150845,3417191856,1672583388,1672585260,1872
3711,3779854934,3792505974,1672612704,1672614288,1584
3590,3554825448,3448633776,1672648738,1672651205,2467
3910,3710562338,3803517637,1672595586,1672596535,949
3627,3517358573,3513295938,1672697084,1672697418,334
3730,3927165965,3401793306,1672625191,1672626363,1172
3585,3439673892,3902625986,1672643761,1672647086,3325
3456,3534126409,3633735593,1672663513,1672664280,767
3881,3205985903,3926643445,1672584090,1672585626,1536
3576,3623266256,3618176292,1672540509,1672542828,2319
3656,3923220461,3557046880,1672538188,1672538794,606
3757,3633735593,3505178849,1672588553,1672590715,2162
3767,3510642075,3661447322,1672679377,1672682183,2806
3579,3533228966,3625463628,1672693676,1672693908,232
3702,3792389522,3912891315,1672595013,1672595637,624
3745,3512958459,3509893027,1672601766,1672603708,1942
3545,3436257398,3668747074,1672554047,1672555612,1565
3918,3514818819,3501567772,1672534324,1672537295,2971
3532,3520873221,3533649454,1672635408,1672638247,2839
3799,3363162590,3780115155,1672673972,1672677269,3297
3898,3270042456,3778040015,1672595858,1672596473,615
3528,3856606678,3974674109,1672699849,1672700126,277
3438,3515890966,3500604680,1672547648,1672548300,652
3445,3439673892,3296462324,1672567601,1672569757,2156
3781,3490214516,3715545685,1672594609,1672594800,191
3430,3533368789,3315703693,1672615492,1672618312,2820
3447,3660063072,3350095157,1672619833,1672622021,2188
3467,3236458894,3977148669,1672556785,1672557819,1034
3819,3610870949,3438489358,1672570371,1672573460,3089
3843,3500841914,3513296868,1672675538,1672678582,3044
3448,3410160376,3311420950,1672616960,1672619596,2636
3434,3823084403,3902760230,1672634877,1672637298,2421
3814,3499217428,3487875183,1672670379,1672672865,2486
3607,3780322355,3779786641,1672633654,1672633920,266
3565,3814305099,3224330592,1672697045,1672699595,2550
3494,3417191856,3920898925,1672569723,1672571199,1476
3684,3336627643,3501215099,1672675103,1672678673,3570
3801,3885157459,3409114719,1672614894,1672615673,779
3460,3824641227,3605221116,1672548349,1672548592,243
3762,3424445495,3533929349,1672656190,1672656605,415
3781,3920625129,3604589802,1672571198,1672573668,2470
3720,3519651506,3534179433,1672578978,1672580330,1352
3486,3770520359,3551376095,1672626717,1672628613,1896
3670,3300818269,3783641602,1672547935,1672548910,975
3548,3897376951,3793935736,1672645021,1672646755,1734
3761,3310039260,3773124276,1672574732,1672574989,257
3538,3335694356,3711919537,1672665522,1672668087,2565
3596,3481640525,3757700712,1672586907,1672588690,1783
3790,3370068529,3283144118,1672618673,1672622166,3493
3816,3812534508,3501786419,1672665361,1672666472,1111
3827,3336339664,3367509761,1672576452,1672577659,1207
3875,3701884158,3500827202,1672612255,1672614722,2467
3748,3817813340,3533079336,1672677073,1672677892,819
3684,3604867757,3732131656,1672561859,1672562846,987
3892,3491684096,3711812325,1672703692,1672705999,2307
3489,3518561777,3380767040,1672612886,1672615457,2571
3501,3510767239,3780338697,1672620640,1672621427,787
3554,3299781901,3783641602,1672615509,1672617995,2486
3558,3551399764,3373028638,1672685310,1672687309,1999
3518,3770704999,3520115090,1672583726,1672584897,1171
3752,3279339278,3515401243,1672620518,1672620658,140
3474,3335694356,3818575661,1672554940,1672555187,247
3793,3316800320,3887243870,1672672583,1672672707,124
3656,3519282716,3300979975,1672657695,1672661271,3576
3753,3519651506,3977352557,1672684662,1672686037,1375
3823,3533929349,3739911441,1672685323,1672687110,1787
3856,3791246640,3793969543,1672644454,1672645647,1193
3571,3931627862,3778640261,1672693052,1672694201,1149
3845,3517991730,3792801638,1672590127,1672593720,3593
3658,3935487534,3716272919,1672553706,1672554654,948
3732,3904569677,3279339278,1672549512,1672552044,2532
3570,3770624662,3468041839,1672543788,1672544670,882
3910,3497808662,3431460073,1672585043,1672586640,1597
3648,3513295938,3311049964,1672638679,1672640699,2020
3591,3931627862,3772391882,1672617229,1672618362,1133
3457,3229974066,3912891315,1672660525,1672662948,2423
3533,3713691388,3398731252,1672616118,1672617636,1518
3758,3393063657,3711006062,1672629401,1672632545,3144
3625,3467988782,3431502855,1672683081,1672685255,2174
3852,3379143440,3618697021,1672589208,1672592323,3115
3589,3447514821,3777694660,1672586125,1672588025,1900
3650,3505807416,3757323954,1672699555,1672702402,2847
3759,3556969573,3739911441,1672665043,1672666318,1275
3630,3436257398,3926643445,1672576674,1672579070,2396
3454,3772236797,3518229776,1672551944,1672555211,3267
3430,3490214516,3715707380,1672619277,1672622255,2978
3771,3245232284,3615688740,1672560127,1672561123,996
3727,3509893027,3517687662,1672599152,1672600686,1534
3589,3505663516,3780571086,1672652170,1672652949,779
3564,3884596900,3772236797,1672560305,1672562732,2427
3722,3791436104,3631479562,1672695184,1672698740,3556
3640,3826238375,3760842815,1672633300,1672636669,3369
3702,3779425804,3304155815,1672654149,1672657556,3407
3627,3773939399,3755065949,1672625849,1672626527,678
3431,3757630221,3756127300,1672624487,1672627003,2516
3628,3774243020,3398198430,1672691874,1672695382,3508
3863,3505888598,3488686442,1672635926,1672637257,1331
3913,3274906650,3661903000,1672560327,1672560571,244
3806,3755230952,3633735593,1672560685,1672560867,182
3547,3614740489,3514818819,1672623046,1672625732,2686
3536,3534179433,3829822608,1672575921,1672579230,3309
3532,3226024417,3926643445,1672613683,1672614577,894
3536,3778134418,3515525630,1672578863,1672579885,1022
3571,3448875382,3792020993,1672668349,1672670279,1930
3432,3421877923,3300979975,1672656020,1672656446,426
3845,3713829743,3201676087,1672651810,1672654213,2403
3686,3779854934,3757075324,1672558022,1672559340,1318
3516,3501786419,3440137407,1672652104,1672653573,1469
3600,3500604680,3481640525,1672566895,1672569566,2671
3825,3714827719,3680810086,1672620083,1672620283,200
3796,3513296868,3776988674,1672646549,1672646816,267
3555,3533423872,3774790271,1672618582,1672621171,2589
3601,3500827202,3972083617,1672582329,1672585558,3229
3462,3448875382,3779892400,1672666287,1672668840,2553
3880,3300511067,3777091903,1672645371,1672645436,65
3847,3824641227,3622665543,1672538875,1672540795,1920
3919,3774290799,3668533536,1672543334,1672546882,3548
3718,3512499658,3777240360,1672590444,1672593927,3483
3793,3638204468,3780571086,1672626340,1672628169,1829
3600,3609881958,3905196766,1672633170,1672634973,1803
3684,3701884158,3713589994,1672702505,1672704831,2326
3881,3716110860,3513041785,1672636201,1672637425,1224
3730,3774790271,3777240360,1672649408,1672651010,1602
3836,3334993594,3505402439,1672644721,1672645240,519
3716,3770704999,3793583656,1672629628,1672630713,1085
3863,3688796737,3440137407,1672658771,1672661694,2923
3474,3241790910,3777184389,1672571017,1672574485,3468
3891,3703396825,3773033649,1672673674,1672674232,558
3645,3518653080,3452016771,1672580610,1672581769,1159
3833,3682133690,3661583097,1672692621,1672693204,583
3792,3610358027,3770146716,1672570310,1672572993,2683
3713,3711218296,3511791953,1672647789,1672649452,1663
3819,3239617320,3451326054,1672689051,1672690438,1387
3814,3319167958,3497671225,1672601322,1672601913,591
3834,3412968120,3774155692,1672604304,1672607398,3094
3492,3710854064,3905899155,1672542610,1672544202,1592
3451,3739911441,3713768950,1672693696,1672696266,2570
3797,3519087371,3885155975,1672650713,1672654196,3483
3429,3715707380,3389634034,1672585915,1672586622,707
3745,3778597171,3511601997,1672593853,1672596158,2305
3494,3495911207,3760651515,1672618356,1672619224,868
3502,3364726656,3859868849,1672607053,1672609979,2926
3608,3755230952,3756474459,1672689339,1672692645,3306
3818,3520560590,3737112297,1672549813,1672552494,2681
3565,3379143440,3280268483,1672585378,1672588447,3069
3708,3520355798,3834963772,1672683581,1672684168,587
3647,3517881647,3351866415,1672639517,1672642519,3002
3895,3772236797,3711637255,1672567284,1672569329,2045
3454,3343816795,3300818269,1672645469,1672645994,525
3783,3609933747,3285204083,1672558363,1672558916,553
3543,3500613459,3770520359,1672679665,1672681352,1687
3521,3311420950,3480490124,1672562535,1672564239,1704
3436,3928719932,3714670620,1672543615,1672543893,278
3679,3357864626,3279475486,1672556079,1672557241,1162
3676,3777091903,3386758279,1672691943,1672692145,202
3533,3505228454,3517887477,1672628424,1672629559,1135
3914,3715086894,3240394404,1672625423,1672627983,2560
3740,3533368789,3716679950,1672625871,1672629181,3310
3539,3375449013,3375449013,1672597025,1672597101,76
3609,3435167810,3923220461,1672546677,1672549101,2424
3427,3225631197,3626499450,1672619808,1672622978,3170
3509,3311085279,3520991398,1672623815,1672626829,3014
3654,3780472203,3299125059,1672644437,1672646815,2378
3858,3428725843,3315703693,1672700623,1672702143,1520
3682,3774290799,3757863420,1672570918,1672574208,3290
3545,3780209375,3226178937,1672673414,1672674423,1009
3432,3791046864,3776518452,1672584123,1672587372,3249
3607,3289817992,3772765746,1672595590,1672597368,1778
3624,3500317969,3510964997,1672657014,1672659907,2893
3430,3607882826,3792745809,1672583867,1672585774,1907
3907,3701424609,3373089838,1672666823,1672667412,589
3505,3448875382,3970909253,1672570270,1672573349,3079
3754,3231494505,3770438122,1672531381,1672532015,634
3443,3760651515,3505634634,1672671324,1672671431,107
3885,3519416013,3431502855,1672580303,1672583297,2994
3760,3703139663,3793418209,1672663491,1672666249,2758
3916,3460719322,3493017654,1672635829,1672636122,293
3626,3627368399,3369708250,1672614100,1672614201,101
3461,3514956366,3710562338,1672611409,1672613797,2388
3433,3711006062,3977352557,1672659417,1672661649,2232
3746,3514246749,3510818674,1672700157,1672702624,2467
3710,3270042456,3713911104,1672546382,1672548993,2611
3597,3711006062,3512958459,1672533516,1672534912,1396
3887,3905899155,3923754072,1672618556,1672621433,2877
3846,3777624586,3756127300,1672667508,1672668492,984
3515,3713517039,3272030610,1672622927,1672625200,2273
3465,3447672935,3970558632,1672658275,1672659598,1323
3478,3613899351,3514324011,1672684453,1672685535,1082
3578,3505402439,3613581796,1672593661,1672595649,1988
3841,3401496246,3770676872,1672538763,1672540919,2156
3854,3713517039,3513041785,1672688387,1672689764,1377
3588,3402385957,3513018485,1672629389,1672630695,1306
3870,3817428320,3770236215,1672586204,1672588571,2367
3705,3887243870,3713829743,1672683887,1672687479,3592
3707,3757630221,3801645328,1672615616,1672616760,1144
3806,3512383699,3970198861,1672658310,1672661163,2853
3654,3518561777,3713589994,1672691699,1672693981,2282
3656,3231713082,3770624662,1672632723,1672636268,3545
3429,3495911207,3490214516,1672563620,1672565760,2140
3654,3512383699,3755222916,1672572301,1672572652,351
3894,3621683102,3231494505,1672579449,1672580411,962
3596,3701136026,3284947372,1672596696,1672598271,1575
3920,3755222916,3715545685,1672600749,1672602435,1686
3577,3519651506,3341893384,1672545575,1672546183,608
3710,3519416013,3791613604,1672671706,1672674973,3267
3689,3517462308,3389634034,1672665846,1672667907,2061
3562,3512958459,3817428320,1672645494,1672647263,1769
3733,3202141727,3274831810,1672601565,1672605121,3556
3666,3755065949,3825881598,1672539420,1672540434,1014
3556,3774155692,3688220326,1672652546,1672653271,725
3475,3505807416,3505521218,1672599282,1672600952,1670
3906,3519446663,3500317969,1672597071,1672600526,3455
3615,3347446226,3803517637,1672703766,1672706406,2640
3475,3516703758,3734118023,1672632538,1672633946,1408
3686,3209526819,3757193551,1672700422,1672700885,463
3904,3334951866,3935913584,1672666026,1672667301,1275
3493,3516321888,3617489344,1672603581,1672604279,698
3544,3757193307,3660887799,1672696952,1672699382,2430
3781,3779786641,3774031303,1672538260,1672540906,2646
3812,3492546679,3517687662,1672556157,1672558529,2372
3462,3777330107,3792489602,1672691334,1672694337,3003
3866,3276348699,3230868435,1672673542,1672675008,1466
3683,3229974066,3977352557,1672626592,1672629872,3280
3765,3773009828,3783136330,1672644338,1672644738,400
3511,3604589802,3808136029,1672576920,1672580515,3595
3561,3935487534,3284932450,1672531743,1672535046,3303
3895,3792072681,3520991398,1672555341,1672558257,2916
3439,3607882826,3660063072,1672701611,1672701674,63
3532,3755992176,3516489668,1672640170,1672642854,2684
3596,3401940259,3850911686,1672608298,1672610087,1789
3514,3490029863,3713941638,1672545655,1672545966,311
3869,3241914067,3714128600,1672694338,1672694566,228
3776,3714067076,3780571086,1672592044,1672595271,3227
3693,3417191856,3774178201,1672585856,1672587234,1378
3563,3395201292,3512830734,1672654184,1672656975,2791
3526,3520322124,3817428320,1672699729,1672700206,477
3615,3492546679,3514285803,1672695349,1672698094,2745
3911,3270042456,3807212280,1672560015,1672561899,1884
3863,3510798825,3831586487,1672581324,1672584678,3354
3481,3689114185,3974674109,1672677390,1672677929,539
3750,3637313265,3338083680,1672596637,1672598986,2349
3819,3296462324,3450286949,1672664226,1672665924,1698
3567,3711812325,3701247948,1672595499,1672596326,827
3536,3636329663,3609659642,1672638833,1672640019,1186
3430,3714185969,3533368789,1672644172,1672644309,137
3756,3294747828,3431460073,1672536249,1672538431,2182
3591,3715707380,3814677862,1672550906,1672551602,696
3771,3300511067,3970558632,1672630085,1672633183,3098
3754,3554944414,3688490530,1672635160,1672638000,2840
3655,3500915665,3701823816,1672673092,1672675745,2653
3686,3514741348,3517881647,1672629158,1672629896,738
3818,3534764451,3472312341,1672687331,1672690088,2757
3704,3826238375,3887243870,1672543120,1672545993,2873
3530,3440107959,3774733620,1672535433,1672538422,2989
3675,3337322736,3774178201,1672624951,1672627322,2371
3673,3773902805,3398198430,1672700786,1672701335,549
3657,3513295938,3288224595,1672632665,1672635836,3171
3770,3354144091,3411688875,1672700377,1672702434,2057
3468,3505111292,3793418209,1672643586,1672645925,2339
3516,3517687662,3479851674,1672654940,1672655843,903
3565,3334951866,3552824113,1672702466,1672705143,2677
3604,3452016771,3770236215,1672554891,1672556210,1319
3770,3479851674,3520416075,1672545113,1672547547,2434
3533,3791753345,3519446663,1672547351,1672550886,3535
3533,3500949309,3755344363,1672547453,1672548481,1028
3753,3930242012,3231713082,1672550997,1672553800,2803
3713,3505266860,3734118023,1672576919,1672577146,227
3578,3736705719,3440137407,1672646715,1672648885,2170
3765,3311420950,3490214516,1672667910,1672670892,2982
3576,3760364383,3456430614,1672669672,1672670819,1147
3479,3777624586,3916490839,1672592054,1672594977,2923
3810,3776988674,3760645796,1672542084,1672542809,725
3904,3283144118,3510554314,1672694271,1672696782,2511
3499,3450286949,3386758279,1672631224,1672632097,873
3879,3890739241,3615113018,1672577351,1672578206,855
3819,3470454332,3780834916,1672566471,1672566824,353
3625,3520764926,3448875382,1672636707,1672640198,3491
3884,3512946768,3512392431,1672593636,1672596789,3153
3817,3492959689,3519651506,1672546237,1672548980,2743
3909,3637313265,3755737419,1672620884,1672622688,1804
3609,3619922891,3621683102,1672697989,1672700843,2854
3828,3793935736,3424660806,1672583516,1672584616,1100
3502,3927165965,3310039260,1672564543,1672564936,393
3425,3366423342,3236458894,1672663323,1672665990,2667
3566,3368283077,3885537225,1672650151,1672651288,1137
3579,3783615982,3440107959,1672666006,1672668055,2049
3888,3270056120,3505725706,1672638592,1672640087,1495
3827,3373089838,3622665543,1672558596,1672560633,2037
3490,3713300120,3756789525,1672614775,1672617492,2717
3576,3398198430,3880926355,1672546130,1672547540,1410
3667,3713589994,3792389522,1672648486,1672649887,1401
3649,3519416013,3517590837,1672668397,1672669925,1528
3750,3715974659,3739661856,1672563230,1672564307,1077
3736,3605221116,3559731671,1672559452,1672561375,1923
3470,3972083617,3783373154,1672669278,1672672396,3118
3529,3618489670,3505402439,1672636100,1672636464,364
3479,3779738691,3505198734,1672634576,1672636503,1927
3431,3776988674,3714678331,1672580561,1672582327,1766
3533,3733558985,3734118023,1672661087,1672663496,2409
3685,3363162590,3770676872,1672534168,1672534448,280
3830,3792020993,3701823816,1672679844,1672681737,1893
3851,3757294769,3500317969,1672629042,1672629625,583
3750,3738026330,3812369928,1672679058,1672680679,1621
3792,3463849738,3231713082,1672552573,1672554274,1701
3552,3734451191,3201800997,1672649925,1672650288,363
3613,3516903528,3711919537,1672536322,1672538384,2062
3614,3793935736,3519087371,1672598602,1672601306,2704
3917,3755222916,3755992176,1672659911,1672660670,759
3863,3776034743,3716272919,1672574517,1672576095,1578
3522,3757700712,3711097754,1672609504,1672610031,527
3826,3608855425,3376467719,1672605690,1672608130,2440
3836,3793969543,3337322736,1672639253,1672641068,1815
3704,3613899351,3441348818,1672540768,1672544299,3531
3886,3835422146,3300511067,1672611081,1672611470,389
3660,3914691363,3737147209,1672536674,1672537362,688
3451,3514818819,3900276517,1672570634,1672572205,1571
3582,3757332128,3923220461,1672542216,1672543210,994
3544,3923220461,3500857494,1672698016,1672701320,3304
3680,3283144118,3791613604,1672629558,1672631789,2231
3692,3770438122,3376467719,1672669165,1672671316,2151
3632,3488686442,3756746867,1672552282,1672552476,194
3814,3347446226,3410160376,1672617007,1672619992,2985
3628,3686523546,3783919913,1672682954,1672684144,1190
3789,3512722110,3380982774,1672541018,1672542611,1593
3692,3755992176,3514703118,1672590653,1672593832,3179
3716,3617116290,3622357348,1672612134,1672615589,3455
3822,3292147449,3350095157,1672618979,1672622005,3026
3545,3777037426,3514246749,1672658694,1672660001,1307
3613,3928511283,3336627643,1672627114,1672628592,1478
3786,3893912331,3780834916,1672532701,1672533905,1204
3491,3511732493,3757348722,1672533199,1672535048,1849
3455,3514324011,3514334067,1672642821,1672643816,995
3723,3448875382,3621184108,1672600376,1672601182,806
3863,3760094385,3517358573,1672658575,1672660489,1914
3683,3779532653,3732131656,1672586326,1672589681,3355
3474,3354144091,3357864626,1672591905,1672593489,1584
3673,3779639983,3774705415,1672703629,1672704732,1103
3862,3347419520,3897435944,1672626351,1672626434,83
3578,3367111751,3472068734,1672597948,1672601167,3219
3915,3776084820,3783771827,1672659744,1672662470,2726
3549,3554186380,3774718695,1672698114,1672698960,846
3502,3396726504,3780472203,1672583622,1672585429,1807
3813,3441703884,3772765746,1672587967,1672588119,152
3460,3500109249,3779892400,1672681405,1672681699,294
3566,3703139663,3351696332,1672648534,1672648715,181
3721,3500737582,3417191856,1672543518,1672544330,812
3610,3511791953,3512800570,1672574823,1672576634,1811
3631,3755065949,3814677862,1672600373,1672600588,215
3794,3773033649,3401793306,1672590599,1672590745,146
3549,3757323954,3500604680,1672638563,1672640704,2141
3787,3305722859,3916490839,1672605540,1672605865,325
3449,3514818819,3517600136,1672575700,1672576338,638
3581,3777485931,3387594369,1672645255,1672647872,2617
3835,3311085279,3780909839,1672620370,1672620882,512
3666,3533228966,3773572967,1672538622,1672540239,1617
3644,3462158237,3778667336,1672666043,1672666311,268
3442,3680843171,3520416075,1672653968,1672656535,2567
3912,3770520359,3852533643,1672664885,1672667246,2361
3663,3899326793,3734915241,1672556169,1672557504,1335
3752,3225029895,3451726367,1672547377,1672549694,2317
3518,3440107959,3783520186,1672552911,1672554349,1438
3760,3701424609,3760362417,1672593063,1672594694,1631
3869,3500317969,3280268483,1672659305,1672659733,428
3689,3512502036,3757294769,1672583353,1672584538,1185
3838,3554944414,3364726656,1672560430,1672563584,3154
3540,3928719932,3773027597,1672701375,1672703783,2408
3851,3279475486,3622357348,1672547725,1672551309,3584
3775,3770296583,3770146716,1672571148,1672573812,2664
3841,3385323994,3779892400,1672669823,1672670439,616
3595,3778597171,3448875382,1672611553,1672613977,2424
3705,3710562338,3977352557,1672584764,1672586591,1827
3471,3780338697,3437286517,1672645066,1672645223,157
3817,3803517637,3224330592,1672699062,1672699142,80
3496,3779938251,3511150845,1672556263,1672558109,1846
3599,3533294425,3779738691,1672703921,1672707374,3453
3745,3387594369,3201676087,1672692752,1672694028,1276
3859,3410538749,3898314440,1672606956,1672608259,1303
3604,3467779445,3279242917,1672602750,1672605411,2661
3800,3701322924,3534357694,1672677751,1672678017,266
3425,3511883730,3755158925,1672676300,1672679529,3229
3528,3500915665,3885155975,1672703127,1672703817,690
3497,3779425804,3202804048,1672675600,1672676977,1377
3696,3500672156,3703139663,1672593061,1672595152,2091
3783,3701424609,3773735484,1672631972,1672634807,2835
3730,3778597171,3385323994,1672618095,1672618584,489
3466,3755532873,3519818818,1672699055,1672700211,1156
3896,3661447322,3779656423,1672560712,1672562047,1335
3622,3617392620,3410538749,1672625505,1672627935,2430
3449,3760651515,3688490530,1672665696,1672669213,3517
3515,3224811762,3306175858,1672542105,1672542408,303
3508,3311049964,3518194482,1672619513,1672619687,174
3779,3230868435,3392943173,1672566705,1672569999,3294
3506,3304155815,3791128487,1672579754,1672581471,1717
3878,3488686442,3501215099,1672689462,1672691656,2194
3787,3271454397,3412968120,1672584502,1672587700,3198
3909,3305336154,3411515369,1672564443,1672565727,1284
3777,3337362061,3384583385,1672627348,1672628052,704
3798,3774243020,3615939504,1672623831,1672624270,439
3487,3770624662,3783550022,1672635486,1672637768,2282
3857,3783433404,3492959689,1672561720,1672565277,3557
3781,3935913584,3399518841,1672643470,1672644757,1287
3765,3773902805,3414940786,1672636715,1672638995,2280
3685,3791693821,3440107959,1672634864,1672635763,899
3691,3510818674,3472068734,1672558396,1672561822,3426
3858,3294747828,3534175249,1672657062,1672657739,677
3502,3310125159,3834963772,1672701877,1672702557,680
3751,3783340788,3208957949,1672639291,1672642865,3574
3675,3783919913,3703139663,1672548246,1672549221,975
3484,3622357348,3357689359,1672615434,1672617639,2205
3657,3760040019,3777184389,1672700793,1672703226,2433
3483,3415833929,3240994288,1672640437,1672643951,3514
3767,3316800320,3630353876,1672697754,1672698782,1028
3764,3336339664,3897456874,1672628144,1672630732,2588
3710,3688220326,3783919913,1672538710,1672540394,1684
3824,3714670620,3714233826,1672575412,1672575896,484
3753,3311049964,3975717896,1672686428,1672687689,1261
3826,3639050419,3411515369,1672697933,1672701007,3074
3664,3776117322,3533188828,1672542406,1672545120,2714
3863,3514971533,3416987084,1672671315,1672673812,2497
3648,3463740710,3931627862,1672552134,1672553460,1326
3442,3336339664,3619922891,1672556236,1672557165,929
3532,3779425804,3334993594,1672629983,1672632698,2715
3514,3472312341,3481640525,1672533841,1672536621,2780
3827,3811075491,3520115090,1672606117,1672608984,2867
3541,3714827719,3350095157,1672554766,1672556779,2013
3469,3770676872,3428725843,1672650574,1672654135,3561
3648,3701823816,3512946768,1672553728,1672556839,3111
3803,3512282789,3900945856,1672558425,1672559545,1120
3892,3310125159,3552824113,1672702160,1672705358,3198
3874,3710854064,3927599181,1672685419,1672687259,1840
3502,3613416045,3612689556,1672696990,1672699216,2226
3718,3505847380,3760721303,1672623365,1672623517,152
3885,3509764635,3760362417,1672608338,1672610297,1959
3683,3773913680,3514818819,1672560066,1672563024,2958
3537,3688796737,3793868716,1672557729,1672558248,519
3769,3664943873,3735374579,1672630229,1672633592,3363
3915,3438078818,3451326054,1672676414,1672677406,992
3715,3500613459,3756704774,1672697182,1672698253,1071
3499,3457620713,3343816795,1672648055,1672651157,3102
3827,3512337405,3923754072,1672680651,1672681009,358
3810,3617489344,3505481368,1672678087,1672680872,2785
3450,3686523546,3890739241,1672568073,1672570878,2805
3606,3505888598,3232208416,1672542622,1672545599,2977
3811,3613416045,3505228454,1672688477,1672689592,1115
3527,3776518452,3776988674,1672552823,1672553675,852
3832,3625463628,3283144118,1672590580,1672592504,1924
3814,3713941638,3392520516,1672595332,1672598517,3185
3880,3833217041,3774031303,1672655105,1672655280,175
3614,3394401087,3534179433,1672664561,1672667367,2806
3477,3736231757,3209526819,1672623383,1672625465,2082
3429,3271752081,3824215187,1672651325,1672652801,1476
3434,3780769110,3897134762,1672620973,1672621851,878
3514,3271752081,3534829213,1672666891,1672669862,2971
3675,3773124276,3241790910,1672586860,1672587226,366
3504,3240994288,3612689556,1672555244,1672556797,1553
3637,3760040019,3516741440,1672699263,1672701538,2275
3694,3520657891,3778899160,1672615269,1672617636,2367
3624,3511317276,3935399379,1672652812,1672653010,198
3598,3501457103,3421385957,1672686583,1672686728,145
3647,3435116799,3807212280,1672648058,1672650682,2624
3553,3734451191,3505198734,1672573533,1672576091,2558
3726,3776034743,3519142371,1672599218,1672602211,2993
3751,3711853996,3607768197,1672545962,1672548133,2171
3813,3556969573,3800257590,1672678584,1672682116,3532
3679,3412968120,3519282716,1672692425,1672692499,74
3617,3517737088,3755573472,1672681206,1672682758,1552
3849,3792525861,3492959689,1672676505,1672676905,400
3769,3774243020,3299443125,1672548398,1672551016,2618
3594,3938503547,3885157459,1672620834,1672622775,1941
3922,3774718695,3664943873,1672571614,1672572678,1064
3751,3760721303,3777485931,1672668307,1672669370,1063
3587,3202804048,3774605761,1672548787,1672551745,2958
3748,3449639012,3469254160,1672566540,1672567496,956
3527,3334993594,3916490839,1672600781,1672601894,1113
3618,3792389522,3454277788,1672569335,1672571067,1732
3518,3774790271,3511317276,1672578043,1672578417,374
3735,3240394404,3895285664,1672627022,1672627294,272
3563,3511024016,3979784676,1672537160,1672540749,3589
3607,3793175445,3501567772,1672672157,1672673828,1671
3849,3897435944,3520355798,1672692687,1672692810,123
3862,3774733620,3441348818,1672658609,1672659231,622
3854,3713300120,3513410578,1672675307,1672676995,1688
3720,3501121099,3480100311,1672558056,1672560506,2450
3641,3793407963,3479851674,1672611671,1672611901,230
3668,3429943738,3343816795,1672628881,1672630222,1341
3479,3713911104,3923220461,1672673577,1672676183,2606
3524,3271752081,3505178849,1672616723,1672619854,3131
3675,3272030610,3491684096,1672683281,1672685764,2483
3749,3934064792,3380130228,1672640590,1672643711,3121
3626,3500109249,3274831810,1672533667,1672535396,1729
3437,3512383699,3500613493,1672656575,1672657429,854
3811,3387594369,3779786641,1672563012,1672565628,2616
3459,3609881958,3499217428,1672646323,1672649690,3367
3580,3514275974,3380982774,1672697811,1672698992,1181
3785,3783801141,3915162005,1672652325,1672655249,2924
3444,3533188828,3519446663,1672553841,1672555258,1417
3845,3462636434,3802932312,1672548916,1672549913,997
3566,3680810086,3533090502,1672614127,1672615667,1540
3625,3792745809,3284947372,1672627278,1672628063,785
3778,3835985172,3711919537,1672645078,1672647045,1967
3863,3780680950,3383138270,1672622520,1672625463,2943
3916,3500915665,3608232640,1672551593,1672552501,908
3775,3880926355,3305722859,1672695471,1672698955,3484
3904,3412968120,3202141727,1672673805,1672676753,2948
3913,3438078818,3923420131,1672650218,1672653467,3249
3816,3779639983,3608922867,1672574071,1672575850,1779
3802,3333918941,3777694660,1672601383,1672602996,1613
3502,3897376951,3732131656,1672698477,1672701983,3506
3638,3713979100,3410538749,1672623715,1672624327,612
3828,3715545685,3437286517,1672641577,1672644413,2836
3679,3835985172,3203538212,1672550470,1672553331,2861
3482,3823084403,3780712350,1672625735,1672628875,3140
3897,3390660440,3703383853,1672540933,1672544124,3191
3461,3777814504,3446533960,1672635842,1672638868,3026
3594,3437286517,3516489668,1672587941,1672590320,2379
3515,3971806004,3305336154,1672663933,1672664619,686
3702,3778040015,3362641275,1672701137,1672704334,3197
3704,3511150845,3512295534,1672582538,1672585960,3422
3601,3514971533,3780322355,1672681857,1672684352,2495
3475,3310125159,3783615982,1672583679,1672586657,2978
3635,3513853403,3734118023,1672688929,1672689392,463
3466,3519651506,3834963772,1672531378,1672532611,1233
3520,3520115090,3512800570,1672627244,1672628788,1544
3464,3497671225,3533188828,1672584410,1672584877,467
3445,3500915665,3715385401,1672564125,1672564757,632
3426,3534175249,3475349791,1672554389,1672557773,3384
3822,3770236215,3792505974,1672654804,1672657106,2302
3728,3517600136,3776034743,1672651782,1672655007,3225
3867,3923420131,3891672228,1672537036,1672538349,1313
3641,3739911441,3682133690,1672625731,1672628913,3182
3809,3360813161,3713784974,1672632781,1672635663,2882
3830,3638204468,3208957949,1672595011,1672598367,3356
3708,3934064792,3311085279,1672645229,1672647203,1974
3887,3928719932,3392836218,1672655681,1672659254,3573
3716,3515402792,3932478321,1672670590,1672671684,1094
3666,3713691388,3928719932,1672611747,1672612857,1110
3438,3480991549,3783433404,1672587856,1672590381,2525
3912,3520657891,3205985903,1672651055,1672654226,3171
3548,3736231757,3792072681,1672532447,1672535190,2743
3793,3520322124,3731646673,1672658422,1672661538,3116
3867,3713300120,3739661856,1672692011,1672695380,3369
3559,3479851674,3516489668,1672533451,1672535219,1768
3565,3803517637,3394297564,1672549704,1672550002,298
3765,3383138270,3792546035,1672662768,1672664960,2192
3757,3501567772,3738026330,1672642320,1672644849,2529
3474,3713829743,3501121099,1672578728,1672581515,2787
3709,3392836218,3912891315,1672619448,1672620832,1384
3452,3201676087,3447514821,1672658138,1672661734,3596
3576,3615688740,3511024016,1672545971,1672547075,1104
3712,3633735593,3360616538,1672644969,1672645298,329
3822,3478114114,3773124276,1672682542,1672683980,1438
3592,3773009828,3935399379,1672601990,1672602453,463
3635,3351866415,3605221116,1672688188,1672689612,1424
3447,3923754072,3733363628,1672571967,1672572513,546
3883,3510187271,3703139663,1672589470,1672589884,414
3749,3310039260,3224811762,1672685861,1672688017,2156
3775,3811075491,3303410628,1672591155,1672593019,1864
3669,3776244398,3834963772,1672573936,1672575317,1381
3458,3511024016,3660887799,1672576232,1672578414,2182
3443,3792546035,3776518452,1672551333,1672554808,3475
3841,3779613523,3703383853,1672675782,1672679116,3334
3790,3715974659,3737972328,1672699977,1672700290,313
3436,3716272919,3512502036,1672556899,1672559071,2172
3780,3533649454,3554186380,1672651025,1672653422,2397
3510,3512502036,3792489602,1672623062,1672624095,1033
3499,3512946768,3501457103,1672604085,1672605722,1637
3867,3713784974,3927165965,1672702765,1672703737,972
3428,3402385957,3904569677,1672598835,1672599275,440
3761,3402385957,3447672935,1672547220,1672548897,1677
3694,3225631197,3415833929,1672567543,1672568175,632
3482,3533188828,3373089838,1672632636,1672632915,279
3853,3613338363,3685816610,1672537537,1672539073,1536
3743,3713911104,3334647380,1672538480,1672540113,1633
3786,3760040019,3780571086,1672606548,1672608055,1507
3668,3271454397,3294747828,1672633261,1672636502,3241
3645,3791246640,3343132529,1672657432,1672660010,2578
3682,3773033649,3755065949,1672588605,1672592021,3416
3860,3604867757,3777330107,1672682049,1672684418,2369
3802,3226511603,3236458894,1672550016,1672551851,1835
3455,3713768950,3225029895,1672702207,1672705014,2807
3899,3734118023,3755496114,1672578142,1672580969,2827
3852,3303410628,3312998540,1672639846,1672640113,267
3603,3392943173,3669146016,1672557984,1672559147,1163
3472,3457960571,3512383699,1672552738,1672555134,2396
3484,3229822507,3392836218,1672578472,1672581411,2939
3524,3396726504,3713784974,1672550214,1672551451,1237
3812,3495911207,3760645796,1672607858,1672608821,963
3739,3500857494,3923420131,1672599465,1672602553,3088
3879,3970198861,3514285803,1672689473,1672690701,1228
3524,3316798920,3780834916,1672639010,1672640464,1454
3564,3757863420,3977352557,1672613291,1672613532,241
3883,3311085279,3733558985,1672682870,1672686053,3183
3828,3519416013,3500737582,1672556142,1672558158,2016
3653,3755992176,3373028638,1672588440,1672590409,1969
3746,3438489358,3517462308,1672604175,1672607100,2925
3456,3773027597,3617489344,1672668676,1672672213,3537
3617,3202141727,3500827202,1672626663,1672629151,2488
3863,3334974375,3793969543,1672614146,1672614763,617
3502,3902861231,3336339664,1672650906,1672651019,113
3788,3511732493,3510964997,1672542734,1672544494,1760
3865,3534543776,3777147510,1672542235,1672542573,338
3883,3783550022,3500525825,1672534730,1672535168,438
3841,3454277788,3780680950,1672535842,1672536640,798
3819,3770520359,3520560590,1672615723,1672615922,199
3748,3902625986,3776518452,1672540220,1672540894,674
3856,3613899351,3713941638,1672534470,1672535200,730
3561,3514246749,3551389192,1672663161,1672664917,1756
3591,3357689359,3232208416,1672568520,1672571877,3357
3716,3511288998,3226511603,1672669511,1672672903,3392
3676,3452016771,3757383891,1672636851,1672640333,3482
3875,3294747828,3780769110,1672701012,1672703728,2716
3513,3909094917,3440137407,1672698006,1672699579,1573
3757,3793315718,3713911104,1672657397,1672658466,1069
3748,3610870949,3383138270,1672657643,1672661182,3539
3734,3511288998,3618489670,1672677306,1672679212,1906
3424,3912891315,3777814504,1672542393,1672542882,489
3767,3688490530,3735374579,1672592016,1672593992,1976
3481,3711812325,3559731671,1672617125,1672617577,452
3845,3384068080,3713784974,1672571567,1672573362,1795
3752,3457620713,3399518841,1672555656,1672557250,1594
3791,3823084403,3970627281,1672656744,1672660007,3263
3895,3272716462,3200543880,1672565749,1672569129,3380
3608,3688220326,3497808662,1672582003,1672582172,169
3726,3711919537,3311098437,1672580008,1672580474,466
3660,3970558632,3395201292,1672694091,1672697343,3252
3585,3311498666,3360616538,1672607882,1672608933,1051
3754,3730071479,3703139663,1672586353,1672589346,2993
3610,3615939504,3770296583,1672567453,1672570807,3354
3678,3500442734,3505198734,1672552025,1672554632,2607
3506,3510798825,3736231757,1672583717,1672585801,2084
3759,3239617320,3710048469,1672615942,1672616292,350
3854,3895285664,3519818818,1672661057,1672662318,1261
3787,3774876004,3783147088,1672608645,1672609715,1070
3645,3665998641,3364378127,1672648035,1672649620,1585
3725,3714827719,3501786419,1672571505,1672574305,2800
3892,3885155975,3783433404,1672685937,1672686477,540
3567,3609933747,3792949946,1672556634,1672558742,2108
3826,3776084820,3411515369,1672630143,1672632379,2236
3650,3311098437,3757193307,1672697373,1672699894,2521
3636,3480991549,3935487534,1672640346,1672641908,1562
3733,3792274796,3621184108,1672547694,1672549361,1667
3444,3225636215,3701424609,1672589171,1672592643,3472
3791,3520355798,3713691388,1672557023,1672559452,2429
3825,3604867757,3760924079,1672632060,1672635143,3083
3500,3970198861,3516489668,1672660187,1672662565,2378
3548,3618354185,3772391882,1672576868,1672580122,3254
3598,3714666884,3711734586,1672651763,1672652937,1174
3792,3815392801,3777330107,1672694977,1672696799,1822
3486,3200543880,3414275042,1672628438,1672629560,1122
3443,3932478321,3711637255,1672697901,1672700077,2176
3686,3780712350,3209526819,1672549355,1672549828,473
3733,3613416045,3402385957,1672585600,1672589128,3528
3700,3517881647,3902760230,1672680327,1672682505,2178
3779,3500044458,3463849738,1672701173,1672701733,560
3724,3773902805,3488763230,1672576985,1672578950,1965
3553,3905196766,3923420131,1672591346,1672594329,2983
3520,3780338697,3714827719,1672678027,1672678334,307
3570,3760645796,3703139663,1672570902,1672574500,3598
3638,3791106564,3402385957,1672547415,1672549401,1986
3697,3609933747,3783520186,1672688662,1672690714,2052
3462,3451326054,3770438122,1672660085,1672661069,984
3780,3512383699,3780712350,1672658157,1672658879,722
3773,3630353876,3714185969,1672646758,1672648667,1909
3624,3661583097,3757193307,1672631736,1672634618,2882
3695,3505888598,3424660806,1672683228,1672684166,938
3848,3517697722,3623266256,1672648751,1672650866,2115
3842,3510028805,3500317969,1672672049,1672672697,648
3847,3853629553,3294703680,1672657199,1672659147,1948
3444,3600876425,3635169815,1672644941,1672645306,365
3578,3716272919,3338083680,1672695216,1672697759,2543
3817,3667673649,3618808151,1672689584,1672691694,2110
3684,3760924079,3411515369,1672535546,1672535742,196
3623,3713829743,3289817992,1672629167,1672631306,2139
3894,3390660440,3517881647,1672684368,1672687730,3362
3764,3814677862,3792505974,1672555151,1672557459,2308
3461,3369708250,3480991549,1672538564,1672539061,497
3874,3424445495,3500442734,1672546270,1672549001,2731
3512,3387594369,3780834916,1672540476,1672542135,1659
3558,3711077927,3904867554,1672636347,1672637273,926
3736,3551399764,3272030610,1672594332,1672597197,2865
3769,3274906650,3885121158,1672550622,1672553664,3042
3660,3689697817,3510919821,1672541396,1672544774,3378
3830,3757294769,3461119815,1672635601,1672636695,1094
3708,3380767040,3511601997,1672657875,1672661185,3310
3850,3773121782,3710048469,1672653685,1672657062,3377
3582,3518565331,3384068080,1672650592,1672651279,687
3553,3510818674,3713300120,1672654108,1672654493,385
3851,3500498112,3203538212,1672651933,1672653831,1898
3713,3516321888,3300979975,1672593815,1672595686,1871
3524,3636329663,3772391882,1672696549,1672699138,2589
3866,3241914067,3394297564,1672556159,1672558549,2390
3572,3617489344,3513327337,1672669511,1672670360,849
3807,3512282789,3280268483,1672691471,1672694524,3053
3714,3274831810,3516703758,1672685620,1672685900,280
3900,3757318448,3757700712,1672657515,1672657601,86
3603,3513041785,3912891315,1672576070,1672579281,3211
3854,3499217428,3292147449,1672545049,1672548168,3119
3559,3512946768,3401496246,1672606245,1672608810,2565
3867,3488763230,3779425804,1672666448,1672666551,103
3815,3463740710,3604867757,1672536071,1672537258,1187
3672,3887243870,3239617320,1672666146,1672667352,1206
3439,3512946768,3380982774,1672683644,1672685195,1551
3600,3715385401,3778926763,1672675575,1672676797,1222
3763,3513081354,3792489602,1672631209,1672632678,1469
3922,3793315718,3272096759,1672688527,1672690447,1920
3679,3424445495,3459681410,1672700249,1672701774,1525
3765,3715086894,3777037426,1672543838,1672544151,313
3492,3416987084,3607768197,1672628225,1672629865,1640
3700,3511442562,3240994288,1672693727,1672696430,2703
3433,3819767045,3400763927,1672572145,1672575063,2918
3754,3516444201,3283770991,1672664342,1672667083,2741
3724,3500302272,3501525100,1672701107,1672703085,1978
3431,3912891315,3757700712,1672674560,1672675691,1131
3921,3710735406,3288224595,1672566370,1672569472,3102
3876,3607768197,3534829213,1672606387,1672607661,1274
3466,3459681410,3688490530,1672627424,1672627569,145
3624,3885121158,3783520186,1672697802,1672699408,1606
3570,3437286517,3757318448,1672610288,1672612477,2189
3517,3232208416,3500841914,1672578889,1672581808,2919
3548,3938503547,3760924079,1672636575,1672637818,1243
3899,3734118023,3292147449,1672580347,1672583656,3309
3534,3500072204,3714670620,1672593356,1672595596,2240
3884,3398198430,3756704774,1672698327,1672700235,1908
3899,3360069849,3505434346,1672618048,1672618274,226
3512,3891672228,3366423342,1672603190,1672606478,3288
3868,3519087371,3505228454,1672695674,1672696102,428
3732,3792949946,3468041839,1672612518,1672612816,298
3663,3756474459,3756127300,1672693136,1672694982,1846
3795,3205985903,3780427126,1672625325,1672628287,2962
3610,3512379024,3279339278,1672688624,1672689636,1012
3628,3450969839,3559458968,1672611221,1672614677,3456
3915,3451726367,3385323994,1672544655,1672547385,2730
3913,3517737088,3715443333,1672565119,1672568247,3128
3701,3730071479,3501215099,1672592811,1672595920,3109
3518,3428027649,3500347447,1672554641,1672556752,2111
3781,3915162005,3608855425,1672684127,1672687553,3426
3551,3472312341,3688796737,1672650140,1672653244,3104
3836,3519142371,3716110860,1672604882,1672605009,127
3592,3220031931,3367971170,1672703152,1672704978,1826
3898,3618489670,3897134762,1672599725,1672602640,2915
3790,3306412634,3509483172,1672585189,1672587878,2689
3787,3333403880,3236499444,1672597363,1672597493,130
3792,3311498666,3734915241,1672592323,1672595832,3509
3813,3510818674,3815392801,1672639066,1672642344,3278
3500,3443357683,3393063657,1672697129,1672697391,262
3520,3272096759,3492546679,1672662177,1672662886,709
3646,3364378127,3409114719,1672607475,1672608389,914
3570,3974674109,3619922891,1672628494,1672628971,477
3551,3617116290,3793743698,1672570720,1672573634,2914
3734,3280054198,3500317969,1672564586,1672564690,104
3750,3279473441,3783928182,1672619196,1672620571,1375
3432,3236458894,3774031303,1672573986,1672574979,993
3885,3852533643,3779646172,1672572302,1672574272,1970
3432,3668414677,3777779869,1672609882,1672610504,622
3535,3299125059,3803517637,1672674002,1672676646,2644
3767,3792546035,3791246640,1672591829,1672593432,1603
3448,3899786664,3791796585,1672622651,1672623372,721
3754,3505481368,3516298579,1672551375,1672553036,1661
3578,3404025196,3441703884,1672641868,1672644325,2457
3613,3500341755,3701136026,1672638130,1672640529,2399
3810,3713768950,3510641433,1672600456,1672603988,3532
3616,3778926763,3733558985,1672539558,1672540678,1120
3571,3505402439,3757332128,1672644857,1672647395,2538
3876,3520181148,3755222916,1672601345,1672604524,3179
3602,3791106564,3533423872,1672569357,1672571901,2544
3751,3288762795,3834631333,1672694854,1672698039,3185
3624,3755737419,3408430195,1672543185,1672543926,741
3493,3711734586,3780834916,1672533678,1672534554,876
3539,3713163045,3505923418,1672659634,1672660423,789
3646,3514971533,3774718695,1672673434,1672675941,2507
3527,3777147510,3454277788,1672676388,1672679601,3213
3429,3779613523,3514741348,1672537770,1672539832,2062
3607,3201800997,3885537225,1672635622,1672638152,2530
3531,3279242917,3209481722,1672531770,1672535222,3452
3761,3757630221,3836241528,1672697343,1672699107,1764
3738,3449333754,3935913584,1672535490,1672535662,172
3440,3793175445,3400763927,1672689813,1672693373,3560
3465,3755230952,3783433404,1672567274,1672567974,700
3647,3776244398,3834963772,1672578702,1672579015,313
3554,3276003502,3756385685,1672691981,1672692501,520
3551,3511288998,3399518841,1672593625,1672595656,2031
3697,3683113954,3824215187,1672543293,1672546461,3168
3916,3554944414,3505179890,1672622023,1672624903,2880
3507,3497671225,3897376951,1672571798,1672573823,2025
3480,3701247948,3512882178,1672582928,1672583428,500
3875,3935487534,3612689556,1672549351,1672551050,1699
3791,3512295534,3333918941,1672645750,1672649277,3527
3427,3757332128,3505725706,1672569839,1672571328,1489
3459,3770296583,3500703304,1672581177,1672582444,1267
3459,3501459390,3441703884,1672593689,1672596213,2524
3804,3783520186,3893912331,1672674769,1672675718,949
3569,3756704774,3500498112,1672674729,1672677314,2585
3459,3927599181,3224330592,1672573014,1672575202,2188
3779,3821054646,3202804048,1672651272,1672654178,2906
3640,3770520359,3274906650,1672533494,1672534257,763
3497,3979802715,3501215099,1672592334,1672593944,1610
3606,3635169815,3760651515,1672644099,1672646664,2565
3863,3556969573,3829864515,1672602533,1672605175,2642
3901,3686227677,3975717896,1672589850,1672591477,1627
3440,3360069849,3773939399,1672562946,1672564596,1650
3611,3501459390,3756789525,1672583537,1672584838,1301
3797,3626499450,3713768950,1672630258,1672633562,3304
3716,3637313265,3774290799,1672615291,1672618370,3079
3496,3779532653,3711000597,1672690583,1672694167,3584
3712,3209526819,3755737419,1672642098,1672644047,1949
3588,3505888598,3685681577,1672556249,1672558299,2050
3583,3373089838,3533368789,1672696399,1672697541,1142
3830,3756746867,3354144091,1672598360,1672599977,1617
3767,3505725706,3364378127,1672564780,1672565286,506
3816,3732131656,3688796737,1672603385,1672604097,712
3624,3533294425,3500827202,1672560078,1672560178,100
3774,3617116290,3757863420,1672645156,1672648127,2971
3648,3291933594,3248058676,1672534032,1672535379,1347
3616,3757348722,3514275974,1672566145,1672568153,2008
3798,3505434346,3935399379,1672557822,1672558224,402
3598,3780427126,3516489668,1672685730,1672687894,2164
3706,3501384020,3315279093,1672558376,1672560481,2105
3611,3619922891,3793743698,1672681108,1672682932,1824
3491,3783163143,3757383891,1672570089,1672573416,3327
3431,3520991398,3533747868,1672621917,1672624066,2149
3508,3533090502,3667427125,1672643396,1672644742,1346
3654,3824641227,3505283390,1672573836,1672574202,366
3557,3778926763,3274906650,1672697338,1672700301,2963
3641,3934064792,3395201292,1672687754,1672688570,816
3490,3793315718,3755065949,1672652981,1672654277,1296
3629,3379143440,3887243870,1672702802,1672704705,1903
3537,3401793306,3206837348,1672633941,1672635326,1385
3735,3928511283,3398198430,1672549181,1672552098,2917
3824,3404025196,3811040565,1672545624,1672548986,3362
3603,3755915206,3224330592,1672582322,1672584631,2309
3661,3533188828,3780872464,1672683755,1672685835,2080
3500,3439673892,3774243020,1672592247,1672593459,1212
3481,3734118023,3701322924,1672599050,1672601955,2905
3894,3610358027,3501457103,1672590079,1672592231,2152
3570,3618489670,3520991398,1672606476,1672609585,3109
3740,3760694096,3492546679,1672595130,1672595663,533
3721,3803389195,3446533960,1672549988,1672553222,3234
3456,3774907131,3520560590,1672535277,1672537938,2661
3922,3773332082,3792745809,1672559252,1672561228,1976
3680,3756746867,3534357694,1672604135,1672605398,1263
3896,3755233658,3755230952,1672608520,1672609376,856
3634,3337362061,3304155815,1672668076,1672671012,2936
3717,3916490839,3760364383,1672695931,1672697748,1817
3450,3900898992,3520416075,1672616122,1672616640,518
3470,3779938251,3733558985,1672539894,1672542939,3045
3905,3520322124,3935913584,1672675888,1672678149,2261
3749,3393063657,3776084820,1672630389,1672633036,2647
3645,3468041839,3276217799,1672581341,1672584263,2922
3718,3492959689,3713768950,1672679161,1672679786,625
3720,3803517637,3923220461,1672593372,1672596909,3537
3432,3518229776,3915162005,1672590616,1672593496,2880
3675,3515525630,3760040019,1672567628,1672568905,1277
3538,3792274796,3512722110,1672536447,1672536950,503
3543,3490029863,3505481368,1672560537,1672562982,2445
3884,3716272919,3294703680,1672592277,1672593237,960
3545,3330340793,3755065949,1672650742,1672651594,852
3564,3793315718,3209481722,1672559226,1672560344,1118
3762,3500915908,3608232640,1672662661,1672664133,1472
3499,3920625129,3270697740,1672600950,1672601153,203
3749,3609113156,3912891315,1672587990,1672589106,1116
3894,3780253901,3923420131,1672659831,1672662065,2234
3537,3273981374,3905899155,1672702024,1672704570,2546
3460,3686523546,3369708250,1672596513,1672597974,1461
3448,3289114629,3488763230,1672677985,1672681114,3129
3550,3776831527,3205985903,1672645172,1672647175,2003
3896,3713979100,3776084820,1672645353,1672645597,244
3699,3500777439,3386758279,1672561987,1672563839,1852
3449,3938503547,3620292035,1672567443,1672570461,3018
3697,3734118023,3793883863,1672647177,1672649934,2757
3713,3613899351,3760094385,1672558276,1672559282,1006
3830,3610870949,3777184389,1672558237,1672558585,348
3919,3351866415,3611055563,1672575199,1672576713,1514
3898,3783928182,3435116799,1672578515,1672580777,2262
3679,3451326054,3351696332,1672542232,1672544827,2595
3462,3500841914,3777147510,1672680282,1672681797,1515
3564,3375449013,3932478321,1672567778,1672570790,3012
3869,3701136026,3970909253,1672660651,1672661418,767
3513,3411515369,3500525825,1672640961,1672643517,2556
3620,3710489491,3447514821,1672563966,1672564904,938
3761,3916490839,3777240360,1672547991,1672549134,1143
3719,3236458894,3850911686,1672590745,1672591157,412
3871,3390660440,3513296868,1672578488,1672581427,2939
3597,3488686442,3780680950,1672700905,1672704136,3231
3882,3512282789,3791753345,1672703853,1672706448,2595
3690,3814677862,3514419100,1672689154,1672691872,2718
3551,3783641602,3900945856,1672625843,1672629044,3201
3550,3927165965,3627368399,1672594860,1672596232,1372
3686,3817813340,3777330107,1672643470,1672643882,412
3559,3513853403,3779613523,1672613545,1672616500,2955
3550,3505807416,3835985172,1672581121,1672583014,1893
3726,3513853403,3739661856,1672692387,1672692959,572
3911,3533649454,3780115155,1672594991,1672596196,1205
3514,3367509761,3777814504,1672619312,1672620818,1506
3660,3488763230,3780472203,1672666494,1672666676,182
3742,3315279093,3208957949,1672600351,1672602350,1999
3875,3288224595,3923754072,1672538399,1672541409,3010
3641,3509366311,3833217041,1672696835,1672698945,2110
3465,3230135532,3802932312,1672638683,1672641643,2960
3751,3803517637,3792801638,1672611243,1672611542,299
3915,3757383891,3511883730,1672558748,1672561522,2774
3576,3229822507,3611055563,1672701251,1672703919,2668
3861,3510028805,3770520359,1672560709,1672562004,1295
3442,3520416075,3500604680,1672619499,1672622410,2911
3490,3505283390,3462273042,1672605126,1672605938,812
3893,3519909393,3481640525,1672615796,1672617647,1851
3614,3510919821,3713691388,1672666608,1672669045,2437
3545,3512383699,3814305099,1672703342,1672703784,442
3622,3783801141,3514741348,1672688655,1672688784,129
3792,3713911104,3780769110,1672576619,1672576790,171
3817,3773121782,3779639983,1672578089,1672579913,1824
3886,3518561777,3480726047,1672607306,1672609382,2076
3823,3520355798,3777624586,1672536761,1672539821,3060
3768,3373089838,3500525825,1672638179,1672639580,1401
3554,3783615982,3505521218,1672623561,1672625308,1747
3520,3714666884,3716628503,1672574261,1672576261,2000
3571,3714120857,3410600350,1672575462,1672576055,593
3562,3613899351,3272716462,1672657086,1672657728,642
3678,3272030610,3519142371,1672690755,1672693262,2507
3523,3209526819,3737112297,1672650630,1672650758,128
3754,3618697021,3369708250,1672571543,1672573211,1668
3455,3517590837,3716272919,1672590588,1672592088,1500
3458,3448633776,3636329663,1672610698,1672610969,271
3898,3821054646,3636329663,1672598107,1672601211,3104
3816,3501786419,3703396825,1672697485,1672701023,3538
3635,3915162005,3793969543,1672654887,1672655689,802
3672,3500498112,3713979100,1672680139,1672683144,3005
3921,3710854064,3513295938,1672548134,1672551166,3032
3694,3783373154,3925979970,1672535322,1672537124,1802
3622,3500613459,3833217041,1672648196,1672649166,970
3566,3376467719,3815392801,1672690108,1672691491,1383
3748,3516444201,3626499450,1672572091,1672575685,3594
3813,3756746867,3208957949,1672661065,1672662039,974
3826,3779738691,3893912331,1672531757,1672532992,1235
3580,3350095157,3513065217,1672550017,1672551101,1084
3757,3661447322,3757332128,1672539439,1672542695,3256
3798,3500317969,3505402439,1672615849,1672618899,3050
3903,3304971369,3446533960,1672613678,1672615828,2150
3541,3713829743,3977352557,1672674216,1672677459,3243
3443,3970627281,3715400486,1672684912,1672684997,85
3634,3779532653,3338083680,1672634102,1672637506,3404
3515,3201676087,3300979975,1672651225,1672654818,3593
3886,3829864515,3505402439,1672616436,1672617263,827
3530,3480100311,3793969543,1672588251,1672589530,1279
3670,3711853996,3519446663,1672678550,1672680281,1731
3543,3755992176,3336339664,1672610347,1672613218,2871
3735,3831586487,3715385401,1672536047,1672537695,1648
3683,3511317276,3501786419,1672545305,1672545529,224
3638,3436025562,3739895284,1672637677,1672639826,2149
3594,3500442734,3770146716,1672545396,1672548144,2748
3840,3490214516,3517600136,1672605280,1672608557,3277
3759,3617489344,3514512367,1672587414,1672590473,3059
3676,3398198430,3467988782,1672561886,1672563296,1410
3663,3713300120,3279242917,1672650424,1672653657,3233
3896,3533188828,3421385957,1672659881,1672661520,1639
3848,3534829213,3270042456,1672582880,1672584049,1169
3622,3770520359,3783615982,1672696099,1672697229,1130
3887,3783520186,3757323954,1672675667,1672677495,1828
3769,3208957949,3713941638,1672672665,1672673455,790
3472,3613581796,3739911441,1672630384,1672630945,561
3788,3803517637,3274831810,1672665103,1672665171,68
3454,3760924079,3834960360,1672569438,1672569832,394
3623,3468041839,3777147510,1672658502,1672661036,2534
3861,3701882224,3801645328,1672572939,1672576284,3345
3687,3403370192,3276217799,1672583525,1672584790,1265
3593,3512383699,3518653080,1672677618,1672677859,241
3515,3780322355,3660063072,1672656373,1672659271,2898
3696,3363162590,3500208903,1672555657,1672558100,2443
3745,3711812325,3514741348,1672700078,1672702674,2596
3539,3812534508,3371455553,1672575817,1672578716,2899
3686,3534175249,3367111751,1672602143,1672604466,2323
3846,3308760650,3240394404,1672560128,1672561714,1586
3699,3472068734,3390660440,1672692181,1672693346,1165
3447,3408498208,3604589802,1672541002,1672541301,299
3698,3505995057,3470454332,1672641194,1672641381,187
3921,3240994288,3971806004,1672687450,1672690480,3030
3831,3773735484,3288762795,1672564055,1672566728,2673
3653,3757193307,3611055563,1672595316,1672597985,2669
3497,3414049538,3393063657,1672635479,1672638955,3476
3625,3449639012,3357689359,1672599921,1672603238,3317
3548,3783520186,3755848152,1672697688,1672699384,1696
3881,3417191856,3780115155,1672667570,1672671144,3574
3739,3617392620,3760362417,1672538195,1672541106,2911
3803,3505154885,3824641227,1672666922,1672668472,1550
3565,3488763230,3511791953,1672620305,1672621842,1537
3541,3899786664,3793969543,1672695173,1672695327,154
3662,3773124276,3225636215,1672652017,1672652177,160
3843,3517687662,3777779869,1672646100,1672648234,2134
3525,3510187271,3612689556,1672680073,1672681967,1894
3599,3283770991,3475349791,1672654357,1672654716,359
3767,3714666884,3554825448,1672608380,1672610363,1983
3650,3416987084,3773572967,1672591324,1672591806,482
3497,3730071479,3735374579,1672564052,1672564259,207
3557,3780338697,3554944414,1672601939,1672605457,3518
3604,3402697190,3668747074,1672667961,1672669502,1541
3629,3780322355,3793418209,1672584149,1672584618,469
3922,3490029863,3514703118,1672653697,1672655057,1360
3776,3226511603,3415833929,1672614732,1672615447,715
3557,3780909839,3600876425,1672694293,1672696649,2356
3906,3610358027,3927403123,1672636793,1672639310,2517
3803,3236499444,3711734586,1672648978,1672650515,1537
3584,3534126409,3505179890,1672631385,1672631522,137
3467,3468041839,3316800320,1672551678,1672552955,1277
3809,3900276517,3711000597,1672600731,1672601558,827
3845,3615115210,3780680950,1672571863,1672574512,2649
3794,3738026330,3511732493,1672632366,1672634648,2282
3544,3793740407,3815392801,1672676219,1672679466,3247
3911,3205923620,3337362061,1672662022,1672664942,2920
3467,3689114185,3716272919,1672549461,1672552509,3048
3593,3500604680,3462636434,1672679970,1672682635,2665
3571,3501525100,3513081354,1672536491,1672539556,3065
3909,3773572967,3517590837,1672685358,1672687265,1907
3867,3347419520,3757294769,1672639360,1672641715,2355
3462,3777485931,3635169815,1672610830,1672612140,1310
3467,3714120857,3480490124,1672580582,1672583068,2486
3888,3533649454,3895285664,1672573181,1672574662,1481
3911,3716628503,3383138270,1672653292,1672655744,2452
3629,3884596900,3780571086,1672548775,1672551985,3210
3901,3514324011,3501567772,1672612440,1672615745,3305
3811,3551376095,3885155975,1672626049,1672628529,2480
3686,3300229945,3711077927,1672637293,1672637800,507
3517,3779613523,3240394404,1672570870,1672571787,917
3789,3384583385,3512383699,1672692633,1672694887,2254
3700,3755230952,3808136029,1672600153,1672601042,889
3910,3780115155,3834631333,1672668359,1672671935,3576
3661,3931627862,3492546679,1672572154,1672574744,2590
3753,3518229776,3438489358,1672575321,1672576788,1467
3854,3519282716,3270042456,1672605568,1672608025,2457
3718,3892304880,3831586487,1672539544,1672542933,3389
3836,3334974375,3688796737,1672629692,1672631316,1624
3583,3517697722,3443357683,1672645290,1672646093,803
3487,3510818674,3779465522,1672644477,1672646425,1948
3472,3774705415,3393063657,1672692337,1672694273,1936
3441,3714678331,3609881958,1672537872,1672539265,1393
3891,3701664364,3492546679,1672658732,1672660531,1799
3788,3622357348,3734915241,1672596079,1672596958,879
3567,3715086894,3783136330,1672568084,1672568838,754
3431,3853629553,3853629553,1672646093,1672646275,182
3538,3793175445,3534566651,1672584412,1672587471,3059
3915,3885537225,3270697740,1672615146,1672618133,2987
3621,3661447322,3755344363,1672605183,1672607904,2721
3484,3914691363,3516321888,1672554039,1672555878,1839
3504,3500341755,3492546679,1672613091,1672613895,804
3599,3354144091,3900898992,1672548408,1672551174,2766
3679,3338390596,3757294769,1672534886,1672535255,369
3672,3755992176,3773033649,1672560933,1672563554,2621
3478,3780322355,3232208416,1672537368,1672540227,2859
3716,3731646673,3783340788,1672568243,1672569053,810
3863,3780322355,3490029863,1672589972,1672593070,3098
3889,3916490839,3613899351,1672599517,1672603099,3582
3838,3711097754,3686227677,1672560829,1672561105,276
3694,3510818674,3451326054,1672539032,1672540636,1604
3478,3760645796,3902760230,1672614533,1672616388,1855
3760,3315279093,3400069268,1672685245,1672686310,1065
3584,3834963772,3834963772,1672593494,1672597019,3525
3773,3715400486,3557046880,1672630368,1672631876,1508
3634,3660887799,3337322736,1672550410,1672551994,1584
3462,3516444201,3974674109,1672544484,1672545163,679
3789,3225029895,3859868849,1672623167,1672623640,473
3604,3739661856,3613899351,1672628797,1672629058,261
3707,3394401087,3780872464,1672542088,1672543780,1692
3562,3488763230,3713589994,1672672492,1672675360,2868
3638,3520322124,3667427125,1672542332,1672545693,3361
3453,3510919821,3511150845,1672614433,1672614725,292
3859,3517687662,3916490839,1672672610,1672674065,1455
3554,3713300120,3739895284,1672565649,1672566993,1344
3606,3756625818,3512379024,1672559506,1672562460,2954
3487,3511843593,3780338697,1672546712,1672548354,1642
3612,3500672156,3737147209,1672688351,1672690373,2022
3474,3630353876,3710562338,1672611857,1672614778,2921
3810,3401940259,3792745809,1672604492,1672605783,1291
3712,3505725706,3703433819,1672565358,1672566328,970
3596,3514308235,3711097754,1672612200,1672614685,2485
3682,3440137407,3779938251,1672665136,1672667124,1988
3475,3455018347,3792801638,1672560844,1672562633,1789
3656,3774290799,3514324011,1672693097,1672693423,326
3701,3711097754,3500604680,1672605724,1672606738,1014
3911,3417191856,3225636215,1672665324,1672665871,547
3863,3336627643,3776244398,1672576974,1672577629,655
3864,3421385957,3711077927,1672588461,1672590683,2222
3435,3500341755,3554186380,1672660043,1672660251,208
3657,3511791953,3783373154,1672629626,1672631342,1716
3788,3760362417,3714827719,1672627767,1672628357,590
3714,3778667336,3509893027,1672604939,1672605195,256
3793,3824215187,3755222916,1672688980,1672691704,2724
3624,3774705415,3319167958,1672579689,1672580489,800
3702,3801645328,3347446226,1672590477,1672592786,2309
3631,3770236215,3412006598,1672611462,1672614054,2592
3635,3500703304,3501281016,1672701186,1672703668,2482
3459,3807212280,3511288998,1672586599,1672587926,1327
3651,3513345163,3618176292,1672643798,1672645359,1561
3762,3201676087,3757863420,1672549119,1672552433,3314
3483,3392836218,3500915908,1672661769,1672663369,1600
3858,3205923620,3774290799,1672623387,1672625492,2105
3434,3972192593,3347419520,1672626656,1672627310,654
3906,3514741348,3791441520,1672623055,1672624285,1230
3592,3501281016,3688220326,1672591562,1672594705,3143
3672,3516703758,3713561276,1672685828,1672688661,2833
3490,3619922891,3620292035,1672583754,1672585801,2047
3472,3780872464,3238288884,1672563778,1672564401,623
3602,3833217041,3409114719,1672619311,1672620258,947
3678,3200543880,3229822507,1672690268,1672692934,2666
3834,3500109249,3201629017,1672604626,1672605814,1188
3623,3289114629,3711637255,1672547425,1672547717,292
3901,3244004456,3357289672,1672614981,1672615651,670
3588,3205923620,3774718695,1672605336,1672608771,3435
3620,3715443333,3665998641,1672548347,1672551060,2713
3755,3780115155,3514512367,1672693785,1672693969,184
3603,3493017654,3511005395,1672639046,1672641121,2075
3659,3515525630,3312998540,1672630995,1672633093,2098
3544,3920898925,3627368399,1672568653,1672569005,352
3478,3480490124,3716628503,1672648784,1672649104,320
3737,3777330107,3780571086,1672685781,1672686102,321
3678,3737112297,3776084820,1672576532,1672578315,1783
3472,3280054198,3511883730,1672559485,1672560685,1200
3913,3289817992,3492959689,1672592710,1672595643,2933
3903,3773837847,3610358027,1672679365,1672680098,733
3815,3833217041,3777330107,1672574201,1672576838,2637
3515,3661447322,3711218296,1672598593,1672599457,864
3662,3513360004,3730071479,1672616130,1672618251,2121
3472,3336627643,3516513251,1672688712,1672692162,3450
3721,3891672228,3791693821,1672643975,1672644060,85
3727,3757348722,3501457103,1672577659,1672579821,2162
3656,3441348818,3920497528,1672606079,1672609610,3531
3459,3501567772,3887243870,1672644093,1672646779,2686
3592,3416987084,3449639012,1672657707,1672658206,499
3566,3505179890,3733363628,1672631278,1672631783,505
3435,3360813161,3714185969,1672543130,1672545718,2588
3451,3613899351,3773121782,1672654495,1672654877,382
3852,3793418209,3600876425,1672637623,1672640044,2421
3780,3714233826,3510187271,1672600024,1672603454,3430
3511,3618489670,3454277788,1672584970,1672585522,552
3647,3935913584,3492546679,1672596231,1672596470,239
3806,3334993594,3375449013,1672610113,1672612586,2473
3460,3757348722,3713517039,1672583789,1672584725,936
3558,3893912331,3755065949,1672694871,1672697256,2385
3921,3783340788,3774718695,1672609430,1672610368,938
3702,3209526819,3380130228,1672582083,1672582143,60
3591,3554944414,3631090677,1672589398,1672592254,2856
3646,3829822608,3713979100,1672625829,1672628864,3035
3577,3904867554,3279242917,1672599317,1672600555,1238
3434,3511843593,3383138270,1672546143,1672547707,1564
3446,3279475486,3518653080,1672663878,1672666376,2498
3871,3780909839,3680810086,1672641445,1672644529,3084
3691,3369708250,3793583656,1672640529,1672643681,3152
3597,3713517039,3392520516,1672667668,1672669257,1589
3736,3501459390,3735374579,1672543311,1672543934,623
3783,3515890966,3608922867,1672637420,1672637672,252
3751,3778597171,3294747828,1672686318,1672687408,1090
3693,3505481368,3626499450,1672546156,1672547020,864
3778,3501459390,3791246640,1672572743,1672573449,706
3491,3777814504,3520657891,1672677579,1672677720,141
3778,3500317969,3274831810,1672543504,1672543589,85
3614,3497095254,3779938251,1672537435,1672539280,1845
3664,3621461051,3392943173,1672596388,1672598198,1810
3678,3777624586,3505283390,1672531584,1672533263,1679
3822,3792389522,3412968120,1672628191,1672629072,881
3523,3270042456,3349856820,1672593028,1672594540,1512
3750,3512337405,3783147088,1672643736,1672647204,3468
3824,3625463628,3756704774,1672569832,1672573255,3423
3611,3402697190,3364378127,1672679297,1672681417,2120
3652,3755222916,3510767239,1672641136,1672643160,2024
3679,3637313265,3272096759,1672570248,1672573048,2800
3873,3710562338,3200543880,1672635796,1672635977,181
3869,3236499444,3362641275,1672600985,1672603628,2643
3908,3898314440,3375449013,1672600677,1672603631,2954
3603,3225029895,3505111292,1672683462,1672686422,2960
3635,3447514821,3412006598,1672613696,1672617114,3418
3592,3834963772,3387594369,1672643273,1672643554,281
3455,3514285803,3779639983,1672663552,1672666815,3263
3520,3608232640,3436025562,1672567879,1672568170,291
3517,3479851674,3533274994,1672682178,1672683120,942
3597,3510919821,3288762795,1672628354,1672630216,1862
3435,3779786641,3835422146,1672607844,1672609682,1838
3572,3513545422,3701005527,1672561106,1672561837,731
3761,3304155815,3478114114,1672603252,1672603854,602
3717,3385323994,3485540729,1672647941,1672649743,1802
3591,3637313265,3510642075,1672544261,1672547691,3430
3488,3462636434,3516444201,1672627919,1672629220,1301
3872,3435116799,3732131656,1672559013,1672562455,3442
3558,3814305099,3511288998,1672564522,1672566764,2242
3670,3757323954,3310125159,1672683084,1672686563,3479
3915,3776988674,3755230952,1672628282,1672629503,1221
3485,3610358027,3515402792,1672664698,1672665235,537
3498,3757700712,3308760650,1672539066,1672541062,1996
3438,3241790910,3977148669,1672594212,1672595557,1345
3830,3512946768,3338083680,1672546480,1672546960,480
3530,3534566651,3661583097,1672570772,1672573140,2368
3631,3773913680,3505111292,1672610170,1672612734,2564
3762,3714666884,3357289672,1672618722,1672621324,2602
3555,3408498208,3505481368,1672687601,1672688180,579
3517,3514334067,3306175858,1672571889,1672572820,931
3915,3736231757,3205985903,1672565124,1672565434,310
3907,3492546679,3534179433,1672667815,1672670588,2773
3496,3661583097,3701664364,1672608388,1672611862,3474
3699,3613581796,3201629017,1672599301,1672599840,539
3449,3885537225,3791613604,1672648426,1672650238,1812
3675,3780209375,3825881598,1672661036,1672664076,3040
3620,3225636215,3710489491,1672551524,1672554447,2923
3616,3517222913,3703139663,1672635750,1672636736,986
3849,3289817992,3713691388,1672638635,1672641097,2462
3474,3200543880,3364726656,1672570158,1672570754,596
3545,3773939399,3714120857,1672599347,1672599796,449
3914,3533188828,3935487534,1672599768,1672602421,2653
3885,3701136026,3756789525,1672700037,1672703241,3204
3430,3533079336,3756127300,1672606608,1672607028,420
3813,3501567772,3904569677,1672603130,1672606575,3445
3801,3622665543,3779613523,1672680900,1672683376,2476
3855,3756385685,3511150845,1672608013,1672610973,2960
3874,3534543776,3779938251,1672648411,1672651303,2892
3595,3411688875,3858172636,1672544041,1672545326,1285
3891,3448633776,3368283077,1672581711,1672582035,324
3561,3739154408,3501281016,1672663665,1672665031,1366
3509,3206837348,3735374579,1672583724,1672583794,70
3739,3533929349,3518194482,1672582593,1672586124,3531
3479,3559731671,3512958459,1672619866,1672620023,157
3647,3780834916,3970909253,1672654468,1672656101,1633
3572,3897456874,3897435944,1672610972,1672611284,312
3544,3778899160,3713589994,1672609507,1672612267,2760
3655,3440107959,3279242917,1672550593,1672552034,1441
3822,3512282789,3633735593,1672665470,1672668956,3486
3922,3710854064,3773572967,1672629770,1672630378,608
3733,3778040015,3554186380,1672688148,1672690521,2373
3790,3615737355,3668747074,1672565900,1672566131,231
3767,3448875382,3229974066,1672622856,1672625374,2518
3446,3514334067,3452016771,1672600185,1672601904,1719
3476,3315703693,3500525825,1672597095,1672597426,331
3588,3920625129,3559458968,1672643940,1672646471,2531
3892,3923754072,3500442734,1672701045,1672702708,1663
3900,3240994288,3756127300,1672680098,1672683358,3260
3890,3927403123,3280268483,1672581195,1672584794,3599
3434,3774876004,3241914067,1672701182,1672703263,2081
3764,3511601997,3793868716,1672658546,1672660783,2237
3596,3500525825,3783919913,1672558395,1672559674,1279
3484,3770704999,3533294425,1672590606,1672593574,2968
3615,3435167810,3488686442,1672692350,1672692503,153
3581,3519087371,3614740489,1672579320,1672581229,1909
3710,3779465522,3792020993,1672697913,1672699168,1255
3804,3757294769,3515525630,1672655346,1672656586,1240
3603,3515401243,3533228966,1672667944,1672671231,3287
3794,3533079336,3621184108,1672592600,1672593123,523
3651,3401496246,3452016771,1672532594,1672534416,1822
3848,3774790271,3499217428,1672596028,1672599121,3093
3518,3513065217,3898314440,1672606672,1672606968,296
3429,3341893384,3467988782,1672639595,1672640753,1158
3627,3916490839,3927599181,1672645430,1672647548,2118
3537,3780338697,3510641433,1672538772,1672540369,1597
3807,3713784974,3703798634,1672611780,1672613870,2090
3863,3461119815,3509893027,1672691934,1672694073,2139
3827,3500949309,3630353876,1672570614,1672570894,280
3494,3793418209,3715619259,1672700803,1672701825,1022
3569,3231494505,3499217428,1672535694,1672537734,2040
3514,3349739136,3855583256,1672624783,1672625785,1002
3766,3236354255,3230135532,1672588995,1672591354,2359
3491,3756746867,3757383891,1672633985,1672634960,975
3523,3505995057,3970627281,1672568424,1672568737,313
3850,3439673892,3701373490,1672693239,1672693581,342
3919,3408430195,3772391882,1672619855,1672621819,1964
3652,3770236215,3638660068,1672569263,1672571132,1869
3748,3783550022,3916490839,1672534488,1672536430,1942
3761,3800257590,3831586487,1672546921,1672550110,3189
3758,3232208416,3511317276,1672673660,1672676119,2459
3801,3375449013,3517697722,1672658290,1672659870,1580
3612,3793583656,3756385685,1672587369,1672588682,1313
3457,3975717896,3513360004,1672574679,1672575914,1235
3529,3904569677,3793969543,1672675907,1672677333,1426
3916,3739895284,3431460073,1672669901,1672672833,2932
3454,3773027597,3850911686,1672603007,1672604295,1288
3511,3791128487,3755532873,1672581582,1672583078,1496
3583,3977352557,3488763230,1672677188,1672677413,225
3616,3519909393,3392836218,1672609638,1672611692,2054
3467,3608922867,3491684096,1672615466,1672615818,352
3784,3783771827,3770438122,1672670413,1672673092,2679
3845,3661903000,3632814465,1672587614,1672589476,1862
3660,3441703884,3614740489,1672585390,1672587018,1628
3764,3710008361,3777147510,1672585123,1672588702,3579
3630,3715854030,3812369928,1672683657,1672686318,2661
3709,3688490530,3534829213,1672620129,1672620453,324
3884,3441348818,3780322355,1672659832,1672660149,317
3598,3335694356,3534764451,1672627940,1672631146,3206
3538,3618489670,3701005527,1672685715,1672687455,1740
3873,3715385401,3609881958,1672668058,1672670813,2755
3746,3311085279,3517358573,1672703166,1672703883,717
3472,3533228966,3632814465,1672656620,1672658962,2342
3582,3793969543,3760364383,1672588453,1672590417,1964
3693,3517590837,3714120857,1672590249,1672591815,1566
3511,3449333754,3608922867,1672618368,1672620917,2549
3603,3306412634,3793743698,1672681118,1672682786,1668
3497,3776518452,3780338697,1672626424,1672628683,2259
3659,3757630221,3926643445,1672556988,1672559388,2400
3605,3739895284,3732131656,1672539785,1672542835,3050
3440,3534543776,3774790271,1672666138,1672668765,2627
3507,3376467719,3617392620,1672605815,1672607838,2023
3725,3501525100,3202804048,1672664733,1672665588,855
3454,3337362061,3713979100,1672701184,1672702528,1344
3507,3755737419,3500525825,1672674461,1672674635,174
3694,3755222916,3783373154,1672636711,1672637365,654
3765,3509756823,3737147209,1672567001,1672567600,599
3618,3850911686,3780338697,1672593242,1672595398,2156
3622,3336339664,3825881598,1672612086,1672613138,1052
3595,3505481368,3760721303,1672564039,1672566988,2949
3827,3793315718,3533274994,1672538133,1672539743,1610
3696,3793883863,3202804048,1672680182,1672683603,3421
3845,3514818819,3349739136,1672540832,1672543758,2926
3488,3757294769,3931627862,1672632869,1672635285,2416
3842,3688796737,3505266860,1672575602,1672575687,85
3820,3713784974,3773939399,1672636283,1672638353,2070
3648,3517687662,3607882826,1672666971,1672669060,2089
3591,3279339278,3604589802,1672542064,1672543714,1650
3575,3500777439,3760364383,1672691765,1672693435,1670
3438,3390660440,3309314379,1672653728,1672654827,1099
3618,3554825448,3351866415,1672675149,1672676267,1118
3911,3899326793,3436257398,1672694682,1672697584,2902
3871,3710496785,3617116290,1672534567,1672536857,2290
3833,3755158925,3885121158,1672621183,1672622933,1750
3497,3792389522,3452016771,1672630188,1672630566,378
3677,3480991549,3449639012,1672592327,1672592870,543
3539,3791128487,3667673649,1672651516,1672654946,3430
3664,3756789525,3334951866,1672671477,1672672336,859
3538,3776084820,3760094385,1672641404,1672644779,3375
3851,3713941638,3520578796,1672546923,1672548255,1332
3582,3770296583,3514956366,1672625727,1672627029,1302
3885,3779656423,3613899351,1672635963,1672636315,352
3867,3497671225,3661903000,1672550508,1672554106,3598
3647,3793743698,3505437712,1672592881,1672595049,2168
3780,3236499444,3772765746,1672630669,1672630940,271
3654,3612689556,3505634634,1672617006,1672618848,1842
3432,3201629017,3783615982,1672623890,1672626894,3004
3736,3557046880,3779425804,1672619592,1672622691,3099
3484,3713561276,3975717896,1672616448,1672617796,1348
3521,3517697722,3772236797,1672637165,1672638441,1276
3643,3510554314,3512882178,1672666410,1672668207,1797
3756,3514324011,3272716462,1672668896,1672671259,2363
3842,3774876004,3533294425,1672555335,1672558261,2926
3827,3710735406,3276003502,1672541642,1672543012,1370
3470,3517600136,3402385957,1672571258,1672572923,1665
3735,3755158925,3512502036,1672587600,1672590641,3041
3557,3248058676,3757383891,1672593072,1672596527,3455
3706,3714670620,3510187271,1672691364,1672691621,257
3448,3715385401,3638204468,1672623136,1672625801,2665
3679,3403370192,3622665543,1672559921,1672560657,736
3638,3689114185,3627368399,1672654166,1672655241,1075
3829,3304971369,3315279093,1672558537,1672558947,410
3451,3770296583,3500737582,1672651113,1672654148,3035
3782,3791246640,3414049538,1672544290,1672545294,1004
3756,3791753345,3360813161,1672675896,1672678263,2367
3596,3715986185,3624297844,1672626264,1672629675,3411
3532,3551389192,3440137407,1672573888,1672574451,563
3556,3350095157,3925979970,1672569097,1672570096,999
3843,3621683102,3715127070,1672576815,1672578719,1904
3552,3757193551,3778899160,1672620762,1672622071,1309
3726,3711919537,3791128487,1672654604,1672655855,1251
3486,3715400486,3715127070,1672589658,1672593052,3394
3805,3384068080,3510919821,1672608885,1672612104,3219
3602,3449333754,3618176292,1672642643,1672644052,1409
3438,3604867757,3680810086,1672670906,1672672470,1564
3655,3418448389,3478114114,1672664158,1672666397,2239
3851,3514971533,3516513251,1672645521,1672645893,372
3713,3288762795,3510818674,1672659799,1672662807,3008
3604,3608922867,3435116799,1672664810,1672667204,2394
3872,3311085279,3394401087,1672576043,1672579271,3228
3798,3897376951,3520639768,1672641142,1672641740,598
3454,3520181148,3315703693,1672593195,1672595552,2357
3634,3713589994,3202804048,1672671797,1672674021,2224
3840,3608232640,3755532873,1672677847,1672681084,3237
3770,3500672156,3639050419,1672623572,1672623856,284
3544,3435116799,3777330107,1672688717,1672691712,2995
3458,3906536154,3900898992,1672665235,1672667041,1806
3596,3703798634,3783641602,1672578589,1672580112,1523
3764,3510554314,3916490839,1672539175,1672540216,1041
3740,3514956366,3819767045,1672584762,1672587653,2891
3794,3710854064,3660063072,1672633211,1672635526,2315
3898,3887243870,3734118023,1672601030,1672603859,2829
3622,3292147449,3900945856,1672586327,1672586653,326
3907,3431460073,3710489491,1672684100,1672687103,3003
3727,3688220326,3533188828,1672685442,1672686020,578
3793,3294747828,3500109249,1672578468,1672581998,3530
3565,3372223551,3915162005,1672695767,1672696852,1085
3615,3276217799,3777814504,1672687505,1672688024,519
3849,3399472693,3457960571,1672642149,1672643821,1672
3440,3398731252,3713768950,1672533773,1672535769,1996
3673,3341893384,3713300120,1672536785,1672539650,2865
3836,3716679950,3755496114,1672604493,1672604930,437
3865,3357289672,3280054198,1672579362,1672582435,3073
3547,3520764926,3780712350,1672674009,1672676993,2984
3687,3710048469,3800257590,1672640160,1672642036,1876
3867,3701664364,3630353876,1672665819,1672668729,2910
3664,3774155692,3791753345,1672702798,1672703583,785
3792,3205923620,3710854064,1672540095,1672543001,2906
3591,3288224595,3514512367,1672641355,1672642016,661
3606,3500949309,3609881958,1672638194,1672639483,1289
3642,3236499444,3710854064,1672697859,1672698347,488
3450,3382733096,3510818674,1672603688,1672605701,2013
3569,3512337405,3412968120,1672690839,1672693155,2316
3840,3774718695,3511732493,1672650695,1672651024,329
3672,3316798920,3357864626,1672674662,1672676465,1803
3746,3686523546,3732584121,1672591025,1672592559,1534
3728,3890739241,3757193551,1672554426,1672557705,3279
3451,3773735484,3513360004,1672670941,1672672114,1173
3619,3778926763,3463849738,1672608083,1672609880,1797
3864,3319167958,3889780657,1672569547,1672572553,3006
3525,3701322924,3621683102,1672567528,1672571020,3492
3740,3209481722,3800257590,1672668974,1672671224,2250
3852,3778667336,3512882178,1672588331,1672591476,3145
3765,3554944414,3461119815,1672539593,1672542012,2419
3857,3934064792,3755230952,1672580926,1672581500,574
3529,3512800570,3635169815,1672601927,1672603397,1470
3824,3394401087,3711077927,1672607597,1672609717,2120
3728,3904867554,3714666884,1672640507,1672642652,2145
3454,3920625129,3773572967,1672540108,1672542739,2631
3807,3836241528,3294747828,1672568244,1672570443,2199
3482,3335694356,3516444201,1672640221,1672642176,1955
3897,3492959689,3777624586,1672635874,1672637135,1261
3472,3520639768,3772391882,1672694851,1672696453,1602
3841,3533294425,3664943873,1672686861,1672688000,1139
3678,3469254160,3791246640,1672604892,1672605355,463
3505,3817813340,3779656423,1672690901,1672691090,189
3842,3735374579,3777037426,1672696193,1672697100,907
3748,3311098437,3714128600,1672647905,1672648997,1092
3625,3392943173,3533188828,1672574161,1672576795,2634
3743,3779786641,3461119815,1672668325,1672669302,977
3711,3367509761,3311049964,1672587828,1672588849,1021
3895,3505663516,3900945856,1672613960,1672614488,528
3631,3505402439,3520115090,1672681658,1672682861,1203
3787,3613206049,3773735484,1672603833,1672604925,1092
3645,3760694096,3500709774,1672589421,1672590996,1575
3759,3512383699,3509366311,1672582968,1672583439,471
3759,3517687662,3516741440,1672578461,1672578848,387
3636,3510837901,3513065217,1672646213,1672647892,1679
3560,3446533960,3384583385,1672582162,1672583285,1123
3858,3852686295,3401793306,1672535850,1672539108,3258
3424,3637313265,3905196766,1672657809,1672659979,2170
3820,3770468980,3779786641,1672638863,1672641154,2291
3672,3299781901,3501786419,1672632116,1672632382,266
3730,3200308999,3615113018,1672588555,1672589535,980
3469,3412006598,3880926355,1672603515,1672605638,2123
3516,3713979100,3408498208,1672558819,1672560658,1839
3636,3783641602,3366423342,1672690725,1672691937,1212
3542,3395201292,3392836218,1672622107,1672622628,521
3544,3779438325,3774876004,1672558078,1672559692,1614
3852,3760263530,3298151889,1672675266,1672678528,3262
3491,3904569677,3824215187,1672599374,1672601465,2091
3566,3733363628,3283492940,1672631449,1672631911,462
3778,3488763230,3780909839,1672680341,1672680841,500
3584,3926643445,3533747868,1672601295,1672602105,810
3435,3519651506,3711853996,1672597868,1672600643,2775
3558,3450969839,3431460073,1672649798,1672650049,251
3467,3349856820,3779738691,1672548938,1672550858,1920
3799,3500341755,3779656423,1672574473,1672577579,3106
3664,3783340788,3364726656,1672588070,1672589426,1356
3870,3902861231,3552824113,1672535241,1672538118,2877
3556,3776988674,3231494505,1672645945,1672648029,2084
3448,3779425804,3437286517,1672636571,1672639356,2785
3716,3512946768,3200308999,1672578820,1672581691,2871
3779,3600876425,3611055563,1672698468,1672699441,973
3503,3610870949,3495911207,1672577232,1672577764,532
3860,3467988782,3276003502,1672631151,1672633815,2664
3780,3505725706,3470454332,1672604136,1672605973,1837
3716,3513853403,3408498208,1672637903,1672640906,3003
3602,3778640261,3435167810,1672592041,1672592164,123
3702,3895285664,3533294425,1672542871,1672543026,155
3878,3715707380,3622357348,1672643461,1672646883,3422
3912,3668533536,3509483172,1672702439,1672703841,1402
3900,3778134418,3398731252,1672664637,1672666998,2361
3579,3716110860,3608232640,1672567771,1672568458,687
3446,3783919913,3779613523,1672600757,1672602701,1944
3442,3513065217,3516741440,1672595272,1672595911,639
3550,3755992176,3238288884,1672686414,1672687386,972
3722,3833217041,3667427125,1672532084,1672534024,1940
3502,3414049538,3815250107,1672617720,1672620911,3191
3554,3715127070,3774155692,1672645520,1672646733,1213
3849,3970603231,3713561276,1672652181,1672654800,2619
3685,3394401087,3783163143,1672607235,1672607888,653
3864,3303410628,3757075324,1672534500,1672537689,3189
3692,3897456874,3511883730,1672693549,1672693774,225
3704,3636329663,3480100311,1672612642,1672614731,2089
3658,3505888598,3755158925,1672561254,1672563640,2386
3849,3855583256,3779465522,1672625277,1672626651,1374
3577,3925979970,3500044458,1672665368,1672666278,910
3788,3408498208,3435116799,1672677302,1672677870,568
3890,3559458968,3777091903,1672588240,1672588822,582
3848,3773735484,3513545422,1672674013,1672676505,2492
3632,3714666884,3505923418,1672597304,1672598498,1194
3850,3517288083,3272096759,1672695921,1672696361,440
3671,3755344363,3927599181,1672656969,1672658758,1789
3916,3366423342,3701882224,1672626084,1672626182,98
3817,3755756564,3457960571,1672601324,1672603862,2538
3766,3680843171,3793935736,1672549338,1672550616,1278
3456,3439673892,3244004456,1672576941,1672579052,2111
3822,3289817992,3618354185,1672629151,1672629506,355
3772,3408430195,3517462308,1672682609,1672683080,471
3625,3227799827,3793740407,1672608864,1672610080,1216
3854,3200308999,3615113018,1672575521,1672577294,1773
3891,3310039260,3519282716,1672646311,1672647230,919
3701,3533929349,3777147510,1672565445,1672567784,2339
3820,3610870949,3439673892,1672625766,1672627456,1690
3619,3312998540,3380130228,1672624564,1672624976,412
3762,3604589802,3779854934,1672686830,1672688358,1528
3462,3514956366,3515402792,1672689753,1672691739,1986
3865,3293835352,3311098437,1672616687,1672618775,2088
3599,3451691949,3505178849,1672547500,1672548389,889
3524,3551376095,3905196766,1672587447,1672589534,2087
3491,3755065949,3513853403,1672555983,1672557177,1194
3656,3711097754,3661903000,1672581007,1672581508,501
3844,3824641227,3480991549,1672598742,1672600502,1760
3878,3404025196,3780680950,1672637810,1672638672,862
3607,3757348722,3701373490,1672555053,1672555494,441
3494,3773124276,3533423872,1672691496,1672694857,3361
3459,3513295938,3689114185,1672551261,1672553706,2445
3916,3206837348,3792505974,1672645849,1672647800,1951
3516,3398198430,3208957949,1672650741,1672651008,267
3749,3520322124,3512958459,1672629716,1672633008,3292
3552,3311098437,3299443125,1672614295,1672615908,1613
3676,3793781065,3513410578,1672542852,1672543322,470
3443,3770520359,3374183227,1672553261,1672556722,3461
3716,3240394404,3392836218,1672688780,1672690032,1252
3883,3778899160,3533274994,1672679329,1672682748,3419
3442,3736231757,3609659642,1672687974,1672688703,729
3871,3609659642,3533090502,1672633499,1672635028,1529
3681,3895285664,3757630221,1672653272,1672656766,3494
3659,3701136026,3551376095,1672678716,1672680838,2122
3693,3450286949,3454277788,1672680010,1672683409,3399
3764,3612689556,3791046864,1672581151,1672582312,1161
3665,3618808151,3518194482,1672616497,1672617956,1459
3839,3463849738,3783163143,1672619814,1672621109,1295
3445,3770296583,3931627862,1672664815,1672667897,3082
3569,3777779869,3343132529,1672580708,1672582113,1405
3915,3904569677,3773332082,1672568752,1672572311,3559
3550,3510837901,3500672156,1672679137,1672679843,706
3490,3305722859,3225636215,1672550232,1672550804,572
3782,3512946768,3826238375,1672677751,1672680028,2277
3457,3316800320,3499217428,1672644847,1672646994,2147
3539,3773121782,3661447322,1672542061,1672542755,694
3873,3500777439,3435116799,1672538976,1672539858,882
3426,3488686442,3435167810,1672635880,1672637767,1887
3434,3225636215,3777624586,1672619495,1672622207,2712
3566,3505481368,3316800320,1672698982,1672700319,1337
3664,3517737088,3792389522,1672629912,1672631841,1929
3453,3979802715,3240994288,1672558641,1672562093,3452
3540,3613581796,3703348097,1672695721,1672697688,1967
3752,3435116799,3289817992,1672543279,1672545313,2034
3715,3208452238,3779786641,1672649507,1672651314,1807
3458,3226024417,3979802715,1672661004,1672664263,3259
3780,3513041785,3714185969,1672586872,1672589346,2474
3659,3887243870,3511317276,1672618151,1672620805,2654
3582,3638660068,3735374579,1672586339,1672587347,1008
3712,3457960571,3776518452,1672677108,1672677215,107
3702,3517881647,3450286949,1672546051,1672546934,883
3627,3429943738,3500777439,1672594049,1672597533,3484
3572,3756625818,3821054646,1672551726,1672554653,2927
3466,3791796585,3512282789,1672643296,1672646842,3546
3877,3905196766,3895285664,1672591462,1672593823,2361
3509,3780115155,3688490530,1672621082,1672621346,264
3686,3778667336,3515402792,1672629962,1672630802,840
3462,3534179433,3622665543,1672561630,1672562781,1151
3533,3737112297,3714827719,1672619294,1672620449,1155
3773,3760364383,3208452238,1672606663,1672608914,2251
3509,3618808151,3733363628,1672564991,1672567273,2282
3783,3631479562,3930242012,1672609601,1672610967,1366
3815,3272030610,3970603231,1672696505,1672700027,3522
3693,3920497528,3605221116,1672677323,1672679782,2459
3645,3792489602,3835985172,1672668488,1672671015,2527
3562,3792014516,3414049538,1672655105,1672657240,2135
3891,3519909393,3614740489,1672674285,1672674932,647
3603,3636329663,3701136026,1672553948,1672554491,543
3632,3701882224,3334647380,1672595513,1672597741,2228
3815,3713517039,3732584121,1672692204,1672694343,2139
3700,3793407963,3439673892,1672687425,1672690798,3373
3677,3791436104,3682133690,1672557908,1672559172,1264
3690,3760364383,3511601997,1672570212,1672570767,555
3718,3755065949,3631090677,1672592990,1672595303,2313
3625,3776034743,3248058676,1672673221,1672676470,3249
3671,3510767239,3501457103,1672681271,1672684283,3012
3424,3400763927,3774718695,1672668081,1672671644,3563
3790,3777091903,3630353876,1672683869,1672685219,1350
3448,3404025196,3715545685,1672631038,1672633849,2811
3475,3665998641,3760651515,1672585185,1672587205,2020
3622,3680843171,3520355798,1672696243,1672699746,3503
3466,3715400486,3510818674,1672533823,1672534319,496
3820,3615087943,3755915206,1672690539,1672690752,213
3514,3770624662,3792525861,1672607118,1672608703,1585
3536,3791441520,3710489491,1672635326,1672638197,2871
3593,3733363628,3479851674,1672597208,1672598813,1605
3873,3667673649,3683113954,1672596344,1672596956,612
3830,3448633776,3773572967,1672588669,1672592179,3510
3487,3893912331,3514971533,1672539413,1672541770,2357
3657,3814677862,3716272919,1672662469,1672664503,2034
3608,3410160376,3715086894,1672594048,1672594908,860
3428,3520578796,3792389522,1672582678,1672584574,1896
3781,3935399379,3220031931,1672677707,1672680790,3083
3796,3713979100,3773027597,1672689216,1672690327,1111
3647,3733558985,3682133690,1672635601,1672636275,674
3636,3491684096,3401793306,1672586228,1672587245,1017
3648,3777814504,3627368399,1672608717,1672610293,1576
3884,3227799827,3755158925,1672677321,1672678090,769
3541,3367111751,3271752081,1672691020,1672691265,245
3457,3814305099,3970558632,1672541097,1672544432,3335
3877,3688490530,3520578796,1672595537,1672597777,2240
3791,3463849738,3505847380,1672650255,1672651526,1271
3473,3684523966,3203538212,1672676422,1672678827,2405
3532,3934064792,3757318448,1672570611,1672572810,2199
3792,3512295534,3735374579,1672586908,1672588353,1445
3737,3305722859,3374183227,1672532425,1672534241,1816
3668,3757193551,3380767040,1672554239,1672555311,1072
3465,3417679834,3456430614,1672638984,1672642097,3113
3468,3835985172,3386758279,1672647791,1672649035,1244
3543,3357689359,3680843171,1672552610,1672554244,1634
3745,3272096759,3271454397,1672693884,1672695470,1586
3622,3510554314,3552824113,1672561956,1672562597,641
3723,3511150845,3780571086,1672648481,1672651374,2893
3505,3619922891,3519850727,1672643887,1672646170,2283
3566,3505923418,3618697021,1672644481,1672646847,2366
3719,3299125059,3760040019,1672665218,1672667649,2431
3453,3457960571,3615939504,1672531302,1672532985,1683
3446,3398198430,3448633776,1672679467,1672681534,2067
3738,3897134762,3400069268,1672648355,1672650952,2597
3620,3349739136,3554825448,1672623340,1672625211,1871
3666,3379143440,3615087943,1672592021,1672595014,2993
3526,3224811762,3279242917,1672640641,1672641546,905
3760,3488763230,3715086894,1672702732,1672703516,784
3466,3688220326,3516513251,1672532198,1672534612,2414
3599,3626499450,3401496246,1672624477,1672626234,1757
3898,3824215187,3853629553,1672678579,1672681990,3411
3497,3534543776,3815250107,1672689358,1672690682,1324
3809,3446533960,3608855425,1672629839,1672632392,2553
3660,3760721303,3757075324,1672578036,1672579084,1048
3627,3513360004,3519028898,1672604545,1672604700,155
3864,3760362417,3478114114,1672648777,1672649445,668
3829,3200543880,3739911441,1672589315,1672589561,246
3583,3402697190,3511883730,1672602499,1672603134,635
3489,3615087943,3519850727,1672647975,1672649165,1190
3583,3517462308,3492546679,1672633530,1672636675,3145
3783,3770624662,3511005395,1672632136,1672632889,753
3662,3715854030,3279473441,1672647032,1672650369,3337
3483,3757630221,3500915908,1672605883,1672606900,1017
3809,3451726367,3770438122,1672551567,1672554546,2979
3555,3394297564,3467988782,1672535850,1672539118,3268
3887,3512499658,3971806004,1672642407,1672645917,3510
3790,3310039260,3757383891,1672693428,1672694266,838
3543,3904569677,3714670620,1672554826,1672558110,3284
3424,3520578796,3519087371,1672677381,1672680644,3263
3452,3793740407,3756789525,1672534612,1672534702,90
3806,3452016771,3554186380,1672585317,1672587756,2439
3839,3713517039,3755532873,1672657845,1672661179,3334
3762,3713163045,3776988674,1672561185,1672564115,2930
3780,3383138270,3974674109,1672682011,1672683289,1278
3769,3467988782,3435167810,1672576309,1672579383,3074
3503,3661903000,3201676087,1672565686,1672566757,1071
3522,3773027597,3392520516,1672655740,1672658848,3108
3616,3357689359,3770296583,1672683653,1672687190,3537
3755,3246370118,3299781901,1672578214,1672581636,3422
3428,3904412440,3713768950,1672574109,1672577018,2909
3834,3757075324,3607882826,1672650486,1672652789,2303
3587,3557046880,3310039260,1672639324,1672640876,1552
3824,3505228454,3447514821,1672532882,1672533268,386
3456,3500442734,3900276517,1672597471,1672600483,3012
3568,3515466096,3791246640,1672697639,1672700906,3267
3893,3660887799,3970627281,1672635509,1672637978,2469
3474,3680810086,3779892400,1672674089,1672674661,572
3700,3509366311,3815392801,1672592753,1672592855,102
3744,3509756823,3520578796,1672615325,1672616536,1211
3865,3774243020,3400763927,1672602200,1672604878,2678
3465,3701823816,3884596900,1672680959,1672683580,2621
3813,3615113018,3858172636,1672678822,1672681362,2540
3535,3731646673,3513410578,1672568856,1672569166,310
3582,3512392431,3730071479,1672608821,1672609780,959
3844,3226511603,3921648519,1672687544,1672690507,2963
3892,3683113954,3898314440,1672664307,1672664891,584
3616,3892304880,3715400486,1672591473,1672592377,904
3893,3714233826,3513081354,1672645400,1672645823,423
3865,3334951866,3609659642,1672542551,1672545554,3003
3732,3511601997,3914691363,1672653195,1672656511,3316
3591,3783928182,3760924079,1672558210,1672558844,634
3541,3225029895,3380767040,1672611233,1672613220,1987
3618,3513296868,3395201292,1672553587,1672556062,2475
3621,3627368399,3783919913,1672588688,1672590102,1414
3684,3534179433,3714670620,1672668541,1672670147,1606
3679,3900898992,3836241528,1672691635,1672694551,2916
3741,3900945856,3519282716,1672633537,1672636035,2498
3633,3970909253,3714185969,1672638822,1672640237,1415
3630,3516741440,3280054198,1672614401,1672617246,2845
3630,3610870949,3791046864,1672649134,1672651366,2232
3654,3512337405,3715974659,1672656902,1672659049,2147
3514,3517222913,3533747868,1672703599,1672704638,1039
3901,3519077659,3513065217,1672679231,1672679460,229
3489,3935487534,3853629553,1672601620,1672604144,2524
3903,3512800570,3618489670,1672693686,1672694623,937
3804,3701882224,3316798920,1672531554,1672533622,2068
3696,3505521218,3730071479,1672658845,1672659607,762
3859,3431502855,3201800997,1672694302,1672695490,1188
3641,3757700712,3330340793,1672591223,1672593243,2020
3578,3803389195,3412968120,1672580096,1672581724,1628
3559,3515466096,3834963772,1672656534,1672657325,791
3481,3468041839,3467988782,1672695332,1672695426,94
3593,3534764451,3516298579,1672672866,1672675917,3051
3641,3756789525,3519651506,1672694518,1672695647,1129
3779,3897134762,3756746867,1672600671,1672603942,3271
3550,3906536154,3684523966,1672532854,1672535025,2171
3522,3514741348,3519909393,1672570847,1672572355,1508
3745,3755573472,3520355798,1672581847,1672581985,138
3548,3710562338,3660063072,1672543309,1672546554,3245
3771,3776244398,3300511067,1672565034,1672567212,2178
3843,3626499450,3201676087,1672675016,1672677145,2129
3472,3279473441,3615737355,1672603501,1672605717,2216
3754,3669146016,3505888598,1672623160,1672624918,1758
3436,3686227677,3970909253,1672559816,1672562553,2737
3748,3443357683,3780427126,1672535723,1672538321,2598
3575,3612689556,3490214516,1672613996,1672616307,2311
3489,3774605761,3757193307,1672533681,1672534966,1285
3904,3713941638,3410160376,1672592026,1672594055,2029
3708,3516903528,3509483172,1672558023,1672561097,3074
3766,3711077927,3241790910,1672568074,1672570277,2203
3734,3713829743,3770520359,1672634853,1672634921,68
3452,3463849738,3226024417,1672573041,1672574474,1433
3517,3779639983,3608922867,1672545745,1672549177,3432
3714,3777189898,3334993594,1672642306,1672644752,2446
3908,3715400486,3780427126,1672646263,1672647815,1552
3765,3760040019,3505154885,1672655939,1672656787,848
3474,3554825448,3201676087,1672615402,1672616079,677
3905,3979802715,3350095157,1672622127,1672623138,1011
3904,3510964997,3440107959,1672694047,1672696163,2116
3465,3617304541,3792745809,1672672284,1672672895,611
3745,3513295938,3514285803,1672574673,1672575830,1157
3431,3716110860,3608232640,1672534779,1672535805,1026
3628,3701884158,3368283077,1672672046,1672673916,1870
3706,3977148669,3500613459,1672567872,1672569490,1618
3671,3905899155,3382733096,1672544208,1672547623,3415
3445,3770468980,3714670620,1672533664,1672536753,3089
3456,3979784676,3481640525,1672673805,1672674021,216
3909,3248058676,3462273042,1672634590,1672634821,231
3454,3686227677,3533747868,1672612722,1672614712,1990
3496,3533423872,3792489602,1672632480,1672635141,2661
3584,3757700712,3923220461,1672635689,1672635972,283
3576,3772765746,3462158237,1672533014,1672534660,1646
3750,3829822608,3390660440,1672577775,1672578885,1110
3542,3517687662,3396726504,1672600019,1672601450,1431
3468,3514741348,3236354255,1672698688,1672699703,1015
3874,3899786664,3680810086,1672648373,1672650740,2367
3767,3970909253,3779613523,1672698711,1672700320,1609
3901,3608232640,3902760230,1672554254,1672557456,3202
3510,3505154885,3510641433,1672646618,1672649303,2685
3845,3509764635,3688796737,1672531539,1672533306,1767
3554,3715707380,3783771827,1672571209,1672572708,1499
3837,3760094385,3272716462,1672702516,1672702856,340
3667,3701247948,3392836218,1672680567,1672682457,1890
3625,3511005395,3448875382,1672532444,1672534125,1681
3836,3895285664,3440107959,1672657383,1672660581,3198
3836,3399518841,3271454397,1672611735,1672613605,1870
3821,3791613604,3933894942,1672685430,1672687241,1811
3774,3757332128,3639050419,1672580495,1672583477,2982
3662,3617116290,3921648519,1672585195,1672587061,1866
3540,3512830734,3294703680,1672630795,1672632524,1729
3558,3979784676,3703396825,1672631696,1672631887,191
3452,3559731671,3733558985,1672571444,1672573900,2456
3877,3272096759,3513345163,1672563620,1672564720,1100
3485,3756789525,3779532653,1672583880,1672586111,2231
3569,3755065949,3757383891,1672540921,1672544345,3424
3638,3711734586,3276003502,1672693284,1672696002,2718
3890,3510554314,3823084403,1672563174,1672564383,1209
3593,3398198430,3488763230,1672657463,1672658030,567
3477,3780571086,3511288998,1672638452,1672638630,178
3843,3408498208,3970627281,1672549475,1672550269,794
3615,3280054198,3792489602,1672606795,1672607289,494
3594,3400069268,3274906650,1672646518,1672649469,2951
3817,3409114719,3319167958,1672700628,1672702163,1535
3624,3615737355,3711006062,1672610879,1672613045,2166
3870,3505179890,3447672935,1672644094,1672646846,2752
3778,3439673892,3710048469,1672548882,1672550690,1808
3705,3429943738,3711734586,1672635528,1672635937,409
3491,3510818674,3200543880,1672610512,1672613324,2812
3787,3310039260,3916490839,1672700582,1672702051,1469
3464,3757348722,3516489668,1672630070,1672631462,1392
3671,3445206685,3362641275,1672592451,1672592745,294
3824,3760924079,3451726367,1672622365,1672625067,2702
3855,3480726047,3732131656,1672639527,1672640784,1257
3641,3615113018,3279475486,1672566096,1672567136,1040
3494,3224330592,3386758279,1672649444,1672652866,3422
3529,3885537225,3823084403,1672566240,1672567485,1245
3799,3711006062,3772078494,1672663656,1672666802,3146
3562,3357289672,3792525861,1672552941,1672555661,2720
3593,3519416013,3373028638,1672575129,1672576229,1100
3630,3311498666,3446533960,1672653669,1672656525,2856
3638,3777091903,3512830734,1672642655,1672643792,1137
3800,3716272919,3500341755,1672540435,1672540769,334
3590,3501384020,3972083617,1672539593,1672542545,2952
3523,3770146716,3713517039,1672665434,1672668873,3439
3737,3226178937,3970627281,1672697123,1672699952,2829
3508,3904569677,3617304541,1672649205,1672651995,2790
3848,3334974375,3493017654,1672576664,1672578267,1603
3526,3401793306,3533004959,1672659343,1672662871,3528
3599,3774907131,3226178937,1672595077,1672598226,3149
3752,3347419520,3511601997,1672596564,1672598488,1924
3914,3380982774,3460719322,1672658999,1672661884,2885
3803,3852686295,3668747074,1672589393,1672592902,3509
3491,3439673892,3791128487,1672676761,1672679602,2841
3772,3533228966,3448633776,1672666026,1672669073,3047
3734,3338390596,3226024417,1672577374,1672580520,3146
3664,3472068734,3834963772,1672541892,1672543510,1618
3572,3516741440,3824641227,1672598143,1672600083,1940
3831,3779465522,3451691949,1672546454,1672549589,3135
3465,3713911104,3505521218,1672593434,1672594515,1081
3764,3533929349,3500044458,1672671302,1672672620,1318
3817,3811040565,3201800997,1672607164,1672608192,1028
3753,3633735593,3835985172,1672563523,1672564805,1282
3714,3467988782,3517737088,1672584516,1672587194,2678
3495,3366423342,3462636434,1672564708,1672565811,1103
3905,3368283077,3635169815,1672558949,1672561852,2903
3910,3716110860,3505198734,1672576172,1672576397,225
3768,3977352557,3514703118,1672543964,1672545014,1050
3496,3511883730,3701136026,1672575645,1672576269,624
3861,3226511603,3600876425,1672570759,1672574340,3581
3649,3783136330,3638660068,1672660456,1672661938,1482
3922,3711637255,3615087943,1672604262,1672607529,3267
3517,3738026330,3400069268,1672546364,1672549550,3186
3785,3773837847,3462273042,1672550804,1672553993,3189
3912,3220031931,3783373154,1672659261,1672660190,929
3674,3429943738,3533929349,1672654529,1672655723,1194
3525,3366423342,3449639012,1672629446,1672629970,524
3505,3661583097,3229974066,1672580102,1672581761,1659
3656,3667673649,3480726047,1672557336,1672559335,1999
3587,3755573472,3478114114,1672602408,1672604236,1828
3770,3520416075,3452016771,1672571444,1672574024,2580
3523,3500498112,3534357694,1672552676,1672555701,3025
3873,3938503547,3501567772,1672548734,1672550531,1797
3621,3334647380,3902625986,1672533444,1672535406,1962
3643,3520764926,3534829213,1672585728,1672587065,1337
3852,3885537225,3336627643,1672674838,1672678420,3582
3687,3770146716,3334993594,1672531820,1672532365,545
3880,3686227677,3436257398,1672565216,1672567031,1815
3853,3665998641,3230135532,1672612137,1672612870,733
3784,3512337405,3734451191,1672631155,1672632579,1424
3744,3512502036,3739895284,1672683491,1672684327,836
3456,3855583256,3335694356,1672698582,1672700829,2247
3500,3614740489,3224968597,1672639750,1672642875,3125
3780,3402697190,3367111751,1672658007,1672658610,603
3751,3713768950,3885157459,1672609760,1672613152,3392
3836,3402697190,3897134762,1672621346,1672624247,2901
3690,3778134418,3904569677,1672654699,1672657676,2977
3619,3509756823,3734915241,1672663368,1672665828,2460
3639,3511732493,3491684096,1672686891,1672687941,1050
3472,3518653080,3500777439,1672554922,1672556662,1740
3826,3520355798,3780680950,1672537421,1672540089,2668
3868,3615939504,3554944414,1672678759,1672680904,2145
3714,3938389661,3518229776,1672546293,1672547158,865
3506,3500302272,3818575661,1672574904,1672576706,1802
3846,3777694660,3736231757,1672670407,1672673709,3302
3577,3534175249,3511024016,1672604864,1672604933,69
3627,3279339278,3605221116,1672654487,1672655102,615
3683,3500604680,3456430614,1672613000,1672614915,1915
3613,3800257590,3783433404,1672638145,1672639138,993
3559,3760640999,3803517637,1672624764,1672625210,446
3748,3435167810,3701247948,1672694066,1672696415,2349
3772,3757318448,3600876425,1672694205,1672696934,2729
3896,3519416013,3517697722,1672686500,1672686672,172
3766,3510028805,3511732493,1672614345,1672614464,119
3882,3209481722,3510642075,1672690519,1672693234,2715
3648,3711919537,3773913680,1672648496,1672651329,2833
3842,3714678331,3512379024,1672687349,1672689702,2353
3729,3201629017,3299125059,1672552403,1672555568,3165
3916,3510187271,3556969573,1672663325,1672666920,3595
3668,3686227677,3777240360,1672644373,1672647220,2847
3650,3776034743,3683113954,1672624123,1672625995,1872
3569,3272096759,3441348818,1672534866,1672536731,1865
3886,3513360004,3283144118,1672541659,1672544357,2698
3919,3756746867,3500915908,1672603489,1672603940,451
3742,3760362417,3457620713,1672570191,1672572726,2535
3466,3288224595,3518194482,1672604195,1672607492,3297
3642,3488763230,3517358573,1672670144,1672673486,3342
3753,3514703118,3519416013,1672556765,1672557190,425
3801,3900945856,3289114629,1672548511,1672550344,1833
3906,3311420950,3778040015,1672554678,1672556340,1662
3799,3734118023,3821054646,1672664105,1672666791,2686
3804,3638660068,3500341755,1672620850,1672621160,310
3827,3683113954,3515525630,1672602768,1672604258,1490
3864,3551376095,3417191856,1672643326,1672643973,647
3791,3511150845,3757630221,1672671610,1672673300,1690
3563,3715986185,3511843593,1672607735,1672610127,2392
3841,3515525630,3338083680,1672582818,1672584983,2165
3700,3770704999,3519909393,1672562774,1672566223,3449
3586,3511288998,3279475486,1672553868,1672554122,254
3790,3384068080,3661583097,1672597311,1672598533,1222
3598,3757193307,3791106564,1672676478,1672678518,2040
3666,3533079336,3224811762,1672573838,1672574173,335
3620,3376467719,3701884158,1672648899,1672650814,1915
3850,3357864626,3401793306,1672557025,1672559265,2240
3737,3972083617,3518229776,1672535571,1672539120,3549
3487,3311098437,3793969543,1672613144,1672615017,1873
3922,3902760230,3451691949,1672621584,1672624044,2460
3682,3500302272,3756746867,1672566061,1672567244,1183
3831,3460719322,3201800997,1672658925,1672660912,1987
3587,3621790707,3236354255,1672697048,1672698193,1145
3426,3512337405,3715443333,1672641422,1672641662,240
3582,3818575661,3492959689,1672537233,1672538178,945
3641,3902760230,3366423342,1672567806,1672571263,3457
3767,3514419100,3855583256,1672644559,1672645990,1431
3618,3760364383,3386758279,1672607386,1672610315,2929
3655,3415833929,3412006598,1672663813,1672665124,1311
3644,3780115155,3774290799,1672547332,1672548986,1654
3447,3516321888,3341893384,1672563955,1672567300,3345
3653,3714120857,3492959689,1672567796,1672569030,1234
3575,3701664364,3202804048,1672552393,1672552521,128
3617,3236354255,3347446226,1672538801,1672539974,1173
3729,3224811762,3703798634,1672666414,1672668174,1760
3438,3205985903,3363162590,1672540505,1672544025,3520
3775,3357289672,3791128487,1672557153,1672559394,2241
3469,3205985903,3505434346,1672613323,1672615161,1838
3768,3500347447,3607882826,1672676649,1672678465,1816
3620,3505663516,3240994288,1672536530,1672538318,1788
3510,3273981374,3689697817,1672610270,1672612999,2729
3534,3510642075,3316798920,1672533672,1672534840,1168
3582,3972083617,3780427126,1672678927,1672681398,2471
3521,3533423872,3505228454,1672552321,1672555544,3223
3630,3500777439,3343132529,1672593919,1672594800,881
3598,3803517637,3779438325,1672637141,1672639069,1928
3616,3710315160,3304155815,1672594580,1672597442,2862
3709,3500208903,3688796737,1672536803,1672540360,3557
3637,3304971369,3439673892,1672681768,1672684348,2580
3877,3800257590,3414049538,1672556446,1672556683,237
3520,3756625818,3310125159,1672699342,1672702545,3203
3437,3925979970,3885155975,1672626237,1672627042,805
3578,3341893384,3469254160,1672531785,1672534117,2332
3821,3518194482,3780571086,1672601908,1672602968,1060
3836,3793969543,3487875183,1672607531,1672611039,3508
3725,3685681577,3834963772,1672566473,1672567664,1191
3652,3792505974,3509893027,1672636810,1672637112,302
3911,3737112297,3739661856,1672545461,1672546129,668
3585,3715385401,3517887477,1672662178,1672665579,3401
3794,3757903168,3451691949,1672684164,1672687232,3068
3559,3509366311,3554944414,1672539733,1672539799,66
3913,3367971170,3402697190,1672541999,1672542915,916
3886,3970558632,3791046864,1672567081,1672568820,1739
3828,3279473441,3711097754,1672671875,1672675262,3387
3638,3791046864,3814305099,1672543277,1672546689,3412
3857,3224811762,3800257590,1672687772,1672690611,2839
3505,3201800997,3533747868,1672605146,1672608507,3361
3703,3343132529,3516741440,1672578309,1672580338,2029
3788,3778597171,3551389192,1672578209,1672580920,2711
3851,3731646673,3923754072,1672550764,1672551349,585
3434,3715986185,3505111292,1672635067,1672636579,1512
3744,3505111292,3829864515,1672686816,1672687235,419
3738,3923754072,3779532653,1672573486,1672573964,478
3724,3412006598,3774907131,1672648614,1672651898,3284
3734,3500317969,3711000597,1672618932,1672621193,2261
3908,3701884158,3977352557,1672610236,1672612423,2187
3869,3519028898,3354144091,1672609237,1672612147,2910
3508,3701664364,3300229945,1672572301,1672572808,507
3721,3512392431,3780834916,1672702146,1672704504,2358
3821,3858172636,3202804048,1672684492,1672686049,1557
3489,3779646172,3710735406,1672573447,1672575177,1730
3686,3279475486,3779646172,1672560195,1672563313,3118
3464,3514818819,3680843171,1672576671,1672580216,3545
3551,3621790707,3238288884,1672695747,1672698366,2619
3780,3711218296,3635169815,1672664277,1672667518,3241
3830,3701884158,3551389192,1672693812,1672694660,848
3589,3701136026,3228888030,1672663441,1672663760,319
3773,3710854064,3511791953,1672668565,1672671987,3422
3494,3889780657,3511791953,1672616263,1672618770,2507
3690,3920625129,3779738691,1672637896,1672640664,2768
3620,3410160376,3631479562,1672558001,1672559200,1199
3656,3225631197,3478114114,1672672739,1672673251,512
3469,3898314440,3519446663,1672563153,1672565136,1983
3809,3469254160,3791753345,1672603935,1672605295,1360
3491,3760364383,3814305099,1672629772,1672632100,2328
3517,3760721303,3615087943,1672541891,1672545345,3454
3652,3501281016,3480991549,1672701228,1672702258,1030
3513,3780427126,3468041839,1672574059,1672574273,214
3797,3779613523,3902760230,1672632333,1672632972,639
3761,3607768197,3457620713,1672625910,1672629073,3163
3826,3793407963,3778926763,1672659459,1672660911,1452
3690,3380767040,3505847380,1672598965,1672601564,2599
3720,3513041785,3778597171,1672562848,1672564223,1375
3799,3774155692,3364378127,1672665448,1672666053,605
3646,3714120857,3533294425,1672602294,1672603620,1326
3808,3514956366,3431502855,1672593971,1672595895,1924
3451,3791693821,3715400486,1672645029,1672646838,1809
3516,3710048469,3354144091,1672642426,1672642977,551
3795,3347446226,3778597171,1672669203,1672670098,895
3565,3517881647,3410160376,1672618667,1672622121,3454
3524,3463740710,3459681410,1672645107,1672647211,2104
3624,3479851674,3435167810,1672565359,1672567386,2027
3887,3519087371,3311420950,1672688726,1672690144,1418
3736,3778134418,3441703884,1672534561,1672537645,3084
3504,3510837901,3505437712,1672662910,1672666185,3275
3696,3396726504,3551399764,1672687979,1672690575,2596
3603,3480490124,3206837348,1672572905,1672574347,1442
3807,3701136026,3501786419,1672700337,1672702778,2441
3633,3512379024,3505888598,1672656692,1672660242,3550
3509,3739911441,3552824113,1672591577,1672595038,3461
3768,3230868435,3289817992,1672543576,1672544280,704
3506,3755222916,3519087371,1672616886,1672617916,1030
3766,3703433819,3859868849,1672546981,1672550294,3313
3881,3930242012,3291933594,1672671076,1672673284,2208
3491,3513041785,3501786419,1672661788,1672662614,826
3676,3757332128,3438078818,1672596147,1672596926,779
3853,3480726047,3228888030,1672683513,1672686455,2942
3550,3411515369,3519818818,1672586301,1672587382,1081
3661,3710854064,3665998641,1672541996,1672543470,1474
3835,3330340793,3428027649,1672681786,1672683280,1494
3857,3299781901,3715854030,1672619043,1672620534,1491
3471,3440137407,3638204468,1672566753,1672566937,184
3908,3364378127,3272716462,1672688797,1672689565,768
3705,3777779869,3621683102,1672683033,1672684976,1943
3656,3245232284,3515890966,1672553870,1672554608,738
3640,3661447322,3206837348,1672645094,1672647938,2844
3600,3509366311,3773572967,1672653007,1672653589,582
3552,3505402439,3366423342,1672566074,1672569556,3482
3785,3938503547,3316800320,1672653384,1672656261,2877
3735,3421385957,3683113954,1672571640,1672574455,2815
3777,3517600136,3792745809,1672538119,1672539033,914
3535,3431460073,3224330592,1672621104,1672621921,817
3494,3713941638,3411688875,1672620242,1672621629,1387
3665,3730071479,3533649454,1672673535,1672676957,3422
3598,3713784974,3615115210,1672548313,1672548878,565
3548,3793743698,3335694356,1672611451,1672614232,2781
3539,3289817992,3514246749,1672614857,1672614966,109
3867,3779738691,3778640261,1672624567,1672626364,1797
3592,3625174002,3517600136,1672544604,1672547146,2542
3784,3755915206,3772078494,1672559299,1672561875,2576
3597,3447672935,3807212280,1672589793,1672590101,308
3442,3755756564,3774705415,1672589339,1672591077,1738
3686,3492959689,3615087943,1672652554,1672654002,1448
3708,3777184389,3902625986,1672684783,1672687011,2228
3744,3783919913,3517222913,1672622878,1672626178,3300
3910,3780209375,3515401243,1672692054,1672694354,2300
3676,3935913584,3509483172,1672559738,1672560791,1053
3882,3467779445,3793743698,1672671243,1672672550,1307
3484,3773913680,3779639983,1672658386,1672660742,2356
3606,3417679834,3668747074,1672620555,1672623690,3135
3473,3757332128,3733558985,1672549101,1672550839,1738
3521,3520322124,3481640525,1672590089,1672591637,1548
3680,3510767239,3618697021,1672576748,1672580102,3354
3835,3449333754,3467779445,1672692419,1672692529,110
3491,3411688875,3510499038,1672672520,1672672771,251
3729,3891672228,3885157459,1672581806,1672585176,3370
3628,3783771827,3231713082,1672540739,1672542757,2018
3544,3736705719,3780322355,1672648642,1672650213,1571
3739,3520657891,3440107959,1672703004,1672704257,1253
3694,3513041785,3238288884,1672551689,1672552854,1165
3616,3625174002,3209526819,1672597672,1672599560,1888
3782,3403370192,3461119815,1672599141,1672601076,1935
3811,3311420950,3429943738,1672597561,1672599193,1632
3465,3510554314,3520322124,1672622652,1672625945,3293
3559,3776244398,3770146716,1672585583,1672589054,3471
3837,3783169442,3274906650,1672574547,1672575426,879
3730,3713768950,3780680950,1672571957,1672574681,2724
3666,3856606678,3770236215,1672663012,1672666519,3507
3479,3330340793,3701322924,1672654063,1672656689,2626
3844,3414049538,3500915665,1672617858,1672618744,886
3544,3817813340,3734451191,1672574781,1672575314,533
3608,3334951866,3755737419,1672690987,1672691084,97
3856,3792801638,3688796737,1672575904,1672578005,2101
3574,3783147088,3776831527,1672593109,1672594612,1503
3599,3517172354,3559458968,1672695312,1672698572,3260
3906,3374183227,3783550022,1672654183,1672654633,450
3575,3977352557,3279242917,1672621870,1672623377,1507
3439,3500498112,3609933747,1672642254,1672643475,1221
3914,3416987084,3401496246,1672629107,1672630641,1534
3599,3382733096,3270056120,1672595639,1672597432,1793
3578,3792020993,3801645328,1672617081,1672620515,3434
3703,3619922891,3783771827,1672569473,1672571660,2187
3782,3920625129,3289817992,1672698323,1672699542,1219
3708,3783169442,3505283390,1672531332,1672532834,1502
3840,3276269264,3513327337,1672586800,1672588367,1567
3873,3231713082,3439673892,1672660766,1672663787,3021
3702,3780338697,3349739136,1672579570,1672580386,816
3808,3441703884,3270042456,1672532029,1672532593,564
3609,3783520186,3520764926,1672643849,1672644538,689
3748,3760924079,3833217041,1672590132,1672591446,1314
3605,3776559988,3271752081,1672609553,1672612856,3303
3482,3626499450,3510028805,1672569724,1672570214,490
3583,3392943173,3711097754,1672620592,1672623742,3150
3802,3783928182,3779854934,1672580330,1672581648,1318
3728,3610358027,3935913584,1672700576,1672703049,2473
3739,3533649454,3534764451,1672703137,1672704423,1286
3514,3408498208,3792546035,1672654518,1672655186,668
3668,3779892400,3614740489,1672579120,1672579821,701
3498,3793743698,3478114114,1672671350,1672672024,674
3488,3821054646,3773124276,1672658062,1672658172,110
3820,3513853403,3316798920,1672599756,1672602602,2846
3430,3517462308,3306412634,1672694013,1672694823,810
3447,3513296868,3231713082,1672580878,1672581394,516
3558,3755915206,3793407963,1672540866,1672541723,857
3688,3505807416,3780571086,1672534541,1672534635,94
3562,3311085279,3755230952,1672681183,1672684746,3563
3488,3533649454,3779639983,1672567131,1672568953,1822
3854,3505847380,3417191856,1672585993,1672586448,455
3789,3689114185,3232208416,1672565489,1672566913,1424
3721,3533649454,3880926355,1672544879,1672545532,653
3524,3520322124,3516903528,1672572472,1672573039,567
3748,3773121782,3276348699,1672605923,1672608571,2648
3791,3801645328,3201800997,1672566471,1672569788,3317
3451,3812534508,3226511603,1672606270,1672607076,806
3429,3244004456,3778134418,1672565308,1672567200,1892
3466,3273981374,3792489602,1672610351,1672611562,1211
3889,3713561276,3500949309,1672615216,1672617334,2118
3703,3780338697,3309314379,1672606703,1672608609,1906
3489,3421877923,3284947372,1672589049,1672590657,1608
3810,3737972328,3701136026,1672579954,1672582374,2420
3519,3512282789,3408430195,1672597654,1672600535,2881
3792,3834631333,3492959689,1672636720,1672638977,2257
3519,3519028898,3225636215,1672599072,1672601980,2908
3490,3500737582,3272030610,1672701673,1672702690,1017
3628,3834960360,3403370192,1672593909,1672596505,2596
3907,3613581796,3610358027,1672620029,1672622562,2533
3820,3517687662,3757193551,1672578603,1672580067,1464
3761,3334647380,3774605761,1672604481,1672607426,2945
3701,3776831527,3817428320,1672615308,1672618485,3177
3506,3362641275,3792949946,1672655304,1672655634,330
3517,3512946768,3412006598,1672676401,1672678074,1673
3907,3609881958,3296462324,1672585046,1672585239,193
3451,3757294769,3457960571,1672632054,1672634713,2659
3861,3611055563,3394401087,1672683626,1672684912,1286
3836,3514703118,3621790707,1672546244,1672546584,340
3662,3613338363,3520322124,1672633499,1672635444,1945
3855,3970603231,3928511283,1672625900,1672627034,1134
3638,3889780657,3618697021,1672566468,1672567476,1008
3536,3928719932,3710008361,1672614576,1672617868,3292
3845,3436025562,3276217799,1672654411,1672657084,2673
3501,3778597171,3617392620,1672621666,1672624861,3195
3846,3202141727,3534829213,1672600859,1672602300,1441
3761,3512958459,3472312341,1672613989,1672615154,1165
3638,3338390596,3898314440,1672644144,1672647056,2912
3665,3818575661,3770704999,1672681442,1672682365,923
3776,3792489602,3431460073,1672568015,1672570016,2001
3571,3711006062,3520181148,1672551580,1672551914,334
3875,3614740489,3205985903,1672666719,1672668253,1534
3787,3305722859,3312998540,1672703031,1672705933,2902
3631,3891672228,3336339664,1672633083,1672634050,967
3744,3638660068,3349739136,1672684581,1672687425,2844
3595,3635169815,3774718695,1672606017,1672606909,892
3693,3395201292,3909094917,1672635615,1672636000,385
3790,3505402439,3501786419,1672692342,1672695401,3059
3909,3803517637,3615113018,1672532818,1672534091,1273
3701,3517590837,3904867554,1672554694,1672555137,443
3626,3436025562,3711006062,1672574237,1672577754,3517
3913,3689114185,3793781065,1672550215,1672553047,2832
3790,3505995057,3417191856,1672622700,1672623088,388
3525,3229822507,3633735593,1672698637,1672700435,1798
3584,3512800570,3774605761,1672594366,1672594762,396
3566,3511791953,3224811762,1672630915,1672632038,1123
3778,3773572967,3779532653,1672674422,1672675238,816
3469,3757193551,3500777439,1672551612,1672553631,2019
3448,3517881647,3792389522,1672670967,1672673341,2374
3434,3518653080,3375449013,1672649435,1672649963,528
3451,3288224595,3534543776,1672575697,1672578545,2848
3829,3757332128,3245232284,1672631684,1672632213,529
3533,3500915665,3368283077,1672607852,1672609739,1887
3522,3885157459,3858172636,1672599493,1672599932,439
3671,3793407963,3416987084,1672544675,1672547261,2586
3732,3500525825,3760721303,1672667912,1672669886,1974
3789,3852533643,3512383699,1672603704,1672607121,3417
3525,3613338363,3431460073,1672699270,1672700482,1212
3527,3505283390,3303410628,1672573783,1672575386,1603
3918,3770236215,3852533643,1672633199,1672633471,272
3823,3710489491,3710854064,1672583995,1672584978,983
3917,3447514821,3920898925,1672662479,1672664883,2404
3742,3774718695,3710562338,1672549351,1672549742,391
3656,3472312341,3821054646,1672533936,1672537313,3377
3590,3793781065,3701884158,1672569961,1672570215,254
3778,3756789525,3300818269,1672589691,1672589787,96
3753,3610358027,3520560590,1672540377,1672542620,2243
3573,3479851674,3625174002,1672664948,1672665153,205
3570,3892304880,3792546035,1672572257,1672573861,1604
3909,3714067076,3513345163,1672609874,1672610769,895
3623,3500915665,3757630221,1672697919,1672700769,2850
3819,3793969543,3552824113,1672647072,1672649131,2059
3870,3755532873,3230868435,1672678311,1672678429,118
3524,3607882826,3713691388,1672579775,1672583120,3345
3468,3710562338,3711734586,1672630954,1672633156,2202
3620,3710854064,3296462324,1672532021,1672534011,1990
3636,3451691949,3774705415,1672610452,1672612903,2451
3726,3757332128,3436257398,1672581690,1672584533,2843
3844,3773572967,3979802715,1672564388,1672565414,1026
3705,3738026330,3714827719,1672663605,1672664775,1170
3696,3773735484,3703139663,1672692316,1672694650,2334
3789,3829822608,3534175249,1672589067,1672590445,1378
3667,3772765746,3779465522,1672695806,1672698754,2948
3512,3491684096,3770520359,1672640353,1672641340,987
3574,3755756564,3618697021,1672560480,1672560820,340
3791,3739154408,3517881647,1672583611,1672587059,3448
3871,3392943173,3757700712,1672627284,1672630696,3412
3800,3289817992,3310125159,1672622011,1672624927,2916
3669,3375449013,3517881647,1672629212,1672629520,308
3649,3517881647,3480100311,1672595361,1672598638,3277
3742,3774641380,3716679950,1672569545,1672572801,3256
3716,3288224595,3515559913,1672634272,1672634687,415
3858,3360813161,3755344363,1672624240,1672626583,2343
3431,3975717896,3613581796,1672690066,1672692580,2514
3560,3412006598,3505521218,1672535347,1672538502,3155
3849,3615939504,3335694356,1672690598,1672693202,2604
3556,3304155815,3927165965,1672605940,1672608595,2655
3612,3203538212,3776559988,1672662462,1672663315,853
3525,3621683102,3515559913,1672683401,1672686021,2620
3692,3533649454,3296462324,1672685602,1672687723,2121
3634,3974674109,3710489491,1672610949,1672611207,258
3801,3701823816,3714666884,1672631736,1672632524,788
3426,3972083617,3481640525,1672658507,1672659523,1016
3527,3368283077,3480991549,1672669477,1672671335,1858
3673,3757193307,3520115090,1672627280,1672630135,2855
3491,3517737088,3505995057,1672657025,1672659019,1994
3852,3855583256,3739895284,1672608688,1672610705,2017
3829,3505807416,3783340788,1672559175,1672562186,3011
3546,3710562338,3831586487,1672576419,1672579051,2632
3625,3703139663,3408430195,1672606790,1672607704,914
3574,3534566651,3373028638,1672546219,1672547911,1692
3786,3510964997,3737972328,1672540248,1672542834,2586
3663,3300229945,3279473441,1672653360,1672656727,3367
3467,3511442562,3330340793,1672622894,1672624168,1274
3875,3514308235,3977352557,1672702930,1672703552,622
3830,3615087943,3201800997,1672695948,1672696593,645
3796,3509366311,3291933594,1672697720,1672697999,279
3532,3514324011,3429943738,1672547546,1672550196,2650
3501,3500709774,3714666884,1672665959,1672666668,709
3771,3500604680,3802932312,1672532858,1672534958,2100
3730,3777189898,3755222916,1672646963,1672648307,1344
3892,3701823816,3311098437,1672590968,1672594057,3089
3793,3778926763,3520639768,1672697567,1672700995,3428
3913,3511317276,3734451191,1672679873,1672681469,1596
3626,3347419520,3403370192,1672585899,1672586490,591
3617,3914691363,3511843593,1672664337,1672664649,312
3868,3755737419,3510642075,1672700897,1672702882,1985
3693,3347419520,3834631333,1672543795,1672547298,3503
3906,3714233826,3374183227,1672648781,1672652126,3345
3814,3472068734,3360616538,1672690654,1672694025,3371
3471,3226178937,3402697190,1672588333,1672589962,1629
3464,3618354185,3618808151,1672548531,1672551089,2558
3583,3383138270,3505228454,1672672433,1672672777,344
3644,3304971369,3401496246,1672536958,1672539610,2652
3885,3311098437,3371455553,1672570293,1672572878,2585
3890,3478114114,3552824113,1672540247,1672541882,1635
3888,3715619259,3971806004,1672564160,1672567007,2847
3560,3280268483,3779892400,1672536986,1672538877,1891
3424,3393063657,3271752081,1672579688,1672582880,3192
3534,3791246640,3737147209,1672586568,1672588114,1546
3732,3703348097,3446533960,1672579978,1672582810,2832
3728,3710496785,3773027597,1672656574,1672658173,1599
3788,3468041839,3801645328,1672633171,1672633544,373
3515,3885155975,3513296868,1672604241,1672606456,2215
3552,3778926763,3815392801,1672588066,1672591275,3209
3472,3856606678,3884596900,1672544856,1672548303,3447
3759,3500737582,3821054646,1672589217,1672592002,2785
3917,3778040015,3780115155,1672592119,1672592990,871
3775,3513018485,3621461051,1672586580,1672588106,1526
3463,3513545422,3514246749,1672638098,1672641014,2916
3807,3760924079,3610358027,1672683346,1672686380,3034
3613,3817428320,3760640999,1672703399,1672704424,1025
3538,3520416075,3229822507,1672629157,1672631620,2463
3750,3475349791,3819767045,1672661018,1672662469,1451
3440,3519142371,3928719932,1672581993,1672584305,2312
3905,3711853996,3716110860,1672551722,1672553910,2188
3460,3622665543,3975717896,1672642309,1672643751,1442
3713,3777147510,3791436104,1672550351,1672551106,755
3750,3780834916,3685816610,1672692118,1672695549,3431
3512,3970603231,3279242917,1672683661,1672687080,3419
3522,3774718695,3916490839,1672698128,1672701217,3089
3742,3773009828,3509366311,1672574667,1672575970,1303
3536,3900945856,3511288998,1672678688,1672679365,677
3637,3373089838,3926643445,1672657203,1672660319,3116
3607,3912891315,3448633776,1672698690,1672700576,1886
3778,3310125159,3509893027,1672559263,1672562684,3421
3866,3510818674,3518565331,1672622558,1672623382,824
3576,3421385957,3492959689,1672628504,1672628685,181
3559,3780571086,3760694096,1672582926,1672586228,3302
3557,3457620713,3505228454,1672662602,1672665265,2663
3873,3226178937,3351866415,1672553087,1672556596,3509
3706,3773735484,3716628503,1672652143,1672655599,3456
3735,3921648519,3534764451,1672570426,1672571284,858
3910,3979802715,3298151889,1672573550,1672577040,3490
3664,3441703884,3920625129,1672620546,1672623612,3066
3703,3512392431,3760842815,1672572545,1672572695,150
3517,3926643445,3490029863,1672555929,1672556074,145
3893,3661583097,3780872464,1672571634,1672574504,2870
3677,3900276517,3613581796,1672603301,1672604442,1141
3463,3511024016,3701373490,1672557582,1672558457,875
3911,3812369928,3850911686,1672693186,1672696164,2978
3481,3276348699,3500341755,1672537407,1672540584,3177
3679,3757630221,3714666884,1672553120,1672553757,637
3755,3515401243,3756474459,1672595290,1672598393,3103
3450,3472068734,3733363628,1672578569,1672579920,1351
3643,3424445495,3755344363,1672641338,1672643089,1751
3864,3774243020,3490029863,1672534569,1672537114,2545
3517,3793922324,3635169815,1672678483,1672679131,648
3773,3225636215,3774876004,1672562467,1672563576,1109
3892,3715086894,3435116799,1672696724,1672697429,705
3429,3392836218,3760640999,1672586577,1672588000,1423
3641,3510964997,3715986185,1672584644,1672585115,471
3700,3516513251,3715854030,1672561710,1672564887,3177
3871,3714185969,3500949309,1672550545,1672550761,216
3663,3713691388,3337322736,1672695934,1672696026,92
3805,3396980894,3613899351,1672679558,1672681829,2271
3579,3225631197,3505888598,1672624678,1672627305,2627
3894,3701882224,3792949946,1672677941,1672678563,622
3515,3500498112,3626499450,1672571387,1672573181,1794
3485,3757318448,3824641227,1672570543,1672571722,1179
3526,3714120857,3791046864,1672550801,1672552218,1417
3840,3792949946,3450969839,1672698493,1672700187,1694
3877,3374183227,3396726504,1672566881,1672567237,356
3742,3468041839,3791106564,1672549720,1672549833,113
3745,3920625129,3270042456,1672678814,1672681352,2538
3717,3271752081,3238288884,1672608223,1672609074,851
3723,3714827719,3979784676,1672701332,1672704059,2727
3491,3499217428,3505888598,1672649503,1672651176,1673
3833,3501525100,3491684096,1672666812,1672669064,2252
3606,3755158925,3271752081,1672598972,1672599395,423
3648,3756746867,3774605761,1672593549,1672596222,2673
3511,3491684096,3467779445,1672568135,1672571363,3228
3667,3520657891,3713784974,1672697260,1672699528,2268
3792,3518653080,3609881958,1672672563,1672675837,3274
3675,3513081354,3701424609,1672587801,1672590005,2204
3574,3511601997,3491469603,1672694266,1672696913,2647
3825,3385323994,3825881598,1672571125,1672572017,892
3446,3617304541,3791753345,1672577260,1672577959,699
3596,3713768950,3923420131,1672596091,1672597572,1481
3756,3456430614,3333918941,1672574919,1672577429,2510
3579,3791693821,3792489602,1672658080,1672658960,880
3683,3462158237,3501384020,1672557817,1672558643,826
3908,3604589802,3401496246,1672692908,1672694045,1137
3852,3470454332,3821054646,1672687444,1672688590,1146
3762,3509764635,3773939399,1672588721,1672589603,882
3676,3304971369,3534126409,1672568315,1672570966,2651
3424,3711637255,3500709774,1672593333,1672595870,2537
3734,3760721303,3613338363,1672556137,1672556722,585
3735,3770704999,3774907131,1672624488,1672627946,3458
3919,3500777439,3374183227,1672657600,1672658768,1168
3560,3824215187,3533929349,1672612713,1672616249,3536
3703,3515525630,3514818819,1672630511,1672630591,80
3825,3770520359,3770438122,1672673433,1672675666,2233
3675,3739911441,3639050419,1672692438,1672694068,1630
3605,3398731252,3451326054,1672545948,1672546181,233
3600,3225631197,3685681577,1672674730,1672676836,2106
3613,3392520516,3668414677,1672540240,1672542776,2536
3538,3710315160,3783641602,1672670410,1672671660,1250
3620,3511442562,3402697190,1672654629,1672654832,203
3670,3780209375,3783147088,1672703095,1672706416,3321
3459,3220031931,3360069849,1672572637,1672573774,1137
3774,3463740710,3226511603,1672536780,1672537748,968
3816,3514308235,3970558632,1672659539,1672662400,2861
3630,3380982774,3821054646,1672636630,1672640221,3591
3792,3440107959,3501567772,1672586481,1672588782,2301
3792,3625463628,3780253901,1672568020,1672569300,1280
3777,3609113156,3833217041,1672597691,1672598529,838
3739,3220031931,3783520186,1672618399,1672621056,2657
3833,3505995057,3757075324,1672545737,1672548626,2889
3810,3624297844,3414049538,1672585861,1672588597,2736
3452,3516741440,3780680950,1672555576,1672558691,3115
3605,3713691388,3347419520,1672608662,1672611948,3286
3700,3487875183,3202804048,1672665516,1672665853,337
3734,3737112297,3497095254,1672613302,1672613388,86
3812,3622357348,3714233826,1672685100,1672687394,2294
3703,3737972328,3902861231,1672618445,1672618621,176
3617,3241790910,3618176292,1672563001,1672566599,3598
3771,3510641433,3880926355,1672628407,1672630596,2189
3854,3438489358,3512722110,1672677457,1672678362,905
3706,3902861231,3826238375,1672602401,1672602959,558
3602,3349856820,3411688875,1672548814,1672549826,1012
3721,3316798920,3710854064,1672623719,1672626070,2351
3632,3617116290,3272096759,1672668669,1672671574,2905
3642,3627368399,3300511067,1672629304,1672631009,1705
3513,3713941638,3294747828,1672561275,1672564823,3548
3566,3760263530,3480991549,1672664520,1672667893,3373
3461,3615737355,3462158237,1672691013,1672692954,1941
3776,3500525825,3618176292,1672644716,1672645166,450
3786,3449333754,3921648519,1672664770,1672666608,1838
3891,3777091903,3470454332,1672555979,1672557188,1209
3557,3417679834,3834631333,1672674105,1672677667,3562
3620,3850911686,3387594369,1672556796,1672558658,1862
3868,3801645328,3793868716,1672670975,1672672416,1441
3857,3732131656,3779301501,1672647024,1672650613,3589
3734,3730071479,3517600136,1672636180,1672638548,2368
3693,3776034743,3714666884,1672599266,1672602574,3308
3603,3701107228,3200308999,1672542423,1672542842,419
3690,3505402439,3779738691,1672697383,1672699762,2379
3643,3612689556,3614740489,1672536984,1672538413,1429
3786,3715545685,3273981374,1672672310,1672673301,991
3754,3608922867,3516489668,1672664775,1672665989,1214
3888,3711637255,3897435944,1672652598,1672654781,2183
3908,3938503547,3312998540,1672694478,1672697817,3339
3724,3351866415,3661447322,1672663548,1672663928,380
3440,3236499444,3780472203,1672675898,1672678275,2377
3792,3513360004,3316800320,1672649184,1672651233,2049
3659,3612689556,3518561777,1672556328,1672558981,2653
3491,3315703693,3713784974,1672656106,1672657968,1862
3474,3774705415,3505266860,1672650444,1672653438,2994
3541,3306412634,3394401087,1672669495,1672672214,2719
3711,3533423872,3500613493,1672543325,1672545586,2261
3902,3774790271,3517881647,1672614413,1672615487,1074
3789,3898314440,3276003502,1672670842,1672673264,2422
3462,3667673649,3501459390,1672650158,1672653582,3424
3751,3289114629,3604589802,1672592016,1672593102,1086
3767,3288762795,3276348699,1672682892,1672685000,2108
3550,3780872464,3500044458,1672621809,1672624824,3015
3658,3225636215,3885121158,1672532174,1672534963,2789
3708,3755756564,3912891315,1672605279,1672608017,2738
3865,3516513251,3714120857,1672609520,1672611760,2240
3447,3512800570,3291933594,1672671524,1672671659,135
3598,3298151889,3821054646,1672576258,1672576914,656
3902,3520657891,3205923620,1672681275,1672682074,799
3776,3710008361,3793418209,1672602035,1672602138,103
3879,3279473441,3635169815,1672632331,1672635498,3167
3853,3283770991,3516298579,1672549787,1672551000,1213
3894,3500613493,3783801141,1672679889,1672679953,64
3631,3732584121,3284932450,1672699704,1672701321,1617
3526,3337362061,3783801141,1672679321,1672681118,1797
3803,3713691388,3513065217,1672686017,1672686914,897
3437,3485540729,3513345163,1672574280,1672576743,2463
3744,3632814465,3665998641,1672560612,1672562511,1899
3734,3505807416,3224330592,1672634500,1672637315,2815
3597,3519850727,3757332128,1672682333,1672683811,1478
3486,3410600350,3757383891,1672608627,1672609621,994
3860,3739661856,3715385401,1672702184,1672704333,2149
3708,3755737419,3778667336,1672589312,1672590538,1226
3528,3228888030,3457960571,1672662267,1672663009,742
3708,3306412634,3236354255,1672637562,1672638986,1424
3765,3780712350,3518229776,1672577268,1672578370,1102
3472,3436025562,3519651506,1672547623,1672548758,1135
3587,3793740407,3300818269,1672700494,1672703325,2831
3598,3417679834,3294703680,1672641969,1672643432,1463
3508,3460719322,3396726504,1672540915,1672544119,3204
3765,3760364383,3515401243,1672581896,1672583488,1592
3495,3299781901,3689114185,1672555409,1672558075,2666
3575,3373089838,3500709774,1672684793,1672686880,2087
3617,3399518841,3509483172,1672657664,1672658075,411
3736,3500498112,3776988674,1672577563,1672577892,329
3852,3435167810,3514741348,1672670394,1672672631,2237
3521,3414275042,3898314440,1672696725,1672697241,516
3429,3793583656,3934064792,1672599364,1672602380,3016
3868,3756789525,3770520359,1672567063,1672569169,2106
3682,3774178201,3824215187,1672589353,1672589831,478
3681,3512383699,3834963772,1672589835,1672592993,3158
3889,3519446663,3230868435,1672538924,1672542071,3147
3547,3610358027,3904867554,1672621822,1672624376,2554
3860,3557046880,3354144091,1672618992,1672621126,2134
3817,3779425804,3299781901,1672671986,1672673004,1018
3828,3367111751,3614740489,1672599815,1672600906,1091
3635,3534126409,3299125059,1672683748,1672687337,3589
3690,3395201292,3402697190,1672695646,1672698972,3326
3510,3448633776,3977148669,1672632490,1672633538,1048
3523,3793175445,3201800997,1672533537,1672533852,315
3903,3776988674,3776518452,1672625448,1672625554,106
3633,3777091903,3701136026,1672660777,1672663791,3014
3448,3793315718,3703433819,1672681038,1672684506,3468
3559,3551399764,3760040019,1672703570,1672704583,1013
3635,3230135532,3500915665,1672693609,1672696504,2895
3739,3509483172,3604867757,1672667074,1672670510,3436
3641,3501121099,3613581796,1672560129,1672563570,3441
3429,3930242012,3510641433,1672606750,1672609242,2492
3918,3357864626,3449333754,1672600925,1672603762,2837
3595,3755404116,3783136330,1672543948,1672545964,2016
3849,3510028805,3394297564,1672550611,1672551924,1313
3477,3316800320,3776518452,1672549511,1672552659,3148
3559,3384583385,3615688740,1672612506,1672613778,1272
3603,3338083680,3500915908,1672619119,1672619522,403
3557,3711734586,3773913680,1672614680,1672614822,142
3806,3501525100,3897435944,1672588587,1672591240,2653
3673,3505995057,3665998641,1672632940,1672633443,503
3461,3792274796,3812534508,1672620717,1672621719,1002
3610,3534566651,3449333754,1672543769,1672546519,2750
3610,3615939504,3899326793,1672587456,1672589685,2229
3489,3714678331,3689114185,1672599055,1672600652,1597
3438,3226024417,3617304541,1672646653,1672646991,338
3527,3891672228,3755532873,1672624022,1672627274,3252
3707,3312998540,3534126409,1672636773,1672637780,1007
3715,3424445495,3294747828,1672674385,1672675340,955
3807,3289817992,3505995057,1672675601,1672675760,159
3749,3779854934,3533079336,1672699432,1672702752,3320
3780,3509764635,3534764451,1672682814,1672684074,1260
3585,3701823816,3200308999,1672638143,1672638213,70
3650,3793418209,3417679834,1672557037,1672557290,253
3699,3209481722,3615939504,1672543815,1672545557,1742
3645,3660887799,3534764451,1672667341,1672667915,574
3657,3511005395,3638204468,1672594522,1672596537,2015
3828,3500709774,3792389522,1672693067,1672696089,3022
3805,3664943873,3501281016,1672671135,1672672053,918
3522,3436025562,3760842815,1672696557,1672699824,3267
3765,3393063657,3736705719,1672698988,1672701125,2137
3539,3462158237,3715443333,1672606644,1672607017,373
3718,3770146716,3534357694,1672579843,1672582510,2667
3893,3636329663,3783928182,1672611139,1672612465,1326
3755,3497808662,3373028638,1672634233,1672635696,1463
3794,3755065949,3791693821,1672676664,1672679201,2537
3650,3232208416,3402385957,1672653022,1672656328,3306
3770,3519142371,3509893027,1672638667,1672639021,354
3559,3309314379,3500498112,1672582352,1672583070,718
3629,3520657891,3439673892,1672548256,1672551017,2761
3761,3760694096,3383138270,1672572914,1672575448,2534
3560,3619922891,3921648519,1672702689,1672703288,599
3920,3330340793,3779301501,1672577012,1672579064,2052
3724,3511005395,3714185969,1672665933,1672668119,2186
3728,3773124276,3343816795,1672598687,1672600921,2234
3581,3824641227,3823084403,1672673967,1672675997,2030
3673,3312998540,3833217041,1672544006,1672546025,2019
3426,3380982774,3294747828,1672652075,1672652499,424
3524,3512499658,3411515369,1672533697,1672534817,1120
3453,3515402792,3779532653,1672665668,1672665860,192
3769,3224811762,3480991549,1672668052,1672671196,3144
3817,3685681577,3770438122,1672669956,1672671179,1223
3592,3625174002,3510554314,1672613891,1672615685,1794
3487,3513018485,3685816610,1672659518,1672661631,2113
3695,3770676872,3368283077,1672651853,1672652968,1115
3897,3892304880,3454277788,1672584586,1672586736,2150
3679,3533188828,3779532653,1672536414,1672539879,3465
3492,3773027597,3369708250,1672544899,1672547208,2309
3882,3609113156,3376467719,1672558085,1672558754,669
3496,3226178937,3774876004,1672628986,1672631969,2983
3860,3701005527,3733558985,1672577791,1672581130,3339
3639,3774290799,3225636215,1672660566,1672662862,2296
3601,3897456874,3834631333,1672606012,1672609302,3290
3906,3713941638,3294747828,1672588302,1672588983,681
3701,3773902805,3833217041,1672553401,1672556364,2963
3684,3792442597,3513081354,1672692049,1672693196,1147
3727,3500613493,3451326054,1672600985,1672603997,3012
3912,3793175445,3554944414,1672538947,1672540036,1089
3878,3793418209,3855583256,1672638574,1672639507,933
3685,3898314440,3441703884,1672619844,1672620593,749
3715,3610358027,3505995057,1672643948,1672644556,608
3875,3501281016,3316798920,1672601812,1672604765,2953
3564,3622357348,3515525630,1672629528,1672630714,1186
3771,3760640999,3711734586,1672695904,1672698119,2215
3581,3513041785,3343132529,1672542585,1672545420,2835
3580,3441703884,3791796585,1672677052,1672677871,819
3561,3459681410,3829822608,1672649986,1672652193,2207
3505,3505228454,3485540729,1672600432,1672603077,2645
3457,3519142371,3612689556,1672661970,1672665443,3473
3760,3774907131,3392836218,1672672713,1672673804,1091
3719,3364378127,3621461051,1672689168,1672691963,2795
3623,3371455553,3779646172,1672601908,1672605041,3133
3905,3803389195,3557046880,1672627170,1672629575,2405
3731,3792801638,3774641380,1672701907,1672702834,927
3667,3404025196,3499217428,1672675353,1672676289,936
3483,3839245934,3701664364,1672543075,1672543740,665
3631,3401940259,3713979100,1672661426,1672661496,70
3612,3667673649,3715707380,1672627205,1672630223,3018
3539,3351866415,3533274994,1672651949,1672653658,1709
3820,3711000597,3534566651,1672602640,1672605514,2874
3658,3714666884,3734451191,1672543481,1672544643,1162
3872,3447672935,3773121782,1672624340,1672625124,784
3914,3333918941,3501215099,1672610139,1672612166,2027
3547,3554944414,3897435944,1672677150,1672680240,3090
3653,3895285664,3737972328,1672531589,1672534239,2650
3730,3228888030,3520764926,1672666451,1672667544,1093
3596,3757294769,3756385685,1672660946,1672661968,1022
3698,3311498666,3773572967,1672684044,1672687098,3054
3660,3272030610,3224968597,1672685558,1672685669,111
3553,3711812325,3228888030,1672683680,1672683971,291
3488,3554944414,3516489668,1672698702,1672699302,600
3637,3435116799,3777037426,1672603022,1672605400,2378
3569,3710008361,3885157459,1672540537,1672544128,3591
3581,3288224595,3395201292,1672542048,1672543851,1803
3498,3885121158,3438489358,1672547486,1672548226,740
3749,3519142371,3514512367,1672689693,1672691201,1508
3885,3701247948,3334974375,1672642451,1672645165,2714
3827,3450286949,3225631197,1672549337,1672552726,3389
3652,3534829213,3227799827,1672627811,1672630017,2206
3759,3200543880,3701005527,1672541573,1672544322,2749
3917,3512383699,3220031931,1672592129,1672595054,2925
3567,3711919537,3755496114,1672547285,1672548771,1486
3619,3783919913,3276217799,1672534029,1672536446,2417
3459,3239617320,3452016771,1672656456,1672659846,3390
3479,3897376951,3793883863,1672550711,1672552573,1862
3816,3620292035,3363162590,1672552028,1672554091,2063
3859,3226511603,3773332082,1672577873,1672580831,2958
3731,3780115155,3534175249,1672631884,1672635432,3548
3615,3621184108,3703139663,1672664503,1672666372,1869
3842,3554186380,3979802715,1672592732,1672595482,2750
3753,3510187271,3833217041,1672574092,1672575629,1537
3792,3703139663,3817813340,1672539970,1672543475,3505
3601,3755737419,3791246640,1672699940,1672701356,1416
3810,3440107959,3636329663,1672638161,1672638373,212
3442,3884596900,3357689359,1672699826,1672703371,3545
3748,3923420131,3792505974,1672634797,1672636615,1818
3514,3636329663,3711637255,1672697727,1672699954,2227
3824,3814305099,3780571086,1672576025,1672577355,1330
3540,3520322124,3933894942,1672668303,1672669347,1044
3486,3859868849,3701005527,1672629439,1672630181,742
3488,3308760650,3701664364,1672673483,1672674194,711
3592,3661903000,3446533960,1672552946,1672556441,3495
3729,3688490530,3791128487,1672557219,1672558964,1745
3668,3757323954,3792745809,1672611678,1672614452,2774
3464,3665998641,3829864515,1672602336,1672603183,847
3547,3773121782,3710048469,1672657419,1672659422,2003
3480,3755404116,3511442562,1672582193,1672585518,3325
3898,3513345163,3396726504,1672549276,1672549983,707
3425,3390660440,3399472693,1672572082,1672573999,1917
3551,3500341755,3229822507,1672617295,1672618505,1210
3476,3625463628,3238288884,1672687894,1672690743,2849
3622,3279339278,3664943873,1672581171,1672581541,370
3617,3225029895,3715545685,1672623554,1672626088,2534
3757,3819767045,3299125059,1672666931,1672667219,288
3884,3935913584,3808136029,1672681587,1672684614,3027
3573,3824641227,3791046864,1672618465,1672619042,577
3718,3711000597,3500109249,1672597195,1672597777,582
3698,3757075324,3779892400,1672601307,1672601450,143
3440,3416987084,3480100311,1672572743,1672576156,3413
3780,3783163143,3505111292,1672674953,1672676022,1069
3749,3512830734,3661903000,1672653600,1672653909,309
3722,3777091903,3366423342,1672661956,1672665209,3253
3856,3710008361,3440107959,1672631944,1672634339,2395
3804,3514419100,3900945856,1672674732,1672678030,3298
3603,3512946768,3773572967,1672658120,1672659375,1255
3767,3714185969,3551376095,1672646832,1672647211,379
3506,3200543880,3459681410,1672551492,1672554105,2613
3525,3244004456,3236499444,1672674640,1672676022,1382
3810,3773027597,3780427126,1672689337,1672691014,1677
3904,3270042456,3680843171,1672587827,1672589152,1325
3487,3480100311,3738026330,1672613180,1672613352,172
3505,3533004959,3514334067,1672570191,1672572753,2562
3474,3733558985,3757630221,1672556274,1672557435,1161
3681,3333918941,3505111292,1672698890,1672702439,3549
3869,3514741348,3756704774,1672640509,1672643675,3166
3538,3619922891,3791753345,1672592041,1672592591,550
3502,3791753345,3412968120,1672617521,1672618236,715
3621,3630353876,3732131656,1672636983,1672637591,608
3516,3360813161,3501786419,1672652569,1672654178,1609
3592,3512946768,3363162590,1672627543,1672629703,2160
3871,3394401087,3975717896,1672544807,1672545499,692
3882,3411515369,3248058676,1672577634,1672580959,3325
3773,3519077659,3500613493,1672627361,1672628688,1327
3882,3779646172,3511005395,1672662520,1672664628,2108
3863,3299443125,3469254160,1672613859,1672615107,1248
3647,3517881647,3439673892,1672637470,1672639537,2067
3867,3351866415,3733363628,1672542644,1672545505,2861
3474,3533929349,3201676087,1672632252,1672632966,714
3897,3279242917,3617489344,1672671290,1672672279,989
3918,3610358027,3885537225,1672631585,1672631899,314
3845,3488686442,3492546679,1672698573,1672702082,3509
3827,3817428320,3509756823,1672552724,1672554694,1970
3748,3500317969,3244004456,1672639272,1672641622,2350
3492,3783771827,3770438122,1672700328,1672700524,196
3876,3300229945,3615737355,1672624533,1672626599,2066
3810,3791613604,3274906650,1672682493,1672684588,2095
3913,3511150845,3811075491,1672599574,1672601159,1585
3789,3201629017,3500841914,1672699749,1672702503,2754
3862,3682133690,3520416075,1672535875,1672536943,1068
3782,3461119815,3443357683,1672662457,1672664858,2401
3673,3229974066,3401940259,1672544112,1672544846,734
3860,3755756564,3454277788,1672532513,1672532768,255
3658,3617116290,3779646172,1672645962,1672647503,1541
3726,3509483172,3495911207,1672539143,1672539211,68
3719,3520355798,3559458968,1672602668,1672605918,3250
3532,3501459390,3791441520,1672567740,1672570399,2659
3515,3685681577,3519142371,1672702874,1672703166,292
3673,3713589994,3685816610,1672699367,1672701062,1695
3434,3512337405,3760094385,1672694693,1672696083,1390
3889,3398198430,3551389192,1672562551,1672563418,867
3461,3480991549,3414049538,1672553129,1672555349,2220
3579,3514308235,3710048469,1672668152,1672671334,3182
3696,3517881647,3372223551,1672637718,1672639716,1998
3744,3839245934,3201676087,1672595111,1672597376,2265
3475,3337362061,3418448389,1672643556,1672644650,1094
3452,3298151889,3777184389,1672610543,1672613837,3294
3860,3373028638,3475349791,1672675785,1672677530,1745
3645,3440107959,3825881598,1672634253,1672635096,843
3442,3517358573,3928511283,1672661725,1672664992,3267
3671,3409114719,3773735484,1672581473,1672582515,1042
3782,3533423872,3500949309,1672592249,1672592375,126
3580,3755756564,3667427125,1672646144,1672646592,448
3488,3396726504,3906536154,1672655366,1672657341,1975
3873,3714827719,3774907131,1672586777,1672589518,2741
3586,3971806004,3293835352,1672584067,1672587289,3222
3541,3208452238,3608855425,1672654479,1672654905,426
3470,3298151889,3826238375,1672538608,1672541278,2670
3484,3792389522,3462273042,1672589986,1672590734,748
3697,3714666884,3970909253,1672566830,1672567697,867
3483,3205923620,3625174002,1672608969,1672611435,2466
3511,3927599181,3515439826,1672556771,1672559570,2799
3794,3515559913,3520115090,1672621622,1672623968,2346
3479,3608922867,3299443125,1672673974,1672674774,800
3424,3715127070,3306175858,1672666273,1672668977,2704
3728,3435167810,3205985903,1672601495,1672604460,2965
3666,3203538212,3279339278,1672583872,1672587453,3581
3593,3613338363,3776518452,1672633562,1672635172,1610
3785,3273981374,3793418209,1672614909,1672615451,542
3632,3791436104,3241790910,1672573665,1672574732,1067
3766,3821054646,3360069849,1672625218,1672625511,293
3666,3791106564,3836241528,1672677074,1672679196,2122
3669,3635169815,3803389195,1672566479,1672569487,3008
3867,3556969573,3793583656,1672648478,1672649177,699
3860,3485540729,3979802715,1672696589,1672697449,860
3590,3802932312,3783433404,1672650129,1672652890,2761
3427,3715986185,3900945856,1672693597,1672694250,653
3784,3620292035,3900276517,1672662384,1672664332,1948
3911,3770624662,3366423342,1672594625,1672595921,1296
3453,3515401243,3516741440,1672591531,1672594238,2707
3748,3715974659,3518561777,1672629226,1672630894,1668
3597,3733558985,3792072681,1672681103,1672681670,567
3582,3815250107,3774907131,1672665777,1672669102,3325
3453,3757323954,3451326054,1672600269,1672602004,1735
3557,3756474459,3760694096,1672679847,1672680353,506
3890,3241914067,3551376095,1672667718,1672670325,2607
3760,3363162590,3715400486,1672690782,1672693634,2852
3452,3776117322,3402385957,1672685077,1672687511,2434
3551,3479851674,3519446663,1672650345,1672652361,2016
3424,3337322736,3755233658,1672552869,1672554875,2006
3832,3480726047,3202141727,1672595179,1672597382,2203
3672,3512383699,3515890966,1672599640,1672601371,1731
3885,3534764451,3755915206,1672695471,1672697821,2350
3556,3439673892,3770704999,1672646425,1672647098,673
3454,3534543776,3311420950,1672655581,1672658405,2824
3588,3480991549,3435116799,1672562857,1672564141,1284
3656,3776988674,3203538212,1672632544,1672633281,737
3698,3776034743,3415833929,1672612880,1672615186,2306
3610,3716679950,3714067076,1672641737,1672643503,1766
3741,3368283077,3333403880,1672703406,1672703961,555
3671,3927403123,3970558632,1672663085,1672666653,3568
3833,3283144118,3236499444,1672601973,1672604780,2807
3733,3505266860,3791796585,1672592583,1672595988,3405
3505,3757323954,3505178849,1672623549,1672626431,2882
3479,3668533536,3505725706,1672666030,1672669431,3401
3916,3517737088,3792546035,1672584349,1672587758,3409
3642,3305336154,3760040019,1672654657,1672657056,2399
3557,3732584121,3891672228,1672634619,1672637224,2605
3836,3793922324,3308760650,1672567109,1672567695,586
3690,3509764635,3386758279,1672595398,1672595787,389
3631,3299443125,3490214516,1672624220,1672625252,1032
3430,3711919537,3713941638,1672689680,1672691806,2126
3797,3205985903,3780427126,1672557346,1672559702,2356
3613,3401940259,3660887799,1672558265,1672561410,3145
3824,3333918941,3272716462,1672686389,1672686783,394
3479,3240394404,3410538749,1672637202,1672639271,2069
3819,3826238375,3610870949,1672677153,1672679549,2396
3921,3755756564,3308760650,1672615395,1672615491,96
3883,3711000597,3793407963,1672640029,1672642067,2038
3807,3510818674,3517600136,1672641333,1672642209,876
3660,3880926355,3608855425,1672687985,1672689379,1394
3685,3792274796,3510642075,1672640036,1672641889,1853
3506,3455018347,3757700712,1672625224,1672626239,1015
3534,3373028638,3227799827,1672695610,1672698990,3380
3674,3770236215,3716110860,1672552985,1672555143,2158
3745,3711734586,3770438122,1672553788,1672556338,2550
3610,3402385957,3517462308,1672649772,1672650192,420
3756,3777814504,3428725843,1672624940,1672625239,299
3458,3501786419,3760924079,1672546934,1672548157,1223
3757,3501567772,3664943873,1672556636,1672559447,2811
3450,3756625818,3373089838,1672615135,1672616550,1415
3901,3500317969,3351866415,1672612184,1672612719,535
3603,3510028805,3609881958,1672628861,1672631492,2631
3650,3505283390,3855583256,1672656149,1672658950,2801
3808,3510641433,3312998540,1672653911,1672655018,1107
3432,3791246640,3710735406,1672647394,1672647938,544
3585,3618489670,3514419100,1672647766,1672651302,3536
3802,3688796737,3337322736,1672589238,1672591678,2440
3913,3893912331,3512383699,1672626515,1672627965,1450
3845,3519416013,3520355798,1672601686,1672604280,2594
3734,3701136026,3376467719,1672544982,1672546008,1026
3595,3551376095,3760263530,1672576081,1672578665,2584
3812,3505847380,3778640261,1672647084,1672647832,748
3791,3312998540,3738026330,1672556153,1672558527,2374
3760,3519077659,3513041785,1672550221,1672551721,1500
3899,3505434346,3519446663,1672650547,1672651501,954
3452,3227799827,3688490530,1672625879,1672628640,2761
3665,3791796585,3505481368,1672597842,1672600058,2216
3840,3384068080,3935399379,1672592132,1672593585,1453
3429,3701322924,3360069849,1672531628,1672535080,3452
3517,3229974066,3414275042,1672693548,1672696966,3418
3624,3783928182,3533747868,1672595863,1672598879,3016
3458,3488763230,3533368789,1672691870,1672693958,2088
3784,3661447322,3333403880,1672542287,1672542517,230
3442,3511317276,3533090502,1672646564,1672648032,1468
3797,3760263530,3519077659,1672654245,1672654717,472
3515,3519909393,3731646673,1672648587,1672650021,1434
3473,3513345163,3279339278,1672543230,1672545524,2294
3496,3500613493,3396980894,1672674729,1672675028,299
3573,3411515369,3701373490,1672547808,1672550577,2769
3593,3970198861,3519850727,1672651719,1672655035,3316
3634,3739911441,3739154408,1672554913,1672558264,3351
3675,3231494505,3239617320,1672698092,1672699058,966
3641,3505923418,3935399379,1672618037,1672619336,1299
3819,3208957949,3613581796,1672549292,1672550287,995
3713,3505888598,3732584121,1672567111,1672567906,795
3426,3935399379,3736231757,1672653372,1672654301,929
3495,3385323994,3371455553,1672630894,1672631859,965
3492,3517600136,3488686442,1672673455,1672673937,482
3622,3780769110,3451726367,1672537031,1672540408,3377
3884,3519282716,3518653080,1672699654,1672700533,879
3898,3710854064,3909094917,1672600728,1672604278,3550
3739,3615939504,3363162590,1672658344,1672661584,3240
3550,3711853996,3416987084,1672655930,1672656157,227
3801,3519446663,3333918941,1672582909,1672583018,109
3474,3779854934,3615113018,1672560237,1672562671,2434
3640,3780872464,3773572967,1672601792,1672604771,2979
3536,3855583256,3779639983,1672629642,1672632118,2476
3716,3516513251,3517600136,1672600454,1672603672,3218
3592,3909094917,3613899351,1672561533,1672563682,2149
3904,3300511067,3438489358,1672573002,1672575990,2988
3640,3792538417,3510499038,1672692417,1672695082,2665
3830,3519416013,3511024016,1672700596,1672701257,661
3456,3777189898,3497095254,1672551466,1672554758,3292
3634,3905899155,3201800997,1672634222,1672637250,3028
3626,3664943873,3839245934,1672588120,1672591530,3410
3607,3803389195,3417679834,1672665183,1672668609,3426
3839,3613206049,3519416013,1672533789,1672537009,3220
3866,3380982774,3500317969,1672688628,1672689298,670
3565,3449639012,3533090502,1672614188,1672614905,717
3519,3516903528,3518229776,1672702720,1672703094,374
3749,3623266256,3475349791,1672643184,1672646011,2827
3674,3793175445,3895285664,1672653209,1672655858,2649
3667,3701136026,3839245934,1672562372,1672563001,629
3458,3393063657,3513853403,1672562046,1672563372,1326
3812,3517590837,3899326793,1672662627,1672665953,3326
3878,3428725843,3617304541,1672623660,1672624425,765
3620,3774907131,3855583256,1672566820,1672570054,3234
3650,3791441520,3780872464,1672637321,1672639039,1718
3652,3512502036,3773121782,1672662016,1672663304,1288
3888,3472068734,3511601997,1672597603,1672600721,3118
3727,3512800570,3414940786,1672690307,1672690461,154
3837,3835422146,3731646673,1672544015,1672544781,766
3903,3517462308,3779639983,1672680661,1672681726,1065
3585,3755496114,3500525825,1672676688,1672678012,1324
3606,3930242012,3551376095,1672668932,1672669152,220
3729,3367111751,3436257398,1672609889,1672610612,723
3663,3519651506,3938503547,1672636801,1672639064,2263
3611,3893912331,3793315718,1672635244,1672636706,1462
3477,3334974375,3510641433,1672703251,1672706377,3126
3906,3511791953,3514956366,1672602693,1672605897,3204
3760,3637313265,3300511067,1672619148,1672621373,2225
3587,3710489491,3512337405,1672565466,1672566121,655
3705,3701373490,3900898992,1672572130,1672574462,2332
3913,3604867757,3509756823,1672588547,1672588636,89
3521,3512379024,3357289672,1672639713,1672642169,2456
3875,3300229945,3834960360,1672576098,1672576421,323
3829,3755848152,3500498112,1672555465,1672558963,3498
3693,3505995057,3516298579,1672574895,1672577690,2795
3500,3680843171,3715400486,1672618119,1672621084,2965
3458,3512383699,3777189898,1672695702,1672698302,2600
3792,3279473441,3757903168,1672569222,1672569475,253
3861,3500857494,3935399379,1672576718,1672579182,2464
3866,3779656423,3279475486,1672641213,1672643564,2351
3613,3511732493,3414940786,1672600706,1672603616,2910
3567,3711097754,3533649454,1672637853,1672639197,1344
3446,3509893027,3354144091,1672658107,1672661350,3243
3493,3513081354,3897456874,1672648236,1672649002,766
3824,3776559988,3514308235,1672667150,1672667957,807
3789,3236499444,3231713082,1672662790,1672665709,2919
3557,3500109249,3514419100,1672613132,1672615778,2646
3683,3305336154,3400069268,1672689944,1672692301,2357
3863,3232208416,3201800997,1672536741,1672540024,3283
3606,3893912331,3757323954,1672631465,1672633430,1965
3570,3462158237,3900945856,1672582411,1672585130,2719
3805,3609933747,3272030610,1672603401,1672605379,1978
3780,3440137407,3454277788,1672602131,1672604127,1996
3832,3424445495,3461119815,1672563677,1672565610,1933
3511,3669146016,3229822507,1672698108,1672701147,3039
3547,3938503547,3311420950,1672580180,1672582348,2168
3757,3757193551,3856606678,1672649566,1672649674,108
3743,3399518841,3310125159,1672591718,1672592243,525
3774,3308760650,3510641433,1672642343,1672644362,2019
3906,3779465522,3714067076,1672691286,1672694682,3396
3589,3520657891,3462273042,1672620556,1672621757,1201
3870,3514419100,3367971170,1672605341,1672606411,1070
3744,3501384020,3500341755,1672665889,1672666440,551
3673,3829822608,3711077927,1672534954,1672535800,846
3675,3710008361,3514741348,1672602321,1672604926,2605
3678,3710489491,3622357348,1672684893,1672686316,1423
3483,3667673649,3500208903,1672597581,1672599332,1751
3657,3793743698,3716272919,1672574037,1672576839,2802
3670,3334993594,3608922867,1672561485,1672564300,2815
3910,3713979100,3208452238,1672640676,1672644169,3493
3432,3621184108,3357289672,1672585861,1672587716,1855
3848,3833217041,3492959689,1672608409,1672610868,2459
3428,3819767045,3305722859,1672701521,1672702500,979
3806,3776244398,3517991730,1672603165,1672604619,1454
3730,3289114629,3387594369,1672677645,1672679702,2057
3584,3710048469,3330340793,1672624844,1672626280,1436
3785,3500442734,3518561777,1672587525,1672587994,469
3736,3311085279,3534357694,1672630867,1672634150,3283
3687,3209481722,3220031931,1672648696,1672650942,2246
3914,3774705415,3409114719,1672628955,1672630706,1751
3638,3520560590,3791753345,1672659015,1672660657,1642
3531,3906536154,3914691363,1672586233,1672588072,1839
3807,3792442597,3436025562,1672543814,1672545294,1480
3495,3715986185,3400763927,1672533084,1672535093,2009
3713,3779786641,3513345163,1672703296,1672705683,2387
3590,3970627281,3236458894,1672578961,1672581948,2987
3841,3330340793,3701424609,1672537705,1672539081,1376
3457,3615737355,3510798825,1672698198,1672699569,1371
3681,3310125159,3310125159,1672656651,1672657184,533
3815,3510554314,3807212280,1672570168,1672570772,604
3699,3516903528,3551389192,1672631160,1672633717,2557
3788,3300511067,3245232284,1672649189,1672649921,732
3909,3817428320,3401940259,1672645696,1672646084,388
3914,3801645328,3520578796,1672664455,1672666202,1747
3604,3228888030,3713561276,1672641006,1672641124,118
3887,3451326054,3280054198,1672678714,1672679135,421
3450,3621184108,3737147209,1672682888,1672685774,2886
3431,3780209375,3885121158,1672677561,1672679401,1840
3783,3312998540,3518194482,1672691310,1672694622,3312
3537,3380982774,3757863420,1672621847,1672624623,2776
3644,3711000597,3701664364,1672696997,1672698201,1204
3715,3783919913,3779938251,1672585640,1672586368,728
3624,3500857494,3309314379,1672545170,1672545902,732
3463,3821054646,3306412634,1672610699,1672611151,452
3789,3618808151,3512722110,1672685243,1672686331,1088
3808,3776559988,3270056120,1672599406,1672600002,596
3528,3244004456,3793781065,1672534798,1672537743,2945
3864,3514334067,3792949946,1672604830,1672607690,2860
3663,3608855425,3533228966,1672657835,1672658467,632
3897,3756789525,3491469603,1672672927,1672674847,1920
3802,3512946768,3505725706,1672684541,1672687257,2716
3821,3977148669,3811075491,1672664040,1672664274,234
3671,3511288998,3517687662,1672657182,1672659921,2739
3555,3625463628,3410160376,1672541748,1672543930,2182
3754,3755233658,3757075324,1672578160,1672581220,3060
3831,3291933594,3688796737,1672626607,1672628378,1771
3866,3904867554,3519818818,1672618046,1672619772,1726
3775,3737972328,3774605761,1672596090,1672598871,2781
3559,3519416013,3783340788,1672577429,1672577884,455
3584,3518194482,3505995057,1672578454,1672578686,232
3439,3399472693,3853629553,1672598842,1672598909,67
3868,3793868716,3436025562,1672602457,1672604740,2283
3626,3343132529,3715854030,1672600233,1672601449,1216
3740,3783340788,3756385685,1672542813,1672546211,3398
3579,3518229776,3773913680,1672686687,1672688555,1868
3777,3793922324,3779532653,1672632657,1672635313,2656
3548,3713784974,3902625986,1672542425,1672545047,2622
3725,3739895284,3554186380,1672582530,1672585961,3431
3886,3334974375,3475349791,1672645722,1672646671,949
3496,3514275974,3415833929,1672688316,1672688663,347
3501,3515466096,3757323954,1672695251,1672695744,493
3908,3703139663,3367111751,1672664640,1672665339,699
3737,3500208903,3760263530,1672677672,1672679188,1516
3732,3335694356,3774605761,1672681345,1672681449,104
3601,3793935736,3701322924,1672561237,1672561810,573
3889,3897376951,3505154885,1672700212,1672703645,3433
3611,3755233658,3285204083,1672671917,1672675250,3333
3882,3520181148,3475349791,1672669872,1672670639,767
3776,3283144118,3770704999,1672546774,1672549423,2649
3910,3880926355,3814305099,1672565240,1672568587,3347
3799,3519416013,3357689359,1672658415,1672660525,2110
3609,3779854934,3516444201,1672557595,1672560546,2951
3842,3776117322,3777240360,1672635389,1672638820,3431
3437,3452016771,3520657891,1672628293,1672631442,3149
3890,3534764451,3897456874,1672660600,1672661236,636
3551,3604867757,3291933594,1672579449,1672580119,670
3764,3511442562,3760645796,1672674111,1672677541,3430
3573,3770520359,3200543880,1672701193,1672703378,2185
3920,3715443333,3452016771,1672556375,1672557525,1150
3473,3904867554,3770296583,1672546957,1672548684,1727
3498,3500341755,3398198430,1672609704,1672610809,1105
3586,3711077927,3401940259,1672685889,1672686768,879
3914,3880926355,3802932312,1672661266,1672661809,543
3648,3734451191,3793315718,1672574174,1672576946,2772
3526,3635169815,3375449013,1672624494,1672625419,925
3877,3923220461,3777240360,1672619158,1672619953,795
3652,3514246749,3716963089,1672616472,1672617895,1423
3844,3435116799,3608922867,1672552370,1672555068,2698
3911,3630353876,3802932312,1672568436,1672571765,3329
3467,3209526819,3511317276,1672698218,1672700180,1962
3829,3777330107,3230135532,1672547226,1672549745,2519
3451,3779425804,3792442597,1672574235,1672574507,272
3439,3551376095,3347419520,1672624723,1672625126,403
3872,3701373490,3511150845,1672626387,1672627462,1075
3727,3398198430,3774641380,1672588691,1672591720,3029
3456,3516741440,3485540729,1672656366,1672658099,1733
3725,3773939399,3485540729,1672657217,1672659577,2360
3504,3513327337,3392836218,1672551241,1672553297,2056
3513,3920625129,3517222913,1672586597,1672589470,2873
3467,3500613493,3512337405,1672576645,1672577034,389
3717,3417679834,3280054198,1672640601,1672643336,2735
3655,3711919537,3367971170,1672682293,1672685004,2711
3514,3783919913,3979784676,1672551235,1672554318,3083
3676,3774790271,3519028898,1672553312,1672554191,879
3722,3773913680,3714185969,1672648974,1672650171,1197
3643,3710735406,3445206685,1672673169,1672673872,703
3627,3280054198,3431502855,1672556821,1672558885,2064
3593,3462158237,3773027597,1672547024,1672549464,2440
3875,3755573472,3401496246,1672651897,1672652251,354
3560,3776034743,3777147510,1672637121,1672637319,198
3779,3818575661,3520560590,1672544228,1672544393,165
3467,3488763230,3424445495,1672675144,1672677940,2796
3563,3315279093,3791046864,1672621312,1672623871,2559
3725,3970627281,3631479562,1672613277,1672613801,524
3682,3514324011,3367971170,1672532720,1672534191,1471
3558,3449639012,3408498208,1672702210,1672703431,1221
3689,3774641380,3615115210,1672690083,1672691555,1472
3885,3979802715,3236499444,1672703798,1672706683,2885
3483,3893912331,3272096759,1672536035,1672536742,707
3610,3241790910,3364726656,1672597350,1672600105,2755
3794,3338390596,3783136330,1672669014,1672671452,2438
3789,3739154408,3825881598,1672578084,1672579611,1527
3819,3772236797,3511442562,1672680727,1672682984,2257
3446,3760645796,3773121782,1672636611,1672637145,534
3737,3400069268,3492546679,1672619320,1672622357,3037
3786,3227799827,3311098437,1672604626,1672606413,1787
3495,3505663516,3895285664,1672664113,1672667697,3584
3478,3505847380,3760694096,1672670457,1672671325,868
3627,3505402439,3777189898,1672609960,1672611300,1340
3774,3447672935,3380982774,1672559253,1672561575,2322
3598,3354144091,3669146016,1672671664,1672673641,1977
3430,3239617320,3792538417,1672589002,1672589584,582
3771,3505634634,3534566651,1672555441,1672556114,673
3612,3686227677,3226511603,1672578655,1672581789,3134
3690,3554825448,3410160376,1672703321,1672705918,2597
3509,3812534508,3334951866,1672548180,1672550141,1961
3521,3701107228,3638204468,1672600026,1672603149,3123
3824,3487875183,3387594369,1672657605,1672661095,3490
3815,3518565331,3610358027,1672671224,1672671390,166
3816,3505179890,3791046864,1672564331,1672564733,402
3590,3757193551,3825881598,1672602188,1672604902,2714
3577,3738026330,3384583385,1672645194,1672648315,3121
3645,3703798634,3780115155,1672659161,1672661471,2310
3711,3898314440,3209481722,1672639720,1672642693,2973
3788,3793583656,3780253901,1672663780,1672666051,2271
3562,3715127070,3811040565,1672670545,1672670909,364
3705,3279473441,3667427125,1672587084,1672588821,1737
3431,3757630221,3480100311,1672596274,1672599596,3322
3540,3715974659,3398198430,1672601432,1672604427,2995
3495,3315703693,3859868849,1672629247,1672631125,1878
3549,3773027597,3456430614,1672576418,1672579369,2951
3745,3834963772,3289114629,1672638231,1672640752,2521
3866,3664943873,3485540729,1672541431,1672541636,205
3562,3510837901,3520355798,1672538043,1672538407,364
3679,3793418209,3902861231,1672535634,1672536169,535
3734,3715086894,3934064792,1672548813,1672550992,2179
3746,3713691388,3500915665,1672678871,1672682265,3394
3819,3618489670,3925979970,1672623377,1672626878,3501
3620,3902760230,3517358573,1672687117,1672689176,2059
3920,3304155815,3338390596,1672570634,1672571178,544
3701,3513545422,3492546679,1672564543,1672564852,309
3634,3885537225,3316798920,1672691665,1672692714,1049
3711,3513327337,3412968120,1672670366,1672673799,3433
3747,3500347447,3625174002,1672678286,1672679587,1301
3726,3559458968,3533274994,1672666536,1672666875,339
3490,3500442734,3757318448,1672695691,1672697704,2013
3763,3778597171,3279242917,1672614652,1672617640,2988
3504,3500827202,3231494505,1672622487,1672624752,2265
3481,3791128487,3241914067,1672568253,1672569287,1034
3847,3792949946,3501786419,1672584177,1672586381,2204
3792,3283492940,3330340793,1672683333,1672684704,1371
3459,3711734586,3711077927,1672694098,1672696248,2150
3458,3554825448,3791106564,1672579198,1672582651,3453
3752,3298151889,3716963089,1672555281,1672555505,224
3618,3703433819,3777485931,1672629096,1672631903,2807
3585,3783641602,3756704774,1672599714,1672600805,1091
3430,3516298579,3500915908,1672593983,1672595320,1337
3489,3686227677,3780909839,1672553215,1672556670,3455
3702,3755532873,3624297844,1672621293,1672624771,3478
3650,3609659642,3518194482,1672555272,1672558590,3318
3626,3773009828,3815392801,1672558939,1672560546,1607
3545,3294703680,3306175858,1672570424,1672572116,1692
3503,3711006062,3824215187,1672569108,1672570917,1809
3709,3468041839,3755496114,1672550133,1672552768,2635
3555,3774907131,3755915206,1672687967,1672690980,3013
3445,3773033649,3520764926,1672601173,1672603796,2623
3470,3455018347,3617489344,1672691446,1672694809,3363
3757,3783615982,3680843171,1672541555,1672543657,2102
3772,3534175249,3970603231,1672703864,1672704281,417
3721,3501457103,3374183227,1672685851,1672686491,640
3604,3760040019,3757323954,1672688352,1672691774,3422
3522,3777814504,3515439826,1672535725,1672536535,810
3884,3534566651,3803389195,1672550565,1672551491,926
3530,3757700712,3514308235,1672683549,1672686976,3427
3633,3492959689,3200308999,1672697783,1672700816,3033
3564,3411515369,3310125159,1672560567,1672562737,2170
3806,3776117322,3364378127,1672544588,1672546328,1740
3637,3447514821,3462636434,1672693854,1672695825,1971
3478,3713163045,3757294769,1672591885,1672593385,1500
3533,3338083680,3682133690,1672604801,1672606869,2068
3637,3511791953,3792014516,1672542633,1672543334,701
3783,3801645328,3533274994,1672578699,1672579859,1160
3811,3500208903,3497095254,1672588879,1672590124,1245
3429,3803517637,3533079336,1672622858,1672623293,435
3914,3514285803,3514971533,1672553753,1672557048,3295
3494,3517358573,3440137407,1672664802,1672665219,417
3852,3279475486,3791106564,1672654046,1672655705,1659
3659,3399518841,3270056120,1672618615,1672620867,2252
3619,3300979975,3667427125,1672686223,1672687436,1213
3485,3385323994,3201676087,1672678156,1672680600,2444
3626,3701005527,3202141727,1672656577,1672658723,2146
3662,3819767045,3438489358,1672670560,1672673269,2709
3516,3517462308,3814677862,1672637746,1672638128,382
3845,3773939399,3792020993,1672583634,1672584198,564
3600,3435167810,3631090677,1672646286,1672648014,1728
3834,3701884158,3533649454,1672648490,1672649243,753
3786,3450969839,3920625129,1672646876,1672648998,2122
3897,3513041785,3534175249,1672682753,1672683598,845
3797,3757700712,3454277788,1672554210,1672557536,3326
3637,3927403123,3310039260,1672609852,1672610589,737
3556,3757630221,3510818674,1672614707,1672615640,933
3658,3533228966,3757193307,1672702216,1672702670,454
3431,3783771827,3209526819,1672557001,1672558593,1592
3526,3618808151,3776831527,1672546566,1672547441,875
3488,3776559988,3533090502,1672606173,1672607523,1350
3610,3931627862,3501567772,1672615803,1672617942,2139
3687,3852686295,3387594369,1672537926,1672538612,686
3748,3667673649,3714233826,1672598492,1672601545,3053
3841,3343132529,3920497528,1672590370,1672592464,2094
3699,3773124276,3780571086,1672611706,1672615216,3510
3781,3715619259,3512502036,1672589829,1672592897,3068
3922,3780338697,3773121782,1672679963,1672680717,754
3746,3450969839,3556969573,1672621177,1672622293,1116
3599,3880926355,3618354185,1672535035,1672537685,2650
3706,3276348699,3520560590,1672680077,1672682007,1930
3654,3380982774,3315703693,1672531720,1672534537,2817
3653,3533004959,3783919913,1672666156,1672668783,2627
3688,3201800997,3738026330,1672550775,1672553097,2322
3598,3793935736,3688796737,1672601225,1672602049,824
3620,3823084403,3893912331,1672667158,1672668961,1803
3655,3450969839,3791693821,1672702824,1672704207,1383
3782,3935487534,3688490530,1672624640,1672627074,2434
3499,3792949946,3900276517,1672579732,1672582463,2731
3766,3793407963,3398198430,1672557048,1672557320,272
3536,3932478321,3395201292,1672606652,1672609614,2962
3854,3515402792,3755344363,1672581003,1672582888,1885
3770,3711077927,3738026330,1672627829,1672629720,1891
3690,3334993594,3303410628,1672619344,1672620760,1416
3729,3382733096,3554825448,1672580330,1672583779,3449
3868,3624297844,3500109249,1672604732,1672607209,2477
3482,3385323994,3793583656,1672693199,1672694544,1345
3909,3272030610,3533423872,1672646440,1672648134,1694
3485,3533929349,3770146716,1672611370,1672611582,212
3517,3514512367,3283770991,1672614651,1672618072,3421
3551,3661903000,3710048469,1672671533,1672672489,956
3879,3814305099,3792442597,1672536259,1672537271,1012
3767,3520764926,3791246640,1672568598,1672571900,3302
3485,3778134418,3774641380,1672634965,1672637394,2429
3890,3714678331,3500613493,1672607011,1672607991,980
3676,3756625818,3462158237,1672685304,1672686984,1680
3530,3470454332,3241790910,1672656050,1672658721,2671
3837,3516703758,3514703118,1672550419,1672551669,1250
3509,3755573472,3436257398,1672619308,1672621871,2563
3440,3439673892,3930242012,1672662672,1672665458,2786
3438,3933894942,3777694660,1672570549,1672573690,3141
3597,3272096759,3357689359,1672560900,1672563239,2339
3629,3283770991,3760040019,1672604164,1672605559,1395
3648,3368283077,3534126409,1672609585,1672611174,1589
3818,3970198861,3500737582,1672541316,1672541932,616
3852,3272096759,3534179433,1672614635,1672614713,78
3513,3520764926,3285204083,1672647970,1672649193,1223
3848,3296462324,3635169815,1672545600,1672549070,3470
3513,3514818819,3284932450,1672625566,1672628578,3012
3578,3972083617,3793740407,1672697492,1672697976,484
3595,3280054198,3436025562,1672596322,1672598323,2001
3633,3398198430,3512383699,1672575886,1672579403,3517
3735,3755233658,3349856820,1672687321,1672690783,3462
3617,3815250107,3971806004,1672645580,1672646594,1014
3459,3600876425,3514703118,1672633867,1672634795,928
3604,3410538749,3792801638,1672565053,1672567204,2151
3447,3757383891,3783771827,1672538977,1672539605,628
3898,3711097754,3615115210,1672561544,1672562307,763
3501,3349739136,3552824113,1672670454,1672672532,2078
3661,3716272919,3925979970,1672697813,1672698770,957
3500,3774705415,3500777439,1672575583,1672576886,1303
3665,3534543776,3622357348,1672604167,1672604418,251
3801,3402697190,3520657891,1672688762,1672689825,1063
3700,3534829213,3452016771,1672555644,1672555882,238
3458,3276217799,3501281016,1672645200,1672648215,3015
3896,3716963089,3417679834,1672642236,1672642896,660
3477,3279475486,3914691363,1672542707,1672545747,3040
3601,3350095157,3450286949,1672685371,1672688481,3110
3523,3756385685,3515402792,1672669912,1672670539,627
3729,3930242012,3933894942,1672648583,1672651734,3151
3918,3776117322,3779646172,1672672933,1672673834,901
3432,3335694356,3480726047,1672557299,1672557877,578
3434,3310125159,3368283077,1672592306,1672592810,504
3837,3631479562,3463740710,1672550547,1672550885,338
3728,3739895284,3734915241,1672593686,1672593914,228
3766,3713829743,3793883863,1672644655,1672647160,2505
3456,3519028898,3551376095,1672684690,1672685537,847
3489,3435167810,3505847380,1672702128,1672703664,1536
3560,3387594369,3971806004,1672624298,1672624585,287
3766,3505402439,3792442597,1672580976,1672584232,3256
3865,3533188828,3923220461,1672596238,1672598490,2252
3532,3779639983,3772765746,1672596442,1672597527,1085
3750,3360069849,3688490530,1672695341,1672697526,2185
3802,3716272919,3760364383,1672645145,1672646520,1375
3487,3461119815,3505437712,1672656679,1672657887,1208
3791,3737112297,3225636215,1672653298,1672654851,1553
3543,3793969543,3510818674,1672550641,1672553026,2385
3480,3906536154,3970198861,1672684709,1672686092,1383
3695,3366423342,3227799827,1672668739,1672672267,3528
3772,3713561276,3238288884,1672703313,1672703643,330
3851,3732584121,3783520186,1672540791,1672542147,1356
3871,3791246640,3933894942,1672587529,1672589924,2395
3749,3293835352,3300979975,1672619712,1672622241,2529
3754,3613581796,3714067076,1672680087,1672681900,1813
3609,3780872464,3513065217,1672666806,1672668256,1450
3711,3923420131,3241914067,1672653363,1672656810,3447
3794,3410600350,3664943873,1672611797,1672614515,2718
3684,3880926355,3274906650,1672688514,1672691175,2661
3706,3756625818,3668533536,1672566458,1672569691,3233
3835,3493017654,3367509761,1672588885,1672590857,1972
3577,3379143440,3755992176,1672671789,1672675286,3497
3734,3811075491,3821054646,1672662861,1672664173,1312
3881,3793583656,3500613459,1672672125,1672674857,2732
3729,3431460073,3392836218,1672636426,1672638649,2223
3451,3605221116,3770296583,1672582273,1672583053,780
3501,3928511283,3829822608,1672675635,1672676900,1265
3661,3440107959,3688220326,1672574859,1672577432,2573
3461,3347446226,3500613493,1672651451,1672653572,2121
3649,3608922867,3734118023,1672585594,1672587143,1549
3884,3272096759,3780209375,1672574292,1672574616,324
3490,3715707380,3349739136,1672555605,1672555681,76
3669,3897435944,3714067076,1672624145,1672626500,2355
3534,3519446663,3713941638,1672693581,1672694563,982
3562,3755158925,3914691363,1672557813,1672558990,1177
3590,3833217041,3814305099,1672682244,1672684074,1830
3797,3404025196,3783169442,1672697441,1672699287,1846
3524,3793868716,3661583097,1672676327,1672679482,3155
3769,3517462308,3701424609,1672648336,1672649810,1474
3713,3559458968,3638660068,1672561971,1672565543,3572
3872,3519651506,3605221116,1672556271,1672559551,3280
3777,3916490839,3534179433,1672670439,1672673747,3308
3659,3510641433,3774733620,1672665707,1672666662,955
3483,3974674109,3534566651,1672630818,1672632638,1820
3759,3686523546,3715986185,1672608935,1672609904,969
3497,3505179890,3511288998,1672575720,1672576353,633
3483,3452016771,3780712350,1672675119,1672678143,3024
3569,3783615982,3757630221,1672537065,1672540631,3566
3636,3665998641,3667673649,1672689032,1672692290,3258
3897,3300511067,3341893384,1672612502,1672614133,1631
3534,3500341755,3497808662,1672536428,1672537185,757
3739,3710854064,3613416045,1672616342,1672618322,1980
3783,3780712350,3334974375,1672604789,1672606728,1939
3823,3519446663,3792389522,1672566271,1672566930,659
3835,3737972328,3774290799,1672570169,1672573240,3071
3783,3703798634,3779465522,1672580161,1672582752,2591
3865,3774876004,3200543880,1672603773,1672606459,2686
3696,3604867757,3279339278,1672565544,1672568855,3311
3771,3520873221,3760721303,1672682935,1672684959,2024
3902,3505807416,3520322124,1672588841,1672592389,3548
3768,3408498208,3270697740,1672538459,1672541323,2864
3462,3500302272,3701823816,1672696001,1672698156,2155
3621,3308760650,3224968597,1672591018,1672593531,2513
3527,3620292035,3514971533,1672615898,1672618706,2808
3822,3505663516,3760651515,1672533777,1672535567,1790
3709,3900898992,3770236215,1672643578,1672644352,774
3562,3518653080,3713589994,1672576912,1672579998,3086
3522,3710008361,3514703118,1672592100,1672594451,2351
3783,3773009828,3617392620,1672549827,1672551691,1864
3868,3770438122,3513853403,1672550392,1672552834,2442
3684,3615939504,3885537225,1672638838,1672639594,756
3606,3520578796,3608922867,1672570448,1672572131,1683
3634,3604589802,3364726656,1672605407,1672607334,1927
3440,3311098437,3858172636,1672580696,1672582429,1733
3441,3792014516,3456430614,1672560680,1672562263,1583
3548,3780472203,3774641380,1672629284,1672631009,1725
3459,3770676872,3232208416,1672544404,1672546136,1732
3726,3288762795,3360616538,1672587900,1672588017,117
3897,3533188828,3779301501,1672620450,1672621940,1490
3802,3533368789,3500442734,1672651474,1672653704,2230
3915,3505179890,3713300120,1672667032,1672669767,2735
3861,3792538417,3792442597,1672562490,1672565987,3497
3634,3756625818,3779892400,1672587852,1672589253,1401
3509,3613338363,3515559913,1672696094,1672696315,221
3451,3511843593,3713163045,1672643561,1672643944,383
3725,3511150845,3609659642,1672559683,1672561635,1952
3539,3829822608,3714128600,1672604556,1672605708,1152
3811,3516298579,3755230952,1672540196,1672543134,2938
3636,3415833929,3366423342,1672648667,1672649532,865
3427,3776117322,3224811762,1672646407,1672646726,319
3758,3411688875,3514818819,1672650848,1672651569,721
3700,3488686442,3755737419,1672644121,1672646843,2722
3524,3824641227,3774155692,1672687120,1672688988,1868
3721,3760364383,3446533960,1672667694,1672668981,1287
3453,3520416075,3887243870,1672652105,1672652640,535
3900,3554944414,3500072204,1672696861,1672698774,1913
3714,3791046864,3517737088,1672535945,1672536067,122
3660,3770468980,3230868435,1672686363,1672686647,284
3694,3470454332,3284947372,1672657019,1672658097,1078
3847,3897134762,3534764451,1672588480,1672590135,1655
3639,3756746867,3791441520,1672643843,1672644644,801
3542,3394401087,3519416013,1672562161,1672562651,490
3764,3305722859,3701424609,1672701475,1672704083,2608
3761,3793315718,3515439826,1672699683,1672700425,742
3621,3284947372,3351696332,1672641315,1672643478,2163
3616,3713979100,3971806004,1672664866,1672667529,2663
3548,3533649454,3511442562,1672536630,1672538516,1886
3783,3617116290,3716272919,1672611217,1672613492,2275
3712,3512379024,3906536154,1672578784,1672579385,601
3876,3315279093,3970627281,1672599002,1672601483,2481
3592,3920625129,3492959689,1672560742,1672562367,1625
3687,3611055563,3732584121,1672575174,1672577817,2643
3791,3276269264,3773027597,1672536148,1672537706,1558
3865,3757863420,3792014516,1672563336,1672566367,3031
3723,3514512367,3441348818,1672674409,1672676363,1954
3883,3514741348,3311498666,1672688919,1672690337,1418
3746,3923754072,3336627643,1672684488,1672684980,492
3866,3517887477,3554825448,1672606688,1672606976,288
3747,3703383853,3817428320,1672559979,1672560806,827
3745,3505995057,3685681577,1672697264,1672697791,527
3551,3279475486,3409114719,1672541256,1672543316,2060
3531,3414940786,3714827719,1672675537,1672676318,781
3784,3716963089,3668533536,1672630880,1672634294,3414
3534,3757075324,3337322736,1672542128,1672542223,95
3630,3776084820,3520181148,1672549454,1672549815,361
3641,3401793306,3500949309,1672601204,1672604191,2987
3710,3689114185,3783136330,1672569646,1672569937,291
3738,3533228966,3500857494,1672633762,1672634928,1166
3702,3833217041,3774733620,1672648252,1672648359,107
3531,3852533643,3500347447,1672683692,1672686435,2743
3736,3288224595,3351866415,1672537116,1672540148,3032
3841,3770438122,3296462324,1672700418,1672702338,1920
3425,3780115155,3780338697,1672679789,1672682438,2649
3913,3756127300,3760721303,1672596066,1672596320,254
3569,3505111292,3627368399,1672678896,1672680300,1404
3919,3533079336,3347419520,1672661691,1672663241,1550
3834,3833217041,3299125059,1672575746,1672579214,3468
3859,3303410628,3773572967,1672547875,1672550676,2801
3580,3441703884,3638660068,1672678539,1672679945,1406
3886,3500317969,3305336154,1672626554,1672627800,1246
3443,3900276517,3516298579,1672610486,1672611083,597
3837,3534179433,3534175249,1672655111,1672655802,691
3491,3367111751,3284947372,1672654950,1672656389,1439
3475,3880926355,3519446663,1672622425,1672622935,510
3527,3468041839,3755915206,1672668751,1672672348,3597
3477,3501281016,3299781901,1672580922,1672582975,2053
3854,3517600136,3364726656,1672643780,1672644337,557
3756,3773027597,3401940259,1672557112,1672558998,1886
3435,3440107959,3975717896,1672600472,1672601908,1436
3559,3714185969,3501786419,1672568850,1672570633,1783
3640,3505228454,3668747074,1672595117,1672598205,3088
3720,3510642075,3452016771,1672680047,1672681357,1310
3784,3713941638,3270697740,1672551812,1672552060,248
3865,3534126409,3225636215,1672583033,1672585869,2836
3442,3701107228,3284947372,1672555594,1672556803,1209
3444,3621184108,3517288083,1672561110,1672562388,1278
3652,3661583097,3715127070,1672678016,1672679889,1873
3713,3756127300,3551389192,1672580914,1672581200,286
3716,3512499658,3505198734,1672622661,1672626173,3512
3454,3792072681,3889780657,1672550188,1672551931,1743
3564,3209481722,3533079336,1672549624,1672552712,3088
3607,3627368399,3855583256,1672594764,1672595781,1017
3636,3448633776,3500672156,1672616587,1672616777,190
3482,3205923620,3351696332,1672683813,1672684894,1081
3453,3685816610,3776518452,1672563556,1672564051,495
3827,3369708250,3829822608,1672612423,1672613093,670
3789,3935399379,3927165965,1672567719,1672571189,3470
3675,3534179433,3517358573,1672653795,1672654165,370
3501,3357289672,3618354185,1672580713,1672582271,1558
3568,3488763230,3501121099,1672619923,1672623505,3582
3778,3774290799,3294703680,1672651955,1672654137,2182
3661,3400069268,3701664364,1672643236,1672645715,2479
3534,3513410578,3613416045,1672617138,1672618891,1753
3545,3533423872,3270042456,1672653455,1672653757,302
3673,3801645328,3760842815,1672556788,1672557217,429
3501,3436257398,3793583656,1672556354,1672556871,517
3795,3793740407,3520657891,1672585779,1672586431,652
3895,3614740489,3793740407,1672684194,1672685828,1634
3888,3333403880,3780834916,1672598122,1672600796,2674
3591,3499217428,3440107959,1672676623,1672677730,1107
3874,3639050419,3737112297,1672612420,1672613103,683
3858,3777037426,3412006598,1672611273,1672611409,136
3725,3970603231,3437286517,1672608704,1672609668,964
3607,3510554314,3760640999,1672668773,1672669762,989
3760,3248058676,3519818818,1672588093,1672589940,1847
3702,3791796585,3554825448,1672536295,1672537026,731
3606,3443357683,3227799827,1672644322,1672644808,486
3790,3733558985,3773902805,1672591935,1672593069,1134
3433,3855583256,3829822608,1672629495,1672630390,895
3460,3438078818,3760924079,1672632721,1672632898,177
3771,3667427125,3337322736,1672553000,1672555334,2334
3767,3622665543,3623266256,1672667405,1672668127,722
3791,3417191856,3713517039,1672636493,1672637847,1354
3628,3757323954,3300979975,1672599888,1672601390,1502
3822,3926643445,3834631333,1672592100,1672592906,806
3774,3802932312,3618354185,1672568037,1672569347,1310
3733,3928719932,3714067076,1672649602,1672650628,1026
3469,3779738691,3513018485,1672618356,1672619850,1494
3727,3514246749,3779639983,1672571497,1672575058,3561
3696,3713941638,3509893027,1672610372,1672612239,1867
3729,3714185969,3360616538,1672545235,1672547193,1958
3488,3736705719,3927599181,1672646526,1672650006,3480
3633,3424660806,3311085279,1672625285,1672628244,2959
3668,3467779445,3774641380,1672680111,1672681459,1348
3739,3501457103,3927165965,1672560745,1672562614,1869
3907,3824641227,3755065949,1672537797,1672539422,1625
3705,3516489668,3520639768,1672557904,1672560102,2198
3716,3500672156,3414049538,1672647199,1672649109,1910
3666,3902625986,3379143440,1672605013,1672606924,1911
3587,3684523966,3625174002,1672694622,1672695723,1101
3502,3509893027,3520322124,1672590191,1672591787,1596
3531,3500498112,3970558632,1672696631,1672700134,3503
3736,3755532873,3714670620,1672560023,1672561776,1753
3487,3511601997,3513345163,1672598660,1672600898,2238
3737,3779438325,3202141727,1672679214,1672680792,1578
3763,3497095254,3792538417,1672677872,1672681276,3404
3438,3492546679,3716628503,1672540679,1672542216,1537
3463,3774876004,3880926355,1672551605,1672552273,668
3616,3511791953,3613581796,1672620181,1672620912,731
3880,3938389661,3703139663,1672556987,1672558173,1186
3641,3304155815,3509366311,1672554138,1672555291,1153
3739,3517697722,3780115155,1672648366,1672648793,427
3526,3755496114,3927165965,1672690010,1672693277,3267
3734,3440107959,3299781901,1672668682,1672670830,2148
3768,3520873221,3511005395,1672702440,1672702707,267
3570,3513041785,3739661856,1672636114,1672638888,2774
3911,3714185969,3512499658,1672685579,1672686396,817
3598,3462636434,3891672228,1672673735,1672676233,2498
3813,3533079336,3715443333,1672670254,1672673318,3064
3449,3971806004,3505198734,1672542039,1672542257,218
3728,3920898925,3783919913,1672632044,1672634872,2828
3505,3510499038,3514275974,1672655411,1672655632,221
3474,3505725706,3885121158,1672679231,1672681125,1894
3624,3701823816,3734915241,1672546624,1672547554,930
3454,3774733620,3738026330,1672685115,1672687225,2110
3736,3518565331,3315279093,1672608787,1672610489,1702
3619,3829822608,3500341755,1672568115,1672571103,2988
3596,3415833929,3279242917,1672633048,1672634439,1391
3877,3500109249,3739661856,1672626139,1672628823,2684
3616,3783550022,3792525861,1672687098,1672689124,2026
3462,3551389192,3773939399,1672640772,1672641245,473
3766,3889780657,3512958459,1672593340,1672593830,490
3787,3500341755,3351696332,1672639648,1672641195,1547
3852,3814305099,3417679834,1672534407,1672537169,2762
3693,3667427125,3757318448,1672670240,1672670581,341
3797,3200308999,3203538212,1672579521,1672581772,2251
3889,3513360004,3231494505,1672652847,1672653764,917
3465,3446533960,3834963772,1672685618,1672686863,1245
3655,3930242012,3472312341,1672682184,1672683491,1307
3482,3520639768,3701884158,1672634304,1672635055,751
3466,3371455553,3887243870,1672550241,1672550518,277
3613,3232208416,3501215099,1672541849,1672542009,160
3475,3411688875,3800257590,1672697401,1672698174,773
3565,3783373154,3701247948,1672614066,1672616773,2707
3686,3421385957,3755756564,1672648368,1672649862,1494
3834,3774876004,3428027649,1672616023,1672617131,1108
3681,3755344363,3701373490,1672570382,1672573030,2648
3571,3916490839,3773913680,1672604105,1672605567,1462
3522,3773027597,3236354255,1672672461,1672672992,531
3804,3715707380,3505634634,1672645003,1672647803,2800
3789,3418448389,3626499450,1672553953,1672554991,1038
3424,3756625818,3296462324,1672545926,1672547585,1659
3899,3509366311,3511024016,1672579962,1672580097,135
3488,3902760230,3715545685,1672677609,1672681200,3591
3534,3715854030,3736705719,1672573171,1672575702,2531
3452,3514246749,3400069268,1672628392,1672630527,2135
3582,3660887799,3793922324,1672543693,1672545303,1610
3508,3755065949,3780253901,1672634783,1672638311,3528
3675,3715974659,3232208416,1672609573,1672612817,3244
3845,3236458894,3270697740,1672572661,1672574203,1542
3674,3511791953,3310039260,1672534008,1672534969,961
3897,3462158237,3505179890,1672678517,1672682029,3512
3656,3685681577,3710008361,1672539882,1672542094,2212
3584,3500827202,3621184108,1672609758,1672610825,1067
3576,3793883863,3617392620,1672621023,1672624571,3548
3488,3351866415,3792389522,1672606163,1672608837,2674
3458,3783163143,3970909253,1672672509,1672673814,1305
3654,3777330107,3513296868,1672621488,1672624516,3028
3785,3779938251,3515525630,1672656989,1672657289,300
3459,3279242917,3289114629,1672562070,1672565654,3584
3921,3783550022,3517222913,1672700970,1672704146,3176
3871,3774641380,3825881598,1672636852,1672639058,2206
3652,3770624662,3898314440,1672632024,1672632811,787
3612,3403370192,3309314379,1672540451,1672540620,169
3738,3401940259,3513360004,1672658100,1672659258,1158
3752,3714067076,3500709774,1672646830,1672649792,2962
3561,3783163143,3620292035,1672572435,1672572548,113
3716,3501215099,3385323994,1672544186,1672545637,1451
3908,3783801141,3500317969,1672673354,1672675180,1826
3789,3713941638,3818575661,1672610672,1672611485,813
3509,3777184389,3517881647,1672658874,1672661780,2906
3472,3500777439,3613899351,1672618375,1672618653,278
3676,3366423342,3272096759,1672594888,1672598245,3357
3442,3904412440,3248058676,1672554203,1672556507,2304
3610,3757294769,3927599181,1672600792,1672602465,1673
3799,3826238375,3310125159,1672619426,1672622866,3440
3892,3777694660,3895285664,1672660137,1672660462,325
3499,3240394404,3891672228,1672577689,1672578949,1260
3757,3783163143,3885155975,1672636388,1672637400,1012
3833,3814677862,3774718695,1672661708,1672664496,2788
3729,3979784676,3488763230,1672540033,1672542784,2751
3863,3500498112,3777624586,1672693765,1672695322,1557
3486,3418448389,3779465522,1672691238,1672692168,930
3597,3757318448,3513410578,1672622376,1672625795,3419
3441,3505111292,3271454397,1672569950,1672572646,2696
3476,3932478321,3551389192,1672673754,1672677309,3555
3535,3533929349,3778640261,1672561279,1672562242,963
3870,3609113156,3778899160,1672680196,1672683360,3164
3794,3760924079,3424445495,1672582795,1672585724,2929
3569,3714827719,3777814504,1672553596,1672556593,2997
3722,3757700712,3714670620,1672571220,1672574700,3480
3878,3357689359,3519446663,1672701316,1672701525,209
3723,3500613493,3244004456,1672650708,1672651915,1207
3556,3519416013,3774733620,1672652482,1672653129,647
3816,3779425804,3777330107,1672683316,1672684841,1525
3541,3928719932,3714067076,1672657255,1672659242,1987
3454,3713941638,3660887799,1672647831,1672651294,3463
3857,3516489668,3559731671,1672678161,1672681668,3507
3622,3517991730,3715619259,1672695444,1672695581,137
3807,3814305099,3852533643,1672566518,1672569986,3468
3703,3793315718,3467988782,1672675337,1672678558,3221
3608,3485540729,3500613493,1672637619,1672639607,1988
3835,3852533643,3755222916,1672537729,1672539569,1840
3905,3311049964,3500672156,1672633860,1672634492,632
3891,3517462308,3930242012,1672611150,1672611341,191
3761,3447672935,3914691363,1672559649,1672560589,940
3686,3686227677,3774605761,1672678264,1672679591,1327
3624,3713300120,3505154885,1672660795,1672664317,3522
3881,3617392620,3373028638,1672557127,1672557685,558
3582,3701424609,3514703118,1672533151,1672535804,2653
3825,3500841914,3509756823,1672577522,1672578130,608
3590,3793781065,3501567772,1672644884,1672648135,3251
3540,3791796585,3792538417,1672701803,1672702024,221
3738,3294747828,3793868716,1672615233,1672617062,1829
3710,3899786664,3711637255,1672699387,1672702079,2692
3534,3520181148,3739661856,1672588601,1672589102,501
3885,3514246749,3514285803,1672578461,1672580900,2439
3697,3792525861,3248058676,1672645883,1672649355,3472
3487,3902760230,3414275042,1672620512,1672620825,313
3886,3711734586,3457960571,1672658497,1672659563,1066
3822,3276003502,3370227921,1672670138,1672673535,3397
3608,3236499444,3780834916,1672634062,1672635930,1868
3855,3533274994,3201800997,1672690982,1672694062,3080
3671,3457960571,3554186380,1672653286,1672655338,2052
3727,3488686442,3605221116,1672681129,1672682380,1251
3912,3518653080,3520578796,1672622059,1672622279,220
3754,3621461051,3337322736,1672564252,1672566045,1793
3527,3779639983,3792489602,1672545238,1672545900,662
3814,3899786664,3808136029,1672702342,1672704754,2412
3506,3380982774,3491684096,1672622457,1672625084,2627
3452,3500525825,3371455553,1672611684,1672613588,1904
3523,3623266256,3334993594,1672660708,1672664151,3443
3804,3516444201,3780322355,1672552923,1672553855,932
3918,3429943738,3777091903,1672607896,1672609323,1427
3715,3664943873,3757700712,1672646622,1672649759,3137
3763,3776559988,3338083680,1672541462,1672542398,936
3557,3755737419,3514512367,1672636708,1672640245,3537
3677,3778640261,3520873221,1672594798,1672597214,2416
3886,3457960571,3792014516,1672670361,1672671785,1424
3913,3236458894,3701322924,1672567839,1672570728,2889
3694,3513041785,3909094917,1672619871,1672620735,864
3759,3357864626,3454277788,1672615719,1672616688,969
3840,3520560590,3773332082,1672615075,1672616299,1224
3845,3551389192,3711097754,1672644144,1672644408,264
3509,3778667336,3893912331,1672561567,1672562158,591
3618,3625463628,3715974659,1672552568,1672553965,1397
3491,3462158237,3300818269,1672561407,1672561792,385
3605,3517881647,3517991730,1672698505,1672700098,1593
3734,3755222916,3224330592,1672566241,1672569434,3193
3506,3505521218,3774243020,1672582955,1672586130,3175
3517,3711006062,3311085279,1672601360,1672603978,2618
3833,3780253901,3756704774,1672619789,1672622949,3160
3896,3928511283,3792525861,1672544737,1672545456,719
3680,3935487534,3779438325,1672628874,1672629067,193
3470,3773913680,3394297564,1672644638,1672648072,3434
3518,3533004959,3617489344,1672613655,1672614906,1251
3885,3772391882,3236499444,1672606785,1672609985,3200
3428,3714185969,3620292035,1672642090,1672642672,582
3852,3638660068,3414940786,1672613177,1672615121,1944
3426,3200308999,3638204468,1672641945,1672643679,1734
3696,3308760650,3632814465,1672685043,1672687212,2169
3884,3509483172,3756127300,1672556701,1672556761,60
3591,3516298579,3435116799,1672653460,1672656707,3247
3431,3513018485,3505481368,1672586426,1672589775,3349
3794,3519028898,3636329663,1672644612,1672645149,537
3885,3791128487,3610870949,1672587703,1672590330,2627
3721,3756789525,3618489670,1672702380,1672705300,2920
3895,3347419520,3462158237,1672648428,1672650182,1754
3488,3773124276,3776034743,1672683369,1672685517,2148
3844,3311498666,3519909393,1672553355,1672556204,2849
3539,3710496785,3514285803,1672608424,1672610361,1937
3904,3711853996,3739911441,1672693352,1672696373,3021
3525,3773913680,3914691363,1672677343,1672679106,1763
3580,3755756564,3429943738,1672575891,1672576637,746
3666,3792389522,3757193551,1672668865,1672672292,3427
3665,3515559913,3852686295,1672622947,1672625861,2914
3485,3780712350,3792745809,1672599852,1672601957,2105
3657,3296462324,3928511283,1672534844,1672536980,2136
3564,3517697722,3400069268,1672599991,1672600354,363
3623,3343816795,3779854934,1672595702,1672598054,2352
3713,3710315160,3500341755,1672619168,1672620185,1017
3457,3519651506,3311498666,1672540214,1672542383,2169
3744,3511601997,3713829743,1672563501,1672566905,3404
3778,3488686442,3825881598,1672668898,1672669605,707
3507,3276348699,3367111751,1672699922,1672701810,1888
3784,3232208416,3428725843,1672611609,1672611796,187
3510,3387594369,3505283390,1672697885,1672700828,2943
3510,3682133690,3792949946,1672589205,1672589688,483
3855,3467988782,3551389192,1672575088,1672575677,589
3680,3783928182,3774155692,1672599828,1672600515,687
3664,3294703680,3514324011,1672626445,1672627098,653
3695,3447672935,3294703680,1672625794,1672627021,1227
3468,3855583256,3829864515,1672699350,1672701653,2303
3827,3500109249,3617304541,1672670478,1672671530,1052
3826,3556969573,3478114114,1672588227,1672589256,1029
3863,3779892400,3533423872,1672682476,1672684609,2133
3761,3931627862,3228888030,1672633890,1672636835,2945
3605,3505807416,3226511603,1672633420,1672635088,1668
3448,3380982774,3447672935,1672653870,1672656932,3062
3577,3520355798,3229974066,1672597011,1672600192,3181
3687,3734118023,3710735406,1672686261,1672686843,582
3544,3783340788,3793743698,1672619763,1672622567,2804
3629,3276217799,3621184108,1672609251,1672611632,2381
3739,3824215187,3825881598,1672672858,1672674202,1344
3687,3792546035,3534566651,1672577608,1672579758,2150
3507,3661903000,3414049538,1672631843,1672632992,1149
3838,3783801141,3416987084,1672568930,1672570865,1935
3686,3533649454,3457960571,1672690192,1672690388,196
3662,3714120857,3305336154,1672660791,1672662148,1357
3588,3792546035,3885157459,1672628561,1672631394,2833
3922,3497671225,3900898992,1672703888,1672704167,279
3531,3895285664,3923220461,1672583295,1672586639,3344
3448,3713691388,3559731671,1672580645,1672583954,3309
3614,3519446663,3779425804,1672547284,1672548465,1181
3674,3500827202,3755344363,1672566558,1672569304,2746
3801,3370068529,3773121782,1672616283,1672617491,1208
3453,3773121782,3661903000,1672626315,1672627543,1228
3517,3293835352,3513410578,1672662311,1672662578,267
3492,3518561777,3505437712,1672683720,1672684209,489
3822,3711853996,3834963772,1672533885,1672536040,2155
3780,3505179890,3635169815,1672612175,1672613969,1794
3775,3756385685,3284947372,1672590888,1672593749,2861
3445,3826238375,3902760230,1672653086,1672653971,885
3851,3711812325,3923754072,1672686687,1672689068,2381
3795,3374183227,3904412440,1672654052,1672656595,2543
3612,3714827719,3791106564,1672645173,1672646089,916
3871,3505663516,3228888030,1672534319,1672537396,3077
3809,3774031303,3772078494,1672697697,1672701114,3417
3656,3701884158,3517991730,1672637215,1672639010,1795
3887,3715619259,3791796585,1672688975,1672691598,2623
3701,3516444201,3891672228,1672589639,1672590293,654
3843,3334993594,3689697817,1672599009,1672600968,1959
3832,3518229776,3689697817,1672611201,1672612954,1753
3735,3713768950,3834631333,1672543033,1672545911,2878
3611,3206837348,3421877923,1672569988,1672571157,1169
3576,3505111292,3923754072,1672590406,1672593627,3221
3713,3770146716,3224968597,1672557477,1672557947,470
3576,3271752081,3518561777,1672640254,1672641749,1495
3729,3625463628,3792389522,1672611240,1672612869,1629
3843,3505923418,3441703884,1672618650,1672619851,1201
3705,3495911207,3630353876,1672653965,1672654540,575
3479,3935487534,3734118023,1672551034,1672551777,743
3908,3513296868,3409114719,1672605956,1672608642,2686
3850,3511843593,3443357683,1672609229,1672610744,1515
3829,3739911441,3554186380,1672613701,1672613781,80
3707,3777779869,3396726504,1672683900,1672686868,2968
3498,3428027649,3511791953,1672543397,1672546865,3468
3708,3409114719,3360069849,1672646448,1672649332,2884
3765,3389634034,3880926355,1672538144,1672541077,2933
3489,3519282716,3636329663,1672584489,1672584794,305
3863,3760094385,3452016771,1672579534,1672580749,1215
3431,3756746867,3711006062,1672681429,1672683997,2568
3648,3514818819,3778640261,1672534905,1672536359,1454
3521,3617304541,3505154885,1672656996,1672659788,2792
3744,3776988674,3312998540,1672642923,1672643660,737
3669,3533649454,3626499450,1672589798,1672590437,639
3465,3493017654,3703139663,1672621420,1672624458,3038
3545,3556969573,3880926355,1672613609,1672617155,3546
3467,3819767045,3900276517,1672665626,1672666351,725
3485,3779892400,3519077659,1672533619,1672533941,322
3459,3808136029,3520639768,1672653227,1672653530,303
3817,3298151889,3609933747,1672672079,1672675298,3219
3594,3793315718,3779438325,1672694649,1672694876,227
3783,3501525100,3711006062,1672702890,1672706361,3471
3909,3773121782,3505228454,1672572225,1672574540,2315
3445,3284932450,3811075491,1672666248,1672669331,3083
3733,3812369928,3617392620,1672628412,1672628977,565
3778,3760094385,3793935736,1672556433,1672559727,3294
3826,3514818819,3410600350,1672675145,1672677193,2048
3622,3299781901,3392520516,1672591399,1672591972,573
3665,3920497528,3384068080,1672599771,1672602241,2470
3739,3792538417,3505521218,1672575246,1672576571,1325
3590,3350095157,3410600350,1672548847,1672550702,1855
3560,3819767045,3533228966,1672628584,1672630217,1633
3517,3850911686,3305722859,1672600243,1672602049,1806
3677,3500302272,3385323994,1672657069,1672657865,796
3802,3608855425,3334647380,1672607151,1672608096,945
3600,3205985903,3513018485,1672589854,1672593044,3190
3589,3615113018,3517697722,1672620885,1672622362,1477
3544,3686523546,3815392801,1672559653,1672561080,1427
3590,3276003502,3733558985,1672617094,1672619990,2896
3792,3497095254,3554944414,1672686696,1672687112,416
3887,3711097754,3826238375,1672643850,1672646188,2338
3747,3710562338,3505154885,1672664296,1672664732,436
3463,3701882224,3716110860,1672656263,1672659003,2740
3697,3338390596,3533747868,1672672853,1672675154,2301
3457,3505283390,3470454332,1672674697,1672676336,1639
3678,3357689359,3701247948,1672543977,1672546658,2681
3547,3364726656,3517687662,1672560174,1672562374,2200
3692,3511317276,3232208416,1672693509,1672694911,1402
3542,3518653080,3791753345,1672603216,1672605190,1974
3887,3509483172,3714678331,1672693332,1672696380,3048
3434,3757383891,3783919913,1672696517,1672698446,1929
3543,3533929349,3285204083,1672633763,1672637324,3561
3652,3818575661,3897376951,1672531754,1672534035,2281
3828,3760362417,3500915665,1672668357,1672668500,143
3919,3497095254,3556969573,1672687946,1672691034,3088
3858,3421385957,3300511067,1672557799,1672558317,518
3460,3757075324,3271752081,1672580431,1672580721,290
3732,3435167810,3445206685,1672610210,1672612351,2141
3663,3735374579,3512502036,1672642747,1672643591,844
3547,3245232284,3505847380,1672623107,1672623724,617
3558,3715385401,3501567772,1672688109,1672690880,2771
3651,3500302272,3739154408,1672678254,1672679109,855
3863,3814677862,3815392801,1672617289,1672619494,2205
3920,3613206049,3520115090,1672570669,1672573483,2814
3455,3930242012,3701247948,1672649827,1672651388,1561
3858,3436257398,3305722859,1672674908,1672676560,1652
3717,3711853996,3774605761,1672556952,1672559179,2227
3605,3934064792,3777814504,1672531784,1672532062,278
3443,3452016771,3512392431,1672545153,1672546295,1142
3444,3500703304,3495911207,1672589610,1672592818,3208
3788,3497671225,3300229945,1672617246,1672618765,1519
3837,3636329663,3404025196,1672691561,1672692500,939
3572,3898314440,3403370192,1672687518,1672688895,1377
3881,3512946768,3703383853,1672676096,1672676520,424
3839,3520657891,3791128487,1672606922,1672608444,1522
3582,3511150845,3373028638,1672571334,1672574355,3021
3691,3360616538,3510818674,1672596276,1672596809,533
3543,3505437712,3417679834,1672680403,1672681741,1338
3786,3431460073,3514308235,1672641911,1672645351,3440
3512,3715443333,3310125159,1672638008,1672641014,3006
3786,3711218296,3394401087,1672595661,1672598442,2781
3750,3514285803,3519850727,1672544251,1672545837,1586
3884,3505434346,3394401087,1672702447,1672702827,380
3721,3823084403,3276348699,1672627642,1672629312,1670
3737,3534764451,3780712350,1672563946,1672565732,1786
3782,3203538212,3241790910,1672691012,1672692804,1792
3493,3421385957,3364726656,1672606335,1672608852,2517
3888,3800257590,3446533960,1672587318,1672588622,1304
3879,3305336154,3621461051,1672639439,1672641758,2319
3581,3394297564,3779854934,1672619304,1672621086,1782
3884,3770676872,3533228966,1672592452,1672595016,2564
3436,3774290799,3612689556,1672667477,1672671044,3567
3589,3858172636,3520355798,1672689826,1672690885,1059
3496,3711853996,3609113156,1672647818,1672649496,1678
3630,3710562338,3490029863,1672699740,1672702616,2876
3874,3517172354,3755532873,1672639272,1672641848,2576
3644,3779639983,3505402439,1672576988,1672578279,1291
3515,3441703884,3514334067,1672641634,1672644173,2539
3642,3835985172,3519850727,1672606082,1672607935,1853
3715,3856606678,3829864515,1672674218,1672677501,3283
3655,3200308999,3512392431,1672578747,1672581741,2994
3891,3520416075,3737112297,1672655586,1672658872,3286
3488,3371455553,3519077659,1672569217,1672570844,1627
3816,3274831810,3755404116,1672658895,1672659773,878
3865,3533929349,3500915665,1672572887,1672573610,723
3620,3780427126,3500737582,1672632262,1672633273,1011
3533,3512383699,3293835352,1672640873,1672642574,1701
3855,3793969543,3856606678,1672651158,1672653591,2433
3824,3511288998,3739911441,1672604791,1672606114,1323
3842,3793583656,3689697817,1672570386,1672573532,3146
3720,3519416013,3357864626,1672636281,1672639673,3392
3733,3938389661,3279475486,1672535856,1672539202,3346
3722,3900276517,3638660068,1672622031,1672622877,846
3820,3777091903,3533294425,1672562023,1672562399,376
3700,3783771827,3500672156,1672610237,1672613335,3098
3776,3390660440,3613416045,1672667845,1672668310,465
3472,3389634034,3534357694,1672639435,1672642365,2930
3551,3776084820,3732584121,1672619644,1672622677,3033
3534,3511442562,3713300120,1672665797,1672669084,3287
3806,3618808151,3621683102,1672629687,1672632021,2334
3814,3292147449,3311098437,1672654252,1672656670,2418
3767,3492959689,3714678331,1672539018,1672542547,3529
3593,3734118023,3928719932,1672553184,1672555903,2719
3899,3299781901,3711853996,1672591661,1672594322,2661
3732,3970198861,3779613523,1672633358,1672634572,1214
3491,3337362061,3757294769,1672632866,1672635208,2342
3431,3333918941,3760362417,1672575588,1672578462,2874
3881,3853629553,3661447322,1672596340,1672598394,2054
3755,3600876425,3777184389,1672585596,1672586567,971
3819,3792538417,3792389522,1672649600,1672651074,1474
3532,3739911441,3714827719,1672574117,1672576911,2794
3771,3664943873,3770704999,1672667002,1672669817,2815
3718,3711218296,3279473441,1672630223,1672632589,2366
3463,3899326793,3369708250,1672555566,1672557270,1704
3540,3517600136,3354144091,1672683722,1672684984,1262
3793,3715619259,3519087371,1672555174,1672557085,1911
3723,3600876425,3429943738,1672643527,1672646203,2676
3781,3462636434,3711637255,1672564298,1672566402,2104
3908,3439673892,3783520186,1672578195,1672578590,395
3757,3688220326,3500604680,1672573016,1672575952,2936
3644,3517222913,3240394404,1672542693,1672545222,2529
3870,3511843593,3733363628,1672690073,1672692017,1944
3514,3912891315,3760040019,1672532205,1672535771,3566
3449,3347419520,3710489491,1672610644,1672611280,636
3703,3793969543,3667427125,1672541394,1672542147,753
3640,3791753345,3511732493,1672703157,1672706154,2997
3610,3934064792,3244004456,1672591339,1672594298,2959
3848,3515401243,3834960360,1672702130,1672705210,3080
3586,3333403880,3519282716,1672660770,1672662178,1408
3759,3410600350,3793407963,1672637741,1672637863,122
3639,3437286517,3779646172,1672677318,1672680209,2891
3661,3279242917,3424445495,1672614492,1672617907,3415
3715,3533188828,3501786419,1672609594,1672613094,3500
3808,3311498666,3757903168,1672632176,1672634884,2708
3653,3520873221,3807212280,1672636496,1672639233,2737
3625,3366423342,3783641602,1672532079,1672533633,1554
3762,3739895284,3519446663,1672535099,1672535231,132
3802,3364378127,3757630221,1672700671,1672703318,2647
3520,3622665543,3230868435,1672627905,1672630707,2802
3626,3551389192,3370068529,1672650649,1672651619,970
3752,3714120857,3343132529,1672584388,1672586611,2223
3915,3624297844,3914691363,1672613546,1672616996,3450
3718,3492959689,3298151889,1672656151,1672656278,127
3524,3778134418,3905899155,1672672202,1672673507,1305
3735,3299125059,3500498112,1672531517,1672532885,1368
3466,3383138270,3311085279,1672572167,1672573432,1265
3583,3793583656,3776034743,1672552824,1672556178,3354
3448,3400069268,3414049538,1672677968,1672679635,1667
3480,3401496246,3299443125,1672628580,1672628954,374
3673,3467988782,3755222916,1672533437,1672534495,1058
3569,3739154408,3755496114,1672558972,1672560316,1344
3432,3367111751,3276217799,1672643239,1672644492,1253
3568,3773124276,3755756564,1672544188,1672546520,2332
3667,3533929349,3755848152,1672631498,1672633113,1615
3612,3638660068,3668747074,1672605513,1672608118,2605
3912,3513345163,3609659642,1672626569,1672627395,826
3906,3559731671,3780209375,1672684746,1672685617,871
3673,3456430614,3774790271,1672592921,1672595820,2899
3771,3418448389,3620292035,1672591570,1672591695,125
3500,3511024016,3201629017,1672594972,1672595178,206
3655,3515890966,3505634634,1672697961,1672699287,1326
3868,3923754072,3272030610,1672544928,1672546265,1337
3644,3633735593,3739154408,1672542096,1672543507,1411
3612,3802932312,3716679950,1672601721,1672604156,2435
3587,3617392620,3783928182,1672683887,1672687309,3422
3558,3774733620,3609113156,1672686692,1672687055,363
3606,3614740489,3554944414,1672542559,1672543110,551
3441,3811040565,3927403123,1672532993,1672536148,3155
3791,3811040565,3839245934,1672556499,1672556819,320
3486,3315703693,3338083680,1672666265,1672669373,3108
3697,3778926763,3755848152,1672596230,1672598338,2108
3745,3817813340,3703348097,1672592202,1672593342,1140
3464,3404025196,3711006062,1672675408,1672678020,2612
3683,3428725843,3779892400,1672561239,1672562961,1722
3568,3825881598,3303410628,1672547956,1672550417,2461
3596,3701664364,3448633776,1672688727,1672691889,3162
3642,3770624662,3685681577,1672626710,1672629121,2411
3880,3493017654,3534764451,1672561617,1672565153,3536
3630,3500915908,3701247948,1672620468,1672621482,1014
3738,3229974066,3736231757,1672608661,1672610072,1411
3819,3500442734,3514956366,1672692734,1672694791,2057
3769,3780338697,3350095157,1672651064,1672653079,2015
3631,3627368399,3688796737,1672620765,1672624255,3490
3462,3467779445,3462636434,1672694245,1672694900,655
3687,3710048469,3510964997,1672700627,1672701387,760
3552,3815250107,3756789525,1672542761,1672545817,3056
3454,3493017654,3514285803,1672594911,1672598377,3466
3854,3349856820,3855583256,1672597694,1672599716,2022
3508,3778667336,3457620713,1672608082,1672610375,2293
3876,3501525100,3791613604,1672638374,1672640350,1976
3767,3760842815,3516703758,1672698068,1672699034,966
3834,3791246640,3505847380,1672672296,1672672962,666
3685,3385323994,3229822507,1672596164,1672597711,1547
3552,3300511067,3639050419,1672533882,1672537092,3210
3851,3220031931,3793743698,1672646507,1672649806,3299
3542,3501384020,3270056120,1672556891,1672558024,1133
3473,3780769110,3852533643,1672669214,1672670909,1695
3810,3757318448,3731646673,1672698168,1672700768,2600
3480,3812369928,3510641433,1672555330,1672558169,2839
3638,3229822507,3501457103,1672628862,1672629466,604
3638,3777779869,3480100311,1672675336,1672675836,500
3710,3492546679,3239617320,1672620835,1672622162,1327
3597,3534764451,3452016771,1672649527,1672650378,851
3761,3412968120,3638660068,1672634635,1672635054,419
3493,3517887477,3895285664,1672609008,1672611685,2677
3728,3779854934,3511005395,1672536070,1672536569,499
3496,3315279093,3429943738,1672623390,1672624448,1058
3589,3469254160,3201800997,1672580969,1672583069,2100
3897,3783550022,3202804048,1672665977,1672667206,1229
3501,3519909393,3776034743,1672582902,1672586417,3515
3607,3774605761,3270042456,1672676626,1672677302,676
3844,3885157459,3623266256,1672673850,1672674113,263
3849,3615688740,3793883863,1672532433,1672533788,1355
3477,3228888030,3518229776,1672574208,1672577515,3307
3473,3636329663,3239617320,1672600491,1672601146,655
3746,3220031931,3492959689,1672561780,1672562524,744
3718,3227799827,3424445495,1672700963,1672704482,3519
3611,3505807416,3773027597,1672667542,1672671068,3526
3887,3783520186,3514741348,1672604968,1672605640,672
3578,3776117322,3778899160,1672541632,1672544765,3133
3599,3399518841,3732131656,1672653474,1672655084,1610
3661,3509764635,3300818269,1672702634,1672704632,1998
3698,3533747868,3713300120,1672692470,1672693965,1495
3562,3612689556,3495911207,1672671644,1672672157,513
3880,3205985903,3783340788,1672616227,1672618108,1881
3908,3500737582,3772765746,1672689913,1672692715,2802
3734,3710315160,3715443333,1672698231,1672698492,261
3703,3488686442,3224968597,1672689095,1672689793,698
3516,3732584121,3824641227,1672654259,1672654966,707
3841,3780872464,3755756564,1672611813,1672614389,2576
3538,3333403880,3821054646,1672646586,1672648609,2023
3673,3735374579,3534543776,1672580257,1672581337,1080
3701,3833217041,3354144091,1672655592,1672658237,2645
3429,3228888030,3734915241,1672575652,1672577001,1349
3526,3776559988,3511005395,1672636717,1672637475,758
3589,3519142371,3703798634,1672552744,1672554058,1314
3704,3780253901,3710562338,1672608295,1672611537,3242
3454,3610358027,3289114629,1672577353,1672580611,3258
3860,3299443125,3926643445,1672542465,1672544315,1850
3567,3736705719,3716272919,1672567848,1672568285,437
3610,3979784676,3533274994,1672548199,1672548270,71
3670,3772236797,3232208416,1672647466,1672648440,974
3476,3931627862,3792442597,1672598261,1672599987,1726
3751,3364378127,3680810086,1672689285,1672691113,1828
3719,3774290799,3779786641,1672542673,1672543584,911
3599,3821054646,3915162005,1672569836,1672572362,2526
3600,3392520516,3467988782,1672617707,1672620487,2780
3512,3783919913,3518561777,1672652881,1672654737,1856
3428,3203538212,3715986185,1672582184,1672584210,2026
3425,3515401243,3779613523,1672679071,1672680725,1654
3772,3778134418,3517737088,1672593735,1672595607,1872
3708,3505995057,3438078818,1672689159,1672689752,593
3617,3516703758,3778926763,1672670997,1672673063,2066
3784,3817813340,3791046864,1672609744,1672613003,3259
3426,3334951866,3245232284,1672647668,1672649376,1708
3766,3511601997,3315279093,1672633182,1672634613,1431
3604,3511601997,3824641227,1672544652,1672545754,1102
3492,3927599181,3974674109,1672555417,1672558922,3505
3913,3904867554,3481640525,1672575889,1672577366,1477
3530,3363162590,3387594369,1672584672,1672585340,668
3561,3604867757,3500672156,1672549135,1672550634,1499
3511,3512722110,3835422146,1672640325,1672643844,3519
3806,3374183227,3500442734,1672663990,1672667338,3348
3513,3710489491,3396726504,1672672495,1672673868,1373
3713,3451326054,3792442597,1672602936,1672605103,2167
3874,3306412634,3472068734,1672582626,1672585888,3262
3748,3552824113,3440137407,1672674705,1672677977,3272
3731,3792949946,3773332082,1672572454,1672574897,2443
3863,3513081354,3756789525,1672660995,1672663238,2243
3845,3755233658,3730071479,1672598298,1672601115,2817
3527,3440137407,3245232284,1672603432,1672603828,396
3498,3557046880,3533649454,1672618214,1672618814,600
3622,3240394404,3280054198,1672534432,1672537937,3505
3674,3513360004,3509366311,1672572046,1672572784,738
3861,3734451191,3518194482,1672617408,1672617813,405
3441,3468041839,3735374579,1672623868,1672625590,1722
3540,3411515369,3928511283,1672703227,1672704330,1103
3907,3336339664,3500072204,1672606901,1672608550,1649
3718,3779892400,3516489668,1672668732,1672669948,1216
3591,3780680950,3688796737,1672570795,1672572807,2012
3542,3380767040,3739911441,1672690527,1672692103,1576
3569,3274906650,3366423342,1672658477,1672659789,1312
3574,3205985903,3368283077,1672691208,1672692302,1094
3636,3783433404,3520991398,1672636623,1672637496,873
3689,3443357683,3367111751,1672535566,1672535870,304
3564,3783771827,3635169815,1672701176,1672704705,3529
3633,3500347447,3755992176,1672651873,1672653959,2086
3619,3774243020,3715400486,1672629615,1672631011,1396
3842,3289114629,3772391882,1672598989,1672602155,3166
3509,3500703304,3370227921,1672686794,1672688541,1747
3714,3773735484,3607882826,1672533151,1672534732,1581
3701,3315703693,3395201292,1672595258,1672596404,1146
3649,3551389192,3730071479,1672548305,1672550049,1744
3642,3513410578,3835422146,1672656365,1672658137,1772
3882,3783163143,3792389522,1672603139,1672604539,1400
3447,3202141727,3776831527,1672602938,1672603866,928
3756,3685681577,3208957949,1672680051,1672682804,2753
3830,3897376951,3360616538,1672546740,1672548302,1562
3795,3778640261,3512383699,1672562749,1672564724,1975
3645,3520873221,3977148669,1672586640,1672588950,2310
3662,3779854934,3209526819,1672623442,1672624649,1207
3596,3559731671,3505888598,1672549428,1672551822,2394
3425,3512499658,3438078818,1672603766,1672605301,1535
3516,3773124276,3856606678,1672645350,1672647187,1837
3773,3783433404,3778040015,1672589565,1672593099,3534
3724,3891672228,3347419520,1672640398,1672640666,268
3577,3337362061,3224330592,1672614000,1672615624,1624
3906,3499217428,3505847380,1672575954,1672576497,543
3482,3248058676,3732131656,1672693464,1672696559,3095
3472,3778040015,3446533960,1672584972,1672588472,3500
3528,3776244398,3446533960,1672669461,1672670182,721
3643,3686227677,3505663516,1672549800,1672551204,1404
3542,3927599181,3755222916,1672675543,1672678390,2847
3775,3859868849,3715127070,1672548054,1672548165,111
3446,3793935736,3438489358,1672558551,1672559494,943
3835,3972083617,3310125159,1672547562,1672548018,456
3721,3792949946,3382733096,1672547176,1672547755,579
3886,3438489358,3487875183,1672536826,1672540368,3542
3909,3618354185,3735374579,1672589523,1672591053,1530
3579,3773735484,3485540729,1672637057,1672638393,1336
3553,3667427125,3512502036,1672617704,1672619796,2092
3768,3505228454,3375449013,1672582604,1672582894,290
3806,3731646673,3713163045,1672621215,1672622987,1772
3874,3770520359,3808136029,1672568253,1672570078,1825
3749,3226511603,3637313265,1672594135,1672595855,1720
3900,3334974375,3384583385,1672699323,1672702754,3431
3859,3792949946,3912891315,1672669079,1672671687,2608
3870,3909094917,3701107228,1672659049,1672660891,1842
3570,3363162590,3776988674,1672567775,1672568191,416
3501,3737147209,3375449013,1672645067,1672645626,559
3600,3739661856,3510798825,1672655586,1672658333,2747
3608,3713691388,3814305099,1672641081,1672643805,2724
3877,3534357694,3793922324,1672613825,1672615111,1286
3552,3398731252,3792745809,1672701997,1672703258,1261
3719,3241790910,3755737419,1672538531,1672540423,1892
3855,3604589802,3757294769,1672696094,1672699463,3369
3820,3505437712,3510919821,1672546008,1672546741,733
3532,3514703118,3510919821,1672647240,1672649836,2596
3767,3514324011,3513041785,1672543640,1672544831,1191
3768,3617392620,3689114185,1672697244,1672699562,2318
3759,3534829213,3500498112,1672605713,1672607375,1662
3491,3450286949,3668533536,1672558987,1672561974,2987
3766,3716628503,3770146716,1672606259,1672608707,2448
3496,3559731671,3755737419,1672604868,1672607981,3113
3496,3337322736,3519282716,1672614621,1672617073,2452
3853,3831586487,3776831527,1672669518,1672672085,2567
3510,3835985172,3232208416,1672626762,1672626970,208
3900,3509764635,3773009828,1672697176,1672697487,311
3667,3892304880,3501215099,1672663329,1672665141,1812
3878,3714185969,3337322736,1672686529,1672688158,1629
3493,3701373490,3334951866,1672600282,1672600826,544
3670,3394297564,3520873221,1672677089,1672677962,873
3590,3755496114,3472068734,1672682128,1672685189,3061
3590,3417191856,3497095254,1672653766,1672654999,1233
3426,3279473441,3783550022,1672648806,1672651048,2242
3794,3938389661,3715619259,1672563410,1672563759,349
3485,3773124276,3513360004,1672659051,1672660307,1256
3436,3288224595,3500208903,1672619004,1672620497,1493
3592,3492959689,3209481722,1672628587,1672630862,2275
3616,3760364383,3755573472,1672679905,1672682437,2532
3489,3428725843,3240394404,1672619542,1672621633,2091
3850,3889780657,3755532873,1672591753,1672593589,1836
3641,3739661856,3459681410,1672614754,1672616870,2116
3917,3622357348,3520873221,1672663561,1672664479,918
3617,3380767040,3614740489,1672621419,1672622655,1236
3871,3520355798,3518653080,1672629217,1672630968,1751
3519,3447672935,3438078818,1672669541,1672671614,2073
3651,3791441520,3778134418,1672649633,1672652364,2731
3740,3932478321,3512946768,1672658883,1672662263,3380
3505,3206837348,3770146716,1672668080,1672668241,161
3891,3755992176,3338083680,1672677478,1672680303,2825
3440,3791128487,3835422146,1672638101,1672638365,264
3760,3779301501,3480991549,1672700369,1672701986,1617
3886,3488763230,3226511603,1672577486,1672578883,1397
3555,3513295938,3680843171,1672673394,1672674113,719
3697,3511791953,3780427126,1672541856,1672542936,1080
3754,3505111292,3510767239,1672577965,1672581502,3537
3735,3792020993,3783136330,1672607732,1672609593,1861
3821,3276269264,3613581796,1672541773,1672544887,3114
3750,3500672156,3354144091,1672651043,1672653082,2039
3459,3399518841,3801645328,1672584547,1672586687,2140
3898,3357689359,3552824113,1672606957,1672609547,2590
3632,3280054198,3772236797,1672608513,1672611560,3047
3721,3304971369,3438489358,1672613981,1672617515,3534
3608,3412968120,3334974375,1672649924,1672650867,943
3839,3248058676,3500442734,1672661040,1672662507,1467
3483,3457620713,3311085279,1672688564,1672689916,1352
3665,3780253901,3661903000,1672605191,1672605286,95
3637,3800257590,3892304880,1672533130,1672536592,3462
3825,3416987084,3835422146,1672685274,1672687855,2581
3525,3440107959,3757075324,1672696521,1672698372,1851
3518,3834963772,3384583385,1672555760,1672558726,2966
3802,3299781901,3701136026,1672682505,1672682814,309
3908,3417679834,3609881958,1672585130,1672585582,452
3710,3899786664,3402697190,1672668599,1672670157,1558
3475,3288762795,3513410578,1672608953,1672609385,432
3587,3757193307,3755573472,1672613494,1672615904,2410
3798,3316800320,3711077927,1672619444,1672620766,1322
3607,3609659642,3239617320,1672651309,1672652098,789
3800,3800257590,3439673892,1672595544,1672597140,1596
3710,3927165965,3885155975,1672588916,1672590719,1803
3897,3755532873,3270042456,1672672333,1672673522,1189
3464,3431460073,3380982774,1672679257,1672680255,998
3848,3621683102,3783373154,1672674455,1672677493,3038
3818,3711734586,3774876004,1672655482,1672656169,687
3604,3905196766,3688490530,1672574653,1672575666,1013
3474,3311049964,3226024417,1672646011,1672646081,70
3614,3511732493,3293835352,1672605622,1672605947,325
3551,3491469603,3615087943,1672655741,1672656997,1256
3626,3279473441,3715545685,1672631346,1672632311,965
3602,3446533960,3773033649,1672575038,1672578627,3589
3704,3793175445,3493017654,1672578116,1672580943,2827
3605,3619922891,3472312341,1672691450,1672692705,1255
3758,3205923620,3209526819,1672562358,1672564811,2453
3518,3760694096,3975717896,1672549716,1672550324,608
3827,3776084820,3276217799,1672586548,1672589285,2737
3916,3905196766,3938503547,1672640149,1672641023,874
3592,3625463628,3770296583,1672628569,1672631684,3115
3862,3779656423,3791441520,1672547243,1672548564,1321
3502,3791128487,3734915241,1672536249,1672538536,2287
3629,3683113954,3520181148,1672572480,1672575840,3360
3759,3757075324,3793740407,1672691019,1672692609,1590
3760,3513295938,3491469603,1672595279,1672597929,2650
3464,3664943873,3385323994,1672677824,1672680670,2846
3546,3779465522,3283492940,1672582755,1672583922,1167
3470,3756127300,3490214516,1672623735,1672624937,1202
3703,3757332128,3776244398,1672685390,1672686967,1577
3883,3760640999,3609659642,1672652209,1672654407,2198
3537,3236499444,3777485931,1672594969,1672596794,1825
3537,3770676872,3224968597,1672667515,1672668497,982
3643,3791436104,3517600136,1672580751,1672584329,3578
3888,3613206049,3380982774,1672555884,1672556499,615
3442,3417191856,3554944414,1672535903,1672537455,1552
3689,3371455553,3440137407,1672589886,1672590838,952
3497,3792546035,3224330592,1672604268,1672606382,2114
3876,3439673892,3618176292,1672555290,1672558180,2890
3469,3429943738,3974674109,1672685400,1672687816,2416
3438,3614740489,3793781065,1672566411,1672567861,1450
3609,3300511067,3902861231,1672606665,1672608773,2108
3658,3716679950,3500915908,1672556099,1672558404,2305
3757,3505663516,3783801141,1672667032,1672669226,2194
3513,3701373490,3773121782,1672610346,1672613731,3385
3586,3514285803,3404025196,1672635862,1672637544,1682
3645,3821054646,3517462308,1672637474,1672638753,1279
3497,3760651515,3533747868,1672693714,1672694842,1128
3424,3512379024,3621790707,1672561166,1672561935,769
3615,3773027597,3447514821,1672703636,1672706144,2508
3921,3338083680,3774031303,1672573793,1672574520,727
3859,3288224595,3778899160,1672594980,1672598546,3566
3685,3770676872,3684523966,1672561211,1672562659,1448
3452,3279242917,3519651506,1672604637,1672607822,3185
3821,3296462324,3977148669,1672531983,1672532228,245
3911,3684523966,3716963089,1672638413,1672638769,356
3729,3480490124,3534357694,1672600866,1672604176,3310
3529,3227799827,3512946768,1672622693,1672626013,3320
3539,3783520186,3701424609,1672657021,1672659398,2377
3444,3772765746,3890739241,1672638665,1672639898,1233
3567,3500841914,3773572967,1672701833,1672702233,400
3629,3839245934,3512379024,1672663114,1672664189,1075
3922,3610870949,3914691363,1672557829,1672559416,1587
3850,3757332128,3756704774,1672615486,1672618430,2944
3443,3272716462,3920497528,1672547708,1672551146,3438
3913,3357289672,3351866415,1672617814,1672620448,2634
3463,3686523546,3435167810,1672632521,1672634587,2066
3536,3367971170,3505228454,1672538619,1672540364,1745
3737,3510818674,3777779869,1672537112,1672538478,1366
3869,3757348722,3462273042,1672668615,1672669375,760
3568,3780338697,3424660806,1672531970,1672534184,2214
3504,3715400486,3935399379,1672551688,1672551986,298
3512,3421385957,3770704999,1672612332,1672612440,108
3547,3777624586,3369708250,1672605493,1672605611,118
3748,3905196766,3533188828,1672703197,1672705177,1980
3535,3661903000,3779438325,1672660693,1672663568,2875
3446,3778597171,3617392620,1672601946,1672603184,1238
3532,3387594369,3756127300,1672668021,1672670827,2806
3890,3501215099,3431502855,1672640188,1672641425,1237
3786,3520764926,3780909839,1672663435,1672664371,936
3908,3776244398,3776084820,1672622351,1672625287,2936
3897,3424445495,3435167810,1672682183,1672684799,2616
3750,3279475486,3512392431,1672700872,1672702812,1940
3484,3449333754,3294747828,1672676735,1672677410,675
3551,3835985172,3774907131,1672573494,1672575109,1615
3918,3519651506,3760721303,1672556086,1672556541,455
3619,3703396825,3384583385,1672569744,1672572452,2708
3900,3621184108,3774733620,1672679930,1672680952,1022
3609,3621461051,3228888030,1672556448,1672557143,695
3592,3284932450,3337362061,1672621771,1672622891,1120
3809,3774907131,3493017654,1672564380,1672565135,755
3597,3517462308,3793935736,1672640543,1672642927,2384
3521,3505283390,3733363628,1672579009,1672582595,3586
3770,3824641227,3514741348,1672692178,1672695068,2890
3670,3533090502,3892304880,1672640306,1672642376,2070
3586,3513545422,3520560590,1672687580,1672687831,251
3765,3793418209,3927403123,1672616757,1672619584,2827
3606,3710489491,3347419520,1672538242,1672539107,865
3546,3283770991,3500347447,1672692354,1672693251,897
3697,3519282716,3491469603,1672696313,1672697344,1031
3818,3347446226,3516703758,1672591999,1672593131,1132
3805,3829822608,3227799827,1672641140,1672642756,1616
3661,3757863420,3468041839,1672580390,1672581260,870
3658,3607882826,3400763927,1672689359,1672691834,2475
3794,3534179433,3783919913,1672536278,1672537349,1071
3747,3515559913,3520115090,1672638393,1672639506,1113
3902,3517881647,3689114185,1672542215,1672542924,709
3909,3500341755,3516903528,1672695102,1672695562,460
3777,3480991549,3852686295,1672555387,1672555505,118
3481,3779438325,3330340793,1672576884,1672577739,855
3532,3557046880,3618489670,1672662818,1672664012,1194
3439,3774243020,3479851674,1672563499,1672566236,2737
3690,3505266860,3304155815,1672686722,1672687058,336
3791,3793418209,3730071479,1672542984,1672546188,3204
3736,3306412634,3399472693,1672630419,1672633160,2741
3713,3276217799,3392836218,1672672325,1672675141,2816
3751,3927165965,3514308235,1672685549,1672687479,1930
3773,3367111751,3306412634,1672613586,1672617101,3515
3541,3615113018,3224330592,1672573703,1672575328,1625
3438,3792020993,3512392431,1672617411,1672619465,2054
3437,3783169442,3472312341,1672633226,1672635248,2022
3656,3920625129,3660887799,1672573616,1672577004,3388
3619,3777624586,3618697021,1672652045,1672653761,1716
3573,3238288884,3793740407,1672674031,1672677220,3189
3493,3384583385,3823084403,1672675317,1672677117,1800
3430,3270042456,3226178937,1672617216,1672620685,3469
3555,3517590837,3513018485,1672600643,1672603060,2417
3574,3203538212,3714067076,1672652449,1672654429,1980
3700,3732584121,3501525100,1672697011,1672699555,2544
3796,3516489668,3437286517,1672623618,1672625306,1688
3791,3370068529,3403370192,1672618182,1672618737,555
3819,3516444201,3779786641,1672643622,1672646376,2754
3436,3669146016,3300818269,1672548633,1672550180,1547
3922,3914691363,3463849738,1672639600,1672642100,2500
3609,3818575661,3505663516,1672689222,1672691195,1973
3677,3669146016,3780322355,1672686962,1672687270,308
3639,3780322355,3736705719,1672680319,1672680902,583
3764,3554825448,3715974659,1672554090,1672556106,2016
3713,3379143440,3414940786,1672672369,1672674171,1802
3707,3510767239,3488763230,1672564753,1672567709,2956
3777,3609933747,3609933747,1672649995,1672651995,2000
3846,3970603231,3701005527,1672666273,1672668644,2371
3802,3363162590,3248058676,1672624524,1672625233,709
3818,3667427125,3895285664,1672625579,1672627460,1881
3554,3685681577,3776117322,1672601204,1672601277,73
3467,3800257590,3776084820,1672658086,1672660362,2276
3530,3232208416,3516444201,1672631196,1672632055,859
3683,3451726367,3488686442,1672559660,1672562611,2951
3523,3357289672,3472068734,1672601139,1672602034,895
3811,3454277788,3500827202,1672593867,1672594647,780
3659,3920497528,3680810086,1672606822,1672608855,2033
3849,3783641602,3609933747,1672564674,1672565693,1019
3698,3240394404,3783615982,1672585976,1672587773,1797
3860,3812369928,3514741348,1672663345,1672664768,1423
3584,3661583097,3770704999,1672649718,1672649788,70
3897,3462158237,3505663516,1672552648,1672554584,1936
3531,3225636215,3915162005,1672619366,1672619743,377
3736,3773033649,3509893027,1672695746,1672697505,1759
3920,3510554314,3935487534,1672573549,1672573824,275
3630,3793175445,3519446663,1672617593,1672619737,2144
3655,3294703680,3448875382,1672621333,1672623909,2576
3784,3757700712,3739911441,1672543741,1672547312,3571
3586,3777330107,3760263530,1672564503,1672566155,1652
3523,3777694660,3609659642,1672634274,1672637570,3296
3487,3780427126,3688490530,1672531483,1672532656,1173
3772,3757193551,3814677862,1672552572,1672556065,3493
3537,3731646673,3925979970,1672616209,1672617768,1559
3722,3402385957,3817813340,1672666839,1672668540,1701
3876,3299781901,3760364383,1672585585,1672587270,1685
3438,3367509761,3885155975,1672681469,1672684496,3027
3824,3227799827,3481640525,1672551814,1672555380,3566
3693,3979784676,3408430195,1672683348,1672685406,2058
3658,3333918941,3904569677,1672583144,1672584408,1264
3585,3305722859,3773124276,1672560291,1672560698,407
3503,3513041785,3246370118,1672655750,1672659348,3598
3902,3516298579,3923220461,1672535154,1672537406,2252
3688,3626499450,3306412634,1672618327,1672621065,2738
3551,3701322924,3927599181,1672565469,1672566876,1407
3439,3501121099,3773837847,1672595388,1672598177,2789
3875,3783928182,3514246749,1672608359,1672610169,1810
3785,3776518452,3300511067,1672682153,1672683481,1328
3466,3900898992,3455018347,1672635862,1672639112,3250
3791,3385323994,3774605761,1672635676,1672636671,995
3607,3226024417,3791613604,1672689411,1672689496,85
3558,3385323994,3510028805,1672541785,1672545195,3410
3599,3285204083,3338083680,1672609248,1672610141,893
3912,3627368399,3401496246,1672611850,1672614973,3123
3574,3512392431,3779532653,1672605393,1672606532,1139
3911,3488763230,3792020993,1672584538,1672586242,1704
3824,3613899351,3360069849,1672598810,1672599720,910
3907,3505807416,3245232284,1672579881,1672580446,565
3562,3739154408,3299781901,1672560061,1672562283,2222
3620,3226178937,3615115210,1672690227,1672691990,1763
3625,3492959689,3757318448,1672541258,1672543964,2706
3764,3499217428,3783520186,1672638528,1672640165,1637
3544,3703396825,3456430614,1672659184,1672659563,379
3766,3779532653,3914691363,1672588693,1672590824,2131
3900,3714827719,3240994288,1672559287,1672561228,1941
3666,3441348818,3311085279,1672624769,1672626715,1946
3517,3511150845,3516298579,1672605973,1672606186,213
3872,3791441520,3457620713,1672687708,1672689090,1382
3475,3412006598,3279242917,1672623204,1672625697,2493
3549,3241790910,3270697740,1672567267,1672568035,768
3515,3230868435,3631479562,1672600678,1672601713,1035
3492,3514703118,3755158925,1672630094,1672630441,347
3748,3780834916,3737112297,1672691197,1672692907,1710
3505,3236499444,3383138270,1672589313,1672591736,2423
3447,3551376095,3618808151,1672624798,1672627564,2766
3467,3935399379,3770236215,1672623629,1672623864,235
3647,3779892400,3435167810,1672599088,1672600721,1633
3810,3703348097,3412968120,1672662543,1672665075,2532
3897,3972192593,3367111751,1672639679,1672641259,1580
3898,3715443333,3428027649,1672591809,1672593466,1657
3889,3773735484,3811075491,1672674936,1672676641,1705
3823,3612689556,3518194482,1672548743,1672550206,1463
3623,3505807416,3512282789,1672556699,1672559685,2986
3876,3311098437,3774733620,1672575256,1672577470,2214
3791,3231713082,3731646673,1672583294,1672585613,2319
3827,3755848152,3921648519,1672580600,1672581433,833
3886,3791753345,3791796585,1672556865,1672559039,2174
3691,3349739136,3613581796,1672564123,1672565037,914
3680,3360616538,3660063072,1672649701,1672652211,2510
3868,3557046880,3885157459,1672676855,1672677946,1091
3809,3773939399,3935399379,1672638255,1672641605,3350
3884,3435116799,3713768950,1672620748,1672622435,1687
3788,3451326054,3514324011,1672567530,1672567767,237
3871,3451326054,3701136026,1672544530,1672547015,2485
3770,3409114719,3835985172,1672677619,1672680948,3329
3762,3713589994,3209526819,1672547903,1672548925,1022
3531,3505847380,3780115155,1672614271,1672615918,1647
3558,3497808662,3891672228,1672620276,1672623030,2754
3497,3774641380,3461119815,1672553438,1672555539,2101
3657,3885157459,3490214516,1672550832,1672552101,1269
3690,3418448389,3791106564,1672702494,1672705792,3298
3800,3534357694,3780209375,1672640795,1672642243,1448
3704,3516903528,3559731671,1672581915,1672585063,3148
3615,3343816795,3914691363,1672667129,1672669019,1890
3807,3380130228,3310039260,1672693035,1672694506,1471
3572,3394401087,3756746867,1672604113,1672606244,2131
3578,3793418209,3491684096,1672638186,1672640525,2339
3553,3401793306,3510028805,1672672855,1672674005,1150
3609,3739895284,3972192593,1672578318,1672581046,2728
3789,3485540729,3756789525,1672592917,1672593341,424
3797,3533368789,3683113954,1672585785,1672588713,2928
3496,3402697190,3428027649,1672674670,1672677124,2454
3729,3246370118,3638660068,1672586956,1672588623,1667
3513,3713561276,3519142371,1672691274,1672692161,887
3753,3823084403,3833217041,1672549257,1672550463,1206
3858,3231713082,3774290799,1672699307,1672702581,3274
3814,3410538749,3938503547,1672635202,1672636706,1504
3614,3736705719,3225636215,1672671811,1672673315,1504
3884,3414940786,3633735593,1672626672,1672627785,1113
3656,3488686442,3736231757,1672570223,1672573594,3371
3665,3756474459,3902861231,1672601922,1672603344,1422
3903,3513065217,3515439826,1672591125,1672593940,2815
3598,3780571086,3660063072,1672643536,1672645855,2319
3460,3375449013,3520560590,1672625578,1672626354,776
3724,3772765746,3410600350,1672637556,1672638315,759
3790,3613338363,3613206049,1672699314,1672700210,896
3765,3777624586,3239617320,1672618186,1672620276,2090
3782,3774031303,3475349791,1672678414,1672681974,3560
3643,3714666884,3203538212,1672579151,1672582708,3557
3587,3509366311,3272096759,1672598167,1672598740,573
3772,3533228966,3713691388,1672535594,1672538631,3037
3565,3478114114,3279473441,1672570594,1672573335,2741
3559,3500347447,3311049964,1672550073,1672553390,3317
3855,3512499658,3887243870,1672666544,1672668634,2090
3739,3808136029,3510187271,1672559882,1672561445,1563
3918,3519087371,3283492940,1672634074,1672636462,2388
3861,3518194482,3451326054,1672679845,1672682622,2777
3683,3224968597,3516298579,1672641393,1672644595,3202
3586,3792020993,3612689556,1672595341,1672596750,1409
3569,3487875183,3884596900,1672574316,1672576631,2315
3681,3780680950,3791046864,1672618823,1672620831,2008
3584,3514741348,3514308235,1672669514,1672673049,3535
3630,3276217799,3622357348,1672696444,1672696941,497
3590,3622357348,3793781065,1672681576,1672681830,254
3825,3316798920,3735374579,1672612948,1672614653,1705
3874,3512946768,3909094917,1672595381,1672595523,142
3633,3713163045,3559731671,1672617298,1672620531,3233
3790,3938389661,3220031931,1672702980,1672706361,3381
3771,3792525861,3755404116,1672615120,1672616893,1773
3584,3299443125,3902625986,1672561079,1672564527,3448
3737,3975717896,3774718695,1672608297,1672611034,2737
3651,3451326054,3971806004,1672687381,1672689236,1855
3667,3776034743,3714827719,1672660290,1672660652,362
3682,3556969573,3853629553,1672680676,1672680890,214
3804,3710735406,3715545685,1672568604,1672570695,2091
3730,3515401243,3341893384,1672671691,1672674376,2685
3544,3856606678,3510798825,1672593216,1672596335,3119
3685,3451691949,3774876004,1672658454,1672661672,3218
3687,3777330107,3970198861,1672532819,1672535123,2304
3605,3780338697,3390660440,1672661290,1672662846,1556
3863,3621461051,3900276517,1672615898,1672617990,2092
3426,3241914067,3520657891,1672661479,1672661638,159
3887,3802932312,3915162005,1672678944,1672680955,2011
3474,3283144118,3488763230,1672659220,1672659776,556
3890,3202141727,3382733096,1672559162,1672562274,3112
3772,3701424609,3792745809,1672597777,1672598356,579
3521,3415833929,3283492940,1672624130,1672625874,1744
3441,3792505974,3793922324,1672703983,1672705251,1268
3843,3559458968,3551389192,1672558029,1672558866,837
3867,3613416045,3479851674,1672661289,1672663328,2039
3855,3668533536,3792949946,1672566853,1672568256,1403
3550,3713517039,3897134762,1672612429,1672613727,1298
3712,3510028805,3776244398,1672656047,1672659458,3411
3919,3517697722,3756789525,1672543786,1672545340,1554
3865,3932478321,3556969573,1672589855,1672591417,1562
3487,3394297564,3755737419,1672693496,1672696266,2770
3774,3533649454,3904412440,1672570541,1672572445,1904
3592,3772765746,3779465522,1672628874,1672631575,2701
3641,3519909393,3897376951,1672535888,1672536973,1085
3597,3636329663,3276003502,1672670823,1672672905,2082
3666,3714678331,3780472203,1672609189,1672609843,654
3535,3514512367,3510028805,1672568738,1672572166,3428
3730,3716272919,3519651506,1672666045,1672667664,1619
3628,3703798634,3399518841,1672589810,1672590955,1145
3538,3895285664,3514703118,1672642831,1672643252,421
3533,3737112297,3793740407,1672663031,1672663819,788
3668,3631090677,3227799827,1672633792,1672634114,322
3611,3756746867,3680843171,1672569863,1672570733,870
3921,3505807416,3519416013,1672608378,1672610645,2267
3847,3938389661,3824641227,1672638867,1672640288,1421
3635,3926643445,3288762795,1672620980,1672622392,1412
3651,3791046864,3904569677,1672696004,1672696964,960
3437,3360616538,3533423872,1672611111,1672612281,1170
3893,3383138270,3783919913,1672567544,1672569561,2017
3754,3511024016,3898314440,1672547479,1672550714,3235
3441,3734915241,3513327337,1672632224,1672633520,1296
3600,3511442562,3480490124,1672620811,1672621379,568
3639,3756127300,3373028638,1672544562,1672546575,2013
3636,3394401087,3774243020,1672534639,1672534805,166
3464,3811075491,3384068080,1672571742,1672572718,976
3487,3783801141,3760640999,1672570474,1672573792,3318
3500,3793922324,3757383891,1672600782,1672601652,870
3623,3615087943,3715619259,1672590513,1672590914,401
3461,3760721303,3511883730,1672701614,1672702998,1384
3888,3660063072,3500703304,1672602602,1672603780,1178
3770,3394297564,3414049538,1672661227,1672663645,2418
3622,3517358573,3410160376,1672652218,1672653750,1532
3552,3370068529,3293835352,1672596444,1672598469,2025
3776,3902760230,3688796737,1672622612,1672623917,1305
3827,3714233826,3306175858,1672661599,1672662742,1143
3627,3398731252,3660063072,1672593310,1672594368,1058
3507,3793407963,3928511283,1672541649,1672542106,457
3895,3716110860,3756789525,1672629729,1672631108,1379
3653,3238288884,3604867757,1672532736,1672534167,1431
3764,3467779445,3609881958,1672574117,1672577308,3191
3502,3385323994,3373089838,1672599776,1672600493,717
3594,3856606678,3773735484,1672672715,1672674474,1759
3796,3779646172,3783340788,1672690083,1672690396,313
3770,3500525825,3330340793,1672556436,1672558982,2546
3908,3756474459,3904569677,1672533780,1672534284,504
3817,3615087943,3783928182,1672587498,1672589258,1760
3719,3315279093,3714678331,1672651936,1672655424,3488
3795,3777624586,3755344363,1672628144,1672628953,809
3724,3510028805,3899786664,1672627487,1672628734,1247
3647,3760842815,3791693821,1672681425,1672684168,2743
3598,3793583656,3200543880,1672601113,1672601217,104
3863,3520416075,3617304541,1672636937,1672639332,2395
3493,3225631197,3462273042,1672600988,1672601799,811
3479,3812369928,3703798634,1672675086,1672677762,2676
3802,3201800997,3621790707,1672643186,1672646015,2829
3675,3772765746,3513853403,1672561663,1672561907,244
3869,3311098437,3808136029,1672625079,1672626015,936
3556,3923754072,3714666884,1672673765,1672676826,3061
3887,3533004959,3505807416,1672553446,1672553571,125
3635,3774641380,3792014516,1672647662,1672648819,1157
3449,3777330107,3792442597,1672600466,1672603711,3245
3757,3209481722,3734118023,1672680193,1672683096,2903
3654,3701882224,3684523966,1672687645,1672689898,2253
3909,3779465522,3514334067,1672666274,1672668451,2177
3431,3357289672,3622665543,1672686022,1672687039,1017
3659,3777624586,3417679834,1672533738,1672534309,571
3544,3205923620,3605221116,1672677147,1672678675,1528
3516,3500613459,3604867757,1672692326,1672695162,2836
3601,3669146016,3829822608,1672649917,1672650866,949
3521,3533929349,3755848152,1672591774,1672594139,2365
3835,3755233658,3925979970,1672609685,1672613237,3552
3831,3701322924,3661447322,1672623735,1672626868,3133
3793,3312998540,3516321888,1672687970,1672691452,3482
3534,3512295534,3389634034,1672588444,1672590817,2373
3575,3505481368,3774155692,1672587885,1672588096,211
3743,3315279093,3360616538,1672649482,1672652341,2859
3715,3773939399,3713163045,1672663462,1672666543,3081
3736,3300229945,3835985172,1672585835,1672587041,1206
3922,3778899160,3334951866,1672680450,1672682538,2088
3611,3770146716,3774641380,1672583290,1672583471,181
3753,3450969839,3615939504,1672664392,1672666012,1620
3622,3229974066,3615688740,1672600763,1672601986,1223
3506,3488686442,3533090502,1672693753,1672696963,3210
3635,3730071479,3625463628,1672606289,1672608967,2678
3730,3435116799,3715385401,1672670918,1672673432,2514
3819,3495911207,3315703693,1672582946,1672585703,2757
3455,3909094917,3513296868,1672598136,1672600614,2478
3784,3519416013,3815250107,1672566729,1672567932,1203
3807,3755158925,3371455553,1672635364,1672637278,1914
3541,3792442597,3773837847,1672563562,1672566629,3067
3854,3899326793,3308760650,1672564379,1672567442,3063
3878,3500347447,3303410628,1672601843,1672603196,1353
3828,3306175858,3612689556,1672567788,1672569098,1310
3572,3773735484,3615939504,1672583056,1672585414,2358
3565,3512800570,3518653080,1672532821,1672534422,1601
3657,3791436104,3778899160,1672536918,1672537566,648
3468,3512830734,3431460073,1672576569,1672577233,664
3488,3417679834,3357689359,1672549296,1672551473,2177
3765,3436025562,3270042456,1672644723,1672647639,2916
3647,3398731252,3311098437,1672672313,1672675329,3016
3742,3760094385,3501525100,1672670144,1672671665,1521
3804,3513360004,3512383699,1672618173,1672619495,1322
3567,3448633776,3335694356,1672640546,1672641652,1106
3620,3715443333,3500709774,1672640430,1672642409,1979
3507,3401496246,3710496785,1672607592,1672608486,894
3656,3608232640,3349739136,1672574200,1672575875,1675
3556,3510642075,3783615982,1672605121,1672607775,2654
3516,3451726367,3773837847,1672603260,1672603943,683
3454,3711077927,3201676087,1672585685,1672588604,2919
3472,3232208416,3839245934,1672532595,1672533868,1273
3899,3887243870,3462273042,1672636909,1672637637,728
3715,3357864626,3400763927,1672631183,1672631859,676
3509,3512830734,3779532653,1672653291,1672655619,2328
3537,3776559988,3618489670,1672561074,1672561358,284
3597,3552824113,3835422146,1672671004,1672673008,2004
3756,3793883863,3271454397,1672634141,1672637111,2970
3604,3270042456,3760651515,1672617651,1672619195,1544
3638,3448875382,3897435944,1672603099,1672603277,178
3466,3514285803,3518565331,1672543881,1672544785,904
3432,3500613459,3516513251,1672633292,1672636749,3457
3569,3512392431,3520416075,1672628743,1672630962,2219
3711,3792389522,3714120857,1672675840,1672676819,979
3613,3635169815,3519142371,1672572848,1672575248,2400
3873,3511442562,3288762795,1672609100,1672611211,2111
3671,3713829743,3519909393,1672588943,1672591427,2484
3495,3928511283,3389634034,1672604136,1672606200,2064
3837,3783928182,3779613523,1672673150,1672673494,344
3891,3760362417,3783928182,1672571598,1672572821,1223
3596,3347419520,3310125159,1672692872,1672695736,2864
3726,3509483172,3272096759,1672611471,1672612261,790
3542,3519282716,3515890966,1672560422,1672561275,853
3867,3511288998,3733558985,1672647334,1672648724,1390
3652,3778899160,3710496785,1672638787,1672639388,601
3446,3534175249,3480991549,1672659240,1672662138,2898
3669,3904412440,3623266256,1672627245,1672627455,210
3902,3619922891,3510554314,1672684675,1672686964,2289
3586,3713941638,3292147449,1672545899,1672547521,1622
3622,3417191856,3760263530,1672585733,1672588633,2900
3525,3780712350,3459681410,1672580077,1672582352,2275
3793,3701005527,3904569677,1672675015,1672676371,1356
3650,3514308235,3780680950,1672661933,1672663954,2021
3592,3500109249,3396980894,1672671126,1672672347,1221
3530,3341893384,3885155975,1672679909,1672681312,1403
3837,3889780657,3533274994,1672595625,1672597367,1742
3720,3303410628,3889780657,1672663407,1672664305,898
3566,3370068529,3500949309,1672594526,1672595579,1053
3880,3229974066,3520115090,1672629932,1672632188,2256
3730,3533090502,3716628503,1672680284,1672683528,3244
3536,3533929349,3617116290,1672558080,1672559324,1244
3760,3772078494,3514956366,1672571376,1672573806,2430
3641,3463740710,3488686442,1672669949,1672671552,1603
3516,3468041839,3714670620,1672670527,1672673761,3234
3796,3472068734,3319167958,1672562641,1672563989,1348
3560,3780571086,3440107959,1672603405,1672604614,1209
3491,3737147209,3711006062,1672579081,1672581184,2103
3766,3780909839,3621461051,1672533706,1672536336,2630
3503,3520873221,3449639012,1672558060,1672560562,2502
3476,3520991398,3776518452,1672688219,1672690392,2173
3879,3710048469,3505402439,1672646516,1672650041,3525
3849,3774907131,3688220326,1672618525,1672618702,177
3802,3824215187,3456430614,1672644275,1672647640,3365
3533,3608232640,3400763927,1672573274,1672574107,833
3447,3513327337,3276003502,1672642095,1672644738,2643
3716,3714128600,3227799827,1672606442,1672608543,2101
3454,3739154408,3839245934,1672596699,1672599926,3227
3767,3814305099,3619922891,1672548528,1672551087,2559
3472,3778667336,3610870949,1672668133,1672671134,3001
3815,3855583256,3428027649,1672575233,1672575862,629
3883,3497808662,3815250107,1672662083,1672662889,806
3658,3512337405,3351866415,1672657157,1672658752,1595
3530,3703348097,3829822608,1672599256,1672601179,1923
3651,3792442597,3272716462,1672583502,1672585827,2325
3884,3792745809,3808136029,1672681476,1672681773,297
3635,3284932450,3392943173,1672634158,1672634650,492
3847,3604589802,3625174002,1672628851,1672630734,1883
3684,3516903528,3516703758,1672550112,1672550664,552
3427,3534126409,3715400486,1672557349,1672560160,2811
3758,3505434346,3791796585,1672553180,1672554213,1033
3719,3792274796,3934064792,1672664158,1672665478,1320
3439,3341893384,3501121099,1672604194,1672606245,2051
3451,3305722859,3311049964,1672578885,1672580833,1948
3480,3792745809,3288762795,1672635373,1672637390,2017
3530,3514971533,3607768197,1672675234,1672675738,504
3459,3480100311,3887243870,1672662717,1672666123,3406
3846,3783373154,3808136029,1672624866,1672625357,491
3813,3773939399,3711097754,1672693912,1672694724,812
3634,3441703884,3617304541,1672592638,1672594129,1491
3703,3701136026,3772765746,1672664255,1672666826,2571
3632,3713163045,3488686442,1672694850,1672697341,2491
3816,3516903528,3366423342,1672702089,1672702252,163
3518,3757193307,3792745809,1672570551,1672570835,284
3753,3902625986,3760645796,1672625104,1672627063,1959
3447,3200308999,3457620713,1672617765,1672620152,2387
3474,3714666884,3516321888,1672593822,1672597333,3511
3678,3897456874,3205985903,1672585322,1672587888,2566
3625,3791753345,3972192593,1672549729,1672549852,123
3807,3885121158,3533004959,1672622915,1672625154,2239
3765,3757075324,3793781065,1672620475,1672621570,1095
3815,3298151889,3350095157,1672629310,1672630285,975
3642,3777485931,3505521218,1672688532,1672689398,866
3573,3533274994,3773837847,1672697938,1672698604,666
3569,3912891315,3228888030,1672597829,1672599170,1341
3447,3777091903,3512946768,1672694708,1672695914,1206
3836,3439673892,3280268483,1672587944,1672588962,1018
3546,3688490530,3276003502,1672564828,1672565727,899
3845,3513360004,3793175445,1672612901,1672613527,626
3683,3613338363,3510919821,1672544349,1672547466,3117
3429,3240994288,3859868849,1672631993,1672634751,2758
3658,3421385957,3777694660,1672694965,1672698422,3457
3808,3791613604,3336627643,1672556698,1672558114,1416
3813,3519416013,3921648519,1672606676,1672608894,2218
3608,3739154408,3350095157,1672534418,1672535892,1474
3797,3462158237,3505266860,1672681130,1672683736,2606
3736,3778597171,3478114114,1672572515,1672575396,2881
3510,3755496114,3518565331,1672681177,1672682154,977
3673,3467779445,3755344363,1672556551,1672560014,3463
3613,3438489358,3501215099,1672655907,1672658849,2942
3891,3756385685,3443357683,1672650841,1672651625,784
3750,3880926355,3512830734,1672621745,1672625183,3438
3834,3711097754,3500777439,1672694863,1672695357,494
3637,3511288998,3783520186,1672645102,1672646069,967
3515,3518653080,3505266860,1672695218,1672697438,2220
3708,3760040019,3459681410,1672701185,1672702064,879
3810,3760842815,3462636434,1672547897,1672550876,2979
3512,3779854934,3226511603,1672602183,1672602701,518
3784,3534829213,3500915665,1672632884,1672635106,2222
3852,3379143440,3711097754,1672617653,1672618138,485
3607,3505228454,3520416075,1672667548,1672670755,3207
3605,3757332128,3337362061,1672646195,1672646737,542
3575,3715974659,3516321888,1672688101,1672691235,3134
3575,3289114629,3780427126,1672594265,1672594971,706
3588,3713979100,3760364383,1672653751,1672656131,2380
3505,3231494505,3760651515,1672619637,1672621104,1467
3744,3505634634,3357289672,1672567584,1672569632,2048
3483,3665998641,3515401243,1672639685,1672641576,1891
3882,3534764451,3497671225,1672643066,1672643638,572
3742,3428027649,3513065217,1672532371,1672532694,323
3631,3686523546,3792538417,1672576587,1672577712,1125
3792,3631090677,3780909839,1672703882,1672706860,2978
3472,3821054646,3512499658,1672699935,1672702664,2729
3692,3773033649,3770438122,1672594301,1672595983,1682
3543,3308760650,3880926355,1672628201,1672628668,467
3667,3512958459,3400763927,1672594646,1672596990,2344
3584,3514741348,3802932312,1672666164,1672668972,2808
3655,3517887477,3392520516,1672607711,1672607926,215
3769,3755158925,3401496246,1672553960,1672557186,3226
3448,3463740710,3711734586,1672639561,1672641423,1862
3823,3401940259,3505888598,1672674445,1672675112,667
3847,3791613604,3779613523,1672631399,1672631854,455
3650,3333403880,3311098437,1672599757,1672602054,2297
3683,3421385957,3713517039,1672619985,1672620961,976
3711,3380130228,3412006598,1672549767,1672550969,1202
3838,3760645796,3448633776,1672549324,1672552199,2875
3731,3757193307,3979802715,1672687364,1672688163,799
3851,3776244398,3479851674,1672651621,1672654913,3292
3853,3689697817,3732584121,1672534323,1672537630,3307
3862,3270697740,3362641275,1672626714,1672628148,1434
3440,3686227677,3716628503,1672648040,1672651084,3044
3890,3688490530,3715443333,1672610294,1672612372,2078
3834,3686523546,3760094385,1672630072,1672633458,3386
3428,3514275974,3519282716,1672680114,1672682442,2328
3583,3437286517,3814305099,1672625655,1672628394,2739
3593,3360813161,3923420131,1672694928,1672697612,2684
3437,3512295534,3448633776,1672630001,1672632866,2865
3673,3398198430,3755737419,1672690567,1672690859,292
3757,3552824113,3517697722,1672677510,1672679331,1821
3720,3773124276,3454277788,1672615916,1672617285,1369
3706,3778597171,3714120857,1672691722,1672694600,2878
3449,3885121158,3450969839,1672650092,1672652488,2396
3741,3512295534,3362641275,1672583058,1672584891,1833
3612,3808136029,3288762795,1672566146,1672567500,1354
3755,3774178201,3757383891,1672594427,1672594742,315
3441,3505807416,3505434346,1672550708,1672551277,569
3543,3970909253,3271752081,1672542669,1672545312,2643
3606,3635169815,3701823816,1672702563,1672703713,1150
3673,3622665543,3394401087,1672580375,1672580847,472
3606,3511442562,3360813161,1672575544,1672576511,967
3626,3928511283,3501459390,1672532821,1672534102,1281
3550,3756385685,3519416013,1672686904,1672689205,2301
3806,3734118023,3979802715,1672611293,1672614248,2955
3882,3920497528,3631479562,1672570605,1672573106,2501
3520,3755404116,3513360004,1672561135,1672562987,1852
3831,3404025196,3514419100,1672549101,1672552684,3583
3617,3512499658,3710735406,1672652276,1672654250,1974
3556,3311049964,3285204083,1672654384,1672655149,765
3724,3399518841,3897134762,1672560333,1672561187,854
3873,3438078818,3977148669,1672644758,1672645093,335
3902,3517462308,3710854064,1672664088,1672667169,3081
3579,3773572967,3667427125,1672590625,1672592637,2012
3478,3834960360,3793781065,1672672986,1672675676,2690
3679,3811075491,3513296868,1672541672,1672544149,2477
3439,3488686442,3205985903,1672582897,1672585767,2870
3592,3684523966,3618808151,1672643494,1672645008,1514
3797,3299443125,3431502855,1672687598,1672689650,2052
3725,3710562338,3312998540,1672611898,1672614193,2295
3724,3511024016,3399518841,1672621542,1672622159,617
3528,3770438122,3516703758,1672535523,1672538870,3347
3558,3505154885,3774907131,1672676535,1672678987,2452
3864,3778040015,3200308999,1672673168,1672674313,1145
3488,3336339664,3206837348,1672586586,1672589516,2930
3458,3792020993,3357864626,1672561739,1672565213,3474
3781,3793922324,3757332128,1672703237,1672703865,628
3917,3779646172,3505807416,1672653879,1672656108,2229
3702,3814677862,3682133690,1672589439,1672590144,705
3601,3902861231,3441703884,1672548316,1672549994,1678
3447,3904569677,3452016771,1672644160,1672646106,1946
3451,3714233826,3812534508,1672604560,1672608078,3518
3713,3319167958,3519028898,1672624895,1672627447,2552
3506,3757075324,3472068734,1672609817,1672610342,525
3532,3398731252,3817813340,1672576671,1672579604,2933
3792,3387594369,3923420131,1672677046,1672678507,1461
3501,3238288884,3380130228,1672625505,1672628703,3198
3825,3245232284,3713829743,1672593376,1672594175,799
3460,3757075324,3505283390,1672661981,1672663848,1867
3920,3970909253,3770468980,1672534654,1672535489,835
3535,3779532653,3296462324,1672664876,1672664999,123
3860,3515525630,3777624586,1672574941,1672578253,3312
3653,3534357694,3239617320,1672601508,1672602551,1043
3554,3664943873,3972192593,1672568741,1672571429,2688
3577,3368283077,3615113018,1672584740,1672585637,897
3764,3517222913,3440107959,1672618019,1672619893,1874
3771,3684523966,3276003502,1672640184,1672641902,1718
3820,3428027649,3610358027,1672646761,1672649461,2700
3684,3394297564,3934064792,1672541438,1672544846,3408
3703,3604589802,3501215099,1672627163,1672629581,2418
3755,3511442562,3517590837,1672553605,1672556441,2836
3525,3516741440,3773027597,1672636083,1672638686,2603
3582,3773735484,3885157459,1672588258,1672589005,747
3914,3710735406,3757294769,1672631594,1672633386,1792
3516,3776117322,3509893027,1672547755,1672550525,2770
3546,3501567772,3519087371,1672632526,1672635823,3297
3602,3271454397,3500498112,1672605961,1672608440,2479
3902,3513853403,3308760650,1672693857,1672696040,2183
3884,3736231757,3739661856,1672620603,1672621994,1391
3694,3773121782,3516444201,1672673085,1672676359,3274
3718,3501384020,3384068080,1672613643,1672615324,1681
3920,3279242917,3512383699,1672582935,1672584624,1689
3660,3271454397,3515401243,1672612982,1672616433,3451
3673,3500072204,3755222916,1672645636,1672645848,212
3548,3772391882,3774718695,1672591678,1672594115,2437
3532,3668533536,3756789525,1672603782,1672607183,3401
3794,3517881647,3834631333,1672565835,1672566345,510
3844,3236499444,3931627862,1672607222,1672607719,497
3823,3298151889,3734451191,1672693250,1672695104,1854
3832,3296462324,3382733096,1672658464,1672659139,675
3711,3669146016,3776988674,1672580353,1672581195,842
3691,3621790707,3209481722,1672598563,1672599567,1004
3803,3635169815,3284947372,1672597568,1672598972,1404
3574,3701884158,3417191856,1672553105,1672554671,1566
3670,3831586487,3500604680,1672618183,1672620935,2752
3454,3554186380,3800257590,1672619510,1672621126,1616
3429,3680810086,3461119815,1672688043,1672691255,3212
3567,3294747828,3511601997,1672536788,1672538281,1493
3893,3927165965,3441703884,1672666067,1672669545,3478
3602,3935913584,3780115155,1672569135,1672571969,2834
3715,3533274994,3202804048,1672688993,1672690005,1012
3480,3514334067,3488763230,1672672408,1672673833,1425
3427,3793781065,3517358573,1672653009,1672653409,400
3457,3534566651,3829822608,1672653843,1672655912,2069
3696,3417679834,3373089838,1672557626,1672558771,1145
3612,3897456874,3500442734,1672673318,1672674068,750
3687,3780834916,3970603231,1672551599,1672553750,2151
3820,3974674109,3311498666,1672581220,1672584234,3014
3721,3509756823,3774243020,1672614564,1672615246,682
3831,3231494505,3288224595,1672608128,1672610664,2536
3432,3289114629,3773124276,1672650396,1672650747,351
3487,3975717896,3701136026,1672701439,1672701820,381
3727,3802932312,3611055563,1672688615,1672691040,2425
3441,3519028898,3779656423,1672546482,1672549985,3503
3858,3505434346,3306412634,1672576300,1672577504,1204
3908,3930242012,3778926763,1672598161,1672600172,2011
3507,3615737355,3779301501,1672592024,1672592137,113
3471,3757332128,3451691949,1672588002,1672588264,262
3638,3900898992,3780909839,1672646007,1672648497,2490
3785,3516513251,3793418209,1672695333,1672696102,769
3640,3401496246,3488686442,1672675286,1672677965,2679
3509,3623266256,3205985903,1672606110,1672607353,1243
3868,3246370118,3376467719,1672635612,1672636580,968
3819,3884596900,3511442562,1672649548,1672650919,1371
3539,3609881958,3373089838,1672565328,1672566103,775
3785,3617489344,3737147209,1672561865,1672562340,475
3627,3514818819,3778597171,1672698254,1672700645,2391
3528,3337322736,3373028638,1672554233,1672555014,781
3916,3715443333,3511150845,1672701324,1672704510,3186
3780,3497095254,3755496114,1672580717,1672581591,874
3913,3505923418,3414275042,1672595710,1672597803,2093
3745,3777330107,3701823816,1672561514,1672563593,2079
3776,3455018347,3607768197,1672645936,1672647282,1346
3481,3757323954,3510798825,1672536758,1672537467,709
3861,3392520516,3625463628,1672539473,1672540309,836
3665,3780769110,3495911207,1672684927,1672686107,1180
3920,3755158925,3509893027,1672561994,1672565072,3078
3641,3607882826,3779646172,1672558793,1672560071,1278
3596,3734118023,3372223551,1672614870,1672615694,824
3736,3330340793,3783169442,1672653544,1672655330,1786
3601,3289817992,3505521218,1672630338,1672633559,3221
3521,3511601997,3757193307,1672675004,1672675543,539
3544,3760721303,3760842815,1672577909,1672580581,2672
3743,3905196766,3783169442,1672630448,1672631951,1503
3497,3831586487,3447672935,1672674560,1672675077,517
3515,3357689359,3780769110,1672676563,1672678403,1840
3656,3231713082,3713829743,1672645585,1672648611,3026
3878,3370227921,3500949309,1672673864,1672674694,830
3612,3826238375,3802932312,1672616965,1672620547,3582
3693,3512502036,3711734586,1672653322,1672654227,905
3712,3518653080,3402697190,1672621726,1672623690,1964
3901,3755756564,3713300120,1672576546,1672577707,1161
3757,3632814465,3445206685,1672585744,1672587895,2151
3652,3449639012,3280054198,1672638078,1672641467,3389
3662,3791046864,3611055563,1672683004,1672686235,3231
3737,3716679950,3714678331,1672598520,1672600347,1827
3874,3488763230,3512383699,1672627368,1672628088,720
3895,3783163143,3783641602,1672640861,1672641924,1063
3572,3737147209,3513065217,1672600695,1672601663,968
3683,3488686442,3228888030,1672682252,1672684008,1756
3629,3774155692,3551389192,1672540929,1672541939,1010
3465,3974674109,3505228454,1672618037,1672620472,2435
3773,3714185969,3715385401,1672606121,1672608253,2132
3916,3500044458,3403370192,1672560705,1672563461,2756
3803,3514956366,3791613604,1672584446,1672585126,680
3765,3517172354,3450969839,1672543867,1672546739,2872
3658,3276348699,3620292035,1672668025,1672669423,1398
3808,3972192593,3979802715,1672642370,1672642950,580
3780,3808136029,3519416013,1672548416,1672551561,3145
3656,3500827202,3512800570,1672667340,1672668381,1041
3475,3815250107,3517462308,1672665000,1672666013,1013
3557,3777485931,3713561276,1672574423,1672574606,183
3745,3624297844,3510642075,1672666460,1672668950,2490
3875,3495911207,3791246640,1672590677,1672592180,1503
3445,3755065949,3755532873,1672701696,1672702939,1243
3678,3713911104,3303410628,1672571703,1672575084,3381
3790,3333403880,3777147510,1672545983,1672547830,1847
3700,3793883863,3455018347,1672570339,1672573368,3029
3829,3475349791,3505725706,1672608505,1672609924,1419
3502,3280054198,3500613459,1672584917,1672585370,453
3624,3236458894,3513018485,1672606218,1672607169,951
3767,3756474459,3534175249,1672618045,1672620379,2334
3644,3279339278,3791128487,1672684636,1672686087,1451
3690,3856606678,3703348097,1672620007,1672620781,774
3619,3519446663,3505725706,1672658493,1672659330,837
3563,3615087943,3480490124,1672561734,1672564295,2561
3785,3369708250,3357689359,1672607339,1672609726,2387
3839,3880926355,3389634034,1672631800,1672632634,834
3435,3713589994,3514512367,1672541474,1672544380,2906
3771,3533929349,3467779445,1672641606,1672643930,2324
3750,3343132529,3208452238,1672695743,1672697427,1684
3820,3774031303,3774641380,1672553874,1672557084,3210
3685,3505437712,3738026330,1672547131,1672549297,2166
3856,3715854030,3774718695,1672615755,1672616836,1081
3716,3479851674,3513041785,1672615142,1672615696,554
3688,3774876004,3411515369,1672619601,1672622344,2743
3672,3505481368,3505111292,1672642518,1672646116,3598
3450,3780769110,3793315718,1672563649,1672566407,2758
3631,3615113018,3462273042,1672559155,1672560581,1426
3872,3714666884,3299125059,1672670042,1672672213,2171
3682,3780571086,3435167810,1672639062,1672640343,1281
3690,3803517637,3777091903,1672562245,1672565336,3091
3563,3774876004,3382733096,1672578433,1672580878,2445
3821,3713300120,3780680950,1672685490,1672685567,77
3572,3408498208,3480100311,1672661609,1672664221,2612
3780,3817428320,3630353876,1672665338,1672667530,2192
3433,3807212280,3205923620,1672555960,1672558523,2563
3818,3737972328,3757630221,1672690182,1672692820,2638
3727,3757863420,3777330107,1672684838,1672686131,1293
3646,3516321888,3608922867,1672596712,1672600162,3450
3568,3760645796,3447672935,1672620636,1672623593,2957
3744,3923220461,3274831810,1672583893,1672587014,3121
3850,3501384020,3760040019,1672688901,1672689929,1028
3576,3755065949,3701322924,1672679435,1672682132,2697
3493,3501457103,3505228454,1672579857,1672579954,97
3565,3713911104,3938389661,1672565216,1672566689,1473
3822,3783136330,3774705415,1672592097,1672594213,2116
3824,3737112297,3773332082,1672611597,1672614360,2763
3683,3834631333,3514419100,1672558350,1672561188,2838
3493,3615113018,3512282789,1672681976,1672682414,438
3607,3757903168,3615115210,1672689009,1672691971,2962
3665,3714128600,3755496114,1672583042,1672586079,3037
3563,3202804048,3500915908,1672567911,1672570435,2524
3892,3534357694,3512337405,1672661067,1672664266,3199
3517,3279339278,3240394404,1672575705,1672577960,2255
3777,3777037426,3271454397,1672632989,1672636180,3191
3917,3927165965,3308760650,1672667072,1672667826,754
3901,3519850727,3921648519,1672555663,1672556133,470
3503,3220031931,3777485931,1672610849,1672611662,813
3763,3386758279,3793743698,1672641461,1672642152,691
3591,3638204468,3445206685,1672684758,1672686910,2152
3543,3792538417,3533079336,1672666801,1672666904,103
3720,3713561276,3821054646,1672600258,1672603674,3416
3730,3713517039,3512383699,1672656599,1672656664,65
3786,3505198734,3270056120,1672647135,1672649158,2023
3677,3279475486,3551389192,1672698712,1672700604,1892
3633,3604867757,3779532653,1672680997,1672681064,67
3743,3607768197,3518565331,1672625162,1672625621,459
3844,3357289672,3932478321,1672661492,1672663162,1670
3604,3636329663,3441703884,1672571286,1672572655,1369
3891,3501786419,3417679834,1672643821,1672646194,2373
3866,3512282789,3703348097,1672620772,1672621806,1034
3482,3773735484,3703798634,1672541259,1672541851,592
3742,3271454397,3505198734,1672571980,1672572655,675
3584,3224811762,3703348097,1672692506,1672695571,3065
3802,3921648519,3900945856,1672562437,1672565068,2631
3465,3501384020,3783136330,1672666420,1672668436,2016
3826,3410538749,3774605761,1672665789,1672667728,1939
3533,3710854064,3229974066,1672701763,1672704139,2376
3780,3408430195,3333918941,1672548089,1672548694,605
3784,3511883730,3625463628,1672537734,1672539039,1305
3671,3517288083,3900945856,1672643525,1672645550,2025
3651,3435116799,3289817992,1672626863,1672628172,1309
3909,3792020993,3230868435,1672649201,1672651903,2702
3603,3534764451,3227799827,1672590803,1672591021,218
3505,3240994288,3519818818,1672535946,1672536127,181
3822,3457620713,3288224595,1672614257,1672616264,2007
3844,3534829213,3520578796,1672689871,1672692018,2147
3637,3613416045,3509366311,1672614961,1672617359,2398
3802,3713163045,3515890966,1672691644,1672694841,3197
3607,3490214516,3298151889,1672652642,1672655787,3145
3577,3897435944,3334951866,1672558364,1672561961,3597
3778,3517462308,3226511603,1672630442,1672631926,1484
3880,3455018347,3617392620,1672641194,1672644587,3393
3498,3512392431,3311049964,1672570521,1672573977,3456
3736,3511883730,3793175445,1672661349,1672662693,1344
3707,3826238375,3760364383,1672627956,1672629019,1063
3804,3701823816,3604867757,1672635666,1672636756,1090
3578,3389634034,3513327337,1672628862,1672629372,510
3814,3520322124,3686227677,1672639094,1672642450,3356
3622,3615113018,3512392431,1672610814,1672611385,571
3725,3739911441,3276348699,1672679202,1672682744,3542
3517,3500777439,3772765746,1672652771,1672654199,1428
3748,3889780657,3757383891,1672644248,1672647518,3270
3655,3900276517,3977148669,1672652994,1672656557,3563
3749,3373028638,3512502036,1672544206,1672546531,2325
3737,3755496114,3294703680,1672677822,1672680178,2356
3735,3490029863,3357689359,1672559545,1672560920,1375
3467,3710048469,3441703884,1672610195,1672612749,2554
3758,3713561276,3511150845,1672605417,1672605487,70
3509,3660063072,3701664364,1672586802,1672589360,2558
3883,3315703693,3385323994,1672607161,1672608336,1175
3836,3380767040,3299781901,1672654173,1672655700,1527
3523,3493017654,3829864515,1672629470,1672631459,1989
3558,3294747828,3515466096,1672612609,1672615538,2929
3490,3501567772,3778597171,1672592938,1672595663,2725
3716,3517462308,3559458968,1672536943,1672539200,2257
3645,3289114629,3289817992,1672631217,1672633584,2367
3814,3836241528,3618697021,1672693354,1672695002,1648
3559,3627368399,3517358573,1672668871,1672669379,508
3811,3733558985,3934064792,1672560898,1672561787,889
3862,3716963089,3931627862,1672645291,1672646626,1335
3476,3773033649,3493017654,1672657148,1672660563,3415
3728,3480100311,3206837348,1672661738,1672664394,2656
3568,3455018347,3779639983,1672574232,1672577577,3345
3690,3934064792,3714067076,1672601939,1672602175,236
3720,3372223551,3512882178,1672539875,1672541087,1212
3809,3777189898,3609881958,1672556029,1672557913,1884
3692,3891672228,3396726504,1672649912,1672652866,2954
3916,3416987084,3408430195,1672631006,1672633188,2182
3468,3778134418,3375449013,1672624523,1672626933,2410
3661,3783520186,3979802715,1672600481,1672602278,1797
3678,3515439826,3774705415,1672589018,1672591075,2057
3574,3315703693,3890739241,1672534406,1672534497,91
3572,3793740407,3760364383,1672601497,1672604984,3487
3787,3780427126,3372223551,1672603428,1672604565,1137
3456,3757383891,3203538212,1672656214,1672656836,622
3493,3682133690,3206837348,1672660348,1672661308,960
3781,3622665543,3686523546,1672682687,1672683142,455
3685,3500302272,3824641227,1672573961,1672577227,3266
3525,3773735484,3334951866,1672614450,1672615715,1265
3806,3970558632,3774876004,1672699553,1672700059,506
3517,3776034743,3770520359,1672577477,1672578648,1171
3586,3902625986,3734451191,1672550686,1672550848,162
3593,3519416013,3778597171,1672542184,1672542398,214
3601,3299781901,3209481722,1672557435,1672560509,3074
3589,3315279093,3774178201,1672639986,1672641353,1367
3705,3515559913,3783136330,1672688789,1672690027,1238
3614,3701136026,3680810086,1672697674,1672698081,407
3867,3519077659,3513018485,1672568411,1672569627,1216
3616,3554944414,3615737355,1672695445,1672697262,1817
3559,3289817992,3500709774,1672565619,1672567817,2198
3671,3513853403,3604867757,1672647326,1672650598,3272
3468,3755065949,3360616538,1672610638,1672613246,2608
3728,3776084820,3436025562,1672586607,1672588678,2071
3862,3783147088,3446533960,1672542296,1672542823,527
3914,3710496785,3773332082,1672601135,1672603839,2704
3680,3887243870,3511317276,1672579800,1672581354,1554
3671,3615087943,3226511603,1672554308,1672555675,1367
3520,3618489670,3491684096,1672535175,1672538494,3319
3585,3773572967,3514275974,1672671865,1672672979,1114
3587,3909094917,3609113156,1672596494,1672596925,431
3762,3500613493,3825881598,1672545544,1672547184,1640
3593,3614740489,3306412634,1672644830,1672644963,133
3684,3793175445,3514818819,1672566597,1672567787,1190
3741,3311498666,3203538212,1672552837,1672553657,820
3699,3664943873,3449333754,1672578523,1672579122,599
3464,3351866415,3480726047,1672548767,1672551937,3170
3687,3488686442,3904569677,1672694945,1672695117,172
3799,3451326054,3511791953,1672622353,1672624745,2392
3599,3409114719,3783550022,1672699750,1672700648,898
3730,3492546679,3500827202,1672694210,1672696790,2580
3905,3667673649,3783550022,1672671089,1672672764,1675
3639,3514971533,3710315160,1672568388,1672571859,3471
3441,3205985903,3777779869,1672553081,1672556291,3210
3476,3270697740,3755496114,1672575263,1672576799,1536
3729,3773332082,3793407963,1672541169,1672544445,3276
3501,3757193307,3396980894,1672578013,1672580535,2522
3871,3272030610,3710735406,1672588212,1672588451,239
3905,3280268483,3615737355,1672567811,1672568841,1030
3632,3500703304,3920625129,1672619857,1672620007,150
3840,3337362061,3904569677,1672662015,1672662273,258
3881,3505434346,3480490124,1672599524,1672603110,3586
3533,3428725843,3613206049,1672639306,1672642062,2756
3590,3932478321,3230135532,1672690587,1672694124,3537
3672,3513296868,3791128487,1672649753,1672650097,344
3549,3441703884,3515466096,1672697399,1672697701,302
3474,3514512367,3315279093,1672607813,1672611340,3527
3532,3514308235,3448875382,1672597613,1672601185,3572
3658,3661447322,3492959689,1672577276,1672580257,2981
3894,3421385957,3777189898,1672624247,1672626418,2171
3731,3510964997,3512958459,1672581260,1672582018,758
3912,3834963772,3402385957,1672578183,1672581346,3163
3619,3710854064,3533368789,1672697322,1672699149,1827
3500,3737147209,3357864626,1672619832,1672621604,1772
3511,3202141727,3520560590,1672640145,1672642995,2850
3626,3780712350,3288762795,1672622235,1672625213,2978
3913,3232208416,3500072204,1672615681,1672616374,693
3727,3514246749,3773837847,1672585468,1672587695,2227
3843,3505634634,3624297844,1672632486,1672635125,2639
3853,3500525825,3306412634,1672573773,1672576404,2631
3455,3711077927,3923420131,1672592175,1672594928,2753
3610,3610870949,3511024016,1672677410,1672680949,3539
3895,3409114719,3615087943,1672540259,1672543395,3136
3479,3757075324,3928511283,1672579595,1672581557,1962
3443,3392520516,3516444201,1672583426,1672585735,2309
3902,3756385685,3512882178,1672581264,1672582505,1241
3651,3793583656,3500604680,1672631828,1672634325,2497
3697,3414940786,3900898992,1672687808,1672690905,3097
3558,3971806004,3500604680,1672544384,1672544712,328
3454,3554944414,3516321888,1672689769,1672690851,1082
3639,3462636434,3757318448,1672647953,1672648030,77
3829,3330340793,3770296583,1672579950,1672582118,2168
3436,3856606678,3343132529,1672537809,1672538182,373
3766,3460719322,3639050419,1672662199,1672664210,2011
3431,3512295534,3480991549,1672607130,1672610312,3182
3888,3480490124,3512392431,1672542974,1672544340,1366
3613,3310039260,3682133690,1672547929,1672548915,986
3849,3509893027,3226511603,1672579239,1672579541,302
3804,3500857494,3776988674,1672614105,1672616764,2659
3453,3792072681,3311498666,1672696607,1672698502,1895
3907,3492546679,3306412634,1672615338,1672618897,3559
3625,3435167810,3363162590,1672692578,1672695069,2491
3514,3669146016,3209526819,1672678198,1672679095,897
3842,3711006062,3739911441,1672614714,1672618129,3415
3502,3514818819,3773027597,1672538879,1672539459,580
3463,3904569677,3611055563,1672610514,1672612950,2436
3855,3452016771,3713911104,1672693335,1672695748,2413
3608,3509764635,3500317969,1672696250,1672698617,2367
3478,3408498208,3713911104,1672596936,1672597122,186
3738,3511883730,3713911104,1672664612,1672664903,291
3827,3368283077,3792745809,1672685100,1672686087,987
3521,3713300120,3793935736,1672627724,1672628655,931
3778,3757075324,3394401087,1672695573,1672698094,2521
3810,3680843171,3783550022,1672700609,1672704030,3421
3659,3515401243,3637313265,1672687282,1672687592,310
3696,3630353876,3770624662,1672666150,1672668702,2552
3777,3793969543,3791613604,1672679932,1672681987,2055
3518,3815250107,3760094385,1672664929,1672666369,1440
3785,3710735406,3509756823,1672666602,1672669797,3195
3808,3637313265,3500442734,1672597375,1672600867,3492
3818,3933894942,3500604680,1672542767,1672545144,2377
3612,3462158237,3933894942,1672670398,1672672286,1888
3898,3362641275,3921648519,1672672654,1672673237,583
3518,3491469603,3792538417,1672689051,1672690759,1708
3535,3783147088,3780322355,1672663557,1672665781,2224
3859,3792442597,3780322355,1672652457,1672654855,2398
3534,3792546035,3533188828,1672680060,1672681659,1599
3748,3201676087,3734451191,1672644220,1672646329,2109
3514,3501215099,3505634634,1672557247,1672559465,2218
3700,3714128600,3757075324,1672560415,1672560671,256
3879,3898314440,3909094917,1672695045,1672695126,81
3686,3757903168,3735374579,1672683872,1672684480,608
3537,3230868435,3518653080,1672636210,1672638936,2726
3484,3777694660,3517358573,1672592397,1672592717,320
3725,3792014516,3485540729,1672549915,1672550770,855
3802,3713784974,3615115210,1672605386,1672608914,3528
3868,3418448389,3517358573,1672623333,1672625167,1834
3484,3517697722,3780680950,1672656351,1672657172,821
3531,3778667336,3713979100,1672609232,1672611200,1968
3766,3520764926,3615688740,1672616111,1672616413,302
3757,3639050419,3205923620,1672630805,1672634329,3524
3456,3755065949,3858172636,1672534965,1672537018,2053
3673,3369708250,3701136026,1672685997,1672689397,3400
3668,3505847380,3757075324,1672531368,1672534510,3142
3856,3509764635,3935913584,1672542427,1672545864,3437
3843,3711077927,3779854934,1672660549,1672661735,1186
3723,3300229945,3239617320,1672659152,1672659930,778
3814,3316800320,3772078494,1672535774,1672537341,1567
3583,3357689359,3755737419,1672548892,1672551946,3054
3837,3791436104,3500072204,1672583460,1672586660,3200
3498,3516903528,3333918941,1672563723,1672565982,2259
3834,3461119815,3772391882,1672558786,1672560213,1427
3560,3680843171,3501215099,1672614607,1672615285,678
3600,3421385957,3912891315,1672581786,1672582797,1011
3832,3739911441,3516444201,1672649067,1672652289,3222
3755,3455018347,3411688875,1672536334,1672539402,3068
3686,3272096759,3505663516,1672699305,1672701241,1936
3661,3501121099,3711853996,1672594703,1672595153,450
3437,3934064792,3390660440,1672544391,1672544991,600
3647,3448875382,3737972328,1672559278,1672561859,2581
3765,3298151889,3923754072,1672681228,1672683972,2744
3651,3517697722,3783136330,1672587645,1672588850,1205
3824,3512392431,3229822507,1672636113,1672637235,1122
3728,3715400486,3780712350,1672681422,1672681826,404
3777,3519850727,3684523966,1672653182,1672653776,594
3481,3615737355,3334951866,1672691239,1672693229,1990
3752,3617392620,3792949946,1672603868,1672605558,1690
3496,3714120857,3357689359,1672680214,1672682565,2351
3915,3902861231,3619922891,1672533906,1672536589,2683
3706,3491469603,3931627862,1672572117,1672573118,1001
3563,3501384020,3517991730,1672614591,1672616306,1715
3853,3203538212,3337362061,1672692382,1672695355,2973
3788,3821054646,3515525630,1672536478,1672536821,343
3530,3714666884,3505725706,1672546860,1672546924,64
3896,3515559913,3224811762,1672661796,1672662633,837
3743,3755344363,3512800570,1672687191,1672689197,2006
3444,3755158925,3517737088,1672660158,1672662681,2523
3647,3852686295,3776559988,1672619631,1672619985,354
3562,3757318448,3279473441,1672698386,1672699794,1408
3626,3462636434,3226024417,1672542760,1672545611,2851
3529,3500317969,3713163045,1672587924,1672590636,2712
3737,3703139663,3399518841,1672632882,1672633061,179
3647,3245232284,3490029863,1672687330,1672688219,889
3884,3501281016,3972083617,1672681808,1672685122,3314
3449,3774641380,3224968597,1672648708,1672651880,3172
3897,3773332082,3488686442,1672540143,1672543272,3129
3904,3636329663,3701136026,1672539508,1672541300,1792
3647,3385323994,3200308999,1672664918,1672667966,3048
3818,3772765746,3343132529,1672635576,1672638245,2669
3908,3777485931,3713691388,1672563786,1672566865,3079
3538,3283144118,3780571086,1672695503,1672697322,1819
3634,3306175858,3515559913,1672662114,1672662660,546
3536,3514246749,3334974375,1672561486,1672563225,1739
3528,3783801141,3300229945,1672586711,1672588251,1540
3856,3201800997,3514324011,1672624077,1672626749,2672
3584,3373089838,3300511067,1672683037,1672683472,435
3454,3554186380,3902625986,1672700719,1672702930,2211
3870,3303410628,3931627862,1672579651,1672582347,2696
3665,3200308999,3472312341,1672571492,1672572765,1273
3813,3338083680,3620292035,1672617521,1672618367,846
3551,3513296868,3970627281,1672649075,1672650643,1568
3448,3517222913,3760094385,1672574583,1672575935,1352
3821,3315279093,3682133690,1672652606,1672655365,2759
3912,3505266860,3513065217,1672603113,1672605104,1991
3859,3760721303,3831586487,1672679754,1672682823,3069
3598,3756385685,3904412440,1672585022,1672586578,1556
3728,3337322736,3900898992,1672611609,1672612366,757
3701,3401793306,3938389661,1672537651,1672539947,2296
3581,3480991549,3619922891,1672534069,1672536690,2621
3828,3900898992,3518565331,1672560332,1672561355,1023
3661,3904569677,3899326793,1672669150,1672669894,744
3889,3668533536,3793175445,1672578447,1672578757,310
3909,3417191856,3734915241,1672552706,1672554305,1599
3655,3370227921,3755233658,1672583499,1672583994,495
3442,3403370192,3534829213,1672683661,1672683849,188
3577,3757294769,3714233826,1672591259,1672593226,1967
3880,3610358027,3927403123,1672652044,1672653987,1943
3692,3414940786,3791441520,1672599416,1672599682,266
3463,3241790910,3793781065,1672618152,1672618802,650
3558,3351696332,3299781901,1672683921,1672685502,1581
3845,3408430195,3513853403,1672682303,1672684533,2230
3786,3304155815,3884596900,1672682477,1672686066,3589
3637,3410600350,3512502036,1672584065,1672584738,673
3642,3619922891,3351866415,1672660332,1672662338,2006
3697,3938503547,3500072204,1672682059,1672683115,1056
3765,3831586487,3780571086,1672586046,1672588860,2814
3622,3774718695,3534566651,1672559366,1672559629,263
3881,3887243870,3501457103,1672662708,1672663592,884
3549,3500109249,3632814465,1672677817,1672677986,169
3861,3755404116,3280268483,1672597337,1672598104,767
3859,3363162590,3311498666,1672628328,1672631522,3194
3746,3436257398,3770236215,1672561447,1672564407,2960
3468,3711734586,3774641380,1672700098,1672700698,600
3816,3716628503,3404025196,1672631732,1672633810,2078
3755,3835985172,3701664364,1672694093,1672696043,1950
3496,3711077927,3715443333,1672533125,1672535385,2260
3727,3610358027,3225636215,1672685780,1672687045,1265
3684,3610870949,3511843593,1672532320,1672535373,3053
3760,3609881958,3424445495,1672638688,1672642208,3520
3870,3829864515,3410160376,1672695226,1672695989,763
3466,3285204083,3711077927,1672572046,1672573278,1232
3596,3783169442,3615939504,1672560333,1672561002,669
3706,3730071479,3510642075,1672636639,1672639543,2904
3787,3510798825,3517358573,1672601235,1672604076,2841
3722,3299781901,3438078818,1672569331,1672572857,3526
3841,3510964997,3770468980,1672654345,1672657459,3114
3800,3520181148,3668414677,1672571487,1672573072,1585
3425,3685816610,3701424609,1672687400,1672690440,3040
3529,3554186380,3519416013,1672630626,1672631092,466
3602,3618176292,3519087371,1672551596,1672554483,2887
3550,3703139663,3660063072,1672701426,1672703067,1641
3771,3440137407,3516321888,1672599520,1672601255,1735
3791,3935399379,3421385957,1672564957,1672566321,1364
3807,3274831810,3512958459,1672682961,1672683978,1017
3562,3554944414,3970603231,1672661520,1672663328,1808
3526,3364726656,3791796585,1672556837,1672557432,595
3536,3500317969,3625174002,1672652009,1672653244,1235
3725,3230868435,3791046864,1672577033,1672577583,550
3540,3387594369,3341893384,1672611549,1672613393,1844
3761,3611055563,3777694660,1672599513,1672602776,3263
3693,3441348818,3792274796,1672692246,1672693478,1232
3572,3305336154,3311420950,1672651916,1672655244,3328
3490,3779892400,3368283077,1672677377,1672677946,569
3570,3703433819,3757193551,1672540103,1672541243,1140
3527,3463849738,3509483172,1672657876,1672661241,3365
3692,3684523966,3668747074,1672650538,1672652706,2168
3601,3389634034,3755230952,1672596449,1672596552,103
3572,3914691363,3288224595,1672568349,1672571225,2876
3480,3755915206,3449333754,1672679897,1672683452,3555
3887,3757332128,3819767045,1672541867,1672542926,1059
3810,3780253901,3351866415,1672534424,1672537305,2881
3712,3714670620,3440137407,1672584952,1672588247,3295
3695,3516321888,3408430195,1672599413,1672600054,641
3517,3793743698,3493017654,1672584675,1672587190,2515
3890,3713517039,3773913680,1672588649,1672590700,2051
3642,3631090677,3334993594,1672557979,1672560982,3003
3446,3485540729,3224968597,1672590659,1672591620,961
3798,3500317969,3792949946,1672700295,1672702113,1818
3741,3757323954,3736231757,1672680200,1672681694,1494
3643,3505634634,3817813340,1672561653,1672562413,760
3610,3519651506,3303410628,1672629385,1672630583,1198
3842,3760645796,3680843171,1672548269,1672551097,2828
3765,3733363628,3938389661,1672624961,1672628079,3118
3599,3713911104,3375449013,1672559353,1672560000,647
3566,3780834916,3803389195,1672548496,1672551948,3452
3843,3737112297,3554944414,1672628163,1672629638,1475
3652,3904412440,3714670620,1672636056,1672638079,2023
3513,3505663516,3500109249,1672554615,1672555614,999
3543,3923420131,3793315718,1672693021,1672694875,1854
3700,3711097754,3779639983,1672626382,1672629673,3291
3893,3710562338,3916490839,1672676371,1672679567,3196
3697,3311420950,3779532653,1672658450,1672658698,248
3647,3779532653,3824215187,1672552689,1672554889,2200
3851,3514334067,3520657891,1672554591,1672557469,2878
3559,3414275042,3831586487,1672694394,1672697831,3437
3890,3500737582,3755573472,1672616383,1672616498,115
3663,3714670620,3270697740,1672688129,1672689914,1785
3862,3435167810,3778667336,1672667913,1672670647,2734
3537,3559731671,3364378127,1672534869,1672535386,517
3584,3551389192,3512379024,1672677156,1672678865,1709
3748,3791436104,3859868849,1672633199,1672634286,1087
3604,3773913680,3283770991,1672703461,1672705360,1899
3510,3834631333,3711077927,1672693519,1672694363,844
3473,3621184108,3360069849,1672661018,1672661751,733
3738,3534126409,3931627862,1672651595,1672653153,1558
3865,3689697817,3934064792,1672597329,1672597800,471
3774,3469254160,3480991549,1672676729,1672680317,3588
3847,3445206685,3779301501,1672543953,1672544381,428
3869,3449639012,3772236797,1672689444,1672691232,1788
3569,3669146016,3505807416,1672641665,1672641787,122
3746,3839245934,3711000597,1672635081,1672637488,2407
3442,3519850727,3710496785,1672576163,1672578460,2297
3556,3972083617,3205985903,1672583988,1672587196,3208
3781,3776084820,3240394404,1672543584,1672544065,481
3796,3517590837,3608855425,1672654174,1672656682,2508
3516,3519282716,3236499444,1672661455,1672664119,2664
3606,3783340788,3514246749,1672605644,1672606270,626
3787,3779639983,3510187271,1672694421,1672695471,1050
3820,3668533536,3890739241,1672648277,1672649573,1296
3699,3701322924,3776034743,1672554681,1672557277,2596
3672,3701247948,3777624586,1672683224,1672683988,764
3654,3774243020,3520991398,1672598617,1672599604,987
3637,3273981374,3514818819,1672597866,1672600146,2280
3527,3510641433,3334974375,1672703835,1672704601,766
3449,3711218296,3755344363,1672634621,1672636896,2275
3638,3384583385,3772765746,1672646220,1672648579,2359
3596,3516513251,3970198861,1672664165,1672666804,2639
3460,3500857494,3783169442,1672580297,1672580481,184
3578,3755065949,3245232284,1672652145,1672654799,2654
3698,3347446226,3349856820,1672557520,1672560594,3074
3575,3791753345,3970627281,1672556895,1672556955,60
3508,3600876425,3343132529,1672576735,1672579338,2603
3640,3783615982,3774605761,1672654194,1672656745,2551
3544,3510187271,3357864626,1672698067,1672698197,130
3841,3626499450,3424660806,1672572721,1672574205,1484
3621,3814305099,3710562338,1672553841,1672555212,1371
3809,3779938251,3638204468,1672657130,1672658331,1201
3879,3613416045,3715545685,1672678249,1672680728,2479
3883,3520657891,3793175445,1672604418,1672608005,3587
3647,3226024417,3519651506,1672539506,1672540175,669
3864,3824215187,3351696332,1672580595,1672582047,1452
3764,3755915206,3714666884,1672551922,1672554585,2663
3749,3421877923,3905196766,1672541052,1672541899,847
3538,3512383699,3617489344,1672550788,1672552822,2034
3903,3372223551,3274831810,1672539101,1672541942,2841
3872,3630353876,3347419520,1672564730,1672565013,283
3560,3630353876,3436025562,1672625569,1672626012,443
3551,3201800997,3513295938,1672582657,1672583296,639
3566,3360813161,3757075324,1672614374,1672617911,3537
3442,3511024016,3533274994,1672532472,1672532630,158
3719,3285204083,3224968597,1672694990,1672695208,218
3709,3778640261,3315279093,1672661739,1672661924,185
3634,3272096759,3627368399,1672668082,1672669766,1684
3597,3510919821,3714128600,1672647425,1672649559,2134
3615,3811075491,3520657891,1672645440,1672648121,2681
3773,3783771827,3396726504,1672653373,1672653932,559
3549,3779301501,3902625986,1672583672,1672586138,2466
3462,3411515369,3701373490,1672589432,1672591756,2324
3751,3835422146,3824215187,1672639047,1672639383,336
3748,3512958459,3447672935,1672679220,1672682237,3017
3711,3621184108,3891672228,1672542773,1672543424,651
3689,3739895284,3232208416,1672674164,1672676553,2389
3755,3505434346,3701136026,1672671367,1672673527,2160
3671,3511150845,3791693821,1672619751,1672620676,925
3888,3617489344,3467779445,1672663148,1672664736,1588
3677,3792274796,3920898925,1672548250,1672549745,1495
3471,3208452238,3815392801,1672559656,1672561775,2119
3559,3755532873,3932478321,1672594275,1672595749,1474
3907,3231494505,3774290799,1672647366,1672649851,2485
3612,3501281016,3755992176,1672688685,1672690163,1478
3470,3272030610,3760842815,1672543971,1672545513,1542
3745,3472068734,3519909393,1672616255,1672617487,1232
3524,3914691363,3714120857,1672559267,1672560337,1070
3483,3288224595,3608855425,1672551826,1672553205,1379
3845,3770146716,3514818819,1672568670,1672569186,516
3701,3780680950,3835422146,1672541653,1672544257,2604
3809,3783136330,3424660806,1672640966,1672642077,1111
3632,3895285664,3227799827,1672654994,1672656712,1718
3811,3394297564,3436025562,1672654960,1672655794,834
3881,3299125059,3755573472,1672567796,1672570405,2609
3589,3533423872,3410600350,1672593630,1672596552,2922
3887,3556969573,3288224595,1672543115,1672543478,363
3785,3777814504,3977352557,1672562607,1672563818,1211
3641,3791796585,3509756823,1672575745,1672577483,1738
3545,3225636215,3480726047,1672594091,1672596034,1943
3683,3609113156,3701005527,1672647846,1672651288,3442
3809,3783615982,3510499038,1672595699,1672598213,2514
3671,3512392431,3456430614,1672672493,1672675716,3223
3574,3760364383,3500302272,1672622610,1672623155,545
3702,3501786419,3774290799,1672692713,1672695296,2583
3694,3715127070,3350095157,1672658271,1672658963,692
3507,3615115210,3428725843,1672601616,1672601737,121
3851,3780115155,3201676087,1672606882,1672607629,747
3754,3516903528,3500044458,1672638440,1672641476,3036
3902,3611055563,3300979975,1672658761,1672660977,2216
3755,3938389661,3459681410,1672594900,1672595229,329
3430,3921648519,3807212280,1672538444,1672540629,2185
3631,3512958459,3516703758,1672698614,1672702145,3531
3530,3241790910,3360813161,1672597307,1672599932,2625
3803,3439673892,3668747074,1672600420,1672601014,594
3854,3228888030,3618354185,1672545791,1672548257,2466
3793,3710489491,3928719932,1672670450,1672671370,920
3911,3776084820,3513345163,1672549239,1672551029,1790
3564,3512337405,3491684096,1672687878,1672690680,2802
3835,3774733620,3519909393,1672549206,1672552466,3260
3856,3409114719,3514703118,1672603268,1672605320,2052
3526,3505847380,3229974066,1672640779,1672643425,2646
3795,3500613459,3310039260,1672623304,1672624033,729
3877,3619922891,3777091903,1672588717,1672592079,3362
3538,3467779445,3512282789,1672562631,1672562968,337
3871,3517737088,3291933594,1672556563,1672557253,690
3790,3224330592,3900898992,1672599380,1672602924,3544
3679,3610870949,3311498666,1672562958,1672564752,1794
3519,3779301501,3288762795,1672681624,1672683142,1518
3674,3500347447,3231494505,1672695905,1672696200,295
3576,3905196766,3779786641,1672549938,1672553117,3179
3901,3618808151,3732584121,1672607031,1672609100,2069
3567,3826238375,3773913680,1672690762,1672690849,87
3639,3904569677,3664943873,1672541482,1672544997,3515
3668,3600876425,3520578796,1672567955,1672571407,3452
3769,3467988782,3438489358,1672682737,1672685390,2653
3709,3916490839,3780322355,1672637755,1672640178,2423
3741,3757318448,3440107959,1672639197,1672639692,495
3576,3462273042,3399518841,1672693884,1672694512,628
3845,3755230952,3224811762,1672657659,1672659451,1792
3554,3680810086,3914691363,1672648441,1672651503,3062
3770,3439673892,3780472203,1672556314,1672556761,447
3633,3780209375,3306175858,1672582936,1672585890,2954
3903,3760040019,3680843171,1672641443,1672644404,2961
3862,3293835352,3892304880,1672586897,1672588123,1226
3834,3424660806,3309314379,1672701829,1672705408,3579
3575,3410538749,3801645328,1672674716,1672675956,1240
3674,3739911441,3783340788,1672658888,1672661734,2846
3460,3757903168,3510767239,1672595954,1672596278,324
3459,3283770991,3791753345,1672544266,1672546528,2262
3604,3661903000,3389634034,1672672470,1672674986,2516
3739,3511005395,3491469603,1672658529,1672660808,2279
3624,3226511603,3515402792,1672649783,1672653221,3438
3813,3817813340,3299443125,1672647997,1672651076,3079
3517,3551376095,3760263530,1672627353,1672630933,3580
3903,3770676872,3509893027,1672695020,1672695993,973
3836,3517222913,3912891315,1672588098,1672589317,1219
3879,3412006598,3367509761,1672550794,1672551742,948
3499,3451726367,3488763230,1672658139,1672660887,2748
3780,3792274796,3299781901,1672664653,1672667551,2898
3584,3774641380,3928719932,1672587675,1672588267,592
3742,3755404116,3713589994,1672562729,1672566056,3327
3784,3688220326,3667427125,1672595632,1672598797,3165
3756,3519909393,3970198861,1672639871,1672640799,928
3875,3760040019,3739895284,1672630202,1672633237,3035
3437,3902760230,3757630221,1672642140,1672643274,1134
3534,3517887477,3778899160,1672538618,1672538769,151
3653,3514956366,3713691388,1672612592,1672615259,2667
3590,3300818269,3512946768,1672680356,1672683235,2879
3602,3824641227,3777189898,1672685440,1672687659,2219
3507,3510919821,3792072681,1672556668,1672559833,3165
3623,3271752081,3793883863,1672646326,1672648955,2629
3540,3615939504,3201800997,1672647359,1672649686,2327
3495,3246370118,3336627643,1672586155,1672587402,1247
3673,3514324011,3244004456,1672549278,1672552194,2916
3753,3773939399,3627368399,1672554240,1672556474,2234
3541,3898314440,3824215187,1672534623,1672536046,1423
3547,3492959689,3760263530,1672583827,1672586701,2874
3488,3396726504,3518653080,1672537549,1672537944,395
3724,3711006062,3895285664,1672585550,1672587808,2258
3488,3505111292,3638660068,1672584060,1672584479,419
3785,3715986185,3333918941,1672632559,1672632861,302
3838,3438489358,3898314440,1672633189,1672635403,2214
3745,3668533536,3440107959,1672549396,1672552408,3012
3591,3238288884,3773124276,1672545197,1672546141,944
3532,3739895284,3517590837,1672550663,1672551167,504
3731,3793315718,3710008361,1672546499,1672547327,828
3657,3435167810,3510554314,1672653747,1672654230,483
3653,3701107228,3499217428,1672685283,1672688665,3382
3658,3373028638,3334647380,1672659129,1672660395,1266
3759,3793935736,3517358573,1672615669,1672616125,456
3741,3780680950,3505923418,1672562239,1672565432,3193
3678,3779438325,3714128600,1672554140,1672555818,1678
3510,3792020993,3276003502,1672604214,1672605774,1560
3543,3534566651,3514956366,1672540222,1672541900,1678
3599,3334647380,3376467719,1672544773,1672545395,622
3670,3364378127,3760094385,1672678742,1672678988,246
3902,3510767239,3713163045,1672689656,1672691891,2235
3773,3974674109,3517222913,1672535393,1672538164,2771
3788,3436025562,3520560590,1672668890,1672669504,614
3739,3733363628,3343816795,1672680123,1672681025,902
3482,3363162590,3421385957,1672540940,1672542689,1749
3913,3732584121,3776034743,1672646880,1672648187,1307
3759,3773009828,3552824113,1672676633,1672678021,1388
3821,3792020993,3774243020,1672633343,1672633877,534
3773,3665998641,3777189898,1672641672,1672643855,2183
3532,3533294425,3899786664,1672594101,1672596998,2897
3436,3404025196,3892304880,1672545744,1672547932,2188
3572,3401793306,3770520359,1672582140,1672585508,3368
3691,3711218296,3280268483,1672681469,1672682265,796
3633,3920497528,3661583097,1672678115,1672679199,1084
3505,3617304541,3335694356,1672588435,1672590920,2485
3576,3500604680,3305722859,1672628356,1672630368,2012
3571,3439673892,3776034743,1672561529,1672562178,649
3682,3905899155,3416987084,1672692145,1672693676,1531
3679,3501215099,3490214516,1672567661,1672570818,3157
3757,3710854064,3608855425,1672541061,1672543215,2154
3613,3618808151,3711218296,1672670775,1672672939,2164
3638,3780209375,3515439826,1672665830,1672667845,2015
3800,3714067076,3760721303,1672556916,1672560221,3305
3698,3774876004,3500347447,1672570069,1672572601,2532
3592,3280054198,3680843171,1672598573,1672599963,1390
3916,3792274796,3534179433,1672566794,1672568131,1337
3769,3513853403,3517697722,1672637348,1672639154,1806
3687,3402697190,3899786664,1672630305,1672633197,2892
3692,3462636434,3839245934,1672631945,1672632387,442
3751,3410160376,3533004959,1672532510,1672533903,1393
3910,3661583097,3479851674,1672592276,1672593364,1088
3643,3701664364,3711006062,1672610903,1672611351,448
3559,3505437712,3713941638,1672605567,1672607303,1736
3616,3923420131,3793315718,1672702858,1672703903,1045
3699,3774155692,3897376951,1672571965,1672575049,3084
3572,3519142371,3533294425,1672624237,1672624976,739
3643,3792525861,3311420950,1672676646,1672680190,3544
3439,3791441520,3387594369,1672533829,1672535928,2099
3737,3732131656,3491469603,1672654398,1672657005,2607
3660,3514956366,3715707380,1672645487,1672646816,1329
3852,3800257590,3774290799,1672656708,1672659595,2887
3787,3429943738,3315703693,1672596609,1672597744,1135
3431,3778899160,3732131656,1672561396,1672563206,1810
3915,3780909839,3510028805,1672665564,1672666217,653
3540,3760362417,3756746867,1672599049,1672602035,2986
3578,3632814465,3515466096,1672587417,1672587875,458
3913,3777779869,3519077659,1672572232,1672574495,2263
3629,3206837348,3755915206,1672646275,1672647304,1029
3620,3499217428,3226024417,1672591937,1672594048,2111
3609,3520657891,3505923418,1672648553,1672651216,2663
3506,3713517039,3783771827,1672571614,1672572203,589
3709,3620292035,3457960571,1672601995,1672604668,2673
3539,3514419100,3701823816,1672540738,1672541195,457
3640,3512379024,3439673892,1672577779,1672580403,2624
3914,3714120857,3714185969,1672676493,1672677256,763
3888,3615688740,3777814504,1672540590,1672543072,2482
3655,3791436104,3279475486,1672533862,1672536559,2697
3651,3517358573,3778926763,1672607639,1672610208,2569
3903,3202141727,3701005527,1672684358,1672687927,3569
3556,3312998540,3384068080,1672581327,1672582268,941
3656,3770520359,3424660806,1672558034,1672560997,2963
3500,3701136026,3460719322,1672582892,1672583792,900
3581,3783771827,3914691363,1672587572,1672588756,1184
3467,3557046880,3792505974,1672672082,1672672227,145
3643,3501459390,3977352557,1672654235,1672656109,1874
3478,3514512367,3927599181,1672601841,1672604156,2315
3552,3472312341,3510919821,1672660953,1672664312,3359
3896,3635169815,3623266256,1672608766,1672611724,2958
3490,3505154885,3272716462,1672594661,1672597789,3128
3427,3614740489,3609881958,1672670454,1672671845,1391
3622,3396726504,3309314379,1672547644,1672550930,3286
3504,3459681410,3480991549,1672701369,1672702806,1437
3915,3613338363,3209481722,1672572069,1672573012,943
3542,3312998540,3760094385,1672566109,1672569209,3100
3672,3294747828,3977352557,1672580481,1672581256,775
3547,3393063657,3825881598,1672657393,1672660337,2944
3769,3661583097,3480490124,1672618832,1672621818,2986
3593,3336339664,3774718695,1672600914,1672604110,3196
3678,3509483172,3389634034,1672612881,1672615455,2574
3817,3715854030,3715986185,1672601633,1672603711,2078
3484,3224330592,3428725843,1672589889,1672590091,202
3600,3773939399,3509764635,1672693926,1672696965,3039
3511,3757383891,3738026330,1672625746,1672627215,1469
3589,3802932312,3514246749,1672683576,1672683989,413
3784,3776988674,3829822608,1672650932,1672653372,2440
3608,3934064792,3201629017,1672657762,1672658433,671
3695,3510641433,3500109249,1672549910,1672550832,922
3792,3852686295,3855583256,1672577148,1672580208,3060
3424,3802932312,3905899155,1672689452,1672689614,162
3828,3633735593,3623266256,1672610856,1672610939,83
3582,3514285803,3510187271,1672638418,1672638635,217
3818,3514956366,3500341755,1672544119,1672544280,161
3707,3757903168,3757700712,1672600630,1672602955,2325
3523,3900276517,3349856820,1672607381,1672609525,2144
3497,3773902805,3710562338,1672597844,1672598274,430
3433,3792072681,3497095254,1672534800,1672536031,1231
3819,3898314440,3534543776,1672628262,1672629171,909
3810,3610870949,3631479562,1672693393,1672695350,1957
3681,3248058676,3701005527,1672647159,1672649743,2584
3678,3714120857,3920497528,1672556303,1672559496,3193
3519,3714678331,3409114719,1672576212,1672579669,3457
3735,3774290799,3513853403,1672578122,1672579038,916
3888,3533228966,3835422146,1672692146,1672694364,2218
3726,3438489358,3776117322,1672545332,1672546093,761
3670,3271454397,3418448389,1672694319,1672696045,1726
3690,3756625818,3393063657,1672582653,1672583830,1177
3715,3688490530,3715854030,1672577307,1672577943,636
3621,3777091903,3621184108,1672702074,1672703003,929
3603,3335694356,3703383853,1672684576,1672687403,2827
3568,3519282716,3760094385,1672608978,1672611637,2659
3500,3713561276,3554825448,1672556791,1672558350,1559
3856,3778040015,3793743698,1672639409,1672641640,2231
3518,3808136029,3779613523,1672648474,1672650950,2476
3668,3923220461,3520322124,1672571306,1672571644,338
3679,3770146716,3780571086,1672596462,1672598718,2256
3697,3279473441,3834963772,1672559848,1672561215,1367
3451,3475349791,3777037426,1672561332,1672564031,2699
3549,3208452238,3519818818,1672697769,1672700700,2931
3632,3300511067,3300818269,1672569554,1672569669,115
3486,3298151889,3292147449,1672631385,1672633162,1777
3506,3639050419,3621683102,1672644173,1672646231,2058
3708,3780712350,3551389192,1672545823,1672548647,2824
3547,3774705415,3229974066,1672572457,1672573829,1372
3774,3803389195,3887243870,1672552352,1672553381,1029
3615,3209481722,3760651515,1672673392,1672674949,1557
3831,3757318448,3412006598,1672638492,1672640631,2139
3577,3618697021,3831586487,1672642294,1672645359,3065
3742,3424445495,3714827719,1672547536,1672547704,168
3810,3520873221,3337322736,1672566491,1672568564,2073
3640,3756474459,3776117322,1672556159,1672557584,1425
3721,3304155815,3732131656,1672596801,1672598387,1586
3682,3793175445,3533423872,1672548076,1672549533,1457
3666,3783373154,3773009828,1672581568,1672583236,1668
3748,3533294425,3394401087,1672627881,1672629566,1685
3693,3399518841,3915162005,1672577319,1672579824,2505
3638,3895285664,3509366311,1672686773,1672687656,883
3622,3833217041,3334647380,1672696694,1672700051,3357
3827,3668747074,3621683102,1672550296,1672552022,1726
3568,3229974066,3333403880,1672557738,1672558973,1235
3781,3343132529,3396980894,1672546895,1672549915,3020
3632,3734118023,3667427125,1672690965,1672693071,2106
3550,3509756823,3505888598,1672545843,1672546821,978
3810,3520657891,3450969839,1672597156,1672599111,1955
3852,3791436104,3236499444,1672700572,1672700671,99
3431,3534175249,3382733096,1672617486,1672619563,2077
3691,3711097754,3773027597,1672619637,1672620398,761
3885,3497671225,3291933594,1672570472,1672570722,250
3487,3778899160,3632814465,1672534758,1672536867,2109
3778,3895285664,3505178849,1672684873,1672686183,1310
3668,3284947372,3240394404,1672639124,1672640702,1578
3895,3500208903,3380767040,1672624169,1672625361,1192
3779,3793407963,3930242012,1672547059,1672548762,1703
3562,3512946768,3779438325,1672628378,1672630935,2557
3601,3760842815,3792072681,1672603104,1672606598,3494
3733,3770520359,3445206685,1672681178,1672683744,2566
3912,3600876425,3501457103,1672654863,1672656810,1947
3538,3608232640,3735374579,1672575941,1672577522,1581
3880,3512295534,3510499038,1672635074,1672636628,1554
3507,3733558985,3448875382,1672536031,1672537925,1894
3515,3511601997,3488686442,1672658458,1672661516,3058
3849,3500672156,3392943173,1672697367,1672699548,2181
3574,3760645796,3518194482,1672691605,1672694616,3011
3652,3387594369,3289817992,1672578037,1672580630,2593
3534,3783919913,3610870949,1672584700,1672586523,1823
3573,3226178937,3500525825,1672546776,1672548563,1787
3692,3240994288,3621790707,1672702768,1672705844,3076
3587,3533423872,3792546035,1672563736,1672566129,2393
3694,3600876425,3715707380,1672624499,1672628057,3558
3595,3510028805,3760364383,1672625485,1672626256,771
3615,3459681410,3517887477,1672680304,1672683505,3201
3677,3351696332,3300979975,1672642743,1672643962,1219
3891,3685681577,3280054198,1672640995,1672643393,2398
3462,3792745809,3505179890,1672628484,1672629034,550
3549,3505481368,3383138270,1672594468,1672596278,1810
3806,3457620713,3244004456,1672636428,1672639715,3287
3734,3375449013,3780834916,1672650390,1672652742,2352
3634,3364726656,3487875183,1672590671,1672591295,624
3724,3511150845,3357864626,1672681212,1672683579,2367
3907,3817813340,3613416045,1672664948,1672667033,2085
3672,3201800997,3520578796,1672703256,1672706012,2756
3745,3734915241,3379143440,1672639554,1672642093,2539
3910,3777091903,3923220461,1672627221,1672630600,3379
3474,3773572967,3770520359,1672624259,1672627332,3073
3838,3201676087,3393063657,1672600038,1672602372,2334
3778,3773913680,3441348818,1672590904,1672592225,1321
3829,3447672935,3635169815,1672535700,1672537450,1750
3452,3756789525,3815250107,1672681737,1672683438,1701
3755,3757348722,3516321888,1672644856,1672646360,1504
3642,3451326054,3689697817,1672593183,1672593480,297
3676,3408430195,3680810086,1672540872,1672541926,1054
3507,3609881958,3500525825,1672656050,1672656676,626
3836,3715619259,3520322124,1672688980,1672692122,3142
3712,3515466096,3833217041,1672644943,1672646625,1682
3829,3557046880,3520578796,1672659214,1672660718,1504
3558,3400069268,3792389522,1672576217,1672577161,944
3603,3505198734,3701664364,1672613372,1672616478,3106
3484,3735374579,3730071479,1672651899,1672653998,2099
3659,3533368789,3461119815,1672584160,1672587096,2936
3496,3885155975,3279473441,1672590426,1672591301,875
3487,3520991398,3500341755,1672698418,1672701974,3556
3762,3501567772,3520991398,1672538173,1672539422,1249
3506,3511317276,3792389522,1672695597,1672696096,499
3600,3533929349,3774243020,1672553031,1672555567,2536
3855,3475349791,3414275042,1672592153,1672594644,2491
3720,3306412634,3294703680,1672702982,1672704521,1539
3830,3779854934,3817813340,1672655234,1672655434,200
3727,3401940259,3225029895,1672593242,1672594458,1216
3757,3510499038,3515466096,1672661217,1672664334,3117
3770,3514308235,3715443333,1672581164,1672583807,2643
3757,3501786419,3472068734,1672677101,1672680043,2942
3913,3436025562,3779656423,1672667387,1672667979,592
3759,3500347447,3613338363,1672593875,1672594504,629
3449,3347446226,3429943738,1672629553,1672633107,3554
3780,3505725706,3792801638,1672658782,1672660142,1360
3658,3899786664,3300818269,1672653291,1672654302,1011
3626,3338390596,3515402792,1672590944,1672592751,1807
3870,3773033649,3559458968,1672659316,1672659741,425
3609,3793935736,3780769110,1672632201,1672634438,2237
3757,3520355798,3367971170,1672581481,1672582076,595
3807,3755992176,3970909253,1672619155,1672621036,1881
3656,3511791953,3533274994,1672552935,1672556494,3559
3651,3513018485,3200308999,1672674223,1672674462,239
3774,3349856820,3512882178,1672606299,1672608828,2529
3770,3447672935,3501281016,1672606218,1672607010,792
3653,3512295534,3293835352,1672598623,1672599140,517
3841,3231494505,3517697722,1672621289,1672624407,3118
3882,3501457103,3902625986,1672648806,1672651090,2284
3455,3512337405,3772078494,1672567381,1672569257,1876
3571,3288762795,3500672156,1672650169,1672652663,2494
3490,3904569677,3500341755,1672617247,1672618590,1343
3606,3533929349,3613338363,1672618105,1672621108,3003
3621,3777694660,3710489491,1672602418,1672604370,1952
3632,3792538417,3520181148,1672702867,1672702983,116
3463,3367111751,3615113018,1672586213,1672587307,1094
3601,3791753345,3755233658,1672539888,1672542018,2130
3505,3533090502,3777240360,1672647653,1672651112,3459
3734,3732131656,3310039260,1672585363,1672588941,3578
3719,3892304880,3755233658,1672701562,1672702871,1309
3821,3609113156,3230135532,1672604840,1672608208,3368
3854,3311085279,3777330107,1672642354,1672645732,3378
3789,3972083617,3505266860,1672571476,1672573519,2043
3868,3366423342,3622357348,1672567270,1672568315,1045
3774,3304971369,3512958459,1672534009,1672534525,516
3618,3625174002,3315279093,1672596920,1672597144,224
3515,3773735484,3383138270,1672538017,1672539653,1636
3882,3757700712,3514818819,1672569555,1672571355,1800
3435,3491469603,3514512367,1672602616,1672602841,225
3447,3447514821,3390660440,1672687537,1672689147,1610
3784,3424660806,3916490839,1672645492,1672647639,2147
3820,3665998641,3667427125,1672688830,1672690576,1746
3668,3920497528,3534179433,1672532117,1672532602,485
3632,3710008361,3923754072,1672621105,1672622948,1843
3446,3778926763,3701823816,1672701221,1672703177,1956
3767,3935399379,3970909253,1672689358,1672692040,2682
3619,3349856820,3451326054,1672613205,1672614816,1611
3475,3510818674,3783641602,1672638380,1672639984,1604
3740,3225636215,3713979100,1672562829,1672565950,3121
3566,3533090502,3713691388,1672636055,1672637575,1520
3805,3336339664,3512830734,1672589070,1672590642,1572
3529,3619922891,3792505974,1672653915,1672655279,1364
3782,3229822507,3880926355,1672675527,1672676632,1105
3792,3620292035,3510642075,1672619938,1672620949,1011
3656,3312998540,3829864515,1672646011,1672647024,1013
3458,3283492940,3382733096,1672620182,1672620639,457
3556,3457960571,3715127070,1672653613,1672656108,2495
3467,3360616538,3519028898,1672563395,1672566464,3069
3842,3793175445,3338083680,1672559831,1672561488,1657
3672,3519142371,3520657891,1672625954,1672627583,1629
3717,3513065217,3779938251,1672682516,1672683181,665
3697,3900898992,3792020993,1672550736,1672553105,2369
3543,3928511283,3756704774,1672658787,1672659886,1099
3859,3236458894,3512392431,1672683135,1672686305,3170
3456,3713979100,3716628503,1672620212,1672623054,2842
3477,3614740489,3517462308,1672579231,1672581850,2619
3840,3791796585,3703139663,1672633921,1672635359,1438
3827,3701247948,3812534508,1672674366,1672676989,2623
3630,3417191856,3713784974,1672614982,1672616853,1871
3632,3756625818,3793935736,1672554423,1672554637,214
3628,3487875183,3500072204,1672578548,1672580708,2160
3447,3511150845,3734118023,1672611039,1672611586,547
3739,3622357348,3737147209,1672612577,1672614061,1484
3902,3516444201,3316800320,1672658478,1672661362,2884
3667,3925979970,3902861231,1672585814,1672586104,290
3460,3713784974,3755737419,1672668561,1672670487,1926
3541,3333403880,3519416013,1672599308,1672599432,124
3427,3777189898,3923754072,1672623303,1672626687,3384
3638,3774733620,3480991549,1672690499,1672693621,3122
3870,3519028898,3500777439,1672617681,1672619222,1541
3486,3783520186,3970909253,1672602325,1672604453,2128
3855,3792389522,3713589994,1672639320,1672641368,2048
3858,3551389192,3505995057,1672548373,1672550459,2086
3684,3505228454,3410600350,1672568508,1672569630,1122
3807,3770520359,3904569677,1672657003,1672658201,1198
3429,3201629017,3817813340,1672556772,1672558619,1847
3444,3739911441,3660887799,1672676289,1672679488,3199
3808,3351696332,3226511603,1672646425,1672647289,864
3616,3755496114,3760694096,1672648290,1672649815,1525
3787,3710854064,3308760650,1672613484,1672616468,2984
3503,3491684096,3495911207,1672626600,1672626967,367
3786,3668747074,3780872464,1672628955,1672630619,1664
3536,3505807416,3615115210,1672558494,1672560031,1537
3633,3209481722,3774876004,1672579710,1672582952,3242
3678,3428725843,3909094917,1672672627,1672673591,964
3640,3713589994,3509366311,1672585489,1672586378,889
3721,3689114185,3975717896,1672667073,1672668710,1637
3876,3701823816,3517288083,1672653145,1672654480,1335
3845,3736705719,3533274994,1672617500,1672617561,61
3762,3491684096,3512800570,1672603223,1672603390,167
3537,3333918941,3778667336,1672558861,1672560347,1486
3542,3773902805,3773332082,1672620634,1672623941,3307
3528,3777779869,3382733096,1672596126,1672598875,2749
3880,3713163045,3713300120,1672561153,1672563640,2487
3803,3975717896,3618176292,1672576732,1672578835,2103
3664,3505725706,3350095157,1672612178,1672615566,3388
3699,3885155975,3701247948,1672533427,1672534128,701
3672,3514971533,3492546679,1672568721,1672569945,1224
3740,3618176292,3280268483,1672672998,1672675087,2089
3658,3668533536,3732584121,1672600963,1672602352,1389
3744,3505888598,3445206685,1672545219,1672547635,2416
3672,3897134762,3533929349,1672685051,1672687202,2151
3827,3774733620,3760924079,1672685080,1672685559,479
3487,3783919913,3514741348,1672687876,1672689509,1633
3626,3776117322,3664943873,1672561588,1672564215,2627
3493,3343132529,3513295938,1672658666,1672659070,404
3576,3756127300,3713163045,1672564665,1672565303,638
3754,3462158237,3300229945,1672693382,1672695251,1869
3808,3517737088,3617392620,1672690159,1672691204,1045
3717,3609933747,3505521218,1672570348,1672570773,425
3579,3228888030,3414275042,1672577710,1672578925,1215
3848,3387594369,3500672156,1672617851,1672620967,3116
3822,3688220326,3701322924,1672594869,1672597142,2273
3811,3395201292,3619922891,1672631772,1672632910,1138
3575,3777624586,3455018347,1672575608,1672577824,2216
3475,3792745809,3774876004,1672566353,1672567676,1323
3570,3239617320,3773332082,1672605308,1672605703,395
3865,3817813340,3416987084,1672601775,1672604399,2624
3498,3926643445,3360616538,1672567445,1672569892,2447
3880,3777694660,3271752081,1672639866,1672643167,3301
3721,3783801141,3310125159,1672560734,1672562793,2059
3533,3500347447,3351696332,1672664562,1672664937,375
3832,3414275042,3710735406,1672546003,1672549544,3541
3558,3770468980,3308760650,1672670849,1672673996,3147
3627,3225029895,3701322924,1672541805,1672545293,3488
3472,3770676872,3635169815,1672646187,1672648149,1962
3825,3667427125,3513545422,1672542703,1672543021,318
3720,3448875382,3711000597,1672673400,1672676528,3128
3847,3933894942,3513018485,1672672112,1672675402,3290
3713,3516444201,3514741348,1672617746,1672618851,1105
3715,3493017654,3500525825,1672683035,1672686416,3381
3567,3713979100,3884596900,1672648154,1672648676,522
3562,3511024016,3713589994,1672542087,1672544091,2004
3871,3773572967,3686227677,1672670980,1672671215,235
3791,3481640525,3760094385,1672640369,1672643610,3241
3685,3757193551,3792014516,1672682567,1672686089,3522
3475,3757700712,3774243020,1672558919,1672562386,3467
3875,3559458968,3904412440,1672584123,1672585067,944
3533,3449639012,3449639012,1672607242,1672608206,964
3492,3500109249,3856606678,1672583617,1672585417,1800
3544,3516489668,3556969573,1672682794,1672685908,3114
3740,3713163045,3703383853,1672596646,1672597008,362
3581,3409114719,3920497528,1672548214,1672548641,427
3594,3475349791,3512830734,1672623310,1672626334,3024
3618,3500442734,3514324011,1672543781,1672545016,1235
3879,3447672935,3514285803,1672540647,1672541038,391
3881,3780834916,3515401243,1672576844,1672580180,3336
3707,3773913680,3514334067,1672581420,1672581842,422
3751,3360616538,3755573472,1672596805,1672598382,1577
3460,3400763927,3500737582,1672655940,1672656067,127
3520,3668414677,3490029863,1672667264,1672667691,427
3615,3289817992,3633735593,1672653431,1672653872,441
3684,3711000597,3617392620,1672564958,1672567328,2370
3482,3500109249,3613338363,1672626059,1672626841,782
3652,3448633776,3779854934,1672557983,1672561219,3236
3665,3612689556,3202141727,1672673312,1672675040,1728
3918,3248058676,3467988782,1672700888,1672701808,920
3476,3885157459,3511024016,1672644766,1672646323,1557
3574,3783928182,3971806004,1672698119,1672698773,654
3594,3490029863,3608232640,1672568348,1672570328,1980
3582,3927599181,3436025562,1672611272,1672611805,533
3895,3500709774,3338083680,1672688943,1672690268,1325
3607,3289114629,3511883730,1672681952,1672683866,1914
3749,3833217041,3333403880,1672672182,1672674510,2328
3828,3608855425,3393063657,1672680519,1672681562,1043
3534,3500208903,3517222913,1672609682,1672613220,3538
3787,3296462324,3716628503,1672644845,1672647687,2842
3464,3885157459,3402697190,1672611696,1672612379,683
3671,3815250107,3513296868,1672620488,1672623158,2670
3472,3755404116,3701884158,1672577893,1672581470,3577
3785,3380767040,3500709774,1672579473,1672582138,2665
3683,3500613459,3618176292,1672561617,1672562872,1255
3759,3714185969,3520181148,1672570260,1672573761,3501
3918,3505634634,3783433404,1672652316,1672653370,1054
3807,3438078818,3714670620,1672631395,1672632757,1362
3592,3515401243,3856606678,1672576488,1672579216,2728
3616,3510187271,3310125159,1672536476,1672536657,181
3720,3520416075,3615113018,1672564716,1672566173,1457
3643,3625174002,3780115155,1672556559,1672559239,2680
3774,3520181148,3551399764,1672633746,1672635769,2023
3906,3887243870,3360069849,1672681031,1672682621,1590
3622,3757193307,3514971533,1672537588,1672538322,734
3736,3554186380,3284947372,1672577811,1672581365,3554
3876,3421877923,3905196766,1672685135,1672685280,145
3575,3831586487,3880926355,1672688271,1672688391,120
3743,3312998540,3979802715,1672650975,1672651870,895
3502,3777624586,3713691388,1672533924,1672536072,2148
3734,3979802715,3713589994,1672579815,1672583223,3408
3875,3927165965,3618808151,1672577499,1672579215,1716
3871,3935487534,3715974659,1672579253,1672581432,2179
3605,3777814504,3711637255,1672689162,1672691077,1915
3461,3756474459,3225631197,1672697005,1672697504,499
3832,3514285803,3512499658,1672620174,1672620551,377
3554,3770676872,3225636215,1672594068,1672594226,158
3499,3783771827,3230868435,1672663264,1672663993,729
3617,3513018485,3774155692,1672628026,1672628177,151
3541,3904569677,3609933747,1672671417,1672674493,3076
3712,3909094917,3515559913,1672663368,1672664782,1414
3552,3515525630,3900898992,1672568680,1672571678,2998
3613,3208957949,3779854934,1672542704,1672543026,322
3879,3467988782,3379143440,1672599480,1672600986,1506
3436,3500525825,3928719932,1672576597,1672579433,2836
3531,3315703693,3520416075,1672648607,1672652156,3549
3693,3518565331,3793743698,1672595107,1672598083,2976
3855,3354144091,3516489668,1672548213,1672550348,2135
3477,3608922867,3417679834,1672597914,1672600959,3045
3694,3505634634,3974674109,1672615772,1672618259,2487
3780,3505111292,3760694096,1672599466,1672602035,2569
3516,3734118023,3505923418,1672661113,1672664594,3481
3836,3757863420,3334974375,1672623657,1672624231,574
3638,3300979975,3755158925,1672545943,1672546241,298
3908,3519077659,3661583097,1672646737,1672647222,485
3650,3738026330,3818575661,1672561247,1672562409,1162
3472,3777240360,3839245934,1672601031,1672601790,759
3695,3448633776,3513081354,1672628764,1672632250,3486
3705,3885121158,3778040015,1672597348,1672600352,3004
3583,3501567772,3367971170,1672604555,1672606603,2048
3735,3834631333,3815250107,1672623514,1672626073,2559
3433,3401940259,3386758279,1672569089,1672569660,571
3621,3516489668,3454277788,1672650121,1672652333,2212
3785,3791246640,3500604680,1672687298,1672690360,3062
3523,3505402439,3418448389,1672683273,1672684035,762
3828,3515525630,3417679834,1672683993,1672685688,1695
3729,3512800570,3730071479,1672536314,1672536950,636
3483,3716679950,3239617320,1672534387,1672535492,1105
3728,3334974375,3974674109,1672681955,1672684358,2403
3677,3716110860,3462273042,1672685662,1672687435,1773
3513,3793935736,3814305099,1672654780,1672655178,398
3506,3733558985,3500208903,1672590271,1672591104,833
3782,3716679950,3923220461,1672649978,1672651618,1640
3471,3440137407,3669146016,1672687759,1672691284,3525
3614,3311498666,3270042456,1672621659,1672624733,3074
3499,3779532653,3514275974,1672584929,1672588230,3301
3570,3615087943,3660887799,1672687581,1672689989,2408
3493,3904412440,3501525100,1672555256,1672556793,1537
3533,3970198861,3770438122,1672671603,1672674107,2504
3715,3621184108,3341893384,1672693402,1672694324,922
3623,3773913680,3441703884,1672548725,1672549783,1058
3433,3739661856,3501281016,1672572673,1672574281,1608
3833,3902861231,3636329663,1672603260,1672605538,2278
3672,3236354255,3792546035,1672678669,1672680093,1424
3703,3925979970,3760263530,1672603209,1672604313,1104
3485,3512958459,3770468980,1672698257,1672701227,2970
3783,3459681410,3421877923,1672657731,1672659392,1661
3487,3499217428,3500302272,1672615363,1672617130,1767
3541,3516444201,3710562338,1672650432,1672652448,2016
3490,3627368399,3688220326,1672649819,1672650499,680
3529,3710315160,3500604680,1672549883,1672551899,2016
3606,3713561276,3683113954,1672674834,1672675526,692
3884,3311085279,3424660806,1672616543,1672618981,2438
3884,3897456874,3357864626,1672541331,1672544787,3456
3500,3495911207,3774243020,1672666737,1672668047,1310
3480,3369708250,3370227921,1672615943,1672618826,2883
3811,3793315718,3357864626,1672564404,1672564684,280
3856,3312998540,3852686295,1672639946,1672643130,3184
3594,3509756823,3736231757,1672623881,1672627297,3416
3920,3711077927,3271454397,1672638462,1672641003,2541
3714,3500044458,3201629017,1672556456,1672559103,2647
3442,3512882178,3225631197,1672615503,1672618622,3119
3632,3777091903,3505888598,1672674829,1672675275,446
3742,3755915206,3734451191,1672630066,1672630848,782
3637,3505283390,3493017654,1672658603,1672661490,2887
3433,3457960571,3783169442,1672661993,1672664333,2340
3696,3520560590,3488686442,1672588249,1672591233,2984
3607,3455018347,3839245934,1672691897,1672694319,2422
3864,3349739136,3793743698,1672573853,1672575299,1446
3644,3714067076,3491469603,1672671110,1672674439,3329
3427,3711812325,3770520359,1672659871,1672661784,1913
3470,3757323954,3505434346,1672550298,1672551395,1097
3722,3284932450,3515525630,1672544594,1672547591,2997
3709,3856606678,3755065949,1672551477,1672554985,3508
3629,3661447322,3497671225,1672541724,1672543508,1784
3505,3283770991,3336627643,1672664383,1672665361,978
3602,3501281016,3279339278,1672684008,1672687323,3315
3508,3236499444,3783136330,1672690111,1672690271,160
3588,3701884158,3885121158,1672688446,1672688788,342
3484,3770704999,3776831527,1672606221,1672609531,3310
3921,3617116290,3492546679,1672611864,1672612436,572
3547,3783641602,3716963089,1672671978,1672675149,3171
3442,3615087943,3533228966,1672542612,1672545018,2406
3521,3270056120,3755065949,1672625166,1672627629,2463
3635,3615737355,3703433819,1672604318,1672607165,2847
3533,3833217041,3970558632,1672547993,1672550109,2116
3892,3380982774,3668747074,1672684184,1672685213,1029
3536,3488686442,3757294769,1672539400,1672540803,1403
3826,3777147510,3731646673,1672590900,1672592109,1209
3863,3448875382,3733558985,1672590543,1672591150,607
3896,3619922891,3520322124,1672546087,1672547972,1885
3643,3887243870,3688796737,1672616894,1672617833,939
3834,3350095157,3714185969,1672610996,1672614245,3249
3632,3505198734,3755344363,1672688423,1672691261,2838
3876,3467779445,3621683102,1672675496,1672677162,1666
3523,3757332128,3755222916,1672613334,1672614190,856
3671,3613899351,3394297564,1672684814,1672687808,2994
3502,3608232640,3554186380,1672640939,1672643610,2671
3503,3276269264,3354144091,1672601128,1672604522,3394
3870,3621790707,3514419100,1672540838,1672542336,1498
3679,3928511283,3713941638,1672562290,1672563982,1692
3911,3760694096,3203538212,1672665613,1672666145,532
3447,3755532873,3272030610,1672687843,1672688158,315
3650,3819767045,3715127070,1672565439,1672566593,1154
3635,3351866415,3737972328,1672604102,1672604748,646
3520,3533423872,3500777439,1672650946,1672653727,2781
3424,3497095254,3202804048,1672573888,1672574785,897
3711,3416987084,3715986185,1672621922,1672622577,655
3663,3512392431,3792442597,1672548531,1672550582,2051
3614,3613206049,3783919913,1672633524,1672635525,2001
3869,3304155815,3773902805,1672615202,1672616556,1354
3849,3285204083,3760651515,1672565405,1672566758,1353
3816,3714120857,3520639768,1672546002,1672546980,978
3517,3760040019,3229974066,1672637498,1672637998,500
3526,3783928182,3774605761,1672593141,1672593577,436
3754,3338083680,3410160376,1672601746,1672602020,274
3661,3916490839,3686523546,1672550818,1672554153,3335
3649,3791046864,3283144118,1672540982,1672541343,361
3523,3510818674,3755496114,1672544954,1672545991,1037
3543,3928511283,3780769110,1672652490,1672653237,747
3749,3512722110,3701136026,1672701278,1672703798,2520
3459,3935913584,3373028638,1672612048,1672614307,2259
3804,3501459390,3300511067,1672571301,1672572176,875
3734,3224811762,3686523546,1672628814,1672629677,863
3562,3516321888,3299443125,1672575704,1672578737,3033
3530,3457960571,3512383699,1672628193,1672630299,2106
3585,3802932312,3241914067,1672568179,1672571324,3145
3535,3778040015,3511005395,1672603349,1672605538,2189
3804,3513853403,3369708250,1672643819,1672646469,2650
3526,3384583385,3534126409,1672583492,1672584849,1357
3767,3934064792,3760364383,1672554117,1672556600,2483
3623,3756746867,3501786419,1672623736,1672625883,2147
3570,3505228454,3774705415,1672692320,1672693866,1546
3745,3703348097,3774790271,1672589363,1672592069,2706
3798,3780115155,3229822507,1672663584,1672664153,569
3519,3305336154,3271454397,1672536758,1672540196,3438
3766,3618489670,3710562338,1672533268,1672535063,1795
3490,3609113156,3779301501,1672663820,1672666080,2260
3595,3283144118,3792274796,1672626828,1672627238,410
3497,3440107959,3517600136,1672574287,1672577583,3296
3491,3467988782,3773939399,1672555537,1672555966,429
3616,3373028638,3609113156,1672612005,1672615420,3415
3542,3451691949,3479851674,1672532070,1672535409,3339
3773,3402385957,3803517637,1672627603,1672631121,3518
3827,3660063072,3815250107,1672627198,1672630666,3468
3819,3382733096,3505888598,1672611729,1672615025,3296
3849,3755158925,3778667336,1672661905,1672664020,2115
3812,3512499658,3801645328,1672643619,1672647164,3545
3480,3436257398,3371455553,1672574861,1672577926,3065
3746,3501121099,3514971533,1672627626,1672629994,2368
3587,3757193307,3975717896,1672550137,1672550462,325
3575,3829864515,3449333754,1672567176,1672567386,210
3690,3514956366,3780909839,1672570640,1672572010,1370
3492,3514818819,3513853403,1672563785,1672565873,2088
3822,3779639983,3776244398,1672582104,1672582554,450
3829,3514246749,3668747074,1672600667,1672602415,1748
3744,3505725706,3512800570,1672553563,1672555642,2079
3813,3272096759,3446533960,1672531826,1672533393,1567
3563,3500857494,3372223551,1672565178,1672568756,3578
3842,3613416045,3899786664,1672657807,1672658751,944
3458,3623266256,3621461051,1672622815,1672625002,2187
3815,3688490530,3505402439,1672669949,1672671285,1336
3870,3792442597,3971806004,1672674656,1672676800,2144
3818,3817428320,3609881958,1672646126,1672648867,2741
3650,3885157459,3500317969,1672600468,1672601426,958
3616,3792546035,3518653080,1672610456,1672611698,1242
3544,3412968120,3625463628,1672677226,1672679747,2521
3516,3619922891,3511024016,1672540510,1672542924,2414
3876,3777037426,3511843593,1672617802,1672618260,458
3740,3716272919,3792389522,1672577657,1672579972,2315
3582,3756746867,3519909393,1672697651,1672699184,1533
3689,3505402439,3443357683,1672564846,1672567713,2867
3488,3927599181,3783147088,1672602953,1672604852,1899
3911,3773837847,3515525630,1672607455,1672608936,1481
3748,3514741348,3615115210,1672689175,1672689825,650
3908,3970558632,3933894942,1672601410,1672602179,769
3901,3818575661,3534175249,1672565427,1672568970,3543
3799,3932478321,3445206685,1672695117,1672697388,2271
3443,3667427125,3970909253,1672591936,1672592299,363
3443,3373028638,3512295534,1672597765,1672599407,1642
3574,3511024016,3500302272,1672673449,1672674032,583
3723,3823084403,3514246749,1672634583,1672635007,424
3454,3518653080,3513853403,1672577979,1672579384,1405
3914,3205923620,3429943738,1672579849,1672583127,3278
3884,3779438325,3370068529,1672617617,1672620943,3326
3593,3220031931,3731646673,1672612133,1672615488,3355
3448,3703383853,3713163045,1672604779,1672605180,401
3695,3974674109,3734118023,1672627350,1672629745,2395
3824,3756127300,3357864626,1672613378,1672615093,1715
3544,3300979975,3457620713,1672545279,1672546793,1514
3530,3793883863,3475349791,1672610467,1672613929,3462
3881,3283770991,3793175445,1672567219,1672567489,270
3539,3777091903,3711097754,1672668026,1672668717,691
3741,3783136330,3414049538,1672661365,1672662496,1131
3706,3858172636,3818575661,1672692882,1672695572,2690
3557,3855583256,3760721303,1672534779,1672536234,1455
3711,3500347447,3703348097,1672622571,1672625309,2738
3686,3779639983,3520181148,1672675856,1672676721,865
3681,3780834916,3971806004,1672690599,1672691819,1220
3692,3779646172,3516321888,1672605853,1672607544,1691
3496,3626499450,3914691363,1672617970,1672618797,827
3807,3520560590,3732131656,1672577131,1672577955,824
3515,3236458894,3488686442,1672655284,1672658795,3511
3751,3231494505,3668747074,1672647718,1672650951,3233
3490,3619922891,3617392620,1672612188,1672613968,1780
3718,3625463628,3783550022,1672540201,1672542221,2020
3500,3783919913,3495911207,1672702165,1672705542,3377
3888,3623266256,3760364383,1672538832,1672541286,2454
3564,3818575661,3456430614,1672610030,1672613243,3213
3614,3925979970,3493017654,1672682963,1672684968,2005
3859,3783373154,3779301501,1672644734,1672645770,1036
3831,3299125059,3612689556,1672606699,1672607007,308
3798,3779425804,3480100311,1672543339,1672544497,1158
3768,3480726047,3609933747,1672607334,1672610118,2784
3635,3660063072,3428725843,1672605350,1672605530,180
3783,3713941638,3716628503,1672625417,1672628345,2928
3632,3500525825,3424660806,1672631584,1672634874,3290
3801,3270056120,3680810086,1672557472,1672558477,1005
3913,3829864515,3608232640,1672701296,1672702156,860
3746,3773332082,3511732493,1672610147,1672611757,1610
3643,3512830734,3402385957,1672641030,1672641787,757
3585,3229974066,3783169442,1672661803,1672663177,1374
3865,3438489358,3920497528,1672638475,1672642025,3550
3902,3334993594,3635169815,1672557213,1672558231,1018
3467,3713561276,3756704774,1672572553,1672573157,604
3544,3383138270,3505198734,1672581102,1672582069,967
3713,3714067076,3505179890,1672543376,1672545880,2504
3514,3401940259,3533649454,1672566740,1672567827,1087
3486,3500498112,3360813161,1672669088,1672669888,800
3480,3792505974,3500827202,1672593826,1672594787,961
3816,3495911207,3756474459,1672670135,1672671759,1624
3918,3398731252,3793935736,1672571233,1672574267,3034
3587,3902625986,3511601997,1672603021,1672605603,2582
3763,3382733096,3755158925,1672622687,1672625925,3238
3718,3613899351,3783520186,1672694698,1672695361,663
3875,3617392620,3363162590,1672673008,1672674896,1888
3429,3462158237,3783801141,1672572317,1672574773,2456
3577,3633735593,3900276517,1672641978,1672645476,3498
3709,3791106564,3513065217,1672623114,1672626200,3086
3740,3271752081,3792274796,1672645747,1672646295,548
3583,3791796585,3481640525,1672571651,1672574333,2682
3532,3501525100,3206837348,1672690345,1672690439,94
3644,3710048469,3495911207,1672590769,1672592441,1672
3479,3284932450,3892304880,1672582945,1672585084,2139
3687,3417679834,3500827202,1672661181,1672662177,996
3869,3534357694,3791128487,1672674622,1672675869,1247
3565,3373028638,3607768197,1672688623,1672690991,2368
3611,3457960571,3505634634,1672671116,1672672580,1464
3544,3516513251,3914691363,1672571367,1672572204,837
3469,3755065949,3335694356,1672637234,1672637820,586
3455,3396726504,3737147209,1672590488,1672593358,2870
3765,3755756564,3974674109,1672672991,1672675256,2265
3899,3534543776,3514324011,1672645845,1672646399,554
3882,3778926763,3334974375,1672602186,1672605777,3591
3731,3776117322,3501525100,1672641957,1672643647,1690
3640,3517991730,3554825448,1672654828,1672654941,113
3504,3770704999,3638204468,1672647299,1672649316,2017
3893,3703139663,3245232284,1672579163,1672582745,3582
3472,3710562338,3416987084,1672573331,1672575076,1745
3639,3516298579,3511442562,1672643698,1672647042,3344
3484,3776084820,3520991398,1672613821,1672616188,2367
3833,3376467719,3461119815,1672560712,1672562578,1866
3761,3516903528,3516444201,1672602416,1672604250,1834
3723,3632814465,3311085279,1672659065,1672660013,948
3890,3514419100,3343816795,1672636271,1672637923,1652
3899,3780209375,3511317276,1672683999,1672684483,484
3452,3398198430,3533188828,1672677405,1672680851,3446
3627,3774705415,3500317969,1672674706,1672675836,1130
3708,3686227677,3732584121,1672657112,1672659981,2869
3746,3897376951,3904412440,1672533042,1672533825,783
3710,3285204083,3274831810,1672680035,1672680875,840
3887,3608922867,3604867757,1672620096,1672622420,2324
3589,3793935736,3669146016,1672594433,1672596671,2238
3590,3337362061,3514275974,1672647332,1672650796,3464
3861,3512337405,3703433819,1672660875,1672661878,1003
3724,3631479562,3330340793,1672703020,1672704425,1405
3435,3379143440,3682133690,1672655165,1672655948,783
3762,3757630221,3898314440,1672669101,1672671204,2103
3573,3793175445,3511005395,1672636728,1672640147,3419
3817,3855583256,3791796585,1672598355,1672601365,3010
3435,3517600136,3239617320,1672695896,1672697447,1551
3684,3885537225,3736231757,1672650941,1672652507,1566
3507,3520355798,3760645796,1672555122,1672557649,2527
3685,3500857494,3505198734,1672689330,1672691447,2117
3745,3364726656,3557046880,1672603590,1672605646,2056
3915,3605221116,3932478321,1672546239,1672547628,1389
3889,3497095254,3755992176,1672549614,1672550240,626
3675,3621683102,3411688875,1672651072,1672651599,527
3739,3271454397,3428027649,1672625344,1672627787,2443
3559,3200543880,3774907131,1672670563,1672672809,2246
3792,3367111751,3618489670,1672659993,1672661489,1496
3782,3711006062,3334993594,1672613395,1672616155,2760
3667,3401793306,3500525825,1672536872,1672539768,2896
3529,3906536154,3481640525,1672620282,1672622944,2662
3676,3515525630,3979802715,1672597015,1672597524,509
3716,3511883730,3780209375,1672685012,1672687475,2463
3807,3283492940,3885155975,1672670585,1672671774,1189
3816,3551389192,3517172354,1672687221,1672690650,3429
3509,3511442562,3778899160,1672545152,1672548430,3278
3858,3777694660,3703139663,1672593093,1672596346,3253
3435,3935913584,3777184389,1672607200,1672608164,964
3503,3511288998,3825881598,1672685106,1672685896,790
3616,3270056120,3898314440,1672623818,1672625241,1423
3765,3226511603,3701136026,1672658424,1672659769,1345
3884,3853629553,3608855425,1672546436,1672548728,2292
3428,3880926355,3379143440,1672640924,1672643443,2519
3532,3760364383,3271752081,1672630847,1672630927,80
3436,3500777439,3225636215,1672640027,1672641548,1521
3841,3505179890,3205923620,1672623691,1672624576,885
3671,3202141727,3757318448,1672605851,1672606687,836
3631,3780115155,3757863420,1672618167,1672618273,106
3582,3404025196,3276269264,1672645984,1672646465,481
3428,3667427125,3818575661,1672614928,1672615752,824
3894,3821054646,3414275042,1672538237,1672540288,2051
3512,3510837901,3511288998,1672671255,1672672044,789
3893,3760263530,3514419100,1672639413,1672640688,1275
3542,3451326054,3514818819,1672573455,1672576970,3515
3866,3351866415,3513545422,1672584313,1672584398,85
3564,3510767239,3334951866,1672599637,1672600275,638
3740,3800257590,3803389195,1672647194,1672649112,1918
3891,3488763230,3440137407,1672633185,1672636427,3242
3683,3520639768,3777147510,1672595671,1672597203,1532
3650,3409114719,3511005395,1672697694,1672701200,3506
3887,3683113954,3777330107,1672619533,1672621847,2314
3544,3773121782,3776518452,1672580011,1672580593,582
3832,3492546679,3760094385,1672584444,1672587992,3548
3672,3632814465,3615113018,1672700639,1672703411,2772
3715,3334974375,3389634034,1672647230,1672650155,2925
3774,3399472693,3661583097,1672590007,1672591821,1814
3652,3688796737,3510837901,1672547730,1672550484,2754
3689,3459681410,3760721303,1672612430,1672615512,3082
3769,3296462324,3472312341,1672589725,1672590821,1096
3600,3500703304,3383138270,1672586466,1672589149,2683
3601,3280054198,3803389195,1672544631,1672547392,2761
3473,3438489358,3755992176,1672595270,1672597652,2382
3705,3793969543,3421385957,1672700756,1672703932,3176
3638,3636329663,3701823816,1672649106,1672650518,1412
3644,3780427126,3209526819,1672642790,1672644279,1489
3520,3505228454,3428725843,1672636917,1672640198,3281
3758,3394401087,3509756823,1672573274,1672575952,2678
3753,3230135532,3777184389,1672687419,1672688856,1437
3455,3500613493,3737147209,1672698777,1672700488,1711
3456,3248058676,3831586487,1672620093,1672621503,1410
3882,3511024016,3680843171,1672545692,1672548338,2646
3649,3279242917,3515402792,1672681354,1672684272,2918
3915,3517881647,3289817992,1672652834,1672656335,3501
3517,3224968597,3516298579,1672688602,1672689733,1131
3436,3755573472,3283144118,1672674522,1672675006,484
3660,3824215187,3733363628,1672599958,1672600437,479
3486,3932478321,3739895284,1672639970,1672641917,1947
3796,3755915206,3905899155,1672644352,1672646208,1856
3613,3402697190,3711000597,1672582208,1672584705,2497
3625,3604589802,3505179890,1672543276,1672544350,1074
3830,3515890966,3776518452,1672551473,1672552462,989
3520,3367111751,3970909253,1672542082,1672543018,936
3532,3490214516,3520991398,1672671584,1672674813,3229
3665,3559458968,3375449013,1672590511,1672593425,2914
3518,3755344363,3622665543,1672565988,1672569271,3283
3450,3500827202,3274831810,1672575439,1672578961,3522
3815,3392520516,3661447322,1672591243,1672591830,587
3445,3517991730,3701424609,1672531436,1672534746,3310
3486,3902861231,3614740489,1672611624,1672614906,3282
3638,3701882224,3516703758,1672656095,1672658942,2847
3497,3661447322,3701005527,1672603283,1672606091,2808
3670,3811040565,3431502855,1672697318,1672700512,3194
3615,3773913680,3520560590,1672587847,1672589253,1406
3843,3716679950,3514971533,1672700914,1672702780,1866
3483,3534175249,3276269264,1672590759,1672591187,428
3762,3274906650,3776988674,1672562651,1672562855,204
3721,3780472203,3452016771,1672666773,1672668749,1976
3518,3817428320,3291933594,1672626602,1672629101,2499
3451,3701136026,3533929349,1672659178,1672660711,1533
3624,3514703118,3618489670,1672544642,1672546785,2143
3451,3519446663,3801645328,1672664911,1672666016,1105
3688,3294747828,3756625818,1672549955,1672552234,2279
3655,3716272919,3774290799,1672552642,1672553707,1065
3543,3858172636,3783340788,1672625642,1672625872,230
3618,3513327337,3970198861,1672621277,1672622022,745
3619,3780769110,3517358573,1672568906,1672569535,629
3760,3551389192,3884596900,1672544924,1672548171,3247
3637,3779425804,3520578796,1672663378,1672665284,1906
3794,3440137407,3793922324,1672573212,1672575950,2738
3810,3618176292,3777814504,1672643530,1672645996,2466
3763,3615087943,3688220326,1672546772,1672549737,2965
3454,3202804048,3440137407,1672657365,1672658469,1104
3769,3311420950,3517737088,1672604267,1672606887,2620
3525,3701373490,3283144118,1672545652,1672548712,3060
3537,3791753345,3448633776,1672671935,1672673462,1527
3898,3505179890,3757700712,1672568309,1672570254,1945
3845,3505995057,3783520186,1672578881,1672581799,2918
3907,3533747868,3520115090,1672568885,1672570378,1493
3685,3774876004,3777091903,1672555268,1672557683,2415
3861,3435116799,3668747074,1672695092,1672695217,125
3708,3510641433,3511317276,1672548879,1672551279,2400
3847,3757193551,3608922867,1672651678,1672654909,3231
3852,3802932312,3668533536,1672680552,1672682968,2416
3601,3533188828,3791796585,1672538446,1672541034,2588
3921,3714120857,3487875183,1672548132,1672549305,1173
3653,3225631197,3760263530,1672596855,1672599782,2927
3921,3510028805,3511791953,1672605353,1672606883,1530
3867,3386758279,3777779869,1672663765,1672665873,2108
3560,3517697722,3510964997,1672653635,1672657115,3480
3521,3755737419,3701247948,1672573737,1672576796,3059
3832,3468041839,3416987084,1672635602,1672637937,2335
3751,3428725843,3793969543,1672604341,1672607602,3261
3443,3279473441,3300818269,1672568382,1672570397,2015
3625,3793407963,3280054198,1672653909,1672654126,217
3495,3931627862,3408498208,1672691556,1672694646,3090
3644,3714120857,3316800320,1672612024,1672615157,3133
3562,3461119815,3228888030,1672617272,1672619532,2260
3888,3618354185,3431502855,1672551632,1672554321,2689
3539,3557046880,3200308999,1672663481,1672665697,2216
3764,3756385685,3701823816,1672591750,1672594759,3009
3860,3315279093,3667673649,1672547949,1672548805,856
3669,3519077659,3715400486,1672632620,1672633692,1072
3481,3505434346,3414940786,1672577407,1672580235,2828
3592,3501567772,3500347447,1672671966,1672674674,2708
3905,3510187271,3208452238,1672583204,1672585077,1873
3815,3668533536,3630353876,1672548219,1672549593,1374
3692,3519818818,3778640261,1672593330,1672595195,1865
3780,3713979100,3774718695,1672697807,1672699323,1516
3722,3226178937,3449333754,1672542493,1672545558,3065
3456,3510641433,3834960360,1672570189,1672573189,3000
3626,3203538212,3357289672,1672699963,1672701686,1723
3810,3703348097,3783340788,1672607726,1672609555,1829
3472,3493017654,3971806004,1672682861,1672686357,3496
3534,3791796585,3621461051,1672647131,1672648469,1338
3692,3902760230,3497808662,1672578874,1672581889,3015
3682,3311049964,3715707380,1672535645,1672538067,2422
3574,3701373490,3404025196,1672661264,1672662980,1716
3457,3232208416,3711919537,1672675316,1672675443,127
3519,3660887799,3757323954,1672644548,1672647648,3100
3781,3793922324,3500604680,1672634433,1672635830,1397
3808,3501567772,3500613493,1672550794,1672553819,3025
3669,3428027649,3713589994,1672650209,1672653533,3324
3823,3735374579,3414275042,1672592478,1672593147,669
3526,3776559988,3517887477,1672662779,1672665619,2840
3677,3701884158,3780209375,1672640632,1672642888,2256
3680,3902861231,3520578796,1672615208,1672617652,2444
3526,3559458968,3793743698,1672689013,1672690583,1570
3680,3231494505,3514285803,1672568865,1672569267,402
3906,3774605761,3510798825,1672648762,1672650201,1439
3627,3501215099,3760694096,1672695760,1672697170,1410
3805,3757863420,3779738691,1672532075,1672535665,3590
3922,3777189898,3511601997,1672690787,1672691479,692
3426,3412006598,3512379024,1672532485,1672532693,208
3838,3714067076,3511288998,1672647571,1672650291,2720
3644,3904867554,3916490839,1672566737,1672567011,274
3910,3852533643,3435167810,1672585844,1672586720,876
3690,3774907131,3711853996,1672534125,1672535815,1690
3681,3347419520,3510554314,1672620241,1672623091,2850
3585,3756127300,3520657891,1672692079,1672694152,2073
3692,3500915908,3510187271,1672617293,1672620052,2759
3848,3357864626,3920497528,1672650095,1672651644,1549
3854,3803389195,3316800320,1672687177,1672688993,1816
3709,3468041839,3470454332,1672661396,1672662833,1437
3429,3777184389,3534175249,1672586856,1672589598,2742
3851,3780769110,3505634634,1672646518,1672649724,3206
3525,3853629553,3774178201,1672595581,1672598523,2942
3857,3739911441,3791441520,1672556197,1672556685,488
3776,3200308999,3500604680,1672548764,1672548997,233
3719,3971806004,3885121158,1672532771,1672533527,756
3884,3783801141,3772236797,1672595857,1672599158,3301
3440,3208957949,3757383891,1672576105,1672577756,1651
3488,3620292035,3760364383,1672606824,1672607746,922
3606,3703139663,3480726047,1672615676,1672617046,1370
3599,3515559913,3283770991,1672578134,1672581117,2983
3702,3492546679,3778640261,1672640749,1672642526,1777
3822,3711000597,3667673649,1672594369,1672595267,898
3684,3330340793,3819767045,1672609999,1672613292,3293
3786,3774733620,3914691363,1672687524,1672690057,2533
3879,3511732493,3505847380,1672616978,1672618035,1057
3778,3402385957,3970909253,1672648328,1672649599,1271
3535,3880926355,3772391882,1672545133,1672545672,539
3476,3516513251,3715385401,1672666566,1672667641,1075
3482,3631090677,3617489344,1672598828,1672599308,480
3817,3902760230,3347419520,1672604218,1672607289,3071
3522,3774907131,3512295534,1672609356,1672609841,485
3514,3343816795,3713911104,1672585517,1672585883,366
3789,3897134762,3416987084,1672594077,1672594873,796
3455,3701107228,3514246749,1672676955,1672677758,803
3813,3885157459,3230868435,1672660869,1672662402,1533
3553,3511288998,3505725706,1672626122,1672626720,598
3505,3834963772,3773837847,1672634506,1672635763,1257
3511,3607882826,3447672935,1672572078,1672573178,1100
3893,3338390596,3372223551,1672653751,1672656818,3067
3512,3519077659,3351866415,1672597164,1672600141,2977
3480,3505434346,3760651515,1672692033,1672692333,300
3432,3519416013,3408430195,1672660007,1672661068,1061
3921,3500347447,3514334067,1672595478,1672595752,274
3867,3710315160,3661583097,1672645264,1672648758,3494
3862,3793935736,3519818818,1672533165,1672534015,850
3893,3421385957,3780338697,1672640471,1672640837,366
3507,3280268483,3505663516,1672625188,1672625791,603
3501,3626499450,3385323994,1672674503,1672675015,512
3903,3369708250,3904867554,1672547599,1672550522,2923
3726,3887243870,3517590837,1672542496,1672545659,3163
3560,3367111751,3520991398,1672563962,1672567269,3307
3759,3613338363,3715854030,1672613405,1672616449,3044
3873,3920898925,3505634634,1672550131,1672551922,1791
3429,3739661856,3439673892,1672652701,1672655221,2520
3616,3613206049,3760651515,1672601134,1672603487,2353
3724,3783550022,3757332128,1672588190,1672590130,1940
3760,3783801141,3665998641,1672625684,1672628346,2662
3452,3701107228,3714233826,1672674574,1672677536,2962
3484,3410160376,3481640525,1672684119,1672685530,1411
3638,3511791953,3510642075,1672546645,1672548865,2220
3441,3615113018,3429943738,1672608676,1672610152,1476
3614,3977352557,3534566651,1672615761,1672618151,2390
3912,3760645796,3519087371,1672660474,1672661476,1002
3840,3349739136,3811075491,1672585533,1672585875,342
3809,3774907131,3455018347,1672702606,1672704604,1998
3473,3449333754,3757348722,1672650050,1672652497,2447
3505,3440107959,3298151889,1672612926,1672615871,2945
3681,3793175445,3505923418,1672694142,1672697017,2875
3780,3814305099,3559458968,1672677563,1672679234,1671
3701,3889780657,3514246749,1672673354,1672676132,2778
3905,3912891315,3520873221,1672703187,1672705118,1931
3708,3556969573,3701373490,1672545302,1672546246,944
3719,3559458968,3817428320,1672631225,1672633805,2580
3668,3511883730,3773902805,1672551749,1672554711,2962
3838,3514741348,3632814465,1672690260,1672691490,1230
3551,3774243020,3456430614,1672678889,1672682121,3232
3509,3834963772,3205923620,1672654912,1672655515,603
3730,3791046864,3756385685,1672664396,1672666017,1621
3431,3479851674,3773009828,1672608270,1672609064,794
3459,3906536154,3338390596,1672670256,1672673835,3579
3500,3792538417,3551389192,1672616227,1672618140,1913
3849,3701884158,3755496114,1672533869,1672535640,1771
3805,3270697740,3480490124,1672619058,1672620432,1374
3736,3904569677,3756746867,1672690872,1672693996,3124
3836,3334647380,3270697740,1672675047,1672677918,2871
3888,3224968597,3632814465,1672541471,1672544707,3236
3431,3341893384,3793740407,1672591135,1672593585,2450
3856,3814677862,3618697021,1672647390,1672650172,2782
3577,3772236797,3519818818,1672595281,1672596416,1135
3607,3505198734,3421385957,1672682159,1672685071,2912
3636,3689114185,3516513251,1672577293,1672580440,3147
3887,3710735406,3533274994,1672540427,1672542525,2098
3577,3559731671,3490214516,1672678602,1672680464,1862
3444,3609933747,3661903000,1672668559,1672671489,2930
3588,3435116799,3756625818,1672560238,1672563270,3032
3552,3607768197,3463849738,1672590174,1672592468,2294
3671,3770676872,3760094385,1672604456,1672605539,1083
3689,3414940786,3557046880,1672593793,1672594561,768
3790,3288762795,3755344363,1672670883,1672673704,2821
3551,3334993594,3272716462,1672597866,1672599848,1982
3662,3930242012,3711637255,1672695070,1672698052,2982
3429,3774876004,3757383891,1672556359,1672557739,1380
3695,3684523966,3276217799,1672653982,1672656212,2230
3874,3226178937,3497671225,1672696311,1672697158,847
3915,3617489344,3513018485,1672672918,1672675684,2766
3530,3777189898,3500341755,1672609408,1672609932,524
3475,3760640999,3756704774,1672568918,1672571458,2540
3909,3802932312,3398731252,1672572139,1672572200,61
3727,3505634634,3779892400,1672647751,1672650014,2263
3476,3288224595,3776518452,1672634330,1672635636,1306
3903,3438078818,3500109249,1672540913,1672544226,3313
3896,3533294425,3488686442,1672652327,1672652777,450
3896,3511601997,3534357694,1672656630,1672659861,3231
3624,3714666884,3501215099,1672686374,1672689604,3230
3909,3428725843,3501215099,1672570034,1672572259,2225
3741,3774641380,3515401243,1672685695,1672686366,671
3487,3418448389,3779854934,1672666494,1672666639,145
3777,3518561777,3386758279,1672576316,1672578482,2166
3468,3637313265,3713517039,1672697903,1672698082,179
3540,3710854064,3300229945,1672558636,1672561103,2467
3886,3516444201,3450969839,1672697430,1672700989,3559
3830,3780322355,3289114629,1672552858,1672556359,3501
3730,3517222913,3511005395,1672559634,1672560920,1286
3457,3435116799,3511843593,1672597163,1672597926,763
3673,3517172354,3755737419,1672621965,1672622178,213
3766,3410160376,3336627643,1672669420,1672672271,2851
3441,3780253901,3812369928,1672609301,1672611879,2578
3542,3710489491,3770296583,1672676058,1672679238,3180
3837,3779854934,3551389192,1672628722,1672630449,1727
3671,3895285664,3803517637,1672645788,1672646161,373
3878,3774876004,3774290799,1672562984,1672565530,2546
3748,3500857494,3319167958,1672602936,1672603226,290
3858,3885157459,3777694660,1672685838,1672688648,2810
3748,3512499658,3509756823,1672572172,1672574963,2791
3531,3970603231,3660063072,1672611034,1672611680,646
3443,3201629017,3512383699,1672554648,1672557460,2812
3685,3928719932,3714666884,1672678160,1672679689,1529
3603,3510641433,3515890966,1672574399,1672576342,1943
3891,3792389522,3303410628,1672607702,1672608930,1228
3578,3520181148,3533090502,1672533607,1672535062,1455
3513,3736231757,3626499450,1672647905,1672650861,2956
3667,3783147088,3500857494,1672542780,1672545452,2672
3824,3836241528,3739661856,1672585613,1672588041,2428
3687,3778134418,3683113954,1672629357,1672629902,545
3748,3780253901,3512946768,1672683645,1672687216,3571
3728,3417191856,3667673649,1672583214,1672583404,190
3849,3710562338,3604867757,1672554246,1672554523,277
3866,3777184389,3898314440,1672571882,1672573294,1412
3840,3773735484,3408498208,1672680619,1672684096,3477
3625,3792489602,3409114719,1672689088,1672692540,3452
3574,3394297564,3733363628,1672597608,1672600541,2933
3793,3446533960,3923420131,1672641759,1672645288,3529
3506,3515402792,3225029895,1672566420,1672567130,710
3768,3935913584,3701823816,1672674199,1672675852,1653
3670,3412968120,3380982774,1672637166,1672640228,3062
3745,3711812325,3893912331,1672554482,1672557991,3509
3887,3792538417,3500613493,1672602398,1672604218,1820
3888,3772078494,3783433404,1672539137,1672540569,1432
3677,3516298579,3668747074,1672547831,1672550005,2174
3573,3617489344,3898314440,1672641620,1672644181,2561
3577,3533079336,3500044458,1672619782,1672621723,1941
3899,3780769110,3716963089,1672592690,1672594725,2035
3608,3276003502,3979784676,1672637761,1672640357,2596
3739,3513018485,3383138270,1672536742,1672538245,1503
3640,3206837348,3972192593,1672637145,1672638706,1561
3501,3446533960,3793743698,1672583340,1672584397,1057
3815,3226511603,3609659642,1672627358,1672629582,2224
3743,3519818818,3309314379,1672605812,1672606473,661
3787,3631479562,3760924079,1672605470,1672607990,2520
3614,3716679950,3505198734,1672669425,1672670375,950
3700,3625174002,3773902805,1672643267,1672645034,1767
3649,3272716462,3713911104,1672556146,1672557188,1042
3570,3366423342,3338390596,1672543572,1672546941,3369
3720,3711218296,3519142371,1672578770,1672580593,1823
3610,3780872464,3615115210,1672543074,1672545728,2654
3441,3296462324,3491469603,1672624738,1672628251,3513
3906,3495911207,3774907131,1672572063,1672573315,1252
3688,3972083617,3773735484,1672636529,1672637590,1061
3424,3505228454,3914691363,1672538341,1672538617,276
3663,3731646673,3440137407,1672655323,1672655518,195
3698,3469254160,3773837847,1672581530,1672584445,2915
3904,3604589802,3710008361,1672539822,1672541559,1737
3674,3776831527,3610870949,1672685828,1672686287,459
3783,3792389522,3792801638,1672606084,1672609226,3142
3675,3283144118,3534566651,1672613006,1672616227,3221
3443,3229974066,3792274796,1672562435,1672563798,1363
3834,3274906650,3517222913,1672659356,1672662108,2752
3448,3615688740,3977148669,1672625998,1672627266,1268
3840,3446533960,3792014516,1672678590,1672681725,3135
3767,3428725843,3500915908,1672655888,1672657959,2071
3426,3515890966,3783520186,1672622479,1672625638,3159
3517,3713829743,3618176292,1672588434,1672589444,1010
3497,3607768197,3230135532,1672593906,1672597062,3156
3622,3441703884,3617116290,1672634935,1672637088,2153
3715,3701136026,3462273042,1672644298,1672646772,2474
3731,3715086894,3380982774,1672549239,1672549625,386
3839,3366423342,3608922867,1672602912,1672604036,1124
3670,3777485931,3500672156,1672656921,1672659049,2128
3433,3500302272,3935913584,1672598697,1672599397,700
3882,3440137407,3630353876,1672605830,1672607749,1919
3609,3336339664,3755404116,1672551992,1672554383,2391
3523,3773009828,3710489491,1672578064,1672581124,3060
3493,3613338363,3514275974,1672669905,1672672857,2952
3608,3733363628,3734915241,1672560796,1672562167,1371
3684,3776831527,3897376951,1672677294,1672678619,1325
3832,3608922867,3773121782,1672588269,1672591511,3242
3556,3935399379,3737972328,1672598172,1672599665,1493
3787,3519909393,3792489602,1672560417,1672561499,1082
3517,3501121099,3970558632,1672593717,1672594787,1070
3750,3510554314,3935913584,1672611354,1672612676,1322
3538,3701005527,3618489670,1672556747,1672559952,3205
3679,3505178849,3480991549,1672645334,1672648356,3022
3822,3334993594,3739895284,1672680236,1672682251,2015
3632,3792014516,3793175445,1672662536,1672663306,770
3502,3855583256,3711077927,1672697247,1672699609,2362
3846,3793315718,3505888598,1672588841,1672590233,1392
3508,3780872464,3517887477,1672601915,1672604490,2575
3791,3664943873,3793740407,1672667956,1672671075,3119
3631,3755344363,3468041839,1672550840,1672554222,3382
3703,3834631333,3505847380,1672658953,1672659380,427
3576,3906536154,3812534508,1672667359,1672667997,638
3530,3783928182,3517881647,1672568786,1672568893,107
3510,3288224595,3774876004,1672641813,1672645041,3228
3541,3424660806,3780322355,1672559344,1672559496,152
3607,3280268483,3513018485,1672703088,1672703793,705
3796,3429943738,3516444201,1672566726,1672570107,3381
3428,3792274796,3490214516,1672635211,1672636092,881
3778,3661903000,3732131656,1672575679,1672578457,2778
3705,3499217428,3491684096,1672552336,1672553462,1126
3509,3757323954,3510499038,1672534882,1672537691,2809
3575,3732584121,3793922324,1672575012,1672577788,2776
3763,3487875183,3617116290,1672633283,1672635023,1740
3775,3514419100,3500949309,1672620834,1672622703,1869
3848,3384583385,3501281016,1672645848,1672647771,1923
3501,3441348818,3288762795,1672606469,1672608039,1570
3501,3803517637,3793922324,1672673116,1672675108,1992
3458,3424445495,3713768950,1672532172,1672535684,3512
3567,3459681410,3534764451,1672622517,1672623112,595
3762,3492546679,3756385685,1672700067,1672700647,580
3785,3500442734,3760640999,1672686297,1672686624,327
3694,3513360004,3807212280,1672615493,1672616478,985
3755,3793883863,3315279093,1672680438,1672682315,1877
3657,3774705415,3501525100,1672596953,1672600193,3240
3871,3472312341,3839245934,1672609637,1672609725,88
3489,3906536154,3472068734,1672642373,1672645409,3036
3788,3714678331,3517887477,1672536872,1672539945,3073
3741,3780209375,3815250107,1672576221,1672578955,2734
3801,3236458894,3231494505,1672542125,1672545101,2976
3882,3513345163,3463740710,1672691268,1672693376,2108
3901,3774733620,3731646673,1672589128,1672591325,2197
3548,3791753345,3411688875,1672679567,1672680486,919
3895,3299125059,3793781065,1672595070,1672598263,3193
3724,3792072681,3272030610,1672685720,1672687001,1281
3693,3713768950,3500915908,1672566964,1672567886,922
3644,3688490530,3893912331,1672572254,1672574989,2735
3680,3756746867,3451326054,1672603469,1672606294,2825
3489,3811040565,3512295534,1672558968,1672562056,3088
3702,3488763230,3930242012,1672629189,1672630424,1235
3850,3357689359,3501215099,1672593066,1672595099,2033
3632,3715854030,3783373154,1672644633,1672647619,2986
3895,3760924079,3501121099,1672640741,1672642516,1775
3739,3357689359,3773902805,1672640551,1672643822,3271
3597,3615737355,3343816795,1672664338,1672666275,1937
3890,3271752081,3714067076,1672536991,1672537941,950
3603,3783801141,3935487534,1672537090,1672539776,2686
3823,3364378127,3283144118,1672696053,1672698364,2311
3563,3737972328,3410160376,1672537685,1672537910,225
3698,3469254160,3778597171,1672591100,1672593169,2069
3693,3436257398,3812369928,1672552084,1672553227,1143
3713,3350095157,3755992176,1672686042,1672688109,2067
3445,3858172636,3778640261,1672621488,1672622642,1154
3671,3757700712,3733558985,1672544307,1672545708,1401
3712,3893912331,3793407963,1672696175,1672698402,2227
3757,3701664364,3715619259,1672642739,1672645469,2730
3714,3236499444,3333403880,1672658187,1672659741,1554
3886,3448875382,3613338363,1672641400,1672644452,3052
3601,3520991398,3490214516,1672626994,1672629885,2891
3783,3490029863,3513296868,1672644287,1672645241,954
3918,3519416013,3304971369,1672531854,1672534512,2658
3824,3334993594,3533004959,1672547037,1672547913,876
3710,3779639983,3605221116,1672598679,1672602124,3445
3848,3390660440,3519446663,1672612878,1672614580,1702
3504,3617116290,3225029895,1672549238,1672550180,942
3871,3283770991,3979784676,1672550768,1672551286,518
3609,3783615982,3384583385,1672653440,1672654042,602
3604,3778667336,3977352557,1672558111,1672558573,462
3574,3505437712,3451726367,1672691903,1672693653,1750
3724,3411688875,3519416013,1672619472,1672620745,1273
3696,3248058676,3792525861,1672566312,1672567034,722
3521,3446533960,3505179890,1672544804,1672547704,2900
3687,3270056120,3780680950,1672537800,1672539046,1246
3587,3773572967,3839245934,1672563489,1672565352,1863
3703,3308760650,3614740489,1672679552,1672682996,3444
3453,3714120857,3412968120,1672574219,1672575347,1128
3757,3510818674,3512800570,1672577749,1672579593,1844
3481,3780209375,3760721303,1672678901,1672680388,1487
3463,3441703884,3923754072,1672606284,1672606977,693
3611,3448875382,3812534508,1672651425,1672654310,2885
3459,3500613493,3551389192,1672533195,1672534197,1002
3884,3884596900,3414940786,1672662915,1672665959,3044
3445,3716272919,3715127070,1672646333,1672647715,1382
3801,3533929349,3714128600,1672679964,1672682841,2877
3559,3972083617,3437286517,1672669904,1672673054,3150
3588,3607882826,3635169815,1672623352,1672624046,694
3584,3367509761,3611055563,1672661784,1672663762,1978
3890,3909094917,3500703304,1672570495,1672572719,2224
3572,3517687662,3245232284,1672615593,1672618153,2560
3648,3518653080,3686227677,1672574424,1672575294,870
3896,3299125059,3621184108,1672678320,1672681749,3429
3642,3716963089,3639050419,1672617661,1672618951,1290
3742,3927599181,3349739136,1672702752,1672706041,3289
3913,3347446226,3533747868,1672664319,1672665691,1372
3721,3334647380,3780834916,1672607106,1672608509,1403
3885,3510641433,3310039260,1672687648,1672688452,804
3535,3491469603,3509366311,1672546007,1672549323,3316
3560,3853629553,3516741440,1672665587,1672668353,2766
3881,3370227921,3631090677,1672638652,1672641039,2387
3853,3510499038,3661583097,1672656229,1672656945,716
3480,3776831527,3349739136,1672673604,1672673868,264
3886,3509764635,3931627862,1672658990,1672660270,1280
3910,3635169815,3660887799,1672639872,1672640712,840
3673,3209526819,3411688875,1672564950,1672566088,1138
3861,3609659642,3500341755,1672636863,1672637478,615
3458,3618176292,3428027649,1672611293,1672612077,784
3669,3232208416,3271454397,1672647478,1672649775,2297
3917,3271454397,3938389661,1672589956,1672590156,200
3753,3272096759,3516321888,1672665407,1672667871,2464
3883,3511883730,3714678331,1672552497,1672555905,3408
3519,3512383699,3315703693,1672649077,1672651919,2842
3520,3333918941,3715854030,1672574325,1672577291,2966
3760,3431460073,3505481368,1672596202,1672596579,377
3697,3737147209,3520355798,1672605836,1672607419,1583
3714,3416987084,3512295534,1672682366,1672683970,1604
3886,3299443125,3756625818,1672614633,1672616795,2162
3885,3920898925,3779301501,1672689835,1672691429,1594
3891,3732584121,3858172636,1672545226,1672546938,1712
3904,3510767239,3357289672,1672561752,1672562295,543
3447,3343132529,3755737419,1672695670,1672697582,1912
3762,3533004959,3512946768,1672579255,1672582440,3185
3530,3783520186,3509764635,1672575376,1672578645,3269
3424,3516741440,3438078818,1672611720,1672613118,1398
3436,3395201292,3637313265,1672638766,1672640405,1639
3428,3205985903,3357289672,1672681687,1672683873,2186
3444,3514285803,3513360004,1672669045,1672669956,911
3430,3608232640,3512383699,1672599853,1672599958,105
3828,3819767045,3338390596,1672703233,1672704351,1118
3507,3688220326,3734915241,1672688158,1672690278,2120
3447,3885155975,3620292035,1672574612,1672575252,640
3678,3791246640,3533294425,1672600965,1672601552,587
3466,3757294769,3411688875,1672699921,1672702474,2553
3626,3396980894,3613899351,1672544506,1672546799,2293
3897,3376467719,3774790271,1672557755,1672557849,94
3452,3371455553,3226511603,1672585091,1672586691,1600
3688,3276269264,3354144091,1672543480,1672543960,480
3476,3512282789,3202141727,1672561666,1672564152,2486
3815,3977148669,3360813161,1672549874,1672551837,1963
3796,3756789525,3890739241,1672568267,1672571760,3493
3455,3500442734,3604589802,1672552190,1672555401,3211
3605,3793175445,3905899155,1672669330,1672671945,2615
3696,3373089838,3289817992,1672680110,1672680859,749
3721,3402385957,3511601997,1672591928,1672593087,1159
3619,3710496785,3533747868,1672671888,1672674505,2617
3532,3513410578,3661583097,1672598591,1672599110,519
3623,3715974659,3757383891,1672625296,1672627413,2117
3433,3398198430,3783147088,1672548802,1672550551,1749
3627,3202804048,3209481722,1672531910,1672532166,256
3791,3418448389,3791693821,1672586701,1672588123,1422
3486,3487875183,3509366311,1672640784,1672643359,2575
3718,3613899351,3703396825,1672603869,1672606834,2965
3623,3510798825,3624297844,1672579200,1672580328,1128
3573,3897376951,3236499444,1672591650,1672594875,3225
3460,3972083617,3373089838,1672537559,1672539500,1941
3842,3409114719,3783147088,1672544402,1672545380,978
3658,3393063657,3363162590,1672581556,1672582531,975
3626,3520322124,3403370192,1672534021,1672536811,2790
3815,3462158237,3905196766,1672538808,1672541990,3182
3708,3510499038,3928719932,1672616132,1672618324,2192
3467,3500709774,3926643445,1672585352,1672585537,185
3701,3349856820,3384068080,1672571984,1672574462,2478
3720,3554825448,3367111751,1672685904,1672687608,1704
3771,3499217428,3428027649,1672600460,1672603892,3432
3478,3923420131,3812369928,1672672676,1672675995,3319
3795,3517687662,3459681410,1672668876,1672669296,420
3742,3688796737,3501457103,1672641140,1672643027,1887
3614,3368283077,3386758279,1672545816,1672548270,2454
3779,3739154408,3920625129,1672681655,1672683585,1930
3599,3513065217,3774876004,1672639187,1672639615,428
3811,3280054198,3733558985,1672608285,1672609510,1225
3823,3505266860,3777189898,1672537704,1672538654,950
3870,3780872464,3622665543,1672627227,1672629294,2067
3659,3972083617,3512502036,1672634852,1672637485,2633
3681,3467779445,3680810086,1672626068,1672628814,2746
3677,3760645796,3755222916,1672596734,1672597511,777
3858,3510499038,3364378127,1672534203,1672536445,2242
3672,3357289672,3333403880,1672687468,1672689920,2452
3914,3831586487,3774031303,1672613834,1672613957,123
3530,3756625818,3515890966,1672598108,1672600453,2345
3663,3520764926,3858172636,1672587356,1672587613,257
3683,3760842815,3500302272,1672621235,1672623289,2054
3516,3755756564,3437286517,1672565711,1672568379,2668
3517,3514419100,3533649454,1672701134,1672703282,2148
3589,3977148669,3501525100,1672659272,1672662651,3379
3863,3343132529,3773913680,1672576483,1672578970,2487
3541,3534764451,3776559988,1672680977,1672681398,421
3793,3792546035,3977148669,1672644622,1672644721,99
3804,3926643445,3715443333,1672546625,1672547344,719
3879,3505995057,3777147510,1672677999,1672678620,621
3890,3382733096,3897456874,1672653139,1672656615,3476
3579,3511005395,3792949946,1672613389,1672614404,1015
3484,3429943738,3246370118,1672622472,1672622795,323
3758,3500613459,3608232640,1672625183,1672626765,1582
3564,3755992176,3833217041,1672660510,1672664024,3514
3841,3783433404,3428027649,1672570173,1672571220,1047
3719,3972192593,3793740407,1672549073,1672549593,520
3532,3737972328,3609659642,1672656651,1672658262,1611
3520,3279473441,3488686442,1672693982,1672695780,1798
3548,3609881958,3779425804,1672684792,1672686647,1855
3848,3380982774,3912891315,1672572955,1672575971,3016
3618,3374183227,3716963089,1672699098,1672699484,386
3580,3774155692,3448633776,1672623070,1672625675,2605
3715,3511843593,3682133690,1672688452,1672691839,3387
3483,3311049964,3401793306,1672579446,1672579607,161
3605,3770704999,3416987084,1672635910,1672636223,313
3749,3435116799,3512379024,1672601179,1672603525,2346
3668,3300818269,3315279093,1672540707,1672541307,600
3770,3627368399,3897456874,1672602276,1672605619,3343
3818,3770520359,3710562338,1672640643,1672641851,1208
3723,3792442597,3774155692,1672681601,1672682459,858
3727,3774705415,3202804048,1672589628,1672592856,3228
3580,3716963089,3776084820,1672611280,1672614414,3134
3880,3296462324,3472068734,1672571199,1672573774,2575
3701,3780909839,3783373154,1672686025,1672688395,2370
3912,3703383853,3711006062,1672602507,1672604833,2326
3866,3778667336,3330340793,1672563191,1672563622,431
3661,3399518841,3774705415,1672603960,1672605460,1500
3468,3516444201,3470454332,1672669579,1672672828,3249
3816,3514956366,3701005527,1672575949,1672577654,1705
3459,3431460073,3778667336,1672673316,1672673761,445
3582,3713829743,3756625818,1672683487,1672684722,1235
3542,3505266860,3487875183,1672631681,1672632035,354
3439,3778926763,3363162590,1672580986,1672583763,2777
3669,3455018347,3516513251,1672675365,1672677988,2623
3771,3517590837,3311049964,1672680266,1672682144,1878
3901,3757193307,3500915665,1672567859,1672570111,2252
3801,3637313265,3777147510,1672569761,1672570874,1113
3737,3935399379,3791613604,1672611111,1672611806,695
3516,3556969573,3505521218,1672628607,1672631051,2444
3715,3511317276,3227799827,1672572563,1672575032,2469
3800,3715707380,3500208903,1672682231,1672683794,1563
3566,3319167958,3520416075,1672549648,1672551693,2045
3646,3392520516,3201800997,1672585091,1672586045,954
3734,3515559913,3755573472,1672670272,1672673660,3388
3774,3855583256,3793583656,1672567039,1672568533,1494
3650,3716110860,3792389522,1672612218,1672613366,1148
3442,3604867757,3715400486,1672575404,1672578621,3217
3520,3299443125,3410538749,1672542283,1672544110,1827
3550,3760364383,3556969573,1672597695,1672598626,931
3506,3298151889,3777240360,1672552251,1672553361,1110
3858,3311049964,3310039260,1672575851,1672579008,3157
3573,3791046864,3481640525,1672620943,1672621838,895
3553,3773902805,3737147209,1672565276,1672565409,133
3498,3852686295,3409114719,1672569948,1672573237,3289
3714,3310039260,3554825448,1672660398,1672662736,2338
3712,3703396825,3463740710,1672692423,1672695231,2808
3530,3925979970,3853629553,1672700955,1672703847,2892
3878,3395201292,3710008361,1672645409,1672645720,311
3734,3824641227,3513018485,1672647113,1672648388,1275
3518,3512722110,3451691949,1672637304,1672640230,2926
3826,3921648519,3636329663,1672601990,1672604826,2836
3435,3756789525,3777240360,1672680712,1672681620,908
3711,3612689556,3436257398,1672662942,1672665355,2413
3688,3492546679,3835422146,1672638297,1672641890,3593
3771,3688796737,3500604680,1672702904,1672704208,1304
3725,3613338363,3367111751,1672684845,1672685090,245
3780,3667673649,3497095254,1672648658,1672650058,1400
3882,3351866415,3773124276,1672604506,1672606813,2307
3919,3609113156,3803389195,1672581208,1672581520,312
3577,3610870949,3777330107,1672687300,1672687829,529
3801,3713979100,3225029895,1672580088,1672581704,1616
3761,3517887477,3517222913,1672626945,1672630527,3582
3732,3689114185,3703798634,1672690428,1672694012,3584
3673,3533929349,3520578796,1672601563,1672604706,3143
3590,3334974375,3783919913,1672578631,1672579943,1312
3743,3885157459,3731646673,1672538045,1672539192,1147
3647,3757332128,3824641227,1672532145,1672533745,1600
3615,3791693821,3777240360,1672589777,1672591898,2121
3529,3900898992,3757294769,1672601395,1672604530,3135
3505,3274906650,3715127070,1672565058,1672566793,1735
3486,3772765746,3773735484,1672597609,1672599899,2290
3731,3389634034,3902861231,1672690893,1672692650,1757
3734,3554825448,3429943738,1672669075,1672671708,2633
3426,3478114114,3520578796,1672680133,1672680342,209
3750,3815250107,3713768950,1672692273,1672695368,3095
3743,3783340788,3777330107,1672533812,1672534830,1018
3716,3774907131,3660063072,1672689526,1672690695,1169
3763,3617392620,3517697722,1672553896,1672556319,2423
3445,3375449013,3608922867,1672680015,1672681400,1385
3893,3684523966,3501457103,1672580865,1672581220,355
3887,3520991398,3923220461,1672647673,1672649846,2173
3618,3617116290,3701005527,1672630159,1672633343,3184
3539,3200308999,3783550022,1672559610,1672560583,973
3540,3783919913,3780571086,1672682569,1672683522,953
3492,3714185969,3772765746,1672635903,1672638509,2606
3554,3607882826,3500915908,1672673002,1672674411,1409
3516,3310125159,3396726504,1672649444,1672651953,2509
3666,3497808662,3533368789,1672683288,1672685390,2102
3765,3701884158,3738026330,1672666377,1672669661,3284
3677,3774907131,3760924079,1672538820,1672540761,1941
3540,3807212280,3291933594,1672673375,1672676678,3303
3450,3319167958,3757903168,1672535208,1672536709,1501
3605,3711006062,3780571086,1672541273,1672541938,665
3613,3276269264,3792949946,1672605064,1672607181,2117
3638,3839245934,3428725843,1672614449,1672614680,231
3674,3208452238,3791046864,1672626106,1672629213,3107
3651,3492546679,3510187271,1672601178,1672603788,2610
3678,3739154408,3792546035,1672681691,1672683289,1598
3549,3756789525,3621184108,1672593613,1672594593,980
3788,3510798825,3839245934,1672694248,1672694630,382
3876,3330340793,3412006598,1672661703,1672664492,2789
3788,3552824113,3609933747,1672687787,1672689509,1722
3455,3501786419,3306412634,1672593779,1672596712,2933
3875,3280268483,3412968120,1672577542,1672580101,2559
3882,3514285803,3715127070,1672690173,1672693441,3268
3547,3519077659,3711218296,1672605830,1672608337,2507
3752,3270042456,3760364383,1672680975,1672684178,3203
3521,3701373490,3760263530,1672596759,1672597164,405
3618,3394401087,3519142371,1672609662,1672612153,2491
3663,3509756823,3920497528,1672537280,1672540141,2861
3492,3229974066,3500072204,1672655136,1672656651,1515
3789,3236499444,3812369928,1672597370,1672597477,107
3645,3770296583,3760924079,1672563161,1672565384,2223
3612,3757348722,3273981374,1672594916,1672595527,611
3521,3200543880,3357289672,1672548038,1672548888,850
3504,3604867757,3533294425,1672628553,1672631814,3261
3698,3855583256,3760094385,1672656137,1672656428,291
3513,3513065217,3902625986,1672664425,1672665986,1561
3826,3935399379,3608855425,1672656553,1672657405,852
3722,3783771827,3510641433,1672583569,1672585400,1831
3474,3383138270,3895285664,1672619882,1672623239,3357
3521,3977352557,3200543880,1672617866,1672619454,1588
3569,3617392620,3621790707,1672631383,1672634632,3249
3784,3684523966,3439673892,1672596730,1672600229,3499
3838,3343816795,3921648519,1672691706,1672693351,1645
3806,3512379024,3501215099,1672531267,1672532135,868
3504,3316800320,3793583656,1672541585,1672542483,898
3730,3435116799,3513545422,1672567530,1672568750,1220
3471,3520764926,3517991730,1672563254,1672566679,3425
3866,3793740407,3757075324,1672625297,1672628751,3454
3807,3556969573,3392520516,1672653438,1672654765,1327
3639,3279473441,3793175445,1672658064,1672658238,174
3648,3757700712,3899786664,1672561536,1672561886,350
3538,3454277788,3447514821,1672624363,1672626588,2225
3645,3299443125,3291933594,1672695299,1672695839,540
3640,3459681410,3367509761,1672633982,1672634648,666
3799,3512383699,3447672935,1672649353,1672649986,633
3498,3716963089,3424660806,1672604105,1672604926,821
3498,3777694660,3905899155,1672641617,1672643628,2011
3481,3241790910,3497671225,1672586581,1672588923,2342
3508,3932478321,3520873221,1672609053,1672611998,2945
3826,3396980894,3615087943,1672555701,1672556495,794
3605,3357864626,3337362061,1672577446,1672578396,950
3425,3500857494,3923754072,1672573444,1672574266,822
3876,3436257398,3208957949,1672618245,1672620648,2403
3611,3513081354,3533188828,1672698089,1672699302,1213
3634,3792949946,3400069268,1672597355,1672597605,250
3878,3481640525,3408430195,1672544351,1672547856,3505
3827,3312998540,3701107228,1672642241,1672645783,3542
3842,3621184108,3774641380,1672574054,1672576833,2779
3904,3608922867,3400069268,1672556515,1672558740,2225
3865,3711853996,3710735406,1672650779,1672651248,469
3803,3770236215,3517358573,1672603531,1672607010,3479
3511,3772765746,3779938251,1672566178,1672569290,3112
3858,3284932450,3739661856,1672619557,1672620620,1063
3797,3609881958,3291933594,1672623695,1672625116,1421
3731,3825881598,3774290799,1672634537,1672637351,2814
3529,3615737355,3517600136,1672564933,1672568414,3481
3681,3893912331,3300511067,1672701179,1672703299,2120
3874,3738026330,3236354255,1672607078,1672608920,1842
3536,3713691388,3467779445,1672675122,1672675998,876
3834,3364726656,3638660068,1672694204,1672695985,1781
3526,3311098437,3500915908,1672580233,1672580855,622
3645,3463849738,3778899160,1672644156,1672644261,105
3779,3780872464,3825881598,1672669221,1672671065,1844
3491,3609881958,3779301501,1672546303,1672549819,3516
3577,3520416075,3201800997,1672610598,1672613340,2742
3799,3500498112,3897456874,1672549955,1672552800,2845
3576,3505663516,3817428320,1672544255,1672546401,2146
3595,3511005395,3757318448,1672537180,1672540645,3465
3587,3688490530,3500827202,1672547497,1672548392,895
3572,3410600350,3452016771,1672687037,1672687633,596
3655,3714120857,3714233826,1672698162,1672701174,3012
3559,3392836218,3428725843,1672576882,1672577237,355
3514,3236354255,3739895284,1672533994,1672536025,2031
3604,3520873221,3376467719,1672592059,1672595093,3034
3491,3932478321,3401793306,1672591531,1672592454,923
3790,3384583385,3737112297,1672625745,1672626497,752
3581,3770468980,3510818674,1672598313,1672601185,2872
3895,3516444201,3270042456,1672578276,1672579436,1160
3452,3713941638,3367971170,1672659814,1672662217,2403
3723,3760094385,3226024417,1672543261,1672546462,3201
3531,3500442734,3714120857,1672686591,1672687494,903
3738,3635169815,3680843171,1672535807,1672536183,376
3489,3414940786,3283492940,1672666230,1672667978,1748
3683,3772236797,3350095157,1672603713,1672607157,3444
3501,3308760650,3773735484,1672675186,1672678711,3525
3861,3303410628,3621683102,1672685598,1672688225,2627
3729,3272716462,3604867757,1672630302,1672633160,2858
3587,3970198861,3354144091,1672618776,1672619353,577
3825,3710735406,3512722110,1672563550,1672565882,2332
3444,3551376095,3393063657,1672585079,1672588426,3347
3425,3811040565,3859868849,1672544322,1672544603,281
3431,3714827719,3970603231,1672697413,1672698149,736
3594,3821054646,3520764926,1672673854,1672674445,591
3685,3534829213,3818575661,1672554140,1672555749,1609
3493,3774031303,3773735484,1672646493,1672649598,3105
3594,3500915665,3617304541,1672636914,1672638701,1787
3441,3900276517,3511288998,1672699053,1672701729,2676
3886,3311498666,3779938251,1672570137,1672571138,1001
3911,3520181148,3772078494,1672573536,1672573936,400
3732,3385323994,3710315160,1672639110,1672642344,3234
3586,3783163143,3441348818,1672677124,1672677211,87
3715,3714666884,3373089838,1672693081,1672695471,2390
3827,3375449013,3780322355,1672550679,1672553829,3150
3890,3824215187,3283144118,1672601749,1672602460,711
3642,3703396825,3455018347,1672543525,1672546457,2932
3424,3755344363,3895285664,1672699272,1672700038,766
3873,3618489670,3777485931,1672694031,1672695416,1385
3473,3513081354,3515525630,1672590753,1672593759,3006
3459,3970603231,3500613459,1672689979,1672693327,3348
3596,3760924079,3716110860,1672629731,1672630597,866
3468,3533929349,3821054646,1672561960,1672562394,434
3719,3779613523,3411515369,1672676301,1672679884,3583
3431,3710315160,3915162005,1672655677,1672656250,573
3868,3631479562,3514741348,1672673047,1672676427,3380
3427,3230135532,3334951866,1672666117,1672669085,2968
3448,3438489358,3505283390,1672597394,1672599216,1822
3522,3808136029,3605221116,1672567441,1672568619,1178
3831,3519909393,3347419520,1672637794,1672638613,819
3591,3554944414,3884596900,1672630667,1672633093,2426
3598,3304971369,3501281016,1672585680,1672588593,2913
3918,3774876004,3460719322,1672650377,1672651851,1474
3777,3451691949,3490029863,1672569094,1672570957,1863
3572,3661583097,3533423872,1672613514,1672615408,1894
3551,3276217799,3777189898,1672636888,1672638631,1743
3487,3520355798,3773939399,1672571502,1672571840,338
3641,3510187271,3779854934,1672604972,1672607759,2787
3481,3492546679,3928719932,1672615405,1672618305,2900
3759,3551399764,3757348722,1672636759,1672639106,2347
3779,3736231757,3500317969,1672569593,1672572399,2806
3852,3557046880,3236458894,1672590634,1672592484,1850
3587,3510554314,3621461051,1672556156,1672558586,2430
3654,3300818269,3533079336,1672682030,1672683958,1928
3711,3703396825,3450286949,1672673809,1672674754,945
3788,3557046880,3770296583,1672636738,1672640087,3349
3477,3783163143,3756127300,1672642229,1672642916,687
3886,3777779869,3500498112,1672658327,1672658417,90
3738,3409114719,3475349791,1672670902,1672672135,1233
3600,3920625129,3501786419,1672699539,1672702560,3021
3629,3756385685,3852533643,1672677433,1672679812,2379
3582,3520657891,3716272919,1672609137,1672612143,3006
3906,3367971170,3829822608,1672677755,1672681215,3460
3671,3480490124,3715086894,1672701360,1672702579,1219
3516,3515466096,3792505974,1672583711,1672584647,936
3858,3776518452,3760645796,1672566349,1672567393,1044
3652,3519446663,3408498208,1672703756,1672703885,129
3649,3451326054,3811040565,1672699773,1672702368,2595
3713,3512282789,3756746867,1672663638,1672664437,799
3459,3400069268,3505663516,1672609893,1672611218,1325
3439,3701884158,3279473441,1672595261,1672597188,1927
3756,3777330107,3457620713,1672603606,1672605276,1670
3541,3715443333,3772391882,1672664062,1672666498,2436
3537,3436257398,3513081354,1672662914,1672664158,1244
3907,3248058676,3435116799,1672644268,1672647348,3080
3686,3739661856,3621184108,1672677741,1672680368,2627
3880,3755737419,3778926763,1672634123,1672635523,1400
3886,3711919537,3630353876,1672678056,1672678969,913
3841,3374183227,3201676087,1672603467,1672606502,3035
3819,3520764926,3755573472,1672692564,1672694399,1835
3900,3520578796,3300229945,1672590026,1672591258,1232
3629,3500672156,3533079336,1672626675,1672630244,3569
3525,3730071479,3511843593,1672567220,1672570259,3039
3702,3515559913,3889780657,1672674749,1672677421,2672
3741,3773572967,3772236797,1672697748,1672699037,1289
3477,3296462324,3511288998,1672665429,1672668445,3016
3485,3292147449,3303410628,1672654837,1672656523,1686
3595,3533423872,3310125159,1672691507,1672694020,2513
3513,3411515369,3760924079,1672573642,1672573914,272
3426,3716628503,3713589994,1672545609,1672547477,1868
3538,3279475486,3774718695,1672603327,1672605806,2479
3891,3513345163,3633735593,1672661027,1672663015,1988
3464,3897456874,3368283077,1672551850,1672552542,692
3671,3792505974,3519142371,1672541307,1672544531,3224
3851,3468041839,3772078494,1672654156,1672655187,1031
3900,3780115155,3818575661,1672567221,1672569053,1832
3789,3686227677,3499217428,1672670381,1672671462,1081
3710,3511317276,3480726047,1672628757,1672629207,450
3533,3668747074,3756746867,1672674352,1672675494,1142
3484,3667427125,3510964997,1672614757,1672615103,346
3725,3779465522,3779438325,1672657265,1672658345,1080
3813,3793969543,3451691949,1672638388,1672640590,2202
3438,3520355798,3823084403,1672665944,1672667541,1597
3498,3713979100,3505847380,1672549785,1672551620,1835
3826,3510964997,3512383699,1672678010,1672678478,468
3903,3733363628,3347419520,1672624584,1672625441,857
3632,3667427125,3511601997,1672631421,1672633143,1722
3918,3716679950,3459681410,1672664022,1672667457,3435
3901,3615737355,3783520186,1672621068,1672623342,2274
3574,3364726656,3203538212,1672628748,1672630679,1931
3431,3472312341,3756625818,1672548597,1672551595,2998
3637,3533228966,3773033649,1672536916,1672539933,3017
3559,3500613493,3897134762,1672686258,1672686341,83
3449,3615087943,3623266256,1672693699,1672696127,2428
3461,3839245934,3305336154,1672647746,1672648318,572
3737,3792020993,3440107959,1672575483,1672577921,2438
3890,3668747074,3714185969,1672601777,1672604080,2303
3446,3554825448,3927599181,1672642167,1672642922,755
3527,3615087943,3793922324,1672582651,1672584894,2243
3454,3512958459,3513545422,1672668308,1672671167,2859
3686,3780680950,3517991730,1672692986,1672695447,2461
3663,3500857494,3900276517,1672568891,1672569132,241
3467,3500613459,3514246749,1672673118,1672675010,1892
3484,3510641433,3552824113,1672561111,1672563472,2361
3795,3755230952,3970558632,1672617696,1672621278,3582
3614,3510798825,3510767239,1672546983,1672547395,412
3522,3935487534,3509366311,1672669526,1672670945,1419
3602,3621184108,3715545685,1672618745,1672621008,2263
3500,3791693821,3776559988,1672639649,1672640911,1262
3833,3885121158,3897456874,1672700053,1672700934,881
3606,3755573472,3514971533,1672658002,1672661063,3061
3727,3424445495,3731646673,1672543824,1672546962,3138
3741,3349739136,3780571086,1672638134,1672641449,3315
3599,3513018485,3780338697,1672534496,1672535060,564
3896,3792072681,3520578796,1672672236,1672673376,1140
3895,3463849738,3938503547,1672703809,1672706562,2753
3447,3783433404,3239617320,1672555533,1672556119,586
3574,3755992176,3779656423,1672618638,1672620273,1635
3628,3774907131,3711812325,1672620925,1672621006,81
3840,3853629553,3619922891,1672649617,1672652143,2526
3434,3783771827,3826238375,1672607987,1672608624,637
3436,3505634634,3467988782,1672613404,1672616623,3219
3792,3520322124,3513295938,1672595115,1672595924,809
3640,3440107959,3664943873,1672573683,1672574818,1135
3764,3415833929,3739895284,1672623307,1672626487,3180
3514,3505995057,3714666884,1672629256,1672630473,1217
3679,3637313265,3440137407,1672596556,1672598025,1469
3637,3791441520,3534179433,1672630358,1672633662,3304
3663,3780253901,3513296868,1672671751,1672672707,956
3454,3686523546,3773121782,1672641857,1672643939,2082
3554,3516298579,3414049538,1672638805,1672640510,1705
3597,3622357348,3517600136,1672637134,1672640390,3256
3505,3733363628,3519416013,1672651170,1672651271,101
3472,3284932450,3711000597,1672606969,1672608208,1239
3811,3713829743,3480991549,1672621657,1672623836,2179
3632,3512958459,3970558632,1672595502,1672596238,736
3694,3829864515,3773572967,1672671316,1672672953,1637
3546,3396726504,3533294425,1672702133,1672704679,2546
3876,3315279093,3201676087,1672605422,1672605700,278
3708,3739895284,3734451191,1672606484,1672608067,1583
3620,3808136029,3514818819,1672632573,1672632711,138
3605,3703348097,3777184389,1672703247,1672704350,1103
3815,3713691388,3714827719,1672699648,1672700003,355
3549,3512383699,3791796585,1672680125,1672681765,1640
3586,3343816795,3836241528,1672619144,1672620803,1659
3471,3839245934,3774705415,1672610940,1672612978,2038
3446,3734451191,3371455553,1672566891,1672569981,3090
3494,3756704774,3713517039,1672586834,1672588135,1301
3650,3926643445,3630353876,1672555041,1672558172,3131
3878,3515525630,3505178849,1672591668,1672592858,1190
3620,3514285803,3927165965,1672650372,1672653764,3392
3762,3703396825,3710489491,1672620290,1672621398,1108
3621,3778134418,3400763927,1672683983,1672687395,3412
3497,3312998540,3399518841,1672660044,1672660528,484
3657,3512295534,3732131656,1672660499,1672663817,3318
3798,3556969573,3732131656,1672651130,1672654070,2940
3700,3415833929,3776988674,1672594702,1672596302,1600
3804,3755915206,3229822507,1672677380,1672680004,2624
3702,3280268483,3403370192,1672691967,1672695179,3212
3812,3428725843,3533649454,1672540359,1672541665,1306
3798,3510187271,3401793306,1672569467,1672571950,2483
3723,3625174002,3315703693,1672618929,1672619943,1014
3852,3792505974,3505521218,1672626789,1672628378,1589
3701,3791441520,3760040019,1672602031,1672602255,224
3707,3713691388,3779301501,1672678871,1672679062,191
3508,3500703304,3756385685,1672534915,1672538133,3218
3696,3512800570,3491684096,1672700875,1672701458,583
3820,3703396825,3811040565,1672559904,1672562941,3037
3649,3270056120,3414275042,1672668070,1672668292,222
3914,3773837847,3780909839,1672659241,1672661495,2254
3690,3337322736,3920497528,1672613360,1672616333,2973
3597,3770676872,3375449013,1672653317,1672656419,3102
3852,3825881598,3770438122,1672641926,1672644570,2644
3502,3977352557,3773902805,1672583206,1672586164,2958
3767,3715086894,3783928182,1672649933,1672653152,3219
3887,3512830734,3609659642,1672618544,1672618699,155
3873,3448875382,3500044458,1672599460,1672602165,2705
3830,3770236215,3773009828,1672536680,1672538544,1864
3762,3609881958,3792745809,1672591272,1672594023,2751
3794,3904412440,3713768950,1672571821,1672572090,269
3574,3417679834,3814305099,1672593807,1672596041,2234
3655,3220031931,3514956366,1672650251,1672653135,2884
3540,3608922867,3343132529,1672556317,1672558605,2288
3720,3497808662,3500703304,1672679173,1672681531,2358
3637,3514334067,3821054646,1672679769,1672680391,622
3849,3780571086,3755158925,1672572063,1672572792,729
3543,3934064792,3208957949,1672636469,1672639253,2784
3673,3451726367,3510798825,1672531326,1672533738,2412
3876,3770236215,3711734586,1672543494,1672545035,1541
3843,3793868716,3279339278,1672553689,1672555244,1555
3575,3774876004,3734915241,1672557284,1672559265,1981
3458,3513041785,3774290799,1672594495,1672595577,1082
3557,3519077659,3511150845,1672587640,1672590854,3214
3442,3516298579,3505198734,1672633400,1672634288,888
3864,3520416075,3226178937,1672702603,1672705856,3253
3431,3839245934,3774733620,1672596032,1672596226,194
3642,3311420950,3271752081,1672599210,1672601955,2745
3633,3777330107,3912891315,1672594031,1672596069,2038
3895,3330340793,3884596900,1672694919,1672696775,1856
3614,3289817992,3811075491,1672630693,1672631053,360
3777,3783928182,3347419520,1672542817,1672544593,1776
3731,3760364383,3236458894,1672698110,1672701066,2956
3822,3783147088,3226024417,1672542359,1672542925,566
3868,3364726656,3509483172,1672642461,1672642588,127
3436,3755737419,3808136029,1672597489,1672597887,398
3530,3362641275,3780322355,1672561922,1672563056,1134
3501,3200308999,3514308235,1672608425,1672610075,1650
3535,3333403880,3515890966,1672640373,1672641121,748
3881,3610358027,3205923620,1672681279,1672682188,909
3690,3517590837,3518194482,1672632603,1672635788,3185
3529,3516513251,3336339664,1672579181,1672579666,485
3907,3730071479,3803389195,1672667889,1672671345,3456
3607,3711097754,3792745809,1672587213,1672588455,1242
3887,3779938251,3609659642,1672669876,1672672153,2277
3781,3500302272,3509764635,1672563998,1672565637,1639
3612,3970603231,3410600350,1672615953,1672617385,1432
3766,3783550022,3372223551,1672633086,1672634959,1873
3584,3793418209,3505283390,1672560735,1672561157,422
3488,3509483172,3401496246,1672576039,1672577300,1261
3731,3515401243,3777091903,1672662792,1672665259,2467
3613,3519416013,3451726367,1672596822,1672597726,904
3752,3467988782,3505888598,1672638484,1672641319,2835
3807,3730071479,3770146716,1672573336,1672574953,1617
3758,3206837348,3667673649,1672652085,1672652288,203
3890,3379143440,3904867554,1672661053,1672663632,2579
3549,3831586487,3923420131,1672564628,1672565431,803
3451,3514818819,3435167810,1672644608,1672644682,74
3891,3514971533,3403370192,1672633465,1672633693,228
3679,3438489358,3273981374,1672644404,1672645186,782
3429,3509764635,3520560590,1672534678,1672536374,1696
3919,3514741348,3227799827,1672641755,1672642879,1124
3906,3778597171,3737147209,1672689260,1672691323,2063
3632,3792442597,3501525100,1672702336,1672705653,3317
3473,3500208903,3777240360,1672569874,1672572049,2175
3507,3689114185,3389634034,1672545056,1672545884,828
3475,3200543880,3680843171,1672641401,1672641597,196
3592,3228888030,3475349791,1672543195,1672545949,2754
3442,3807212280,3500208903,1672606751,1672608938,2187
3493,3977148669,3776084820,1672653267,1672655554,2287
3430,3935913584,3428027649,1672545962,1672548984,3022
3584,3294747828,3439673892,1672612058,1672615437,3379
3561,3835985172,3304971369,1672655428,1672656348,920
3740,3452016771,3776244398,1672652113,1672653426,1313
3604,3760640999,3770676872,1672586932,1672590247,3315
3727,3977148669,3792442597,1672641212,1672642092,880
3852,3622665543,3831586487,1672633887,1672634245,358
3871,3701424609,3511843593,1672672148,1672674872,2724
3730,3399472693,3520764926,1672533547,1672535204,1657
3564,3885157459,3711734586,1672650580,1672652087,1507
3887,3824641227,3660063072,1672560709,1672563621,2912
3645,3701664364,3519028898,1672670127,1672670384,257
3799,3511317276,3609933747,1672657118,1672657691,573
3892,3304155815,3773027597,1672648279,1672651005,2726
3623,3618489670,3439673892,1672596679,1672598592,1913
3855,3379143440,3710315160,1672688497,1672691169,2672
3543,3778640261,3638204468,1672574798,1672575730,932
3583,3777037426,3755496114,1672641429,1672642004,575
3486,3792538417,3518653080,1672592158,1672592999,841
3846,3534566651,3451326054,1672561691,1672562057,366
3468,3557046880,3777814504,1672585757,1672587464,1707
3467,3516903528,3902625986,1672549872,1672550457,585
3562,3513327337,3800257590,1672577127,1672578973,1846
3768,3509366311,3399518841,1672598708,1672601662,2954
3551,3703798634,3559458968,1672531589,1672533525,1936
3841,3201629017,3904569677,1672658249,1672658559,310
3767,3803517637,3760640999,1672607085,1672610055,2970
3892,3505847380,3479851674,1672662526,1672663182,656
3715,3349739136,3777330107,1672649526,1672651335,1809
3653,3605221116,3713691388,1672550411,1672550544,133
3729,3556969573,3273981374,1672554573,1672554810,237
3805,3463740710,3755756564,1672677281,1672680200,2919
3665,3714666884,3513345163,1672543676,1672544003,327
3761,3780571086,3424660806,1672676631,1672677330,699
3871,3817813340,3715986185,1672608297,1672609148,851
3491,3334974375,3714185969,1672562579,1672565567,2988
3830,3859868849,3505198734,1672655469,1672656697,1228
3721,3510499038,3516513251,1672627001,1672629316,2315
3779,3400763927,3778134418,1672627947,1672628363,416
3523,3701322924,3363162590,1672644064,1672646444,2380
3907,3501786419,3689114185,1672659103,1672661809,2706
3559,3716963089,3974674109,1672580332,1672581161,829
3883,3445206685,3517462308,1672589902,1672590384,482
3815,3829864515,3792538417,1672580179,1672583143,2964
3776,3516903528,3715619259,1672659686,1672661534,1848
3807,3701107228,3500347447,1672602395,1672602939,544
3596,3505283390,3520115090,1672568446,1672568879,433
3708,3206837348,3715385401,1672660366,1672661814,1448
3757,3500777439,3884596900,1672624804,1672627723,2919
3802,3363162590,3500703304,1672674395,1672675266,871
3798,3436257398,3518565331,1672690125,1672690966,841
3475,3330340793,3336627643,1672658212,1672659968,1756
3582,3778597171,3510499038,1672536145,1672537331,1186
3659,3774705415,3909094917,1672613308,1672616701,3393
3879,3279339278,3516444201,1672574417,1672575002,585
3518,3421877923,3347446226,1672678699,1672681899,3200
3893,3701322924,3514818819,1672611411,1672611710,299
3795,3833217041,3511442562,1672669093,1672670395,1302
3742,3366423342,3783163143,1672640889,1672642859,1970
3862,3713517039,3500208903,1672702291,1672704020,1729
3688,3236458894,3757903168,1672572017,1672573363,1346
3881,3622357348,3779646172,1672608300,1672610061,1761
3686,3777694660,3755230952,1672587408,1672589309,1901
3858,3516903528,3792020993,1672656560,1672658270,1710
3759,3803517637,3808136029,1672572660,1672574021,1361
3819,3369708250,3299443125,1672566438,1672569211,2773
3887,3479851674,3935487534,1672614621,1672617057,2436
3604,3977148669,3515402792,1672569673,1672571244,1571
3786,3491684096,3920497528,1672688979,1672692489,3510
3857,3488686442,3201676087,1672540507,1672541767,1260
3437,3793740407,3716628503,1672541053,1672543950,2897
3899,3780427126,3791046864,1672600028,1672602301,2273
3467,3935399379,3815392801,1672605586,1672606956,1370
3815,3774290799,3773913680,1672571289,1672572251,962
3740,3450969839,3392943173,1672643130,1672643466,336
3896,3501457103,3516513251,1672601873,1672603207,1334
3763,3497095254,3735374579,1672555030,1672558428,3398
3844,3756474459,3208452238,1672580793,1672581852,1059
3759,3779639983,3505154885,1672602471,1672604957,2486
3641,3777485931,3836241528,1672679370,1672680003,633
3673,3773913680,3839245934,1672644009,1672645810,1801
3774,3756625818,3505434346,1672536525,1672538261,1736
3567,3552824113,3793418209,1672667806,1672668037,231
3674,3793781065,3715854030,1672632830,1672634758,1928
3537,3858172636,3447672935,1672602445,1672603291,846
3883,3755065949,3773735484,1672646357,1672649191,2834
3451,3451726367,3490029863,1672615279,1672616138,859
3509,3534543776,3783919913,1672600370,1672603509,3139
3485,3835985172,3716679950,1672618605,1672619285,680
3827,3892304880,3889780657,1672613507,1672616410,2903
3564,3421385957,3272096759,1672538816,1672539552,736
3665,3711637255,3554825448,1672620860,1672621517,657
3489,3226178937,3533274994,1672699358,1672701272,1914
3620,3232208416,3450286949,1672621102,1672621402,300
3857,3451726367,3510499038,1672637998,1672639153,1155
3879,3343816795,3715707380,1672575063,1672576574,1511
3840,3792505974,3245232284,1672703601,1672704652,1051
3649,3668533536,3791693821,1672584701,1672585127,426
3757,3448875382,3554186380,1672645105,1672648531,3426
3768,3623266256,3779892400,1672580135,1672582203,2068
3447,3505437712,3533274994,1672622928,1672626295,3367
3840,3421877923,3757294769,1672648067,1672650288,2221
3847,3385323994,3512337405,1672537439,1672539216,1777
3658,3334647380,3445206685,1672656726,1672657338,612
3728,3824215187,3500841914,1672539563,1672542317,2754
3496,3510028805,3756789525,1672592735,1672594888,2153
3814,3792274796,3520873221,1672619941,1672622069,2128
3547,3776117322,3514285803,1672631712,1672633439,1727
3654,3300818269,3246370118,1672579759,1672580019,260
3508,3514308235,3604589802,1672596544,1672598804,2260
3759,3315279093,3777330107,1672657713,1672658915,1202
3812,3732131656,3777147510,1672697871,1672700951,3080
3436,3710008361,3755233658,1672652599,1672655636,3037
3575,3408430195,3347419520,1672616714,1672617390,676
3843,3710315160,3760040019,1672606438,1672607173,735
3495,3357864626,3824215187,1672545457,1672547214,1757
3841,3972083617,3664943873,1672553393,1672554089,696
3856,3713911104,3492546679,1672536301,1672537403,1102
3587,3773009828,3533747868,1672544838,1672547236,2398
3863,3736705719,3773027597,1672702560,1672702843,283
3689,3885157459,3774876004,1672549959,1672551820,1861
3752,3711077927,3410538749,1672695927,1672696565,638
3748,3920625129,3773939399,1672698515,1672700929,2414
3873,3505178849,3615939504,1672640903,1672643845,2942
3492,3394297564,3520873221,1672696190,1672697017,827
3639,3551399764,3776117322,1672611585,1672611939,354
3605,3713300120,3517881647,1672646929,1672648301,1372
3682,3667673649,3519818818,1672550939,1672552260,1321
3751,3511843593,3774178201,1672557855,1672559120,1265
3770,3618808151,3299443125,1672572496,1672575439,2943
3764,3351696332,3424445495,1672698715,1672702087,3372
3436,3701136026,3517172354,1672699648,1672701668,2020
3551,3505266860,3500302272,1672546629,1672549528,2899
3862,3703348097,3519077659,1672624288,1672624583,295
3828,3780909839,3448633776,1672562942,1672563454,512
3764,3812369928,3438078818,1672680201,1672681212,1011
3895,3897456874,3517697722,1672635392,1672638156,2764
3502,3512958459,3734915241,1672693637,1672694906,1269
3485,3410538749,3757193307,1672556465,1672558965,2500
3864,3490214516,3311085279,1672624743,1672625308,565
3495,3513327337,3715127070,1672596183,1672598212,2029
3908,3551376095,3300979975,1672574287,1672577461,3174
3840,3774155692,3631479562,1672641278,1672642970,1692
3481,3638204468,3511843593,1672703726,1672705740,2014
3900,3661583097,3205923620,1672619439,1672621816,2377
3897,3520322124,3773027597,1672584600,1672586118,1518
3774,3310039260,3288762795,1672538667,1672539401,734
3519,3667673649,3497095254,1672686017,1672687668,1651
3552,3238288884,3779465522,1672672282,1672674725,2443
3679,3374183227,3533929349,1672552709,1672556226,3517
3894,3715443333,3739661856,1672543405,1672545263,1858
3622,3791128487,3512337405,1672584222,1672586459,2237
3911,3791106564,3733558985,1672544696,1672546334,1638
3772,3435116799,3667427125,1672567863,1672570331,2468
3517,3607882826,3618808151,1672610703,1672612150,1447
3899,3638204468,3703798634,1672594129,1672595148,1019
3553,3373028638,3615939504,1672576376,1672579587,3211
3522,3452016771,3739895284,1672693352,1672696471,3119
3730,3520115090,3783136330,1672604782,1672608141,3359
3712,3637313265,3241790910,1672699251,1672700107,856
3516,3793418209,3817813340,1672590391,1672593985,3594
3589,3418448389,3927165965,1672648142,1672651491,3349
3451,3773939399,3889780657,1672613391,1672614697,1306
3901,3288224595,3424445495,1672567053,1672567122,69
3534,3520115090,3716272919,1672602213,1672604770,2557
3891,3280054198,3511442562,1672567313,1672568118,805
3814,3510641433,3914691363,1672581160,1672581348,188
3717,3440107959,3392836218,1672576271,1672579436,3165
3905,3604589802,3618489670,1672597011,1672598232,1221
3827,3826238375,3760640999,1672590064,1672593546,3482
3717,3685681577,3716679950,1672576626,1672577723,1097
3806,3757348722,3920898925,1672560509,1672561378,869
3724,3613581796,3737147209,1672681297,1672682245,948
3588,3408430195,3617304541,1672630973,1672632886,1913
3623,3667673649,3505888598,1672591571,1672592087,516
3894,3713691388,3520657891,1672583717,1672585481,1764
3574,3468041839,3610358027,1672600971,1672601625,654
3696,3438489358,3906536154,1672578139,1672580425,2286
3879,3437286517,3467988782,1672655659,1672659159,3500
3852,3435116799,3396726504,1672678515,1672681617,3102
3652,3505178849,3891672228,1672545872,1672546771,899
3506,3311498666,3514512367,1672634264,1672635555,1291
3443,3203538212,3512337405,1672614537,1672615003,466
3601,3349856820,3615737355,1672599750,1672602635,2885
3650,3615113018,3398731252,1672623588,1672626896,3308
3694,3792072681,3829822608,1672561615,1672562925,1310
3704,3517358573,3500442734,1672547939,1672551133,3194
3885,3855583256,3236499444,1672657646,1672659494,1848
3770,3520873221,3793175445,1672581865,1672585262,3397
3797,3833217041,3380767040,1672572794,1672575164,2370
3863,3710735406,3615737355,1672593481,1672595576,2095
3506,3431502855,3760094385,1672538760,1672541016,2256
3770,3778926763,3285204083,1672699084,1672702533,3449
3829,3972083617,3757318448,1672616802,1672619840,3038
3667,3455018347,3500915908,1672599535,1672602882,3347
3838,3713561276,3386758279,1672661808,1672664689,2881
3682,3757323954,3623266256,1672571368,1672572012,644
3432,3274831810,3715086894,1672635289,1672638147,2858
3519,3783615982,3333403880,1672584816,1672587263,2447
3877,3315279093,3335694356,1672661608,1672664865,3257
3706,3701136026,3829864515,1672575842,1672576247,405
3739,3467988782,3715545685,1672561941,1672562031,90
3501,3239617320,3776084820,1672545950,1672547508,1558
3577,3776518452,3505178849,1672625467,1672626919,1452
3442,3618176292,3284947372,1672571130,1672571934,804
3464,3517222913,3933894942,1672643848,1672645475,1627
3738,3374183227,3779938251,1672603052,1672603223,171
3611,3899786664,3714067076,1672644365,1672647117,2752
3499,3909094917,3517288083,1672695867,1672697694,1827
3602,3793935736,3236499444,1672590685,1672592865,2180
3429,3770676872,3294703680,1672607276,1672610464,3188
3872,3513081354,3792538417,1672578361,1672581171,2810
3713,3435116799,3701823816,1672661909,1672663931,2022
3857,3312998540,3703139663,1672663404,1672664364,960
3767,3909094917,3791436104,1672545470,1672548022,2552
3776,3852686295,3774641380,1672586480,1672588077,1597
3638,3374183227,3756385685,1672540577,1672540774,197
3470,3791796585,3288224595,1672666117,1672668505,2388
3696,3607768197,3732584121,1672632801,1672636244,3443
3834,3776084820,3514308235,1672684706,1672688095,3389
3722,3305336154,3513410578,1672560445,1672560616,171
3531,3755756564,3312998540,1672586870,1672590049,3179
3493,3701107228,3792489602,1672585405,1672588698,3293
3763,3898314440,3682133690,1672548249,1672550884,2635
3548,3791106564,3617116290,1672676967,1672677597,630
3678,3373028638,3513345163,1672643045,1672643741,696
3797,3703798634,3271752081,1672632252,1672632955,703
3715,3774178201,3510798825,1672699804,1672700703,899
3716,3715545685,3389634034,1672572707,1672574469,1762
3909,3227799827,3338390596,1672577464,1672580673,3209
3533,3230135532,3399518841,1672537267,1672538319,1052
3494,3773913680,3920497528,1672593165,1672595634,2469
3838,3480991549,3779301501,1672667151,1672668993,1842
3794,3512383699,3783919913,1672635434,1672635917,483
3710,3533294425,3735374579,1672645797,1672648830,3033
3879,3557046880,3334951866,1672534589,1672537530,2941
3495,3972083617,3773027597,1672644345,1672646839,2494
3441,3783919913,3357864626,1672554142,1672555827,1685
3427,3852533643,3792389522,1672577171,1672579225,2054
3769,3793418209,3505154885,1672684455,1672685174,719
3634,3774178201,3289114629,1672578215,1672580601,2386
3842,3497808662,3440107959,1672647128,1672648752,1624
3700,3853629553,3688220326,1672666701,1672667929,1228
3500,3774718695,3380767040,1672563592,1672566543,2951
3435,3757323954,3511791953,1672573918,1672576640,2722
3582,3783373154,3515890966,1672684314,1672687615,3301
3713,3714067076,3661447322,1672684763,1672688130,3367
3700,3517358573,3226511603,1672603435,1672606555,3120
3778,3396726504,3280054198,1672589910,1672593462,3552
3887,3403370192,3480726047,1672586820,1672588564,1744
3584,3497808662,3200308999,1672647079,1672647500,421
3448,3780680950,3294747828,1672596447,1672598004,1557
3452,3714670620,3440107959,1672638062,1672640890,2828
3805,3757075324,3779738691,1672537365,1672537935,570
3703,3773837847,3778926763,1672589312,1672589644,332
3894,3977148669,3382733096,1672638083,1672641226,3143
3861,3617392620,3338390596,1672639185,1672639368,183
3589,3615115210,3513296868,1672604296,1672605280,984
3611,3501121099,3774178201,1672566528,1672567709,1181
3920,3905196766,3505634634,1672630976,1672634078,3102
3878,3520355798,3517887477,1672696256,1672697463,1207
3785,3428725843,3819767045,1672685624,1672685959,335
3435,3501567772,3701424609,1672623049,1672624836,1787
3464,3396726504,3714185969,1672671497,1672673414,1917
3868,3716272919,3904569677,1672577613,1672579464,1851
3693,3635169815,3757348722,1672571755,1672574545,2790
3595,3711812325,3533368789,1672656234,1672659179,2945
3650,3509366311,3366423342,1672579375,1672579498,123
3635,3438078818,3450969839,1672572566,1672574262,1696
3574,3715619259,3203538212,1672702693,1672703431,738
3801,3338083680,3338083680,1672579480,1672582370,2890
3800,3516321888,3505888598,1672674322,1672677189,2867
3682,3777485931,3500208903,1672676692,1672680078,3386
3869,3639050419,3923220461,1672626477,1672626717,240
3770,3607882826,3511024016,1672612698,1672614612,1914
3690,3357289672,3970198861,1672545034,1672545686,652
3702,3760640999,3930242012,1672682571,1672682931,360
3633,3779613523,3316798920,1672550969,1672552374,1405
3873,3713300120,3713163045,1672618566,1672622009,3443
3434,3792525861,3516298579,1672653846,1672655131,1285
3468,3533929349,3311420950,1672632207,1672635241,3034
3506,3783771827,3401940259,1672655365,1672657074,1709
3752,3703396825,3773033649,1672687361,1672689582,2221
3745,3311085279,3411515369,1672676280,1672677802,1522
3426,3436257398,3303410628,1672610365,1672613652,3287
3631,3500949309,3889780657,1672591369,1672592238,869
3533,3512383699,3517887477,1672574264,1672576672,2408
3907,3500827202,3274906650,1672628107,1672629960,1853
3591,3450286949,3974674109,1672578194,1672579530,1336
3492,3777091903,3306175858,1672680844,1672684252,3408
3874,3509764635,3792072681,1672585486,1672588296,2810
3599,3711812325,3500915665,1672550344,1672551940,1596
3642,3736231757,3701664364,1672572253,1672574559,2306
3871,3517462308,3517590837,1672567824,1672569820,1996
3672,3225029895,3514741348,1672558542,1672558777,235
3427,3660063072,3834960360,1672604220,1672607607,3387
3790,3401793306,3836241528,1672671849,1672672260,411
3894,3852686295,3303410628,1672546746,1672548930,2184
3507,3505521218,3552824113,1672610823,1672613767,2944
3536,3440137407,3455018347,1672531219,1672534704,3485
3822,3777814504,3972083617,1672629394,1672630844,1450
3703,3791693821,3505266860,1672627822,1672629256,1434
3909,3714233826,3972083617,1672603706,1672605942,2236
3786,3715854030,3792014516,1672650994,1672654273,3279
3912,3818575661,3739911441,1672673677,1672676647,2970
3457,3711218296,3760694096,1672574785,1672576190,1405
3810,3609881958,3899786664,1672630620,1672631316,696
3453,3449639012,3533004959,1672675521,1672676936,1415
3917,3777147510,3396980894,1672677989,1672681440,3451
3706,3715619259,3517881647,1672571789,1672575386,3597
3687,3517358573,3777485931,1672564192,1672567030,2838
3844,3515525630,3774907131,1672549669,1672551477,1808
3520,3239617320,3501215099,1672649110,1672649372,262
3687,3520322124,3777814504,1672555124,1672558204,3080
3594,3793418209,3435116799,1672698359,1672701200,2841
3496,3449333754,3501384020,1672565388,1672565474,86
3557,3711637255,3777091903,1672690931,1672691819,888
3843,3808136029,3829864515,1672608550,1672609044,494
3753,3511288998,3773572967,1672623595,1672626079,2484
3474,3516298579,3505847380,1672652753,1672655781,3028
3782,3480100311,3713589994,1672543666,1672547223,3557
3662,3248058676,3716110860,1672583581,1672584548,967
3863,3624297844,3226178937,1672682937,1672684811,1874
3837,3756746867,3424445495,1672670224,1672671768,1544
3744,3505111292,3669146016,1672638598,1672638850,252
3499,3272716462,3776117322,1672694386,1672696932,2546
3825,3770438122,3514275974,1672532158,1672534233,2075
3899,3380130228,3272030610,1672578178,1672578974,796
3642,3385323994,3617304541,1672603929,1672604761,832
3648,3714128600,3447672935,1672683737,1672686267,2530
3642,3462273042,3731646673,1672672515,1672675806,3291
3875,3500737582,3514275974,1672648439,1672651779,3340
3859,3478114114,3970558632,1672618999,1672621210,2211
3452,3773027597,3516298579,1672687748,1672687960,212
3460,3511150845,3500442734,1672537506,1672538209,703
3539,3308760650,3513018485,1672641484,1672644346,2862
3440,3505402439,3669146016,1672655039,1672655957,918
3816,3825881598,3533274994,1672666516,1672668865,2349
3722,3512946768,3776084820,1672600173,1672602804,2631
3595,3291933594,3480726047,1672626920,1672630143,3223
3517,3904569677,3774290799,1672654193,1672655720,1527
3827,3713768950,3495911207,1672691116,1672691527,411
3712,3811075491,3792538417,1672596519,1672597027,508
3569,3714678331,3412006598,1672599839,1672602408,2569
3808,3906536154,3834960360,1672683909,1672685679,1770
3737,3501121099,3248058676,1672584139,1672585791,1652
3554,3904569677,3500613493,1672531413,1672532177,764
3544,3770704999,3511317276,1672698783,1672700660,1877
3623,3933894942,3613338363,1672662744,1672665720,2976
3789,3238288884,3280268483,1672696011,1672698399,2388
3914,3772236797,3778667336,1672611093,1672614006,2913
3500,3311498666,3505283390,1672560755,1672561298,543
3740,3517697722,3711812325,1672564855,1672564943,88
3807,3463849738,3514324011,1672613075,1672615578,2503
3876,3711097754,3793883863,1672549561,1672553147,3586
3476,3633735593,3605221116,1672677417,1672678679,1262
3536,3819767045,3756625818,1672576944,1672578712,1768
3627,3779786641,3710315160,1672541678,1672543018,1340
3432,3970198861,3756704774,1672658695,1672659590,895
3478,3701005527,3369708250,1672642290,1672645543,3253
3643,3739895284,3511317276,1672621919,1672623785,1866
3772,3715974659,3435167810,1672534234,1672536341,2107
3670,3513545422,3288762795,1672541294,1672544806,3512
3885,3533188828,3510187271,1672552295,1672555218,2923
3750,3441703884,3519142371,1672539170,1672540100,930
3842,3774876004,3241914067,1672590933,1672592127,1194
3466,3755065949,3386758279,1672541438,1672542494,1056
3885,3519142371,3363162590,1672664324,1672666484,2160
3567,3615115210,3899326793,1672591222,1672594615,3393
3742,3756789525,3755230952,1672612506,1672615732,3226
3615,3701664364,3713911104,1672606276,1672608697,2421
3699,3778899160,3501457103,1672578984,1672580873,1889
3525,3713589994,3608855425,1672672178,1672672272,94
3535,3632814465,3774605761,1672679200,1672679553,353
3507,3686523546,3351696332,1672548820,1672549507,687
3679,3895285664,3779438325,1672567080,1672568647,1567
3549,3776988674,3859868849,1672633330,1672636317,2987
3760,3770624662,3305722859,1672667180,1672667927,747
3461,3757323954,3224811762,1672699747,1672703280,3533
3620,3792389522,3515525630,1672669870,1672672520,2650
3821,3533747868,3904867554,1672672835,1672675119,2284
3826,3685681577,3609933747,1672657265,1672658460,1195
3843,3618808151,3509756823,1672633570,1672636634,3064
3602,3780680950,3238288884,1672640556,1672642263,1707
3708,3780571086,3357689359,1672656928,1672657630,702
3561,3779425804,3683113954,1672646739,1672647607,868
3739,3520416075,3793935736,1672594211,1672597501,3290
3737,3885121158,3490029863,1672552120,1672552639,519
3778,3755065949,3710496785,1672625911,1672626718,807
3823,3710048469,3760362417,1672637121,1672640556,3435
3624,3505434346,3279339278,1672684863,1672687850,2987
3719,3756789525,3556969573,1672622535,1672623802,1267
3596,3224811762,3777330107,1672693474,1672695940,2466
3906,3631479562,3715707380,1672596817,1672597770,953
3468,3357289672,3904867554,1672542724,1672545366,2642
3767,3513296868,3316800320,1672542298,1672543060,762
3858,3778640261,3776034743,1672636422,1672637564,1142
3809,3511732493,3779892400,1672669578,1672669973,395
3444,3777485931,3357689359,1672575376,1672577980,2604
3759,3393063657,3930242012,1672536447,1672538162,1715
3820,3760924079,3703433819,1672536200,1672539177,2977
3720,3636329663,3514285803,1672676475,1672679499,3024
3569,3360069849,3319167958,1672623311,1672626767,3456
3558,3428725843,3333403880,1672670127,1672671468,1341
3891,3418448389,3624297844,1672560057,1672561137,1080
3828,3534175249,3760651515,1672532685,1672535171,2486
3726,3514285803,3779892400,1672646032,1672648013,1981
3585,3408498208,3408498208,1672616469,1672617894,1425
3503,3410160376,3770438122,1672545366,1672547527,2161
3461,3509764635,3931627862,1672662455,1672663978,1523
3689,3349739136,3414049538,1672583120,1672584835,1715
3798,3793740407,3755573472,1672601762,1672603973,2211
3827,3364726656,3803517637,1672594344,1672595826,1482
3553,3774031303,3710496785,1672546034,1672547787,1753
3748,3357289672,3240994288,1672585871,1672588081,2210
3785,3512946768,3824215187,1672591383,1672593540,2157
3457,3241914067,3935913584,1672652622,1672656077,3455
3682,3979784676,3970627281,1672647021,1672648377,1356
3617,3520322124,3505481368,1672655582,1672657897,2315
3498,3780338697,3349856820,1672550353,1672552541,2188
3557,3505663516,3715974659,1672629888,1672631179,1291
3456,3928511283,3834631333,1672591078,1672592995,1917
3828,3513853403,3554825448,1672609597,1672612592,2995
3774,3509366311,3618697021,1672565791,1672565876,85
3604,3306412634,3438078818,1672593137,1672594408,1271
3711,3608232640,3792505974,1672601345,1672602273,928
3437,3776117322,3271454397,1672684982,1672686915,1933
3562,3777091903,3505198734,1672628345,1672628425,80
3512,3770624662,3493017654,1672533522,1672535888,2366
3597,3637313265,3519077659,1672598030,1672600342,2312
3618,3713829743,3533274994,1672672452,1672674364,1912
3766,3972083617,3668533536,1672603241,1672606282,3041
3709,3774718695,3468041839,1672545530,1672547981,2451
3441,3421877923,3756625818,1672536106,1672538575,2469
3789,3778899160,3205985903,1672594827,1672597697,2870
3617,3736231757,3435167810,1672617674,1672618423,749
3586,3757075324,3384583385,1672622720,1672625139,2419
3425,3519850727,3701107228,1672664934,1672665754,820
3644,3668533536,3780322355,1672666720,1672667449,729
3749,3336627643,3713561276,1672651159,1672654084,2925
3562,3686227677,3686227677,1672576589,1672579682,3093
3750,3520322124,3783163143,1672564178,1672565043,865
3863,3509893027,3511883730,1672621767,1672623936,2169
3719,3401496246,3337362061,1672673292,1672674455,1163
3922,3514703118,3276217799,1672563929,1672564971,1042
3504,3714678331,3372223551,1672621340,1672624049,2709
3619,3780253901,3559458968,1672580231,1672583171,2940
3758,3462158237,3609881958,1672627829,1672630706,2877
3444,3711000597,3445206685,1672662018,1672663618,1600
3775,3501786419,3780209375,1672703706,1672705987,2281
3730,3337362061,3311085279,1672652001,1672653053,1052
3559,3399472693,3227799827,1672537738,1672540715,2977
3686,3421385957,3500857494,1672692611,1672692745,134
3850,3974674109,3808136029,1672627996,1672629473,1477
3822,3399518841,3713300120,1672618229,1672620597,2368
3760,3703396825,3824215187,1672605737,1672605962,225
3765,3505663516,3904569677,1672622777,1672622963,186
3858,3757193307,3500525825,1672685361,1672688461,3100
3574,3500703304,3772078494,1672573849,1672575548,1699
3730,3280054198,3770520359,1672580152,1672581484,1332
3863,3668533536,3559731671,1672582946,1672583707,761
3458,3814305099,3300818269,1672691443,1672691722,279
3605,3448633776,3357864626,1672547002,1672550164,3162
3767,3490029863,3760362417,1672678993,1672680777,1784
3893,3703433819,3715707380,1672554618,1672557177,2559
3586,3280054198,3633735593,1672554163,1672556940,2777
3902,3685816610,3755065949,1672687652,1672689711,2059
3922,3534175249,3238288884,1672702491,1672705973,3482
3512,3668414677,3248058676,1672681128,1672682417,1289
3753,3512830734,3715545685,1672537479,1672539649,2170
3727,3519818818,3300229945,1672668484,1672670503,2019
3450,3970909253,3852533643,1672691444,1672693295,1851
3515,3619922891,3224968597,1672648181,1672649978,1797
3761,3520657891,3902760230,1672588589,1672591724,3135
3833,3715545685,3513295938,1672580155,1672583490,3335
3609,3485540729,3398198430,1672693009,1672695520,2511
3725,3715986185,3852533643,1672627642,1672629042,1400
3452,3509483172,3974674109,1672575050,1672576561,1511
3456,3716963089,3770520359,1672685830,1672687368,1538
3451,3636329663,3733363628,1672672508,1672675889,3381
3896,3367509761,3500827202,1672663893,1672666602,2709
3504,3511024016,3928511283,1672690672,1672693071,2399
3767,3730071479,3792014516,1672667289,1672670030,2741
3751,3500208903,3831586487,1672657223,1672660710,3487
3909,3635169815,3793583656,1672601230,1672604139,2909
3576,3512337405,3334647380,1672601073,1672604557,3484
3567,3511442562,3710854064,1672630944,1672631223,279
3628,3514956366,3533090502,1672620485,1672622360,1875
3490,3411515369,3703139663,1672631455,1672633939,2484
3729,3440137407,3627368399,1672621721,1672622151,430
3534,3517881647,3500613459,1672669179,1672670336,1157
3846,3424445495,3514324011,1672622512,1672624108,1596
3615,3501281016,3613338363,1672621595,1672624547,2952
3902,3343132529,3739661856,1672677387,1672678442,1055
3512,3711097754,3793743698,1672532514,1672534241,1727
3655,3812369928,3618808151,1672675153,1672676065,912
3429,3515402792,3793868716,1672552959,1672554936,1977
3790,3515401243,3609933747,1672695471,1672698969,3498
3756,3770704999,3701424609,1672686903,1672690349,3446
3726,3611055563,3316800320,1672551898,1672554851,2953
3903,3416987084,3900898992,1672595520,1672599098,3578
3756,3520115090,3334647380,1672650533,1672651756,1223
3516,3411515369,3288224595,1672617114,1672619681,2567
3691,3400069268,3755532873,1672562961,1672563041,80
3448,3793868716,3669146016,1672649952,1672652301,2349
3438,3756127300,3226024417,1672593199,1672595100,1901
3497,3757630221,3701882224,1672562574,1672563790,1216
3588,3776034743,3360813161,1672698550,1672701864,3314
3711,3971806004,3279339278,1672618686,1672619325,639
3795,3367111751,3780322355,1672552771,1672555704,2933
3876,3512882178,3773009828,1672582287,1672585138,2851
3439,3316798920,3975717896,1672687591,1672688686,1095
3909,3792072681,3246370118,1672560958,1672563550,2592
3685,3279473441,3689697817,1672674099,1672674886,787
3600,3776559988,3404025196,1672667588,1672670528,2940
3917,3938389661,3418448389,1672627192,1672627998,806
3490,3372223551,3791046864,1672619609,1672622765,3156
3579,3428725843,3793583656,1672658426,1672658695,269
3817,3773124276,3701247948,1672665984,1672666659,675
3647,3733558985,3402697190,1672632698,1672634804,2106
3495,3777485931,3792505974,1672552907,1672555592,2685
3662,3714185969,3826238375,1672547624,1672548012,388
3825,3716963089,3760364383,1672642081,1672644586,2505
3605,3757193307,3757193307,1672577601,1672579006,1405
3921,3701373490,3505266860,1672581678,1672584798,3120
3631,3511024016,3357289672,1672658771,1672659677,906
3901,3334974375,3501786419,1672690366,1672691233,867
3883,3756746867,3773124276,1672591587,1672593641,2054
3843,3620292035,3783520186,1672694378,1672695315,937
3452,3500672156,3229822507,1672652965,1672653886,921
3509,3779938251,3279473441,1672613307,1672616619,3312
3795,3480991549,3236499444,1672688823,1672690819,1996
3738,3512499658,3515402792,1672548045,1672548160,115
3493,3488763230,3533747868,1672545800,1672548251,2451
3471,3887243870,3755496114,1672692484,1672694240,1756
3763,3364378127,3500442734,1672611949,1672614385,2436
3747,3757294769,3760263530,1672703949,1672706034,2085
3828,3271454397,3505634634,1672590381,1672591729,1348
3781,3773033649,3509366311,1672571564,1672572352,788
3502,3711218296,3385323994,1672691060,1672693657,2597
3566,3760651515,3283144118,1672542884,1672544696,1812
3881,3273981374,3360616538,1672669593,1672671346,1753
3680,3715443333,3485540729,1672664555,1672667476,2921
3882,3514308235,3380130228,1672556873,1672559736,2863
3752,3501459390,3276269264,1672690511,1672690777,266
3529,3792745809,3604867757,1672557044,1672559622,2578
3863,3349856820,3276217799,1672648914,1672651662,2748
3904,3792014516,3505847380,1672547495,1672550796,3301
3745,3773009828,3731646673,1672576255,1672579615,3360
3741,3373089838,3512282789,1672539438,1672541668,2230
3526,3710008361,3229974066,1672624746,1672626522,1776
3438,3689697817,3688220326,1672661658,1672662026,368
3895,3449639012,3739911441,1672702131,1672705660,3529
3682,3609881958,3783169442,1672565453,1672568242,2789
3893,3621461051,3760645796,1672635170,1672635644,474
3907,3814305099,3505847380,1672538110,1672540064,1954
3511,3404025196,3760362417,1672635096,1672635329,233
3917,3519087371,3304971369,1672661121,1672663096,1975
3564,3513041785,3515439826,1672572707,1672574928,2221
3705,3517222913,3236458894,1672696930,1672698836,1906
3766,3660063072,3803389195,1672624678,1672625440,762
3472,3792274796,3380982774,1672636566,1672639287,2721
3559,3376467719,3792274796,1672610177,1672611391,1214
3439,3609113156,3224330592,1672601501,1672602531,1030
3518,3608922867,3664943873,1672606549,1672609413,2864
3698,3770146716,3613581796,1672604503,1672607201,2698
3791,3836241528,3757193551,1672590499,1672593671,3172
3691,3760651515,3440107959,1672602833,1672605196,2363
3475,3715400486,3793407963,1672610390,1672613315,2925
3852,3852533643,3511150845,1672664781,1672667264,2483
3689,3411688875,3732584121,1672646123,1672649008,2885
3625,3310125159,3760721303,1672682148,1672684770,2622
3642,3364378127,3519909393,1672694198,1672696834,2636
3732,3519909393,3770676872,1672682602,1672683697,1095
3563,3284947372,3450286949,1672547522,1672548359,837
3659,3511883730,3701373490,1672622229,1672622805,576
3639,3898314440,3515525630,1672556719,1672559285,2566
3778,3716679950,3773124276,1672658659,1672659794,1135
3509,3664943873,3228888030,1672692273,1672694415,2142
3450,3534175249,3362641275,1672603611,1672606230,2619
3631,3396980894,3424445495,1672554602,1672557291,2689
3501,3373089838,3309314379,1672542513,1672545003,2490
3529,3316800320,3836241528,1672641512,1672642823,1311
3756,3501384020,3792538417,1672623290,1672623625,335
3592,3467988782,3783919913,1672585016,1672585469,453
3829,3513065217,3343132529,1672582508,1672584641,2133
3766,3774178201,3777147510,1672684834,1672686341,1507
3742,3202804048,3774155692,1672673054,1672675173,2119
3690,3514246749,3424445495,1672534035,1672534331,296
3459,3200543880,3710489491,1672674025,1672674804,779
3799,3513296868,3713517039,1672625311,1672625669,358
3534,3613338363,3480991549,1672608461,1672608715,254
3561,3703433819,3311498666,1672539457,1672540711,1254
3847,3533294425,3479851674,1672571307,1672574385,3078
3918,3835985172,3800257590,1672544439,1672545934,1495
3514,3512295534,3312998540,1672688591,1672691635,3044
3755,3533649454,3294747828,1672678305,1672679759,1454
3480,3900276517,3225636215,1672676742,1672677635,893
3530,3505888598,3396726504,1672590618,1672591679,1061
3835,3779656423,3467988782,1672586990,1672590318,3328
3615,3299125059,3607882826,1672559819,1672560181,362
3698,3755222916,3394401087,1672546212,1672546638,426
3457,3636329663,3607882826,1672602098,1672605621,3523
3662,3613899351,3793883863,1672551372,1672551862,490
3566,3618176292,3906536154,1672628043,1672631563,3520
3572,3462158237,3500525825,1672658500,1672660036,1536
3660,3202141727,3534764451,1672673102,1672675047,1945
3809,3451691949,3438489358,1672688397,1672689032,635
3805,3276348699,3710735406,1672541615,1672543007,1392
3831,3205923620,3776244398,1672606592,1672607416,824
3905,3462158237,3777779869,1672672026,1672675170,3144
3470,3610358027,3206837348,1672633674,1672637261,3587
3424,3390660440,3500347447,1672645370,1672645930,560
3778,3224330592,3688490530,1672579424,1672582153,2729
3534,3852533643,3779786641,1672585921,1672588044,2123
3544,3370068529,3402385957,1672573741,1672574160,419
3756,3534764451,3518561777,1672557410,1672558026,616
3460,3510499038,3209526819,1672685325,1672686520,1195
3832,3240394404,3414940786,1672567331,1672570277,2946
3620,3791046864,3889780657,1672703047,1672703218,171
3702,3360069849,3300229945,1672697229,1672700467,3238
3631,3757863420,3467779445,1672675904,1672677547,1643
3745,3559731671,3517358573,1672594732,1672595401,669
3459,3714678331,3779532653,1672566461,1672569985,3524
3765,3897134762,3487875183,1672631325,1672634879,3554
3721,3899326793,3475349791,1672623880,1672624640,760
3887,3220031931,3349739136,1672592092,1672593576,1484
3459,3374183227,3449639012,1672635188,1672638653,3465
3430,3730071479,3519282716,1672596432,1672599887,3455
3770,3492959689,3779532653,1672674081,1672675944,1863
3505,3979802715,3614740489,1672633261,1672634814,1553
3821,3791436104,3904867554,1672547268,1672548174,906
3869,3811075491,3633735593,1672653163,1672653434,271
3544,3630353876,3520560590,1672544150,1672544465,315
3520,3402697190,3715974659,1672625157,1672626203,1046
3882,3760040019,3938389661,1672636607,1672638795,2188
3833,3227799827,3631090677,1672666390,1672669097,2707
3463,3792949946,3777240360,1672580754,1672583529,2775
3863,3776518452,3807212280,1672591019,1672591801,782
3429,3457960571,3783801141,1672655172,1672658051,2879
3591,3817813340,3510767239,1672561254,1672561517,263
3665,3811040565,3802932312,1672532358,1672534052,1694
3914,3513853403,3517222913,1672569521,1672570680,1159
3756,3461119815,3773837847,1672625200,1672626722,1522
3573,3343132529,3793740407,1672564602,1672567327,2725
3802,3972083617,3445206685,1672535778,1672536842,1064
3519,3735374579,3609659642,1672560551,1672562374,1823
3659,3374183227,3792442597,1672602957,1672603091,134
3783,3500703304,3505923418,1672557146,1672559364,2218
3520,3836241528,3369708250,1672667087,1672670252,3165
3520,3760721303,3480490124,1672582902,1672583227,325
3740,3711000597,3777779869,1672689075,1672691341,2266
3768,3441703884,3520560590,1672535160,1672537969,2809
3495,3279473441,3833217041,1672620742,1672621804,1062
3630,3533368789,3710854064,1672627132,1672629684,2552
3847,3777189898,3284932450,1672703053,1672705156,2103
3853,3780872464,3777814504,1672551891,1672554244,2353
3584,3436025562,3760924079,1672608481,1672610696,2215
3729,3236458894,3755992176,1672562941,1672564243,1302
3794,3440137407,3774641380,1672540003,1672543342,3339
3590,3714120857,3513041785,1672692960,1672693252,292
3917,3668414677,3520181148,1672584691,1672586757,2066
3740,3485540729,3714067076,1672632396,1672633449,1053
3899,3772078494,3774641380,1672575567,1672578470,2903
3653,3294703680,3288224595,1672698941,1672699999,1058
3605,3271752081,3414940786,1672576422,1672577856,1434
3527,3400763927,3935399379,1672556140,1672559461,3321
3434,3793583656,3554186380,1672558478,1672558615,137
3484,3428725843,3552824113,1672562842,1672564269,1427
3613,3635169815,3364378127,1672633006,1672636320,3314
3690,3497808662,3551399764,1672670546,1672671220,674
3739,3276348699,3373028638,1672698985,1672699359,374
3797,3414940786,3270697740,1672573703,1672575784,2081
3830,3780253901,3774876004,1672679886,1672680468,582
3570,3517590837,3440137407,1672682492,1672684925,2433
3439,3230135532,3902625986,1672560195,1672563722,3527
3750,3347419520,3411515369,1672533828,1672536160,2332
3794,3512282789,3438489358,1672686524,1672688268,1744
3455,3519850727,3914691363,1672625614,1672626252,638
3789,3395201292,3777330107,1672607333,1672610280,2947
3527,3613416045,3760694096,1672555385,1672558237,2852
3733,3912891315,3780338697,1672599961,1672601553,1592
3832,3467779445,3517991730,1672699274,1672700896,1622
3776,3902861231,3779738691,1672552938,1672555607,2669
3570,3612689556,3783919913,1672637119,1672638374,1255
3857,3783163143,3777037426,1672658926,1672659993,1067
3496,3514512367,3438489358,1672686609,1672688601,1992
3683,3839245934,3402697190,1672650793,1672652709,1916
3627,3551399764,3509366311,1672683840,1672684467,627
3825,3457960571,3505283390,1672546907,1672547198,291
3860,3436257398,3609933747,1672567647,1672571035,3388
3442,3703798634,3512958459,1672569201,1672570993,1792
3697,3360069849,3770624662,1672703726,1672705517,1791
3775,3812534508,3554825448,1672676263,1672679812,3549
3663,3710315160,3236458894,1672604102,1672606575,2473
3812,3478114114,3449639012,1672569257,1672572626,3369
3772,3248058676,3240994288,1672543193,1672544923,1730
3820,3716110860,3777189898,1672627556,1672630500,2944
3725,3505283390,3713300120,1672570131,1672572493,2362
3581,3780338697,3511005395,1672534850,1672536689,1839
3525,3780427126,3791046864,1672660244,1672663728,3484
3527,3230868435,3230135532,1672663261,1672664486,1225
3876,3779613523,3627368399,1672643102,1672646310,3208
3863,3713768950,3500857494,1672672244,1672674197,1953
3838,3714120857,3341893384,1672535231,1672537045,1814
3564,3611055563,3241790910,1672701631,1672704709,3078
3770,3516703758,3226178937,1672627041,1672629220,2179
3443,3774733620,3927403123,1672679429,1672682769,3340
3588,3701373490,3614740489,1672565392,1672567114,1722
3495,3779938251,3627368399,1672591522,1672592890,1368
3833,3732131656,3974674109,1672679065,1672681533,2468
3466,3514308235,3387594369,1672650491,1672651595,1104
3688,3770468980,3688796737,1672593487,1672596738,3251
3525,3777240360,3415833929,1672701775,1672704090,2315
3496,3517590837,3394297564,1672688074,1672691182,3108
3725,3448633776,3770468980,1672684271,1672685224,953
3629,3505154885,3773913680,1672637180,1672640575,3395
3720,3341893384,3885121158,1672600245,1672601808,1563
3565,3792949946,3246370118,1672558917,1672561577,2660
3795,3500841914,3885155975,1672572125,1672572886,761
3669,3533747868,3206837348,1672680358,1672682526,2168
3769,3772765746,3402385957,1672689751,1672692624,2873
3555,3773902805,3776518452,1672600781,1672601403,622
3441,3514512367,3927403123,1672543125,1672545014,1889
3491,3311498666,3703798634,1672698638,1672700606,1968
3801,3500208903,3619922891,1672550955,1672554133,3178
3630,3512800570,3315703693,1672600473,1672603397,2924
3814,3513345163,3511150845,1672601097,1672602620,1523
3753,3514324011,3927165965,1672680519,1672681085,566
3909,3519416013,3755756564,1672602730,1672603721,991
3642,3609881958,3637313265,1672586718,1672588140,1422
3517,3715086894,3783433404,1672562178,1672563730,1552
3570,3534764451,3777184389,1672609760,1672611688,1928
3507,3370227921,3621184108,1672536020,1672539328,3308
3505,3401496246,3713911104,1672667502,1672668561,1059
3843,3435167810,3897376951,1672644403,1672645224,821
3456,3393063657,3774641380,1672677791,1672678285,494
3806,3533649454,3510641433,1672593232,1672596298,3066
3789,3371455553,3505111292,1672577269,1672577778,509
3882,3227799827,3517697722,1672545162,1672545568,406
3792,3505923418,3533294425,1672682135,1672684463,2328
3711,3801645328,3773121782,1672589738,1672590538,800
3443,3772391882,3829822608,1672692352,1672694639,2287
3894,3315279093,3909094917,1672569987,1672571658,1671
3445,3500442734,3501786419,1672665507,1672669024,3517
3644,3514703118,3803389195,1672590094,1672593151,3057
3803,3780209375,3783801141,1672575777,1672578926,3149
3772,3319167958,3902760230,1672596049,1672598677,2628
3759,3519142371,3396726504,1672532160,1672533373,1213
3682,3734915241,3711000597,1672683547,1672683978,431
3424,3839245934,3755065949,1672613467,1672615792,2325
3812,3613338363,3279475486,1672560930,1672563239,2309
3460,3500737582,3437286517,1672535970,1672538864,2894
3728,3513410578,3777485931,1672675753,1672679064,3311
3567,3481640525,3780712350,1672618817,1672621160,2343
3804,3456430614,3500044458,1672559757,1672563178,3421
3700,3472312341,3711218296,1672620647,1672621601,954
3537,3417191856,3627368399,1672639956,1672642517,2561
3614,3401793306,3514818819,1672552799,1672555895,3096
3429,3273981374,3500072204,1672566865,1672570055,3190
3898,3515439826,3518561777,1672561528,1672562043,515
3892,3480490124,3780872464,1672655121,1672658529,3408
3491,3635169815,3463849738,1672570750,1672574224,3474
3567,3500604680,3284947372,1672675776,1672679065,3289
3472,3607768197,3518561777,1672592280,1672594899,2619
3723,3300511067,3905899155,1672697213,1672698051,838
3586,3515401243,3701882224,1672647493,1672647943,450
3605,3701107228,3511732493,1672598020,1672598444,424
3724,3979784676,3511442562,1672531664,1672534573,2909
3673,3615113018,3280054198,1672577535,1672579034,1499
3902,3514956366,3779646172,1672666099,1672668395,2296
3861,3713941638,3491684096,1672644128,1672645824,1696
3807,3772078494,3509893027,1672625242,1672625892,650
3666,3755573472,3701823816,1672630272,1672631533,1261
3742,3208957949,3517697722,1672674202,1672677084,2882
3789,3792442597,3519077659,1672680192,1672683118,2926
3727,3393063657,3500525825,1672642700,1672645375,2675
3831,3409114719,3557046880,1672622745,1672625437,2692
3804,3437286517,3510641433,1672593013,1672595496,2483
3698,3450969839,3472312341,1672630818,1672631127,309
3459,3533188828,3520322124,1672674456,1672677336,2880
3676,3509483172,3792274796,1672622130,1672623534,1404
3768,3519850727,3337322736,1672641385,1672644336,2951
3601,3667673649,3343816795,1672613455,1672615605,2150
3690,3772078494,3755756564,1672667961,1672668829,868
3872,3399518841,3534543776,1672699159,1672701902,2743
3434,3667427125,3505228454,1672542120,1672544899,2779
3570,3412968120,3778134418,1672538140,1672540106,1966
3602,3510798825,3500302272,1672604267,1672604851,584
3771,3312998540,3701322924,1672535218,1672537053,1835
3634,3276269264,3887243870,1672679085,1672679768,683
3701,3385323994,3783163143,1672583232,1672585497,2265
3818,3439673892,3701424609,1672678450,1672678989,539
3637,3514246749,3927403123,1672591850,1672592795,945
3428,3715974659,3515439826,1672648975,1672652301,3326
3621,3501384020,3368283077,1672630625,1672633087,2462
3778,3760842815,3792525861,1672682568,1672683915,1347
3684,3970603231,3711853996,1672598246,1672599542,1296
3480,3552824113,3635169815,1672533478,1672537031,3553
3724,3610870949,3731646673,1672562982,1672565453,2471
3645,3505807416,3893912331,1672543812,1672545691,1879
3733,3362641275,3236499444,1672534707,1672537963,3256
3914,3224811762,3533004959,1672649785,1672653260,3475
3601,3500703304,3201676087,1672665177,1672665654,477
3750,3792072681,3330340793,1672678910,1672681225,2315
3868,3760721303,3559731671,1672696026,1672699316,3290
3479,3517687662,3500915665,1672664497,1672666014,1517
3880,3970558632,3384068080,1672568960,1672570154,1194
3584,3773033649,3972192593,1672687573,1672689891,2318
3899,3773027597,3793781065,1672590599,1672590675,76
3795,3613338363,3478114114,1672583514,1672584323,809
3627,3559731671,3791106564,1672693919,1672695136,1217
3830,3505283390,3920898925,1672555621,1672555832,211
3711,3533188828,3783136330,1672532050,1672533438,1388
3866,3689697817,3412968120,1672546286,1672549273,2987
3743,3334993594,3755737419,1672660067,1672663450,3383
3864,3311498666,3734118023,1672562075,1672563587,1512
3440,3979784676,3778667336,1672574190,1672574650,460
3792,3777147510,3818575661,1672630391,1672631287,896
3617,3283144118,3228888030,1672689487,1672690937,1450
3595,3714678331,3370227921,1672643112,1672646479,3367
3640,3512882178,3774718695,1672659974,1672663309,3335
3592,3294703680,3414049538,1672665473,1672667400,1927
3854,3516703758,3737112297,1672646760,1672647827,1067
3630,3284932450,3620292035,1672688795,1672690000,1205
3778,3905196766,3492959689,1672653314,1672655193,1879
3594,3714067076,3714827719,1672615764,1672618967,3203
3456,3780427126,3298151889,1672586159,1672587658,1499
3485,3559458968,3401940259,1672652938,1672653103,165
3703,3510554314,3912891315,1672598143,1672599783,1640
3633,3701136026,3791106564,1672703730,1672704032,302
3484,3408430195,3513853403,1672698548,1672699087,539
3852,3431460073,3701664364,1672655373,1672656642,1269
3608,3777779869,3516489668,1672577038,1672580391,3353
3716,3333403880,3334974375,1672594904,1672596728,1824
3457,3755233658,3610358027,1672551193,1672554334,3141
3644,3429943738,3774907131,1672672707,1672673312,605
3509,3392943173,3357289672,1672648876,1672652402,3526
3785,3367971170,3607768197,1672538523,1672538597,74
3555,3230135532,3311420950,1672640782,1672643090,2308
3701,3932478321,3636329663,1672687908,1672689882,1974
3517,3306175858,3371455553,1672671548,1672672575,1027
3690,3923420131,3298151889,1672618657,1672618735,78
3555,3613899351,3415833929,1672618965,1672621274,2309
3740,3607768197,3774733620,1672584415,1672585508,1093
3855,3688490530,3777779869,1672630831,1672631572,741
3713,3515466096,3970909253,1672658577,1672661574,2997
3512,3534175249,3716679950,1672581485,1672582236,751
3760,3780712350,3402385957,1672626993,1672628992,1999
3900,3635169815,3447514821,1672589221,1672590830,1609
3538,3554825448,3916490839,1672693643,1672695476,1833
3667,3380982774,3284947372,1672689166,1672690819,1653
3632,3226024417,3774733620,1672695484,1672697805,2321
3676,3455018347,3551376095,1672629621,1672632648,3027
3448,3904569677,3711077927,1672630592,1672632807,2215
3671,3928719932,3900276517,1672643974,1672645598,1624
3668,3632814465,3441348818,1672559374,1672561064,1690
3766,3226024417,3202141727,1672532135,1672532277,142
3641,3408430195,3792020993,1672587577,1672589006,1429
3592,3410600350,3926643445,1672635660,1672637118,1458
3900,3380130228,3534543776,1672538444,1672539870,1426
3795,3793781065,3505995057,1672539233,1672541877,2644
3622,3780909839,3410600350,1672630015,1672632534,2519
3803,3500498112,3773332082,1672565628,1672567505,1877
3884,3533090502,3777091903,1672648513,1672651366,2853
3798,3510919821,3780680950,1672558373,1672559242,869
3910,3800257590,3626499450,1672654944,1672656975,2031
3735,3303410628,3435167810,1672548903,1672551500,2597
3598,3611055563,3757863420,1672589623,1672592327,2704
3502,3492959689,3516741440,1672602087,1672603773,1686
3697,3480991549,3500703304,1672678464,1672679123,659
3428,3622357348,3441348818,1672538708,1672542075,3367
3596,3298151889,3701373490,1672701111,1672703465,2354
3659,3783433404,3480490124,1672642687,1672643437,750
3864,3492546679,3891672228,1672556493,1672558349,1856
3506,3514246749,3241790910,1672548183,1672549400,1217
3488,3520991398,3757332128,1672637429,1672640305,2876
3656,3509756823,3801645328,1672674657,1672676084,1427
3457,3979784676,3631090677,1672576378,1672579576,3198
3864,3227799827,3930242012,1672646778,1672647617,839
3878,3685816610,3517991730,1672677104,1672680370,3266
3735,3533747868,3701136026,1672556578,1672558981,2403
3768,3389634034,3713691388,1672694154,1672694440,286
3902,3519446663,3713829743,1672670380,1672673578,3198
3826,3457620713,3685681577,1672533788,1672536364,2576
3917,3412968120,3533079336,1672669392,1672671554,2162
3808,3773332082,3618354185,1672694913,1672697176,2263
3709,3520764926,3792014516,1672560836,1672560932,96
3453,3228888030,3551376095,1672546818,1672549424,2606
3493,3225636215,3909094917,1672700241,1672701384,1143
3475,3703348097,3938389661,1672703960,1672704675,715
3564,3714827719,3335694356,1672595168,1672597745,2577
3899,3299443125,3554825448,1672610419,1672612789,2370
3888,3914691363,3604867757,1672595434,1672597678,2244
3687,3446533960,3714666884,1672543851,1672546586,2735
3692,3208452238,3270056120,1672603888,1672606129,2241
3580,3298151889,3701823816,1672553628,1672554963,1335
3747,3931627862,3236499444,1672559548,1672561463,1915
3512,3385323994,3312998540,1672538390,1672540811,2421
3613,3703396825,3517172354,1672566532,1672569632,3100
3830,3236354255,3462273042,1672545677,1672548293,2616
3655,3636329663,3613581796,1672669612,1672672546,2934
3878,3713589994,3899326793,1672657747,1672658577,830
3868,3938503547,3533188828,1672663596,1672663873,277
3566,3770468980,3500915908,1672698788,1672702337,3549
3786,3778134418,3779892400,1672621885,1672624528,2643
3820,3363162590,3411688875,1672609068,1672612472,3404
3847,3505923418,3779938251,1672660547,1672662646,2099
3474,3904569677,3411515369,1672644745,1672647095,2350
3600,3683113954,3454277788,1672564097,1672566508,2411
3593,3701107228,3715443333,1672654767,1672657115,2348
3922,3226024417,3624297844,1672681707,1672685149,3442
3747,3793743698,3552824113,1672637911,1672641377,3466
3750,3463740710,3776084820,1672689167,1672692241,3074
3900,3780909839,3755848152,1672533620,1672535886,2266
3569,3246370118,3737972328,1672583560,1672584767,1207
3801,3756474459,3552824113,1672535555,1672537544,1989
3482,3977148669,3330340793,1672661095,1672664506,3411
3531,3923220461,3829864515,1672699721,1672699852,131
3731,3357289672,3449333754,1672696115,1672698259,2144
3865,3737972328,3701322924,1672571186,1672573580,2394
3535,3232208416,3757294769,1672597821,1672600220,2399
3438,3815250107,3472068734,1672610097,1672610673,576
3671,3714128600,3756746867,1672681795,1672684687,2892
3729,3500915665,3363162590,1672581466,1672581664,198
3641,3793743698,3779301501,1672546942,1672548089,1147
3876,3491469603,3512337405,1672540696,1672543026,2330
3534,3470454332,3457620713,1672599953,1672600902,949
3602,3512946768,3900276517,1672568734,1672571115,2381
3882,3429943738,3511601997,1672600262,1672603597,3335
3609,3688220326,3938503547,1672621360,1672623784,2424
3534,3334974375,3934064792,1672689171,1672690201,1030
3712,3429943738,3501215099,1672635183,1672635327,144
3584,3783771827,3379143440,1672581003,1672583864,2861
3586,3451326054,3533090502,1672623586,1672626880,3294
3714,3347446226,3384583385,1672565518,1672567735,2217
3799,3905899155,3505725706,1672683821,1672686975,3154
3583,3701884158,3779786641,1672649469,1672651398,1929
3429,3905899155,3774290799,1672677870,1672678862,992
3832,3480991549,3855583256,1672596786,1672597352,566
3677,3349856820,3551389192,1672560174,1672563212,3038
3689,3779854934,3633735593,1672613526,1672616160,2634
3725,3510837901,3934064792,1672537610,1672537817,207
3708,3516321888,3780427126,1672642370,1672644117,1747
3508,3492546679,3615939504,1672556936,1672560533,3597
3896,3779892400,3512392431,1672675441,1672676864,1423
3607,3899786664,3668747074,1672623454,1672626929,3475
3615,3710735406,3501215099,1672616266,1672617040,774
3686,3715443333,3783771827,1672683659,1672684690,1031
3623,3778134418,3408430195,1672679663,1672682689,3026
3667,3276348699,3620292035,1672532690,1672535469,2779
3645,3395201292,3350095157,1672635570,1672636940,1370
3657,3505198734,3912891315,1672635873,1672636844,971
3832,3638204468,3613338363,1672574127,1672574958,831
3638,3379143440,3617392620,1672624108,1672625440,1332
3484,3793922324,3774290799,1672545006,1672547795,2789
3678,3276348699,3337322736,1672620397,1672622786,2389
3619,3715443333,3510187271,1672701413,1672702421,1008
3487,3354144091,3513410578,1672561731,1672564378,2647
3798,3421877923,3755532873,1672649605,1672653013,3408
3439,3480100311,3447514821,1672553008,1672555648,2640
3661,3891672228,3715127070,1672584670,1672587799,3129
3572,3493017654,3493017654,1672630626,1672631123,497
3743,3757193307,3897435944,1672639689,1672641657,1968
3715,3884596900,3760640999,1672627540,1672628304,764
3713,3835985172,3613581796,1672532770,1672534370,1600
3814,3500498112,3399518841,1672543134,1672543493,359
3745,3401793306,3791753345,1672621670,1672624586,2916
3734,3505228454,3760694096,1672559180,1672560420,1240
3602,3791106564,3517697722,1672664590,1672666887,2297
3456,3617304541,3756127300,1672576372,1672578593,2221
3682,3779656423,3715385401,1672561124,1672561467,343
3432,3815392801,3500044458,1672698118,1672701532,3414
3488,3350095157,3715707380,1672629435,1672632610,3175
3753,3639050419,3500703304,1672687099,1672688030,931
3786,3516444201,3791106564,1672635094,1672637488,2394
3488,3389634034,3938503547,1672553946,1672554285,339
3641,3792505974,3756127300,1672703020,1672705194,2174
3836,3716110860,3891672228,1672547092,1672550290,3198
3910,3607882826,3977148669,1672693857,1672694832,975
3912,3615939504,3501459390,1672590703,1672590863,160
3824,3716628503,3905196766,1672612597,1672612673,76
3672,3777814504,3757863420,1672565028,1672567542,2514
3603,3701247948,3777147510,1672572173,1672575489,3316
3507,3399472693,3501281016,1672607465,1672610325,2860
3734,3285204083,3783163143,1672649990,1672651755,1765
3657,3386758279,3852533643,1672572236,1672574678,2442
3917,3710489491,3288224595,1672694545,1672694969,424
3828,3393063657,3517991730,1672596591,1672596965,374
3759,3416987084,3366423342,1672610051,1672613541,3490
3728,3304155815,3490029863,1672608529,1672609109,580
3492,3520181148,3305722859,1672675041,1672678040,2999
3674,3604589802,3516489668,1672570763,1672572973,2210
3818,3520416075,3511883730,1672565030,1672566430,1400
3607,3609881958,3890739241,1672547838,1672548187,349
3521,3515401243,3770624662,1672543090,1672544271,1181
3861,3779938251,3703433819,1672543293,1672544394,1101
3641,3505178849,3362641275,1672693253,1672695953,2700
3778,3509483172,3505179890,1672654026,1672654248,222
3505,3774705415,3783169442,1672559893,1672560178,285
3478,3501215099,3776244398,1672666881,1672669325,2444
3436,3410600350,3500341755,1672695344,1672695758,414
3558,3935399379,3773902805,1672647752,1672648625,873
3821,3701664364,3336339664,1672552834,1672553304,470
3658,3829864515,3330340793,1672534815,1672536865,2050
3436,3337322736,3510641433,1672620862,1672622386,1524
3867,3619922891,3833217041,1672677080,1672680276,3196
3662,3814305099,3357864626,1672636309,1672638038,1729
3655,3519142371,3283492940,1672607258,1672607759,501
3500,3400763927,3701005527,1672604999,1672608556,3557
3851,3755532873,3401496246,1672671391,1672671982,591
3603,3501121099,3923220461,1672660786,1672661010,224
3917,3972192593,3714666884,1672548172,1672549483,1311
3714,3519077659,3858172636,1672698168,1672700620,2452
3549,3856606678,3533294425,1672591268,1672592567,1299
3571,3713979100,3283770991,1672583314,1672586400,3086
3807,3514324011,3928511283,1672537981,1672540735,2754
3553,3774876004,3497808662,1672556828,1672557740,912
3481,3792801638,3613581796,1672537416,1672538186,770
3738,3609659642,3402697190,1672623207,1672624645,1438
3735,3783615982,3855583256,1672694897,1672696230,1333
3464,3756385685,3311049964,1672542949,1672545083,2134
3636,3513327337,3460719322,1672645459,1672648122,2663
3778,3448875382,3517600136,1672591957,1672595250,3293
3477,3519651506,3791613604,1672537049,1672537803,754
3690,3779646172,3336627643,1672629822,1672632506,2684
3673,3428027649,3559458968,1672594172,1672596271,2099
3705,3334974375,3398731252,1672595157,1672595487,330
3594,3713163045,3510818674,1672616598,1672617805,1207
3589,3309314379,3271752081,1672596729,1672599652,2923
3597,3780427126,3492546679,1672601626,1672602277,651
3632,3852686295,3469254160,1672692033,1672695118,3085
3462,3515401243,3739895284,1672678977,1672682348,3371
3504,3513360004,3225029895,1672697800,1672700637,2837
3758,3711812325,3519142371,1672643989,1672644062,73
3851,3349739136,3772765746,1672616164,1672616269,105
3560,3607882826,3803389195,1672635350,1672637842,2492
3592,3607882826,3514956366,1672639399,1672641293,1894
3612,3770520359,3402385957,1672687351,1672687472,121
3435,3513081354,3931627862,1672550554,1672552417,1863
3660,3777330107,3783340788,1672582576,1672584542,1966
3803,3714120857,3334647380,1672640241,1672641502,1261
3783,3513853403,3979784676,1672566846,1672568225,1379
3715,3783433404,3516298579,1672656238,1672657429,1191
3648,3283492940,3245232284,1672533262,1672536743,3481
3811,3780322355,3533649454,1672684446,1672687760,3314
3699,3400069268,3533188828,1672562467,1672563520,1053
3913,3200308999,3755065949,1672702829,1672705308,2479
3750,3488686442,3783641602,1672627869,1672629196,1327
3681,3408498208,3774733620,1672668275,1672670613,2338
3720,3451726367,3451726367,1672572258,1672574816,2558
3772,3757318448,3201629017,1672674169,1672675442,1273
3821,3604867757,3374183227,1672653763,1672654319,556
3768,3703348097,3357689359,1672608739,1672610541,1802
3562,3615688740,3451691949,1672675524,1672678694,3170
3515,3713561276,3334993594,1672658911,1672660757,1846
3542,3780253901,3385323994,1672559591,1672562505,2914
3441,3684523966,3899326793,1672547415,1672548401,986
3694,3209526819,3333918941,1672585143,1672585501,358
3838,3455018347,3435167810,1672613753,1672614943,1190
3886,3387594369,3760362417,1672535202,1672537255,2053
3434,3517687662,3518194482,1672701260,1672703312,2052
3648,3410160376,3276269264,1672538477,1672540457,1980
3704,3793868716,3711812325,1672642856,1672646236,3380
3670,3755848152,3367111751,1672662087,1672665591,3504
3574,3414049538,3703139663,1672641131,1672644258,3127
3690,3615737355,3467779445,1672685714,1672687567,1853
3889,3312998540,3711097754,1672602098,1672604259,2161
3604,3791106564,3617304541,1672669314,1672671204,1890
3866,3703139663,3920625129,1672633775,1672634875,1100
3774,3920497528,3895285664,1672638439,1672639858,1419
3739,3793418209,3893912331,1672702174,1672704846,2672
3918,3472312341,3777814504,1672676001,1672676688,687
3650,3668414677,3516703758,1672545057,1672545910,853
3542,3480726047,3604589802,1672676131,1672676414,283
3827,3835985172,3559458968,1672684133,1672685290,1157
3666,3824215187,3280268483,1672543757,1672545247,1490
3617,3557046880,3229822507,1672539731,1672541239,1508
3704,3513345163,3972192593,1672637203,1672640422,3219
3556,3380767040,3347446226,1672579835,1672582419,2584
3633,3500613459,3512295534,1672616014,1672617896,1882
3894,3513345163,3519850727,1672638546,1672639158,612
3726,3534543776,3793969543,1672667314,1672670697,3383
3449,3500703304,3938503547,1672686806,1672689128,2322
3658,3225631197,3513018485,1672667064,1672670098,3034
3706,3460719322,3703348097,1672555064,1672556497,1433
3517,3715400486,3779786641,1672676295,1672679555,3260
3552,3396980894,3505634634,1672613989,1672616053,2064
3775,3450969839,3618176292,1672562931,1672565190,2259
3457,3756704774,3402697190,1672556217,1672556801,584
3913,3517687662,3510818674,1672572947,1672575453,2506
3584,3467988782,3472068734,1672608289,1672610703,2414
3633,3511005395,3621461051,1672644606,1672644679,73
3609,3520181148,3600876425,1672574924,1672576586,1662
3762,3390660440,3534357694,1672604295,1672607421,3126
3835,3445206685,3793418209,1672572818,1672575164,2346
3691,3710008361,3469254160,1672675775,1672677745,1970
3699,3505807416,3451726367,1672562084,1672563988,1904
3920,3834960360,3271454397,1672697744,1672701205,3461
3697,3519077659,3834960360,1672560450,1672562047,1597
3461,3312998540,3436025562,1672544639,1672545002,363
3693,3472312341,3514419100,1672657053,1672658024,971
3559,3534179433,3757332128,1672620404,1672622027,1623
3901,3500613459,3773027597,1672594489,1672594975,486
3710,3755992176,3303410628,1672584356,1672584456,100
3528,3511024016,3517288083,1672627751,1672631338,3587
3911,3755573472,3777814504,1672558173,1672558565,392
3549,3459681410,3756474459,1672578292,1672580863,2571
3894,3410538749,3386758279,1672640887,1672643752,2865
3906,3835422146,3511288998,1672621499,1672622971,1472
3662,3316798920,3414275042,1672693698,1672694363,665
3655,3305336154,3778134418,1672657122,1672660294,3172
3539,3835985172,3534566651,1672550507,1672553128,2621
3611,3755496114,3612689556,1672611112,1672611904,792
3807,3791046864,3294747828,1672619744,1672620306,562
3706,3783928182,3226511603,1672600660,1672604069,3409
3771,3514971533,3492546679,1672603613,1672604065,452
3787,3731646673,3899326793,1672612081,1672615246,3165
3749,3631090677,3279242917,1672672505,1672672650,145
3448,3515466096,3774790271,1672692381,1672693892,1511
3446,3300818269,3449333754,1672568713,1672571349,2636
3424,3533649454,3408430195,1672640201,1672641069,868
3565,3757383891,3472068734,1672533521,1672535974,2453
3578,3778040015,3411688875,1672538866,1672540114,1248
3915,3519077659,3485540729,1672645198,1672647904,2706
3809,3280268483,3514971533,1672637956,1672640480,2524
3782,3205923620,3774641380,1672545687,1672546239,552
3844,3780209375,3446533960,1672551650,1672553573,1923
3536,3756625818,3316800320,1672617256,1672620197,2941
3635,3770236215,3716628503,1672627546,1672629592,2046
3585,3714120857,3615737355,1672536458,1672538354,1896
3803,3779738691,3374183227,1672584623,1672585463,840
3450,3350095157,3824641227,1672622779,1672623207,428
3534,3713163045,3517222913,1672582965,1672585344,2379
3469,3500777439,3487875183,1672637245,1672639462,2217
3573,3711812325,3492546679,1672615414,1672615851,437
3746,3300511067,3714670620,1672693644,1672697069,3425
3735,3276269264,3831586487,1672646763,1672647502,739
3565,3774718695,3272716462,1672651990,1672652868,878
3523,3631479562,3501525100,1672554690,1672557002,2312
3543,3441348818,3311085279,1672681349,1672681797,448
3716,3520560590,3791436104,1672543459,1672545493,2034
3749,3683113954,3817428320,1672685799,1672688676,2877
3913,3311049964,3780115155,1672701867,1672703698,1831
3614,3364378127,3714128600,1672560894,1672561759,865
3875,3229822507,3793883863,1672635960,1672636996,1036
3629,3510642075,3701882224,1672554303,1672555543,1240
3647,3760842815,3774031303,1672668384,1672668551,167
3474,3625174002,3557046880,1672666318,1672667140,822
3580,3760640999,3367509761,1672629355,1672631177,1822
3440,3514308235,3500827202,1672594415,1672597414,2999
3498,3625174002,3455018347,1672623212,1672623804,592
3640,3703383853,3638204468,1672579254,1672579841,587
3562,3424445495,3760842815,1672644708,1672648049,3341
3881,3624297844,3510641433,1672564502,1672567548,3046
3720,3713163045,3853629553,1672544511,1672546022,1511
3718,3519028898,3757348722,1672558540,1672559410,870
3693,3701136026,3680810086,1672627323,1672629784,2461
3753,3511288998,3791046864,1672658866,1672662197,3331
3712,3488763230,3533929349,1672676370,1672678493,2123
3757,3890739241,3414275042,1672543110,1672546383,3273
3491,3757863420,3559731671,1672532333,1672533393,1060
3558,3627368399,3364378127,1672670202,1672671173,971
3556,3893912331,3734118023,1672533055,1672534630,1575
3883,3520355798,3514419100,1672547015,1672547455,440
3553,3815392801,3475349791,1672621796,1672623282,1486
3625,3410538749,3839245934,1672683201,1672686796,3595
3910,3200543880,3500613493,1672648985,1672651769,2784
3630,3515525630,3715986185,1672532599,1672535507,2908
3599,3701373490,3770146716,1672700670,1672701382,712
3839,3505888598,3468041839,1672625220,1672628217,2997
3502,3783163143,3661447322,1672695157,1672696715,1558
3665,3756746867,3501281016,1672532797,1672536184,3387
3725,3710048469,3620292035,1672646126,1672649155,3029
3513,3202141727,3773837847,1672637604,1672640730,3126
3706,3792442597,3773332082,1672577135,1672578069,934
3545,3500442734,3364726656,1672640724,1672644255,3531
3465,3660063072,3610358027,1672598056,1672601199,3143
3891,3559731671,3783136330,1672654163,1672656556,2393
3548,3481640525,3380767040,1672678707,1672679885,1178
3478,3600876425,3517590837,1672547620,1672550326,2706
3817,3615087943,3510499038,1672595798,1672595863,65
3725,3516741440,3793743698,1672683434,1672684026,592
3640,3713911104,3665998641,1672660975,1672664154,3179
3824,3979784676,3319167958,1672670625,1672671199,574
3817,3938389661,3461119815,1672638177,1672640405,2228
3898,3926643445,3714678331,1672571272,1672572563,1291
3600,3783641602,3780712350,1672664694,1672665707,1013
3524,3776988674,3410160376,1672642989,1672644517,1528
3600,3513327337,3517172354,1672669749,1672671312,1563
3682,3776988674,3928511283,1672565631,1672567752,2121
3715,3938389661,3773027597,1672635782,1672637530,1748
3922,3904569677,3938503547,1672628096,1672629101,1005
3673,3776831527,3819767045,1672604921,1672605155,234
3509,3688220326,3916490839,1672562865,1672564108,1243
3474,3825881598,3783641602,1672682561,1672684739,2178
3739,3703396825,3715986185,1672619060,1672620039,979
3886,3734915241,3226178937,1672587341,1672590308,2967
3738,3459681410,3300818269,1672577714,1672578086,372
3532,3703139663,3285204083,1672626147,1672626971,824
3799,3770624662,3615115210,1672592925,1672593533,608
3759,3497671225,3757318448,1672623865,1672626759,2894
3585,3815392801,3462636434,1672615825,1672617837,2012
3793,3715974659,3779646172,1672641340,1672642077,737
3560,3773939399,3510641433,1672549679,1672551328,1649
3570,3552824113,3755848152,1672624611,1672626481,1870
3571,3884596900,3618697021,1672558849,1672560803,1954
3836,3738026330,3512800570,1672621021,1672624097,3076
3883,3617392620,3612689556,1672631001,1672631145,144
3594,3715545685,3884596900,1672659800,1672662417,2617
3629,3811040565,3635169815,1672651737,1672654893,3156
3632,3885537225,3280054198,1672531672,1672533253,1581
3584,3756704774,3513295938,1672678991,1672681746,2755
3586,3665998641,3438078818,1672686627,1672689093,2466
3467,3380767040,3411688875,1672669003,1672669811,808
3473,3977148669,3316800320,1672671135,1672673974,2839
3503,3710854064,3780769110,1672597743,1672598156,413
3764,3226511603,3774733620,1672554139,1672557726,3587
3793,3367111751,3834963772,1672659744,1672661835,2091
3818,3736231757,3783373154,1672560180,1672562524,2344
3648,3661583097,3424660806,1672697989,1672700071,2082
3885,3343132529,3713979100,1672660677,1672662389,1712
3592,3977352557,3488686442,1672644801,1672647784,2983
3457,3410160376,3513327337,1672630313,1672632186,1873
3564,3500857494,3440137407,1672580079,1672582320,2241
3659,3970198861,3428027649,1672551242,1672553864,2622
3650,3519077659,3513345163,1672668232,1672671095,2863
3658,3505111292,3793781065,1672703636,1672704014,378
3439,3825881598,3608855425,1672588812,1672589261,449
3895,3520355798,3202141727,1672629667,1672630513,846
3667,3271752081,3271752081,1672540405,1672543769,3364
3888,3792014516,3517600136,1672563481,1672563660,179
3661,3513296868,3711000597,1672573519,1672574862,1343
3602,3510028805,3627368399,1672587589,1672589613,2024
3524,3284947372,3897134762,1672696726,1672697082,356
3755,3513410578,3279475486,1672698978,1672701419,2441
3588,3701424609,3299443125,1672561486,1672563455,1969
3466,3311498666,3780209375,1672551891,1672553141,1250
3512,3800257590,3272096759,1672597457,1672600206,2749
3436,3421877923,3774907131,1672545467,1672548763,3296
3834,3897435944,3625463628,1672549994,1672553255,3261
3491,3338083680,3703348097,1672544490,1672546356,1866
3770,3518565331,3972192593,1672635088,1672635975,887
3472,3701664364,3270697740,1672592080,1672593422,1342
3558,3518561777,3611055563,1672664804,1672666398,1594
3514,3783928182,3777694660,1672566954,1672569709,2755
3650,3500341755,3773124276,1672568507,1672571197,2690
3842,3510642075,3402385957,1672587876,1672590982,3106
3745,3517697722,3713941638,1672560167,1672560958,791
3858,3513345163,3757630221,1672634436,1672635044,608
3561,3615087943,3205985903,1672656509,1672659863,3354
3462,3814677862,3505995057,1672552266,1672553756,1490
3444,3760364383,3270697740,1672584603,1672584840,237
3435,3225631197,3884596900,1672664362,1672666756,2394
3692,3776034743,3294703680,1672678978,1672681309,2331
3903,3505154885,3334951866,1672653298,1672655247,1949
3845,3380982774,3780209375,1672545979,1672547606,1627
3733,3510554314,3368283077,1672558304,1672561168,2864
3602,3514324011,3460719322,1672695454,1672697197,1743
3424,3514334067,3885121158,1672632952,1672636474,3522
3782,3713768950,3510028805,1672656300,1672658279,1979
3564,3923220461,3755915206,1672617265,1672620807,3542
3857,3714666884,3513853403,1672631550,1672634413,2863
3444,3511601997,3703383853,1672600877,1672603922,3045
3596,3512830734,3970603231,1672581602,1672584536,2934
3584,3336627643,3808136029,1672557940,1672560899,2959
3802,3619922891,3701322924,1672562809,1672564700,1891
3854,3739661856,3793922324,1672589727,1672590978,1251
3827,3710008361,3288762795,1672542117,1672545048,2931
3434,3757193307,3500949309,1672602435,1672604128,1693
3617,3392520516,3807212280,1672574265,1672575424,1159
3796,3469254160,3803389195,1672648662,1672651765,3103
3598,3739895284,3829822608,1672632799,1672636186,3387
3860,3271454397,3512722110,1672546786,1672548639,1853
3457,3716963089,3511150845,1672639589,1672640583,994
3482,3375449013,3283770991,1672675887,1672676022,135
3567,3770676872,3455018347,1672534420,1672536700,2280
3602,3272030610,3778040015,1672604562,1672606215,1653
3733,3836241528,3739154408,1672555667,1672557143,1476
3863,3500777439,3792505974,1672560434,1672560532,98
3794,3514308235,3305336154,1672584571,1672585362,791
3449,3635169815,3343132529,1672674619,1672676091,1472
3845,3925979970,3904569677,1672601047,1672603082,2035
3462,3505198734,3680843171,1672606207,1672607478,1271
3521,3520873221,3755915206,1672607721,1672608032,311
3690,3974674109,3500613459,1672539870,1672542408,2538
3867,3519909393,3714128600,1672559547,1672561258,1711
3518,3792745809,3372223551,1672669625,1672672552,2927
3505,3271454397,3517881647,1672537736,1672540164,2428
3512,3714678331,3500442734,1672541720,1672544982,3262
3802,3713300120,3793883863,1672647514,1672650764,3250
3861,3238288884,3505481368,1672663647,1672666259,2612
3454,3505663516,3557046880,1672561323,1672561617,294
3778,3518565331,3778640261,1672575258,1672578394,3136
3771,3205923620,3611055563,1672703266,1672706222,2956
3620,3734451191,3376467719,1672541543,1672544522,2979
3612,3774155692,3516444201,1672657775,1672659854,2079
3595,3283492940,3225636215,1672696370,1672699146,2776
3682,3902760230,3274906650,1672534372,1672536655,2283
3774,3451726367,3505888598,1672598366,1672601252,2886
3881,3401496246,3510641433,1672642254,1672644082,1828
3782,3792538417,3559731671,1672642885,1672643608,723
3823,3824641227,3791613604,1672629749,1672632645,2896
3805,3755344363,3501215099,1672691384,1672694677,3293
3919,3807212280,3500525825,1672532834,1672533105,271
3557,3609881958,3892304880,1672628013,1672631019,3006
3773,3533004959,3755496114,1672637338,1672640773,3435
3693,3618697021,3817813340,1672537241,1672538364,1123
3701,3611055563,3920625129,1672676073,1672676809,736
3559,3632814465,3463849738,1672668095,1672670306,2211
3858,3923420131,3519818818,1672680067,1672680487,420
3564,3624297844,3970627281,1672590178,1672591516,1338
3750,3855583256,3626499450,1672539212,1672542572,3360
3540,3710496785,3501215099,1672566558,1672567881,1323
3434,3900945856,3349739136,1672596523,1672598083,1560
3633,3451326054,3637313265,1672702210,1672703279,1069
3917,3472068734,3470454332,1672554703,1672554887,184
3872,3714678331,3914691363,1672699217,1672700277,1060
3920,3900898992,3932478321,1672547101,1672547277,176
3631,3454277788,3927165965,1672551505,1672554977,3472
3721,3490029863,3757348722,1672700893,1672703928,3035
3757,3497095254,3667427125,1672656465,1672658720,2255
3818,3509893027,3777485931,1672655989,1672657690,1701
3789,3626499450,3898314440,1672630390,1672631428,1038
3428,3491469603,3777189898,1672697145,1672699219,2074
3901,3920625129,3520115090,1672680374,1672683920,3546
3890,3533423872,3780834916,1672598275,1672598828,553
3674,3605221116,3246370118,1672585457,1672588863,3406
3846,3783147088,3515559913,1672540944,1672543417,2473
3449,3366423342,3512379024,1672541713,1672542385,672
3519,3783136330,3514818819,1672582802,1672584894,2092
3727,3621184108,3288224595,1672563333,1672564479,1146
3752,3620292035,3367509761,1672576156,1672578255,2099
3733,3812534508,3923220461,1672647252,1672649549,2297
3646,3513360004,3792389522,1672570793,1672573276,2483
3439,3686227677,3777189898,1672609294,1672610342,1048
3633,3755222916,3511791953,1672570733,1672573063,2330
3428,3730071479,3755756564,1672699539,1672700662,1123
3650,3902625986,3609933747,1672664150,1672666020,1870
3511,3834963772,3713561276,1672613603,1672615357,1754
3441,3385323994,3618697021,1672609793,1672611832,2039
3804,3609881958,3928511283,1672628259,1672629881,1622
3500,3783433404,3609113156,1672552840,1672555964,3124
3454,3757903168,3773033649,1672693232,1672693850,618
3544,3639050419,3637313265,1672575819,1672576488,669
3674,3756385685,3755344363,1672601966,1672603301,1335
3917,3778640261,3755344363,1672561920,1672562996,1076
3902,3337362061,3410538749,1672684916,1672686554,1638
3525,3777091903,3557046880,1672582515,1672585385,2870
3745,3701107228,3462158237,1672639969,1672641673,1704
3615,3970909253,3315703693,1672676785,1672680145,3360
3852,3773124276,3979784676,1672623357,1672624776,1419
3508,3613581796,3438489358,1672591668,1672594065,2397
3839,3661447322,3519416013,1672620250,1672622414,2164
3735,3773033649,3520355798,1672579489,1672582320,2831
3920,3505154885,3367509761,1672583684,1672583985,301
3588,3500208903,3793315718,1672572533,1672575249,2716
3496,3517172354,3438489358,1672554340,1672555663,1323
3623,3533004959,3701136026,1672551214,1672552355,1141
3715,3446533960,3451326054,1672585335,1672586644,1309
3801,3505111292,3209481722,1672568703,1672572150,3447
3852,3779646172,3445206685,1672567134,1672569735,2601
3464,3299443125,3505888598,1672576063,1672576443,380
3732,3714666884,3711000597,1672693514,1672696457,2943
3692,3500737582,3779738691,1672649506,1672650580,1074
3810,3636329663,3792525861,1672647662,1672648903,1241
3810,3793175445,3533188828,1672580193,1672582896,2703
3829,3274906650,3776117322,1672632775,1672635904,3129
3568,3792489602,3620292035,1672538774,1672540207,1433
3903,3665998641,3770468980,1672666670,1672667420,750
3458,3774876004,3276348699,1672628595,1672631112,2517
3595,3513295938,3660063072,1672557374,1672559059,1685
3718,3208957949,3514419100,1672541106,1672544201,3095
3861,3683113954,3755737419,1672587542,1672588358,816
3586,3300229945,3701884158,1672698920,1672700959,2039
3505,3923420131,3411688875,1672572490,1672573531,1041
3909,3451691949,3516489668,1672561595,1672561989,394
3435,3310125159,3802932312,1672583845,1672584096,251
3585,3497808662,3774733620,1672627097,1672629227,2130
3876,3926643445,3227799827,1672617259,1672617386,127
3475,3401793306,3928511283,1672684655,1672684896,241
3607,3734451191,3793922324,1672533222,1672533658,436
3856,3617489344,3792546035,1672650947,1672651354,407
3641,3756127300,3396980894,1672535859,1672536934,1075
3516,3470454332,3774641380,1672596497,1672596852,355
3745,3394401087,3774178201,1672578243,1672580835,2592
3645,3497671225,3362641275,1672632810,1672634782,1972
3535,3360616538,3516298579,1672661406,1672663235,1829
3424,3715854030,3770704999,1672688398,1672691194,2796
3439,3505481368,3389634034,1672579651,1672579926,275
3481,3825881598,3343132529,1672549119,1672550264,1145
3710,3224968597,3229822507,1672583785,1672584112,327
3710,3713829743,3519818818,1672583587,1672585687,2100
3724,3202141727,3617304541,1672587823,1672589217,1394
3634,3715443333,3897376951,1672538376,1672539491,1115
3648,3272096759,3803517637,1672610582,1672613060,2478
3698,3667673649,3279242917,1672548284,1672551584,3300
3568,3505266860,3777330107,1672692266,1672694899,2633
3598,3773902805,3783373154,1672662278,1672664996,2718
3643,3714678331,3435167810,1672665571,1672666670,1099
3464,3357289672,3780472203,1672638565,1672642070,3505
3914,3500442734,3516321888,1672639276,1672640126,850
3646,3519909393,3755404116,1672556282,1672558675,2393
3704,3415833929,3776518452,1672581863,1672583157,1294
3472,3520657891,3611055563,1672643303,1672643587,284
3782,3534764451,3714678331,1672551262,1672553059,1797
3904,3701136026,3230868435,1672678693,1672679666,973
3612,3500841914,3364726656,1672658560,1672661708,3148
3793,3208452238,3515890966,1672686395,1672689107,2712
3454,3294747828,3906536154,1672679809,1672680343,534
3914,3776831527,3792525861,1672658639,1672660365,1726
3837,3772391882,3333918941,1672590582,1672593478,2896
3695,3505402439,3533649454,1672657915,1672659853,1938
3709,3898314440,3970603231,1672605349,1672606411,1062
3849,3459681410,3979784676,1672560489,1672562759,2270
3480,3500709774,3500827202,1672682065,1672684559,2494
3668,3334647380,3617304541,1672566439,1672567784,1345
3864,3205985903,3774605761,1672619283,1672621625,2342
3670,3520560590,3755233658,1672675490,1672676609,1119
3680,3516298579,3777091903,1672630652,1672630964,312
3425,3814305099,3551376095,1672571734,1672573224,1490
3639,3404025196,3360069849,1672657919,1672658664,745
3442,3387594369,3306412634,1672654758,1672655197,439
3843,3519028898,3713517039,1672677328,1672678093,765
3916,3274906650,3337362061,1672669607,1672669858,251
3792,3777037426,3296462324,1672552210,1672553063,853
3763,3551389192,3609113156,1672695914,1672698291,2377
3844,3371455553,3518653080,1672627575,1672627682,107
3454,3364726656,3462158237,1672701759,1672704566,2807
3716,3520578796,3791246640,1672636186,1672639613,3427
3788,3517358573,3755915206,1672680237,1672680656,419
3868,3279339278,3505888598,1672621721,1672622831,1110
3727,3773124276,3383138270,1672583031,1672585896,2865
3451,3274831810,3500498112,1672693491,1672696468,2977
3670,3509764635,3516444201,1672677101,1672678634,1533
3772,3791106564,3315703693,1672677826,1672679786,1960
3557,3518229776,3440137407,1672617908,1672621395,3487
3720,3224330592,3773009828,1672574411,1672576577,2166
3747,3938503547,3783433404,1672544921,1672547835,2914
3692,3791246640,3514324011,1672542048,1672542376,328
3708,3713768950,3732131656,1672540737,1672541593,856
3797,3519446663,3617392620,1672624366,1672626415,2049
3475,3447672935,3904412440,1672656440,1672658635,2195
3594,3279473441,3533747868,1672652705,1672655187,2482
3734,3609933747,3617116290,1672696750,1672698133,1383
3906,3836241528,3505283390,1672633818,1672635156,1338
3430,3509893027,3516741440,1672661380,1672661937,557
3740,3615087943,3534179433,1672573742,1672574625,883
3572,3497095254,3736231757,1672621080,1672622590,1510
3733,3516513251,3975717896,1672625192,1672627403,2211
3561,3609113156,3300818269,1672692266,1672694286,2020
3740,3713163045,3398198430,1672699999,1672702397,2398
3558,3714067076,3604589802,1672683818,1672685386,1568
3857,3505178849,3511288998,1672693133,1672695333,2200
3918,3815250107,3779646172,1672570171,1672573236,3065
3817,3621790707,3418448389,1672694734,1672695989,1255
3565,3283492940,3779465522,1672619884,1672620188,304
3473,3920625129,3205923620,1672574313,1672574486,173
3712,3291933594,3714670620,1672552848,1672556176,3328
3654,3414940786,3516741440,1672564591,1672565194,603
3461,3512383699,3370227921,1672622472,1672625556,3084
3757,3534357694,3714120857,1672581884,1672585445,3561
3776,3710735406,3533274994,1672685673,1672689103,3430
3513,3312998540,3615115210,1672701641,1672703829,2188
3823,3791246640,3519446663,1672548093,1672550256,2163
3760,3511791953,3975717896,1672638580,1672639084,504
3559,3757318448,3688796737,1672637063,1672639774,2711
3613,3501786419,3897376951,1672683542,1672684774,1232
3770,3773124276,3288224595,1672543270,1672543483,213
3906,3821054646,3274831810,1672536207,1672536830,623
3879,3276217799,3713979100,1672614099,1672614426,327
3736,3488686442,3272096759,1672686737,1672687139,402
3461,3533090502,3755848152,1672538174,1672538430,256
3633,3610870949,3402385957,1672603155,1672605877,2722
3756,3501384020,3934064792,1672584295,1672586181,1886
3607,3279339278,3310039260,1672559381,1672560090,709
3661,3774907131,3905899155,1672696174,1672699763,3589
3759,3410538749,3904867554,1672631447,1672633464,2017
3482,3783147088,3500604680,1672606764,1672607688,924
3834,3777694660,3441703884,1672606073,1672609170,3097
3637,3773837847,3556969573,1672676097,1672676561,464
3605,3701005527,3312998540,1672658426,1672660193,1767
3675,3519909393,3512882178,1672625195,1672627396,2201
3837,3774178201,3970909253,1672568597,1672571998,3401
3541,3834960360,3783801141,1672545482,1672547870,2388
3438,3793407963,3501457103,1672611650,1672613995,2345
3432,3770624662,3461119815,1672697245,1672700415,3170
3872,3715707380,3512295534,1672534980,1672537780,2800
3817,3462636434,3505847380,1672536036,1672536201,165
3733,3472312341,3791046864,1672542446,1672544346,1900
3704,3285204083,3336627643,1672625551,1672628165,2614
3750,3440137407,3226024417,1672679297,1672681417,2120
3520,3559731671,3668533536,1672567461,1672568063,602
3860,3515466096,3478114114,1672601703,1672602560,857
3609,3505634634,3279475486,1672633467,1672633856,389
3644,3370227921,3618489670,1672546001,1672547231,1230
3824,3429943738,3710562338,1672575048,1672578349,3301
3889,3373089838,3336339664,1672617207,1672618224,1017
3885,3271454397,3668747074,1672683409,1672683479,70
3663,3512830734,3516444201,1672602088,1672602322,234
3912,3438078818,3450969839,1672696483,1672699528,3045
3918,3780253901,3533423872,1672702731,1672703530,799
3692,3370068529,3512830734,1672703697,1672706829,3132
3636,3518565331,3631479562,1672556373,1672557274,901
3658,3713300120,3520657891,1672558290,1672561850,3560
3904,3927403123,3778926763,1672610655,1672610908,253
3781,3760263530,3357289672,1672549264,1672550879,1615
3673,3438078818,3350095157,1672692865,1672695256,2391
3523,3435167810,3520560590,1672644390,1672646855,2465
3784,3780872464,3417191856,1672690324,1672692409,2085
3475,3783771827,3500341755,1672542449,1672545838,3389
3578,3401793306,3914691363,1672695168,1672696763,1595
3845,3520657891,3517222913,1672677395,1672678043,648
3686,3713784974,3284947372,1672643763,1672644988,1225
3808,3512502036,3201629017,1672635277,1672635677,400
3643,3607768197,3500857494,1672607666,1672610719,3053
3487,3500109249,3779465522,1672534336,1672535461,1125
3869,3443357683,3520578796,1672588811,1672589763,952
3698,3451326054,3201800997,1672619404,1672622570,3166
3564,3417679834,3272096759,1672591014,1672593161,2147
3491,3401940259,3600876425,1672571148,1672571641,493
3456,3710048469,3792525861,1672666179,1672667174,995
3903,3224968597,3621790707,1672663278,1672665866,2588
3595,3362641275,3760094385,1672661739,1672663241,1502
3480,3777037426,3519028898,1672605800,1672606289,489
3675,3897134762,3515559913,1672616255,1672618695,2440
3618,3792274796,3534357694,1672566350,1672569644,3294
3428,3274906650,3932478321,1672621974,1672623067,1093
3905,3756746867,3791441520,1672550020,1672553275,3255
3534,3411688875,3505521218,1672661378,1672663656,2278
3699,3394401087,3289114629,1672588602,1672588895,293
3719,3246370118,3760640999,1672679596,1672683076,3480
3535,3384068080,3534175249,1672589486,1672593038,3552
3697,3852533643,3394401087,1672657229,1672660414,3185
3672,3505198734,3904867554,1672626049,1672629550,3501
3548,3615113018,3779646172,1672637086,1672637579,493
3752,3475349791,3492546679,1672620516,1672623016,2500
3712,3757863420,3360813161,1672641848,1672643775,1927
3439,3783136330,3780872464,1672606983,1672607456,473
3605,3516321888,3462158237,1672684154,1672685417,1263
3787,3294747828,3534566651,1672533563,1672535390,1827
3463,3316798920,3755496114,1672642255,1672642599,344
3546,3777091903,3680843171,1672620441,1672621512,1071
3675,3279475486,3779786641,1672568978,1672570656,1678
3875,3279473441,3491469603,1672559583,1672562926,3343
3479,3608232640,3224330592,1672537305,1672539208,1903
3763,3757348722,3934064792,1672597000,1672597216,216
3884,3501121099,3714185969,1672569309,1672570697,1388
3525,3519651506,3505481368,1672616550,1672616762,212
3755,3760842815,3859868849,1672684868,1672686988,2120
3566,3714128600,3734118023,1672656492,1672659120,2628
3789,3505663516,3635169815,1672543107,1672544338,1231
3477,3793922324,3396980894,1672606308,1672607098,790
3508,3776244398,3448633776,1672535572,1672536118,546
3702,3783520186,3457620713,1672699531,1672701893,2362
3914,3756704774,3520991398,1672687133,1672687833,700
3444,3338083680,3311098437,1672678766,1672679206,440
3828,3402385957,3701322924,1672674693,1672674883,190
3609,3736231757,3783147088,1672560417,1672563126,2709
3529,3519028898,3519142371,1672597664,1672600385,2721
3583,3783433404,3686523546,1672625637,1672628957,3320
3703,3236458894,3780680950,1672670997,1672671767,770
3686,3905196766,3713561276,1672592439,1672592653,214
3720,3783169442,3230135532,1672679704,1672682820,3116
3722,3755233658,3615737355,1672532811,1672534847,2036
3723,3715385401,3501384020,1672559916,1672561004,1088
3917,3892304880,3783163143,1672694010,1672695094,1084
3921,3617304541,3686523546,1672619872,1672620291,419
3652,3793583656,3777779869,1672681146,1672682249,1103
3767,3710315160,3414275042,1672609414,1672609951,537
3686,3774641380,3451726367,1672570700,1672573555,2855
3637,3448633776,3792072681,1672681757,1672684463,2706
3554,3385323994,3513545422,1672681841,1672684314,2473
3716,3932478321,3635169815,1672686709,1672688877,2168
3734,3938503547,3897134762,1672652081,1672653388,1307
3440,3760842815,3777485931,1672621391,1672622685,1294
3848,3685681577,3379143440,1672618339,1672618810,471
3798,3803389195,3791796585,1672533683,1672535317,1634
3595,3792014516,3520115090,1672627741,1672628424,683
3595,3241790910,3501121099,1672595516,1672597488,1972
3446,3834963772,3384068080,1672621047,1672621802,755
3599,3271454397,3631090677,1672640660,1672642615,1955
3505,3685681577,3610870949,1672675183,1672676919,1736
3892,3319167958,3514818819,1672686521,1672688710,2189
3619,3620292035,3835422146,1672613469,1672615634,2165
3751,3808136029,3685816610,1672643967,1672646071,2104
3909,3930242012,3392520516,1672583411,1672584512,1101
3850,3791246640,3713768950,1672694929,1672698421,3492
3713,3511317276,3514818819,1672576662,1672580038,3376
3807,3731646673,3716628503,1672641300,1672641404,104
3567,3612689556,3386758279,1672648830,1672652314,3484
3637,3716628503,3683113954,1672681265,1672683591,2326
3476,3280268483,3280268483,1672690834,1672690954,120
3775,3519850727,3511843593,1672618871,1672620446,1575
3839,3505663516,3791441520,1672678746,1672680872,2126
3663,3448875382,3792949946,1672636050,1672637283,1233
3580,3315279093,3780472203,1672564251,1672565374,1123
3668,3395201292,3701424609,1672559412,1672561290,1878
3524,3757700712,3755532873,1672669297,1672670413,1116
3786,3716628503,3481640525,1672604542,1672607128,2586
3686,3716963089,3760651515,1672614906,1672615968,1062
3535,3636329663,3737147209,1672656861,1672658321,1460
3489,3757383891,3638660068,1672585796,1672586814,1018
3526,3500072204,3514971533,1672625641,1672626902,1261
3628,3304155815,3510964997,1672658925,1672661721,2796
3591,3770520359,3421385957,1672653771,1672657189,3418
3871,3554944414,3500703304,1672629031,1672631581,2550
3485,3520639768,3792442597,1672695818,1672698054,2236
3596,3334951866,3773837847,1672588684,1672591056,2372
3565,3732131656,3401496246,1672562401,1672563104,703
3496,3448875382,3468041839,1672598211,1672599023,812
3674,3514741348,3513853403,1672548715,1672551143,2428
3802,3619922891,3333403880,1672559568,1672561145,1577
3555,3519282716,3715086894,1672583135,1672586245,3110
3479,3451726367,3520873221,1672654822,1672658055,3233
3795,3409114719,3621461051,1672665572,1672668322,2750
3648,3354144091,3437286517,1672644275,1672644780,505
3696,3517737088,3713829743,1672600497,1672600718,221
3775,3898314440,3511791953,1672627765,1672629082,1317
3883,3374183227,3755848152,1672535439,1672537117,1678
3429,3230135532,3515402792,1672575752,1672578265,2513
3685,3732131656,3513410578,1672534774,1672537183,2409
3586,3500317969,3205985903,1672670663,1672674112,3449
3595,3715986185,3500703304,1672703358,1672706562,3204
3670,3479851674,3773121782,1672641228,1672643767,2539
3662,3519850727,3621184108,1672632791,1672635565,2774
3672,3401793306,3500347447,1672634109,1672636391,2282
3717,3509483172,3225029895,1672570637,1672570708,71
3700,3815392801,3858172636,1672684023,1672686947,2924
3600,3773121782,3201676087,1672574553,1672577333,2780
3460,3505888598,3497671225,1672643986,1672645614,1628
3739,3500613493,3513327337,1672578693,1672581442,2749
3921,3617392620,3777091903,1672639245,1672642185,2940
3909,3618808151,3885121158,1672566214,1672566719,505
3435,3447672935,3500347447,1672542907,1672543308,401
3574,3931627862,3300818269,1672640438,1672641197,759
3822,3776117322,3209526819,1672666617,1672668164,1547
3854,3387594369,3635169815,1672681814,1672682660,846
3572,3271454397,3510641433,1672618565,1672619696,1131
3632,3505154885,3376467719,1672550058,1672551874,1816
3481,3713517039,3895285664,1672677877,1672679958,2081
3611,3622665543,3792274796,1672538237,1672540621,2384
3569,3449639012,3755496114,1672698440,1672700496,2056
3433,3505437712,3770468980,1672595236,1672595952,716
3573,3780680950,3505481368,1672675313,1672678510,3197
3880,3733363628,3736705719,1672645723,1672649280,3557
3685,3469254160,3792801638,1672598390,1672598722,332
3784,3899326793,3701005527,1672579134,1672581469,2335
3751,3713941638,3500341755,1672604254,1672604530,276
3643,3716628503,3615688740,1672604284,1672607567,3283
3884,3270056120,3623266256,1672633773,1672636295,2522
3514,3755230952,3776518452,1672670231,1672673304,3073
3790,3505266860,3716272919,1672650290,1672652657,2367
3727,3363162590,3517590837,1672565786,1672567463,1677
3646,3739154408,3392520516,1672558268,1672560710,2442
3527,3812534508,3783615982,1672659852,1672662078,2226
3708,3505178849,3661447322,1672702336,1672705405,3069
3834,3772391882,3814677862,1672698547,1672700798,2251
3540,3618489670,3791046864,1672553911,1672557354,3443
3718,3512800570,3462636434,1672634747,1672635804,1057
3847,3280268483,3852686295,1672581160,1672584034,2874
3635,3505521218,3928719932,1672656539,1672659813,3274
3815,3613581796,3715086894,1672609485,1672610052,567
3473,3791796585,3505402439,1672660427,1672662282,1855
3835,3757332128,3514971533,1672602302,1672603178,876
3597,3713911104,3428725843,1672653489,1672656925,3436
3797,3778899160,3372223551,1672662546,1672664553,2007
3648,3685816610,3398198430,1672676649,1672678568,1919
3467,3271454397,3512383699,1672699545,1672699828,283
3494,3248058676,3398198430,1672675421,1672676932,1511
3599,3815392801,3783163143,1672628276,1672628657,381
3815,3885155975,3401496246,1672613623,1672616498,2875
3629,3519446663,3513018485,1672555284,1672557399,2115
3630,3755573472,3713163045,1672531796,1672534792,2996
3726,3515466096,3935399379,1672611420,1672611634,214
3804,3225636215,3392943173,1672684802,1672686615,1813
3568,3801645328,3533004959,1672536560,1672538080,1520
3851,3518565331,3311085279,1672697712,1672699796,2084
3828,3505923418,3514246749,1672667860,1672670565,2705
3814,3927165965,3517600136,1672578019,1672578266,247
3739,3834631333,3311098437,1672595202,1672598188,2986
3530,3510837901,3236354255,1672699596,1672700205,609
3575,3478114114,3513295938,1672615966,1672617068,1102
3650,3236354255,3715443333,1672558245,1672560277,2032
3481,3930242012,3371455553,1672605106,1672607701,2595
3655,3554825448,3300511067,1672550815,1672551191,376
3717,3783550022,3760263530,1672685357,1672686347,990
3754,3392520516,3209481722,1672647769,1672648189,420
3499,3701247948,3975717896,1672690728,1672691538,810
3666,3617304541,3780712350,1672595209,1672595531,322
3476,3517222913,3505888598,1672585777,1672589131,3354
3899,3852686295,3271752081,1672615657,1672618328,2671
3779,3274831810,3232208416,1672672110,1672673873,1763
3523,3487875183,3518229776,1672653897,1672657103,3206
3471,3557046880,3491684096,1672645911,1672646231,320
3791,3379143440,3447514821,1672592556,1672593054,498
3782,3341893384,3667673649,1672580781,1672583582,2801
3908,3774155692,3519028898,1672582411,1672584232,1821
3670,3516741440,3513327337,1672575150,1672576076,926
3897,3556969573,3855583256,1672597000,1672597320,320
3902,3421385957,3516903528,1672703250,1672706669,3419
3627,3512958459,3783520186,1672594142,1672595679,1537
3652,3779738691,3514246749,1672676009,1672678783,2774
3470,3711812325,3451726367,1672548286,1672549898,1612
3514,3447514821,3884596900,1672671077,1672673650,2573
3608,3779613523,3715127070,1672562786,1672562935,149
3535,3778134418,3930242012,1672700476,1672704017,3541
3593,3778667336,3511732493,1672547977,1672550054,2077
3911,3245232284,3736231757,1672570557,1672572110,1553
3792,3240394404,3793922324,1672629422,1672631930,2508
3595,3438078818,3316800320,1672687730,1672689452,1722
3535,3440137407,3421877923,1672598237,1672600488,2251
3873,3898314440,3817813340,1672588027,1672590351,2324
3775,3757075324,3209481722,1672546446,1672549175,2729
3524,3665998641,3517358573,1672651242,1672651401,159
3792,3270697740,3791753345,1672567558,1672569011,1453
3462,3401793306,3900898992,1672582549,1672583978,1429
3749,3554825448,3817813340,1672690090,1672692176,2086
3426,3793781065,3452016771,1672669511,1672672742,3231
3754,3770676872,3713300120,1672541183,1672544080,2897
3724,3833217041,3491469603,1672669865,1672671561,1696
3831,3609933747,3715974659,1672537690,1672540555,2865
3710,3711077927,3520355798,1672702806,1672704376,1570
3851,3756385685,3513296868,1672546111,1672547812,1701
3509,3792274796,3780834916,1672537317,1672539154,1837
3445,3534829213,3501384020,1672700792,1672703723,2931
3734,3517687662,3701424609,1672594962,1672597372,2410
3723,3271752081,3393063657,1672588368,1672591526,3158
3622,3780769110,3977352557,1672691058,1672694057,2999
3559,3395201292,3610870949,1672642397,1672645806,3409
3701,3760040019,3701884158,1672575289,1672577955,2666
3656,3779854934,3308760650,1672623767,1672626290,2523
3703,3668414677,3815392801,1672580676,1672581313,637
3815,3533004959,3793583656,1672625736,1672627015,1279
3842,3668747074,3385323994,1672544585,1672547863,3278
3573,3500613493,3793175445,1672561919,1672562606,687
3564,3316800320,3360616538,1672650637,1672652878,2241
3519,3505888598,3510641433,1672612099,1672614871,2772
3607,3289817992,3711734586,1672645615,1672646320,705
3435,3354144091,3402385957,1672624509,1672624969,460
3864,3500915665,3770296583,1672621052,1672624555,3503
3771,3270042456,3246370118,1672617605,1672617877,272
3708,3519850727,3711919537,1672675591,1672676773,1182
3899,3617392620,3639050419,1672650099,1672653459,3360
3705,3228888030,3349856820,1672543220,1672546365,3145
3806,3783615982,3462273042,1672687764,1672687923,159
3818,3534566651,3715986185,1672624192,1672626703,2511
3585,3305336154,3889780657,1672570305,1672573568,3263
3623,3500072204,3490214516,1672700972,1672701788,816
3653,3276269264,3467779445,1672580491,1672581480,989
3490,3792546035,3899326793,1672632446,1672634133,1687
3915,3416987084,3497095254,1672537537,1672540813,3276
3713,3417191856,3783136330,1672586947,1672588422,1475
3848,3280268483,3923420131,1672607886,1672608742,856
3604,3334974375,3500347447,1672698185,1672701236,3051
3856,3618176292,3839245934,1672642839,1672642964,125
3872,3610358027,3411688875,1672598992,1672601949,2957
3662,3343816795,3970909253,1672653400,1672653463,63
3651,3472312341,3933894942,1672535290,1672536087,797
3817,3505154885,3688490530,1672539939,1672542677,2738
3776,3512282789,3367509761,1672664668,1672667627,2959
3579,3468041839,3760263530,1672541481,1672543715,2234
3920,3467779445,3533929349,1672650773,1672654053,3280
3803,3520991398,3408430195,1672612022,1672614581,2559
3745,3701823816,3713517039,1672604045,1672604754,709
3472,3505402439,3793935736,1672561476,1672564312,2836
3893,3276217799,3519909393,1672581024,1672583500,2476
3799,3495911207,3780680950,1672581834,1672582582,748
3902,3923420131,3685816610,1672567290,1672569875,2585
3424,3760094385,3305336154,1672545947,1672549335,3388
3579,3793922324,3780115155,1672674534,1672674899,365
3531,3341893384,3311498666,1672534119,1672534879,760
3660,3512722110,3815250107,1672539653,1672542361,2708
3868,3497808662,3774876004,1672696825,1672698108,1283
3773,3632814465,3497095254,1672541188,1672542589,1401
3828,3621683102,3480100311,1672593384,1672596643,3259
3731,3510919821,3311085279,1672561205,1672561982,777
3754,3713979100,3756625818,1672649593,1672652189,2596
3558,3480991549,3756789525,1672614228,1672614968,740
3651,3310125159,3500613459,1672561123,1672562147,1024
3759,3201629017,3711919537,1672662618,1672665634,3016
3880,3668747074,3850911686,1672611418,1672614878,3460
3575,3380130228,3885155975,1672576684,1672579561,2877
3739,3520639768,3977148669,1672556087,1672558703,2616
3919,3773572967,3501525100,1672687647,1672688399,752
3523,3515890966,3203538212,1672543242,1672545122,1880
3557,3220031931,3440107959,1672664133,1672664843,710
3815,3774178201,3803389195,1672580731,1672582514,1783
3898,3232208416,3514308235,1672555815,1672559284,3469
3511,3499217428,3661583097,1672670633,1672672661,2028
3630,3631479562,3614740489,1672577120,1672577257,137
3797,3680810086,3779656423,1672581448,1672583554,2106
3795,3780253901,3436257398,1672605261,1672607868,2607
3835,3288224595,3613581796,1672696647,1672699387,2740
3540,3783771827,3505198734,1672555291,1672557467,2176
3811,3815392801,3760364383,1672614190,1672617553,3363
3690,3311498666,3283770991,1672548513,1672551605,3092
3869,3714670620,3511883730,1672691971,1672695032,3061
3679,3349856820,3380982774,1672660437,1672660516,79
3454,3734915241,3450969839,1672601070,1672601756,686
3512,3501786419,3895285664,1672597209,1672598656,1447
3635,3855583256,3334974375,1672693350,1672694352,1002
3636,3520322124,3680810086,1672589557,1672593122,3565
3540,3467779445,3533090502,1672620268,1672623483,3215
3711,3396980894,3610358027,1672629490,1672632670,3180
3880,3780571086,3500317969,1672657786,1672658089,303
3858,3686523546,3428725843,1672573557,1672574242,685
3510,3334993594,3615737355,1672596608,1672597039,431
3763,3398198430,3610870949,1672694600,1672697792,3192
3770,3505923418,3300229945,1672695492,1672696565,1073
3427,3272096759,3714185969,1672592770,1672593986,1216
3802,3495911207,3774641380,1672574462,1672575864,1402
3668,3513853403,3783373154,1672681491,1672682518,1027
3566,3711000597,3710562338,1672537110,1672539974,2864
3694,3757700712,3793922324,1672631566,1672633758,2192
3458,3559731671,3447514821,1672616244,1672619043,2799
3446,3902625986,3293835352,1672541530,1672542421,891
3649,3604867757,3364726656,1672578096,1672579296,1200
3635,3791753345,3438489358,1672635591,1672636956,1365
3900,3779613523,3276269264,1672543869,1672544314,445
3637,3756789525,3755065949,1672599928,1672601794,1866
3866,3226511603,3605221116,1672553908,1672556307,2399
3785,3975717896,3920497528,1672668387,1672669549,1162
3549,3779854934,3533649454,1672620402,1672621057,655
3880,3517358573,3791046864,1672540496,1672540672,176
3730,3514971533,3517590837,1672684271,1672684415,144
3466,3713561276,3624297844,1672692171,1672693596,1425
3475,3776518452,3935913584,1672595082,1672596986,1904
3852,3500109249,3497808662,1672656011,1672656240,229
3598,3500841914,3626499450,1672671125,1672672066,941
3436,3410538749,3500341755,1672549335,1672552496,3161
3700,3410538749,3367509761,1672639701,1672639835,134
3802,3451691949,3505634634,1672563614,1672566009,2395
3659,3631090677,3435167810,1672566750,1672567737,987
3637,3615087943,3777694660,1672622673,1672626085,3412
3883,3510499038,3713561276,1672673248,1672676248,3000
3876,3468041839,3447672935,1672558877,1672559306,429
3801,3373089838,3511024016,1672649676,1672652567,2891
3835,3289114629,3779465522,1672686994,1672687943,949
3458,3380130228,3756127300,1672634150,1672637609,3459
3454,3777624586,3315279093,1672600739,1672602937,2198
3427,3703139663,3509764635,1672615268,1672615416,148
3478,3451691949,3792538417,1672687566,1672688913,1347
3785,3512499658,3276217799,1672703744,1672705243,1499
3897,3793740407,3612689556,1672583614,1672584003,389
3494,3779892400,3701884158,1672588539,1672589462,923
3887,3285204083,3459681410,1672586330,1672588910,2580
3463,3351696332,3299443125,1672564853,1672565375,522
3559,3511883730,3772765746,1672643186,1672645700,2514
3827,3783169442,3333918941,1672590615,1672591009,394
3576,3772078494,3512337405,1672618752,1672621905,3153
3650,3774290799,3311085279,1672627744,1672630019,2275
3586,3739911441,3773837847,1672655268,1672658534,3266
3669,3776831527,3703798634,1672600952,1672601748,796
3604,3714827719,3500613493,1672548148,1672549866,1718
3500,3392520516,3513853403,1672612962,1672616176,3214
3609,3755344363,3305336154,1672551000,1672553677,2677
3626,3618697021,3774733620,1672552688,1672554965,2277
3635,3519446663,3505481368,1672648999,1672650724,1725
3680,3514246749,3885121158,1672581072,1672584527,3455
3538,3853629553,3514419100,1672693246,1672696158,2912
3597,3276269264,3855583256,1672703919,1672705137,1218
3473,3505178849,3457960571,1672586451,1672586608,157
3629,3760645796,3686227677,1672593267,1672594562,1295
3770,3505888598,3779639983,1672645649,1672646979,1330
3557,3534357694,3382733096,1672555448,1672555995,547
3679,3710735406,3516513251,1672692243,1672693890,1647
3758,3970558632,3451326054,1672654833,1672657650,2817
3791,3927165965,3520991398,1672669196,1672672580,3384
3804,3778040015,3205985903,1672647646,1672648342,696
3591,3226178937,3512392431,1672546961,1672550438,3477
3919,3501121099,3780872464,1672616141,1672619248,3107
3425,3515559913,3898314440,1672602020,1672604881,2861
3543,3733363628,3510641433,1672574682,1672575385,703
3922,3664943873,3501281016,1672618040,1672618230,190
3515,3500703304,3373089838,1672685526,1672687485,1959
3884,3533228966,3440137407,1672567656,1672569333,1677
3829,3283770991,3755756564,1672628233,1672628652,419
3594,3360813161,3389634034,1672687545,1672688286,741
3521,3814305099,3514275974,1672642171,1672645242,3071
3481,3811040565,3310125159,1672634086,1672636662,2576
3434,3513081354,3802932312,1672591024,1672594156,3132
3862,3711006062,3462158237,1672542541,1672542615,74
3805,3272716462,3688220326,1672589715,1672590454,739
3757,3773121782,3770520359,1672695453,1672697918,2465
3899,3905196766,3779738691,1672540538,1672540637,99
3449,3852533643,3932478321,1672584080,1672585340,1260
3696,3688796737,3495911207,1672557465,1672559980,2515
3847,3514971533,3279242917,1672694511,1672697442,2931
3649,3351866415,3661903000,1672659969,1672661426,1457
3675,3710496785,3755848152,1672554335,1672557285,2950
3898,3938503547,3209481722,1672667447,1672668054,607
3509,3240394404,3755573472,1672535474,1672535617,143
3568,3970198861,3778899160,1672632086,1672633360,1274
3536,3513410578,3701884158,1672634243,1672636761,2518
3704,3239617320,3792274796,1672583989,1672585465,1476
3891,3337362061,3495911207,1672587332,1672589787,2455
3479,3793868716,3737972328,1672667456,1672667656,200
3644,3209526819,3373028638,1672622800,1672624870,2070
3864,3513345163,3500613459,1672575460,1672575849,389
3914,3760721303,3202141727,1672696454,1672698852,2398
3477,3505434346,3760645796,1672634298,1672636391,2093
3657,3509366311,3509764635,1672587727,1672590870,3143
3683,3618489670,3974674109,1672660408,1672662920,2512
3641,3780769110,3716628503,1672679340,1672681969,2629
3795,3333403880,3515402792,1672611953,1672614551,2598
3547,3205923620,3935487534,1672567506,1672568507,1001
3492,3819767045,3205985903,1672557303,1672559527,2224
3910,3776559988,3935399379,1672552677,1672553061,384
3748,3664943873,3812369928,1672615729,1672617394,1665
3443,3343816795,3396726504,1672610464,1672611295,831
3670,3900276517,3778040015,1672545981,1672549514,3533
3657,3512383699,3392836218,1672608265,1672609472,1207
3443,3713911104,3203538212,1672606798,1672608932,2134
3717,3715385401,3970603231,1672548993,1672550595,1602
3495,3807212280,3905899155,1672596970,1672599649,2679
3785,3497808662,3755573472,1672689651,1672692221,2570
3911,3739661856,3554825448,1672679748,1672682712,2964
3551,3414275042,3491684096,1672663080,1672666204,3124
3555,3245232284,3773027597,1672702175,1672703853,1678
3746,3920898925,3230135532,1672583239,1672584099,860
3870,3514419100,3283492940,1672554090,1672556178,2088
3565,3448633776,3226178937,1672551460,1672552647,1187
3701,3485540729,3793315718,1672696692,1672700251,3559
3742,3512882178,3739895284,1672653098,1672654726,1628
3776,3885121158,3517358573,1672580531,1672583345,2814
3540,3480991549,3899326793,1672649040,1672650656,1616
3837,3333403880,3638660068,1672631792,1672633231,1439
3615,3513327337,3485540729,1672653012,1672655409,2397
3812,3731646673,3414940786,1672665379,1672668403,3024
3618,3472312341,3792389522,1672668073,1672668636,563
3605,3533649454,3814677862,1672632214,1672633898,1684
3448,3421877923,3928719932,1672615838,1672618598,2760
3705,3777485931,3630353876,1672679171,1672681781,2610
3590,3411515369,3760640999,1672678124,1672678304,180
3543,3899786664,3467779445,1672598407,1672600949,2542
3591,3495911207,3404025196,1672569967,1672570333,366
3443,3370068529,3428027649,1672531937,1672533753,1816
3429,3755496114,3316798920,1672597394,1672599910,2516
3853,3208452238,3701882224,1672644221,1672646925,2704
3705,3938389661,3834631333,1672553901,1672555703,1802
3611,3208957949,3276348699,1672626125,1672627241,1116
3753,3770520359,3505481368,1672557865,1672560255,2390
3776,3387594369,3511732493,1672625461,1672628785,3324
3879,3519909393,3638660068,1672649396,1672652794,3398
3819,3367971170,3511442562,1672684461,1672685306,845
3659,3396980894,3774155692,1672700861,1672704270,3409
3751,3909094917,3904867554,1672563563,1672566764,3201
3585,3812534508,3236458894,1672652046,1672653292,1246
3689,3792014516,3226178937,1672596901,1672600284,3383
3575,3899326793,3756625818,1672546771,1672548759,1988
3837,3760094385,3520560590,1672618186,1672618258,72
3800,3394401087,3757318448,1672589322,1672591807,2485
3585,3512882178,3390660440,1672590761,1672593799,3038
3523,3668747074,3680810086,1672592084,1672593172,1088
3758,3610358027,3411688875,1672590939,1672592103,1164
3548,3755404116,3608855425,1672565471,1672565907,436
3914,3774155692,3236354255,1672628498,1672631764,3266
3649,3739895284,3208957949,1672535570,1672537974,2404
3605,3625463628,3351866415,1672605589,1672608441,2852
3561,3605221116,3621184108,1672585008,1672588192,3184
3601,3383138270,3899326793,1672539545,1672540324,779
3572,3334647380,3777240360,1672645632,1672646869,1237
3880,3462158237,3793781065,1672546322,1672547194,872
3667,3811040565,3835985172,1672620344,1672623041,2697
3828,3733558985,3226178937,1672697060,1672698594,1534
3494,3792546035,3360813161,1672544409,1672547198,2789
3705,3701882224,3792949946,1672562545,1672564247,1702
3593,3711097754,3716272919,1672697545,1672699662,2117
3841,3757863420,3819767045,1672664683,1672666085,1402
3547,3777779869,3291933594,1672619333,1672622027,2694
3670,3900276517,3421385957,1672545946,1672547513,1567
3495,3638660068,3500347447,1672574091,1672574627,536
3508,3859868849,3491469603,1672647729,1672648243,514
3557,3373028638,3778597171,1672701476,1672701623,147
3630,3520764926,3715619259,1672677522,1672680173,2651
3560,3402385957,3711734586,1672643190,1672643401,211
3768,3609881958,3900945856,1672684593,1672684893,300
3539,3669146016,3716679950,1672586719,1672588032,1313
3761,3912891315,3778640261,1672610613,1672612482,1869
3770,3892304880,3334647380,1672673144,1672675313,2169
3838,3398198430,3770676872,1672688557,1672689681,1124
3885,3792949946,3417191856,1672663474,1672667001,3527
3911,3517590837,3608855425,1672668378,1672669704,1326
3590,3500208903,3510964997,1672593846,1672594665,819
3490,3777779869,3440137407,1672655760,1672657066,1306
3716,3306175858,3755848152,1672534152,1672535334,1182
3487,3739154408,3621184108,1672656854,1672657574,720
3667,3349739136,3226178937,1672627313,1672627382,69
3782,3608855425,3783136330,1672690963,1672692031,1068
3592,3755158925,3755992176,1672566819,1672568152,1333
3663,3491469603,3773913680,1672670777,1672671679,902
3720,3398198430,3519077659,1672563552,1672566476,2924
3904,3559731671,3480490124,1672616553,1672618550,1997
3695,3379143440,3271454397,1672603602,1672607131,3529
3424,3514275974,3783771827,1672536439,1672537506,1067
3616,3451691949,3711734586,1672551795,1672554019,2224
3614,3668414677,3299125059,1672563295,1672565886,2591
3866,3773027597,3757348722,1672627128,1672630097,2969
3695,3793935736,3552824113,1672683890,1672684865,975
3556,3511732493,3760721303,1672635097,1672638299,3202
3650,3517600136,3511883730,1672603503,1672604563,1060
3487,3757294769,3714128600,1672699028,1672699981,953
3612,3515402792,3772391882,1672630464,1672631310,846
3520,3793418209,3711006062,1672610616,1672613920,3304
3475,3441703884,3505663516,1672660631,1672662643,2012
3806,3774605761,3823084403,1672658763,1672659416,653
3460,3757193551,3688490530,1672698864,1672701504,2640
3782,3776988674,3715086894,1672695413,1672698228,2815
3776,3533079336,3779786641,1672559660,1672561707,2047
3765,3668533536,3716963089,1672564021,1672565008,987
3750,3760040019,3780427126,1672694975,1672696751,1776
3868,3487875183,3520657891,1672634802,1672636431,1629
3838,3505847380,3392520516,1672684138,1672685744,1606
3604,3933894942,3515439826,1672554228,1672556120,1892
3503,3493017654,3755344363,1672550881,1672553303,2422
3866,3935487534,3920625129,1672585010,1672587813,2803
3594,3617392620,3792072681,1672542719,1672545321,2602
3862,3533079336,3777624586,1672640810,1672643255,2445
3813,3779646172,3715974659,1672535543,1672537516,1973
3461,3500915908,3777184389,1672620953,1672623385,2432
3647,3661903000,3609113156,1672610932,1672614477,3545
3441,3615115210,3514246749,1672585511,1672587286,1775
3524,3557046880,3926643445,1672601505,1672603560,2055
3893,3511288998,3512800570,1672599288,1672602578,3290
3429,3760721303,3835422146,1672652795,1672655209,2414
3777,3685681577,3715443333,1672613827,1672616631,2804
3751,3279473441,3386758279,1672539364,1672542641,3277
3864,3703433819,3399518841,1672531656,1672532787,1131
3668,3500703304,3441703884,1672578374,1672581199,2825
3735,3617392620,3715707380,1672536199,1672538802,2603
3820,3424445495,3354144091,1672606043,1672606258,215
3560,3783433404,3793743698,1672660878,1672661745,867
3805,3914691363,3818575661,1672685573,1672687660,2087
3698,3716272919,3490214516,1672692260,1672693422,1162
3462,3516703758,3858172636,1672699063,1672700420,1357
3841,3834631333,3780834916,1672615233,1672616476,1243
3846,3533228966,3927403123,1672554498,1672554924,426
3474,3495911207,3920898925,1672579459,1672580802,1343
3691,3289817992,3490214516,1672659115,1672659615,500
3467,3779301501,3817813340,1672694822,1672696165,1343
3768,3734915241,3711734586,1672662873,1672664204,1331
3549,3772078494,3779938251,1672576548,1672578011,1463
3489,3512830734,3803517637,1672633809,1672635839,2030
3563,3533423872,3559731671,1672659307,1672661368,2061
3856,3898314440,3518229776,1672532804,1672533631,827
3511,3514419100,3512800570,1672531759,1672533141,1382
3878,3715443333,3638204468,1672662322,1672663208,886
3844,3631479562,3713691388,1672608532,1672610634,2102
3874,3510642075,3500044458,1672642898,1672644873,1975
3810,3773332082,3615113018,1672582150,1672582441,291
3822,3559458968,3467988782,1672552333,1672553129,796
3818,3921648519,3518653080,1672599617,1672602916,3299
3832,3778597171,3615113018,1672668679,1672669378,699
3677,3279242917,3627368399,1672609259,1672610365,1106
3701,3520873221,3455018347,1672699519,1672702784,3265
3568,3440107959,3514419100,1672595126,1672597388,2262
3594,3280268483,3895285664,1672689947,1672693024,3077
3700,3485540729,3621461051,1672692756,1672695661,2905
3921,3319167958,3500857494,1672532778,1672534990,2212
3765,3450286949,3757863420,1672589565,1672592019,2454
3819,3780322355,3316800320,1672536951,1672538799,1848
3769,3811075491,3755532873,1672549525,1672551684,2159
3518,3273981374,3714666884,1672637125,1672638280,1155
3790,3970603231,3714670620,1672558760,1672562356,3596
3477,3240394404,3439673892,1672642631,1672644291,1660
3465,3382733096,3793868716,1672676503,1672679359,2856
3634,3360813161,3776084820,1672691016,1672691429,413
3636,3783641602,3610358027,1672698234,1672698835,601
3582,3515525630,3972083617,1672538891,1672539677,786
3871,3371455553,3791693821,1672596939,1672598041,1102
3460,3374183227,3519446663,1672572277,1672572820,543
3729,3520416075,3512383699,1672581589,1672583888,2299
3658,3512800570,3667427125,1672572416,1672574989,2573
3457,3513327337,3509483172,1672633087,1672636465,3378
3690,3491469603,3500915908,1672577389,1672578383,994
3852,3760721303,3621461051,1672564560,1672564807,247
3831,3409114719,3855583256,1672647036,1672647528,492
3573,3713911104,3668533536,1672628616,1672629633,1017
3906,3383138270,3239617320,1672650175,1672652092,1917
3640,3885157459,3499217428,1672621613,1672624968,3355
3542,3276348699,3760362417,1672650589,1672652898,2309
3753,3703348097,3499217428,1672683514,1672687113,3599
3464,3779738691,3456430614,1672552627,1672552955,328
3899,3330340793,3792745809,1672695367,1672696414,1047
3873,3519142371,3685816610,1672597434,1672600554,3120
3776,3450969839,3783373154,1672702139,1672702358,219
3779,3292147449,3479851674,1672683368,1672685542,2174
3914,3661583097,3334993594,1672597441,1672600458,3017
3863,3401793306,3793175445,1672668116,1672668720,604
3438,3776244398,3510028805,1672650888,1672651488,600
3872,3203538212,3350095157,1672626835,1672629837,3002
3540,3534357694,3304971369,1672595788,1672599181,3393
3828,3714678331,3711077927,1672680032,1672683530,3498
3662,3701664364,3927165965,1672587246,1672588700,1454
3594,3620292035,3803517637,1672628299,1672631888,3589
3680,3792020993,3777624586,1672649667,1672650145,478
3425,3399518841,3500709774,1672642825,1672644151,1326
3700,3938503547,3201629017,1672632708,1672633402,694
3632,3777147510,3713979100,1672650172,1672652097,1925
3748,3455018347,3360813161,1672652547,1672655527,2980
3701,3783641602,3715385401,1672531300,1672533745,2445
3531,3660063072,3283492940,1672557420,1672559932,2512
3451,3385323994,3518229776,1672627127,1672629588,2461
3790,3517172354,3337322736,1672604450,1672606476,2026
3751,3701424609,3780253901,1672568625,1672569395,770
3722,3209481722,3518194482,1672649292,1672651111,1819
3716,3467779445,3501384020,1672640951,1672644387,3436
3700,3714128600,3667427125,1672610839,1672613726,2887
3904,3379143440,3225029895,1672545988,1672549178,3190
3648,3283492940,3732131656,1672669643,1672669840,197
3851,3779301501,3351696332,1672633634,1672636122,2488
3684,3500525825,3633735593,1672547726,1672549006,1280
3585,3505434346,3467779445,1672583192,1672583764,572
3468,3203538212,3505266860,1672630784,1672631026,242
3592,3516298579,3500613459,1672562891,1672566227,3336
3920,3604867757,3505434346,1672604465,1672606918,2453
3680,3424660806,3783615982,1672650628,1672652979,2351
3672,3228888030,3613581796,1672557508,1672557918,410
3884,3825881598,3201800997,1672655689,1672657316,1627
3780,3791246640,3777330107,1672559149,1672561865,2716
3583,3772236797,3811040565,1672680770,1672682302,1532
3571,3510798825,3334974375,1672568596,1672569696,1100
3771,3757193307,3299781901,1672541906,1672543201,1295
3640,3713784974,3612689556,1672610792,1672610949,157
3510,3447672935,3516298579,1672633620,1672634108,488
3825,3533274994,3609933747,1672575825,1672579351,3526
3723,3932478321,3300818269,1672614033,1672617592,3559
3426,3920497528,3774705415,1672575948,1672578144,2196
3527,3534175249,3791441520,1672608816,1672609741,925
3876,3777147510,3779738691,1672703061,1672704460,1399
3733,3270697740,3514703118,1672658835,1672661353,2518
3827,3618697021,3776988674,1672607038,1672609367,2329
3573,3514741348,3776244398,1672647935,1672648531,596
3867,3793175445,3760645796,1672588062,1672589901,1839
3703,3451326054,3551389192,1672589035,1672592075,3040
3590,3387594369,3315703693,1672695488,1672698105,2617
3646,3682133690,3791753345,1672599447,1672601861,2414
3859,3780909839,3791106564,1672573672,1672575288,1616
3487,3225029895,3493017654,1672605499,1672608477,2978
3836,3739911441,3510187271,1672675520,1672678142,2622
3619,3777485931,3737112297,1672556764,1672558013,1249
3563,3776831527,3424445495,1672633373,1672636491,3118
3694,3421385957,3519416013,1672668292,1672669398,1106
3751,3500709774,3408430195,1672666418,1672667742,1324
3556,3773121782,3311098437,1672611648,1672614410,2762
3650,3757863420,3500777439,1672669301,1672669443,142
3593,3770236215,3623266256,1672660125,1672663010,2885
3845,3793583656,3360616538,1672644315,1672646205,1890
3532,3448633776,3755222916,1672593953,1672596593,2640
3910,3716110860,3276269264,1672634591,1672637615,3024
3844,3760640999,3360813161,1672650831,1672653020,2189
3820,3711006062,3224811762,1672635718,1672636950,1232
3483,3431502855,3737147209,1672650631,1672652027,1396
3460,3208957949,3308760650,1672640438,1672641992,1554
3770,3779639983,3382733096,1672577106,1672578601,1495
3810,3205985903,3514275974,1672564462,1672566218,1756
3541,3500841914,3441348818,1672566723,1672567063,340
3691,3839245934,3714670620,1672667545,1672669095,1550
3447,3492546679,3777694660,1672623058,1672625264,2206
3611,3904867554,3733363628,1672547836,1672548074,238
3716,3824641227,3755737419,1672661253,1672662856,1603
3889,3500613493,3852686295,1672614658,1672617830,3172
3608,3517737088,3792801638,1672579802,1672582496,2694
3683,3409114719,3225636215,1672617179,1672618437,1258
3798,3689697817,3511843593,1672651305,1672653472,2167
3683,3357689359,3682133690,1672596019,1672598280,2261
3723,3714233826,3625463628,1672546204,1672549696,3492
3772,3617304541,3357864626,1672673670,1672675861,2191
3500,3357864626,3362641275,1672546304,1672548569,2265
3906,3534175249,3770676872,1672596109,1672597339,1230
3769,3500109249,3351866415,1672572962,1672574805,1843
3492,3400069268,3514275974,1672616747,1672619769,3022
3493,3511024016,3400069268,1672622366,1672623619,1253
3788,3605221116,3755222916,1672629273,1672631337,2064
3608,3501459390,3300511067,1672544705,1672544952,247
3581,3739661856,3497808662,1672686647,1672687415,768
3614,3505434346,3783340788,1672569456,1672572013,2557
3920,3505847380,3510499038,1672620234,1672620740,506
3753,3516903528,3779465522,1672545540,1672547693,2153
3433,3824641227,3833217041,1672585562,1672587341,1779
3524,3736705719,3338390596,1672677445,1672677924,479
3659,3517358573,3802932312,1672695405,1672698189,2784
3634,3716628503,3241914067,1672551375,1672554580,3205
3830,3661903000,3773332082,1672701445,1672702806,1361
3874,3710496785,3972083617,1672560675,1672562413,1738
3772,3689114185,3468041839,1672543036,1672543126,90
3721,3792014516,3701884158,1672665344,1672667854,2510
3795,3639050419,3534175249,1672546189,1672549703,3514
3911,3501459390,3270056120,1672637708,1672637813,105
3903,3638204468,3349739136,1672650289,1672650502,213
3535,3533423872,3311085279,1672557962,1672559439,1477
3604,3770146716,3600876425,1672668670,1672670018,1348
3656,3520639768,3294747828,1672580010,1672581542,1532
3764,3905899155,3778040015,1672606548,1672608138,1590
3651,3371455553,3812534508,1672546135,1672549487,3352
3615,3520322124,3701005527,1672634285,1672634751,466
3574,3200543880,3533090502,1672584384,1672586177,1793
3666,3501121099,3778667336,1672569037,1672570823,1786
3630,3534829213,3519850727,1672674292,1672674770,478
3884,3926643445,3513360004,1672684992,1672685932,940
3742,3710562338,3715974659,1672624833,1672627150,2317
3635,3713163045,3613416045,1672598821,1672601346,2525
3809,3513327337,3756385685,1672654844,1672655066,222
3593,3897435944,3300511067,1672572071,1672572421,350
3704,3661903000,3792072681,1672578935,1672581215,2280
3427,3715443333,3270042456,1672673196,1672673324,128
3731,3306412634,3970909253,1672618309,1672620797,2488
3823,3244004456,3491684096,1672549584,1672551714,2130
3801,3979784676,3500915665,1672625405,1672625997,592
3894,3780427126,3920497528,1672663920,1672667186,3266
3859,3755404116,3511005395,1672673720,1672673798,78
3717,3792274796,3755496114,1672585649,1672586793,1144
3502,3777189898,3755573472,1672636864,1672638749,1885
3898,3501525100,3935399379,1672670106,1672673570,3464
3679,3779438325,3408498208,1672580230,1672583360,3130
3521,3638204468,3480991549,1672553053,1672555427,2374
3607,3779738691,3468041839,1672698096,1672701413,3317
3461,3505923418,3206837348,1672702726,1672702932,206
3627,3512946768,3514246749,1672571320,1672571617,297
3884,3801645328,3793418209,1672680822,1672683910,3088
3843,3701823816,3680843171,1672650339,1672651436,1097
3727,3610358027,3385323994,1672536636,1672536837,201
3824,3517600136,3776084820,1672676661,1672677035,374
3559,3500347447,3793935736,1672652792,1672654350,1558
3878,3510798825,3349856820,1672677742,1672679920,2178
3497,3505266860,3631090677,1672677434,1672679099,1665
3474,3288762795,3306412634,1672548452,1672551386,2934
3462,3739895284,3449639012,1672648469,1672648683,214
3504,3500915665,3337322736,1672663631,1672666624,2993
3906,3620292035,3226024417,1672692097,1672694977,2880
3711,3927403123,3513296868,1672625552,1672627248,1696
3444,3227799827,3510187271,1672545377,1672548256,2879
3551,3338083680,3300818269,1672572132,1672572328,196
3860,3509483172,3470454332,1672682477,1672684783,2306
3787,3559458968,3512499658,1672625861,1672627844,1983
3449,3757193551,3230135532,1672673616,1672675857,2241
3543,3513545422,3614740489,1672694561,1672695513,952
3565,3455018347,3793407963,1672545782,1672546964,1182
3771,3739911441,3533004959,1672580124,1672582452,2328
3721,3362641275,3516321888,1672612153,1672613467,1314
3615,3455018347,3683113954,1672677777,1672680983,3206
3579,3459681410,3534357694,1672680288,1672681877,1589
3726,3338083680,3780322355,1672653256,1672654858,1602
3882,3928511283,3304155815,1672694303,1672695236,933
3848,3779646172,3689697817,1672638719,1672641530,2811
3455,3375449013,3514308235,1672545784,1672548396,2612
3619,3716628503,3792442597,1672577071,1672577221,150
3522,3619922891,3316798920,1672683180,1672686045,2865
3742,3859868849,3519142371,1672639459,1672640122,663
3729,3500347447,3621790707,1672643311,1672644579,1268
3553,3505111292,3802932312,1672577928,1672578412,484
3483,3688220326,3791753345,1672694285,1672696081,1796
3447,3516903528,3757332128,1672659061,1672661714,2653
3767,3500525825,3975717896,1672692893,1672693186,293
3580,3972083617,3608232640,1672623579,1672623747,168
3560,3500827202,3490214516,1672630461,1672632725,2264
3666,3739154408,3399472693,1672683033,1672685755,2722
3460,3793883863,3514334067,1672628653,1672631468,2815
3645,3803517637,3892304880,1672665702,1672666858,1156
3886,3333918941,3401496246,1672535708,1672536500,792
3880,3711000597,3510767239,1672635108,1672637653,2545
3695,3897134762,3756789525,1672652867,1672654711,1844
3569,3492959689,3703139663,1672601009,1672602208,1199
3526,3972192593,3685816610,1672643540,1672646793,3253
3751,3389634034,3779532653,1672645991,1672648565,2574
3543,3533079336,3463849738,1672662908,1672665996,3088
3565,3757193551,3308760650,1672632657,1672633778,1121
3655,3534829213,3730071479,1672680376,1672682325,1949
3563,3387594369,3760924079,1672602747,1672603432,685
3622,3500604680,3731646673,1672703803,1672704064,261
3615,3421385957,3516321888,1672628288,1672628411,123
3513,3400763927,3500442734,1672553075,1672553922,847
3444,3669146016,3500949309,1672547420,1672550067,2647
3660,3510642075,3701322924,1672615565,1672619006,3441
3819,3780115155,3756625818,1672541459,1672541672,213
3703,3248058676,3760842815,1672647648,1672648415,767
3704,3533423872,3509893027,1672578138,1672578212,74
3915,3791128487,3392520516,1672543259,1672546432,3173
3661,3970603231,3505923418,1672695953,1672698754,2801
3561,3836241528,3636329663,1672548217,1672551273,3056
3879,3780338697,3819767045,1672554319,1672556856,2537
3458,3274831810,3288224595,1672569946,1672572953,3007
3898,3714678331,3783169442,1672694562,1672695875,1313
3595,3757323954,3226178937,1672688056,1672690337,2281
3889,3770676872,3208957949,1672636427,1672639385,2958
3546,3519142371,3514285803,1672651616,1672654759,3143
3472,3500915908,3516298579,1672644707,1672645136,429
3640,3517737088,3505179890,1672553535,1672555388,1853
3467,3735374579,3505111292,1672557682,1672559044,1362
3674,3757700712,3779854934,1672686553,1672688018,1465
3430,3533929349,3661583097,1672567233,1672568693,1460
3760,3468041839,3445206685,1672608110,1672608508,398
3640,3621790707,3272030610,1672625074,1672626718,1644
3606,3935487534,3755158925,1672653552,1672654989,1437
3606,3350095157,3283770991,1672677190,1672680400,3210
3756,3276348699,3635169815,1672647502,1672650288,2786
3821,3773902805,3779425804,1672697053,1672700029,2976
3906,3938389661,3435116799,1672667345,1672670695,3350
3853,3505634634,3780338697,1672647063,1672649142,2079
3645,3357689359,3414940786,1672666220,1672667186,966
3731,3551399764,3814305099,1672698522,1672701597,3075
3872,3385323994,3615688740,1672610982,1672611174,192
3480,3912891315,3970909253,1672660643,1672661278,635
3649,3511288998,3812369928,1672665192,1672665738,546
3626,3730071479,3777330107,1672577962,1672578759,797
3736,3500442734,3739661856,1672630065,1672632367,2302
3856,3357689359,3770236215,1672615184,1672616434,1250
3555,3713979100,3513345163,1672564960,1672566361,1401
3800,3439673892,3933894942,1672642826,1672643527,701
3435,3229822507,3470454332,1672648178,1672651283,3105
3589,3713300120,3333403880,1672650652,1672653413,2761
3585,3755573472,3514246749,1672646146,1672648424,2278
3666,3619922891,3454277788,1672611370,1672613986,2616
3858,3931627862,3467779445,1672612281,1672615537,3256
3608,3556969573,3839245934,1672551892,1672553814,1922
3476,3715443333,3292147449,1672560177,1672561575,1398
3726,3351696332,3511024016,1672675505,1672677708,2203
3429,3899786664,3403370192,1672668004,1672670754,2750
3711,3300229945,3200543880,1672702625,1672703531,906
3788,3399472693,3311098437,1672570846,1672571686,840
3526,3417679834,3791046864,1672623009,1672626111,3102
3875,3757294769,3755065949,1672647650,1672648689,1039
3483,3703348097,3505995057,1672661198,1672661497,299
3786,3829864515,3715086894,1672597296,1672598388,1092
3554,3927403123,3773124276,1672597970,1672598484,514
3807,3435167810,3701664364,1672564560,1672565120,560
3707,3703383853,3780115155,1672676892,1672677588,696
3890,3779639983,3512295534,1672652844,1672655155,2311
3462,3792442597,3414275042,1672673838,1672675503,1665
3876,3770236215,3515525630,1672695176,1672695392,216
3721,3756385685,3736705719,1672658477,1672658613,136
3898,3516703758,3300229945,1672677116,1672680356,3240
3731,3621184108,3757075324,1672694354,1672694982,628
3561,3793418209,3703396825,1672658887,1672659064,177
3812,3533929349,3773572967,1672613833,1672616631,2798
3556,3713941638,3441348818,1672674937,1672675842,905
3818,3505154885,3517737088,1672660753,1672663080,2327
3817,3811075491,3778134418,1672595751,1672598824,3073
3602,3312998540,3756385685,1672665523,1672665958,435
3638,3224811762,3904569677,1672581410,1672583234,1824
3726,3783433404,3360616538,1672661108,1672664704,3596
3588,3607882826,3715545685,1672576115,1672577443,1328
3512,3711077927,3501457103,1672589835,1672592321,2486
3772,3618808151,3792489602,1672576173,1672577010,837
3696,3270697740,3800257590,1672645964,1672649433,3469
3832,3429943738,3511732493,1672576709,1672578888,2179
3690,3660063072,3755496114,1672698745,1672701860,3115
3827,3792538417,3791246640,1672560431,1672562763,2332
3805,3739154408,3517687662,1672609029,1672610868,1839
3849,3887243870,3398731252,1672567658,1672568654,996
3788,3485540729,3380130228,1672587118,1672590128,3010
3707,3617392620,3619922891,1672606215,1672609030,2815
3593,3533090502,3800257590,1672615099,1672615984,885
3733,3500341755,3621461051,1672697819,1672698022,203
3654,3627368399,3757383891,1672688442,1672691620,3178
3730,3715443333,3517600136,1672552187,1672554014,1827
3663,3500857494,3715986185,1672630895,1672633829,2934
3585,3500709774,3225636215,1672609362,1672610854,1492
3825,3533423872,3224330592,1672555584,1672559071,3487
3704,3815250107,3776518452,1672623444,1672623840,396
3792,3515890966,3793315718,1672634388,1672637237,2849
3613,3519087371,3534829213,1672591008,1672593425,2417
3773,3633735593,3738026330,1672560178,1672561393,1215
3783,3711919537,3500703304,1672562672,1672564641,1969
3524,3600876425,3755158925,1672665883,1672667569,1686
3791,3783928182,3757193307,1672679771,1672681329,1558
3704,3617116290,3711853996,1672674001,1672674148,147
3470,3773735484,3779639983,1672602667,1672606035,3368
3676,3304155815,3780909839,1672641020,1672643179,2159
3458,3737147209,3370068529,1672637095,1672639051,1956
3455,3519909393,3780322355,1672646637,1672647695,1058
3822,3783641602,3505154885,1672580525,1672582960,2435
3757,3669146016,3819767045,1672603913,1672607025,3112
3535,3737147209,3505402439,1672605738,1672606729,991
3429,3615087943,3733363628,1672590255,1672593568,3313
3438,3688796737,3774718695,1672534851,1672536374,1523
3772,3533423872,3715619259,1672567071,1672568468,1397
3442,3839245934,3509756823,1672672383,1672673163,780
3695,3779639983,3375449013,1672639309,1672641952,2643
3900,3610358027,3514419100,1672691516,1672691858,342
3563,3421877923,3780872464,1672687788,1672690947,3159
3671,3823084403,3714128600,1672620563,1672623580,3017
3493,3468041839,3415833929,1672609622,1672612891,3269
3527,3600876425,3701136026,1672543119,1672543388,269
3669,3927165965,3518229776,1672582025,1672582367,342
3874,3284947372,3774876004,1672625814,1672626822,1008
3533,3791436104,3710562338,1672694725,1672696434,1709
3762,3713979100,3513545422,1672587427,1672589690,2263
3622,3478114114,3510767239,1672637433,1672637803,370
3707,3501457103,3279339278,1672657669,1672658340,671
3476,3731646673,3703396825,1672680213,1672683213,3000
3777,3780427126,3701823816,1672567407,1672568083,676
3896,3380982774,3880926355,1672538041,1672539920,1879
3671,3435116799,3777240360,1672605359,1672606174,815
3860,3931627862,3779438325,1672643239,1672643785,546
3852,3701882224,3517222913,1672638927,1672641550,2623
3742,3703798634,3443357683,1672629894,1672631062,1168
3506,3970198861,3501281016,1672671913,1672672014,101
3901,3688490530,3505283390,1672579093,1672581304,2211
3617,3360813161,3448875382,1672645809,1672649181,3372
3599,3515401243,3710562338,1672534562,1672534981,419
3651,3612689556,3429943738,1672579556,1672580076,520
3884,3815250107,3895285664,1672599287,1672602065,2778
3901,3232208416,3770438122,1672598274,1672599462,1188
3816,3384583385,3533274994,1672612831,1672614044,1213
3528,3783433404,3618808151,1672539193,1672542667,3474
3795,3225029895,3618808151,1672604760,1672605017,257
3480,3689697817,3439673892,1672694200,1672696195,1995
3699,3613581796,3711637255,1672643699,1672646687,2988
3476,3780115155,3613206049,1672546731,1672549895,3164
3452,3513345163,3714120857,1672584477,1672584838,361
3731,3774876004,3814305099,1672696503,1672699146,2643
3757,3780909839,3513327337,1672687829,1672688172,343
3568,3271454397,3226178937,1672684068,1672686870,2802
3730,3609933747,3773837847,1672554906,1672556476,1570
3708,3713691388,3337322736,1672607280,1672610141,2861
3873,3410538749,3893912331,1672622708,1672625243,2535
3558,3533090502,3511843593,1672619395,1672622646,3251
3846,3791246640,3701005527,1672663003,1672663302,299
3425,3928511283,3392520516,1672548150,1672550040,1890
3790,3760364383,3715443333,1672586826,1672589013,2187
3787,3384583385,3511005395,1672616498,1672617643,1145
3752,3773572967,3683113954,1672548789,1672551944,3155
3435,3688796737,3783520186,1672636323,1672639175,2852
3571,3519028898,3608232640,1672631108,1672631627,519
3495,3710048469,3516444201,1672636631,1672639416,2785
3516,3385323994,3514334067,1672686358,1672686948,590
3887,3505266860,3500841914,1672656308,1672658698,2390
3758,3438489358,3274906650,1672539168,1672542284,3116
3553,3517600136,3760721303,1672554822,1672556093,1271
3519,3887243870,3688490530,1672606573,1672607551,978
3869,3880926355,3451691949,1672701329,1672703386,2057
3864,3448633776,3780115155,1672658940,1672660226,1286
3825,3801645328,3604867757,1672615618,1672618391,2773
3847,3500703304,3303410628,1672670072,1672672397,2325
3589,3826238375,3711853996,1672536692,1672539177,2485
3547,3783520186,3930242012,1672600686,1672602303,1617
3878,3519651506,3515890966,1672620267,1672620878,611
3841,3916490839,3779738691,1672534350,1672535486,1136
3645,3716963089,3519446663,1672668904,1672672297,3393
3750,3200543880,3505178849,1672699327,1672702713,3386
3900,3898314440,3501459390,1672601572,1672602362,790
3446,3516513251,3739661856,1672641763,1672644370,2607
3639,3500109249,3818575661,1672573152,1672573977,825
3565,3778134418,3448875382,1672607592,1672609208,1616
3917,3206837348,3533274994,1672600653,1672602301,1648
3622,3334951866,3780680950,1672549990,1672550483,493
3862,3316800320,3900945856,1672533773,1672536638,2865
3655,3386758279,3906536154,1672537954,1672539138,1184
3821,3440107959,3834631333,1672586652,1672587456,804
3586,3711000597,3902760230,1672539567,1672539644,77
3671,3714067076,3367111751,1672581394,1672582524,1130
3734,3756704774,3779532653,1672636967,1672640295,3328
3700,3770704999,3350095157,1672608677,1672612052,3375
3607,3337362061,3514741348,1672598750,1672602027,3277
3681,3897376951,3891672228,1672703869,1672705447,1578
3525,3783615982,3461119815,1672696841,1672699705,2864
3871,3636329663,3292147449,1672643289,1672645834,2545
3805,3668747074,3509366311,1672557153,1672559591,2438
3790,3283144118,3779465522,1672622400,1672622820,420
3727,3510964997,3512722110,1672651473,1672652252,779
3722,3293835352,3792538417,1672575765,1672575842,77
3702,3885157459,3300979975,1672649670,1672651679,2009
3473,3337362061,3362641275,1672677269,1672678669,1400
3465,3714120857,3360813161,1672677064,1672677773,709
3720,3885121158,3621790707,1672645462,1672647238,1776
3603,3608855425,3777779869,1672621480,1672624362,2882
3609,3812534508,3715854030,1672703204,1672704679,1475
3443,3270042456,3520639768,1672584785,1672586524,1739
3748,3500498112,3920625129,1672576622,1672579442,2820
3527,3510837901,3226024417,1672618877,1672622410,3533
3602,3755532873,3713784974,1672570604,1672574150,3546
3851,3505154885,3792489602,1672637735,1672638886,1151
3662,3755065949,3736231757,1672698854,1672701418,2564
3449,3514818819,3509483172,1672663765,1672664048,283
3817,3500347447,3533423872,1672545525,1672546543,1018
3436,3630353876,3613581796,1672567735,1672570904,3169
3683,3631479562,3554944414,1672653890,1672656827,2937
3552,3780427126,3472312341,1672677290,1672678482,1192
3435,3232208416,3668414677,1672572685,1672574621,1936
3454,3776831527,3509756823,1672579843,1672581214,1371
3491,3513545422,3760694096,1672552629,1672555244,2615
3679,3510837901,3241914067,1672588699,1672589697,998
3437,3500442734,3438078818,1672616010,1672617534,1524
3616,3792949946,3276217799,1672585072,1672585465,393
3442,3934064792,3533004959,1672585915,1672587027,1112
3658,3500302272,3779639983,1672584853,1672587506,2653
3706,3376467719,3236354255,1672674240,1672677638,3398
3775,3284947372,3770296583,1672602627,1672605031,2404
3651,3416987084,3777240360,1672654029,1672657301,3272
3728,3622665543,3688796737,1672637863,1672640948,3085
3540,3463849738,3554825448,1672647877,1672649161,1284
3526,3703383853,3500604680,1672583011,1672585568,2557
3442,3437286517,3499217428,1672610816,1672611719,903
3548,3783520186,3812534508,1672668089,1672670438,2349
3672,3664943873,3760842815,1672676995,1672677744,749
3609,3905899155,3680810086,1672584457,1672585976,1519
3807,3783771827,3711218296,1672553034,1672553958,924
3551,3703383853,3839245934,1672674179,1672676193,2014
3904,3450286949,3202141727,1672541551,1672543276,1725
3751,3227799827,3512295534,1672680957,1672683548,2591
3789,3972083617,3279473441,1672532261,1672533502,1241
3526,3534357694,3392520516,1672607732,1672609979,2247
3582,3783373154,3793883863,1672603426,1672604582,1156
3738,3408430195,3293835352,1672565158,1672565439,281
3804,3760362417,3490029863,1672652523,1672654105,1582
3708,3480726047,3505995057,1672603344,1672604640,1296
3845,3793969543,3703139663,1672613046,1672614795,1749
3881,3440137407,3618697021,1672638787,1672639786,999
3616,3533294425,3703139663,1672618962,1672619536,574
3563,3469254160,3792274796,1672595721,1672595784,63
3615,3209526819,3512379024,1672657235,1672658092,857
3435,3608922867,3364726656,1672608329,1672611839,3510
3797,3375449013,3791106564,1672585230,1672587995,2765
3540,3779938251,3468041839,1672698967,1672701789,2822
3557,3501281016,3500737582,1672691461,1672694936,3475
3450,3514971533,3226178937,1672627034,1672628981,1947
3633,3635169815,3343816795,1672567877,1672568386,509
3912,3428725843,3394401087,1672617838,1672621082,3244
3786,3510028805,3512882178,1672632123,1672633021,898
3849,3225636215,3408430195,1672690051,1672691581,1530
3753,3715086894,3791128487,1672580641,1672583217,2576
3525,3341893384,3412006598,1672533519,1672536891,3372
3913,3777240360,3410538749,1672566803,1672567775,972
3872,3792505974,3300818269,1672586654,1672588158,1504
3902,3205985903,3337322736,1672676270,1672679235,2965
3518,3370227921,3505663516,1672680003,1672680083,80
3655,3829864515,3367971170,1672685296,1672686050,754
3462,3793868716,3284947372,1672617130,1672618308,1178
3606,3519416013,3914691363,1672601899,1672603985,2086
3590,3711000597,3938389661,1672552541,1672553841,1300
3875,3773837847,3892304880,1672533822,1672534107,285
3565,3780322355,3927165965,1672564918,1672567658,2740
3505,3635169815,3393063657,1672616464,1672619097,2633
3773,3448875382,3411515369,1672652364,1672655399,3035
3539,3480100311,3819767045,1672630028,1672633273,3245
3626,3623266256,3304971369,1672577676,1672580282,2606
3857,3770704999,3520639768,1672682950,1672683498,548
3787,3509764635,3774876004,1672675843,1672677381,1538
3648,3292147449,3791436104,1672562637,1672564639,2002
3675,3334974375,3300979975,1672568908,1672572149,3241
3730,3511024016,3902625986,1672549494,1672550586,1092
3638,3505434346,3777779869,1672553041,1672556076,3035
3564,3979784676,3431502855,1672619636,1672621726,2090
3752,3701005527,3273981374,1672602287,1672603021,734
3442,3779892400,3792072681,1672648360,1672650290,1930
3467,3515402792,3208957949,1672652009,1672652702,693
3859,3757903168,3512379024,1672645246,1672647754,2508
3589,3292147449,3972083617,1672608342,1672609185,843
3611,3733558985,3448633776,1672568713,1672569109,396
3793,3713784974,3480726047,1672580284,1672583351,3067
3643,3773121782,3245232284,1672658483,1672660454,1971
3673,3300511067,3885537225,1672572629,1672573966,1337
3539,3551376095,3920625129,1672567601,1672569415,1814
3736,3757383891,3513065217,1672617153,1672618419,1266
3876,3703433819,3334974375,1672612162,1672613720,1558
3659,3514419100,3757193307,1672666838,1672668217,1379
3824,3617489344,3308760650,1672535690,1672536676,986
3448,3409114719,3783433404,1672648708,1672649917,1209
3572,3737147209,3296462324,1672569758,1672571693,1935
3911,3367111751,3774790271,1672637758,1672639249,1491
3614,3852686295,3398731252,1672562246,1672565385,3139
3912,3703798634,3415833929,1672538481,1672541342,2861
3811,3390660440,3792949946,1672600431,1672600759,328
3687,3777485931,3783801141,1672684022,1672686571,2549
3740,3515525630,3428725843,1672645973,1672647509,1536
3764,3977352557,3755496114,1672603483,1672605693,2210
3807,3773902805,3711006062,1672559673,1672561877,2204
3495,3232208416,3225029895,1672663964,1672667453,3489
3593,3714666884,3625463628,1672625003,1672627079,2076
3759,3977148669,3783919913,1672688655,1672689641,986
3627,3230868435,3315703693,1672602882,1672604073,1191
3465,3372223551,3364726656,1672536372,1672536568,196
3866,3376467719,3308760650,1672703098,1672705241,2143
3815,3516741440,3270042456,1672682493,1672683380,887
3576,3604867757,3774907131,1672594815,1672595841,1026
3723,3835422146,3689114185,1672661298,1672664090,2792
3444,3755848152,3517687662,1672556904,1672559971,3067
3752,3414275042,3351696332,1672531903,1672533053,1150
3763,3501457103,3630353876,1672651560,1672653217,1657
3866,3733363628,3334993594,1672556692,1672559164,2472
3727,3711006062,3783615982,1672674518,1672677339,2821
3701,3618697021,3336339664,1672669064,1672672103,3039
3541,3927599181,3333403880,1672635462,1672638398,2936
3433,3756127300,3501459390,1672621015,1672624195,3180
3725,3631090677,3926643445,1672694669,1672696283,1614
3543,3617392620,3428725843,1672547614,1672548816,1202
3442,3756385685,3534179433,1672532718,1672533265,547
3890,3760645796,3512830734,1672587187,1672587830,643
3607,3517590837,3316798920,1672553011,1672555784,2773
3519,3366423342,3305722859,1672541333,1672541685,352
3535,3360069849,3360069849,1672663727,1672665757,2030
3692,3533228966,3701884158,1672675551,1672678727,3176
3468,3791753345,3755404116,1672670959,1672672772,1813
3533,3510642075,3505228454,1672543253,1672545785,2532
3555,3236458894,3610870949,1672580104,1672580852,748
3568,3733558985,3920625129,1672618731,1672621366,2635
3461,3338390596,3513345163,1672698454,1672699863,1409
3792,3463740710,3856606678,1672622835,1672623496,661
3622,3668414677,3760651515,1672641245,1672644424,3179
3851,3520115090,3389634034,1672608998,1672612566,3568
3850,3714120857,3897435944,1672673145,1672673807,662
3486,3779656423,3970627281,1672548090,1672550148,2058
3856,3230135532,3311420950,1672583979,1672585531,1552
3765,3385323994,3274906650,1672584761,1672586892,2131
3760,3514275974,3500672156,1672665758,1672668823,3065
3583,3773332082,3501567772,1672651234,1672652563,1329
3445,3520639768,3791106564,1672635705,1672636962,1257
3915,3715974659,3701107228,1672627533,1672629449,1916
3864,3460719322,3479851674,1672572064,1672573718,1654
3861,3774290799,3414275042,1672596560,1672599879,3319
3643,3821054646,3793922324,1672551713,1672553881,2168
3727,3688490530,3438078818,1672652678,1672654329,1651
3867,3774718695,3240394404,1672647559,1672649410,1851
3796,3792546035,3455018347,1672678631,1672679726,1095
3433,3780712350,3850911686,1672643216,1672646115,2899
3660,3274906650,3617489344,1672578342,1672579114,772
3725,3500709774,3793175445,1672661108,1672663628,2520
3686,3280268483,3858172636,1672546140,1672547986,1846
3819,3333918941,3622665543,1672540120,1672542090,1970
3714,3778640261,3755756564,1672672780,1672676245,3465
3761,3889780657,3714128600,1672652748,1672653373,625
3486,3925979970,3931627862,1672659929,1672661853,1924
3609,3780427126,3783801141,1672605900,1672608634,2734
3858,3780209375,3780834916,1672623529,1672624272,743
3572,3711218296,3505111292,1672581370,1672584739,3369
3524,3478114114,3376467719,1672664029,1672665686,1657
3521,3703798634,3500915908,1672638663,1672641029,2366
3764,3757700712,3760645796,1672596422,1672599826,3404
3636,3755496114,3512337405,1672665421,1672668837,3416
3694,3316800320,3783801141,1672540711,1672541097,386
3580,3974674109,3757903168,1672593404,1672595459,2055
3719,3974674109,3757318448,1672576272,1672576419,147
3628,3783163143,3890739241,1672533415,1672535204,1789
3589,3814305099,3807212280,1672540074,1672541138,1064
3705,3414275042,3617392620,1672622618,1672624574,1956
3433,3757903168,3779656423,1672560531,1672561752,1221
3677,3500347447,3711734586,1672576275,1672578889,2614
3657,3517172354,3357289672,1672548244,1672551601,3357
3607,3410160376,3779425804,1672619247,1672620767,1520
3452,3778926763,3283144118,1672579641,1672581728,2087
3609,3755344363,3792505974,1672578015,1672581294,3279
3623,3834960360,3334974375,1672695950,1672698650,2700
3651,3370068529,3514971533,1672652072,1672652358,286
3703,3431460073,3817428320,1672583851,1672584624,773
3712,3400069268,3319167958,1672583942,1672585557,1615
3723,3783520186,3808136029,1672697098,1672699165,2067
3536,3411688875,3203538212,1672589533,1672591429,1896
3708,3780571086,3514334067,1672554566,1672557389,2823
3550,3392836218,3513853403,1672647694,1672650582,2888
3832,3757863420,3667427125,1672532167,1672532507,340
3678,3685681577,3510818674,1672632314,1672633727,1413
3727,3448633776,3607882826,1672634664,1672636587,1923
3745,3283144118,3519282716,1672640108,1672642940,2832
3650,3480100311,3971806004,1672568871,1672568990,119
3717,3779938251,3463849738,1672557800,1672558801,1001
3745,3793781065,3454277788,1672544198,1672545000,802
3598,3834960360,3920898925,1672689594,1672691377,1783
3909,3284947372,3807212280,1672695523,1672697196,1673
3501,3511732493,3350095157,1672531823,1672534820,2997
3824,3627368399,3500341755,1672660467,1672663826,3359
3808,3615688740,3350095157,1672630884,1672631630,746
3821,3714128600,3283144118,1672656309,1672659564,3255
3850,3514419100,3497808662,1672548448,1672551198,2750
3852,3334647380,3272030610,1672676244,1672677565,1321
3549,3515890966,3770468980,1672538564,1672538666,102
3494,3515890966,3902625986,1672536952,1672537853,901
3855,3800257590,3351866415,1672697101,1672700641,3540
3783,3534829213,3500347447,1672682263,1672683074,811
3581,3500709774,3236499444,1672617779,1672619854,2075
3890,3226024417,3792442597,1672550935,1672552368,1433
3463,3336339664,3449639012,1672684709,1672685013,304
3477,3626499450,3418448389,1672684772,1672686441,1669
3570,3534764451,3440107959,1672564729,1672567838,3109
3892,3773735484,3311420950,1672559289,1672562833,3544
3609,3500525825,3639050419,1672699384,1672700318,934
3505,3774718695,3773027597,1672538012,1672541556,3544
3836,3224811762,3500208903,1672581117,1672581391,274
3560,3660063072,3310125159,1672698689,1672702169,3480
3658,3533228966,3756746867,1672549713,1672551584,1871
3710,3609881958,3637313265,1672577743,1672579350,1607
3468,3236458894,3636329663,1672688857,1672689569,712
3724,3733558985,3370068529,1672597805,1672599367,1562
3763,3440107959,3519282716,1672605218,1672606557,1339
3541,3850911686,3520115090,1672610335,1672610834,499
3806,3386758279,3715974659,1672559285,1672562501,3216
3854,3792801638,3334993594,1672632533,1672633278,745
3718,3513296868,3688490530,1672629085,1672630570,1485
3656,3517288083,3551389192,1672618766,1672621402,2636
3671,3791436104,3201629017,1672576027,1672578819,2792
3684,3500347447,3716963089,1672695895,1672697255,1360
3807,3897134762,3770704999,1672547349,1672550467,3118
3484,3418448389,3812369928,1672677593,1672680767,3174
3757,3402385957,3401496246,1672702674,1672704607,1933
3661,3414275042,3515466096,1672589361,1672591275,1914
3830,3829822608,3401793306,1672678496,1672681191,2695
3899,3360069849,3780571086,1672679546,1672680855,1309
3656,3792072681,3232208416,1672572882,1672575918,3036
3499,3447672935,3780680950,1672675989,1672678752,2763
3728,3738026330,3977352557,1672614282,1672617126,2844
3807,3714678331,3366423342,1672694814,1672695209,395
3608,3435167810,3514275974,1672616002,1672616410,408
3548,3912891315,3779438325,1672592773,1672592945,172
3886,3777330107,3495911207,1672635602,1672637297,1695
3440,3299443125,3667427125,1672542538,1672545889,3351
3869,3779613523,3714233826,1672534756,1672537556,2800
3676,3777330107,3500949309,1672652924,1672656479,3555
3435,3774790271,3505888598,1672698387,1672700387,2000
3507,3293835352,3612689556,1672619375,1672620793,1418
3576,3349739136,3338083680,1672531368,1672534093,2725
3668,3711734586,3398198430,1672605459,1672607228,1769
3850,3400069268,3408498208,1672651746,1672651838,92
3514,3701005527,3711637255,1672565800,1672566364,564
3671,3414940786,3793922324,1672568004,1672569661,1657
3900,3783919913,3701107228,1672534077,1672536580,2503
3915,3975717896,3390660440,1672583039,1672586172,3133
3681,3757193551,3200308999,1672590029,1672592482,2453
3738,3631479562,3800257590,1672593183,1672595451,2268
3592,3617304541,3514308235,1672586694,1672589552,2858
3815,3451726367,3364378127,1672563475,1672564372,897
3859,3511317276,3711853996,1672568774,1672571005,2231
3441,3505179890,3517881647,1672594167,1672596222,2055
3828,3835422146,3858172636,1672676474,1672677250,776
3720,3793883863,3357689359,1672565810,1672568333,2523
3709,3519850727,3730071479,1672539766,1672542526,2760
3439,3853629553,3774907131,1672677106,1672677877,771
3886,3232208416,3514419100,1672666103,1672667514,1411
3900,3516513251,3316800320,1672679333,1672681308,1975
3477,3688490530,3514703118,1672691976,1672694546,2570
3644,3880926355,3613338363,1672558356,1672559959,1603
3444,3732584121,3270042456,1672537221,1672540155,2934
3792,3614740489,3514512367,1672591293,1672591931,638
3872,3783163143,3774178201,1672685185,1672688651,3466
3439,3905899155,3231494505,1672615920,1672618947,3027
3855,3770236215,3618176292,1672698252,1672701187,2935
3637,3774178201,3792525861,1672566364,1672569001,2637
3915,3779438325,3757700712,1672612977,1672615702,2725
3851,3639050419,3241914067,1672683651,1672685415,1764
3431,3905899155,3411515369,1672565051,1672567630,2579
3851,3783771827,3501215099,1672580382,1672583881,3499
3551,3398731252,3930242012,1672661137,1672664731,3594
3527,3714827719,3923220461,1672600850,1672601362,512
3692,3904412440,3512800570,1672580834,1672583536,2702
3649,3279473441,3774178201,1672614620,1672616650,2030
3882,3783615982,3792489602,1672573391,1672573961,570
3657,3501786419,3435116799,1672600418,1672602815,2397
3829,3517887477,3778667336,1672602731,1672604547,1816
3757,3305336154,3515439826,1672644026,1672646156,2130
3664,3411515369,3703348097,1672573002,1672576501,3499
3587,3701884158,3780338697,1672673479,1672675744,2265
3468,3625463628,3316800320,1672659400,1672660683,1283
3882,3617116290,3756746867,1672598008,1672600174,2166
3736,3209481722,3514703118,1672645883,1672647426,1543
3527,3757383891,3306175858,1672572760,1672575187,2427
3578,3757075324,3512392431,1672550428,1672551503,1075
3560,3780472203,3279339278,1672681763,1672682485,722
3504,3517737088,3736231757,1672623222,1672623394,172
3708,3703433819,3970198861,1672544480,1672545259,779
3832,3520115090,3248058676,1672594735,1672595068,333
3736,3897456874,3793418209,1672540529,1672540898,369
3620,3517600136,3885157459,1672660381,1672663775,3394
3777,3448633776,3935487534,1672665690,1672666426,736
3601,3410600350,3280268483,1672546082,1672549506,3424
3708,3736705719,3305336154,1672578190,1672579327,1137
3752,3230135532,3757863420,1672583948,1672585187,1239
3526,3783373154,3511791953,1672595303,1672598766,3463
3555,3276269264,3972083617,1672686645,1672689758,3113
3892,3511732493,3935913584,1672651726,1672654382,2656
3836,3288224595,3685681577,1672657373,1672657520,147
3891,3755065949,3739911441,1672569260,1672571240,1980
3753,3468041839,3920497528,1672562349,1672565662,3313
3813,3354144091,3791753345,1672627402,1672629153,1751
3564,3241790910,3534357694,1672558193,1672561780,3587
3482,3780322355,3731646673,1672646339,1672647486,1147
3728,3516298579,3383138270,1672658837,1672661942,3105
3640,3755065949,3835985172,1672577675,1672579294,1619
3644,3609659642,3713829743,1672609049,1672611192,2143
3495,3500915665,3533747868,1672691456,1672693135,1679
3470,3385323994,3228888030,1672639042,1672640522,1480
3661,3791046864,3520991398,1672696881,1672698603,1722
3733,3401940259,3556969573,1672668884,1672669632,748
3793,3357289672,3855583256,1672685364,1672688105,2741
3704,3309314379,3446533960,1672590624,1672593753,3129
3485,3770146716,3773837847,1672562697,1672566226,3529
3539,3501525100,3511005395,1672672119,1672674910,2791
3778,3604867757,3408498208,1672701218,1672701722,504
3535,3455018347,3283770991,1672603955,1672605581,1626
3795,3513327337,3814305099,1672664083,1672667663,3580
3696,3513853403,3401940259,1672634549,1672636834,2285
3761,3515439826,3711853996,1672536560,1672539121,2561
3641,3756704774,3615113018,1672563835,1672565447,1612
3851,3739154408,3201676087,1672650743,1672653502,2759
3833,3755848152,3241914067,1672538486,1672540942,2456
3781,3760645796,3774605761,1672678478,1672679089,611
3594,3514334067,3272096759,1672680534,1672680669,135
3595,3667427125,3462636434,1672653005,1672655229,2224
3527,3501457103,3363162590,1672699369,1672700603,1234
3790,3333918941,3431502855,1672658787,1672661549,2762
3703,3927165965,3777814504,1672664071,1672667081,3010
3506,3500949309,3421877923,1672682111,1672683231,1120
3811,3500302272,3515402792,1672624556,1672625977,1421
3772,3493017654,3824641227,1672679234,1672681534,2300
3699,3636329663,3792949946,1672579972,1672582759,2787
3784,3292147449,3621790707,1672555927,1672558616,2689
3830,3921648519,3305336154,1672659489,1672662668,3179
3643,3229974066,3975717896,1672613155,1672613247,92
3555,3500857494,3612689556,1672659769,1672662264,2495
3633,3737112297,3513296868,1672580560,1672583633,3073
3885,3514419100,3711097754,1672532084,1672533289,1205
3799,3774907131,3480726047,1672649584,1672650301,717
3484,3757332128,3510767239,1672596490,1672598780,2290
3473,3512379024,3853629553,1672592840,1672595953,3113
3836,3776518452,3470454332,1672667984,1672668244,260
3810,3755573472,3516741440,1672573378,1672575260,1882
3611,3304971369,3520639768,1672686558,1672690002,3444
3838,3409114719,3447672935,1672690927,1672691359,432
3429,3737112297,3933894942,1672591802,1672593340,1538
3523,3904412440,3510964997,1672557435,1672560239,2804
3645,3516489668,3773572967,1672594508,1672595152,644
3694,3516903528,3280054198,1672619270,1672622237,2967
3810,3514419100,3661903000,1672557752,1672558727,975
3577,3505807416,3509756823,1672569543,1672571242,1699
3836,3834631333,3618489670,1672576365,1672579327,2962
3481,3934064792,3225636215,1672646535,1672649978,3443
3732,3792442597,3701136026,1672569594,1672571903,2309
3828,3923220461,3501567772,1672649058,1672652195,3137
3434,3380767040,3780712350,1672641210,1672641400,190
3530,3512800570,3395201292,1672688634,1672691830,3196
3896,3315703693,3534543776,1672628702,1672628912,210
3499,3272716462,3774290799,1672669004,1672669495,491
3807,3893912331,3793969543,1672650046,1672653601,3555
3757,3773902805,3774641380,1672540877,1672542223,1346
3915,3280054198,3500109249,1672689965,1672692879,2914
3696,3934064792,3500347447,1672679898,1672681502,1604
3514,3612689556,3792014516,1672594213,1672595153,940
3872,3760645796,3618354185,1672689067,1672689709,642
3850,3513360004,3776559988,1672629112,1672630387,1275
3912,3711000597,3551399764,1672555379,1672556876,1497
3493,3613899351,3716963089,1672605607,1672607530,1923
3432,3231713082,3319167958,1672688316,1672689216,900
3814,3394401087,3624297844,1672551990,1672553220,1230
3556,3308760650,3792949946,1672573106,1672575151,2045
3696,3739911441,3333403880,1672626320,1672628173,1853
3724,3792389522,3517687662,1672590717,1672592450,1733
3706,3714670620,3793743698,1672658355,1672659488,1133
3704,3904867554,3510837901,1672658819,1672661181,2362
3567,3778899160,3776988674,1672651079,1672653776,2697
3863,3938503547,3622665543,1672632812,1672635742,2930
3837,3604589802,3760842815,1672633948,1672634052,104
3725,3512958459,3519651506,1672534852,1672535566,714
3695,3501459390,3224811762,1672672835,1672674117,1282
3747,3403370192,3334993594,1672564589,1672565913,1324
3803,3715443333,3438078818,1672534539,1672536910,2371
3641,3492959689,3778134418,1672676471,1672678843,2372
3917,3713300120,3511791953,1672639460,1672640564,1104
3553,3500672156,3807212280,1672564202,1672567249,3047
3861,3807212280,3510642075,1672656808,1672660294,3486
3665,3713829743,3505847380,1672686419,1672688118,1699
3485,3760364383,3493017654,1672673296,1672673642,346
3523,3336339664,3480100311,1672654055,1672656691,2636
3750,3437286517,3403370192,1672551314,1672552662,1348
3791,3889780657,3730071479,1672605194,1672605628,434
3621,3411688875,3443357683,1672645698,1672648943,3245
3669,3623266256,3360616538,1672608653,1672612008,3355
3865,3755404116,3777037426,1672699386,1672700182,796
3424,3519416013,3760645796,1672540388,1672541330,942
3917,3519651506,3412006598,1672602150,1672603744,1594
3801,3703396825,3770520359,1672682930,1672684634,1704
3617,3520181148,3239617320,1672535668,1672538139,2471
3605,3733558985,3855583256,1672533698,1672535432,1734
3746,3357864626,3791613604,1672598796,1672599407,611
3679,3780834916,3316800320,1672691057,1672691152,95
3722,3347419520,3755222916,1672702932,1672705723,2791
3653,3288224595,3689697817,1672703068,1672705982,2914
3495,3357289672,3710735406,1672566163,1672569501,3338
3848,3713561276,3631479562,1672541259,1672541457,198
3646,3519651506,3552824113,1672674534,1672677339,2805
3491,3793315718,3897456874,1672610798,1672611155,357
3815,3515401243,3600876425,1672545133,1672546995,1862
3870,3770520359,3350095157,1672541674,1672543817,2143
3703,3780253901,3475349791,1672664688,1672666187,1499
3641,3514512367,3755065949,1672664561,1672665588,1027
3507,3485540729,3667427125,1672591714,1672594228,2514
3740,3520657891,3402385957,1672536813,1672537396,583
3429,3637313265,3635169815,1672657742,1672659073,1331
3915,3310039260,3778899160,1672562187,1672563361,1174
3854,3927403123,3756789525,1672683808,1672683879,71
3609,3289114629,3451726367,1672630970,1672631740,770
3620,3495911207,3289114629,1672533316,1672534990,1674
3649,3938503547,3533188828,1672554649,1672558053,3404
3706,3311420950,3520416075,1672642828,1672644416,1588
3462,3780769110,3710496785,1672625658,1672628312,2654
3890,3661447322,3512958459,1672534629,1672537675,3046
3494,3900276517,3621790707,1672676067,1672676956,889
3861,3505481368,3829822608,1672683270,1672684936,1666
3603,3511024016,3899326793,1672599048,1672599326,278
3851,3367971170,3621461051,1672594097,1672597292,3195
3737,3241914067,3306175858,1672610576,1672610662,86
3882,3826238375,3791796585,1672540902,1672543934,3032
3434,3623266256,3772236797,1672571293,1672571938,645
3831,3512830734,3664943873,1672697973,1672699637,1664
3827,3500044458,3511442562,1672614904,1672616069,1165
3528,3517697722,3791753345,1672637083,1672638347,1264
3437,3774641380,3500498112,1672703005,1672703205,200
3537,3520639768,3401496246,1672640814,1672641689,875
3768,3970909253,3773735484,1672697467,1672698886,1419
3461,3309314379,3689114185,1672594040,1672594986,946
3916,3779738691,3276003502,1672613689,1672617244,3555
3670,3316798920,3516298579,1672697554,1672701043,3489
3561,3208957949,3351696332,1672568643,1672569039,396
3835,3780427126,3615737355,1672538601,1672541605,3004
3734,3612689556,3772765746,1672580513,1672582487,1974
3577,3608855425,3635169815,1672686824,1672687402,578
3585,3904412440,3625174002,1672597819,1672601042,3223
3634,3421877923,3516513251,1672596653,1672600042,3389
3838,3730071479,3623266256,1672660669,1672662980,2311
3738,3714827719,3715086894,1672649250,1672652185,2935
3740,3686227677,3935399379,1672633775,1672635983,2208
3784,3467779445,3285204083,1672674222,1672675089,867
3875,3621184108,3780209375,1672658828,1672661561,2733
3905,3270056120,3904867554,1672555997,1672558087,2090
3437,3710735406,3272716462,1672642143,1672643348,1205
3654,3201676087,3890739241,1672551418,1672554053,2635
3448,3511732493,3714233826,1672532444,1672532736,292
3658,3510919821,3440137407,1672673595,1672674986,1391
3616,3970558632,3280268483,1672644264,1672645288,1024
3602,3772765746,3713517039,1672588875,1672589060,185
3502,3855583256,3510964997,1672601823,1672603234,1411
3582,3533079336,3392943173,1672548014,1672548981,967
3710,3730071479,3776988674,1672650154,1672652805,2651
3756,3774718695,3780209375,1672631303,1672633540,2237
3570,3351696332,3511843593,1672651197,1672653364,2167
3892,3835985172,3533294425,1672632039,1672634381,2342
3879,3488763230,3512282789,1672630923,1672632002,1079
3736,3516298579,3505434346,1672651428,1672652700,1272
3857,3733363628,3617489344,1672598721,1672601715,2994
3860,3370227921,3777330107,1672657060,1672660339,3279
3905,3497808662,3928719932,1672624336,1672626146,1810
3523,3668747074,3435116799,1672619078,1672621042,1964
3822,3429943738,3556969573,1672633996,1672634721,725
3698,3614740489,3231713082,1672638424,1672640379,1955
3719,3519651506,3511732493,1672582317,1672582505,188
3786,3703798634,3734915241,1672699827,1672702435,2608
3731,3305336154,3710735406,1672651677,1672654059,2382
3849,3835422146,3492546679,1672585445,1672587741,2296
3542,3224811762,3803389195,1672571007,1672574456,3449
3737,3511005395,3791753345,1672580096,1672580874,778
3500,3505179890,3737972328,1672616089,1672617427,1338
3814,3357864626,3793740407,1672663847,1672664757,910
3846,3757193307,3615688740,1672642547,1672644363,1816
3495,3756127300,3739911441,1672562439,1672564105,1666
3569,3435167810,3505154885,1672607781,1672607948,167
3439,3534126409,3402385957,1672537614,1672538450,836
3488,3736231757,3669146016,1672672536,1672674682,2146
3670,3505521218,3977148669,1672550432,1672551723,1291
3673,3285204083,3510818674,1672602155,1672602949,794
3769,3713979100,3755737419,1672664883,1672665982,1099
3862,3701322924,3431502855,1672633301,1672634868,1567
3800,3613416045,3534126409,1672674263,1672676808,2545
3895,3431502855,3429943738,1672537905,1672540858,2953
3779,3375449013,3884596900,1672560166,1672562000,1834
3528,3756746867,3974674109,1672606858,1672608208,1350
3547,3203538212,3272096759,1672670635,1672671313,678
3727,3665998641,3757294769,1672616967,1672620327,3360
3583,3625463628,3505434346,1672691500,1672694077,2577
3462,3347446226,3900945856,1672619745,1672622411,2666
3720,3333403880,3793407963,1672665634,1672668888,3254
3585,3500827202,3701664364,1672603418,1672603649,231
3466,3777189898,3891672228,1672684925,1672686515,1590
3695,3451326054,3501281016,1672546558,1672548872,2314
3428,3715545685,3500044458,1672662271,1672662826,555
3841,3757294769,3390660440,1672690926,1672692652,1726
3442,3457620713,3760694096,1672679546,1672681198,1652
3708,3778640261,3920625129,1672678526,1672681124,2598
3508,3337362061,3780115155,1672547300,1672548931,1631
3525,3375449013,3200543880,1672591250,1672591795,545
3725,3770624662,3757630221,1672639974,1672641186,1212
3648,3793175445,3472312341,1672584556,1672586429,1873
3719,3279473441,3776988674,1672624726,1672625688,962
3585,3615737355,3385323994,1672615101,1672616629,1528
3607,3793969543,3402385957,1672570055,1672573519,3464
3522,3801645328,3970909253,1672672079,1672675029,2950
3919,3773735484,3515890966,1672594770,1672596588,1818
3437,3501525100,3834963772,1672568304,1672571045,2741
3808,3760651515,3833217041,1672694634,1672694705,71
3632,3511732493,3276217799,1672597750,1672598762,1012
3673,3511288998,3817428320,1672703937,1672704177,240
3707,3779656423,3793407963,1672681697,1672685143,3446
3457,3906536154,3515401243,1672700323,1672702946,2623
3746,3755404116,3534357694,1672581031,1672583360,2329
3662,3757193307,3935487534,1672678158,1672680830,2672
3611,3360069849,3783340788,1672690327,1672691772,1445
3717,3510837901,3680843171,1672618415,1672621364,2949
3692,3338083680,3689114185,1672692035,1672693186,1151
3640,3737112297,3714067076,1672587499,1672589903,2404
3492,3500109249,3519028898,1672661812,1672663709,1897
3436,3977148669,3513360004,1672581048,1672583737,2689
3843,3776034743,3510187271,1672627463,1672630059,2596
3481,3299443125,3661447322,1672674394,1672676009,1615
3749,3755992176,3333403880,1672578202,1672578673,471
3462,3501459390,3376467719,1672632211,1672634238,2027
3529,3791796585,3618489670,1672561944,1672564714,2770
3432,3834960360,3701424609,1672569065,1672569681,616
3870,3793743698,3779425804,1672662035,1672662338,303
3734,3856606678,3716679950,1672551855,1672554848,2993
3730,3438489358,3680843171,1672641179,1672642594,1415
3896,3520764926,3818575661,1672671120,1672672981,1861
3464,3421877923,3299443125,1672589062,1672591251,2189
3451,3533929349,3778597171,1672599198,1672601064,1866
3909,3756789525,3668747074,1672541610,1672544398,2788
3674,3467779445,3399472693,1672628461,1672629600,1139
3583,3517288083,3505434346,1672600470,1672603606,3136
3742,3633735593,3776518452,1672612258,1672614101,1843
3477,3711853996,3755992176,1672606925,1672608605,1680
3623,3836241528,3500915665,1672567718,1672571299,3581
3852,3393063657,3505725706,1672593974,1672597524,3550
3866,3779639983,3713561276,1672643510,1672644057,547
3848,3372223551,3333403880,1672570258,1672572483,2225
3713,3288762795,3534566651,1672587189,1672589923,2734
3528,3630353876,3608232640,1672590707,1672591577,870
3830,3703396825,3618489670,1672690229,1672691709,1480
3678,3513295938,3449333754,1672593072,1672594494,1422
3615,3701373490,3308760650,1672638431,1672640906,2475
3886,3685816610,3714128600,1672563176,1672565903,2727
3794,3668533536,3519077659,1672682967,1672685370,2403
3564,3703383853,3617392620,1672602623,1672605492,2869
3675,3515402792,3236354255,1672658501,1672661795,3294
3909,3316800320,3979802715,1672565067,1672565811,744
3432,3770520359,3224968597,1672579058,1672582347,3289
3797,3884596900,3632814465,1672611633,1672614402,2769
3625,3977148669,3755233658,1672609238,1672611502,2264
3837,3299125059,3970603231,1672585094,1672585295,201
3508,3639050419,3330340793,1672621363,1672623063,1700
3608,3513327337,3512946768,1672614212,1672616897,2685
3840,3770296583,3500915908,1672549796,1672551945,2149
3919,3510642075,3619922891,1672658825,1672660010,1185
3548,3364726656,3289114629,1672644522,1672644910,388
3634,3311098437,3772236797,1672675492,1672677746,2254
3555,3500604680,3404025196,1672677965,1672679789,1824
3712,3335694356,3859868849,1672630885,1672631084,199
3692,3760094385,3511732493,1672615141,1672615554,413
3903,3513345163,3880926355,1672681498,1672684953,3455
3678,3488686442,3305336154,1672559321,1672562273,2952
3513,3513853403,3909094917,1672536764,1672536826,62
3769,3928719932,3533423872,1672567042,1672568734,1692
3775,3512392431,3852686295,1672577207,1672579694,2487
3776,3803389195,3622665543,1672540557,1672542498,1941
3839,3689697817,3505807416,1672668313,1672670839,2526
3813,3970198861,3370227921,1672650061,1672651629,1568
3702,3935913584,3392520516,1672555465,1672558298,2833
3679,3229822507,3733363628,1672698199,1672700113,1914
3552,3615087943,3710008361,1672694378,1672695616,1238
3465,3715854030,3778040015,1672617943,1672619978,2035
3760,3505521218,3227799827,1672615468,1672615965,497
3481,3441348818,3511150845,1672700894,1672701602,708
3741,3683113954,3801645328,1672631608,1672632276,668
3693,3480490124,3472312341,1672534535,1672534735,200
3728,3756625818,3714666884,1672663406,1672666081,2675
3509,3472068734,3711218296,1672550563,1672554017,3454
3804,3898314440,3920497528,1672672327,1672673403,1076
3818,3224811762,3276348699,1672587044,1672590603,3559
3842,3714128600,3272096759,1672597080,1672598194,1114
3526,3938503547,3802932312,1672532781,1672535307,2526
3786,3428027649,3230868435,1672543699,1672546534,2835
3817,3927403123,3304155815,1672609017,1672612616,3599
3494,3472068734,3343816795,1672548570,1672550586,2016
3546,3970909253,3488763230,1672690583,1672691328,745
3743,3512502036,3803389195,1672597677,1672600686,3009
3720,3335694356,3519142371,1672676772,1672676999,227
3576,3627368399,3513041785,1672610199,1672612343,2144
3492,3779646172,3512958459,1672657742,1672658619,877
3860,3398198430,3605221116,1672699390,1672701847,2457
3883,3500709774,3617489344,1672655132,1672657640,2508
3813,3977148669,3440107959,1672552594,1672553987,1393
3626,3977352557,3511317276,1672651697,1672654695,2998
3677,3291933594,3713911104,1672660960,1672664344,3384
3430,3669146016,3778134418,1672543761,1672544762,1001
3823,3609113156,3299443125,1672541063,1672543870,2807
3706,3514246749,3501459390,1672669153,1672670895,1742
3513,3455018347,3385323994,1672576195,1672576730,535
3848,3885157459,3618808151,1672571128,1672573519,2391
3541,3779301501,3735374579,1672561857,1672562227,370
3730,3783771827,3370227921,1672698392,1672701890,3498
3851,3364726656,3519087371,1672575433,1672578959,3526
3888,3791693821,3336339664,1672690321,1672691693,1372
3572,3463740710,3905196766,1672609622,1672611458,1836
3910,3393063657,3236458894,1672556494,1672558209,1715
3802,3755222916,3240994288,1672549749,1672549978,229
3486,3755532873,3776988674,1672695303,1672695571,268
3729,3902861231,3511843593,1672551506,1672553868,2362
3464,3512295534,3201800997,1672641831,1672642155,324
3887,3779854934,3410160376,1672642853,1672646258,3405
3501,3736705719,3755158925,1672679148,1672679866,718
3768,3299443125,3319167958,1672682851,1672685046,2195
3814,3500841914,3792505974,1672574393,1672576199,1806
3774,3333403880,3801645328,1672682810,1672683100,290
3720,3505888598,3520578796,1672563439,1672564057,618
3426,3386758279,3510641433,1672688262,1672689312,1050
3905,3520639768,3783163143,1672562096,1672564151,2055
3890,3716272919,3783641602,1672542957,1672543534,577
3764,3349739136,3607768197,1672623398,1672625977,2579
3743,3783928182,3792546035,1672658956,1672659194,238
3874,3500949309,3916490839,1672646574,1672650131,3557
3515,3534543776,3701882224,1672681592,1672682526,934
3518,3500827202,3500044458,1672597972,1672600217,2245
3596,3513545422,3760263530,1672537525,1672538079,554
3490,3520355798,3519077659,1672602333,1672604062,1729
3858,3445206685,3783550022,1672606877,1672608585,1708
3461,3736705719,3779425804,1672603625,1672604307,682
3542,3457620713,3372223551,1672566373,1672567956,1583
3632,3710735406,3241790910,1672553880,1672556256,2376
3661,3819767045,3370227921,1672600764,1672602549,1785
3624,3783520186,3776084820,1672594454,1672595411,957
3477,3815392801,3513041785,1672545480,1672545621,141
3482,3703798634,3490214516,1672539871,1672542802,2931
3820,3801645328,3511150845,1672667433,1672670377,2944
3481,3760263530,3390660440,1672691284,1672694808,3524
3854,3371455553,3902760230,1672567623,1672568699,1076
3910,3280268483,3609933747,1672549720,1672552799,3079
3786,3923420131,3714120857,1672583595,1672585386,1791
3912,3385323994,3739661856,1672579693,1672580507,814
3545,3519087371,3711218296,1672677451,1672678441,990
3568,3511601997,3897435944,1672531495,1672531600,105
3827,3519651506,3755756564,1672538872,1672539014,142
3448,3776034743,3515559913,1672665780,1672667570,1790
3835,3559458968,3510554314,1672547072,1672548773,1701
3704,3334993594,3333918941,1672619579,1672622629,3050
3575,3622357348,3608855425,1672667941,1672668560,619
3636,3701107228,3349856820,1672575243,1672575607,364
3528,3637313265,3780571086,1672531873,1672532973,1100
3624,3441348818,3920625129,1672585397,1672586294,897
3755,3777037426,3505437712,1672547898,1672548083,185
3851,3284932450,3773124276,1672703270,1672706735,3465
3676,3501384020,3463849738,1672640458,1672642526,2068
3582,3757294769,3534126409,1672537521,1672540332,2811
3457,3836241528,3451691949,1672676010,1672678881,2871
3845,3731646673,3517737088,1672586308,1672588963,2655
3617,3500703304,3520560590,1672691296,1672692564,1268
3582,3351866415,3448633776,1672573680,1672574895,1215
3829,3834631333,3240394404,1672611946,1672615000,3054
3498,3792442597,3460719322,1672633784,1672634712,928
3563,3791753345,3833217041,1672565447,1672568600,3153
3817,3701882224,3715127070,1672543601,1672546432,2831
3848,3497671225,3513041785,1672697339,1672698196,857
3904,3793583656,3362641275,1672673197,1672673469,272
3546,3900276517,3505995057,1672556381,1672557515,1134
3761,3885121158,3534543776,1672592075,1672594744,2669
3436,3370227921,3613899351,1672647355,1672648891,1536
3747,3852686295,3461119815,1672656724,1672659150,2426
3560,3900898992,3615113018,1672573073,1672574575,1502
3853,3834963772,3714233826,1672602087,1672604941,2854
3514,3811040565,3501215099,1672563453,1672565247,1794
3461,3885121158,3497808662,1672549891,1672550014,123
3714,3500737582,3780834916,1672649259,1672649703,444
3868,3755532873,3229974066,1672634705,1672635941,1236
3671,3200543880,3513295938,1672696869,1672699528,2659
3825,3774718695,3890739241,1672636233,1672637235,1002
3554,3349856820,3760721303,1672624103,1672626998,2895
3452,3230868435,3833217041,1672540447,1672540652,205
3665,3713300120,3514275974,1672625155,1672625572,417
3853,3305336154,3200543880,1672602994,1672606420,3426
3777,3793935736,3770146716,1672580625,1672583172,2547
3440,3890739241,3509893027,1672671561,1672671930,369
3472,3288762795,3513295938,1672545721,1672547749,2028
3517,3357689359,3272030610,1672626879,1672627190,311
3897,3931627862,3661583097,1672553154,1672555375,2221
3619,3520578796,3330340793,1672667040,1672668601,1561
3804,3512722110,3368283077,1672654047,1672654567,520
3524,3783136330,3885155975,1672611056,1672612113,1057
3613,3517687662,3517687662,1672698220,1672700180,1960
3728,3715974659,3463740710,1672556271,1672558964,2693
3699,3335694356,3668533536,1672646434,1672650028,3594
3849,3779892400,3435116799,1672532106,1672534132,2026
3727,3289114629,3533274994,1672651185,1672653912,2727
3668,3511150845,3905196766,1672614043,1672616183,2140
3736,3226511603,3661903000,1672642854,1672646439,3585
3561,3337362061,3551376095,1672695651,1672697988,2337
3817,3367509761,3408498208,1672650959,1672652553,1594
3466,3501567772,3300229945,1672675218,1672676757,1539
3890,3714666884,3739911441,1672548108,1672550545,2437
3872,3306175858,3778040015,1672659601,1672660576,975
3796,3739154408,3472312341,1672645566,1672647082,1516
3683,3757348722,3835985172,1672596118,1672597999,1881
3560,3311098437,3774907131,1672606957,1672607872,915
3723,3773027597,3739911441,1672629983,1672631765,1782
3817,3510964997,3703396825,1672557640,1672560444,2804
3842,3225029895,3510554314,1672545951,1672547331,1380
3783,3202141727,3904867554,1672662438,1672665165,2727
3579,3534175249,3449639012,1672609305,1672612472,3167
3614,3970627281,3895285664,1672650873,1672652546,1673
3436,3713163045,3396726504,1672595790,1672597011,1221
3575,3497808662,3428027649,1672615478,1672619006,3528
3427,3239617320,3731646673,1672583692,1672584893,1201
3647,3792489602,3304155815,1672618300,1672621326,3026
3542,3411688875,3783550022,1672572336,1672573621,1285
3906,3490029863,3533228966,1672545843,1672547808,1965
3613,3337322736,3480726047,1672684942,1672686240,1298
3602,3510818674,3533368789,1672538461,1672541376,2915
3636,3715974659,3202804048,1672607240,1672610163,2923
3902,3783433404,3630353876,1672676367,1672677543,1176
3631,3393063657,3773902805,1672667893,1672670481,2588
3695,3777330107,3713561276,1672601081,1672604314,3233
3772,3779738691,3379143440,1672683942,1672687080,3138
3715,3773837847,3715619259,1672572391,1672574989,2598
3520,3518561777,3510964997,1672647352,1672650944,3592
3537,3778640261,3520560590,1672598161,1672599446,1285
3535,3618808151,3921648519,1672691135,1672694321,3186
3828,3895285664,3399472693,1672536007,1672538293,2286
3676,3428027649,3519909393,1672652823,1672655419,2596
3571,3316800320,3513410578,1672551223,1672553299,2076
3446,3505434346,3224330592,1672562908,1672563704,796
3906,3447672935,3819767045,1672694724,1672695876,1152
3620,3889780657,3510554314,1672543741,1672544942,1201
3542,3270697740,3499217428,1672625963,1672628060,2097
3672,3534179433,3513327337,1672542164,1672543407,1243
3632,3932478321,3294747828,1672672490,1672672708,218
3688,3714678331,3791106564,1672633629,1672634177,548
3538,3711734586,3900276517,1672537598,1672538332,734
3644,3899326793,3516444201,1672675549,1672678869,3320
3634,3520355798,3288224595,1672549493,1672550788,1295
3482,3823084403,3783147088,1672602700,1672604479,1779
3818,3625174002,3533188828,1672672346,1672674253,1907
3687,3202141727,3739661856,1672607610,1672608211,601
3897,3715986185,3713561276,1672649707,1672650878,1171
3922,3510798825,3337362061,1672694490,1672697517,3027
3874,3501121099,3226511603,1672567436,1672570794,3358
3564,3710048469,3515890966,1672598283,1672598981,698
3789,3447514821,3792546035,1672558998,1672559939,941
3439,3467779445,3683113954,1672643827,1672645782,1955
3625,3776244398,3777330107,1672568855,1672571188,2333
3655,3462636434,3757294769,1672590264,1672590833,569
3480,3517881647,3386758279,1672623322,1672623482,160
3721,3363162590,3710854064,1672571009,1672572001,992
3505,3933894942,3710854064,1672553368,1672556454,3086
3427,3246370118,3756746867,1672677510,1672679401,1891
3486,3412968120,3236354255,1672538993,1672539595,602
3855,3783169442,3970627281,1672661018,1672664476,3458
3683,3428027649,3757383891,1672679563,1672680070,507
3905,3776244398,3511732493,1672577973,1672580623,2650
3521,3519282716,3777814504,1672668958,1672669375,417
3701,3920625129,3755065949,1672549474,1672550597,1123
3727,3500347447,3713768950,1672619429,1672619911,482
3703,3410160376,3505847380,1672653266,1672654389,1123
3623,3803389195,3835422146,1672697155,1672699331,2176
3598,3501121099,3520560590,1672700794,1672701129,335
3829,3500109249,3505888598,1672566296,1672569173,2877
3567,3293835352,3714067076,1672615233,1672616689,1456
3920,3669146016,3760040019,1672619104,1672619898,794
3498,3449333754,3319167958,1672578292,1672581627,3335
3594,3890739241,3710735406,1672617787,1672619333,1546
3540,3202804048,3780571086,1672703480,1672703629,149
3481,3236499444,3367111751,1672594582,1672596019,1437
3711,3791046864,3618354185,1672661536,1672661873,337
3529,3279473441,3900276517,1672640324,1672642022,1698
3610,3519818818,3885155975,1672567662,1672568317,655
3470,3930242012,3505725706,1672591709,1672593711,2002
3734,3825881598,3760645796,1672650972,1672651348,376
3727,3514971533,3757332128,1672664733,1672667910,3177
3576,3701005527,3515559913,1672684985,1672688561,3576
3773,3614740489,3460719322,1672627881,1672628081,200
3649,3713829743,3621683102,1672548923,1672549971,1048
3891,3520322124,3902861231,1672618659,1672621384,2725
3509,3296462324,3514956366,1672607029,1672608502,1473
3709,3803389195,3856606678,1672603453,1672603686,233
3793,3701823816,3505807416,1672581616,1672585160,3544
3597,3627368399,3557046880,1672545830,1672549001,3171
3892,3481640525,3333403880,1672570079,1672570815,736
3620,3509764635,3776559988,1672696411,1672699309,2898
3548,3392520516,3501525100,1672630079,1672633418,3339
3429,3205923620,3431502855,1672667305,1672669571,2266
3726,3710735406,3428725843,1672651517,1672652204,687
3545,3533228966,3226024417,1672612359,1672613869,1510
3516,3614740489,3713768950,1672643389,1672644104,715
3480,3734118023,3362641275,1672603481,1672603639,158
3719,3299443125,3792489602,1672678987,1672681935,2948
3432,3505283390,3441348818,1672583283,1672586332,3049
3668,3493017654,3500109249,1672626752,1672630238,3486
3647,3905196766,3505995057,1672638271,1672640711,2440
3729,3783147088,3349856820,1672599190,1672600322,1132
3537,3225029895,3349856820,1672624687,1672626092,1405
3756,3928719932,3505434346,1672579787,1672580696,909
3567,3756625818,3623266256,1672664907,1672668194,3287
3524,3229822507,3446533960,1672651555,1672652506,951
3785,3701664364,3779301501,1672632519,1672632598,79
3846,3783520186,3812369928,1672647655,1672650748,3093
3816,3885155975,3296462324,1672697752,1672698329,577
3504,3516741440,3401496246,1672595559,1672597160,1601
3630,3755404116,3248058676,1672579002,1672579198,196
3796,3289114629,3533079336,1672605257,1672605867,610
3445,3688490530,3970603231,1672655620,1672658193,2573
3810,3551399764,3755222916,1672594341,1672597422,3081
3498,3622357348,3667673649,1672559246,1672560807,1561
3797,3400069268,3774907131,1672676570,1672677999,1429
3786,3792489602,3610870949,1672702434,1672704019,1585
3912,3755915206,3925979970,1672544811,1672546426,1615
3918,3739895284,3505481368,1672586632,1672588404,1772
3725,3803389195,3272096759,1672606437,1672607674,1237
3733,3367509761,3777184389,1672540578,1672541823,1245
3427,3713768950,3776117322,1672554860,1672556777,1917
3539,3270056120,3914691363,1672674222,1672675944,1722
3860,3414940786,3701136026,1672557999,1672559782,1783
3460,3469254160,3424660806,1672603034,1672603345,311
3911,3792489602,3814677862,1672672625,1672675478,2853
3482,3792525861,3283492940,1672656497,1672658390,1893
3550,3310039260,3703798634,1672661783,1672663973,2190
3783,3824641227,3512958459,1672563793,1672566856,3063
3644,3305722859,3935487534,1672681464,1672684180,2716
3907,3703798634,3226511603,1672633335,1672633805,470
3839,3701884158,3791128487,1672641429,1672642721,1292
3670,3367111751,3515890966,1672557269,1672559455,2186
3820,3518229776,3520578796,1672640693,1672642364,1671
3757,3367509761,3518565331,1672580735,1672582805,2070
3480,3928511283,3520764926,1672580048,1672580404,356
3819,3534179433,3858172636,1672623311,1672624040,729
3861,3885121158,3970909253,1672661547,1672665007,3460
3743,3497095254,3533228966,1672607824,1672611366,3542
3430,3519282716,3554825448,1672585376,1672585652,276
3881,3852686295,3505847380,1672590200,1672590549,349
3434,3885155975,3490214516,1672689737,1672690971,1234
3795,3551376095,3621683102,1672684861,1672686701,1840
3568,3513041785,3392520516,1672630437,1672633228,2791
3737,3885155975,3512502036,1672640196,1672642502,2306
3673,3793740407,3607882826,1672636145,1672636415,270
3476,3294703680,3772078494,1672601457,1672602023,566
3685,3448633776,3639050419,1672629796,1672630735,939
3449,3776518452,3711734586,1672626548,1672629775,3227
3602,3631479562,3779613523,1672634397,1672636789,2392
3891,3438078818,3341893384,1672556498,1672558781,2283
3455,3450286949,3609113156,1672674360,1672677066,2706
3693,3288224595,3757193551,1672618193,1672620047,1854
3851,3520991398,3834963772,1672637382,1672638770,1388
3889,3451326054,3774155692,1672601755,1672605214,3459
3785,3284947372,3664943873,1672547355,1672548940,1585
3601,3711097754,3774790271,1672647431,1672650051,2620
3504,3793883863,3534829213,1672555310,1672556315,1005
3914,3812534508,3289114629,1672649435,1672652432,2997
3668,3518653080,3273981374,1672667818,1672668374,556
3613,3380130228,3457960571,1672625770,1672629299,3529
3622,3481640525,3517288083,1672569566,1672571878,2312
3461,3284947372,3791796585,1672609436,1672610618,1182
3435,3703396825,3701884158,1672674763,1672675894,1131
3817,3852686295,3367509761,1672540821,1672542411,1590
3883,3824215187,3411515369,1672594002,1672595006,1004
3450,3519142371,3926643445,1672604102,1672605313,1211
3487,3661583097,3372223551,1672670831,1672672722,1891
3802,3505807416,3776034743,1672688931,1672688995,64
3518,3713163045,3710008361,1672610806,1672612009,1203
3794,3815392801,3456430614,1672697495,1672697740,245
3828,3773902805,3736231757,1672631587,1672632492,905
3779,3776034743,3668533536,1672685848,1672687047,1199
3833,3779786641,3519087371,1672569095,1672569932,837
3875,3480726047,3885157459,1672682682,1672683720,1038
3708,3713979100,3514818819,1672696815,1672697094,279
3432,3779613523,3452016771,1672699801,1672701379,1578
3616,3337322736,3398198430,1672542537,1672545575,3038
3556,3519142371,3315703693,1672577535,1672579026,1491
3738,3792014516,3516298579,1672692365,1672693661,1296
3847,3291933594,3510964997,1672586711,1672588027,1316
3494,3774876004,3517991730,1672639583,1672640180,597
3502,3514741348,3920898925,1672574448,1672577130,2682
3489,3773735484,3306175858,1672669656,1672671862,2206
3777,3689114185,3228888030,1672582585,1672583152,567
3740,3711218296,3534566651,1672563156,1672565671,2515
3826,3410600350,3803517637,1672690189,1672691226,1037
3743,3892304880,3520991398,1672673441,1672675298,1857
3685,3780769110,3392836218,1672634674,1672637782,3108
3676,3227799827,3610358027,1672640944,1672641763,819
3700,3701664364,3382733096,1672624532,1672628127,3595
3545,3760694096,3774605761,1672640568,1672640700,132
3734,3351866415,3298151889,1672664614,1672665190,576
3722,3928719932,3774243020,1672575165,1672576378,1213
3517,3505266860,3236458894,1672579139,1672582073,2934
3545,3776831527,3608855425,1672696021,1672696584,563
3464,3605221116,3366423342,1672691319,1672693626,2307
3500,3605221116,3500525825,1672619258,1672621868,2610
3856,3613206049,3511005395,1672681259,1672684580,3321
3568,3515559913,3755158925,1672612967,1672613332,365
3584,3300818269,3205923620,1672565266,1672566590,1324
3816,3283770991,3609113156,1672546520,1672547858,1338
3471,3737972328,3834631333,1672637636,1672638088,452
3496,3776518452,3500737582,1672677717,1672680150,2433
3868,3488686442,3935913584,1672611527,1672614894,3367
3629,3515401243,3780872464,1672540016,1672540380,364
3517,3610358027,3375449013,1672542283,1672543452,1169
3793,3533294425,3902760230,1672646418,1672647816,1398
3442,3294747828,3511442562,1672656026,1672659355,3329
3508,3516444201,3431502855,1672557331,1672557744,413
3910,3513345163,3495911207,1672659461,1672660183,722
3903,3780115155,3517991730,1672607323,1672608718,1395
3701,3488763230,3469254160,1672681115,1672681295,180
3811,3289114629,3402385957,1672598986,1672602078,3092
3707,3835422146,3513065217,1672692283,1672695075,2792
3488,3515525630,3772391882,1672587316,1672589766,2450
3604,3607882826,3711853996,1672557508,1672558672,1164
3575,3441348818,3757323954,1672661453,1672662244,791
3744,3517697722,3467988782,1672661281,1672663985,2704
3917,3714666884,3424445495,1672682988,1672685203,2215
3468,3480490124,3824215187,1672589498,1672590747,1249
3489,3783520186,3731646673,1672679782,1672682373,2591
3546,3299125059,3421385957,1672560637,1672561873,1236
3659,3514324011,3271752081,1672666513,1672668796,2283
3567,3970909253,3815392801,1672549013,1672550928,1915
3678,3510641433,3224330592,1672656061,1672658192,2131
3840,3618489670,3279242917,1672567991,1672571215,3224
3511,3909094917,3205985903,1672646031,1672646591,560
3765,3460719322,3757294769,1672539483,1672540755,1272
3911,3350095157,3858172636,1672533527,1672534636,1109
3449,3300979975,3284932450,1672563445,1672566427,2982
3628,3448875382,3415833929,1672650545,1672650835,290
3588,3928511283,3900898992,1672636783,1672637220,437
3812,3625174002,3299125059,1672646847,1672648254,1407
3430,3701823816,3715707380,1672601833,1672604115,2282
3475,3770704999,3893912331,1672679108,1672681754,2646
3717,3500208903,3776244398,1672642137,1672645729,3592
3816,3505434346,3661583097,1672600989,1672602129,1140
3438,3777184389,3514334067,1672543421,1672544787,1366
3468,3792538417,3512295534,1672568001,1672571191,3190
3819,3760645796,3225029895,1672624162,1672626388,2226
3875,3757318448,3817428320,1672648228,1672649351,1123
3434,3829864515,3224330592,1672594322,1672594529,207
3470,3357864626,3518565331,1672666959,1672670296,3337
3698,3357289672,3559458968,1672541621,1672541929,308
3880,3500109249,3777779869,1672672552,1672674920,2368
3470,3680843171,3437286517,1672642896,1672644005,1109
3507,3440107959,3373028638,1672583358,1672585750,2392
3599,3505807416,3505807416,1672630309,1672633425,3116
3551,3375449013,3533228966,1672627085,1672628180,1095
3690,3270697740,3304155815,1672556252,1672557833,1581
3504,3441348818,3288224595,1672638202,1672639691,1489
3534,3755915206,3511843593,1672573662,1672575575,1913
3830,3774243020,3829864515,1672687231,1672689176,1945
3592,3367971170,3715545685,1672646624,1672648769,2145
3659,3800257590,3731646673,1672661297,1672663046,1749
3888,3283492940,3516741440,1672681095,1672682261,1166
3505,3513065217,3637313265,1672666137,1672668679,2542
3587,3899786664,3772078494,1672628965,1672630212,1247
3757,3225631197,3533294425,1672591683,1672594357,2674
3469,3303410628,3972192593,1672699576,1672702313,2737
3903,3225631197,3701664364,1672694266,1672697175,2909
3648,3892304880,3608922867,1672596533,1672597491,958
3783,3505995057,3757700712,1672657461,1672660448,2987
3671,3714128600,3783801141,1672692097,1672692504,407
3594,3667427125,3410538749,1672666459,1672666593,134
3796,3613416045,3202804048,1672542039,1672544924,2885
3469,3533294425,3398731252,1672563989,1672566087,2098
3585,3533004959,3715443333,1672691961,1672695535,3574
3711,3780338697,3387594369,1672552503,1672554124,1621
3848,3730071479,3239617320,1672619498,1672621164,1666
3476,3600876425,3760364383,1672542999,1672543583,584
3472,3349856820,3661903000,1672686440,1672689975,3535
3683,3232208416,3638204468,1672553623,1672554115,492
3761,3710315160,3904569677,1672551224,1672554556,3332
3430,3438489358,3305722859,1672700978,1672701380,402
3571,3928719932,3559731671,1672588011,1672588109,98
3693,3520115090,3760094385,1672661318,1672661626,308
3644,3928511283,3770704999,1672654030,1672654799,769
3545,3803389195,3638204468,1672573816,1672575234,1418
3596,3774705415,3714670620,1672582211,1672583193,982
3635,3500317969,3519909393,1672597739,1672598340,601
3579,3467988782,3637313265,1672666984,1672667859,875
3795,3783340788,3533004959,1672590394,1672593216,2822
3903,3500347447,3448633776,1672703594,1672707169,3575
3759,3209481722,3227799827,1672619200,1672621160,1960
3444,3512337405,3899326793,1672579066,1672579438,372
3482,3500347447,3923420131,1672540093,1672542559,2466
3849,3701664364,3511791953,1672674877,1672675033,156
3882,3715707380,3410538749,1672574069,1672577623,3554
3732,3273981374,3777694660,1672538232,1672540151,1919
3750,3772078494,3505923418,1672565254,1672568288,3034
3806,3803389195,3512392431,1672633287,1672636127,2840
3495,3400763927,3500317969,1672667289,1672668516,1227
3652,3520115090,3362641275,1672580151,1672583450,3299
3896,3283144118,3457960571,1672692824,1672693625,801
3733,3274906650,3533423872,1672589956,1672590475,519
3772,3776831527,3517358573,1672644016,1672646466,2450
3907,3920898925,3513065217,1672703863,1672705687,1824
3495,3633735593,3885121158,1672679561,1672680045,484
3714,3715385401,3414275042,1672591448,1672593831,2383
3453,3755992176,3755404116,1672584987,1672585776,789
3424,3516489668,3454277788,1672579035,1672581396,2361
3452,3885157459,3680810086,1672599897,1672603180,3283
3542,3559731671,3439673892,1672672118,1672673333,1215
3776,3734451191,3826238375,1672595904,1672598748,2844
3839,3900898992,3627368399,1672605717,1672606592,875
3616,3410538749,3773009828,1672594726,1672597802,3076
3885,3683113954,3551376095,1672702960,1672705832,2872
3431,3501384020,3509366311,1672628029,1672631465,3436
3908,3510919821,3637313265,1672641658,1672643310,1652
3766,3900898992,3931627862,1672542937,1672544095,1158
3710,3926643445,3437286517,1672621743,1672622666,923
3445,3604589802,3773124276,1672624868,1672626947,2079
3809,3505179890,3306412634,1672607553,1672611026,3473
3644,3311085279,3513018485,1672589864,1672591315,1451
3845,3689697817,3513296868,1672605596,1672609031,3435
3597,3393063657,3835422146,1672663477,1672665806,2329
3512,3225631197,3417191856,1672622653,1672625360,2707
3756,3856606678,3760263530,1672673875,1672675221,1346
3796,3238288884,3517172354,1672667426,1672668004,578
3659,3608232640,3773735484,1672547849,1672549834,1985
3507,3559731671,3637313265,1672545945,1672546989,1044
3714,3505807416,3817813340,1672560179,1672560519,340
3628,3932478321,3209526819,1672601329,1672603852,2523
3645,3230135532,3905899155,1672668031,1672668358,327
3565,3835985172,3445206685,1672600137,1672601215,1078
3810,3520657891,3777779869,1672549970,1672552082,2112
3724,3770704999,3774705415,1672680038,1672682029,1991
3431,3756746867,3513018485,1672668541,1672670065,1524
3505,3493017654,3738026330,1672648950,1672650770,1820
3668,3495911207,3447514821,1672634854,1672637639,2785
3917,3519909393,3817428320,1672687266,1672689759,2493
3565,3755233658,3716963089,1672677213,1672677400,187
3714,3713941638,3897376951,1672608194,1672609712,1518
3584,3509366311,3778667336,1672562038,1672563559,1521
3817,3205985903,3272716462,1672549555,1672553018,3463
3773,3792020993,3500442734,1672598174,1672600567,2393
3890,3774790271,3792274796,1672616075,1672617283,1208
3749,3757332128,3613206049,1672549951,1672550142,191
3548,3511843593,3609113156,1672565100,1672567499,2399
3544,3777184389,3715974659,1672597742,1672598568,826
3578,3509893027,3501121099,1672700020,1672700877,857
3696,3520639768,3305336154,1672540969,1672542374,1405
3504,3716679950,3284947372,1672625473,1672626314,841
3570,3533929349,3333918941,1672638559,1672641852,3293
3837,3518561777,3350095157,1672589915,1672593270,3355
3563,3350095157,3513360004,1672640338,1672643357,3019
3832,3821054646,3783136330,1672635021,1672635678,657
3914,3241790910,3515402792,1672591850,1672594473,2623
3789,3203538212,3732584121,1672617576,1672620923,3347
3651,3505198734,3244004456,1672542802,1672546087,3285
3813,3551399764,3900945856,1672542295,1672544042,1747
3548,3289114629,3306175858,1672656513,1672658275,1762
3532,3904412440,3534764451,1672668386,1672670924,2538
3894,3500777439,3515402792,1672588751,1672591394,2643
3657,3380982774,3460719322,1672600037,1672602972,2935
3783,3520355798,3520991398,1672618110,1672619831,1721
3778,3468041839,3783615982,1672578088,1672578588,500
3882,3825881598,3622357348,1672698567,1672699794,1227
3557,3618697021,3283770991,1672628097,1672630786,2689
3525,3701884158,3732584121,1672604310,1672604790,480
3551,3488763230,3934064792,1672703332,1672705045,1713
3665,3270042456,3773572967,1672567627,1672571008,3381
3613,3500072204,3533368789,1672540133,1672540309,176
3719,3511601997,3638204468,1672543238,1672544603,1365
3691,3715974659,3402697190,1672643226,1672645142,1916
3652,3850911686,3776034743,1672657827,1672659915,2088
3901,3272096759,3807212280,1672580266,1672581995,1729
3803,3715385401,3684523966,1672643059,1672643572,513
3879,3626499450,3500857494,1672542876,1672545945,3069
3522,3756385685,3500442734,1672650361,1672652620,2259
3470,3517462308,3514334067,1672658254,1672661376,3122
3762,3735374579,3623266256,1672639143,1672640383,1240
3509,3905196766,3930242012,1672551262,1672554546,3284
3838,3505402439,3398731252,1672533056,1672536465,3409
3894,3617116290,3714128600,1672559779,1672563342,3563
3702,3701322924,3807212280,1672651450,1672653014,1564
3739,3209526819,3757323954,1672633992,1672637395,3403
3542,3701247948,3513327337,1672696777,1672696856,79
3520,3366423342,3517697722,1672627519,1672630320,2801
3678,3334974375,3500341755,1672669826,1672670395,569
3482,3510499038,3818575661,1672680695,1672681230,535
3473,3932478321,3607768197,1672702231,1672703437,1206
3672,3447514821,3512882178,1672676407,1672676735,328
3774,3209481722,3491469603,1672621716,1672623074,1358
3614,3512800570,3304971369,1672696048,1672696808,760
3912,3270056120,3755404116,1672584049,1672586771,2722
3754,3440137407,3480991549,1672660521,1672661117,596
3638,3500208903,3294747828,1672597266,1672598597,1331
3623,3333403880,3206837348,1672545317,1672547194,1877
3455,3519651506,3792525861,1672623425,1672623959,534
3641,3756704774,3343132529,1672642591,1672642668,77
3873,3791046864,3559458968,1672544436,1672546224,1788
3552,3520873221,3773837847,1672671646,1672673167,1521
3472,3488686442,3755230952,1672546573,1672549106,2533
3640,3680810086,3200543880,1672576952,1672579638,2686
3434,3760842815,3734451191,1672640340,1672640513,173
3606,3801645328,3288224595,1672571419,1672573990,2571
3531,3497671225,3431502855,1672660378,1672660933,555
3821,3505663516,3783928182,1672592718,1672593937,1219
3588,3716963089,3350095157,1672684345,1672687523,3178
3481,3500317969,3778926763,1672675690,1672678748,3058
3707,3364378127,3607768197,1672551723,1672554179,2456
3702,3770236215,3510499038,1672596194,1672597775,1581
3742,3902760230,3505847380,1672539702,1672542945,3243
3626,3931627862,3777624586,1672632110,1672633622,1512
3429,3859868849,3517172354,1672557168,1672559720,2552
3665,3716110860,3510798825,1672655193,1672657242,2049
3525,3343132529,3793740407,1672621636,1672623396,1760
3734,3289114629,3501457103,1672659960,1672663280,3320
3921,3347446226,3618697021,1672666788,1672668939,2151
3541,3514246749,3510499038,1672647341,1672649115,1774
3878,3510499038,3713589994,1672665247,1672667428,2181
3497,3516741440,3457620713,1672691853,1672692255,402
3680,3299781901,3514285803,1672535782,1672539009,3227
3790,3511883730,3372223551,1672632723,1672634959,2236
3456,3757318448,3792072681,1672642334,1672645033,2699
3550,3607768197,3713784974,1672622070,1672624358,2288
3875,3713163045,3792274796,1672634353,1672634501,148
3677,3780872464,3513410578,1672554462,1672557052,2590
3556,3360813161,3814305099,1672607061,1672607430,369
3701,3739911441,3500525825,1672700220,1672701199,979
3439,3370068529,3394401087,1672699104,1672699956,852
3561,3812369928,3510767239,1672621819,1672622635,816
3440,3533188828,3793883863,1672606342,1672609310,2968
3602,3448633776,3533079336,1672579988,1672580290,302
3921,3938503547,3368283077,1672618151,1672619879,1728
3455,3514275974,3505888598,1672597505,1672600501,2996
3878,3380767040,3713561276,1672657149,1672657309,160
3752,3715127070,3519416013,1672560070,1672561193,1123
3601,3512830734,3701882224,1672700192,1672701442,1250
3863,3792489602,3777814504,1672645213,1672647865,2652
3781,3304971369,3335694356,1672538700,1672540453,1753
3710,3793922324,3923754072,1672596163,1672598867,2704
3475,3520115090,3776034743,1672540856,1672544275,3419
3801,3710315160,3615087943,1672672663,1672673659,996
3697,3351696332,3711077927,1672678821,1672679051,230
3444,3780338697,3513065217,1672562714,1672564086,1372
3727,3615737355,3890739241,1672640562,1672640724,162
3853,3315279093,3468041839,1672676508,1672678315,1807
3877,3776559988,3510641433,1672564380,1672566984,2604
3825,3853629553,3639050419,1672621074,1672623543,2469
3437,3449639012,3515401243,1672669215,1672671120,1905
3826,3505888598,3773033649,1672644841,1672648365,3524
3750,3777240360,3421385957,1672674080,1672676614,2534
3615,3510187271,3757294769,1672673436,1672676065,2629
3603,3792389522,3686227677,1672559638,1672561447,1809
3906,3556969573,3360813161,1672669466,1672670378,912
3596,3792389522,3519818818,1672700639,1672703785,3146
3720,3774178201,3713691388,1672593148,1672595615,2467
3901,3757383891,3631479562,1672544951,1672545585,634
3658,3793175445,3835422146,1672684485,1672685330,845
3615,3711000597,3500498112,1672536058,1672537546,1488
3687,3783373154,3701884158,1672599906,1672601051,1145
3683,3272716462,3779465522,1672566638,1672567809,1171
3491,3224811762,3778597171,1672580519,1672582899,2380
3649,3818575661,3279473441,1672689498,1672689861,363
3842,3517991730,3773572967,1672606087,1672608881,2794
3648,3621683102,3220031931,1672535889,1672538496,2607
3425,3398198430,3618489670,1672673716,1672674132,416
3766,3501459390,3351696332,1672550102,1672552136,2034
3681,3279339278,3665998641,1672617563,1672619435,1872
3605,3711812325,3760694096,1672666451,1672669711,3260
3614,3402385957,3618808151,1672611199,1672614633,3434
3595,3716110860,3791046864,1672641791,1672642696,905
3547,3445206685,3347419520,1672581372,1672584066,2694
3878,3915162005,3505807416,1672532960,1672533745,785
3725,3738026330,3395201292,1672633841,1672635710,1869
3816,3615115210,3386758279,1672671550,1672674465,2915
3673,3778926763,3824641227,1672703124,1672704607,1483
3659,3500208903,3520115090,1672652518,1672653787,1269
3793,3500302272,3435167810,1672683912,1672687041,3129
3722,3239617320,3716272919,1672589007,1672590588,1581
3779,3737112297,3711097754,1672532278,1672532868,590
3692,3551389192,3836241528,1672643937,1672644554,617
3750,3791753345,3512337405,1672685706,1672688588,2882
3642,3517358573,3760640999,1672684332,1672685680,1348
3658,3791246640,3288224595,1672674571,1672676801,2230
3889,3899326793,3294703680,1672580261,1672581147,886
3886,3711734586,3770438122,1672566584,1672568245,1661
3781,3770624662,3713691388,1672653679,1672655900,2221
3610,3472068734,3703396825,1672568044,1672570287,2243
3475,3773913680,3610358027,1672590864,1672592239,1375
3654,3811075491,3975717896,1672569215,1672569738,523
3474,3438489358,3270042456,1672669140,1672670265,1125
3798,3402697190,3792014516,1672576938,1672579687,2749
3907,3511843593,3236458894,1672540822,1672543155,2333
3595,3452016771,3900945856,1672655185,1672657424,2239
3911,3505228454,3534764451,1672558865,1672560970,2105
3687,3770236215,3513345163,1672556585,1672560126,3541
3839,3481640525,3396980894,1672596797,1672599223,2426
3555,3512295534,3617392620,1672583453,1672585439,1986
3758,3773572967,3773837847,1672666423,1672668388,1965
3453,3357289672,3773939399,1672564398,1672565908,1510
3558,3334993594,3341893384,1672694209,1672696662,2453
3564,3505807416,3244004456,1672691853,1672694484,2631
3431,3793740407,3970627281,1672643466,1672644130,664
3913,3451691949,3554944414,1672584558,1672587105,2547
3821,3500949309,3435167810,1672692698,1672693440,742
3659,3382733096,3680843171,1672674663,1672677178,2515
3626,3376467719,3421877923,1672550880,1672551722,842
3794,3774876004,3890739241,1672587539,1672589859,2320
3561,3370068529,3440137407,1672680267,1672683866,3599
3759,3757294769,3607768197,1672667611,1672669298,1687
3786,3793883863,3499217428,1672559155,1672561461,2306
3825,3517462308,3774178201,1672689227,1672692353,3126
3472,3714827719,3792505974,1672533687,1672534829,1142
3744,3512946768,3770520359,1672643598,1672645188,1590
3861,3711218296,3899326793,1672574575,1672577992,3417
3431,3513345163,3607768197,1672557836,1672559450,1614
3692,3783771827,3452016771,1672578864,1672580624,1760
3688,3551399764,3776117322,1672660430,1672662457,2027
3652,3935913584,3710489491,1672551327,1672553667,2340
3751,3927403123,3792489602,1672611793,1672614321,2528
3684,3916490839,3447672935,1672640982,1672642853,1871
3614,3512722110,3392836218,1672652250,1672654905,2655
3805,3273981374,3925979970,1672532113,1672533473,1360
3832,3970603231,3779465522,1672657822,1672659481,1659
3467,3395201292,3386758279,1672589636,1672591543,1907
3809,3533929349,3469254160,1672552911,1672555532,2621
3886,3306175858,3519818818,1672539170,1672541084,1914
3844,3613338363,3228888030,1672671691,1672675225,3534
3534,3288224595,3604589802,1672538792,1672542106,3314
3605,3835985172,3774907131,1672571122,1672572273,1151
3882,3439673892,3756746867,1672623096,1672623610,514
3554,3680843171,3780338697,1672676390,1672678955,2565
3483,3294703680,3500302272,1672594532,1672596158,1626
3602,3519651506,3347419520,1672549089,1672550548,1459
3649,3668747074,3773332082,1672646917,1672648250,1333
3706,3354144091,3808136029,1672616936,1672619876,2940
3568,3899786664,3514246749,1672590874,1672594192,3318
3721,3505725706,3469254160,1672580743,1672581988,1245
3910,3920497528,3505437712,1672643888,1672644175,287
3496,3715986185,3509756823,1672680202,1672681134,932
3513,3497095254,3512882178,1672681665,1672683475,1810
3604,3343816795,3501567772,1672623834,1672625803,1969
3737,3774243020,3791753345,1672660000,1672661197,1197
3860,3710048469,3364726656,1672658433,1672660692,2259
3601,3923754072,3734915241,1672667416,1672669029,1613
3851,3559458968,3311498666,1672629294,1672632214,2920
3855,3739154408,3737147209,1672626318,1672629505,3187
3594,3514285803,3639050419,1672693380,1672695108,1728
3757,3711218296,3288762795,1672592332,1672594933,2601
3606,3509366311,3618489670,1672561341,1672564630,3289
3637,3773572967,3802932312,1672610241,1672611486,1245
3804,3607768197,3920625129,1672678338,1672678427,89
3614,3734451191,3638204468,1672556626,1672557411,785
3685,3773033649,3280054198,1672631132,1672632415,1283
3532,3778040015,3688490530,1672660628,1672661707,1079
3521,3834631333,3819767045,1672632921,1672633081,160
3751,3357289672,3505437712,1672562532,1672562628,96
3706,3505402439,3711812325,1672633341,1672636682,3341
3516,3739661856,3625174002,1672559692,1672562287,2595
3920,3500109249,3351696332,1672665034,1672665181,147
3915,3792538417,3739154408,1672602307,1672604415,2108
3643,3515401243,3505228454,1672561241,1672563144,1903
3873,3778926763,3773332082,1672655483,1672655860,377
3626,3351696332,3977148669,1672552830,1672556073,3243
3714,3757193307,3533649454,1672545287,1672548884,3597
3852,3485540729,3755344363,1672636661,1672638051,1390
3801,3305722859,3519446663,1672540122,1672541601,1479
3603,3349739136,3534126409,1672597561,1672598020,459
3804,3900276517,3701322924,1672683179,1672683543,364
3461,3335694356,3274831810,1672681380,1672684716,3336
3698,3273981374,3760364383,1672663464,1672666562,3098
3553,3760694096,3371455553,1672550278,1672553347,3069
3485,3701373490,3689114185,1672534796,1672537270,2474
3733,3735374579,3621184108,1672584411,1672586050,1639
3487,3517462308,3793922324,1672615320,1672617469,2149
3555,3792546035,3520991398,1672616679,1672617501,822
3531,3905196766,3454277788,1672665472,1672667996,2524
3700,3487875183,3793781065,1672541836,1672542067,231
3631,3516444201,3533004959,1672558601,1672561041,2440
3891,3505521218,3773913680,1672532365,1672533385,1020
3598,3792489602,3334974375,1672575090,1672577322,2232
3560,3686227677,3513081354,1672602723,1672603177,454
3688,3900276517,3514956366,1672607195,1672608619,1424
3566,3772078494,3501121099,1672642658,1672644469,1811
3865,3392836218,3713979100,1672675777,1672676619,842
3446,3714067076,3713691388,1672597886,1672600074,2188
3684,3516489668,3609881958,1672561974,1672565489,3515
3452,3710489491,3970603231,1672536314,1672539903,3589
3536,3683113954,3296462324,1672645494,1672645843,349
3561,3884596900,3927403123,1672588452,1672591483,3031
3577,3774718695,3513853403,1672651248,1672651468,220
3894,3248058676,3227799827,1672577656,1672580958,3302
3815,3515525630,3895285664,1672565111,1672567695,2584
3573,3462273042,3757700712,1672614609,1672616169,1560
3471,3338390596,3514818819,1672633008,1672634357,1349
3481,3711218296,3368283077,1672644105,1672644561,456
3849,3500613459,3517358573,1672670888,1672673597,2709
3838,3689114185,3240994288,1672595872,1672596086,214
3602,3516321888,3447514821,1672666956,1672668224,1268
3866,3791796585,3337322736,1672554956,1672557660,2704
3656,3291933594,3500072204,1672631151,1672632267,1116
3798,3351696332,3513018485,1672685619,1672688009,2390
3769,3533368789,3776518452,1672635016,1672638480,3464
3858,3780427126,3815250107,1672606452,1672609184,2732
3455,3518653080,3783615982,1672603830,1672604696,866
3651,3732584121,3971806004,1672643701,1672645710,2009
3474,3757863420,3714233826,1672688371,1672690968,2597
3810,3418448389,3311049964,1672696189,1672697067,878
3500,3512392431,3201629017,1672677235,1672678849,1614
3657,3500525825,3334951866,1672543496,1672546788,3292
3818,3638204468,3505847380,1672537211,1672539890,2679
3454,3776034743,3387594369,1672610171,1672611773,1602
3452,3623266256,3518561777,1672547700,1672549981,2281
3447,3900945856,3421877923,1672607423,1672607936,513
3472,3533274994,3757348722,1672557573,1672558059,486
3679,3451326054,3622665543,1672697305,1672697869,564
3855,3224968597,3755222916,1672551095,1672553700,2605
3721,3500672156,3618489670,1672627222,1672628461,1239
3883,3930242012,3351696332,1672546657,1672549695,3038
3639,3757193307,3316798920,1672682923,1672686135,3212
3441,3554825448,3755848152,1672593574,1672595663,2089
3461,3499217428,3756385685,1672623588,1672625940,2352
3861,3613206049,3412006598,1672692383,1672693240,857
3860,3730071479,3735374579,1672694953,1672698108,3155
3453,3777147510,3760721303,1672576296,1672577184,888
3642,3899326793,3736231757,1672703005,1672705447,2442
3491,3920898925,3294747828,1672606868,1672610090,3222
3830,3505198734,3224968597,1672554172,1672557024,2852
3521,3228888030,3271752081,1672596374,1672596756,382
3582,3462273042,3660063072,1672565224,1672565786,562
3556,3880926355,3780115155,1672532918,1672535272,2354
3628,3604589802,3776117322,1672674152,1672676899,2747
3840,3893912331,3232208416,1672638875,1672640902,2027
3772,3519818818,3778040015,1672570915,1672570995,80
3876,3613581796,3533929349,1672553021,1672556418,3397
3606,3200308999,3505923418,1672565952,1672567840,1888
3907,3780909839,3428027649,1672687350,1672688088,738
3903,3411688875,3610358027,1672662083,1672663357,1274
3455,3660063072,3770704999,1672580870,1672584276,3406
3459,3905196766,3925979970,1672664254,1672667490,3236
3514,3779425804,3304971369,1672631928,1672635112,3184
3576,3272716462,3513327337,1672699719,1672700868,1149
3691,3517697722,3610358027,1672563277,1672566355,3078
3911,3710489491,3520991398,1672652188,1672654476,2288
3775,3513327337,3500208903,1672666480,1672667800,1320
3725,3334974375,3683113954,1672689555,1672690269,714
3860,3448875382,3472068734,1672675866,1672676125,259
3751,3927403123,3770704999,1672625168,1672627388,2220
3693,3300229945,3777037426,1672666400,1672667367,967
3857,3369708250,3514818819,1672555033,1672558312,3279
3754,3756789525,3890739241,1672652951,1672653253,302
3611,3517288083,3600876425,1672551679,1672552471,792
3571,3232208416,3928719932,1672648628,1672649222,594
3543,3463740710,3421385957,1672601693,1672603228,1535
3711,3701322924,3686227677,1672650641,1672652714,2073
3916,3393063657,3225631197,1672576258,1672576782,524
3426,3382733096,3736231757,1672538993,1672539209,216
3854,3792072681,3557046880,1672615898,1672618071,2173
3542,3852533643,3713979100,1672650235,1672652421,2186
3599,3715707380,3755230952,1672666151,1672667114,963
3649,3382733096,3272096759,1672617418,1672618895,1477
3790,3500672156,3505481368,1672532352,1672532889,537
3796,3492546679,3393063657,1672668579,1672670373,1794
3663,3454277788,3276003502,1672547104,1672548145,1041
3657,3920497528,3283770991,1672615514,1672615900,386
3860,3772236797,3205923620,1672592472,1672593823,1351
3649,3627368399,3783801141,1672649015,1672651941,2926
3803,3783433404,3497808662,1672671616,1672673859,2243
3563,3780253901,3760640999,1672593969,1672596841,2872
3874,3408430195,3447514821,1672687123,1672688832,1709
3465,3780571086,3755158925,1672663990,1672666506,2516
3733,3792546035,3612689556,1672675655,1672677450,1795
3713,3338390596,3774178201,1672553235,1672553387,152
3809,3337322736,3520639768,1672650899,1672651210,311
3762,3515466096,3902760230,1672673748,1672674918,1170
3526,3240394404,3400763927,1672658599,1672660684,2085
3666,3311498666,3357689359,1672595942,1672598781,2839
3432,3417679834,3905196766,1672655271,1672656212,941
3603,3276217799,3533079336,1672676912,1672677484,572
3907,3514512367,3310125159,1672564224,1672567699,3475
3828,3333403880,3755915206,1672666428,1672667199,771
3737,3737147209,3308760650,1672649177,1672650112,935
3810,3513327337,3633735593,1672637091,1672639608,2517
3577,3715127070,3456430614,1672538906,1672539646,740
3598,3778640261,3779425804,1672582751,1672584544,1793
3863,3812534508,3715707380,1672671050,1672672416,1366
3671,3274906650,3779656423,1672621848,1672625317,3469
3691,3487875183,3773121782,1672695523,1672696093,570
3615,3613338363,3500777439,1672531761,1672532322,561
3890,3779639983,3812369928,1672703500,1672703959,459
3890,3661903000,3203538212,1672656916,1672659915,2999
3557,3319167958,3411515369,1672677019,1672678850,1831
3658,3773124276,3778040015,1672675435,1672675854,419
3662,3715619259,3783147088,1672649489,1672652925,3436
3761,3311049964,3737972328,1672533599,1672534657,1058
3895,3534357694,3520639768,1672541327,1672543726,2399
3470,3386758279,3970909253,1672548667,1672551401,2734
3837,3633735593,3776518452,1672578031,1672579211,1180
3537,3689114185,3774243020,1672550091,1672550690,599
3547,3520578796,3500841914,1672546366,1672548194,1828
3487,3701136026,3779892400,1672541882,1672543832,1950
3454,3509756823,3467988782,1672680735,1672681781,1046
3529,3714827719,3755158925,1672692557,1672693120,563
3798,3470454332,3338083680,1672551720,1672552725,1005
3781,3490029863,3509366311,1672656116,1672659007,2891
3908,3778926763,3715443333,1672553391,1672553649,258
3918,3288224595,3773033649,1672561567,1672562024,457
3459,3360813161,3304155815,1672580761,1672582070,1309
3816,3417191856,3373089838,1672646820,1672650127,3307
3827,3225029895,3337362061,1672568369,1672568775,406
3549,3834963772,3392520516,1672702897,1672703190,293
3602,3383138270,3315703693,1672688544,1672689306,762
3443,3779425804,3773735484,1672624189,1672625248,1059
3663,3398198430,3559458968,1672614561,1672615459,898
3582,3792538417,3668747074,1672599906,1672603465,3559
3685,3279339278,3739661856,1672627805,1672631121,3316
3651,3714067076,3511442562,1672676459,1672677594,1135
3486,3609659642,3701882224,1672533474,1672534194,720
3488,3783615982,3617116290,1672609247,1672612056,2809
3637,3880926355,3680810086,1672593091,1672596367,3276
3708,3779854934,3779425804,1672629846,1672631076,1230
3494,3481640525,3517687662,1672679617,1672681556,1939
3836,3774790271,3776117322,1672531429,1672532739,1310
3697,3311085279,3273981374,1672544746,1672546696,1950
3715,3780769110,3776831527,1672698969,1672700165,1196
3827,3621461051,3354144091,1672569001,1672572502,3501
3435,3856606678,3201676087,1672628080,1672629550,1470
3769,3792014516,3510554314,1672544497,1672548056,3559
3700,3559731671,3780322355,1672565549,1672568347,2798
3613,3208452238,3772765746,1672569190,1672572058,2868
3520,3713911104,3755158925,1672696481,1672699606,3125
3768,3505995057,3399518841,1672675889,1672676763,874
3884,3402385957,3500857494,1672662750,1672664670,1920
3521,3475349791,3738026330,1672589278,1672591445,2167
3502,3509756823,3224330592,1672615485,1672618453,2968
3674,3513295938,3776518452,1672554509,1672556800,2291
3605,3621790707,3428725843,1672695769,1672697805,2036
3473,3447514821,3201800997,1672633111,1672636125,3014
3885,3897376951,3520764926,1672698243,1672701032,2789
3881,3916490839,3300979975,1672624435,1672625288,853
3449,3445206685,3335694356,1672691728,1672695003,3275
3507,3226511603,3505283390,1672610941,1672611458,517
3830,3703798634,3701884158,1672579695,1672581908,2213
3749,3792442597,3680810086,1672692477,1672692702,225
3642,3780872464,3757630221,1672651058,1672654612,3554
3651,3280054198,3385323994,1672605117,1672606521,1404
3840,3480100311,3280268483,1672634718,1672636272,1554
3554,3500044458,3436257398,1672677550,1672679120,1570
3861,3330340793,3519416013,1672554232,1672557154,2922
3503,3456430614,3703396825,1672552002,1672553362,1360
3869,3893912331,3715854030,1672664076,1672667384,3308
3795,3500604680,3505402439,1672550375,1672551771,1396
3798,3513545422,3713561276,1672676733,1672678037,1304
3644,3631090677,3774155692,1672555051,1672555611,560
3702,3970558632,3201800997,1672578110,1672581539,3429
3780,3450286949,3839245934,1672600842,1672602044,1202
3843,3461119815,3208957949,1672631448,1672633504,2056
3450,3897435944,3500827202,1672622112,1672624101,1989
3624,3226511603,3517462308,1672686597,1672689787,3190
3760,3757075324,3414049538,1672686527,1672688444,1917
3750,3510499038,3783919913,1672537783,1672541077,3294
3646,3514703118,3279242917,1672545818,1672546363,545
3430,3713979100,3364726656,1672638900,1672639894,994
3881,3613581796,3773913680,1672690915,1672692558,1643
3442,3511791953,3823084403,1672635948,1672637047,1099
3656,3410600350,3336339664,1672651721,1672651997,276
3602,3559458968,3500317969,1672660493,1672663692,3199
3450,3305722859,3512295534,1672562360,1672562801,441
3753,3554825448,3715385401,1672698094,1672700433,2339
3699,3520578796,3701005527,1672535996,1672536209,213
3851,3203538212,3517358573,1672675246,1672676058,812
3589,3315703693,3850911686,1672546205,1672549784,3579
3675,3621461051,3272096759,1672600759,1672604134,3375
3541,3510919821,3600876425,1672631059,1672632256,1197
3780,3279473441,3920497528,1672693657,1672694612,955
3431,3556969573,3520578796,1672625716,1672629243,3527
3656,3367111751,3779301501,1672627217,1672630193,2976
3535,3372223551,3668747074,1672574899,1672578012,3113
3645,3613206049,3304971369,1672598273,1672600787,2514
3835,3439673892,3497095254,1672664593,1672665870,1277
3914,3510818674,3792505974,1672575464,1672577748,2284
3842,3737112297,3457960571,1672581825,1672582381,556
3601,3533004959,3774733620,1672675191,1672678612,3421
3717,3714185969,3276348699,1672679446,1672679538,92
3501,3713691388,3428027649,1672676073,1672677901,1828
3575,3431502855,3501567772,1672562757,1672563887,1130
3500,3480100311,3701247948,1672701982,1672704892,2910
3622,3288762795,3773121782,1672631214,1672633562,2348
3788,3760362417,3505198734,1672639564,1672640309,745
3901,3294703680,3279242917,1672548660,1672548722,62
3720,3316800320,3897435944,1672571353,1672572904,1551
3699,3614740489,3780322355,1672555937,1672558006,2069
3540,3226024417,3773572967,1672572715,1672573848,1133
3792,3776084820,3411515369,1672677519,1672680850,3331
3752,3756746867,3517737088,1672588856,1672590779,1923
3441,3451326054,3609113156,1672623656,1672627229,3573
3597,3611055563,3755158925,1672701602,1672704950,3348
3616,3791693821,3517887477,1672555158,1672558024,2866
3901,3349739136,3755158925,1672691225,1672692496,1271
3777,3505634634,3792538417,1672654762,1672655309,547
3879,3972192593,3714185969,1672588424,1672589187,763
3786,3770438122,3380982774,1672553351,1672555427,2076
3566,3716272919,3792072681,1672647417,1672650452,3035
3714,3238288884,3780872464,1672695943,1672698454,2511
3494,3409114719,3779613523,1672566581,1672568425,1844
3670,3226178937,3979802715,1672649421,1672652794,3373
3851,3559458968,3609113156,1672543240,1672543870,630
3537,3660887799,3236499444,1672596018,1672598345,2327
3669,3689114185,3533188828,1672590306,1672591526,1220
3453,3755158925,3825881598,1672543313,1672544256,943
3774,3448633776,3711812325,1672684016,1672685562,1546
3907,3533188828,3833217041,1672697043,1672699524,2481
3499,3454277788,3703396825,1672621329,1672624813,3484
3485,3885155975,3710562338,1672564119,1672565719,1600
3763,3815250107,3701107228,1672635272,1672637280,2008
3919,3200308999,3509764635,1672643336,1672644928,1592
3622,3367971170,3500347447,1672649442,1672651264,1822
3583,3714233826,3319167958,1672669313,1672669868,555
3787,3513545422,3755737419,1672612129,1672615724,3595
3881,3385323994,3713911104,1672599065,1672600911,1846
3861,3711006062,3512946768,1672652549,1672653422,873
3774,3510641433,3510642075,1672626456,1672626521,65
3556,3505228454,3853629553,1672576935,1672577524,589
3481,3387594369,3490214516,1672610373,1672611205,832
3667,3733558985,3792014516,1672697536,1672700314,2778
3504,3773332082,3669146016,1672535999,1672538722,2723
3920,3516321888,3372223551,1672602801,1672604770,1969
3427,3533004959,3367509761,1672687468,1672688854,1386
3854,3299781901,3791106564,1672547015,1672549514,2499
3451,3520181148,3351696332,1672574484,1672575330,846
3589,3517358573,3517462308,1672651472,1672652464,992
3760,3780427126,3734451191,1672567382,1672568990,1608
3776,3533228966,3733558985,1672659139,1672661891,2752
3855,3300818269,3373028638,1672695368,1672696569,1201
3789,3923220461,3793969543,1672615907,1672618257,2350
3460,3500709774,3783147088,1672532910,1672533452,542
3833,3792538417,3686523546,1672663240,1672663612,372
3570,3517887477,3773572967,1672536945,1672539322,2377
3689,3756625818,3512830734,1672582911,1672583527,616
3755,3710048469,3715619259,1672668538,1672671042,2504
3714,3448633776,3533090502,1672631955,1672634623,2668
3721,3271752081,3685681577,1672692249,1672692675,426
3691,3711006062,3715854030,1672670554,1672674037,3483
3676,3450286949,3773939399,1672665856,1672666440,584
3616,3517697722,3613416045,1672569045,1672569393,348
3701,3300511067,3238288884,1672670004,1672670598,594
3872,3497671225,3338390596,1672600118,1672602478,2360
3608,3755848152,3770624662,1672581993,1672582506,513
3878,3519416013,3516444201,1672659866,1672660841,975
3712,3891672228,3512379024,1672555457,1672558194,2737
3898,3608232640,3411688875,1672654873,1672658098,3225
3481,3778134418,3713829743,1672531557,1672532181,624
3447,3664943873,3408498208,1672689897,1672692089,2192
3704,3514956366,3777624586,1672562458,1672564726,2268
3677,3515401243,3683113954,1672692963,1672696342,3379
3658,3520416075,3533090502,1672620760,1672622333,1573
3916,3855583256,3770296583,1672686999,1672689282,2283
3826,3315279093,3395201292,1672608296,1672610777,2481
3550,3200308999,3853629553,1672564823,1672565550,727
3528,3505111292,3448633776,1672588049,1672590339,2290
3718,3519282716,3554944414,1672672668,1672675939,3271
3766,3615688740,3201629017,1672648844,1672649094,250
3628,3770236215,3823084403,1672634207,1672634316,109
3597,3448875382,3793583656,1672645224,1672648111,2887
3843,3609113156,3334647380,1672672512,1672673623,1111
3882,3773027597,3519651506,1672568427,1672570658,2231
3476,3934064792,3396726504,1672574277,1672577452,3175
3581,3384068080,3889780657,1672578202,1672579675,1473
3627,3711006062,3807212280,1672694037,1672695385,1348
3444,3970909253,3228888030,1672627559,1672629597,2038
3723,3514308235,3440137407,1672612133,1672612708,575
3836,3757700712,3244004456,1672557780,1672559344,1564
3823,3293835352,3831586487,1672553553,1672555243,1690
3532,3710562338,3511883730,1672562751,1672563054,303
3845,3792489602,3220031931,1672533827,1672537057,3230
3536,3505663516,3660063072,1672685053,1672688465,3412
3699,3200543880,3456430614,1672592938,1672596460,3522
3575,3300229945,3780338697,1672585755,1672587276,1521
3829,3448875382,3773027597,1672697045,1672698454,1409
3838,3731646673,3791753345,1672613359,1672615915,2556
3472,3501215099,3519087371,1672562388,1672565815,3427
3656,3715385401,3735374579,1672591178,1672594181,3003
3636,3773332082,3375449013,1672616482,1672618990,2508
3752,3437286517,3276003502,1672676733,1672679337,2604
3734,3500915908,3294747828,1672691927,1672692249,322
3894,3774641380,3202141727,1672634027,1672635178,1151
3677,3773902805,3774733620,1672575360,1672578468,3108
3862,3701884158,3439673892,1672549703,1672550246,543
3845,3459681410,3304971369,1672546737,1672548635,1898
3480,3271752081,3780338697,1672693002,1672693091,89
3645,3755344363,3734118023,1672687065,1672690511,3446
3816,3410600350,3667673649,1672622877,1672625241,2364
3534,3505266860,3609113156,1672681340,1672683117,1777
3624,3513545422,3449333754,1672676379,1672678006,1627
3914,3935913584,3488686442,1672695569,1672696605,1036
3785,3701247948,3379143440,1672646299,1672648713,2414
3578,3811075491,3505995057,1672608569,1672611231,2662
3427,3408498208,3639050419,1672644047,1672645175,1128
3482,3533649454,3450969839,1672582841,1672583899,1058
3562,3757700712,3905196766,1672536603,1672539795,3192
3650,3200308999,3509893027,1672703464,1672704981,1517
3476,3971806004,3305336154,1672544967,1672548465,3498
3525,3517887477,3760842815,1672585077,1672588349,3272
3842,3335694356,3668747074,1672550756,1672553458,2702
3741,3664943873,3354144091,1672571394,1672574483,3089
3430,3774876004,3514956366,1672621814,1672622501,687
3762,3835422146,3505283390,1672693618,1672694358,740
3464,3905899155,3625174002,1672548695,1672549322,627
3811,3533747868,3517697722,1672654385,1672656947,2562
3795,3774031303,3608922867,1672672519,1672674533,2014
3493,3755496114,3514275974,1672701203,1672703594,2391
3608,3792072681,3791106564,1672563341,1672566577,3236
3691,3279475486,3336339664,1672635414,1672638941,3527
3848,3760263530,3272096759,1672644672,1672645626,954
3493,3774705415,3236354255,1672631297,1672632467,1170
3471,3500827202,3779892400,1672587506,1672589866,2360
3759,3938503547,3897456874,1672551818,1672554705,2887
3884,3770520359,3615115210,1672630889,1672633626,2737
3435,3517687662,3803517637,1672581511,1672584280,2769
3439,3701247948,3607768197,1672630313,1672633631,3318
3799,3618354185,3220031931,1672701141,1672703729,2588
3704,3770236215,3448633776,1672570666,1672573981,3315
3560,3394401087,3392836218,1672543837,1672546898,3061
3490,3518653080,3772765746,1672628512,1672630658,2146
3489,3511150845,3618697021,1672574200,1672576529,2329
3549,3909094917,3376467719,1672590196,1672591695,1499
3763,3757075324,3783147088,1672628674,1672630606,1932
3547,3734915241,3201676087,1672619854,1672622667,2813
3469,3608922867,3312998540,1672687636,1672688690,1054
3553,3714120857,3668414677,1672635226,1672636642,1416
3749,3791753345,3713517039,1672576817,1672579046,2229
3586,3773027597,3490214516,1672640849,1672644388,3539
3760,3757630221,3829822608,1672609527,1672611441,1914
3524,3230135532,3403370192,1672678266,1672680671,2405
3515,3773121782,3510837901,1672696424,1672699366,2942
3583,3273981374,3792014516,1672604612,1672605667,1055
3831,3271752081,3925979970,1672619150,1672620020,870
3445,3505725706,3408430195,1672596433,1672597873,1440
3850,3710315160,3469254160,1672595782,1672597936,2154
3767,3315279093,3714678331,1672577699,1672580238,2539
3670,3312998540,3793740407,1672561521,1672563932,2411
3805,3772236797,3774907131,1672607102,1672609602,2500
3768,3310125159,3534764451,1672664117,1672664422,305
3922,3778640261,3513296868,1672598800,1672601153,2353
3535,3559458968,3774718695,1672647756,1672647940,184
3720,3714670620,3209481722,1672657911,1672659782,1871
3698,3792072681,3701884158,1672584231,1672586106,1875
3861,3897134762,3668414677,1672634808,1672638143,3335
3906,3241790910,3448633776,1672652442,1672653696,1254
3603,3783801141,3774907131,1672617809,1672620020,2211
3606,3517288083,3509764635,1672583582,1672586470,2888
3860,3202141727,3934064792,1672691149,1672692851,1702
3562,3803517637,3780338697,1672603754,1672605943,2189
3789,3505923418,3514324011,1672641680,1672642843,1163
3835,3500915908,3357689359,1672598758,1672599264,506
3791,3349856820,3443357683,1672650827,1672654088,3261
3493,3613206049,3760362417,1672582169,1672585315,3146
3718,3501459390,3500442734,1672681530,1672684210,2680
3432,3511024016,3505634634,1672658412,1672660557,2145
3782,3385323994,3357289672,1672604868,1672606190,1322
3714,3510798825,3792801638,1672537716,1672539133,1417
3874,3974674109,3533274994,1672539206,1672541256,2050
3511,3451326054,3736231757,1672653423,1672654254,831
3918,3780322355,3701373490,1672689630,1672692445,2815
3551,3395201292,3463849738,1672684160,1672685039,879
3578,3757630221,3979784676,1672584340,1672585093,753
3789,3776117322,3288762795,1672577992,1672580547,2555
3757,3224330592,3774705415,1672613843,1672616609,2766
3600,3248058676,3604867757,1672583480,1672584905,1425
3603,3236499444,3201800997,1672613549,1672614364,815
3736,3519077659,3977148669,1672533461,1672536012,2551
3532,3859868849,3283144118,1672652380,1672655400,3020
3504,3756127300,3514956366,1672613971,1672615886,1915
3707,3236354255,3777624586,1672561406,1672562544,1138
3906,3408498208,3517600136,1672678401,1672680388,1987
3536,3791753345,3777779869,1672540193,1672542080,1887
3503,3732584121,3906536154,1672566210,1672567706,1496
3750,3208957949,3440107959,1672668848,1672669705,857
3867,3777240360,3364726656,1672644262,1672645740,1478
3729,3912891315,3773121782,1672579938,1672583035,3097
3497,3505111292,3774876004,1672535142,1672538723,3581
3495,3513081354,3683113954,1672689520,1672692597,3077
3452,3472312341,3231713082,1672690075,1672691617,1542
3841,3774243020,3737112297,1672550906,1672551025,119
3610,3519282716,3779613523,1672703440,1672705361,1921
3697,3902760230,3402697190,1672551607,1672555206,3599
3632,3364378127,3756385685,1672569374,1672571269,1895
3529,3534175249,3510642075,1672558628,1672559652,1024
3900,3735374579,3916490839,1672685544,1672686757,1213
3806,3436257398,3491469603,1672596526,1672598833,2307
3459,3224968597,3777814504,1672687889,1672688432,543
3799,3480490124,3450969839,1672600951,1672603920,2969
3672,3777147510,3732584121,1672678261,1672680458,2197
3592,3451691949,3713517039,1672588386,1672590134,1748
3740,3510028805,3609881958,1672596370,1672599793,3423
3855,3226511603,3774790271,1672541505,1672543081,1576
3489,3780571086,3779613523,1672531549,1672532206,657
3740,3713300120,3714233826,1672653674,1672656986,3312
3756,3792538417,3921648519,1672646492,1672646846,354
3669,3457960571,3311498666,1672639119,1672642043,2924
3532,3773735484,3715127070,1672605266,1672605975,709
3775,3559731671,3777694660,1672614136,1672614437,301
3762,3711000597,3921648519,1672596852,1672597852,1000
3566,3834631333,3736705719,1672582436,1672585984,3548
3527,3505154885,3733363628,1672600402,1672603295,2893
3612,3715443333,3202141727,1672557063,1672557427,364
3890,3516321888,3410160376,1672553137,1672555516,2379
3450,3202141727,3437286517,1672567767,1672571001,3234
3456,3831586487,3710315160,1672647530,1672650856,3326
3639,3516903528,3814305099,1672537617,1672541061,3444
3806,3680843171,3396980894,1672691650,1672695087,3437
3883,3404025196,3905899155,1672565901,1672567169,1268
3797,3665998641,3512392431,1672570990,1672574333,3343
3748,3852686295,3701424609,1672680167,1672682861,2694
3887,3418448389,3349739136,1672615965,1672617625,1660
3888,3971806004,3338083680,1672542886,1672546294,3408
3875,3349856820,3338390596,1672548323,1672548849,526
3786,3710496785,3755233658,1672624230,1672624746,516
3646,3735374579,3777814504,1672620201,1672623339,3138
3597,3511005395,3776831527,1672697746,1672701331,3585
3636,3777189898,3776831527,1672678484,1672679721,1237
3521,3512800570,3779639983,1672627557,1672627817,260
3550,3362641275,3500703304,1672635949,1672636114,165
3586,3617489344,3462273042,1672605380,1672607293,1913
3786,3367509761,3618489670,1672568561,1672569181,620
3735,3270697740,3774907131,1672554977,1672557619,2642
3903,3760924079,3792442597,1672627205,1672627935,730
3449,3248058676,3713768950,1672629681,1672632412,2731
3715,3760263530,3713941638,1672575540,1672578003,2463
3663,3510641433,3895285664,1672701798,1672705014,3216
3919,3401793306,3731646673,1672622302,1672622796,494
3898,3783615982,3395201292,1672538129,1672538867,738
3443,3714827719,3715086894,1672650462,1672651991,1529
3745,3293835352,3715707380,1672658504,1672660998,2494
3883,3885157459,3399518841,1672598962,1672601091,2129
3689,3392836218,3357864626,1672659466,1672662857,3391
3710,3927599181,3448875382,1672602165,1672604439,2274
3473,3793935736,3510767239,1672681880,1672684736,2856
3603,3461119815,3408430195,1672601496,1672603430,1934
3446,3519818818,3520355798,1672702275,1672703472,1197
3456,3398198430,3935399379,1672605745,1672608159,2414
3684,3517288083,3609659642,1672616465,1672619369,2904
3791,3310039260,3715854030,1672605063,1672607674,2611
3623,3401496246,3511288998,1672650058,1672652017,1959
3902,3607768197,3920625129,1672608263,1672608472,209
3913,3909094917,3618489670,1672587608,1672587973,365
3463,3777189898,3341893384,1672597187,1672598635,1448
3560,3516321888,3776559988,1672600498,1672600826,328
3781,3293835352,3688220326,1672646951,1672650324,3373
3509,3513296868,3713561276,1672612326,1672614355,2029
3645,3757318448,3500827202,1672560866,1672561331,465
3917,3224811762,3737112297,1672587926,1672589126,1200
3443,3491684096,3760645796,1672531948,1672535474,3526
3852,3791753345,3755222916,1672580677,1672583710,3033
3885,3514971533,3460719322,1672624122,1672627488,3366
3470,3509756823,3517462308,1672559093,1672561206,2113
3900,3500525825,3895285664,1672590137,1672591619,1482
3672,3505198734,3392520516,1672623998,1672627442,3444
3507,3516321888,3208957949,1672669057,1672671244,2187
3880,3757700712,3513327337,1672549081,1672549890,809
3469,3512499658,3770146716,1672544526,1672545137,611
3592,3755222916,3733363628,1672573139,1672576310,3171
3578,3686227677,3335694356,1672606668,1672607873,1205
3557,3384583385,3710562338,1672628261,1672629499,1238
3484,3512337405,3780571086,1672683223,1672685371,2148
3854,3776559988,3714233826,1672598964,1672600310,1346
3734,3825881598,3760924079,1672642863,1672645267,2404
3429,3756704774,3310039260,1672558781,1672560632,1851
3888,3680843171,3500317969,1672647098,1672647552,454
3914,3774178201,3403370192,1672630654,1672631328,674
3638,3783520186,3607768197,1672538831,1672541640,2809
3611,3283144118,3824215187,1672679807,1672681392,1585
3642,3271454397,3935399379,1672560192,1672562130,1938
3864,3703348097,3438078818,1672536748,1672537733,985
3642,3774718695,3366423342,1672631723,1672632177,454
3665,3479851674,3931627862,1672546902,1672550287,3385
3801,3703433819,3516513251,1672570028,1672572317,2289
3626,3533294425,3713517039,1672563973,1672565931,1958
3824,3623266256,3376467719,1672579937,1672582119,2182
3751,3367509761,3367971170,1672543615,1672544551,936
3437,3615737355,3363162590,1672659015,1672660679,1664
3539,3757294769,3455018347,1672558441,1672561979,3538
3572,3500709774,3622357348,1672578896,1672581702,2806
3840,3778134418,3467779445,1672664013,1672666754,2741
3745,3783163143,3533294425,1672578828,1672579969,1141
3496,3793868716,3500827202,1672584977,1672586702,1725
3675,3209481722,3414940786,1672561160,1672562157,997
3729,3792505974,3779938251,1672650972,1672651317,345
3499,3711006062,3455018347,1672624443,1672625742,1299
3469,3829822608,3501525100,1672534180,1672537061,2881
3506,3757332128,3392520516,1672613967,1672616411,2444
3780,3701005527,3776559988,1672596403,1672599801,3398
3748,3228888030,3336627643,1672538644,1672539751,1107
3551,3306412634,3635169815,1672684361,1672684812,451
3697,3512379024,3246370118,1672702498,1672704679,2181
3639,3935399379,3835422146,1672587906,1672588535,629
3537,3977352557,3511288998,1672544371,1672546736,2365
3730,3814677862,3299125059,1672622413,1672625862,3449
3686,3316798920,3271752081,1672657533,1672660177,2644
3469,3357864626,3240394404,1672583689,1672584686,997
3677,3306175858,3909094917,1672632882,1672633020,138
3812,3701664364,3338083680,1672536855,1672537398,543
3520,3710008361,3713163045,1672624609,1672624890,281
3746,3228888030,3803389195,1672586261,1672588794,2533
3843,3457620713,3202141727,1672571968,1672574838,2870
3451,3701005527,3821054646,1672668009,1672668095,86
3592,3923754072,3779532653,1672538727,1672538829,102
3697,3392943173,3970603231,1672634439,1672637571,3132
3615,3533929349,3793175445,1672654815,1672656271,1456
3481,3783373154,3500604680,1672576474,1672576561,87
3639,3818575661,3703396825,1672647413,1672650521,3108
3618,3412968120,3818575661,1672703920,1672706317,2397
3881,3492546679,3512379024,1672545405,1672545507,102
3604,3371455553,3514285803,1672683614,1672683801,187
3700,3887243870,3774641380,1672543771,1672543955,184
3867,3791246640,3411515369,1672605937,1672609410,3473
3850,3774031303,3792489602,1672640568,1672644149,3581
3643,3512502036,3755222916,1672653485,1672656777,3292
3807,3505178849,3533368789,1672650050,1672650628,578
3759,3904412440,3475349791,1672679633,1672681734,2101
3887,3480991549,3534175249,1672606012,1672608068,2056
3534,3357289672,3380767040,1672575747,1672579273,3526
3611,3815250107,3292147449,1672616524,1672619529,3005
3813,3231713082,3411515369,1672612321,1672615139,2818
3511,3914691363,3500857494,1672571748,1672572291,543
3826,3510837901,3714233826,1672689077,1672690142,1065
3484,3773033649,3224811762,1672586286,1672587562,1276
3440,3371455553,3803389195,1672531685,1672532682,997
3427,3779639983,3637313265,1672596180,1672598148,1968
3570,3710562338,3777184389,1672691728,1672692449,721
3880,3300818269,3713517039,1672590496,1672591331,835
3450,3412968120,3974674109,1672558002,1672559175,1173
3571,3701247948,3701322924,1672544730,1672547785,3055
3844,3316800320,3559458968,1672604980,1672607314,2334
3545,3617304541,3783919913,1672619695,1672619880,185
3533,3760263530,3431460073,1672646985,1672649964,2979
3599,3497671225,3410538749,1672686199,1672687746,1547
3801,3514512367,3703383853,1672689283,1672690806,1523
3828,3225636215,3384068080,1672654411,1672657374,2963
3669,3500915908,3533004959,1672628929,1672630946,2017
3832,3461119815,3780338697,1672629243,1672629857,614
3668,3618489670,3509756823,1672619447,1672622800,3353
3884,3334974375,3336627643,1672693845,1672696542,2697
3428,3774790271,3711734586,1672614906,1672617338,2432
3542,3534175249,3517590837,1672587789,1672588633,844
3843,3283144118,3511024016,1672543592,1672546863,3271
3613,3229822507,3773009828,1672537808,1672541087,3279
3472,3448633776,3755737419,1672547992,1672551122,3130
3566,3755404116,3518565331,1672692671,1672695500,2829
3587,3714185969,3501567772,1672556237,1672557802,1565
3733,3926643445,3760651515,1672602931,1672605941,3010
3570,3774641380,3711637255,1672614951,1672617323,2372
3692,3245232284,3373089838,1672564426,1672566346,1920
3708,3904412440,3839245934,1672614026,1672614449,423
3446,3760721303,3714067076,1672606097,1672608004,1907
3737,3480991549,3533747868,1672658260,1672661346,3086
3672,3226024417,3289114629,1672556314,1672557649,1335
3487,3347419520,3520578796,1672647047,1672649762,2715
3492,3772236797,3334974375,1672534861,1672536821,1960
3554,3511883730,3380130228,1672678062,1672679116,1054
3566,3491684096,3520764926,1672633559,1672636480,2921
3446,3376467719,3480726047,1672604095,1672604555,460
3450,3231713082,3454277788,1672681232,1672683425,2193
3717,3713691388,3500949309,1672595989,1672597653,1664
3641,3688490530,3556969573,1672540182,1672541244,1062
3894,3310039260,3760263530,1672587774,1672590934,3160
3757,3202804048,3773332082,1672621193,1672622532,1339
3518,3779854934,3515439826,1672544821,1672548149,3328
3832,3927403123,3534357694,1672567546,1672568814,1268
3542,3380982774,3421877923,1672681928,1672684534,2606
3468,3289817992,3401940259,1672561763,1672562416,653
3809,3513327337,3202141727,1672576953,1672578089,1136
3838,3505995057,3608922867,1672579750,1672581523,1773
3624,3716110860,3756746867,1672640575,1672644099,3524
3445,3891672228,3559458968,1672602770,1672602977,207
3700,3829822608,3714067076,1672558773,1672561643,2870
3712,3770296583,3274906650,1672702127,1672704317,2190
3910,3399472693,3288224595,1672678062,1672679068,1006
3818,3774718695,3283144118,1672662546,1672662935,389
3660,3513345163,3511732493,1672548416,1672549827,1411
3735,3755532873,3715986185,1672622978,1672626192,3214
3808,3513853403,3714678331,1672680834,1672684101,3267
3444,3792489602,3777779869,1672531354,1672531639,285
3844,3773009828,3311049964,1672686165,1672689204,3039
3847,3518229776,3480100311,1672611429,1672612698,1269
3681,3408498208,3517887477,1672630655,1672632846,2191
3472,3923754072,3770624662,1672631603,1672633376,1773
3621,3668414677,3279242917,1672679811,1672682895,3084
3869,3534126409,3270056120,1672552376,1672553882,1506
3897,3777814504,3904412440,1672668601,1672670557,1956
3517,3284947372,3732131656,1672606318,1672608503,2185
3785,3856606678,3511601997,1672531286,1672534643,3357
3531,3902625986,3923754072,1672688142,1672688859,717
3537,3509366311,3624297844,1672692622,1672693745,1123
3858,3716679950,3792538417,1672684349,1672685940,1591
3501,3517881647,3335694356,1672580217,1672581288,1071
3862,3716272919,3858172636,1672538335,1672539377,1042
3494,3715974659,3360616538,1672619166,1672621667,2501
3838,3756746867,3760721303,1672533936,1672536109,2173
3492,3791613604,3231494505,1672574158,1672575660,1502
3482,3887243870,3779465522,1672600503,1672602579,2076
3704,3452016771,3779854934,1672676720,1672677067,347
3465,3970627281,3360069849,1672605621,1672607202,1581
3649,3500347447,3825881598,1672636950,1672638947,1997
3622,3401793306,3472068734,1672554979,1672555264,285
3745,3517697722,3711919537,1672550362,1672553295,2933
3792,3511442562,3938503547,1672616674,1672617347,673
3494,3739661856,3299443125,1672561962,1672562883,921
3670,3387594369,3351866415,1672608294,1672611658,3364
3710,3626499450,3500341755,1672580725,1672583060,2335
3901,3349856820,3512295534,1672564116,1672564839,723
3715,3774718695,3733558985,1672633590,1672636047,2457
3672,3467988782,3551389192,1672575228,1672576520,1292
3893,3500604680,3559458968,1672551150,1672552446,1296
3696,3893912331,3815392801,1672659810,1672663388,3578
3434,3780209375,3501215099,1672671043,1672672075,1032
3587,3517737088,3514246749,1672695743,1672696699,956
3641,3834963772,3604867757,1672678538,1672680927,2389
3562,3714678331,3440107959,1672543716,1672545656,1940
3565,3635169815,3517222913,1672563305,1672563673,368
3791,3783919913,3715707380,1672675861,1672678069,2208
3525,3412968120,3357289672,1672606156,1672609538,3382
3844,3424445495,3447672935,1672599054,1672599960,906
3691,3627368399,3792072681,1672553820,1672556098,2278
3736,3757700712,3776244398,1672651715,1672653758,2043
3471,3310125159,3517881647,1672659837,1672662983,3146
3464,3500613459,3379143440,1672532884,1672533473,589
3763,3399472693,3638660068,1672571118,1672571838,720
3523,3517881647,3892304880,1672662906,1672664283,1377
3434,3408498208,3615115210,1672578056,1672580815,2759
3737,3760645796,3305336154,1672569008,1672572290,3282
3740,3920497528,3661903000,1672615267,1672616783,1516
3914,3511442562,3715127070,1672621454,1672622021,567
3736,3609659642,3500302272,1672621592,1672623350,1758
3684,3897456874,3772391882,1672593786,1672596449,2663
3783,3600876425,3500317969,1672677079,1672678113,1034
3802,3520560590,3904412440,1672581998,1672582597,599
3843,3448875382,3338390596,1672666940,1672669613,2673
3834,3341893384,3821054646,1672628980,1672629474,494
3846,3836241528,3899786664,1672602313,1672605362,3049
3570,3778899160,3772078494,1672587924,1672590008,2084
3908,3770624662,3633735593,1672644327,1672645212,885
3786,3513327337,3621184108,1672596138,1672598297,2159
3725,3380982774,3938389661,1672610427,1672611795,1368
3849,3897376951,3774733620,1672564811,1672566363,1552
3550,3714120857,3517881647,1672645144,1672645784,640
3596,3711853996,3905899155,1672604647,1672607138,2491
3857,3713829743,3272096759,1672540635,1672540696,61
3825,3294703680,3350095157,1672558919,1672559962,1043
3847,3622357348,3737972328,1672667071,1672669274,2203
3901,3703396825,3714120857,1672676844,1672680084,3240
3581,3296462324,3793175445,1672674266,1672674364,98
3553,3533274994,3760721303,1672584951,1672586072,1121
3731,3510642075,3613581796,1672584553,1672585038,485
3495,3713163045,3713784974,1672641031,1672641425,394
3572,3501786419,3716110860,1672676528,1672678191,1663
3909,3514419100,3808136029,1672620368,1672621790,1422
3712,3793781065,3770704999,1672605180,1672606311,1131
3775,3621683102,3783136330,1672628969,1672629487,518
3649,3497095254,3462158237,1672651679,1672653009,1330
3750,3713784974,3897376951,1672655384,1672656179,795
3822,3354144091,3783520186,1672669811,1672672944,3133
3716,3350095157,3757193307,1672603010,1672605526,2516
3450,3364378127,3803389195,1672637838,1672638718,880
3449,3454277788,3701247948,1672612541,1672615939,3398
3537,3792014516,3780209375,1672581150,1672583964,2814
3860,3519909393,3401940259,1672640979,1672643812,2833
3668,3757863420,3774907131,1672674745,1672676838,2093
3648,3472068734,3513295938,1672543619,1672544260,641
3774,3300229945,3779738691,1672611486,1672613614,2128
3626,3283492940,3505154885,1672618662,1672619818,1156
3657,3512379024,3415833929,1672674833,1672675402,569
3664,3367509761,3505402439,1672637770,1672640596,2826
3891,3779854934,3824215187,1672563684,1672565224,1540
3632,3615939504,3897456874,1672615946,1672618267,2321
3850,3710489491,3755222916,1672686245,1672688816,2571
3838,3534175249,3938503547,1672608851,1672609088,237
3723,3421877923,3621461051,1672616440,1672619087,2647
3688,3350095157,3239617320,1672656852,1672657830,978
3503,3713829743,3501525100,1672614977,1672618196,3219
3703,3308760650,3773332082,1672665430,1672666078,648
3792,3780427126,3501281016,1672589817,1672592459,2642
3654,3783550022,3316800320,1672561600,1672563377,1777
3742,3440137407,3613581796,1672540082,1672543300,3218
3596,3513545422,3379143440,1672549543,1672550874,1331
3834,3399472693,3608922867,1672580499,1672582824,2325
3563,3617304541,3793740407,1672638955,1672642124,3169
3474,3701884158,3505995057,1672670912,1672671226,314
3601,3780427126,3368283077,1672577946,1672578774,828
3850,3756474459,3815392801,1672569910,1672570916,1006
3800,3792489602,3757903168,1672533921,1672535963,2042
3448,3244004456,3515402792,1672665323,1672668142,2819
3634,3970603231,3739911441,1672654610,1672654753,143
3836,3360813161,3783615982,1672566156,1672567053,897
3564,3777330107,3225636215,1672541373,1672542367,994
3862,3402697190,3615087943,1672605200,1672606148,948
3898,3773121782,3350095157,1672570121,1672572390,2269
3697,3739661856,3737112297,1672702885,1672704734,1849
3525,3456430614,3897376951,1672663221,1672666400,3179
3663,3972192593,3618489670,1672584799,1672585203,404
3539,3819767045,3905196766,1672631514,1672634480,2966
3671,3511442562,3203538212,1672695184,1672695661,477
3537,3360069849,3757323954,1672591274,1672593283,2009
3780,3802932312,3304971369,1672535511,1672536284,773
3664,3760362417,3778926763,1672687323,1672687392,69
3794,3534829213,3773837847,1672652010,1672654883,2873
3538,3715127070,3225636215,1672562239,1672563223,984
3598,3916490839,3928511283,1672699893,1672701912,2019
3701,3779646172,3551376095,1672611098,1672614387,3289
3632,3364726656,3713691388,1672653666,1672656015,2349
3769,3520355798,3607768197,1672605540,1672605609,69
3812,3228888030,3906536154,1672618450,1672621860,3410
3790,3791693821,3412006598,1672608759,1672609932,1173
3826,3519909393,3900945856,1672542435,1672544869,2434
3451,3783136330,3779613523,1672631157,1672631566,409
3689,3803389195,3470454332,1672533313,1672535076,1763
3527,3624297844,3737147209,1672569483,1672572800,3317
3547,3713979100,3337362061,1672558581,1672561876,3295
3797,3447672935,3612689556,1672691415,1672693182,1767
3646,3635169815,3289114629,1672650021,1672652806,2785
3761,3370227921,3208957949,1672657382,1672660771,3389
3539,3284947372,3757323954,1672669499,1672669618,119
3896,3283492940,3514419100,1672614703,1672618225,3522
3674,3495911207,3793418209,1672666025,1672666456,431
3874,3904569677,3462636434,1672610280,1672613630,3350
3595,3777330107,3760924079,1672575438,1672575795,357
3646,3701136026,3906536154,1672562124,1672563914,1790
3498,3680843171,3715986185,1672645338,1672646460,1122
3901,3703798634,3334647380,1672616865,1672618889,2024
3767,3241790910,3791753345,1672548819,1672551297,2478
3612,3856606678,3367971170,1672657940,1672660013,2073
3548,3735374579,3811075491,1672586003,1672586119,116
3915,3478114114,3825881598,1672595488,1672598134,2646
3723,3607768197,3780472203,1672561338,1672564912,3574
3715,3711919537,3360616538,1672628846,1672629803,957
3778,3885157459,3510499038,1672583081,1672585425,2344
3598,3363162590,3970627281,1672686299,1672689138,2839
3686,3533368789,3778926763,1672593542,1672596228,2686
3476,3226511603,3778134418,1672698056,1672699376,1320
3620,3497095254,3510554314,1672556357,1672559886,3529
3827,3394297564,3970627281,1672701399,1672701548,149
3443,3803389195,3772765746,1672644929,1672646890,1961
3697,3409114719,3859868849,1672586649,1672589451,2802
3912,3513327337,3716679950,1672550705,1672553091,2386
3694,3760651515,3615737355,1672689702,1672691295,1593
3624,3682133690,3310125159,1672622119,1672623338,1219
3810,3688490530,3236458894,1672571123,1672572485,1362
3811,3401793306,3520560590,1672531239,1672533249,2010
3883,3900276517,3792505974,1672606503,1672607002,499
3640,3770236215,3533423872,1672577505,1672577958,453
3667,3892304880,3510499038,1672637729,1672638023,294
3793,3291933594,3778899160,1672548899,1672549595,696
3539,3715619259,3757700712,1672699021,1672701984,2963
3524,3205985903,3350095157,1672603705,1672604020,315
3877,3512337405,3612689556,1672619199,1672622304,3105
3586,3517881647,3501121099,1672604693,1672607338,2645
3596,3713517039,3511005395,1672653782,1672655603,1821
3832,3713768950,3607768197,1672639986,1672642944,2958
3686,3779938251,3737112297,1672692785,1672693150,365
3814,3760924079,3500317969,1672685290,1672687097,1807
3631,3760040019,3760364383,1672607870,1672609919,2049
3469,3829864515,3360616538,1672604566,1672607799,3233
3665,3757193307,3513410578,1672681884,1672685182,3298
3714,3367509761,3510818674,1672681488,1672684555,3067
3908,3226024417,3807212280,1672683618,1672686659,3041
3530,3510554314,3780472203,1672703260,1672703557,297
3492,3859868849,3515439826,1672651128,1672651473,345
3773,3701005527,3520322124,1672650745,1672651626,881
3490,3441703884,3519282716,1672677050,1672680564,3514
3769,3755737419,3933894942,1672565088,1672566054,966
3883,3333918941,3755737419,1672703929,1672705600,1671
3911,3934064792,3774243020,1672569355,1672569887,532
3589,3501786419,3892304880,1672571324,1672574632,3308
3519,3517462308,3300511067,1672608632,1672609320,688
3524,3505481368,3338390596,1672628110,1672631388,3278
3610,3559731671,3336627643,1672684478,1672687560,3082
3635,3683113954,3375449013,1672622440,1672622874,434
3518,3511843593,3394401087,1672673128,1672674368,1240
3694,3505266860,3680843171,1672573841,1672574060,219
3829,3780253901,3380767040,1672623032,1672626249,3217
3922,3733558985,3500044458,1672637164,1672639964,2800
3470,3534175249,3300818269,1672615986,1672618656,2670
3590,3534764451,3516903528,1672630047,1672630170,123
3552,3408498208,3500525825,1672550816,1672552675,1859
3572,3737147209,3660887799,1672697030,1672698877,1847
3428,3770236215,3755915206,1672602395,1672603312,917
3659,3512958459,3701247948,1672534758,1672534885,127
3731,3921648519,3977352557,1672651718,1672653303,1585
3510,3226024417,3621790707,1672531305,1672534219,2914
3658,3462273042,3517887477,1672596388,1672596750,362
3781,3428725843,3300979975,1672661187,1672662557,1370
3879,3755230952,3380982774,1672620115,1672623055,2940
3769,3300979975,3279475486,1672621397,1672623437,2040
3915,3783550022,3438078818,1672625760,1672628627,2867
3546,3927403123,3401940259,1672647268,1672650456,3188
3821,3776244398,3793743698,1672689163,1672690416,1253
3525,3688220326,3500709774,1672531937,1672534000,2063
3725,3448875382,3852686295,1672549250,1672549493,243
3838,3371455553,3774641380,1672557459,1672557531,72
3774,3792801638,3451326054,1672587319,1672589755,2436
3630,3517697722,3505402439,1672595240,1672598103,2863
3762,3488763230,3410538749,1672628735,1672631583,2848
3904,3755915206,3518565331,1672691995,1672692393,398
3776,3514818819,3497808662,1672681612,1672683796,2184
3442,3757075324,3480991549,1672643652,1672644479,827
3581,3620292035,3635169815,1672548280,1672549088,808
3858,3715854030,3669146016,1672703120,1672704184,1064
3558,3512392431,3450969839,1672656154,1672656875,721
3871,3533274994,3773332082,1672648518,1672651259,2741
3816,3241914067,3899326793,1672594266,1672596312,2046
3466,3460719322,3382733096,1672552473,1672555389,2916
3841,3357864626,3801645328,1672533099,1672536650,3551
3660,3516444201,3511288998,1672569164,1672571433,2269
3780,3779425804,3311420950,1672553128,1672555775,2647
3825,3412968120,3202141727,1672610440,1672612392,1952
3888,3714233826,3770296583,1672554453,1672556300,1847
3575,3783641602,3380982774,1672670599,1672672122,1523
3601,3512958459,3431502855,1672687540,1672687673,133
3802,3448633776,3626499450,1672698935,1672701579,2644
3532,3612689556,3220031931,1672543472,1672544221,749
3888,3448875382,3664943873,1672544217,1672546547,2330
3836,3205923620,3463849738,1672543732,1672547241,3509
3865,3609659642,3887243870,1672604609,1672607677,3068
3905,3451726367,3387594369,1672552194,1672553540,1346
3794,3900945856,3710496785,1672594673,1672597766,3093
3664,3516703758,3497671225,1672537926,1672539381,1455
3638,3300979975,3533004959,1672598292,1672598783,491
3546,3900945856,3688796737,1672605426,1672605836,410
3658,3500949309,3505807416,1672655806,1672656166,360
3457,3514275974,3812534508,1672622587,1672625815,3228
3852,3859868849,3793922324,1672591852,1672594919,3067
3869,3311085279,3757383891,1672566003,1672567723,1720
3754,3777330107,3373028638,1672603294,1672603667,373
3614,3500841914,3783163143,1672559163,1672560284,1121
3797,3424660806,3310039260,1672673626,1672675049,1423
3439,3227799827,3556969573,1672692655,1672694507,1852
3556,3774155692,3713561276,1672580640,1672580917,277
3614,3389634034,3793935736,1672624388,1672625570,1182
3426,3680843171,3701664364,1672698111,1672700534,2423
3695,3551399764,3479851674,1672558766,1672561434,2668
3887,3284932450,3500442734,1672624526,1672624944,418
3629,3916490839,3497808662,1672686924,1672688881,1957
3535,3792745809,3428027649,1672631851,1672633106,1255
3467,3783433404,3501215099,1672643147,1672645898,2751
3901,3703798634,3357864626,1672660980,1672662383,1403
3434,3897376951,3607768197,1672669869,1672672878,3009
3712,3500841914,3793315718,1672683032,1672685564,2532
3880,3624297844,3621683102,1672603580,1672606560,2980
3715,3500604680,3305722859,1672657208,1672658148,940
3881,3398198430,3615115210,1672695970,1672698309,2339
3483,3505995057,3225636215,1672684325,1672687848,3523
3803,3312998540,3510798825,1672668711,1672669325,614
3688,3516444201,3440107959,1672534065,1672534679,614
3753,3511288998,3701664364,1672557641,1672559181,1540
3593,3505521218,3778134418,1672619177,1672622582,3405
3634,3279339278,3755222916,1672534641,1672535452,811
3522,3777091903,3305336154,1672689517,1672691266,1749
3835,3467988782,3916490839,1672545429,1672548387,2958
3858,3357689359,3778134418,1672674407,1672676516,2109
3745,3519416013,3684523966,1672565124,1672568504,3380
3444,3246370118,3713911104,1672615008,1672615667,659
3569,3516489668,3780322355,1672592913,1672593584,671
3569,3783641602,3240394404,1672564227,1672566905,2678
3851,3360813161,3517222913,1672577127,1672577249,122
3480,3757323954,3240394404,1672579596,1672581730,2134
3821,3803517637,3408430195,1672550052,1672553549,3497
3583,3288224595,3557046880,1672699098,1672700477,1379
3788,3414275042,3887243870,1672693512,1672696969,3457
3748,3824215187,3519446663,1672600551,1672601283,732
3439,3773009828,3897456874,1672673064,1672673128,64
3480,3977352557,3480726047,1672608001,1672610712,2711
3473,3520322124,3780680950,1672681481,1672684185,2704
3714,3510919821,3401940259,1672597509,1672597975,466
3497,3519282716,3934064792,1672543407,1672546085,2678
3848,3607768197,3500949309,1672558347,1672561484,3137
3470,3515402792,3829822608,1672604368,1672607598,3230
3658,3779892400,3399518841,1672557304,1672560605,3301
3913,3534175249,3710496785,1672625668,1672629033,3365
3637,3511024016,3424445495,1672628229,1672629215,986
3486,3367111751,3505198734,1672681892,1672682928,1036
3794,3445206685,3923754072,1672671681,1672671927,246
3911,3533090502,3410538749,1672642893,1672645260,2367
3819,3923754072,3713941638,1672539477,1672541597,2120
3559,3783919913,3401940259,1672625959,1672626052,93
3819,3779639983,3819767045,1672673331,1672674896,1565
3533,3289114629,3760362417,1672652298,1672652523,225
3725,3500208903,3900945856,1672636077,1672639417,3340
3619,3703139663,3792949946,1672652104,1672655146,3042
3921,3669146016,3756789525,1672688882,1672689757,875
3683,3755532873,3230135532,1672555585,1672558278,2693
3768,3975717896,3395201292,1672550439,1672552810,2371
3565,3770624662,3341893384,1672676539,1672676970,431
3589,3279475486,3559731671,1672583079,1672583608,529
3611,3360616538,3714678331,1672590488,1672591781,1293
3452,3755404116,3773027597,1672532424,1672534981,2557
3907,3300979975,3462273042,1672641848,1672642101,253
3829,3393063657,3823084403,1672701403,1672704353,2950
3653,3500613493,3440107959,1672614410,1672616840,2430
3867,3347446226,3485540729,1672699245,1672701527,2282
3648,3236458894,3791246640,1672700935,1672702395,1460
3907,3511732493,3491684096,1672618600,1672620509,1909
3896,3513081354,3793935736,1672639094,1672641297,2203
3674,3520991398,3357689359,1672537452,1672538032,580
3846,3701005527,3776084820,1672702963,1672706547,3584
3436,3713517039,3288762795,1672573706,1672574812,1106
3766,3623266256,3891672228,1672568296,1672570841,2545
3640,3776559988,3271454397,1672674061,1672674706,645
3913,3780427126,3373028638,1672666394,1672667544,1150
3638,3689697817,3737112297,1672567970,1672571252,3282
3804,3389634034,3354144091,1672676992,1672677732,740
3556,3354144091,3515559913,1672653517,1672656696,3179
3506,3517737088,3774907131,1672673402,1672674166,764
3466,3520639768,3619922891,1672698461,1672699646,1185
3495,3933894942,3447672935,1672578648,1672582061,3413
3573,3776084820,3517172354,1672601330,1672604348,3018
3545,3300511067,3401793306,1672692103,1672692333,230
3576,3514512367,3557046880,1672685608,1672688158,2550
3631,3500737582,3622357348,1672560731,1672563071,2340
3515,3739661856,3515890966,1672672269,1672675002,2733
3796,3336627643,3791046864,1672630921,1672633144,2223
3873,3755404116,3617392620,1672603284,1672603399,115
3701,3880926355,3357864626,1672669362,1672670223,861
3586,3793922324,3617304541,1672619371,1672619569,198
3898,3500109249,3505663516,1672604994,1672607112,2118
3820,3757318448,3774290799,1672647424,1672647684,260
3608,3923754072,3776518452,1672535326,1672537476,2150
3532,3801645328,3514741348,1672596052,1672596862,810
3666,3755222916,3512499658,1672539411,1672542893,3482
3799,3793407963,3280268483,1672695722,1672695960,238
3638,3777485931,3902861231,1672595544,1672597105,1561
3506,3516489668,3912891315,1672574033,1672575431,1398
3762,3792014516,3899786664,1672601631,1672601951,320
3614,3714120857,3829864515,1672639972,1672640679,707
3440,3519909393,3512282789,1672630561,1672630872,311
3476,3513345163,3311098437,1672656880,1672659136,2256
3882,3884596900,3770704999,1672596260,1672599059,2799
3677,3497808662,3519818818,1672532948,1672534788,1840
3425,3897376951,3970198861,1672560659,1672563880,3221
3660,3534126409,3533079336,1672623267,1672624232,965
3439,3757323954,3780322355,1672636918,1672639014,2096
3493,3300979975,3755848152,1672560944,1672562076,1132
3866,3208452238,3615688740,1672615398,1672618928,3530
3708,3755756564,3716110860,1672652398,1672655493,3095
3748,3514741348,3518561777,1672619970,1672621158,1188
3568,3852533643,3509893027,1672578690,1672581184,2494
3827,3500498112,3618697021,1672663001,1672665197,2196
3614,3793969543,3757318448,1672655464,1672655606,142
3582,3448633776,3479851674,1672612881,1672614742,1861
3596,3780571086,3518653080,1672658879,1672661292,2413
3458,3783928182,3534126409,1672698833,1672701494,2661
3688,3401940259,3902861231,1672640351,1672642213,1862
3751,3501567772,3533294425,1672583454,1672585293,1839
3466,3639050419,3667673649,1672569395,1672571090,1695
3577,3517737088,3386758279,1672690413,1672692173,1760
3694,3900898992,3505807416,1672544692,1672545990,1298
3887,3500672156,3773009828,1672677991,1672680859,2868
3820,3512282789,3783641602,1672567111,1672568556,1445
3820,3714670620,3205985903,1672663753,1672664240,487
3685,3429943738,3710315160,1672644945,1672645472,527
3889,3839245934,3513327337,1672660416,1672661694,1278
3734,3791046864,3610870949,1672664535,1672667864,3329
3741,3757294769,3514971533,1672565876,1672569277,3401
3505,3512337405,3619922891,1672535039,1672538223,3184
3720,3517172354,3731646673,1672546267,1672548076,1809
3518,3793883863,3520416075,1672531562,1672533021,1459
3788,3519909393,3505437712,1672598553,1672598888,335
3778,3520578796,3701107228,1672628135,1672629382,1247
3452,3457960571,3454277788,1672676420,1672677454,1034
3541,3689114185,3834631333,1672694719,1672694864,145
3557,3638204468,3934064792,1672583336,1672586495,3159
3749,3513296868,3534764451,1672635297,1672637645,2348
3538,3755496114,3410160376,1672687103,1672687194,91
3804,3755532873,3783641602,1672555345,1672556084,739
3829,3914691363,3850911686,1672574636,1672576526,1890
3812,3505402439,3357289672,1672643438,1672646194,2756
3913,3792538417,3783163143,1672579273,1672579964,691
3822,3201800997,3480991549,1672685409,1672688477,3068
3751,3637313265,3776034743,1672643697,1672646299,2602
3577,3510642075,3270056120,1672572878,1672573804,926
3920,3390660440,3389634034,1672609514,1672612544,3030
3501,3711077927,3283770991,1672701615,1672704086,2471
3916,3517737088,3791436104,1672552623,1672553787,1164
3707,3755222916,3513327337,1672583454,1672584126,672
3783,3925979970,3505228454,1672578600,1672581505,2905
3511,3977148669,3617489344,1672633658,1672637187,3529
3593,3780872464,3713979100,1672701839,1672703969,2130
3549,3283144118,3780472203,1672543734,1672547063,3329
3603,3757630221,3410538749,1672687808,1672688235,427
3792,3701373490,3774718695,1672595301,1672596885,1584
3670,3760721303,3714670620,1672591885,1672591980,95
3837,3205985903,3280268483,1672617669,1672619987,2318
3507,3515466096,3431460073,1672664045,1672664506,461
3493,3435116799,3515402792,1672536749,1672538819,2070
3870,3829822608,3343132529,1672630276,1672633300,3024
3878,3714827719,3500949309,1672543938,1672545789,1851
3685,3467988782,3380130228,1672658824,1672659624,800
3515,3300979975,3312998540,1672547944,1672550984,3040
3440,3431460073,3713163045,1672648026,1672648640,614
3789,3902625986,3615939504,1672630657,1672632134,1477
3518,3517288083,3443357683,1672590000,1672591359,1359
3705,3315703693,3435167810,1672691963,1672694644,2681
3852,3551389192,3443357683,1672638536,1672641208,2672
3565,3376467719,3780872464,1672667198,1672670252,3054
3921,3778040015,3294747828,1672611888,1672614444,2556
3599,3330340793,3415833929,1672634130,1672635341,1211
3566,3760645796,3970603231,1672635728,1672637781,2053
3431,3299443125,3513410578,1672573038,1672574404,1366
3596,3310125159,3773572967,1672555248,1672555722,474
3672,3362641275,3818575661,1672627484,1672630231,2747
3525,3738026330,3500613459,1672539219,1672542723,3504
3779,3500827202,3711077927,1672665012,1672667292,2280
3659,3333918941,3393063657,1672690475,1672692889,2414
3575,3760362417,3831586487,1672645710,1672647681,1971
3774,3930242012,3714067076,1672560714,1672561191,477
3777,3777037426,3485540729,1672632497,1672634356,1859
3537,3701884158,3713691388,1672666916,1672669203,2287
3805,3738026330,3311085279,1672581892,1672584223,2331
3459,3624297844,3755158925,1672534960,1672538229,3269
3469,3392943173,3669146016,1672682434,1672685387,2953
3795,3970198861,3755992176,1672571152,1672573333,2181
3851,3517288083,3224968597,1672670128,1672672839,2711
3670,3500613493,3760040019,1672636549,1672638465,1916
3704,3224968597,3714128600,1672652891,1672655315,2424
3616,3669146016,3610870949,1672611170,1672614466,3296
3692,3604589802,3505198734,1672681948,1672683468,1520
3777,3338390596,3517697722,1672532449,1672534885,2436
3810,3330340793,3773735484,1672657438,1672657654,216
3607,3714670620,3756127300,1672605198,1672607031,1833
3591,3279242917,3755496114,1672628762,1672629169,407
3706,3689114185,3459681410,1672629124,1672630415,1291
3788,3309314379,3734118023,1672580220,1672581855,1635
3524,3270056120,3701823816,1672561201,1672563684,2483
3844,3288762795,3971806004,1672678061,1672678216,155
3812,3615115210,3520416075,1672677180,1672679260,2080
3451,3783169442,3714670620,1672658796,1672661611,2815
3707,3824641227,3792546035,1672571563,1672574478,2915
3749,3534179433,3515466096,1672624684,1672624778,94
3889,3520115090,3509893027,1672550153,1672550565,412
3460,3899786664,3517881647,1672624496,1672626813,2317
3920,3613899351,3760924079,1672560267,1672562198,1931
3636,3514818819,3510499038,1672669205,1672669965,760
3439,3701664364,3778040015,1672546225,1672549615,3390
3626,3638660068,3510642075,1672601937,1672604264,2327
3517,3468041839,3714067076,1672572801,1672575597,2796
3751,3792020993,3639050419,1672589267,1672589788,521
3604,3500109249,3792546035,1672596809,1672598467,1658
3813,3773837847,3757318448,1672661316,1672663611,2295
3765,3520181148,3755848152,1672677254,1672677750,496
3623,3711853996,3852533643,1672573714,1672574234,520
3618,3392943173,3833217041,1672571404,1672573555,2151
3556,3636329663,3632814465,1672597077,1672598605,1528
3640,3505663516,3501567772,1672579586,1672582217,2631
3544,3600876425,3505807416,1672562246,1672564083,1837
3534,3505179890,3357864626,1672547590,1672550762,3172
3795,3823084403,3303410628,1672681172,1672683773,2601
3593,3780680950,3463740710,1672635801,1672638037,2236
3582,3461119815,3236458894,1672590600,1672591678,1078
3478,3408498208,3783928182,1672692769,1672693394,625
3819,3685681577,3732131656,1672605133,1672605850,717
3724,3363162590,3792072681,1672556221,1672558224,2003
3500,3627368399,3778640261,1672540618,1672542563,1945
3868,3512958459,3757294769,1672584598,1672587370,2772
3749,3514703118,3716628503,1672546668,1672549657,2989
3792,3417679834,3638204468,1672694730,1672696881,2151
3853,3625174002,3408498208,1672698643,1672700637,1994
3620,3604867757,3660063072,1672566061,1672567438,1377
3515,3335694356,3897134762,1672585607,1672585878,271
3719,3780680950,3839245934,1672560392,1672562622,2230
3727,3780427126,3714670620,1672581885,1672584165,2280
3514,3760040019,3357289672,1672580780,1672581379,599
3643,3511288998,3512282789,1672550141,1672551948,1807
3813,3791046864,3374183227,1672614073,1672616421,2348
3446,3370068529,3236354255,1672602631,1672604552,1921
3861,3755848152,3927599181,1672632944,1672635821,2877
3909,3511791953,3713911104,1672624164,1672626878,2714
3689,3716628503,3520560590,1672558369,1672560712,2343
3813,3515559913,3551399764,1672596947,1672598445,1498
3781,3283492940,3755915206,1672643287,1672645624,2337
3435,3617116290,3519909393,1672637257,1672639402,2145
3456,3755158925,3927165965,1672653787,1672655515,1728
3878,3454277788,3780872464,1672697712,1672699091,1379
3567,3774243020,3756704774,1672696975,1672698072,1097
3473,3835985172,3274831810,1672592913,1672593658,745
3717,3517462308,3500072204,1672598790,1672600944,2154
3488,3554825448,3923754072,1672688931,1672692434,3503
3908,3779438325,3500525825,1672578116,1672580811,2695
3868,3757318448,3533274994,1672643482,1672644100,618
3603,3904412440,3311420950,1672683193,1672686146,2953
3493,3773572967,3633735593,1672682963,1672683549,586
3556,3516321888,3600876425,1672606575,1672609403,2828
3803,3517600136,3396980894,1672595170,1672597202,2032
3496,3755496114,3773121782,1672664487,1672665223,736
3505,3793740407,3780472203,1672675951,1672679530,3579
3537,3858172636,3500072204,1672701267,1672703834,2567
3719,3783771827,3884596900,1672593068,1672595157,2089
3765,3734451191,3292147449,1672621612,1672624665,3053
3842,3773009828,3248058676,1672580910,1672581888,978
3651,3509893027,3515890966,1672590795,1672594121,3326
3705,3793175445,3756746867,1672671243,1672672750,1507
3921,3902760230,3829864515,1672543475,1672543972,497
3497,3230868435,3436025562,1672549112,1672551218,2106
3490,3928511283,3429943738,1672658622,1672661221,2599
3742,3715854030,3618354185,1672548530,1672550974,2444
3461,3375449013,3500737582,1672602931,1672604144,1213
3825,3774178201,3853629553,1672608533,1672611769,3236
3694,3410160376,3408498208,1672668209,1672671196,2987
3897,3792949946,3807212280,1672559600,1672562304,2704
3635,3791441520,3714185969,1672613186,1672615952,2766
3510,3200308999,3667427125,1672539620,1672542772,3152
3542,3500709774,3780834916,1672625428,1672626514,1086
3775,3770624662,3773124276,1672534321,1672534491,170
3689,3285204083,3701884158,1672675576,1672676579,1003
3589,3780712350,3625174002,1672599614,1672603041,3427
3493,3668414677,3451726367,1672643096,1672645937,2841
3820,3380130228,3713941638,1672544922,1672548518,3596
3672,3808136029,3829864515,1672675988,1672677039,1051
3554,3511843593,3392520516,1672561218,1672561573,355
3785,3660887799,3472312341,1672644312,1672644917,605
3718,3270056120,3737147209,1672639083,1672639478,395
3916,3236499444,3772236797,1672596605,1672599246,2641
3823,3791436104,3517358573,1672556848,1672557239,391
3485,3614740489,3880926355,1672687449,1672691004,3555
3684,3316800320,3777330107,1672605404,1672607879,2475
3898,3909094917,3505178849,1672572098,1672572949,851
3840,3615737355,3401496246,1672638492,1672641065,2573
3908,3501215099,3552824113,1672609979,1672613425,3446
3744,3501786419,3491684096,1672593417,1672595945,2528
3691,3773124276,3511732493,1672663744,1672664034,290
3776,3923420131,3711853996,1672569509,1672569988,479
3563,3736231757,3774641380,1672534454,1672536796,2342
3714,3533004959,3311049964,1672619063,1672619523,460
3545,3885537225,3505437712,1672538772,1672540488,1716
3474,3739154408,3500317969,1672579486,1672581734,2248
3898,3791796585,3206837348,1672581044,1672584603,3559
3759,3311049964,3231713082,1672659546,1672661339,1793
3820,3923220461,3416987084,1672617217,1672618262,1045
3686,3756474459,3411688875,1672687028,1672687735,707
3922,3351866415,3500737582,1672579220,1672580720,1500
3660,3631479562,3497808662,1672672659,1672673887,1228
3669,3819767045,3780680950,1672702490,1672705500,3010
3659,3410160376,3239617320,1672630717,1672632020,1303
3784,3779738691,3914691363,1672645050,1672645816,766
3755,3739895284,3915162005,1672536697,1672538679,1982
3614,3617116290,3505437712,1672594809,1672594913,104
3840,3777240360,3514334067,1672586246,1672589020,2774
3842,3518653080,3349856820,1672699149,1672702228,3079
3555,3285204083,3501567772,1672688093,1672691411,3318
3895,3497808662,3932478321,1672535604,1672537614,2010
3894,3935399379,3895285664,1672576637,1672580046,3409
3452,3311085279,3411515369,1672606677,1672609506,2829
3865,3468041839,3612689556,1672570256,1672571146,890
3813,3884596900,3517881647,1672543187,1672545019,1832
3793,3206837348,3777037426,1672556958,1672557750,792
3464,3447672935,3367971170,1672563556,1672566073,2517
3492,3710735406,3774155692,1672581180,1672582427,1247
3784,3272096759,3713691388,1672576290,1672579494,3204
3685,3280268483,3338390596,1672580657,1672581823,1166
3766,3517358573,3713979100,1672556119,1672556314,195
3434,3618176292,3736705719,1672656443,1672657280,837
3470,3518565331,3791106564,1672691797,1672692340,543
3851,3513327337,3512379024,1672547785,1672550822,3037
3651,3701107228,3514275974,1672629046,1672632307,3261
3884,3454277788,3701107228,1672552209,1672554955,2746
3683,3554944414,3620292035,1672542761,1672544944,2183
3876,3791613604,3500613459,1672639523,1672640152,629
3583,3760362417,3713941638,1672577680,1672578525,845
3544,3972083617,3710048469,1672635828,1672636440,612
3912,3410538749,3807212280,1672628869,1672629962,1093
3565,3815250107,3778134418,1672625786,1672629065,3279
3875,3374183227,3380982774,1672540785,1672543504,2719
3618,3514324011,3513410578,1672593249,1672594070,821
3739,3609113156,3902760230,1672560424,1672561875,1451
3437,3533188828,3500208903,1672642839,1672644387,1548
3881,3505111292,3439673892,1672664256,1672666072,1816
3670,3760721303,3202141727,1672587102,1672589147,2045
3815,3757630221,3661583097,1672638279,1672638621,342
3484,3398731252,3500672156,1672676997,1672677675,678
3543,3241790910,3977148669,1672618573,1672619608,1035
3486,3617489344,3760640999,1672575594,1672576916,1322
3587,3412006598,3807212280,1672574157,1672576550,2393
3467,3374183227,3472068734,1672622660,1672623593,933
3731,3274831810,3272096759,1672603577,1672605053,1476
3798,3300818269,3300511067,1672549311,1672549852,541
3447,3515890966,3373028638,1672562010,1672565174,3164
3544,3517358573,3792525861,1672627779,1672630810,3031
3755,3856606678,3499217428,1672532268,1672532879,611
3704,3505888598,3899786664,1672585743,1672586239,496
3433,3380767040,3456430614,1672619070,1672619731,661
3616,3777485931,3736705719,1672618424,1672621425,3001
3619,3783147088,3780872464,1672637996,1672640777,2781
3911,3680843171,3341893384,1672574773,1672577031,2258
3766,3972192593,3770296583,1672640019,1672641637,1618
3553,3341893384,3791796585,1672606037,1672606703,666
3747,3793407963,3300979975,1672599489,1672602196,2707
3651,3461119815,3756625818,1672562322,1672562967,645
3839,3780571086,3760651515,1672585903,1672588753,2850
3762,3349856820,3622357348,1672552754,1672553169,415
3510,3520991398,3311049964,1672558945,1672560609,1664
3550,3609113156,3836241528,1672584422,1672586101,1679
3599,3711919537,3701664364,1672590616,1672593235,2619
3649,3501525100,3230135532,1672562591,1672563897,1306
3873,3371455553,3755496114,1672611288,1672613636,2348
3893,3826238375,3792014516,1672609261,1672610903,1642
3894,3372223551,3510642075,1672654567,1672657456,2889
3593,3294747828,3288224595,1672577465,1672580531,3066
3859,3380982774,3239617320,1672639801,1672640209,408
3748,3770704999,3608855425,1672679050,1672681936,2886
3592,3315279093,3467779445,1672548725,1672549790,1065
3466,3770676872,3803389195,1672602575,1672602674,99
3772,3500827202,3512800570,1672607018,1672610134,3116
3600,3811075491,3490214516,1672621210,1672621972,762
3808,3923754072,3509366311,1672590605,1672594089,3484
3678,3306412634,3455018347,1672688386,1672691571,3185
3797,3510187271,3701322924,1672568681,1672571470,2789
3696,3660063072,3755573472,1672637321,1672638303,982
3531,3520639768,3519077659,1672662018,1672663117,1099
3862,3933894942,3467779445,1672606367,1672606639,272
3477,3661583097,3447514821,1672547719,1672550423,2704
3658,3505521218,3618808151,1672684850,1672685549,699
3920,3701884158,3609933747,1672563878,1672566381,2503
3799,3613206049,3760364383,1672577804,1672580621,2817
3639,3534175249,3792274796,1672660803,1672661662,859
3514,3401940259,3760263530,1672547639,1672548185,546
3510,3360813161,3505923418,1672658027,1672659775,1748
3831,3938389661,3308760650,1672531241,1672532552,1311
3671,3703383853,3557046880,1672571439,1672572165,726
3560,3240994288,3619922891,1672606963,1672609927,2964
3911,3803389195,3661583097,1672548813,1672549018,205
3535,3402697190,3755233658,1672607966,1672611140,3174
3505,3773121782,3500613493,1672627590,1672628951,1361
3448,3904569677,3780909839,1672597517,1672598259,742
3872,3852533643,3977352557,1672691227,1672694107,2880
3543,3617304541,3902861231,1672619987,1672620774,787
3741,3402697190,3715986185,1672580159,1672583694,3535
3534,3793969543,3534357694,1672594009,1672596609,2600
3818,3446533960,3533747868,1672611076,1672613126,2050
3771,3551399764,3404025196,1672666737,1672668332,1595
3513,3518194482,3557046880,1672628808,1672631000,2192
3488,3500347447,3367111751,1672563811,1672566686,2875
3495,3608232640,3517687662,1672652461,1672653895,1434
3502,3519651506,3701107228,1672613387,1672615555,2168
3790,3792020993,3505888598,1672670988,1672672240,1252
3593,3459681410,3347419520,1672586686,1672587497,811
3821,3770296583,3715619259,1672541020,1672543698,2678
3520,3520416075,3500072204,1672620349,1672620878,529
3732,3923220461,3500703304,1672622788,1672624668,1880
3791,3513295938,3793743698,1672648317,1672650869,2552
3727,3770624662,3276217799,1672685970,1672689377,3407
3704,3289114629,3499217428,1672651470,1672653422,1952
3552,3815392801,3439673892,1672603355,1672604811,1456
3899,3710048469,3617304541,1672691304,1672692136,832
3620,3668747074,3311098437,1672695999,1672698808,2809
3548,3921648519,3288762795,1672545470,1672545853,383
3574,3334974375,3772078494,1672593106,1672594369,1263
3681,3279473441,3714678331,1672676021,1672678506,2485
3802,3779646172,3472312341,1672595300,1672596486,1186
3889,3791046864,3688796737,1672595891,1672596349,458
3702,3236458894,3615115210,1672593670,1672593833,163
3801,3334974375,3739661856,1672555438,1672558586,3148
3800,3604867757,3468041839,1672589869,1672592409,2540
3753,3686523546,3783520186,1672648960,1672650491,1531
3490,3793868716,3226511603,1672547684,1672550939,3255
3839,3756789525,3205985903,1672637233,1672639558,2325
3513,3685681577,3398731252,1672674430,1672675436,1006
3746,3779892400,3773902805,1672650992,1672651469,477
3885,3970909253,3364726656,1672601594,1672602868,1274
3844,3701005527,3834963772,1672678109,1672680297,2188
3608,3713691388,3783771827,1672540828,1672543792,2964
3759,3480490124,3772391882,1672624362,1672625694,1332
3519,3511317276,3783928182,1672694766,1672698200,3434
3589,3384068080,3289114629,1672663964,1672664652,688
3825,3373089838,3451326054,1672669652,1672672936,3284
3800,3500208903,3710008361,1672647508,1672647631,123
3546,3736231757,3351696332,1672691467,1672693340,1873
3900,3515890966,3711218296,1672630497,1672633422,2925
3820,3818575661,3711006062,1672674375,1672675322,947
3519,3369708250,3711097754,1672614342,1672614774,432
3848,3617116290,3333403880,1672554255,1672555581,1326
3547,3451726367,3772236797,1672639197,1672639553,356
3708,3755992176,3401793306,1672571640,1672572589,949
3829,3533649454,3505888598,1672678769,1672681090,2321
3475,3716272919,3490214516,1672550310,1672553181,2871
3852,3839245934,3490029863,1672667741,1672669191,1450
3682,3534543776,3308760650,1672671434,1672673741,2307
3486,3783520186,3495911207,1672672842,1672673283,441
3500,3801645328,3757348722,1672548533,1672552104,3571
3565,3770438122,3533649454,1672656327,1672657252,925
3546,3479851674,3500949309,1672681242,1672682055,813
3777,3390660440,3371455553,1672598580,1672602057,3477
3619,3780571086,3757318448,1672535650,1672539197,3547
3524,3274831810,3631090677,1672658216,1672661765,3549
3658,3480991549,3299443125,1672675538,1672677603,2065
3711,3505807416,3783136330,1672566898,1672567037,139
3868,3779938251,3509366311,1672638346,1672638578,232
3826,3470454332,3825881598,1672686580,1672689432,2852
3488,3638204468,3739911441,1672590483,1672591017,534
3584,3605221116,3779656423,1672579802,1672579882,80
3459,3933894942,3380982774,1672701246,1672702599,1353
3622,3497808662,3625463628,1672537058,1672540321,3263
3754,3611055563,3770236215,1672674755,1672676592,1837
3477,3607882826,3928511283,1672617772,1672618863,1091
3843,3439673892,3500841914,1672553685,1672557002,3317
3714,3777779869,3393063657,1672684108,1672686693,2585
3723,3688220326,3884596900,1672603303,1672604121,818
3578,3492546679,3518561777,1672641511,1672643783,2272
3792,3343816795,3890739241,1672545671,1672549087,3416
3721,3505663516,3923754072,1672610307,1672612687,2380
3528,3435116799,3366423342,1672651796,1672655079,3283
3728,3715707380,3774031303,1672675064,1672676424,1360
3815,3619922891,3770704999,1672538262,1672539243,981
3616,3715619259,3513041785,1672661846,1672662769,923
3565,3791753345,3505888598,1672597378,1672599238,1860
3553,3779438325,3534179433,1672572104,1672572456,352
3575,3776117322,3518194482,1672630473,1672633153,2680
3683,3284932450,3306412634,1672628789,1672630093,1304
3841,3779465522,3202141727,1672698386,1672698846,460
3610,3756385685,3760364383,1672664543,1672666521,1978
3782,3300511067,3457620713,1672586778,1672588079,1301
3720,3791441520,3880926355,1672657626,1672658733,1107
3614,3776518452,3716110860,1672604903,1672606076,1173
3593,3517172354,3887243870,1672671969,1672674878,2909
3816,3757075324,3618489670,1672592954,1672596525,3571
3501,3517737088,3760651515,1672548673,1672551627,2954
3428,3755065949,3779301501,1672693109,1672695766,2657
3903,3812534508,3615087943,1672539361,1672542228,2867
3719,3291933594,3510641433,1672630050,1672630112,62
3770,3533004959,3926643445,1672679777,1672680874,1097
3911,3480726047,3300979975,1672608554,1672609668,1114
3877,3499217428,3514334067,1672680213,1672680381,168
3650,3739661856,3889780657,1672658117,1672661276,3159
3431,3792442597,3793883863,1672652265,1672653579,1314
3817,3271454397,3626499450,1672623903,1672626475,2572
3665,3491469603,3793740407,1672681354,1672684722,3368
3533,3518229776,3534175249,1672681070,1672681524,454
3517,3360616538,3360813161,1672590791,1672593191,2400
3449,3791106564,3774243020,1672627814,1672628341,527
3772,3928719932,3519142371,1672699427,1672701619,2192
3735,3791796585,3780338697,1672548842,1672549616,774
3762,3783340788,3514246749,1672637120,1672639023,1903
3747,3777330107,3533079336,1672698623,1672700911,2288
3826,3710008361,3902760230,1672550876,1672551787,911
3608,3779438325,3780680950,1672650402,1672652834,2432
3514,3509483172,3299125059,1672603032,1672604223,1191
3746,3512392431,3367971170,1672694836,1672695569,733
3736,3238288884,3770438122,1672665733,1672668214,2481
3508,3755158925,3829822608,1672565308,1672566628,1320
3771,3793407963,3509366311,1672636490,1672637912,1422
3553,3511288998,3777814504,1672564612,1672565115,503
3894,3604589802,3793418209,1672644421,1672647896,3475
3462,3716272919,3510187271,1672571019,1672574361,3342
3692,3304155815,3457620713,1672642462,1672642532,70
3709,3898314440,3701247948,1672594214,1672594947,733
3844,3248058676,3400763927,1672642630,1672646195,3565
3851,3517887477,3231494505,1672647309,1672649213,1904
3830,3231494505,3512882178,1672626476,1672628004,1528
3536,3271454397,3793922324,1672690563,1672692632,2069
3918,3467988782,3713979100,1672607503,1672608442,939
3730,3519282716,3770146716,1672657771,1672660945,3174
3843,3347419520,3783136330,1672542738,1672545068,2330
3662,3299443125,3505402439,1672670524,1672673946,3422
3563,3921648519,3347419520,1672534013,1672534449,436
3462,3734915241,3977352557,1672586284,1672589754,3470
3904,3273981374,3512379024,1672569560,1672572922,3362
3572,3780472203,3935913584,1672650057,1672652833,2776
3598,3520181148,3283144118,1672641416,1672642488,1072
3479,3520115090,3505725706,1672640357,1672640878,521
3894,3534126409,3792389522,1672689825,1672689991,166
3712,3792538417,3412968120,1672656871,1672658246,1375
3437,3926643445,3468041839,1672562546,1672565581,3035
3625,3435167810,3755848152,1672561303,1672563611,2308
3533,3512392431,3716272919,1672576642,1672578734,2092
3606,3436257398,3701005527,1672630961,1672633948,2987
3682,3487875183,3668747074,1672686261,1672687600,1339
3563,3554186380,3834631333,1672608470,1672610828,2358
3682,3776559988,3491469603,1672701120,1672703103,1983
3816,3456430614,3400763927,1672550417,1672552259,1842
3532,3511024016,3779646172,1672628786,1672632363,3577
3832,3347446226,3703396825,1672586884,1672588657,1773
3869,3770438122,3774733620,1672574650,1672576911,2261
3563,3925979970,3384068080,1672555875,1672556140,265
3754,3225636215,3902861231,1672621703,1672624438,2735
3438,3401940259,3927165965,1672657058,1672659097,2039
3793,3926643445,3512337405,1672637912,1672641353,3441
3553,3497808662,3271752081,1672584378,1672586921,2543
3871,3772078494,3439673892,1672633443,1672636803,3360
3695,3638204468,3431460073,1672634525,1672635579,1054
3537,3626499450,3776034743,1672696812,1672699618,2806
3853,3779465522,3897456874,1672664056,1672667437,3381
3717,3515401243,3738026330,1672657464,1672660052,2588
3578,3661903000,3399518841,1672654521,1672656354,1833
3871,3688796737,3457620713,1672580052,1672582211,2159
3452,3783771827,3500109249,1672632913,1672635790,2877
3517,3711637255,3487875183,1672535393,1672535499,106
3439,3713768950,3276003502,1672548097,1672549340,1243
3798,3514419100,3456430614,1672591443,1672594674,3231
3496,3505179890,3777694660,1672659520,1672662892,3372
3788,3347419520,3505228454,1672575526,1672577426,1900
3893,3492959689,3834631333,1672696611,1672699680,3069
3517,3933894942,3773027597,1672641679,1672643622,1943
3922,3774705415,3389634034,1672596015,1672596590,575
3566,3885155975,3401496246,1672543966,1672546442,2476
3571,3713589994,3605221116,1672537127,1672539249,2122
3484,3667673649,3815250107,1672594193,1672596497,2304
3717,3514971533,3770146716,1672643844,1672646011,2167
3598,3614740489,3772765746,1672618808,1672620409,1601
3913,3514512367,3780872464,1672556708,1672557458,750
3511,3807212280,3895285664,1672535665,1672538677,3012
3743,3807212280,3834960360,1672602520,1672604178,1658
3519,3294703680,3511288998,1672652795,1672655551,2756
3796,3713768950,3428027649,1672563512,1672567070,3558
3874,3776559988,3909094917,1672568790,1672571071,2281
3917,3534829213,3412968120,1672616895,1672619378,2483
3881,3284947372,3517991730,1672644361,1672647827,3466
3637,3376467719,3500604680,1672533834,1672534541,707
3894,3627368399,3715619259,1672690011,1672692449,2438
3621,3500072204,3714670620,1672695695,1672697204,1509
3711,3760040019,3500915908,1672564020,1672565811,1791
3627,3792745809,3505995057,1672564986,1672568547,3561
3496,3511150845,3533004959,1672686618,1672687231,613
3674,3803517637,3367509761,1672551083,1672552586,1503
3824,3780209375,3517687662,1672564050,1672566115,2065
3479,3850911686,3500672156,1672669158,1672669711,553
3842,3441348818,3229822507,1672600095,1672602890,2795
3480,3311049964,3713911104,1672569452,1672572815,3363
3524,3613899351,3773902805,1672632486,1672633915,1429
3649,3441348818,3449333754,1672557095,1672560085,2990
3640,3411688875,3928719932,1672608917,1672610663,1746
3699,3615688740,3409114719,1672602704,1672604298,1594
3727,3887243870,3774243020,1672639717,1672642291,2574
3915,3224968597,3780115155,1672620610,1672623533,2923
3653,3825881598,3513295938,1672563395,1672563713,318
3869,3516703758,3909094917,1672553134,1672556443,3309
3902,3619922891,3780322355,1672597882,1672599546,1664
3898,3631479562,3480490124,1672679839,1672682652,2813
3842,3500317969,3617392620,1672567624,1672567901,277
3886,3559458968,3372223551,1672680266,1672681750,1484
3727,3716963089,3920898925,1672576969,1672577474,505
3690,3685816610,3793969543,1672581570,1672582870,1300
3831,3621683102,3385323994,1672592207,1672594173,1966
3673,3438078818,3511150845,1672577112,1672577909,797
3880,3517358573,3755496114,1672588255,1672588929,674
3470,3688796737,3605221116,1672682285,1672685677,3392
3586,3756127300,3777189898,1672683978,1672685882,1904
3738,3500857494,3447514821,1672598401,1672599494,1093
3641,3938389661,3667673649,1672621073,1672624011,2938
3472,3773837847,3500317969,1672671487,1672674136,2649
3827,3334974375,3226511603,1672546210,1672548541,2331
3529,3733558985,3220031931,1672682972,1672683136,164
3693,3689114185,3927165965,1672607007,1672608570,1563
3772,3635169815,3512830734,1672609178,1672610948,1770
3446,3272030610,3534543776,1672639968,1672640079,111
3573,3701424609,3351696332,1672575398,1672578098,2700
3907,3622357348,3755532873,1672543122,1672544701,1579
3734,3516513251,3777091903,1672546691,1672549200,2509
3683,3446533960,3760924079,1672532432,1672532886,454
3550,3333918941,3776244398,1672697646,1672699296,1650
3661,3514308235,3311085279,1672634991,1672635230,239
3507,3509483172,3435167810,1672658181,1672660648,2467
3764,3401496246,3389634034,1672626765,1672628290,1525
3531,3431460073,3970909253,1672688900,1672690927,2027
3755,3680843171,3232208416,1672607558,1672608312,754
3432,3714666884,3511791953,1672604275,1672607141,2866
3732,3912891315,3682133690,1672581753,1672584939,3186
3678,3505283390,3296462324,1672545212,1672546076,864
3711,3770438122,3510767239,1672543934,1672546999,3065
3492,3500341755,3779786641,1672677121,1672679087,1966
3530,3441703884,3815392801,1672689710,1672691984,2274
3765,3938503547,3490214516,1672625943,1672627838,1895
3560,3421877923,3897435944,1672672042,1672675366,3324
3611,3756385685,3773121782,1672545260,1672546404,1144
3831,3511288998,3392836218,1672609715,1672611677,1962
3802,3618808151,3808136029,1672660649,1672661265,616
3836,3500613493,3512379024,1672622893,1672624613,1720
3759,3514741348,3238288884,1672681940,1672684572,2632
3654,3534829213,3852533643,1672625059,1672625468,409
3835,3410600350,3312998540,1672569088,1672570604,1516
3684,3793418209,3715443333,1672569135,1672570772,1637
3490,3299781901,3899786664,1672580064,1672581204,1140
3779,3770236215,3880926355,1672592552,1672594815,2263
3824,3225631197,3701322924,1672676476,1672677824,1348
3439,3511843593,3512337405,1672670798,1672672065,1267
3674,3818575661,3773837847,1672580569,1672581420,851
3722,3731646673,3757630221,1672692019,1672693022,1003
3543,3688490530,3514971533,1672608882,1672611120,2238
3560,3270042456,3631479562,1672600567,1672601766,1199
3550,3347446226,3900276517,1672615097,1672617639,2542
3654,3970558632,3408498208,1672565319,1672568445,3126
3789,3452016771,3714666884,1672565962,1672568351,2389
3501,3779465522,3509483172,1672663176,1672664770,1594
3485,3514956366,3812534508,1672554881,1672555401,520
3757,3779786641,3276217799,1672690758,1672693718,2960
3548,3619922891,3737972328,1672589176,1672590285,1109
3550,3739154408,3333918941,1672672441,1672673598,1157
3708,3760040019,3224811762,1672565351,1672566420,1069
3848,3441348818,3512946768,1672699248,1672701793,2545
3893,3791693821,3270042456,1672701229,1672702835,1606
3717,3610358027,3737147209,1672653408,1672654644,1236
3487,3228888030,3615115210,1672591525,1672592792,1267
3463,3271752081,3776831527,1672700273,1672702932,2659
3655,3520657891,3438489358,1672632445,1672635648,3203
3825,3824215187,3938389661,1672694260,1672697151,2891
3843,3225029895,3626499450,1672618564,1672620530,1966
3803,3280054198,3490029863,1672622477,1672624906,2429
3527,3889780657,3284932450,1672537484,1672541022,3538
3900,3334951866,3891672228,1672598555,1672599200,645
3593,3408430195,3272716462,1672567093,1672568679,1586
3904,3497671225,3618176292,1672618367,1672621846,3479
3516,3756474459,3294703680,1672547468,1672549160,1692
3610,3610870949,3627368399,1672625159,1672628071,2912
3494,3777091903,3533079336,1672626537,1672628176,1639
3897,3519087371,3398731252,1672644007,1672647584,3577
3906,3608922867,3229974066,1672644546,1672647515,2969
3440,3773837847,3379143440,1672608514,1672610500,1986
3773,3309314379,3505663516,1672595657,1672596076,419
3445,3636329663,3276003502,1672597904,1672598112,208
3672,3711077927,3360069849,1672559135,1672560166,1031
3478,3927599181,3417191856,1672620272,1672622862,2590
3749,3701136026,3792389522,1672553830,1672557035,3205
3453,3783641602,3791693821,1672563956,1672564790,834
3778,3713517039,3513360004,1672640233,1672640816,583
3921,3773027597,3710315160,1672669565,1672672130,2565
3729,3480100311,3334647380,1672600040,1672603113,3073
3458,3300229945,3760040019,1672694971,1672696380,1409
3913,3368283077,3815250107,1672598300,1672598707,407
3471,3514956366,3756385685,1672657192,1672657269,77
3744,3382733096,3757863420,1672541586,1672543760,2174
3885,3811075491,3360069849,1672564557,1672564831,274
3632,3305336154,3515401243,1672677644,1672678285,641
3882,3755404116,3510818674,1672677166,1672677323,157
3621,3900276517,3401496246,1672620503,1672623174,2671
3860,3701107228,3893912331,1672645304,1672646720,1416
3434,3739911441,3457620713,1672540472,1672540793,321
3454,3792801638,3226024417,1672555949,1672558610,2661
3550,3669146016,3382733096,1672543315,1672546372,3057
3520,3299443125,3715854030,1672575050,1672576834,1784
3720,3246370118,3664943873,1672548738,1672549657,919
3802,3511150845,3783147088,1672664213,1672665175,962
3647,3774155692,3556969573,1672559025,1672560341,1316
3910,3711077927,3470454332,1672550500,1672552174,1674
3843,3485540729,3770236215,1672655976,1672656897,921
3698,3500347447,3778597171,1672696680,1672698704,2024
3659,3904412440,3500709774,1672653954,1672656766,2812
3550,3424660806,3509483172,1672632220,1672635503,3283
3756,3686227677,3514512367,1672537977,1672540455,2478
3676,3777037426,3500857494,1672562229,1672563922,1693
3474,3551399764,3203538212,1672565770,1672567786,2016
3847,3517462308,3271752081,1672641425,1672642210,785
3769,3516321888,3618176292,1672588334,1672591092,2758
3761,3229822507,3710489491,1672629293,1672631736,2443
3776,3791436104,3512499658,1672588980,1672590879,1899
3433,3812534508,3368283077,1672614068,1672614734,666
3790,3680843171,3783136330,1672554457,1672556038,1581
3636,3517737088,3920625129,1672681936,1672682130,194
3910,3505807416,3533004959,1672568048,1672570438,2390
3467,3514419100,3814677862,1672544852,1672545279,427
3891,3492959689,3505178849,1672567246,1672569093,1847
3424,3480726047,3519446663,1672701101,1672702630,1529
3627,3755756564,3520991398,1672575825,1672578157,2332
3708,3500613459,3417191856,1672593749,1672595911,2162
3541,3755756564,3515401243,1672602103,1672602994,891
3844,3520181148,3715986185,1672539819,1672540286,467
3442,3638660068,3505434346,1672591108,1672594438,3330
3691,3305722859,3701884158,1672623996,1672625394,1398
3540,3755992176,3668747074,1672570417,1672573908,3491
3524,3208957949,3715854030,1672610099,1672612001,1902
3687,3415833929,3633735593,1672594530,1672596665,2135
3825,3394401087,3513041785,1672578150,1672578995,845
3598,3915162005,3617304541,1672698590,1672700279,1689
3767,3859868849,3208452238,1672547913,1672548878,965
3520,3703383853,3500672156,1672634938,1672635471,533
3603,3770468980,3755756564,1672686980,1672687937,957
3528,3639050419,3480490124,1672616536,1672616671,135
3729,3760721303,3793407963,1672606425,1672607763,1338
3809,3715127070,3791613604,1672548043,1672549302,1259
3846,3897456874,3279339278,1672700365,1672701090,725
3771,3791753345,3774178201,1672694643,1672695025,382
3815,3770236215,3736231757,1672545971,1672546494,523
3729,3970558632,3780253901,1672535285,1672535460,175
3630,3551399764,3236499444,1672601437,1672604259,2822
3470,3783373154,3608232640,1672548958,1672549555,597
3850,3615688740,3773913680,1672565236,1672566959,1723
3907,3533649454,3517222913,1672578779,1672580212,1433
3761,3559731671,3386758279,1672673772,1672675559,1787
3561,3778926763,3613581796,1672589092,1672591631,2539
3751,3607882826,3802932312,1672564456,1672566706,2250
3656,3505663516,3248058676,1672551376,1672553504,2128
3451,3792072681,3441703884,1672597884,1672601470,3586
3867,3780769110,3715545685,1672536976,1672537468,492
3482,3777624586,3497095254,1672544524,1672544896,372
3424,3480726047,3604867757,1672544379,1672545253,874
3431,3710562338,3289817992,1672531242,1672534171,2929
3616,3461119815,3783340788,1672688251,1672691675,3424
3486,3294747828,3289817992,1672629071,1672631713,2642
3592,3756127300,3202141727,1672647389,1672648678,1289
3587,3511288998,3514956366,1672586312,1672586911,599
3568,3276269264,3626499450,1672610400,1672610910,510
3818,3916490839,3208452238,1672588545,1672589102,557
3895,3201629017,3755848152,1672569634,1672572021,2387
3724,3682133690,3534566651,1672543684,1672545418,1734
3788,3518653080,3385323994,1672617317,1672620449,3132
3699,3928719932,3807212280,1672652310,1672655887,3577
3683,3500737582,3457620713,1672599370,1672600628,1258
3696,3515525630,3932478321,1672661808,1672663205,1397
3881,3932478321,3505154885,1672645716,1672648406,2690
3828,3971806004,3916490839,1672605196,1672608618,3422
3871,3512800570,3716963089,1672586014,1672586186,172
3918,3814677862,3715086894,1672536559,1672539533,2974
3748,3515559913,3730071479,1672592222,1672593822,1600
3551,3777624586,3500341755,1672539578,1672542350,2772
3723,3300818269,3815250107,1672646665,1672649625,2960
3507,3505434346,3714128600,1672688283,1672688983,700
3877,3609933747,3511732493,1672692668,1672695808,3140
3508,3370227921,3368283077,1672670020,1672672749,2729
3531,3435116799,3902861231,1672553154,1672553617,463
3625,3469254160,3926643445,1672575900,1672577803,1903
3699,3510499038,3755532873,1672604483,1672605953,1470
3776,3792949946,3792505974,1672564852,1672564935,83
3686,3715400486,3512882178,1672690614,1672693630,3016
3904,3620292035,3229974066,1672568606,1672569768,1162
3780,3311085279,3517687662,1672625662,1672627796,2134
3540,3715385401,3701424609,1672587090,1672590264,3174
3528,3338083680,3335694356,1672643830,1672644944,1114
3565,3201629017,3468041839,1672568027,1672569655,1628
3503,3733363628,3778040015,1672638356,1672638781,425
3746,3776034743,3510187271,1672612956,1672615146,2190
3569,3248058676,3298151889,1672583403,1672584827,1424
3731,3225636215,3392520516,1672628207,1672630149,1942
3683,3617304541,3518229776,1672648664,1672650229,1565
3666,3274831810,3815250107,1672630517,1672631062,545
3573,3512337405,3783136330,1672591617,1672593842,2225
3632,3779613523,3511791953,1672620651,1672623092,2441
3853,3688796737,3428027649,1672686982,1672690264,3282
3709,3975717896,3428725843,1672689948,1672691509,1561
3589,3979802715,3392520516,1672615010,1672615931,921
3743,3343816795,3436257398,1672533742,1672534204,462
3865,3814677862,3779646172,1672579740,1672582943,3203
3438,3792020993,3777624586,1672538442,1672539716,1274
3850,3669146016,3615115210,1672697691,1672701151,3460
3450,3783147088,3435167810,1672531549,1672535065,3516
3621,3774790271,3398731252,1672645687,1672646003,316
3810,3399518841,3513410578,1672539364,1672542720,3356
3844,3382733096,3533929349,1672701036,1672702159,1123
3480,3920898925,3336627643,1672532507,1672532916,409
3856,3384068080,3351696332,1672628259,1672629739,1480
3641,3632814465,3451326054,1672672383,1672672447,64
3894,3500949309,3514324011,1672654889,1672656497,1608
3751,3778926763,3604589802,1672550870,1672554160,3290
3473,3505179890,3618354185,1672679424,1672680735,1311
3449,3615688740,3334974375,1672648907,1672651940,3033
3469,3284932450,3229974066,1672533087,1672536081,2994
3737,3556969573,3755496114,1672618976,1672620903,1927
3724,3276348699,3515401243,1672686802,1672689041,2239
3479,3778899160,3772765746,1672687071,1672688926,1855
3857,3821054646,3701107228,1672611545,1672612006,461
3629,3793868716,3733363628,1672596137,1672597810,1673
3901,3776559988,3500072204,1672683942,1672684843,901
3654,3760842815,3519282716,1672658139,1672659695,1556
3842,3755222916,3520181148,1672650903,1672652325,1422
3640,3410538749,3701823816,1672601638,1672603587,1949
3503,3462273042,3885537225,1672692326,1672692393,67
3858,3308760650,3791693821,1672656313,1672659253,2940
3799,3511601997,3230135532,1672547968,1672550360,2392
3660,3916490839,3783550022,1672684091,1672685944,1853
3882,3505725706,3519282716,1672566175,1672569529,3354
3761,3632814465,3780253901,1672682385,1672683358,973
3729,3412968120,3316800320,1672591370,1672593211,1841
3443,3272716462,3490029863,1672703139,1672705081,1942
3809,3389634034,3757700712,1672644959,1672648005,3046
3471,3512800570,3513081354,1672581126,1672582282,1156
3592,3774705415,3510641433,1672593832,1672595604,1772
3777,3684523966,3411688875,1672568509,1672569237,728
3867,3979802715,3713589994,1672592920,1672594097,1177
3808,3511317276,3600876425,1672579004,1672579282,278
3667,3457960571,3224811762,1672664587,1672665980,1393
3875,3800257590,3701424609,1672650502,1672651262,760
3888,3714120857,3889780657,1672699933,1672701336,1403
3806,3780427126,3505266860,1672634042,1672636497,2455
3799,3622665543,3631090677,1672624892,1672628461,3569
3518,3755233658,3736705719,1672692184,1672692703,519
3535,3510028805,3501215099,1672547415,1672550040,2625
3731,3449639012,3228888030,1672665664,1672666167,503
3645,3241790910,3517600136,1672555032,1672556931,1899
3856,3205985903,3904412440,1672636905,1672637843,938
3604,3229822507,3859868849,1672632272,1672634012,1740
3678,3450969839,3703139663,1672582190,1672582837,647
3754,3714678331,3534175249,1672540459,1672541485,1026
3602,3512295534,3559731671,1672580310,1672581009,699
3506,3780769110,3509756823,1672666728,1672667032,304
3463,3248058676,3757075324,1672582566,1672582800,234
3850,3609933747,3511601997,1672613260,1672614596,1336
3759,3701107228,3336627643,1672611123,1672613915,2792
3796,3500827202,3685816610,1672638057,1672640362,2305
3638,3451691949,3516444201,1672656310,1672658060,1750
3475,3600876425,3716272919,1672598742,1672601131,2389
3750,3438489358,3510028805,1672665303,1672668754,3451
3788,3624297844,3776831527,1672604824,1672605427,603
3693,3755496114,3516703758,1672662517,1672664156,1639
3604,3276348699,3384583385,1672689923,1672690886,963
3535,3680810086,3756385685,1672544322,1672544913,591
3569,3639050419,3710048469,1672552110,1672554039,1929
3596,3756789525,3519142371,1672561622,1672563477,1855
3667,3309314379,3829822608,1672540535,1672541519,984
3448,3363162590,3773902805,1672662896,1672663766,870
3560,3713561276,3780872464,1672552649,1672553853,1204
3871,3715086894,3792949946,1672665124,1672665619,495
3572,3513295938,3824641227,1672583734,1672584050,316
3593,3615939504,3350095157,1672559782,1672560686,904
3447,3500949309,3756127300,1672594190,1672597506,3316
3875,3383138270,3885155975,1672700935,1672704328,3393
3617,3451726367,3517590837,1672595982,1672597414,1432
3881,3938503547,3455018347,1672587336,1672588049,713
3781,3661583097,3716963089,1672573942,1672575413,1471
3696,3760094385,3519077659,1672597463,1672599866,2403
3487,3512392431,3774178201,1672604859,1672608319,3460
3822,3639050419,3457960571,1672614686,1672616506,1820
3917,3480991549,3497808662,1672594115,1672595277,1162
3637,3829822608,3713784974,1672549536,1672550682,1146
3722,3920497528,3667427125,1672531644,1672531833,189
3647,3335694356,3404025196,1672688820,1672690514,1694
3822,3835422146,3505847380,1672583726,1672585470,1744
3531,3229974066,3899326793,1672541960,1672544698,2738
3912,3772236797,3792274796,1672641355,1672643951,2596
3432,3800257590,3713829743,1672605074,1672607222,2148
3664,3364726656,3510767239,1672574353,1672576420,2067
3896,3715707380,3410538749,1672611315,1672614110,2795
3818,3519446663,3631479562,1672576115,1672579429,3314
3632,3617304541,3226024417,1672599519,1672602083,2564
3643,3938503547,3733558985,1672657271,1672658075,804
3896,3703383853,3505437712,1672588292,1672590506,2214
3803,3792801638,3713768950,1672689290,1672692073,2783
3591,3755915206,3617116290,1672535353,1672538442,3089
3679,3920898925,3372223551,1672564993,1672568153,3160
3467,3556969573,3818575661,1672595298,1672597577,2279
3476,3514285803,3880926355,1672615633,1672615797,164
3491,3779438325,3757332128,1672593015,1672595394,2379
3741,3773735484,3441703884,1672698923,1672700734,1811
3710,3428027649,3817428320,1672650021,1672650469,448
3557,3793935736,3733558985,1672543265,1672545188,1923
3759,3368283077,3793740407,1672590087,1672592032,1945
3600,3519651506,3516444201,1672687382,1672687781,399
3784,3514308235,3793969543,1672634853,1672636386,1533
3612,3774907131,3360069849,1672591464,1672591831,367
3885,3716679950,3396980894,1672574395,1672575653,1258
3666,3760651515,3392520516,1672566371,1672569724,3353
3482,3617304541,3505521218,1672607230,1672610487,3257
3738,3660063072,3294747828,1672610028,1672612061,2033
3446,3773572967,3305722859,1672630277,1672631012,735
3576,3534179433,3376467719,1672674915,1672675566,651
3709,3514246749,3462158237,1672540434,1672540563,129
3428,3551376095,3792546035,1672556264,1672556645,381
3781,3337362061,3739661856,1672669547,1672670890,1343
3778,3520639768,3309314379,1672631769,1672633383,1614
3577,3713979100,3299125059,1672613525,1672613977,452
3754,3490214516,3793418209,1672541597,1672543242,1645
3903,3613206049,3773121782,1672646970,1672649786,2816
3899,3514512367,3608922867,1672653609,1672654371,762
3841,3792546035,3447672935,1672560955,1672561260,305
3717,3853629553,3500709774,1672642215,1672645500,3285
3434,3780209375,3774907131,1672630275,1672631185,910
3887,3350095157,3230868435,1672534019,1672536041,2022
3873,3756704774,3467779445,1672674467,1672677870,3403
3843,3283492940,3512722110,1672622246,1672624748,2502
3785,3885121158,3773735484,1672688868,1672691933,3065
3917,3793418209,3428725843,1672662283,1672664756,2473
3445,3895285664,3773027597,1672639694,1672640940,1246
3719,3777330107,3856606678,1672680477,1672683472,2995
3435,3519416013,3757075324,1672552114,1672554085,1971
3677,3510919821,3383138270,1672665713,1672667543,1830
3753,3349856820,3518565331,1672571876,1672574936,3060
3547,3793868716,3283492940,1672566806,1672569290,2484
3460,3517358573,3714670620,1672697541,1672699570,2029
3463,3756746867,3364726656,1672574698,1672576025,1327
3677,3505888598,3756385685,1672562051,1672563375,1324
3882,3635169815,3770438122,1672554280,1672554909,629
3608,3500777439,3519651506,1672628622,1672629190,568
3786,3783615982,3734915241,1672692536,1672694483,1947
3620,3817813340,3609933747,1672651257,1672651823,566
3432,3285204083,3520764926,1672584517,1672586119,1602
3909,3394297564,3362641275,1672698374,1672701111,2737
3766,3756789525,3755496114,1672606848,1672607840,992
3478,3783615982,3780209375,1672605724,1672606318,594
3448,3791106564,3519142371,1672686791,1672688549,1758
3495,3668533536,3668533536,1672537611,1672538113,502
3467,3613338363,3680810086,1672671561,1672674569,3008
3580,3710489491,3895285664,1672576169,1672577353,1184
3686,3519651506,3515890966,1672537026,1672538039,1013
3543,3450286949,3428725843,1672603188,1672604467,1279
3582,3534175249,3514285803,1672549396,1672551749,2353
3567,3783771827,3294703680,1672582291,1672585292,3001
3564,3770146716,3615688740,1672663247,1672664254,1007
3702,3938503547,3715974659,1672556316,1672559047,2731
3833,3412006598,3897435944,1672636926,1672639142,2216
3910,3770704999,3853629553,1672578812,1672580191,1379
3814,3770468980,3774718695,1672538167,1672540921,2754
3511,3734118023,3512383699,1672696794,1672700258,3464
3738,3510642075,3446533960,1672542920,1672546167,3247
3649,3792072681,3357289672,1672680605,1672681427,822
3519,3774178201,3621683102,1672618178,1672621383,3205
3638,3220031931,3520873221,1672540797,1672543657,2860
3540,3701823816,3238288884,1672644032,1672646189,2157
3451,3814305099,3512383699,1672621421,1672622601,1180
3805,3480490124,3404025196,1672576626,1672579178,2552
3774,3421385957,3518194482,1672694628,1672697580,2952
3520,3891672228,3519416013,1672614834,1672618099,3265
3480,3970603231,3780338697,1672671747,1672673419,1672
3776,3230868435,3772078494,1672675215,1672677873,2658
3492,3375449013,3710562338,1672579226,1672580512,1286
3897,3505198734,3779854934,1672563019,1672566542,3523
3429,3379143440,3772236797,1672559909,1672562664,2755
3843,3520322124,3689114185,1672606249,1672606998,749
3585,3773939399,3343816795,1672657555,1672660001,2446
3613,3777091903,3774718695,1672625882,1672627610,1728
3439,3517222913,3858172636,1672585991,1672586568,577
3438,3418448389,3757332128,1672531380,1672533100,1720
3481,3468041839,3757193551,1672700467,1672703648,3181
3694,3334647380,3779854934,1672562558,1672565019,2461
3437,3492959689,3505663516,1672568797,1672570262,1465
3816,3533929349,3452016771,1672678224,1672680387,2163
3477,3776518452,3665998641,1672565089,1672567607,2518
3908,3517590837,3403370192,1672583029,1672585192,2163
3618,3730071479,3304971369,1672684916,1672686147,1231
3453,3777189898,3534764451,1672583039,1672585381,2342
3875,3667673649,3505198734,1672591652,1672591748,96
3647,3393063657,3343132529,1672613237,1672616063,2826
3579,3203538212,3514703118,1672679256,1672681622,2366
3687,3613416045,3206837348,1672648136,1672648570,434
3734,3459681410,3715974659,1672697017,1672700578,3561
3563,3490029863,3921648519,1672637848,1672640255,2407
3596,3514275974,3902760230,1672613906,1672614625,719
3758,3421385957,3232208416,1672551974,1672554753,2779
3886,3730071479,3510641433,1672701238,1672701531,293
3817,3505481368,3449639012,1672667276,1672668139,863
3747,3852533643,3505178849,1672607115,1672610538,3423
3679,3791106564,3777624586,1672589142,1672592475,3333
3692,3456430614,3517991730,1672686142,1672687241,1099
3695,3792274796,3517600136,1672639181,1672641752,2571
3724,3354144091,3779301501,1672595380,1672596927,1547
3679,3517687662,3514419100,1672674182,1672677348,3166
3795,3455018347,3793583656,1672664093,1672666525,2432
3721,3371455553,3336339664,1672538203,1672539317,1114
3511,3688796737,3500827202,1672684339,1672687616,3277
3866,3440107959,3514512367,1672591974,1672593997,2023
3483,3514703118,3500072204,1672567108,1672570690,3582
3448,3778926763,3416987084,1672588651,1672589170,519
3864,3716628503,3511288998,1672691418,1672693288,1870
3617,3311085279,3289817992,1672689296,1672689534,238
3810,3715086894,3449639012,1672683528,1672685972,2444
3529,3554944414,3630353876,1672654461,1672656377,1916
3568,3970627281,3779425804,1672551259,1672553275,2016
3609,3715400486,3776084820,1672670150,1672670570,420
3604,3505154885,3972192593,1672610631,1672614003,3372
3737,3517991730,3703139663,1672646286,1672649725,3439
3541,3792745809,3424445495,1672699174,1672699315,141
3473,3773033649,3715854030,1672662929,1672664485,1556
3912,3814677862,3755756564,1672602175,1672604866,2691
3674,3713979100,3512383699,1672562193,1672562962,769
3735,3208452238,3360069849,1672619773,1672620206,433
3820,3618489670,3779656423,1672652385,1672654586,2201
3535,3714233826,3462636434,1672673965,1672677366,3401
3628,3755573472,3511732493,1672621775,1672622558,783
3609,3792546035,3760094385,1672634552,1672635734,1182
3654,3510642075,3777330107,1672561930,1672562731,801
3677,3739911441,3680810086,1672576790,1672577807,1017
3679,3337322736,3460719322,1672540424,1672543725,3301
3474,3713589994,3774641380,1672603297,1672603841,544
3776,3793743698,3613581796,1672692825,1672695674,2849
3632,3493017654,3229822507,1672669348,1672672908,3560
3548,3280054198,3270056120,1672575605,1672578870,3265
3501,3732131656,3500777439,1672664983,1672667268,2285
3838,3772765746,3319167958,1672662754,1672663150,396
3802,3979802715,3617489344,1672694489,1672695712,1223
3586,3834631333,3510642075,1672633356,1672634020,664
3452,3932478321,3429943738,1672621898,1672624759,2861
3830,3480100311,3274906650,1672663212,1672663354,142
3588,3201629017,3343816795,1672567227,1672569313,2086
3517,3617392620,3850911686,1672565786,1672567345,1559
3539,3793407963,3373089838,1672590808,1672592310,1502
3607,3757863420,3661447322,1672585068,1672587116,2048
3617,3519818818,3559731671,1672703799,1672705826,2027
3788,3783147088,3892304880,1672606772,1672609149,2377
3717,3533188828,3755344363,1672619369,1672622331,2962
3460,3200543880,3338390596,1672546052,1672547428,1376
3474,3241914067,3491684096,1672637962,1672641315,3353
3786,3364726656,3710562338,1672543071,1672545686,2615
3652,3501525100,3404025196,1672552881,1672556440,3559
3557,3511791953,3511732493,1672558454,1672561855,3401
3489,3202141727,3364726656,1672657215,1672658694,1479
3818,3272096759,3500613459,1672612575,1672615488,2913
3700,3519818818,3436257398,1672582266,1672585120,2854
3460,3715385401,3513065217,1672636145,1672638356,2211
3774,3923220461,3411515369,1672652171,1672655398,3227
3437,3232208416,3779465522,1672545918,1672548404,2486
3707,3711077927,3450286949,1672614789,1672615433,644
3574,3501281016,3639050419,1672535702,1672537421,1719
3571,3686227677,3479851674,1672660944,1672664428,3484
3887,3357689359,3490214516,1672564813,1672566468,1655
3780,3500915665,3856606678,1672532415,1672532669,254
3828,3520560590,3829822608,1672630078,1672631659,1581
3800,3514741348,3927165965,1672669504,1672670251,747
3491,3514324011,3783801141,1672670513,1672672274,1761
3480,3711097754,3334993594,1672581321,1672581417,96
3684,3831586487,3500317969,1672627150,1672627442,292
3744,3424445495,3773121782,1672667755,1672670490,2735
3632,3299125059,3309314379,1672671643,1672674371,2728
3758,3682133690,3779532653,1672537804,1672537968,164
3591,3713784974,3885155975,1672595217,1672595603,386
3684,3534126409,3441348818,1672682985,1672684371,1386
3533,3783771827,3300979975,1672601420,1672604965,3545
3871,3500915908,3336627643,1672684287,1672685355,1068
3801,3716110860,3716628503,1672650330,1672653927,3597
3722,3793407963,3500949309,1672589856,1672592481,2625
3683,3615087943,3512295534,1672666939,1672667644,705
3881,3479851674,3337322736,1672565877,1672566168,291
3719,3206837348,3469254160,1672653046,1672656136,3090
3912,3380982774,3637313265,1672659798,1672661340,1542
3677,3309314379,3379143440,1672665197,1672666885,1688
3579,3512392431,3773121782,1672664093,1672666055,1962
3577,3814305099,3470454332,1672645935,1672647314,1379
3711,3660887799,3779532653,1672577290,1672580215,2925
3510,3500072204,3783641602,1672667852,1672670551,2699
3781,3308760650,3618176292,1672683149,1672685612,2463
3704,3505154885,3455018347,1672686709,1672688303,1594
3753,3283144118,3304971369,1672644726,1672646763,2037
3756,3514334067,3853629553,1672548712,1672551520,2808
3553,3716272919,3517358573,1672589477,1672590286,809
3565,3819767045,3972192593,1672593236,1672594160,924
3680,3617304541,3501567772,1672674704,1672677337,2633
3772,3733558985,3779639983,1672561070,1672563324,2254
3665,3225029895,3801645328,1672667250,1672670096,2846
3486,3299443125,3534357694,1672702423,1672705541,3118
3815,3500949309,3319167958,1672640064,1672642241,2177
3698,3732584121,3686523546,1672535682,1672538475,2793
3723,3509893027,3208452238,1672695753,1672699228,3475
3672,3701664364,3231494505,1672699251,1672701757,2506
3577,3777037426,3501215099,1672671178,1672673117,1939
3876,3774290799,3779465522,1672586241,1672586757,516
3890,3200308999,3516298579,1672554900,1672556697,1797
3896,3373028638,3925979970,1672657777,1672660414,2637
3805,3792745809,3306412634,1672680802,1672681690,888
3903,3793407963,3701424609,1672600124,1672600688,564
3628,3610870949,3518565331,1672665664,1672667478,1814
3871,3392943173,3778040015,1672673887,1672677279,3392
3868,3518565331,3777037426,1672663621,1672666279,2658
3508,3401793306,3713784974,1672644990,1672648047,3057
3625,3208452238,3428725843,1672606596,1672607473,877
3488,3835985172,3935487534,1672546584,1672548358,1774
3706,3792505974,3513545422,1672532531,1672534128,1597
3870,3807212280,3760094385,1672544800,1672545687,887
3899,3755344363,3710489491,1672574302,1672577194,2892
3504,3780338697,3776244398,1672602967,1672605790,2823
3784,3509366311,3669146016,1672583020,1672585183,2163
3651,3208957949,3609933747,1672536584,1672538208,1624
3918,3779465522,3779892400,1672679181,1672682637,3456
3537,3714666884,3279242917,1672637494,1672639456,1962
3823,3380130228,3294703680,1672647661,1672647735,74
3550,3517590837,3791796585,1672597696,1672599354,1658
3802,3756704774,3463740710,1672532740,1672533787,1047
3643,3701322924,3668747074,1672539771,1672541577,1806
3912,3316800320,3511442562,1672586039,1672589558,3519
3500,3497671225,3341893384,1672681571,1672682686,1115
3911,3757323954,3511843593,1672677126,1672679324,2198
3447,3938503547,3510964997,1672540958,1672542171,1213
3586,3604867757,3505228454,1672683698,1672683972,274
3527,3770520359,3304155815,1672578669,1672581637,2968
3672,3308760650,3463740710,1672593692,1672594910,1218
3654,3811040565,3791613604,1672630627,1672630956,329
3621,3710489491,3615115210,1672583679,1672584294,615
3665,3510919821,3711637255,1672672333,1672675031,2698
3771,3409114719,3554186380,1672587258,1672590251,2993
3622,3610870949,3367509761,1672642380,1672645320,2940
3630,3510499038,3757294769,1672574183,1672574802,619
3637,3514285803,3778926763,1672658038,1672659830,1792
3802,3238288884,3760694096,1672559767,1672560162,395
3701,3554825448,3517288083,1672539564,1672542391,2827
3584,3414049538,3308760650,1672534040,1672535241,1201
3674,3515402792,3773033649,1672571315,1672572391,1076
3887,3615737355,3241790910,1672668067,1672671591,3524
3879,3825881598,3505228454,1672557130,1672558842,1712
3433,3373089838,3517590837,1672635533,1672636876,1343
3913,3777037426,3341893384,1672614769,1672615149,380
3697,3774907131,3241914067,1672550461,1672551420,959
3621,3773572967,3239617320,1672553573,1672554390,817
3464,3884596900,3772391882,1672684321,1672685009,688
3536,3488763230,3607882826,1672582762,1672583715,953
3505,3780769110,3401793306,1672636480,1672639749,3269
3855,3780338697,3928719932,1672613376,1672616171,2795
3823,3715986185,3938503547,1672693410,1672694185,775
3488,3509366311,3618354185,1672645044,1672647150,2106
3709,3515890966,3428725843,1672677265,1672679898,2633
3598,3625174002,3780872464,1672574184,1672576280,2096
3546,3491684096,3818575661,1672697842,1672700675,2833
3477,3438078818,3932478321,1672689138,1672690099,961
3826,3923420131,3824641227,1672623054,1672623307,253
3622,3520657891,3715443333,1672598890,1672600912,2022
3651,3514956366,3500827202,1672538317,1672538499,182
3584,3792745809,3902760230,1672638901,1672640773,1872
3617,3631090677,3239617320,1672619595,1672622544,2949
3918,3776034743,3467779445,1672613342,1672616073,2731
3502,3519282716,3517590837,1672542192,1672545637,3445
3693,3392520516,3760924079,1672666457,1672666937,480
3466,3756789525,3776988674,1672554861,1672556920,2059
3654,3533747868,3757193551,1672679206,1672680019,813
3790,3778667336,3688490530,1672538926,1672539259,333
3483,3514308235,3637313265,1672654991,1672656396,1405
3836,3897456874,3206837348,1672641514,1672642449,935
3784,3227799827,3515401243,1672584487,1672585158,671
3818,3517288083,3770236215,1672546273,1672547907,1634
3527,3382733096,3773121782,1672616600,1672619254,2654
3777,3236354255,3510837901,1672700410,1672701768,1358
3438,3390660440,3337322736,1672565586,1672566414,828
3776,3737147209,3905196766,1672647993,1672650127,2134
3815,3319167958,3778667336,1672647548,1672648958,1410
3599,3638204468,3757903168,1672583247,1672585435,2188
3460,3272096759,3334993594,1672595397,1672598180,2783
3518,3394401087,3927403123,1672658198,1672658924,726
3917,3534179433,3701005527,1672586700,1672588707,2007
3694,3417679834,3756474459,1672624318,1672624396,78
3796,3755532873,3520181148,1672539840,1672542504,2664
3691,3778926763,3779425804,1672591790,1672593919,2129
3532,3276269264,3390660440,1672670676,1672672604,1928
3767,3935913584,3533649454,1672624465,1672627718,3253
3661,3379143440,3834963772,1672670859,1672672020,1161
3849,3793868716,3803517637,1672652651,1672654640,1989
3887,3783801141,3829822608,1672644391,1672646601,2210
3845,3500613493,3756789525,1672564649,1672566597,1948
3910,3294747828,3852533643,1672589375,1672589515,140
3884,3497808662,3734915241,1672609264,1672609398,134
3757,3411515369,3777330107,1672675720,1672679024,3304
3907,3711000597,3730071479,1672642268,1672645672,3404
3620,3394297564,3755065949,1672577482,1672580496,3014
3864,3755532873,3620292035,1672662461,1672663408,947
3574,3755233658,3711000597,1672608535,1672610624,2089
3688,3520657891,3900945856,1672648577,1672649861,1284
3918,3803389195,3920625129,1672611974,1672614610,2636
3877,3225029895,3618697021,1672570529,1672571653,1124
3489,3401940259,3513018485,1672532095,1672533679,1584
3527,3299125059,3773939399,1672701402,1672701664,262
3551,3390660440,3505178849,1672541145,1672542906,1761
3711,3710735406,3855583256,1672614157,1672615164,1007
3491,3510499038,3380982774,1672659420,1672662682,3262
3663,3714666884,3357864626,1672582045,1672583398,1353
3644,3608855425,3609881958,1672591195,1672593744,2549
3453,3396980894,3933894942,1672574469,1672576404,1935
3494,3467779445,3505634634,1672578485,1672578692,207
3446,3338390596,3435167810,1672569613,1672569690,77
3818,3224968597,3366423342,1672685415,1672688388,2973
3430,3688220326,3774243020,1672612500,1672615157,2657
3653,3519282716,3833217041,1672697626,1672698789,1163
3456,3757193551,3608232640,1672634696,1672636715,2019
3769,3618489670,3467988782,1672604453,1672606999,2546
3873,3304971369,3375449013,1672596564,1672598804,2240
3513,3443357683,3371455553,1672554441,1672555944,1503
3585,3770438122,3454277788,1672614918,1672615186,268
3795,3431502855,3274831810,1672644708,1672648211,3503
3679,3711097754,3774031303,1672562992,1672563891,899
3846,3977352557,3230135532,1672549947,1672552935,2988
3817,3773735484,3454277788,1672548627,1672550737,2110
3699,3757332128,3621790707,1672700996,1672703166,2170
3471,3488763230,3711097754,1672669538,1672671557,2019
3595,3514324011,3834960360,1672591612,1672591990,378
3749,3637313265,3534764451,1672688295,1672689948,1653
3807,3511883730,3517991730,1672667965,1672671526,3561
3541,3554825448,3823084403,1672690187,1672690280,93
3467,3823084403,3505725706,1672545760,1672546801,1041
3612,3770296583,3778667336,1672702474,1672704662,2188
3838,3288224595,3703139663,1672646166,1672646284,118
3769,3783163143,3783801141,1672689211,1672689886,675
3638,3372223551,3415833929,1672657507,1672661022,3515
3692,3492959689,3380982774,1672658992,1672661442,2450
3742,3792538417,3821054646,1672620393,1672621311,918
3790,3793175445,3783147088,1672570712,1672573440,2728
3920,3500777439,3513296868,1672675057,1672676137,1080
3895,3617304541,3621461051,1672554572,1672556489,1917
3523,3375449013,3772391882,1672640130,1672642741,2611
3611,3621184108,3200543880,1672531349,1672533618,2269
3762,3711000597,3703348097,1672553852,1672555703,1851
3612,3792538417,3485540729,1672656570,1672659224,2654
3878,3682133690,3715619259,1672596141,1672596826,685
3837,3404025196,3774243020,1672563942,1672566140,2198
3717,3685681577,3209526819,1672693985,1672696193,2208
3488,3201629017,3778134418,1672625158,1672628291,3133
3672,3668414677,3334951866,1672682718,1672684631,1913
3628,3638204468,3757193307,1672648796,1672649653,857
3573,3551389192,3935487534,1672668778,1672669647,869
3669,3779465522,3311049964,1672622272,1672623286,1014
3902,3858172636,3513410578,1672534601,1672536649,2048
3558,3449333754,3711853996,1672580846,1672581601,755
3551,3760640999,3409114719,1672535539,1672537842,2303
3612,3505283390,3351866415,1672658408,1672661371,2963
3636,3626499450,3533079336,1672562131,1672563627,1496
3806,3415833929,3349739136,1672628872,1672632183,3311
3444,3311049964,3460719322,1672597210,1672600682,3472
3428,3490214516,3520764926,1672588870,1672590282,1412
3610,3534175249,3240394404,1672579426,1672579551,125
3804,3853629553,3512282789,1672636405,1672636617,212
3694,3618808151,3311420950,1672558395,1672561439,3044
3854,3777189898,3294703680,1672531667,1672535030,3363
3726,3621461051,3701823816,1672611414,1672612203,789
3741,3500109249,3739154408,1672635679,1672638507,2828
3817,3509366311,3853629553,1672549038,1672551942,2904
3776,3774705415,3513327337,1672575335,1672576901,1566
3908,3618808151,3512800570,1672652278,1672653745,1467
3495,3533228966,3900945856,1672624466,1672627679,3213
3509,3424660806,3311420950,1672638037,1672638743,706
3779,3209481722,3783136330,1672657689,1672661142,3453
3651,3701882224,3370227921,1672542213,1672543152,939
3502,3357689359,3439673892,1672641457,1672644955,3498
3437,3710048469,3515890966,1672683831,1672684261,430
3562,3661583097,3668533536,1672580128,1672580273,145
3879,3617392620,3554825448,1672546983,1672548750,1767
3565,3491469603,3229822507,1672554258,1672557274,3016
3654,3226511603,3711006062,1672598689,1672599057,368
3592,3826238375,3288224595,1672643398,1672646972,3574
3758,3713589994,3703798634,1672615571,1672616364,793
3593,3685681577,3520355798,1672697355,1672698458,1103
3912,3829822608,3885157459,1672585115,1672586451,1336
3827,3756474459,3778134418,1672625637,1672628096,2459
3757,3660063072,3491684096,1672609939,1672610073,134
3876,3382733096,3713300120,1672554029,1672557360,3331
3891,3772236797,3618354185,1672614623,1672614757,134
3724,3610358027,3904867554,1672596465,1672598369,1904
3489,3760694096,3617489344,1672684502,1672687079,2577
3762,3792525861,3357289672,1672533927,1672537235,3308
3847,3390660440,3412968120,1672656576,1672658260,1684
3443,3773572967,3516321888,1672574999,1672576058,1059
3653,3511288998,3288224595,1672666239,1672667585,1346
3900,3516703758,3203538212,1672649088,1672652083,2995
3843,3500604680,3777694660,1672672547,1672675765,3218
3683,3291933594,3777779869,1672583789,1672585524,1735
3441,3513041785,3773009828,1672541322,1672542599,1277
3567,3367509761,3517887477,1672680177,1672682972,2795
3469,3773572967,3367111751,1672644620,1672648044,3424
3575,3300511067,3488686442,1672557627,1672560737,3110
3500,3461119815,3505178849,1672596352,1672596812,460
3514,3516741440,3703798634,1672588575,1672591412,2837
3549,3518565331,3271454397,1672665572,1672668813,3241
3918,3493017654,3398198430,1672697817,1672701410,3593
3917,3971806004,3900898992,1672542498,1672543750,1252
3509,3500498112,3668414677,1672694414,1672697567,3153
3738,3713829743,3384068080,1672593384,1672593956,572
3618,3895285664,3383138270,1672693926,1672694109,183
3566,3435167810,3714233826,1672682672,1672685918,3246
3551,3891672228,3513545422,1672619766,1672622884,3118
3888,3480490124,3777485931,1672540351,1672540906,555
3558,3773121782,3300511067,1672534606,1672535665,1059
3608,3617392620,3623266256,1672572945,1672574005,1060
3769,3899786664,3895285664,1672568930,1672571180,2250
3886,3783147088,3713784974,1672703034,1672706241,3207
3860,3424660806,3349856820,1672569494,1672570003,509
3630,3341893384,3756704774,1672678389,1672681853,3464
3477,3756625818,3510028805,1672553855,1672555782,1927
3505,3354144091,3715086894,1672662118,1672663291,1173
3447,3467988782,3431502855,1672648322,1672651202,2880
3550,3505847380,3885121158,1672621456,1672624102,2646
3472,3510964997,3834960360,1672641702,1672642871,1169
3902,3238288884,3760640999,1672616160,1672618006,1846
3799,3316798920,3468041839,1672635907,1672637547,1640
3889,3500915665,3730071479,1672672769,1672676064,3295
3440,3714128600,3408430195,1672656587,1672659716,3129
3610,3760842815,3357289672,1672686889,1672689946,3057
3456,3501786419,3824215187,1672693879,1672697047,3168
3487,3780472203,3715854030,1672536353,1672536762,409
3695,3472312341,3410160376,1672543545,1672545058,1513
3504,3783771827,3793868716,1672540718,1672543393,2675
3871,3450286949,3513853403,1672567568,1672570423,2855
3770,3780115155,3835985172,1672567368,1672568922,1554
3514,3773332082,3533188828,1672544007,1672545943,1936
3578,3364378127,3439673892,1672562943,1672563399,456
3682,3520355798,3401940259,1672689729,1672691754,2025
3915,3760094385,3792072681,1672671055,1672673464,2409
3524,3232208416,3337362061,1672544008,1672545958,1950
3626,3756789525,3495911207,1672562570,1672563706,1136
3806,3319167958,3418448389,1672623558,1672625118,1560
3720,3824641227,3516444201,1672563507,1672564107,600
3887,3240994288,3660063072,1672609784,1672613301,3517
3733,3488763230,3414940786,1672559943,1672560981,1038
3740,3928511283,3777485931,1672699419,1672700625,1206
3425,3497808662,3443357683,1672566061,1672569361,3300
3489,3511791953,3239617320,1672679413,1672679977,564
3855,3505154885,3710315160,1672598834,1672601446,2612
3811,3812369928,3716963089,1672575812,1672577892,2080
3717,3615737355,3776559988,1672622418,1672622624,206
3543,3921648519,3970627281,1672577523,1672578626,1103
3713,3773009828,3812369928,1672544099,1672546596,2497
3791,3384068080,3625463628,1672632157,1672634618,2461
3851,3519142371,3792546035,1672637148,1672637856,708
3655,3891672228,3636329663,1672562946,1672565073,2127
3920,3500347447,3293835352,1672591654,1672592120,466
3558,3399472693,3514512367,1672694330,1672697614,3284
3629,3793175445,3412968120,1672650671,1672651199,528
3669,3385323994,3451726367,1672658746,1672660930,2184
3836,3920898925,3792020993,1672654567,1672656673,2106
3598,3807212280,3390660440,1672629248,1672630850,1602
3451,3792442597,3714666884,1672699590,1672700553,963
3564,3224811762,3933894942,1672559554,1672560984,1430
3467,3755915206,3412006598,1672649905,1672650618,713
3703,3490029863,3518194482,1672560447,1672561043,596
3562,3436025562,3520560590,1672575567,1672577881,2314
3659,3468041839,3783919913,1672656954,1672658812,1858
3555,3803517637,3360616538,1672616569,1672618646,2077
3780,3792538417,3757193307,1672624935,1672625685,750
3440,3701005527,3280268483,1672655785,1672657604,1819
3569,3760640999,3826238375,1672665306,1672665574,268
3484,3793407963,3773124276,1672607938,1672611535,3597
3629,3701882224,3734118023,1672628316,1672629347,1031
3630,3370068529,3517590837,1672615167,1672617533,2366
3513,3711218296,3205923620,1672555688,1672559067,3379
3496,3505266860,3636329663,1672604149,1672604333,184
3595,3770438122,3515466096,1672686230,1672687090,860
3911,3638204468,3510767239,1672667062,1672668549,1487
3727,3760040019,3505634634,1672568741,1672571317,2576
3612,3421877923,3500703304,1672694025,1672697572,3547
3715,3779738691,3202141727,1672561277,1672563411,2134
3660,3424660806,3533090502,1672596012,1672599392,3380
3664,3777624586,3893912331,1672585882,1672586763,881
3860,3209526819,3757383891,1672687173,1672689616,2443
3644,3421385957,3770704999,1672532064,1672534414,2350
3891,3859868849,3513295938,1672570253,1672572467,2214
3571,3928719932,3505888598,1672579733,1672581739,2006
3697,3351696332,3373089838,1672565648,1672567881,2233
3895,3760263530,3293835352,1672685163,1672688714,3551
3761,3386758279,3338390596,1672687840,1672689206,1366
3537,3770236215,3626499450,1672689409,1672689476,67
3647,3316798920,3783801141,1672540506,1672540873,367
3446,3505663516,3777240360,1672662697,1672664105,1408
3614,3774155692,3417679834,1672690056,1672693641,3585
3914,3979802715,3636329663,1672609558,1672611480,1922
3489,3893912331,3756704774,1672695336,1672695763,427
3596,3401496246,3730071479,1672629096,1672631594,2498
3598,3801645328,3974674109,1672628804,1672629940,1136
3507,3630353876,3231494505,1672568461,1672570591,2130
3526,3292147449,3500044458,1672697123,1672698134,1011
3539,3685681577,3716110860,1672674961,1672677100,2139
3619,3452016771,3487875183,1672541954,1672545110,3156
3605,3241914067,3773902805,1672682143,1672683339,1196
3849,3711812325,3710008361,1672623870,1672625145,1275
3735,3200308999,3792546035,1672560199,1672562552,2353
3467,3618176292,3975717896,1672702076,1672702163,87
3562,3395201292,3316800320,1672665607,1672668369,2762
3693,3680843171,3299125059,1672661971,1672665172,3201
3713,3380130228,3514324011,1672655054,1672657444,2390
3497,3270697740,3220031931,1672531416,1672532023,607
3667,3514512367,3779892400,1672653258,1672654521,1263
3797,3227799827,3923754072,1672603863,1672605858,1995
3550,3713979100,3517222913,1672546634,1672548460,1826
3751,3300229945,3779938251,1672594687,1672597206,2519
3783,3970603231,3311498666,1672592135,1672593174,1039
3443,3293835352,3520355798,1672653108,1672654434,1326
3580,3514703118,3533079336,1672657992,1672658726,734
3861,3829864515,3739895284,1672581960,1672582169,209
3643,3349739136,3783641602,1672643329,1672644974,1645
3880,3927165965,3520657891,1672657325,1672659795,2470
3603,3514703118,3631479562,1672623540,1672624176,636
3864,3463740710,3713691388,1672626090,1672627271,1181
3799,3463849738,3774876004,1672629908,1672632842,2934
3816,3715385401,3512379024,1672562240,1672565719,3479
3684,3791441520,3438078818,1672655168,1672655256,88
3862,3617489344,3792538417,1672667011,1672670318,3307
3534,3512383699,3776117322,1672616781,1672618278,1497
3653,3534764451,3682133690,1672626746,1672628601,1855
3569,3534566651,3500949309,1672599542,1672602419,2877
3424,3520560590,3224330592,1672687657,1672688862,1205
3580,3220031931,3713163045,1672613487,1672615223,1736
3449,3424445495,3895285664,1672646695,1672647294,599
3822,3779639983,3284932450,1672625216,1672626055,839
3651,3773033649,3688490530,1672658683,1672658788,105
3700,3923420131,3757903168,1672663456,1672664889,1433
3745,3620292035,3513410578,1672540762,1672543214,2452
3683,3520639768,3220031931,1672574470,1672574710,240
3828,3812369928,3609113156,1672600485,1672602911,2426
3611,3501567772,3236458894,1672546381,1672549370,2989
3609,3509483172,3734915241,1672593503,1672594317,814
3502,3914691363,3897456874,1672693612,1672696294,2682
3629,3680843171,3330340793,1672575259,1672578312,3053
3905,3780322355,3617392620,1672647315,1672650004,2689
3449,3310039260,3974674109,1672637265,1672640639,3374
3433,3472068734,3283492940,1672688331,1672690559,2228
3709,3791436104,3501457103,1672595192,1672595709,517
3582,3774705415,3713979100,1672555037,1672555263,226
3780,3839245934,3791246640,1672660825,1672661454,629
3809,3510187271,3815392801,1672541544,1672544796,3252
3916,3341893384,3518653080,1672632652,1672635674,3022
3490,3357289672,3834631333,1672536214,1672536635,421
3791,3509764635,3686227677,1672687762,1672690577,2815
3675,3613899351,3739895284,1672562338,1672565640,3302
3847,3417191856,3803389195,1672685659,1672688627,2968
3920,3357689359,3373089838,1672598915,1672601520,2605
3563,3756789525,3701664364,1672639258,1672639830,572
3559,3977148669,3711097754,1672595957,1672596762,805
3763,3970558632,3360616538,1672605743,1672606621,878
3705,3734118023,3518194482,1672599236,1672602662,3426
3854,3792072681,3932478321,1672636077,1672637205,1128
3903,3514956366,3614740489,1672676385,1672678683,2298
3503,3512379024,3517697722,1672573100,1672574932,1832
3669,3403370192,3617116290,1672675715,1672678591,2876
3546,3618808151,3770236215,1672568565,1672570105,1540
3662,3774155692,3770704999,1672653530,1672657033,3503
3823,3660887799,3773939399,1672645900,1672646232,332
3796,3710562338,3412006598,1672661742,1672662313,571
3805,3900276517,3387594369,1672637789,1672638899,1110
3710,3779656423,3770468980,1672649970,1672652322,2352
3905,3227799827,3703798634,1672576279,1672579049,2770
3553,3792538417,3793743698,1672694312,1672697113,2801
3615,3715443333,3791753345,1672698006,1672698329,323
3693,3935399379,3480991549,1672637986,1672640503,2517
3487,3457960571,3834960360,1672550891,1672553244,2353
3729,3280054198,3621461051,1672637104,1672640624,3520
3425,3972192593,3777189898,1672564968,1672567644,2676
3491,3384583385,3510187271,1672595052,1672597218,2166
3640,3880926355,3501457103,1672598253,1672600351,2098
3774,3714067076,3311498666,1672673205,1672673992,787
3595,3510642075,3621461051,1672627767,1672630954,3187
3645,3703433819,3780909839,1672663075,1672664617,1542
3426,3738026330,3791613604,1672590790,1672593862,3072
3656,3501786419,3271454397,1672542786,1672543326,540
3865,3533188828,3757863420,1672639854,1672642133,2279
3921,3770704999,3777184389,1672664115,1672667562,3447
3452,3511024016,3239617320,1672592257,1672594713,2456
3574,3240994288,3209481722,1672701836,1672702064,228
3571,3480991549,3715443333,1672631530,1672633541,2011
3697,3389634034,3757863420,1672607447,1672610498,3051
3550,3713829743,3347419520,1672672644,1672675828,3184
3663,3518561777,3714666884,1672608056,1672608769,713
3651,3505923418,3500044458,1672560131,1672562554,2423
3644,3533004959,3501384020,1672680441,1672683880,3439
3568,3817428320,3556969573,1672665835,1672668523,2688
3906,3829864515,3664943873,1672648398,1672651781,3383
3456,3757903168,3898314440,1672640476,1672642689,2213
3587,3515439826,3375449013,1672551517,1672554236,2719
3838,3636329663,3779301501,1672626820,1672629118,2298
3470,3815392801,3755756564,1672549804,1672552407,2603
3515,3306412634,3714666884,1672659165,1672661095,1930
3770,3770236215,3970909253,1672565468,1672568175,2707
3626,3852533643,3755915206,1672610081,1672611384,1303
3527,3733363628,3438078818,1672664655,1672665747,1092
3835,3516321888,3897456874,1672622750,1672626145,3395
3535,3613338363,3533294425,1672633685,1672635454,1769
3802,3512882178,3733363628,1672696665,1672698488,1823
3707,3283492940,3500777439,1672681787,1672684436,2649
3774,3627368399,3739154408,1672652496,1672652653,157
3827,3776988674,3905899155,1672572850,1672574999,2149
3455,3972192593,3505995057,1672662433,1672665333,2900
3737,3639050419,3774876004,1672534301,1672537869,3568
3441,3513065217,3202804048,1672701831,1672703776,1945
3553,3733363628,3351696332,1672606490,1672609925,3435
3894,3774031303,3394401087,1672535715,1672537361,1646
3491,3887243870,3859868849,1672690426,1672693567,3141
3560,3480726047,3514741348,1672564543,1672567536,2993
3651,3551376095,3288762795,1672597594,1672600854,3260
3509,3934064792,3512392431,1672569339,1672570965,1626
3672,3713163045,3411688875,1672617780,1672618050,270
3569,3514512367,3713163045,1672696313,1672698967,2654
3441,3909094917,3770146716,1672576281,1672576512,231
3486,3404025196,3517222913,1672681961,1672682294,333
3594,3636329663,3780427126,1672597840,1672598193,353
3707,3272716462,3513327337,1672666822,1672667714,892
3887,3209526819,3800257590,1672627552,1672629922,2370
3660,3441348818,3511843593,1672676396,1672679208,2812
3726,3505434346,3288762795,1672611003,1672612828,1825
3738,3357689359,3621461051,1672531278,1672534381,3103
3430,3272716462,3791753345,1672554374,1672556768,2394
3657,3970627281,3856606678,1672588243,1672590045,1802
3792,3710562338,3236499444,1672666803,1672667924,1121
3551,3621683102,3703798634,1672632212,1672632837,625
3698,3516703758,3792505974,1672640079,1672640818,739
3481,3734451191,3341893384,1672617097,1672617489,392
3839,3481640525,3714067076,1672545532,1672549029,3497
3500,3791753345,3938503547,1672642523,1672643910,1387
3872,3333403880,3778926763,1672622020,1672624202,2182
3582,3738026330,3770296583,1672549203,1672550600,1397
3869,3780909839,3716963089,1672556066,1672558156,2090
3883,3408430195,3300511067,1672580385,1672581025,640
3911,3500613459,3777779869,1672702783,1672703495,712
3803,3710315160,3364378127,1672596904,1672599070,2166
3431,3201629017,3711734586,1672611339,1672614283,2944
3801,3821054646,3514246749,1672671047,1672673059,2012
3777,3770296583,3505437712,1672681927,1672682057,130
3704,3500841914,3273981374,1672534057,1672536182,2125
3533,3880926355,3512392431,1672632077,1672633875,1798
3646,3780571086,3756385685,1672540977,1672543589,2612
3668,3807212280,3756789525,1672590176,1672591164,988
3597,3793935736,3511024016,1672669938,1672673119,3181
3471,3201800997,3501525100,1672590630,1672590766,136
3678,3279473441,3351696332,1672598333,1672599524,1191
3654,3664943873,3366423342,1672567410,1672568642,1232
3848,3449333754,3367971170,1672609941,1672610607,666
3778,3777091903,3834963772,1672560869,1672561954,1085
3735,3774641380,3480991549,1672545304,1672547352,2048
3687,3900276517,3334647380,1672661073,1672664166,3093
3776,3923420131,3638204468,1672643318,1672645569,2251
3655,3512499658,3685816610,1672602125,1672605307,3182
3779,3415833929,3701136026,1672558920,1672561886,2966
3574,3774031303,3776117322,1672605697,1672607356,1659
3757,3711097754,3626499450,1672683828,1672687413,3585
3483,3480100311,3624297844,1672667169,1672669370,2201
3877,3357864626,3300229945,1672635491,1672638302,2811
3719,3779786641,3284947372,1672669357,1672671083,1726
3853,3773009828,3398731252,1672656845,1672659192,2347
3518,3791246640,3701884158,1672547490,1672547919,429
3688,3615115210,3623266256,1672680967,1672682500,1533
3581,3449639012,3497095254,1672695814,1672695945,131
3897,3855583256,3773027597,1672656145,1672657590,1445
3573,3446533960,3609881958,1672533880,1672536349,2469
3427,3383138270,3510499038,1672561855,1672563347,1492
3866,3289817992,3431460073,1672678502,1672681034,2532
3897,3276003502,3515890966,1672597221,1672599100,1879
3888,3777694660,3716628503,1672692700,1672696225,3525
3453,3713163045,3349856820,1672597434,1672598538,1104
3556,3505995057,3791796585,1672571868,1672573284,1416
3657,3802932312,3823084403,1672582316,1672585907,3591
3531,3780909839,3448875382,1672656862,1672660461,3599
3533,3852686295,3519909393,1672604492,1672606793,2301
3425,3755065949,3351866415,1672615839,1672618998,3159
3461,3773124276,3668414677,1672667924,1672670994,3070
3480,3294747828,3609113156,1672699688,1672703217,3529
3587,3382733096,3793922324,1672626717,1672628995,2278
3744,3735374579,3779532653,1672614297,1672617224,2927
3850,3439673892,3933894942,1672691720,1672693998,2278
3579,3440137407,3461119815,1672589524,1672592113,2589
3852,3485540729,3731646673,1672663556,1672664600,1044
3537,3792489602,3779639983,1672558411,1672558637,226
3912,3505807416,3773572967,1672570494,1672570744,250
3768,3626499450,3760645796,1672680281,1672681286,1005
3425,3201629017,3338390596,1672593618,1672594315,697
3643,3438489358,3410160376,1672578476,1672580645,2169
3520,3225029895,3793868716,1672654384,1672656928,2544
3685,3774155692,3665998641,1672602102,1672605622,3520
3707,3513295938,3760640999,1672615532,1672616013,481
3475,3510028805,3711000597,1672609310,1672610328,1018
3614,3515466096,3509483172,1672683840,1672684146,306
3541,3468041839,3310125159,1672535755,1672539243,3488
3622,3931627862,3773902805,1672699399,1672702195,2796
3882,3811040565,3511288998,1672562248,1672562699,451
3816,3716272919,3774641380,1672547256,1672549169,1913
3709,3409114719,3485540729,1672571890,1672572761,871
3484,3793935736,3970558632,1672686989,1672690129,3140
3500,3713589994,3239617320,1672535514,1672537345,1831
3823,3509366311,3280268483,1672584152,1672585974,1822
3669,3773121782,3510554314,1672612572,1672615711,3139
3533,3357289672,3280268483,1672681903,1672684178,2275
3806,3812369928,3714067076,1672546181,1672548417,2236
3613,3505634634,3438489358,1672581874,1672582696,822
3455,3701005527,3755222916,1672618075,1672619613,1538
3600,3780322355,3900945856,1672543298,1672545976,2678
3899,3225636215,3520991398,1672543883,1672546812,2929
3623,3736705719,3760645796,1672550694,1672554148,3454
3794,3360616538,3284947372,1672549676,1672550302,626
3896,3392520516,3793935736,1672556429,1672556578,149
3597,3824215187,3627368399,1672609433,1672610446,1013
3514,3637313265,3639050419,1672663416,1672665133,1717
3666,3513295938,3414275042,1672635332,1672637908,2576
3725,3776244398,3308760650,1672593151,1672594341,1190
3851,3509756823,3859868849,1672565529,1672568670,3141
3560,3236499444,3711077927,1672569703,1672570052,349
3571,3792538417,3711000597,1672664672,1672665561,889
3447,3859868849,3283492940,1672559777,1672561840,2063
3684,3517881647,3756385685,1672534432,1672537515,3083
3561,3459681410,3513327337,1672680417,1672682320,1903
3425,3776117322,3608855425,1672594185,1672594747,562
3685,3760924079,3334647380,1672679128,1672681856,2728
3730,3615688740,3636329663,1672647472,1672650632,3160
3559,3774705415,3272030610,1672681648,1672682177,529
3773,3793969543,3451691949,1672574821,1672575854,1033
3608,3299125059,3780338697,1672542124,1672544866,2742
3475,3445206685,3736705719,1672703038,1672705393,2355
3727,3412968120,3792389522,1672651731,1672653316,1585
3795,3737112297,3273981374,1672534925,1672537206,2281
3499,3226024417,3308760650,1672644178,1672646655,2477
3522,3510818674,3975717896,1672603232,1672603790,558
3546,3513327337,3390660440,1672696292,1672697244,952
3527,3493017654,3347446226,1672627318,1672628725,1407
3432,3780571086,3897456874,1672549512,1672550167,655
3503,3834963772,3513545422,1672626899,1672629680,2781
3431,3824215187,3682133690,1672676281,1672676364,83
3845,3515466096,3736231757,1672660029,1672660783,754
3685,3912891315,3513853403,1672601812,1672602781,969
3582,3793315718,3935913584,1672616605,1672617274,669
3893,3615115210,3777189898,1672573034,1672575818,2784
3733,3755230952,3739154408,1672671849,1672672098,249
3813,3239617320,3773939399,1672660248,1672660840,592
3597,3756704774,3382733096,1672653537,1672655248,1711
3558,3938389661,3824641227,1672690489,1672691218,729
3536,3716679950,3760263530,1672671505,1672673041,1536
3587,3824641227,3779639983,1672613322,1672616718,3396
3496,3732584121,3316800320,1672558950,1672559220,270
3720,3399472693,3756625818,1672676365,1672677043,678
3837,3443357683,3897376951,1672543776,1672545727,1951
3586,3510499038,3793175445,1672688692,1672691852,3160
3457,3757323954,3201800997,1672689767,1672691331,1564
3747,3770624662,3770236215,1672531667,1672534519,2852
3564,3202804048,3715086894,1672684437,1672687915,3478
3802,3481640525,3512882178,1672596711,1672597139,428
3726,3777091903,3920497528,1672549190,1672550926,1736
3763,3755532873,3760645796,1672576549,1672578894,2345
3448,3904412440,3386758279,1672696096,1672698099,2003
3796,3303410628,3660887799,1672631698,1672632156,458
3718,3834631333,3224330592,1672666050,1672668281,2231
3813,3311049964,3534829213,1672686831,1672687601,770
3519,3736705719,3777694660,1672689743,1672690508,765
3488,3889780657,3776518452,1672613510,1672616101,2591
3785,3780322355,3710008361,1672660952,1672662772,1820
3535,3701882224,3777091903,1672559856,1672560789,933
3684,3438489358,3513041785,1672695411,1672697387,1976
3846,3299125059,3519850727,1672649121,1672652189,3068
3568,3534126409,3402697190,1672595481,1672596363,882
3481,3520416075,3500525825,1672642542,1672644964,2422
3651,3225636215,3201629017,1672584562,1672587945,3383
3538,3688490530,3516321888,1672563319,1672566524,3205
3570,3774155692,3622357348,1672555411,1672556033,622
3515,3398198430,3783928182,1672606523,1672606595,72
3833,3515559913,3441703884,1672654629,1672657113,2484
3756,3394401087,3776831527,1672584506,1672586202,1696
3738,3200308999,3383138270,1672672215,1672674514,2299
3637,3350095157,3418448389,1672666312,1672669289,2977
3523,3514703118,3834631333,1672627807,1672631228,3421
3435,3300979975,3970627281,1672590073,1672591375,1302
3647,3834631333,3920497528,1672628501,1672629579,1078
3774,3505434346,3449639012,1672585370,1672585966,596
3816,3429943738,3773913680,1672537597,1672540458,2861
3804,3382733096,3755737419,1672646100,1672648685,2585
3523,3511317276,3360069849,1672587801,1672587984,183
3468,3623266256,3783136330,1672582553,1672584813,2260
3570,3364726656,3779892400,1672673758,1672673863,105
3913,3336627643,3500915908,1672538166,1672538769,603
3875,3338390596,3770676872,1672632267,1672633237,970
3687,3514324011,3510554314,1672690002,1672691539,1537
3795,3777037426,3611055563,1672607208,1672609712,2504
3632,3450969839,3517288083,1672674903,1672675342,439
3650,3793418209,3779425804,1672589227,1672590792,1565
3781,3853629553,3244004456,1672553543,1672554118,575
3898,3436257398,3760640999,1672616644,1672618666,2022
3638,3288224595,3511150845,1672609381,1672609469,88
3547,3534764451,3701424609,1672551429,1672554370,2941
3441,3274906650,3554186380,1672655377,1672657204,1827
3574,3500841914,3289817992,1672592182,1672592551,369
3671,3456430614,3501459390,1672668610,1672671927,3317
3425,3970909253,3334951866,1672587556,1672588309,753
3786,3756789525,3891672228,1672576335,1672579100,2765
3919,3244004456,3778134418,1672562097,1672562738,641
3438,3239617320,3315279093,1672622026,1672623464,1438
3669,3505521218,3513327337,1672650964,1672652285,1321
3460,3701882224,3319167958,1672642920,1672643873,953
3842,3733558985,3755848152,1672674848,1672677449,2601
3639,3770676872,3773124276,1672624062,1672624265,203
3587,3701107228,3623266256,1672537934,1672540815,2881
3890,3823084403,3343816795,1672556773,1672559686,2913
3529,3455018347,3715974659,1672596220,1672597230,1010
3490,3927403123,3270697740,1672537956,1672538347,391
3645,3505995057,3618808151,1672605913,1672608995,3082
3495,3208957949,3900276517,1672633001,1672634016,1015
3677,3246370118,3500442734,1672612841,1672613212,371
3865,3533294425,3934064792,1672538493,1672541845,3352
3459,3971806004,3200543880,1672664778,1672666829,2051
3870,3760362417,3770468980,1672649097,1672651352,2255
3772,3783550022,3812534508,1672562636,1672565629,2993
3558,3500525825,3513545422,1672653052,1672655125,2073
3532,3203538212,3701664364,1672699160,1672699920,760
3725,3783771827,3793743698,1672639275,1672641494,2219
3582,3970198861,3509366311,1672702324,1672705011,2687
3834,3791753345,3715443333,1672674936,1672678098,3162
3823,3300511067,3554944414,1672584304,1672586716,2412
3920,3534179433,3372223551,1672629252,1672632129,2877
3653,3518561777,3935399379,1672682886,1672685905,3019
3499,3814677862,3409114719,1672680998,1672684052,3054
3452,3818575661,3778926763,1672547893,1672550046,2153
3575,3713589994,3793583656,1672585323,1672587901,2578
3564,3757348722,3850911686,1672653535,1672654203,668
3841,3517991730,3760645796,1672646292,1672646423,131
3840,3755158925,3349856820,1672659495,1672661476,1981
3790,3688796737,3660887799,1672687165,1672687935,770
3861,3755233658,3760362417,1672691654,1672692408,754
3808,3823084403,3231713082,1672553396,1672556667,3271
3779,3416987084,3400763927,1672662106,1672664452,2346
3705,3916490839,3382733096,1672560842,1672560919,77
3724,3774718695,3897435944,1672597829,1672599590,1761
3864,3839245934,3686523546,1672541462,1672543030,1568
3665,3505481368,3701664364,1672601013,1672604093,3080
3863,3513081354,3791753345,1672632099,1672635481,3382
3689,3757193307,3421385957,1672531643,1672534215,2572
3768,3513041785,3519077659,1672554586,1672556819,2233
3789,3470454332,3337362061,1672591228,1672592307,1079
3509,3224330592,3510798825,1672683436,1672686926,3490
3434,3513345163,3736231757,1672540727,1672541207,480
3696,3310125159,3615113018,1672592253,1672592513,260
3500,3897435944,3273981374,1672581679,1672582916,1237
3833,3520764926,3463740710,1672672276,1672675187,2911
3893,3701322924,3533004959,1672560351,1672563937,3586
3859,3505178849,3398731252,1672700894,1672702492,1598
3712,3780571086,3467779445,1672703701,1672704953,1252
3501,3490214516,3755222916,1672658834,1672661181,2347
3856,3279339278,3357864626,1672588344,1672589738,1394
3826,3613416045,3478114114,1672658376,1672659643,1267
3614,3793935736,3713163045,1672651719,1672653439,1720
3569,3401496246,3479851674,1672657255,1672660766,3511
3648,3900276517,3604867757,1672533872,1672537323,3451
3688,3424445495,3513065217,1672691239,1672694191,2952
3873,3451726367,3710489491,1672638769,1672640387,1618
3650,3975717896,3711077927,1672588460,1672591223,2763
3660,3478114114,3292147449,1672546844,1672547371,527
3469,3617116290,3732584121,1672613835,1672616806,2971
3821,3713911104,3202804048,1672657780,1672659886,2106
3702,3780571086,3469254160,1672687150,1672690181,3031
3909,3513360004,3831586487,1672615760,1672617669,1909
3922,3516489668,3817428320,1672590931,1672592373,1442
3743,3462158237,3970558632,1672584506,1672586499,1993
3691,3756127300,3226024417,1672690545,1672692024,1479
3609,3701882224,3501786419,1672582446,1672584874,2428
3808,3902760230,3500672156,1672615330,1672616906,1576
3736,3467988782,3819767045,1672674952,1672675895,943
3629,3374183227,3513065217,1672595619,1672596390,771
3863,3454277788,3812369928,1672669491,1672671745,2254
3836,3778926763,3703139663,1672649982,1672651322,1340
3800,3380767040,3456430614,1672581839,1672584624,2785
3797,3780115155,3392520516,1672597961,1672599566,1605
3579,3387594369,3779465522,1672659466,1672662570,3104
3779,3701005527,3902760230,1672606438,1672608530,2092
3558,3505437712,3661903000,1672661613,1672663929,2316
3474,3457620713,3935399379,1672624385,1672625292,907
3439,3780209375,3780472203,1672559996,1672560153,157
3854,3480726047,3715443333,1672573995,1672574564,569
3603,3757383891,3703348097,1672554440,1672557023,2583
3842,3621184108,3819767045,1672653473,1672656946,3473
3738,3501215099,3366423342,1672631680,1672634100,2420
3817,3201676087,3686523546,1672566069,1672566844,775
3544,3403370192,3755737419,1672535258,1672537947,2689
3471,3315279093,3512800570,1672612639,1672613313,674
3641,3505434346,3783147088,1672539062,1672540130,1068
3585,3512392431,3792020993,1672594135,1672595444,1309
3865,3510818674,3367111751,1672697810,1672700819,3009
3903,3921648519,3891672228,1672673096,1672675962,2866
3800,3780680950,3500703304,1672594761,1672596749,1988
3875,3232208416,3205985903,1672533059,1672533909,850
3838,3519028898,3505154885,1672579890,1672581252,1362
3578,3701884158,3416987084,1672586648,1672588479,1831
3560,3319167958,3417679834,1672693370,1672695688,2318
3652,3501459390,3921648519,1672628197,1672630268,2071
3872,3783771827,3373089838,1672647257,1672649927,2670
3612,3780209375,3701424609,1672696510,1672696894,384
3569,3500109249,3777694660,1672533801,1672537275,3474
3702,3380130228,3688490530,1672679206,1672679688,482
3809,3511317276,3714185969,1672676792,1672678419,1627
3805,3519077659,3520560590,1672648011,1672648670,659
3916,3519818818,3510964997,1672697179,1672697542,363
3795,3783550022,3701664364,1672669773,1672670419,646
3492,3511442562,3776084820,1672687892,1672688545,653
3887,3760645796,3979784676,1672653216,1672654918,1702
3513,3273981374,3777147510,1672624667,1672627247,2580
3467,3938503547,3415833929,1672674448,1672677688,3240
3683,3501281016,3701424609,1672582956,1672586115,3159
3570,3447514821,3283770991,1672551899,1672553712,1813
3778,3441348818,3609659642,1672674344,1672674583,239
3909,3441703884,3517887477,1672621276,1672622149,873
3451,3500737582,3927599181,1672538637,1672539672,1035
3922,3902861231,3392520516,1672701843,1672703655,1812
3435,3225631197,3899786664,1672697212,1672697950,738
3886,3534179433,3512383699,1672630343,1672630875,532
3603,3792546035,3333403880,1672677245,1672680704,3459
3650,3514741348,3755065949,1672587882,1672591144,3262
3688,3513345163,3823084403,1672540416,1672543325,2909
3783,3757903168,3500703304,1672674905,1672676582,1677
3584,3760694096,3760651515,1672690996,1672691356,360
3872,3201629017,3783136330,1672653220,1672656139,2919
3489,3505807416,3450969839,1672602892,1672603989,1097
3919,3230868435,3311498666,1672564878,1672565240,362
3819,3333403880,3914691363,1672686077,1672689100,3023
3742,3633735593,3783340788,1672644982,1672647433,2451
3487,3505923418,3703139663,1672595922,1672596459,537
3800,3793868716,3689697817,1672626533,1672627128,595
3731,3792020993,3739895284,1672559256,1672561785,2529
3881,3713784974,3927599181,1672664438,1672667167,2729
3737,3779301501,3513853403,1672567889,1672570415,2526
3904,3710008361,3367509761,1672664327,1672665281,954
3679,3513360004,3793740407,1672577251,1672578970,1719
3797,3613206049,3512722110,1672666555,1672667973,1418
3867,3379143440,3276269264,1672611035,1672613981,2946
3663,3904412440,3756746867,1672652472,1672652577,105
3853,3614740489,3520115090,1672680663,1672682834,2171
3507,3231713082,3814677862,1672642413,1672643982,1569
3464,3801645328,3334993594,1672573066,1672574055,989
3527,3935487534,3316798920,1672569140,1672571674,2534
3547,3912891315,3386758279,1672569021,1672570728,1707
3488,3734451191,3733558985,1672622095,1672624800,2705
3494,3800257590,3456430614,1672628002,1672630077,2075
3640,3552824113,3225631197,1672587407,1672589207,1800
3552,3351696332,3808136029,1672572719,1672574203,1484
3530,3779639983,3902760230,1672703287,1672704482,1195
3702,3520181148,3514512367,1672549582,1672552990,3408
3424,3852533643,3533004959,1672602602,1672606108,3506
3452,3777330107,3757193307,1672698275,1672700990,2715
3750,3533747868,3715086894,1672694786,1672696061,1275
3768,3703383853,3551376095,1672652644,1672653931,1287
3836,3887243870,3512830734,1672684449,1672686593,2144
3434,3756127300,3368283077,1672594415,1672595525,1110
3572,3480100311,3276269264,1672626689,1672626986,297
3480,3271752081,3276217799,1672690714,1672692007,1293
3779,3520416075,3774718695,1672585662,1672588884,3222
3801,3783373154,3793781065,1672695028,1672698237,3209
3501,3509483172,3631090677,1672576031,1672577322,1291
3821,3513295938,3463740710,1672564807,1672568248,3441
3608,3334647380,3688796737,1672574625,1672574837,212
3507,3604589802,3755222916,1672601515,1672602414,899
3793,3350095157,3737112297,1672537052,1672540146,3094
3914,3510818674,3411688875,1672663063,1672666051,2988
3484,3605221116,3439673892,1672699074,1672699668,594
3793,3773913680,3519446663,1672595098,1672596377,1279
3799,3299443125,3513041785,1672550497,1672551057,560
3562,3534566651,3334647380,1672660843,1672661341,498
3884,3823084403,3505434346,1672690100,1672690886,786
3774,3511732493,3505663516,1672535406,1672538167,2761
3827,3509366311,3274831810,1672631657,1672634898,3241
3462,3417679834,3228888030,1672538966,1672540544,1578
3788,3514308235,3773124276,1672618053,1672618341,288
3554,3225636215,3510642075,1672554033,1672556204,2171
3463,3226511603,3451726367,1672595497,1672598112,2615
3461,3519087371,3818575661,1672593993,1672597337,3344
3787,3505154885,3701322924,1672573081,1672573594,513
3503,3517697722,3814677862,1672663092,1672663324,232
3612,3773027597,3636329663,1672534744,1672537139,2395
3493,3618176292,3713768950,1672652341,1672655568,3227
3669,3777330107,3774290799,1672624516,1672626743,2227
3900,3792389522,3367509761,1672608213,1672609049,836
3548,3934064792,3519446663,1672548802,1672549498,696
3548,3519142371,3770296583,1672658503,1672659522,1019
3792,3333918941,3760364383,1672569027,1672570999,1972
3861,3800257590,3713829743,1672700805,1672701167,362
3751,3500302272,3306412634,1672594946,1672598507,3561
3500,3683113954,3519282716,1672658221,1672660957,2736
3866,3505179890,3480490124,1672645756,1672648788,3032
3559,3783373154,3501525100,1672617494,1672620914,3420
3849,3517991730,3711097754,1672538205,1672539419,1214
3787,3812369928,3515559913,1672565064,1672568213,3149
3603,3793407963,3226024417,1672583580,1672586190,2610
3493,3228888030,3236499444,1672537079,1672538880,1801
3764,3480100311,3500317969,1672621034,1672622517,1483
3610,3970198861,3518565331,1672608500,1672609129,629
3623,3778667336,3904867554,1672565980,1672568676,2696
3734,3402697190,3885537225,1672629336,1672632017,2681
3899,3396726504,3505521218,1672611116,1672613603,2487
3585,3500072204,3515890966,1672607269,1672608268,999
3807,3880926355,3793781065,1672554849,1672555049,200
3509,3925979970,3683113954,1672535192,1672537929,2737
3836,3512383699,3791613604,1672599378,1672599749,371
3733,3512882178,3401793306,1672638293,1672638803,510
3888,3895285664,3472068734,1672683003,1672684442,1439
3719,3316800320,3776831527,1672642949,1672645249,2300
3597,3200308999,3974674109,1672553384,1672555498,2114
3459,3632814465,3632814465,1672603766,1672604883,1117
3845,3715127070,3330340793,1672654227,1672657101,2874
3628,3310039260,3516513251,1672577444,1672578146,702
3810,3554186380,3776831527,1672701297,1672704449,3152
3630,3509893027,3200543880,1672578256,1672581707,3451
3912,3777485931,3716628503,1672565990,1672567925,1935
3756,3755065949,3533294425,1672649438,1672651468,2030
3715,3334993594,3220031931,1672647564,1672648924,1360
3850,3701884158,3520181148,1672637340,1672637400,60
3914,3347446226,3280054198,1672637979,1672640633,2654
3476,3398731252,3274906650,1672683008,1672684286,1278
3701,3308760650,3202804048,1672639218,1672642421,3203
3648,3780338697,3283144118,1672538539,1672539503,964
3451,3517887477,3300229945,1672545848,1672546317,469
3691,3415833929,3884596900,1672650810,1672652536,1726
3661,3451726367,3716963089,1672534911,1672538351,3440
3633,3514818819,3778040015,1672564363,1672567755,3392
3633,3310125159,3905196766,1672558127,1672558670,543
3818,3757193551,3519909393,1672563459,1672566186,2727
3526,3209526819,3774605761,1672692236,1672695541,3305
3682,3713691388,3505154885,1672596457,1672596588,131
3742,3773735484,3398731252,1672644242,1672646998,2756
3524,3791246640,3755404116,1672633704,1672634948,1244
3824,3780322355,3834963772,1672588707,1672591923,3216
3724,3739911441,3791246640,1672634883,1672635099,216
3919,3757193551,3227799827,1672690691,1672692001,1310
3548,3774243020,3296462324,1672539315,1672540834,1519
3626,3755992176,3514971533,1672666966,1672667497,531
3462,3909094917,3660887799,1672686665,1672687052,387
3716,3452016771,3858172636,1672658334,1672659845,1511
3549,3518653080,3710048469,1672560766,1672560826,60
3816,3201629017,3418448389,1672580794,1672581994,1200
3753,3760040019,3760694096,1672612742,1672615485,2743
3901,3631090677,3900276517,1672672746,1672675516,2770
3863,3347446226,3791441520,1672566495,1672567911,1416
3648,3811040565,3701247948,1672691919,1672694218,2299
3590,3319167958,3438489358,1672546612,1672549698,3086
3534,3347446226,3757630221,1672570275,1672573771,3496
3618,3511732493,3793781065,1672688938,1672689195,257
3849,3512379024,3350095157,1672605317,1672608861,3544
3851,3226511603,3776559988,1672659598,1672660860,1262
3664,3777037426,3230868435,1672672928,1672676015,3087
3741,3416987084,3315703693,1672583111,1672585607,2496
3881,3357689359,3688220326,1672568831,1672568896,65
3496,3305336154,3517737088,1672623348,1672623776,428
3754,3343132529,3510641433,1672568635,1672568754,119
3697,3279473441,3897134762,1672670604,1672671554,950
3614,3383138270,3380767040,1672683951,1672687050,3099
3844,3660063072,3716110860,1672578203,1672581320,3117
3484,3236354255,3512499658,1672665964,1672669491,3527
3704,3517590837,3393063657,1672630429,1672632006,1577
3856,3755344363,3880926355,1672543409,1672544855,1446
3809,3780769110,3619922891,1672559273,1672560957,1684
3654,3783919913,3668414677,1672698170,1672699636,1466
3725,3714678331,3932478321,1672643699,1672645009,1310
3902,3512946768,3511883730,1672653481,1672655641,2160
3790,3481640525,3710489491,1672531401,1672533108,1707
3637,3495911207,3756127300,1672549922,1672550129,207
3427,3635169815,3414275042,1672686683,1672688769,2086
3594,3519282716,3791753345,1672537446,1672540236,2790
3590,3716628503,3811040565,1672564687,1672567217,2530
3869,3812369928,3703383853,1672556044,1672557902,1858
3549,3780769110,3607882826,1672563397,1672565627,2230
3831,3449333754,3732584121,1672626452,1672628057,1605
3553,3713829743,3446533960,1672585058,1672587562,2504
3836,3480490124,3730071479,1672542861,1672543875,1014
3574,3617392620,3517600136,1672703264,1672705936,2672
3479,3534543776,3513410578,1672688883,1672691338,2455
3867,3495911207,3517687662,1672671729,1672672276,547
3730,3274906650,3927165965,1672660835,1672663655,2820
3743,3315279093,3208957949,1672555451,1672556569,1118
3510,3791246640,3510964997,1672618309,1672619542,1233
3650,3231713082,3270056120,1672613182,1672616624,3442
3707,3774705415,3680843171,1672697198,1672698229,1031
3818,3367111751,3715986185,1672564020,1672566710,2690
3577,3711734586,3299781901,1672693100,1672695068,1968
3921,3380130228,3512282789,1672697989,1672698709,720
3891,3716963089,3736705719,1672680106,1672682178,2072
3560,3625174002,3517172354,1672608545,1672611538,2993
3643,3755737419,3780427126,1672627124,1672630534,3410
3549,3737112297,3792801638,1672575728,1672575971,243
3566,3774290799,3534764451,1672672348,1672673047,699
3516,3366423342,3514324011,1672577660,1672580100,2440
3871,3780322355,3305722859,1672573993,1672575234,1241
3897,3776831527,3349739136,1672587916,1672588519,603
3902,3399518841,3364378127,1672581389,1672583370,1981
3662,3510554314,3739661856,1672534863,1672535468,605
3670,3774605761,3703433819,1672605056,1672605221,165
3430,3386758279,3661903000,1672575797,1672578498,2701
3693,3715443333,3415833929,1672598789,1672601277,2488
3869,3500737582,3274831810,1672579888,1672579985,97
3707,3612689556,3469254160,1672656279,1672658167,1888
3880,3774907131,3793175445,1672647446,1672647936,490
3542,3505402439,3505111292,1672698009,1672701334,3325
3903,3899786664,3618697021,1672558811,1672561805,2994
3899,3512882178,3618354185,1672665328,1672666407,1079
3814,3360616538,3401940259,1672662970,1672664365,1395
3540,3400069268,3835985172,1672579072,1672580400,1328
3821,3513545422,3380130228,1672657369,1672658577,1208
3542,3206837348,3513360004,1672672258,1672673235,977
3779,3505847380,3362641275,1672659593,1672661486,1893
3706,3825881598,3970909253,1672544416,1672546963,2547
3696,3368283077,3612689556,1672670349,1672671891,1542
3624,3512946768,3760040019,1672537433,1672540305,2872
3798,3520657891,3451691949,1672633125,1672634478,1353
3685,3369708250,3519850727,1672554491,1672556137,1646
3637,3429943738,3270697740,1672574218,1672577793,3575
3470,3505481368,3609881958,1672562141,1672564356,2215
3769,3891672228,3513360004,1672545781,1672549079,3298
3819,3364378127,3479851674,1672658358,1672660785,2427
3538,3468041839,3505402439,1672600526,1672601034,508
3826,3311420950,3600876425,1672612248,1672612989,741
3636,3770146716,3367111751,1672541242,1672544165,2923
3600,3774605761,3793969543,1672650114,1672651737,1623
3903,3661583097,3357289672,1672609547,1672611825,2278
3712,3398731252,3774243020,1672536539,1672539546,3007
3759,3505888598,3500109249,1672644970,1672648229,3259
3461,3382733096,3517737088,1672642017,1672644782,2765
3599,3341893384,3772391882,1672568595,1672569591,996
3632,3792072681,3513345163,1672684758,1672686747,1989
3859,3519446663,3230868435,1672540513,1672542821,2308
3879,3505198734,3533228966,1672652711,1672653791,1080
3854,3893912331,3684523966,1672653526,1672654805,1279
3535,3472068734,3714670620,1672643291,1672644710,1419
3623,3783550022,3294747828,1672632845,1672635928,3083
3758,3360616538,3224811762,1672531277,1672533378,2101
3637,3778134418,3900945856,1672689131,1672691217,2086
3526,3938503547,3435116799,1672684907,1672685265,358
3498,3551389192,3461119815,1672697055,1672698461,1406
3907,3701373490,3220031931,1672685461,1672687544,2083
3679,3455018347,3773572967,1672635619,1672637844,2225
3902,3760924079,3399472693,1672600701,1672603036,2335
3438,3836241528,3480991549,1672682063,1672684353,2290
3893,3713517039,3815250107,1672685136,1672687369,2233
3689,3783641602,3713300120,1672687290,1672688229,939
3859,3534175249,3925979970,1672627997,1672630871,2874
3428,3534357694,3792489602,1672658058,1672661579,3521
3581,3730071479,3479851674,1672693009,1672693552,543
3891,3780712350,3780472203,1672558183,1672560452,2269
3898,3519909393,3716963089,1672678594,1672681381,2787
3467,3554186380,3517462308,1672579709,1672580513,804
3619,3505266860,3417191856,1672618912,1672621258,2346
3766,3305336154,3520560590,1672650375,1672650868,493
3649,3713941638,3710854064,1672632498,1672634744,2246
3784,3315703693,3512502036,1672539666,1672540630,964
3531,3462636434,3457960571,1672679540,1672680715,1175
3860,3534566651,3773837847,1672575120,1672578288,3168
3858,3971806004,3294703680,1672548424,1672550337,1913
3436,3904867554,3885157459,1672565484,1672568725,3241
3447,3904569677,3347419520,1672685007,1672688384,3377
3761,3299781901,3399472693,1672671094,1672673990,2896
3880,3202141727,3201676087,1672570186,1672572024,1838
3535,3774718695,3703139663,1672590971,1672591674,703
3615,3689697817,3885121158,1672655860,1672659238,3378
3642,3714067076,3826238375,1672649431,1672652183,2752
3520,3386758279,3665998641,1672575547,1672576006,459
3425,3792274796,3858172636,1672649294,1672652109,2815
3735,3246370118,3793418209,1672656243,1672658943,2700
3890,3500672156,3366423342,1672541150,1672542752,1602
3484,3819767045,3497095254,1672571649,1672574341,2692
3466,3410160376,3462273042,1672538678,1672540542,1864
3524,3631090677,3533090502,1672594472,1672597409,2937
3534,3490214516,3510964997,1672573667,1672573935,268
3434,3834960360,3400069268,1672642763,1672643964,1201
3496,3778899160,3858172636,1672628074,1672630545,2471
3521,3615737355,3441703884,1672646376,1672648955,2579
3606,3517222913,3505154885,1672577869,1672580607,2738
3528,3792505974,3609881958,1672542186,1672544679,2493
3862,3703396825,3715443333,1672673053,1672675824,2771
3426,3551399764,3334993594,1672581574,1672583678,2104
3466,3738026330,3209481722,1672701222,1672703443,2221
3659,3505807416,3778134418,1672643961,1672645523,1562
3883,3755756564,3501457103,1672587037,1672588636,1599
3836,3780834916,3304155815,1672539494,1672540615,1121
3754,3730071479,3515439826,1672557834,1672560728,2894
3816,3505111292,3608922867,1672632116,1672634777,2661
3637,3431502855,3760721303,1672647720,1672649084,1364
3552,3491469603,3972083617,1672686857,1672687838,981
3770,3236499444,3272096759,1672623583,1672624287,704
3515,3520657891,3779532653,1672583783,1672584726,943
3455,3421877923,3773837847,1672699543,1672699969,426
3557,3303410628,3520416075,1672537385,1672539492,2107
3500,3500604680,3713589994,1672630573,1672632082,1509
3631,3505847380,3401496246,1672534980,1672536177,1197
3783,3533649454,3755756564,1672615531,1672617147,1616
3666,3270042456,3833217041,1672635232,1672638162,2930
3572,3622357348,3440107959,1672656740,1672658706,1966
3428,3334993594,3334993594,1672612563,1672614298,1735
3881,3517697722,3780769110,1672679607,1672683158,3551
3592,3661447322,3688490530,1672628800,1672632160,3360
3766,3776518452,3892304880,1672547283,1672550705,3422
3451,3757348722,3715619259,1672606347,1672607733,1386
3688,3501384020,3478114114,1672554175,1672556641,2466
3681,3618697021,3604589802,1672632036,1672635281,3245
3819,3224330592,3934064792,1672652282,1672653691,1409
3626,3500703304,3510818674,1672550952,1672554541,3589
3702,3451326054,3554944414,1672702094,1672703644,1550
3863,3514512367,3516298579,1672669825,1672672122,2297
3590,3783433404,3904569677,1672623574,1672625695,2121
3561,3607882826,3231713082,1672589127,1672592723,3596
3640,3520764926,3779938251,1672593399,1672596408,3009
3479,3510641433,3411515369,1672552046,1672555488,3442
3553,3421877923,3631479562,1672689785,1672692316,2531
3695,3438078818,3783373154,1672692109,1672692582,473
3810,3755992176,3520416075,1672608584,1672609120,536
3540,3611055563,3512830734,1672621534,1672623881,2347
3744,3773572967,3703433819,1672640633,1672641093,460
3659,3971806004,3755230952,1672659724,1672660329,605
3427,3351866415,3360616538,1672667949,1672670607,2658
3743,3792525861,3336339664,1672575517,1672576035,518
3520,3513345163,3510641433,1672567008,1672568343,1335
3554,3776988674,3714120857,1672595613,1672597735,2122
3655,3428027649,3757075324,1672702699,1672705902,3203
3598,3500857494,3934064792,1672676524,1672678403,1879
3452,3505847380,3818575661,1672549463,1672553045,3582
3472,3624297844,3793175445,1672630598,1672631212,614
3635,3631479562,3714120857,1672647589,1672647831,242
3658,3360813161,3387594369,1672627692,1672629135,1443
3615,3756704774,3884596900,1672560194,1672561361,1167
3646,3300511067,3293835352,1672588298,1672590274,1976
3796,3770704999,3714120857,1672685022,1672688144,3122
3854,3703348097,3621184108,1672658536,1672661433,2897
3769,3755065949,3777147510,1672642602,1672643160,558
3912,3512800570,3225029895,1672594718,1672596742,2024
3637,3884596900,3534179433,1672568381,1672571929,3548
3631,3435167810,3780472203,1672691996,1672695186,3190
3425,3737972328,3902625986,1672573157,1672574174,1017
3561,3376467719,3660063072,1672599087,1672600001,914
3852,3615688740,3403370192,1672544967,1672546862,1895
3736,3897376951,3770704999,1672556598,1672559109,2511
3564,3776831527,3436257398,1672581750,1672583676,1926
3832,3500949309,3438078818,1672542010,1672545437,3427
3455,3515890966,3534543776,1672663687,1672664123,436
3626,3285204083,3205923620,1672660990,1672662953,1963
3726,3732584121,3783919913,1672538155,1672540489,2334
3501,3777330107,3501525100,1672698015,1672699697,1682
3800,3792505974,3500703304,1672546870,1672549095,2225
3849,3383138270,3779438325,1672657050,1672657150,100
3903,3621683102,3505807416,1672676877,1672677688,811
3548,3920898925,3520181148,1672557613,1672560278,2665
3584,3534764451,3304155815,1672629624,1672630680,1056
3729,3401793306,3626499450,1672579254,1672581566,2312
3653,3779938251,3897456874,1672692862,1672695183,2321
3619,3660063072,3760364383,1672636248,1672637646,1398
3425,3224330592,3850911686,1672603328,1672606639,3311
3781,3497808662,3933894942,1672576557,1672577584,1027
3480,3428725843,3734118023,1672594267,1672597604,3337
3572,3463849738,3311049964,1672670463,1672671813,1350
3518,3289114629,3778899160,1672672857,1672675555,2698
3608,3774876004,3520657891,1672655399,1672656585,1186
3544,3710854064,3294703680,1672677397,1672678920,1523
3575,3776117322,3803517637,1672554401,1672556211,1810
3897,3292147449,3398731252,1672603296,1672606893,3597
3578,3833217041,3826238375,1672677804,1672679968,2164
3648,3462273042,3421385957,1672574744,1672575690,946
3901,3445206685,3231494505,1672625337,1672625671,334
3917,3792014516,3923220461,1672665849,1672667329,1480
3707,3505847380,3231494505,1672590320,1672592128,1808
3480,3386758279,3887243870,1672542614,1672544001,1387
3570,3931627862,3226024417,1672555272,1672556034,762
3726,3713163045,3755233658,1672592376,1672595194,2818
3899,3703139663,3364378127,1672587752,1672589120,1368
3782,3384068080,3520181148,1672699451,1672700598,1147
3871,3793922324,3665998641,1672537956,1672538248,292
3757,3492959689,3757075324,1672548293,1672549565,1272
3677,3800257590,3513295938,1672658253,1672660597,2344
3578,3248058676,3755344363,1672674892,1672677664,2772
3725,3757630221,3609659642,1672540061,1672542320,2259
3579,3902625986,3757193307,1672578559,1672579129,570
3567,3817813340,3715854030,1672539477,1672541558,2081
3494,3923754072,3777184389,1672692292,1672694680,2388
3900,3855583256,3201676087,1672591291,1672592467,1176
3773,3777624586,3755915206,1672652864,1672655325,2461
3850,3823084403,3609659642,1672603211,1672604970,1759
3900,3713768950,3380767040,1672666709,1672668469,1760
3838,3513853403,3608922867,1672594005,1672595798,1793
3467,3200308999,3455018347,1672667944,1672668273,329
3903,3516321888,3513018485,1672547961,1672548836,875
3779,3605221116,3505807416,1672696080,1672698705,2625
3469,3714067076,3510919821,1672581828,1672584580,2752
3677,3774290799,3225636215,1672565487,1672565756,269
3638,3288224595,3715854030,1672687210,1672689458,2248
3549,3621790707,3713163045,1672619365,1672620532,1167
3505,3520657891,3824215187,1672601450,1672602315,865
3675,3456430614,3783169442,1672684611,1672687986,3375
3800,3334951866,3779854934,1672532118,1672533370,1252
3655,3710735406,3783641602,1672700148,1672703259,3111
3729,3791613604,3685816610,1672689071,1672689514,443
3748,3335694356,3783550022,1672633339,1672634561,1222
3787,3793868716,3512337405,1672653936,1672656445,2509
3609,3501215099,3926643445,1672601874,1672605127,3253
3766,3736705719,3460719322,1672664474,1672664571,97
3441,3793315718,3703396825,1672640262,1672643259,2997
3572,3517887477,3777624586,1672573777,1672577200,3423
3869,3909094917,3519416013,1672643321,1672646546,3225
3857,3711218296,3756789525,1672628705,1672629391,686
3737,3680843171,3457960571,1672586508,1672588732,2224
3541,3513853403,3291933594,1672680203,1672682142,1939
3758,3495911207,3410538749,1672610639,1672612400,1761
3763,3513410578,3279339278,1672625840,1672627896,2056
3728,3783147088,3516489668,1672609046,1672609217,171
3793,3229974066,3902861231,1672614111,1672616958,2847
3577,3556969573,3401496246,1672577778,1672580796,3018
3453,3510919821,3392520516,1672563009,1672566158,3149
3472,3280268483,3777330107,1672649099,1672651240,2141
3426,3617116290,3772765746,1672689216,1672690546,1330
3867,3500072204,3779438325,1672565882,1672567210,1328
3476,3517172354,3935487534,1672683060,1672683326,266
3906,3491684096,3408498208,1672569747,1672572111,2364
3852,3520115090,3637313265,1672703102,1672705949,2847
3794,3713561276,3209526819,1672683626,1672685804,2178
3677,3731646673,3347446226,1672562988,1672565474,2486
3897,3367509761,3505402439,1672625605,1672627776,2171
3627,3311049964,3916490839,1672556172,1672557051,879
3514,3774243020,3283144118,1672656293,1672659782,3489
3691,3683113954,3686523546,1672694373,1672696473,2100
3667,3770676872,3371455553,1672582077,1672584210,2133
3434,3487875183,3500915908,1672574504,1672574762,258
3598,3513081354,3807212280,1672679967,1672680639,672
3554,3513065217,3812369928,1672684424,1672685536,1112
3752,3451691949,3304971369,1672652473,1672653120,647
3722,3495911207,3451326054,1672594026,1672594811,785
3611,3510798825,3511024016,1672654297,1672656408,2111
3744,3823084403,3772765746,1672669281,1672669666,385
3684,3701823816,3245232284,1672545268,1672548748,3480
3439,3304971369,3630353876,1672686221,1672687282,1061
3684,3245232284,3280054198,1672640798,1672642503,1705
3562,3288762795,3446533960,1672630586,1672632535,1949
3871,3402697190,3760362417,1672677751,1672679175,1424
3920,3618176292,3773735484,1672672100,1672672851,751
3705,3834963772,3701884158,1672690250,1672693466,3216
3872,3559458968,3774733620,1672563904,1672566489,2585
3619,3514246749,3613206049,1672640853,1672643040,2187
3690,3783136330,3510919821,1672632381,1672634659,2278
3489,3772236797,3613899351,1672532114,1672534419,2305
3676,3500442734,3793969543,1672629122,1672630341,1219
3670,3668747074,3520322124,1672544876,1672545775,899
3632,3604589802,3776988674,1672570104,1672571675,1571
3682,3637313265,3208957949,1672691971,1672694783,2812
3883,3760694096,3516513251,1672629197,1672630432,1235
3686,3853629553,3462636434,1672559441,1672561063,1622
3604,3615939504,3517991730,1672649882,1672650293,411
3626,3792442597,3516489668,1672625583,1672627984,2401
3691,3395201292,3932478321,1672587434,1672587949,515
3762,3757323954,3612689556,1672560040,1672562457,2417
3801,3793407963,3755230952,1672633505,1672634728,1223
3841,3439673892,3755065949,1672585163,1672587327,2164
3782,3276003502,3512392431,1672592522,1672594476,1954
3694,3551389192,3239617320,1672696039,1672698447,2408
3831,3780253901,3440107959,1672573834,1672574528,694
3896,3512946768,3456430614,1672674063,1672677628,3565
3861,3480100311,3438489358,1672588948,1672591744,2796
3553,3292147449,3513018485,1672613473,1672615486,2013
3588,3517288083,3316798920,1672631599,1672633670,2071
3457,3500341755,3227799827,1672608310,1672610904,2594
3428,3839245934,3710562338,1672629799,1672632441,2642
3623,3776518452,3273981374,1672582222,1672582460,238
3653,3975717896,3635169815,1672680868,1672682727,1859
3798,3514971533,3770296583,1672665653,1672666908,1255
3620,3885121158,3393063657,1672684623,1672685023,400
3626,3714067076,3513410578,1672594964,1672597730,2766
3812,3491684096,3715707380,1672614753,1672616279,1526
3846,3770704999,3783373154,1672618560,1672620311,1751
3605,3516903528,3240994288,1672702163,1672702824,661
3871,3454277788,3300818269,1672578057,1672580777,2720
3631,3450969839,3793407963,1672618371,1672619008,637
3654,3897134762,3272030610,1672621557,1672624638,3081
3464,3779639983,3823084403,1672654078,1672654792,714
3645,3899326793,3615115210,1672587903,1672589374,1471
3558,3511601997,3556969573,1672683265,1672685104,1839
3661,3823084403,3890739241,1672628427,1672629504,1077
3573,3920898925,3513041785,1672550067,1672551586,1519
3539,3416987084,3923420131,1672541087,1672541523,436
3673,3311498666,3621184108,1672675345,1672677876,2531
3486,3440107959,3395201292,1672701375,1672703969,2594
3745,3505481368,3203538212,1672678628,1672680245,1617
3522,3515402792,3468041839,1672700448,1672703806,3358
3480,3624297844,3713784974,1672676104,1672677664,1560
3527,3225631197,3514419100,1672671660,1672674923,3263
3881,3554825448,3711218296,1672655496,1672655697,201
3576,3500672156,3367971170,1672543785,1672544302,517
3458,3760694096,3343132529,1672553217,1672555285,2068
3459,3778134418,3468041839,1672606361,1672607233,872
3437,3501121099,3614740489,1672589451,1672591744,2293
3561,3713517039,3711077927,1672671370,1672672825,1455
3748,3715127070,3421385957,1672662478,1672665641,3163
3726,3497671225,3446533960,1672606445,1672608408,1963
3721,3730071479,3511843593,1672598465,1672600077,1612
3786,3858172636,3438489358,1672615221,1672617005,1784
3589,3231713082,3516298579,1672673562,1672677059,3497
3865,3509756823,3618489670,1672540006,1672541723,1717
3676,3228888030,3701424609,1672703800,1672704548,748
3809,3811075491,3713561276,1672637593,1672640357,2764
3673,3241790910,3757193551,1672570716,1672573793,3077
3913,3401496246,3774178201,1672703010,1672704009,999
3751,3236499444,3713941638,1672629958,1672631498,1540
3915,3513345163,3839245934,1672532881,1672535730,2849
3607,3760924079,3780209375,1672559297,1672560131,834
3672,3513853403,3311420950,1672543136,1672544007,871
3749,3778134418,3505923418,1672675361,1672676191,830
3430,3366423342,3852533643,1672596479,1672599669,3190
3860,3933894942,3505521218,1672626925,1672629009,2084
3495,3364378127,3500915908,1672614546,1672616658,2112
3713,3276348699,3224330592,1672575886,1672578900,3014
3784,3773572967,3792489602,1672595665,1672595886,221
3658,3774243020,3710562338,1672696569,1672699220,2651
3498,3779639983,3825881598,1672621066,1672622207,1141
3749,3241790910,3713561276,1672684502,1672685661,1159
3444,3975717896,3379143440,1672674138,1672675079,941
3738,3514419100,3760362417,1672585580,1672588967,3387
3425,3505434346,3401793306,1672541610,1672544042,2432
3740,3714185969,3802932312,1672624441,1672627214,2773
3491,3284932450,3276269264,1672703787,1672705903,2116
3782,3701247948,3511024016,1672668778,1672669266,488
3512,3229822507,3296462324,1672565934,1672568427,2493
3528,3457960571,3703139663,1672588291,1672591561,3270
3639,3773124276,3500341755,1672640620,1672644147,3527
3605,3757193551,3778040015,1672666839,1672669135,2296
3788,3935487534,3500109249,1672579817,1672580837,1020
3565,3225631197,3716628503,1672696975,1672697088,113
3683,3774243020,3780338697,1672609492,1672612983,3491
3563,3814305099,3517358573,1672647984,1672649465,1481
3647,3622665543,3429943738,1672602550,1672604767,2217
3688,3283770991,3710735406,1672533953,1672534309,356
3721,3780571086,3916490839,1672614579,1672615069,490
3863,3836241528,3661903000,1672679849,1672683213,3364
3617,3614740489,3715127070,1672609972,1672611710,1738
3917,3920497528,3389634034,1672538849,1672541566,2717
3908,3631090677,3773033649,1672617764,1672618022,258
3678,3617489344,3714067076,1672677434,1672680134,2700
3792,3205985903,3736705719,1672591887,1672592185,298
3701,3791046864,3757700712,1672694690,1672697305,2615
3783,3229822507,3285204083,1672651767,1672653521,1754
3495,3245232284,3463740710,1672668008,1672670943,2935
3807,3773913680,3630353876,1672665812,1672667657,1845
3433,3501121099,3517222913,1672703950,1672707467,3517
3427,3533004959,3713589994,1672611739,1672615295,3556
3779,3970558632,3516489668,1672673795,1672675559,1764
3680,3445206685,3777037426,1672678752,1672679271,519
3723,3220031931,3505725706,1672620672,1672624163,3491
3905,3824215187,3774733620,1672700329,1672703753,3424
3515,3293835352,3514308235,1672691816,1672694455,2639
3708,3330340793,3660063072,1672543367,1672546795,3428
3538,3551389192,3519077659,1672558365,1672561553,3188
3440,3500208903,3880926355,1672596194,1672597043,849
3873,3774718695,3509366311,1672654503,1672657601,3098
3828,3520355798,3509366311,1672567775,1672568222,447
3671,3351866415,3334951866,1672607694,1672610663,2969
3457,3380130228,3479851674,1672598683,1672599618,935
3686,3774178201,3414940786,1672606555,1672607771,1216
3561,3512882178,3512946768,1672563414,1672563883,469
3742,3201676087,3607882826,1672642502,1672643308,806
3520,3519446663,3366423342,1672644664,1672644840,176
3498,3505179890,3505198734,1672594662,1672595710,1048
3578,3755065949,3515401243,1672593684,1672595102,1418
3569,3811075491,3972192593,1672683496,1672683697,201
3574,3701373490,3230135532,1672532384,1672533701,1317
3452,3394401087,3686523546,1672651505,1672652813,1308
3594,3755737419,3310039260,1672624339,1672627552,3213
3921,3512800570,3231494505,1672601618,1672604749,3131
3676,3760094385,3500841914,1672539054,1672541084,2030
3920,3715385401,3905196766,1672555806,1672556092,286
3724,3777189898,3713768950,1672697191,1672698989,1798
3583,3534175249,3515559913,1672558778,1672559100,322
3622,3701664364,3520115090,1672592246,1672594382,2136
3868,3411515369,3350095157,1672612237,1672614242,2005
3777,3513345163,3515525630,1672703232,1672703461,229
3506,3800257590,3517172354,1672672322,1672673243,921
3485,3517991730,3921648519,1672577495,1672577982,487
3716,3979802715,3383138270,1672663877,1672664522,645
3812,3394297564,3400069268,1672546430,1672548149,1719
3722,3970198861,3509756823,1672613522,1672617004,3482
3537,3737147209,3793407963,1672639078,1672640023,945
3906,3773913680,3510641433,1672538524,1672538861,337
3489,3357689359,3410160376,1672683372,1672685715,2343
3506,3710562338,3783340788,1672589910,1672590738,828
3446,3618808151,3510818674,1672613532,1672615492,1960
3681,3512337405,3298151889,1672547898,1672548448,550
3501,3783169442,3792389522,1672612013,1672614937,2924
3801,3609933747,3900945856,1672628328,1672631575,3247
3834,3757630221,3701424609,1672547379,1672550007,2628
3901,3757294769,3500857494,1672549910,1672553251,3341
3917,3350095157,3501215099,1672594960,1672595875,915
3630,3519416013,3774733620,1672544957,1672546547,1590
3546,3513296868,3343132529,1672634224,1672635258,1034
3458,3800257590,3431502855,1672603533,1672604382,849
3843,3457960571,3756789525,1672582859,1672585796,2937
3633,3500604680,3459681410,1672686226,1672689076,2850
3861,3519282716,3607768197,1672591003,1672592428,1425
3730,3774290799,3284947372,1672570388,1672572569,2181
3886,3511601997,3347446226,1672635033,1672636031,998
3662,3513853403,3337362061,1672684472,1672686053,1581
3451,3299781901,3604867757,1672621387,1672624265,2878
3474,3610870949,3501121099,1672567295,1672569000,1705
3762,3514956366,3615115210,1672588408,1672591342,2934
3903,3893912331,3533090502,1672692044,1672693271,1227
3509,3375449013,3777091903,1672675643,1672676308,665
3824,3350095157,3626499450,1672621488,1672622212,724
3487,3618354185,3513041785,1672631686,1672634255,2569
3645,3279473441,3363162590,1672538358,1672541344,2986
3482,3756385685,3713589994,1672679114,1672679263,149
3773,3703383853,3505178849,1672663492,1672665949,2457
3808,3305336154,3294703680,1672619214,1672620417,1203
3865,3460719322,3229974066,1672565403,1672565920,517
3497,3208957949,3201800997,1672574887,1672577538,2651
3919,3713691388,3480490124,1672553942,1672557103,3161
3669,3500709774,3615115210,1672677083,1672678567,1484
3917,3338083680,3770438122,1672577247,1672579322,2075
3429,3289114629,3469254160,1672560254,1672563591,3337
3832,3501567772,3316800320,1672697669,1672698921,1252
3883,3505995057,3357864626,1672586202,1672587165,963
3878,3428725843,3714128600,1672632157,1672634357,2200
3855,3520322124,3505521218,1672668511,1672670784,2273
3639,3776559988,3811075491,1672695237,1672696027,790
3721,3551389192,3760364383,1672603718,1672606611,2893
3455,3505228454,3240394404,1672636256,1672638430,2174
3872,3685681577,3518229776,1672598279,1672599212,933
3474,3270042456,3512337405,1672674692,1672675212,520
3800,3480726047,3533649454,1672552661,1672555233,2572
3644,3711637255,3480991549,1672552046,1672555084,3038
3692,3398731252,3505807416,1672702277,1672702945,668
3610,3227799827,3755404116,1672698658,1672698995,337
3442,3224811762,3271752081,1672596768,1672599498,2730
3542,3734118023,3770704999,1672611925,1672614086,2161
3618,3480490124,3808136029,1672621902,1672624110,2208
3627,3975717896,3715385401,1672584832,1672587803,2971
3520,3773121782,3511442562,1672553477,1672556930,3453
3884,3512958459,3604867757,1672631337,1672634297,2960
3730,3511005395,3409114719,1672578067,1672578719,652
3558,3777147510,3206837348,1672593634,1672596698,3064
3593,3396726504,3288224595,1672546377,1672547698,1321
3847,3410538749,3505847380,1672663446,1672665191,1745
3545,3390660440,3774876004,1672678250,1672678783,533
3545,3975717896,3415833929,1672588944,1672589708,764
3738,3533294425,3276269264,1672689700,1672690646,946
3632,3755573472,3509764635,1672592218,1672594627,2409
3486,3500777439,3783520186,1672566263,1672567717,1454
3828,3979802715,3817813340,1672672265,1672673162,897
3562,3501525100,3399518841,1672617041,1672620191,3150
3907,3511024016,3500737582,1672586449,1672589291,2842
3885,3279242917,3793315718,1672667923,1672668108,185
3680,3701005527,3760364383,1672691057,1672694134,3077
3829,3756746867,3926643445,1672677123,1672679421,2298
3433,3792505974,3608232640,1672641723,1672645185,3462
3775,3492959689,3792525861,1672567393,1672570155,2762
3909,3513545422,3713941638,1672676372,1672678138,1766
3515,3755756564,3667673649,1672648466,1672649462,996
3601,3457620713,3398198430,1672538350,1672541022,2672
3905,3770520359,3622357348,1672621733,1672622126,393
3767,3772391882,3884596900,1672684492,1672684760,268
3587,3880926355,3500949309,1672669521,1672670310,789
3599,3793922324,3520991398,1672635422,1672637511,2089
3921,3757332128,3664943873,1672676541,1672677340,799
3812,3520416075,3626499450,1672651369,1672652569,1200
3686,3554825448,3512337405,1672663922,1672666158,2236
3605,3437286517,3488686442,1672617210,1672619927,2717
3561,3715443333,3734118023,1672630435,1672633325,2890
3517,3778640261,3501525100,1672667076,1672670598,3522
3546,3897456874,3607768197,1672624686,1672627689,3003
3473,3686227677,3703433819,1672566410,1672569091,2681
3907,3738026330,3623266256,1672666877,1672669114,2237
3787,3792020993,3516489668,1672612931,1672615994,3063
3827,3300229945,3505521218,1672553854,1672557307,3453
3460,3500613493,3416987084,1672569203,1672572321,3118
3571,3972192593,3661903000,1672553555,1672555288,1733
3701,3916490839,3557046880,1672648458,1672651120,2662
3828,3500709774,3398198430,1672605428,1672608094,2666
3781,3401496246,3505228454,1672610409,1672613313,2904
3717,3701373490,3774605761,1672596516,1672598743,2227
3742,3736231757,3885155975,1672607791,1672610364,2573
3618,3920625129,3773124276,1672546509,1672548412,1903
3435,3711637255,3713561276,1672665862,1672668258,2396
3519,3400763927,3384068080,1672532003,1672533267,1264
3601,3803389195,3776244398,1672595981,1672597158,1177
3655,3280268483,3520115090,1672626758,1672629419,2661
3789,3780322355,3912891315,1672687331,1672687643,312
3705,3714827719,3501786419,1672539448,1672541151,1703
3438,3770468980,3715086894,1672690319,1672691758,1439
3475,3773572967,3203538212,1672664303,1672667691,3388
3791,3511843593,3757630221,1672637690,1672639967,2277
3646,3906536154,3448633776,1672629868,1672630984,1116
3815,3421877923,3495911207,1672612863,1672613307,444
3815,3792949946,3713163045,1672625132,1672627518,2386
3844,3701247948,3515402792,1672548185,1672549449,1264
3638,3858172636,3270056120,1672583610,1672584457,847
3757,3520355798,3226024417,1672698288,1672698804,516
3813,3306412634,3236354255,1672566346,1672566970,624
3721,3551399764,3206837348,1672599161,1672601730,2569
3612,3757348722,3774790271,1672650040,1672652548,2508
3626,3774243020,3497671225,1672594897,1672596845,1948
3609,3773939399,3421385957,1672631380,1672633353,1973
3795,3515559913,3518561777,1672643934,1672647014,3080
3654,3812534508,3551376095,1672554255,1672554407,152
3751,3792801638,3626499450,1672552120,1672554555,2435
3488,3624297844,3615115210,1672660329,1672662529,2200
3701,3808136029,3272096759,1672680471,1672683948,3477
3555,3557046880,3505437712,1672551216,1672553140,1924
3858,3716963089,3621683102,1672673095,1672675866,2771
3475,3533004959,3300229945,1672589282,1672592765,3483
3618,3516903528,3500915908,1672671601,1672674767,3166
3454,3364726656,3337322736,1672618206,1672619562,1356
3451,3200308999,3711077927,1672599738,1672600094,356
3795,3276348699,3757863420,1672604632,1672608190,3558
3833,3517222913,3515890966,1672688530,1672691189,2659
3714,3701005527,3760721303,1672586752,1672587307,555
3589,3456430614,3638204468,1672655114,1672657973,2859
3869,3380130228,3938503547,1672587165,1672589477,2312
3721,3552824113,3710854064,1672534385,1672534502,117
3558,3792489602,3757383891,1672693652,1672695030,1378
3708,3935399379,3826238375,1672646417,1672648742,2325
3449,3236354255,3732584121,1672701527,1672703887,2360
3850,3505402439,3774641380,1672598868,1672600019,1151
3680,3519909393,3513410578,1672678093,1672679013,920
3788,3556969573,3451326054,1672568742,1672569089,347
3563,3516741440,3360616538,1672647234,1672649392,2158
3753,3716272919,3311049964,1672555806,1672556826,1020
3742,3607768197,3776244398,1672625824,1672628494,2670
3809,3519446663,3779646172,1672698268,1672699607,1339
3601,3638660068,3351866415,1672635348,1672635865,517
3493,3885157459,3802932312,1672695958,1672696883,925
3614,3757903168,3226024417,1672699102,1672702627,3525
3792,3428027649,3517358573,1672668625,1672669549,924
3797,3777330107,3343816795,1672542730,1672546050,3320
3752,3615688740,3533423872,1672667284,1672667684,400
3484,3514285803,3779892400,1672537742,1672540099,2357
3473,3755992176,3853629553,1672588721,1672589233,512
3590,3517358573,3501786419,1672681606,1672683424,1818
3602,3812369928,3701664364,1672653108,1672655951,2843
3429,3383138270,3755737419,1672560022,1672562809,2787
3716,3450286949,3519087371,1672647149,1672649242,2093
3740,3683113954,3780338697,1672699659,1672700867,1208
3744,3836241528,3360813161,1672698010,1672700514,2504
3721,3778899160,3534357694,1672703061,1672705078,2017
3496,3315279093,3510554314,1672576424,1672579343,2919
3659,3777330107,3930242012,1672581602,1672583821,2219
3856,3779425804,3514703118,1672693599,1672695447,1848
3768,3408498208,3736231757,1672609054,1672611542,2488
3636,3392836218,3512800570,1672545681,1672547277,1596
3491,3760040019,3716963089,1672669841,1672671759,1918
3681,3284932450,3977352557,1672652486,1672654704,2218
3854,3895285664,3516703758,1672664678,1672667426,2748
3673,3660887799,3202804048,1672672481,1672674123,1642
3719,3451726367,3354144091,1672554707,1672556198,1491
3740,3500709774,3380982774,1672655623,1672656083,460
3887,3224968597,3357864626,1672675487,1672677550,2063
3910,3347419520,3414940786,1672617104,1672620208,3104
3495,3499217428,3715986185,1672627994,1672629155,1161
3717,3468041839,3376467719,1672601350,1672602393,1043
3675,3284947372,3380130228,1672616944,1672620293,3349
3913,3770236215,3520322124,1672660580,1672662731,2151
3871,3701373490,3904569677,1672653581,1672655310,1729
3510,3515466096,3737147209,1672598639,1672600548,1909
3902,3686523546,3779425804,1672618544,1672621757,3213
3833,3501215099,3399472693,1672654283,1672656615,2332
3824,3776117322,3385323994,1672613558,1672616866,3308
3562,3689114185,3470454332,1672652505,1672653644,1139
3523,3501121099,3811075491,1672532199,1672532485,286
3767,3285204083,3701322924,1672641546,1672642684,1138
3903,3408498208,3394297564,1672534869,1672535170,301
3912,3431502855,3293835352,1672678500,1672681249,2749
3840,3451691949,3485540729,1672652436,1672652645,209
3635,3512722110,3793418209,1672649148,1672650571,1423
3911,3224968597,3791693821,1672563229,1672566436,3207
3745,3519909393,3739154408,1672700702,1672701409,707
3818,3519909393,3970198861,1672653686,1672655689,2003
3823,3736705719,3510818674,1672570599,1672571376,777
3599,3608232640,3449333754,1672616926,1672617076,150
3816,3715443333,3513545422,1672685310,1672686253,943
3533,3350095157,3513081354,1672662436,1672663635,1199
3730,3437286517,3710854064,1672652200,1672652417,217
3903,3779425804,3713829743,1672598527,1672600565,2038
3642,3491469603,3272096759,1672664107,1672666606,2499
3744,3396980894,3783928182,1672547685,1672550455,2770
3773,3497671225,3300511067,1672671834,1672674355,2521
3827,3900945856,3309314379,1672619822,1672622595,2773
3648,3780909839,3885155975,1672676157,1672678553,2396
3458,3534126409,3500827202,1672679793,1672683040,3247
3527,3395201292,3923220461,1672544836,1672545783,947
3633,3835422146,3516298579,1672565365,1672567578,2213
3429,3776117322,3755233658,1672679326,1672682193,2867
3856,3897134762,3773837847,1672680236,1672683811,3575
3712,3513295938,3970558632,1672574780,1672575141,361
3496,3201676087,3899786664,1672660513,1672661756,1243
3753,3970558632,3512946768,1672595339,1672596216,877
3871,3512830734,3389634034,1672671627,1672673348,1721
3560,3501786419,3276217799,1672660990,1672662160,1170
3453,3770520359,3417191856,1672663833,1672667199,3366
3809,3622665543,3200308999,1672543402,1672544720,1318
3814,3552824113,3755065949,1672571997,1672572367,370
3909,3630353876,3293835352,1672685541,1672688244,2703
3743,3500347447,3755915206,1672660597,1672662599,2002
3694,3510028805,3977352557,1672567935,1672570614,2679
3458,3509764635,3500208903,1672577703,1672579998,2295
3529,3914691363,3615688740,1672560646,1672563379,2733
3922,3514512367,3414940786,1672574948,1672577580,2632
3921,3518653080,3792949946,1672693777,1672694344,567
3728,3773837847,3392943173,1672697968,1672700852,2884
3434,3236499444,3310039260,1672563253,1672564166,913
3651,3638660068,3505725706,1672587364,1672588828,1464
3647,3734915241,3714128600,1672563143,1672565971,2828
3714,3554186380,3333403880,1672644087,1672644989,902
3809,3437286517,3279475486,1672566200,1672568475,2275
3697,3533294425,3437286517,1672622209,1672622459,250
3871,3203538212,3244004456,1672595758,1672599282,3524
3774,3609113156,3505434346,1672575557,1672578765,3208
3436,3239617320,3688220326,1672656596,1672658538,1942
3805,3201676087,3505154885,1672582869,1672584041,1172
3716,3500672156,3824215187,1672575038,1672578035,2997
3889,3517881647,3617489344,1672684084,1672686850,2766
3724,3554825448,3534175249,1672537128,1672538360,1232
3869,3518229776,3774290799,1672658828,1672662115,3287
3463,3780872464,3774705415,1672592093,1672595063,2970
3734,3226024417,3619922891,1672595778,1672597727,1949
3515,3515439826,3294747828,1672586552,1672588801,2249
3596,3793935736,3792525861,1672665980,1672668397,2417
3812,3608855425,3305336154,1672632961,1672635667,2706
3477,3408430195,3791796585,1672636033,1672639449,3416
3688,3367509761,3516903528,1672536759,1672539925,3166
3631,3779532653,3241914067,1672596946,1672599845,2899
3451,3734118023,3421385957,1672647478,1672648818,1340
3803,3669146016,3513296868,1672596202,1672597360,1158
3450,3734915241,3375449013,1672597072,1672598411,1339
3881,3777694660,3349739136,1672669861,1672672418,2557
3762,3512722110,3505266860,1672645168,1672646922,1754
3601,3392943173,3510818674,1672663300,1672665585,2285
3790,3500827202,3770676872,1672623482,1672625444,1962
3732,3783550022,3551399764,1672645754,1672646545,791
3528,3554944414,3516903528,1672561206,1672562264,1058
3760,3757323954,3620292035,1672540774,1672544184,3410
3595,3776988674,3505923418,1672688311,1672690456,2145
3737,3279339278,3905196766,1672649459,1672650399,940
3505,3779301501,3779425804,1672698995,1672699520,525
3681,3513853403,3364378127,1672535170,1672536806,1636
3850,3472312341,3454277788,1672699130,1672701526,2396
3751,3703396825,3459681410,1672686216,1672688159,1943
3804,3612689556,3206837348,1672614101,1672616839,2738
3624,3273981374,3306412634,1672603457,1672606665,3208
3874,3792505974,3445206685,1672698666,1672699349,683
3643,3280268483,3272716462,1672680004,1672681772,1768
3425,3230135532,3316798920,1672695934,1672696171,237
3657,3386758279,3452016771,1672608929,1672609546,617
3659,3817428320,3773033649,1672663476,1672666977,3501
3729,3272716462,3713163045,1672537751,1672539845,2094
3910,3351696332,3500613459,1672545234,1672548347,3113
3475,3398731252,3514971533,1672578945,1672580375,1430
3785,3338083680,3519282716,1672695212,1672698667,3455
3840,3512383699,3760263530,1672664153,1672664868,715
3446,3333918941,3229974066,1672613501,1672614499,998
3821,3686227677,3902625986,1672607677,1672609814,2137
3792,3399472693,3757332128,1672681874,1672682541,667
3688,3501121099,3285204083,1672573815,1672574984,1169
3825,3513853403,3852533643,1672599344,1672602085,2741
3801,3401496246,3734118023,1672695566,1672697689,2123
3691,3520873221,3382733096,1672532439,1672535204,2765
3647,3491469603,3500709774,1672655134,1672655810,676
3846,3605221116,3779613523,1672584586,1672585684,1098
3737,3338083680,3270697740,1672649542,1672653091,3549
3442,3755230952,3938389661,1672593763,1672596623,2860
3500,3511601997,3920898925,1672571473,1672573507,2034
3847,3341893384,3783550022,1672691947,1672695037,3090
3570,3485540729,3770296583,1672574390,1672575129,739
3814,3792020993,3774605761,1672701627,1672704969,3342
3835,3520181148,3285204083,1672663520,1672663682,162
3480,3772078494,3791753345,1672617086,1672617636,550
3581,3491684096,3803517637,1672594900,1672596453,1553
3621,3383138270,3619922891,1672540092,1672543590,3498
3542,3620292035,3533747868,1672671570,1672675077,3507
3509,3491684096,3551389192,1672537144,1672540306,3162
3701,3909094917,3737112297,1672653798,1672655122,1324
3679,3334951866,3230868435,1672697435,1672699997,2562
3517,3757193551,3783641602,1672552854,1672556260,3406
3697,3668414677,3272030610,1672658591,1672660384,1793
3723,3448875382,3392836218,1672678560,1672681497,2937
3733,3777330107,3515402792,1672640837,1672643023,2186
3651,3363162590,3333918941,1672557367,1672559869,2502
3662,3899326793,3899786664,1672679853,1672679974,121
3631,3713768950,3615737355,1672597498,1672598299,801
3448,3714678331,3398731252,1672550828,1672551448,620
3531,3514419100,3500498112,1672676305,1672676901,596
3902,3760924079,3229822507,1672615444,1672618081,2637
3911,3500915665,3271454397,1672540807,1672543275,2468
3440,3384068080,3534566651,1672666961,1672667364,403
3638,3534175249,3512379024,1672555738,1672558267,2529
3456,3389634034,3731646673,1672585673,1672587724,2051
3709,3772078494,3715400486,1672681418,1672683619,2201
3650,3511601997,3778640261,1672620181,1672623649,3468
3570,3680810086,3488763230,1672604254,1672606649,2395
3468,3829864515,3284932450,1672591487,1672594486,2999
3702,3380767040,3386758279,1672548930,1672549105,175
3608,3621790707,3472068734,1672702154,1672703381,1227
3809,3756625818,3774031303,1672567074,1672567732,658
3814,3792442597,3533649454,1672542360,1672542879,519
3521,3783373154,3351866415,1672699803,1672703359,3556
3517,3515439826,3454277788,1672624541,1672627207,2666
3528,3713911104,3733363628,1672556511,1672557904,1393
3532,3811075491,3441703884,1672575311,1672578036,2725
3688,3928719932,3715400486,1672560155,1672560295,140
3806,3825881598,3760040019,1672638331,1672641239,2908
3808,3316800320,3780834916,1672614579,1672616625,2046
3666,3236354255,3923754072,1672609985,1672611081,1096
3866,3513327337,3701247948,1672584053,1672584342,289
3762,3824641227,3777624586,1672607559,1672608169,610
3893,3755233658,3392520516,1672595927,1672596818,891
3901,3714067076,3793743698,1672559523,1672562188,2665
3919,3512830734,3208957949,1672647593,1672650226,2633
3630,3501786419,3701424609,1672536746,1672539701,2955
3685,3904569677,3636329663,1672565337,1672566124,787
3553,3534126409,3209526819,1672607129,1672608161,1032
3908,3793922324,3777694660,1672697535,1672701047,3512
3440,3209526819,3803517637,1672590720,1672593440,2720
3856,3517222913,3392836218,1672566095,1672567599,1504
3867,3439673892,3701107228,1672606874,1672607354,480
3865,3770704999,3713691388,1672639748,1672642536,2788
3563,3501281016,3209526819,1672605245,1672605983,738
3631,3733558985,3783550022,1672626804,1672628549,1745
3850,3500302272,3716110860,1672602842,1672603095,253
3571,3410538749,3338390596,1672578674,1672578928,254
3841,3513065217,3756625818,1672645101,1672645690,589
3854,3516703758,3713768950,1672656921,1672659273,2352
3865,3613899351,3279242917,1672570196,1672571637,1441
3881,3897376951,3757903168,1672556654,1672558937,2283
3669,3230135532,3714678331,1672532230,1672534089,1859
3606,3303410628,3777814504,1672669337,1672672429,3092
3659,3231713082,3626499450,1672676536,1672677140,604
3650,3972192593,3533004959,1672612786,1672616087,3301
3676,3240394404,3607882826,1672643929,1672646656,2727
3863,3279242917,3791796585,1672538780,1672539369,589
3576,3505154885,3668747074,1672643667,1672644507,840
3570,3294703680,3360069849,1672589674,1672591101,1427
3796,3608855425,3780253901,1672577622,1672579566,1944
3516,3360813161,3711006062,1672605751,1672606135,384
3696,3600876425,3904412440,1672659386,1672661154,1768
3432,3379143440,3551389192,1672663195,1672665567,2372
3570,3284932450,3760651515,1672553041,1672554591,1550
3532,3511005395,3519077659,1672608330,1672610560,2230
3914,3818575661,3614740489,1672585360,1672588474,3114
3735,3343132529,3415833929,1672628351,1672630385,2034
3470,3533747868,3779301501,1672659692,1672662363,2671
3870,3236458894,3227799827,1672576463,1672577075,612
3612,3626499450,3402697190,1672696983,1672699886,2903
3704,3515525630,3513545422,1672600968,1672604363,3395
3913,3632814465,3534126409,1672554149,1672557511,3362
3485,3357689359,3511601997,1672566440,1672569777,3337
3780,3779854934,3701005527,1672637604,1672638413,809
3628,3246370118,3404025196,1672595679,1672598710,3031
3506,3350095157,3450286949,1672615687,1672618446,2759
3862,3519142371,3226511603,1672578660,1672581542,2882
3446,3299443125,3778640261,1672700361,1672702029,1668
3581,3357689359,3200543880,1672694110,1672694932,822
3671,3783163143,3231713082,1672621965,1672622480,515
3901,3793583656,3376467719,1672652980,1672656329,3349
3554,3791246640,3921648519,1672673389,1672676657,3268
3697,3774733620,3367971170,1672586601,1672589361,2760
3696,3791246640,3500302272,1672560889,1672562547,1658
3467,3500525825,3713163045,1672585496,1672586349,853
3565,3756625818,3534566651,1672540529,1672542395,1866
3504,3364726656,3604867757,1672694047,1672694303,256
3464,3604867757,3613899351,1672556798,1672560107,3309
3424,3510767239,3610358027,1672545480,1672549019,3539
3603,3505995057,3312998540,1672559380,1672559519,139
3749,3289114629,3777189898,1672659224,1672659664,440
3825,3625463628,3468041839,1672551018,1672551426,408
3646,3440107959,3374183227,1672636929,1672637826,897
3520,3713941638,3668747074,1672677358,1672679552,2194
3525,3710489491,3450286949,1672576112,1672579348,3236
3742,3701322924,3334951866,1672614205,1672615928,1723
3502,3779892400,3411688875,1672603748,1672606786,3038
3435,3293835352,3605221116,1672595504,1672596780,1276
3569,3491469603,3731646673,1672662886,1672664405,1519
3796,3390660440,3792949946,1672573296,1672576265,2969
3570,3511442562,3514285803,1672674740,1672676184,1444
3844,3520416075,3701424609,1672557079,1672557850,771
3529,3488763230,3780909839,1672676783,1672679106,2323
3684,3283144118,3921648519,1672586004,1672587345,1341
3728,3505995057,3783136330,1672565049,1672566324,1275
3634,3438078818,3792745809,1672623462,1672624305,843
3444,3305336154,3376467719,1672560212,1672563559,3347
3809,3755222916,3556969573,1672701766,1672702100,334
3664,3500709774,3300979975,1672603936,1672607270,3334
3439,3516321888,3783641602,1672570815,1672572054,1239
3813,3772078494,3815250107,1672587610,1672588296,686
3727,3622665543,3793969543,1672668394,1672670992,2598
3464,3852533643,3923754072,1672685559,1672688727,3168
3634,3380130228,3689114185,1672587588,1672590487,2899
3654,3534126409,3200543880,1672690700,1672690985,285
3827,3608922867,3793883863,1672614389,1672616100,1711
3842,3414049538,3783520186,1672582936,1672583134,198
3543,3462158237,3437286517,1672693689,1672695439,1750
3812,3354144091,3231494505,1672607038,1672609520,2482
3518,3475349791,3792442597,1672679988,1672680840,852
3851,3556969573,3462158237,1672697124,1672699947,2823
3811,3622357348,3533090502,1672560302,1672563587,3285
3641,3491469603,3621790707,1672654075,1672657493,3418
3600,3460719322,3701823816,1672601851,1672603126,1275
3794,3338390596,3773572967,1672656965,1672659437,2472
3547,3288762795,3834960360,1672567005,1672569692,2687
3524,3715545685,3454277788,1672696285,1672698699,2414
3766,3505725706,3710048469,1672667239,1672669037,1798
3526,3510798825,3456430614,1672662012,1672663556,1544
3530,3610358027,3284932450,1672568947,1672571001,2054
3681,3927403123,3715619259,1672569010,1672569306,296
3835,3619922891,3773913680,1672600737,1672601977,1240
3547,3371455553,3462636434,1672685298,1672685527,229
3910,3855583256,3396980894,1672632218,1672634581,2363
3447,3736231757,3440107959,1672616968,1672617623,655
3453,3780769110,3770624662,1672669935,1672670334,399
3743,3688490530,3774705415,1672614062,1672617317,3255
3685,3713589994,3780712350,1672628682,1672630491,1809
3475,3711812325,3716272919,1672667036,1672670596,3560
3875,3633735593,3713517039,1672644642,1672645035,393
3427,3738026330,3513410578,1672694758,1672695728,970
3525,3368283077,3885121158,1672534046,1672536695,2649
3563,3688490530,3280054198,1672585675,1672588876,3201
3729,3518565331,3686523546,1672612256,1672615085,2829
3441,3774290799,3517697722,1672654493,1672655459,966
3709,3500857494,3733558985,1672609495,1672611509,2014
3706,3815392801,3688796737,1672616779,1672619618,2839
3575,3777330107,3308760650,1672677125,1672679484,2359
3484,3715545685,3905899155,1672659876,1672663050,3174
3877,3756789525,3777147510,1672672266,1672673663,1397
3611,3783919913,3710048469,1672582367,1672585684,3317
3608,3519818818,3615115210,1672549838,1672550636,798
3449,3684523966,3803517637,1672609972,1672610544,572
3585,3512282789,3480100311,1672665767,1672668494,2727
3671,3777091903,3777189898,1672567714,1672570951,3237
3537,3912891315,3817813340,1672623184,1672626584,3400
3820,3289114629,3701882224,1672686574,1672688149,1575
3504,3713911104,3683113954,1672683856,1672686288,2432
3512,3396980894,3618697021,1672597103,1672600446,3343
3725,3410538749,3755756564,1672689737,1672691800,2063
3648,3315703693,3661583097,1672683845,1672686047,2202
3817,3713768950,3386758279,1672633635,1672634856,1221
3680,3244004456,3559731671,1672562277,1672562855,578
3905,3505154885,3500208903,1672687189,1672689684,2495
3444,3534175249,3714128600,1672685060,1672687459,2399
3526,3513327337,3226024417,1672656279,1672658115,1836
3513,3294703680,3731646673,1672554082,1672554226,144
3425,3780338697,3773939399,1672604758,1672608053,3295
3790,3512282789,3783919913,1672578953,1672582472,3519
3466,3244004456,3793407963,1672534730,1672537065,2335
3673,3661447322,3270697740,1672633708,1672635998,2290
3607,3279339278,3231494505,1672647133,1672650215,3082
3492,3703139663,3500613493,1672632700,1672634652,1952
3512,3533274994,3703433819,1672604220,1672606535,2315
3695,3517991730,3226178937,1672601641,1672604098,2457
3605,3800257590,3462158237,1672623344,1672626220,2876
3882,3505434346,3519087371,1672679897,1672681433,1536
3664,3554186380,3306175858,1672692199,1672695098,2899
3656,3777694660,3774641380,1672552163,1672554034,1871
3459,3478114114,3774243020,1672533220,1672536586,3366
3522,3515402792,3905196766,1672638892,1672640038,1146
3823,3520416075,3773033649,1672672109,1672674510,2401
3508,3200543880,3777694660,1672599323,1672600624,1301
3513,3554825448,3755737419,1672547936,1672551223,3287
3816,3757630221,3360813161,1672601101,1672603937,2836
3768,3920898925,3380130228,1672574285,1672576514,2229
3762,3926643445,3710489491,1672585135,1672586309,1174
3663,3505266860,3203538212,1672548071,1672551005,2934
3576,3710048469,3533090502,1672694025,1672697399,3374
3548,3730071479,3367111751,1672679407,1672681023,1616
3574,3299781901,3298151889,1672624458,1672625821,1363
3686,3760721303,3412968120,1672555425,1672558586,3161
3820,3463740710,3368283077,1672537919,1672539985,2066
3880,3778134418,3396726504,1672690580,1672693376,2796
3768,3533747868,3858172636,1672563610,1672566945,3335
3495,3904569677,3783928182,1672694257,1672697579,3322
3714,3349739136,3488763230,1672600938,1672603268,2330
3439,3713784974,3414275042,1672633996,1672635850,1854
3909,3519142371,3618489670,1672692185,1672693321,1136
3455,3472068734,3852533643,1672697400,1672700379,2979
3831,3240994288,3738026330,1672655515,1672656517,1002
3787,3923220461,3791046864,1672633072,1672634140,1068
3902,3732584121,3316800320,1672631540,1672632167,627
3465,3514512367,3891672228,1672615682,1672616888,1206
3530,3631479562,3505154885,1672555577,1672556494,917
3437,3559458968,3703383853,1672628951,1672630645,1694
3773,3447514821,3735374579,1672539375,1672542870,3495
3830,3665998641,3760651515,1672644499,1672645862,1363
3765,3512379024,3783550022,1672658279,1672659796,1517
3756,3783641602,3513327337,1672628412,1672628826,414
3596,3410600350,3505283390,1672626602,1672628785,2183
3576,3755222916,3774243020,1672701244,1672701967,723
3844,3534175249,3621790707,1672535993,1672538661,2668
3448,3403370192,3416987084,1672673555,1672676549,2994
3871,3455018347,3389634034,1672603104,1672606083,2979
3764,3713691388,3226511603,1672618061,1672621414,3353
3888,3296462324,3511843593,1672699977,1672701084,1107
3603,3920898925,3241914067,1672569814,1672570198,384
3734,3770236215,3519909393,1672586202,1672589203,3001
3916,3500072204,3534764451,1672699045,1672700298,1253
3618,3510187271,3501786419,1672578342,1672579233,891
3920,3236499444,3516321888,1672702205,1672704701,2496
3759,3274831810,3351696332,1672548425,1672550783,2358
3514,3825881598,3515559913,1672621826,1672621972,146
3511,3791441520,3533004959,1672686828,1672688144,1316
3633,3203538212,3885537225,1672600963,1672602603,1640
3504,3604867757,3760842815,1672612717,1672615825,3108
3724,3512392431,3755230952,1672651326,1672654376,3050
3672,3972083617,3701823816,1672607601,1672610277,2676
3699,3880926355,3450969839,1672575481,1672575583,102
3901,3201629017,3902861231,1672612851,1672616225,3374
3868,3715385401,3472312341,1672667400,1672669381,1981
3525,3533649454,3732131656,1672603779,1672607157,3378
3614,3479851674,3424445495,1672605471,1672606935,1464
3669,3613206049,3774178201,1672624637,1672626506,1869
3616,3315703693,3380982774,1672582904,1672584066,1162
3586,3853629553,3206837348,1672542150,1672544305,2155
3841,3773735484,3470454332,1672633948,1672637331,3383
3685,3859868849,3621184108,1672542431,1672545704,3273
3812,3478114114,3512392431,1672634063,1672637208,3145
3876,3335694356,3424445495,1672587061,1672588077,1016
3464,3349856820,3334974375,1672625448,1672628758,3310
3597,3661447322,3505634634,1672691097,1672692948,1851
3713,3639050419,3755496114,1672674732,1672677236,2504
3688,3780909839,3424660806,1672573095,1672574024,929
3565,3711006062,3755848152,1672633675,1672635589,1914
3881,3279242917,3701823816,1672590597,1672592737,2140
3464,3625463628,3620292035,1672680995,1672681746,751
3784,3773121782,3600876425,1672637547,1672638231,684
3607,3401940259,3311098437,1672672918,1672673040,122
3455,3779656423,3774178201,1672584769,1672588142,3373
3612,3668533536,3710562338,1672686815,1672690270,3455
3710,3611055563,3511601997,1672620423,1672623468,3045
3879,3520416075,3757700712,1672683472,1672685751,2279
3485,3364726656,3517462308,1672614658,1672616689,2031
3779,3770236215,3701247948,1672667724,1672671026,3302
3783,3271454397,3289114629,1672596577,1672598238,1661
3913,3417679834,3511843593,1672617647,1672620672,3025
3645,3534175249,3885155975,1672568862,1672571705,2843
3727,3492959689,3492546679,1672663848,1672664422,574
3921,3808136029,3713911104,1672694891,1672697717,2826
3685,3279339278,3855583256,1672626851,1672627231,380
3652,3394401087,3793418209,1672609346,1672609477,131
3721,3441703884,3229974066,1672544600,1672545437,837
3802,3225636215,3710048469,1672534284,1672535321,1037
3551,3514334067,3783928182,1672647284,1672649311,2027
3566,3446533960,3887243870,1672667297,1672670340,3043
3910,3294747828,3511150845,1672700492,1672703526,3034
3796,3225631197,3490029863,1672545672,1672547457,1785
3868,3229822507,3890739241,1672670251,1672671272,1021
3601,3296462324,3612689556,1672602493,1672603107,614
3780,3772078494,3241790910,1672625162,1672626314,1152
3892,3780322355,3773027597,1672593205,1672595606,2401
3563,3450969839,3308760650,1672544403,1672545333,930
3822,3732131656,3774641380,1672617989,1672619660,1671
3775,3505111292,3703139663,1672620130,1672621809,1679
3831,3772236797,3283492940,1672636491,1672636725,234
3839,3408498208,3733363628,1672579345,1672581749,2404
3852,3511288998,3440107959,1672670881,1672671913,1032
3838,3774718695,3271454397,1672678749,1672682092,3343
3458,3615688740,3927165965,1672577415,1672579240,1825
3802,3520560590,3479851674,1672650478,1672651232,754
3709,3410160376,3703396825,1672667155,1672670174,3019
3626,3792505974,3497671225,1672564872,1672565083,211
3592,3770520359,3760094385,1672541158,1672541843,685
3565,3500703304,3455018347,1672563191,1672564027,836
3608,3438078818,3737112297,1672639225,1672640386,1161
3517,3611055563,3900898992,1672622485,1672624885,2400
3890,3501281016,3625463628,1672552755,1672553040,285
3790,3305722859,3220031931,1672537192,1672538821,1629
3592,3935913584,3607882826,1672628646,1672631933,3287
3666,3923754072,3559731671,1672619476,1672622648,3172
3555,3770704999,3518653080,1672582057,1672585572,3515
3628,3770236215,3880926355,1672553727,1672555027,1300
3761,3902861231,3905196766,1672595693,1672597953,2260
3659,3518565331,3451726367,1672548503,1672551911,3408
3542,3755756564,3791753345,1672592977,1672594410,1433
3839,3519850727,3241790910,1672550208,1672550814,606
3881,3885537225,3338083680,1672594664,1672597571,2907
3471,3518561777,3382733096,1672587557,1672590201,2644
3719,3925979970,3519909393,1672637189,1672639595,2406
3494,3703139663,3715127070,1672667976,1672668168,192
3634,3756127300,3514512367,1672612928,1672614582,1654
3677,3516741440,3534829213,1672605298,1672607136,1838
3872,3512722110,3777240360,1672631201,1672634345,3144
3703,3977352557,3493017654,1672623068,1672625312,2244
3590,3511005395,3300511067,1672677117,1672677558,441
3635,3817813340,3435167810,1672677084,1672679750,2666
3536,3774178201,3801645328,1672611462,1672613263,1801
3616,3534566651,3520639768,1672615200,1672615851,651
3774,3793418209,3755848152,1672588409,1672591033,2624
3560,3308760650,3783801141,1672590665,1672590990,325
3621,3364726656,3364726656,1672625264,1672627245,1981
3718,3380767040,3780472203,1672669227,1672671314,2087
3592,3757193551,3495911207,1672607441,1672607557,116
3581,3825881598,3364726656,1672576951,1672577210,259
3711,3554186380,3800257590,1672629786,1672631625,1839
3880,3755344363,3431460073,1672618001,1672619257,1256
3769,3229974066,3500672156,1672546906,1672547176,270
3776,3202804048,3713768950,1672541284,1672541488,204
3880,3551376095,3783928182,1672573372,1672576297,2925
3720,3971806004,3533090502,1672582493,1672583598,1105
3655,3515402792,3615087943,1672660725,1672662225,1500
3784,3385323994,3280054198,1672675994,1672676452,458
3800,3505434346,3701373490,1672693286,1672694553,1267
3794,3773124276,3774243020,1672645859,1672649291,3432
3654,3447672935,3519028898,1672581041,1672581335,294
3653,3776831527,3516489668,1672650077,1672650905,828
3594,3661583097,3624297844,1672596579,1672597620,1041
3728,3793935736,3757193551,1672666613,1672667999,1386
3466,3533929349,3715400486,1672546390,1672548395,2005
3883,3619922891,3533079336,1672660672,1672664205,3533
3521,3509756823,3499217428,1672647413,1672648162,749
3830,3777779869,3834963772,1672613816,1672614372,556
3845,3891672228,3380982774,1672542811,1672544956,2145
3851,3715400486,3519087371,1672605816,1672609390,3574
3893,3779425804,3315703693,1672612131,1672614208,2077
3513,3783163143,3501786419,1672599910,1672602919,3009
3895,3970909253,3915162005,1672548520,1672549929,1409
3795,3303410628,3852533643,1672666749,1672669611,2862
3690,3701823816,3510641433,1672564414,1672567042,2628
3676,3279475486,3899786664,1672603434,1672605484,2050
3869,3899326793,3715986185,1672659427,1672661390,1963
3728,3812534508,3416987084,1672694737,1672695497,760
3844,3926643445,3349856820,1672549824,1672551644,1820
3602,3274906650,3533649454,1672612356,1672615424,3068
3623,3517222913,3300229945,1672610310,1672611712,1402
3750,3834631333,3685816610,1672641763,1672644362,2599
3544,3492546679,3533228966,1672701022,1672703213,2191
3469,3938389661,3792489602,1672550469,1672554051,3582
3908,3636329663,3792801638,1672684045,1672684773,728
3841,3500672156,3755915206,1672591839,1672593594,1755
3543,3379143440,3713300120,1672615976,1672616613,637
3722,3793743698,3515525630,1672552716,1672554697,1981
3749,3975717896,3683113954,1672638705,1672639068,363
3683,3909094917,3615688740,1672562400,1672564165,1765
3497,3513065217,3288762795,1672667488,1672667710,222
3912,3513360004,3384583385,1672594214,1672597019,2805
3506,3454277788,3970627281,1672666800,1672669200,2400
3883,3380982774,3776988674,1672658927,1672661640,2713
3795,3500317969,3500841914,1672640528,1672643183,2655
3785,3347419520,3757075324,1672633049,1672635374,2325
3787,3791128487,3755344363,1672670663,1672672550,1887
3614,3778926763,3793175445,1672624439,1672625146,707
3732,3776559988,3880926355,1672534330,1672535126,796
3559,3510837901,3680810086,1672661607,1672664603,2996
3776,3713163045,3812534508,1672603169,1672606297,3128
3497,3776559988,3779938251,1672566021,1672566165,144
3661,3713589994,3897376951,1672533414,1672536313,2899
3568,3770146716,3285204083,1672550035,1672553186,3151
3594,3892304880,3618697021,1672604123,1672604811,688
3625,3510028805,3337362061,1672703596,1672704726,1130
3627,3755230952,3715974659,1672664018,1672666706,2688
3438,3703383853,3770146716,1672550998,1672551509,511
3524,3834960360,3930242012,1672576682,1672577755,1073
3571,3500703304,3394297564,1672587140,1672587521,381
3538,3756127300,3774718695,1672637924,1672639649,1725
3739,3909094917,3349856820,1672642529,1672642943,414
3562,3511883730,3667427125,1672638266,1672641523,3257
3864,3800257590,3270697740,1672586701,1672588712,2011
3670,3310039260,3715854030,1672547488,1672549446,1958
3466,3517172354,3711006062,1672631868,1672634279,2411
3432,3513065217,3382733096,1672551620,1672552506,886
3492,3660063072,3773027597,1672612340,1672613750,1410
3920,3736705719,3451726367,1672558331,1672560941,2610
3705,3686227677,3500709774,1672533106,1672534318,1212
3468,3905899155,3617392620,1672616659,1672619995,3336
3687,3791436104,3509756823,1672674267,1672674662,395
3921,3900945856,3492546679,1672620635,1672620876,241
3534,3632814465,3713768950,1672626885,1672629663,2778
3667,3501525100,3711218296,1672699064,1672700832,1768
3564,3367509761,3505111292,1672543454,1672545290,1836
3511,3773121782,3500949309,1672686618,1672687363,745
3696,3513545422,3514285803,1672564636,1672566870,2234
3601,3604867757,3715986185,1672617148,1672617798,650
3613,3513296868,3225636215,1672669848,1672670271,423
3922,3928511283,3517737088,1672678525,1672681665,3140
3496,3610358027,3850911686,1672622277,1672624001,1724
3510,3379143440,3514334067,1672605158,1672606402,1244
3879,3772765746,3779656423,1672593144,1672594073,929
3778,3201629017,3400069268,1672596157,1672598280,2123
3756,3479851674,3715974659,1672630863,1672632723,1860
3906,3470454332,3889780657,1672547811,1672550657,2846
3464,3859868849,3299443125,1672622378,1672623860,1482
3629,3780909839,3380767040,1672622221,1672624972,2751
3493,3519909393,3905899155,1672702902,1672704055,1153
3491,3783147088,3617116290,1672610047,1672612933,2886
3823,3533188828,3774605761,1672589208,1672590635,1427
3753,3774876004,3711734586,1672611422,1672612349,927
3524,3274831810,3811040565,1672561393,1672564763,3370
3917,3478114114,3201800997,1672700611,1672701450,839
3691,3757318448,3515401243,1672551784,1672553955,2171
3747,3312998540,3734451191,1672611807,1672613376,1569
3633,3778134418,3661903000,1672645122,1672646677,1555
3642,3229974066,3738026330,1672570931,1672571934,1003
3804,3436025562,3783919913,1672597769,1672599580,1811
3753,3773033649,3519087371,1672592024,1672593740,1716
3711,3417679834,3492546679,1672576517,1672580109,3592
3529,3792949946,3292147449,1672702351,1672705564,3213
3473,3791246640,3819767045,1672561100,1672561526,426
3787,3424445495,3715854030,1672620118,1672623620,3502
3759,3715443333,3617392620,1672557380,1672558574,1194
3465,3488686442,3366423342,1672598903,1672600969,2066
3546,3835985172,3778597171,1672661098,1672664020,2922
3566,3792389522,3777037426,1672688644,1672689747,1103
3454,3777779869,3517687662,1672601797,1672602214,417
3538,3783801141,3829822608,1672669288,1672670617,1329
3465,3533368789,3739154408,1672617878,1672620996,3118
3596,3904569677,3274906650,1672602860,1672605823,2963
3782,3552824113,3829864515,1672629916,1672630680,764
3687,3780209375,3683113954,1672567501,1672570036,2535
3762,3777184389,3396980894,1672660913,1672663584,2671
3781,3509764635,3701322924,1672690352,1672691806,1454
3487,3667673649,3300511067,1672619343,1672619930,587
3889,3760362417,3276217799,1672668134,1672669614,1480
3630,3516903528,3668747074,1672654008,1672656685,2677
3750,3446533960,3239617320,1672569001,1672572170,3169
3822,3438078818,3777037426,1672576344,1672578314,1970
3507,3783433404,3923420131,1672594770,1672595539,769
3903,3516741440,3224968597,1672643966,1672644115,149
3673,3511732493,3757193551,1672668161,1672668899,738
3892,3713979100,3205923620,1672692446,1672693903,1457
3822,3480726047,3370068529,1672671453,1672672499,1046
3520,3505888598,3500347447,1672575792,1672576696,904
3918,3520873221,3276348699,1672623786,1672624822,1036
3727,3688796737,3505663516,1672569769,1672572262,2493
3426,3779892400,3514741348,1672548641,1672550772,2131
3623,3780712350,3517462308,1672608054,1672611365,3311
3848,3448633776,3467988782,1672536467,1672537247,780
3484,3778040015,3283144118,1672675005,1672677389,2384
3921,3618697021,3445206685,1672698979,1672700329,1350
3761,3732131656,3617392620,1672533420,1672533830,410
3728,3227799827,3773902805,1672699418,1672701155,1737
3672,3608922867,3392943173,1672577669,1672579158,1489
3671,3710854064,3755158925,1672637916,1672639886,1970
3643,3772236797,3900898992,1672646861,1672647340,479
3687,3505481368,3380982774,1672536608,1672539495,2887
3598,3516489668,3315279093,1672655315,1672658133,2818
3436,3514956366,3668414677,1672696087,1672697954,1867
3473,3437286517,3414275042,1672564630,1672566399,1769
3619,3208452238,3517737088,1672535844,1672539042,3198
3544,3791753345,3202141727,1672566708,1672569151,2443
3803,3776831527,3276003502,1672661449,1672662708,1259
3494,3858172636,3778597171,1672621600,1672622738,1138
3840,3627368399,3834631333,1672547304,1672549914,2610
3795,3438078818,3826238375,1672664526,1672666244,1718
3492,3686227677,3203538212,1672624640,1672625077,437
3534,3514285803,3294747828,1672693726,1672695487,1761
3426,3505179890,3713163045,1672557624,1672559729,2105
3752,3312998540,3770296583,1672637195,1672640623,3428
3433,3683113954,3826238375,1672612965,1672614154,1189
3671,3625463628,3319167958,1672547612,1672550920,3308
3732,3497095254,3514971533,1672639960,1672643487,3527
3630,3928719932,3713589994,1672632260,1672634504,2244
3821,3783433404,3777694660,1672620743,1672622799,2056
3673,3373089838,3500109249,1672562775,1672563018,243
3550,3688490530,3680843171,1672588853,1672591637,2784
3891,3684523966,3357864626,1672534315,1672537609,3294
3842,3512383699,3392836218,1672579059,1672580038,979
3895,3373089838,3351696332,1672533829,1672535879,2050
3517,3315703693,3480100311,1672636912,1672639068,2156
3643,3622665543,3779613523,1672570011,1672570726,715
3515,3283144118,3935487534,1672542684,1672545412,2728
3494,3791693821,3774243020,1672573063,1672576349,3286
3797,3783550022,3715707380,1672688824,1672690450,1626
3799,3755233658,3607768197,1672608186,1672610714,2528
3826,3414049538,3755344363,1672546859,1672548255,1396
3543,3462158237,3972083617,1672584840,1672586365,1525
3710,3772078494,3512502036,1672612439,1672615271,2832
3789,3505481368,3714233826,1672593848,1672595050,1202
3815,3518194482,3780209375,1672633349,1672636327,2978
3622,3703433819,3291933594,1672538608,1672540992,2384
3679,3241790910,3338083680,1672686668,1672688263,1595
3891,3240394404,3756625818,1672535923,1672537221,1298
3762,3621790707,3777485931,1672677110,1672680563,3453
3599,3777330107,3367971170,1672564296,1672565520,1224
3510,3636329663,3518229776,1672690999,1672693163,2164
3674,3516513251,3417191856,1672594624,1672597984,3360
3892,3791046864,3755915206,1672693253,1672695659,2406
3507,3757193307,3779532653,1672622003,1672622804,801
3517,3661447322,3732584121,1672581533,1672584321,2788
3786,3500777439,3852533643,1672634994,1672635392,398
3748,3499217428,3921648519,1672697697,1672699439,1742
3856,3755222916,3835985172,1672567692,1672571039,3347
3916,3760645796,3715086894,1672604882,1672608347,3465
3529,3500915908,3519909393,1672630195,1672632289,2094
3482,3511317276,3467988782,1672665732,1672666661,929
3708,3974674109,3520657891,1672541272,1672542379,1107
3881,3755065949,3711637255,1672653055,1672653136,81
3709,3392520516,3736231757,1672568133,1672569241,1108
3613,3970909253,3778134418,1672620709,1672623325,2616
3644,3347446226,3859868849,1672597048,1672597921,873
3783,3792014516,3511883730,1672548209,1672550982,2773
3770,3511843593,3511317276,1672591937,1672593161,1224
3450,3923420131,3811040565,1672646709,1672649078,2369
3651,3776988674,3230868435,1672575218,1672578438,3220
3509,3779425804,3770296583,1672684144,1672684349,205
3594,3734451191,3518194482,1672611351,1672612563,1212
3604,3335694356,3975717896,1672564582,1672567644,3062
3880,3777485931,3369708250,1672556834,1672560058,3224
3766,3615939504,3480100311,1672534361,1672537889,3528
3757,3367971170,3401940259,1672542893,1672544858,1965
3918,3306175858,3755404116,1672596512,1672598499,1987
3427,3514512367,3905196766,1672587771,1672587899,128
3516,3349739136,3756385685,1672630120,1672631203,1083
3799,3783641602,3613206049,1672685890,1672686322,432
3826,3452016771,3379143440,1672642249,1672644924,2675
3602,3755404116,3533274994,1672638492,1672641514,3022
3592,3923220461,3380130228,1672639696,1672640768,1072
3783,3437286517,3776518452,1672682001,1672684005,2004
3515,3793743698,3505179890,1672622086,1672623689,1603
3555,3501567772,3853629553,1672687259,1672688212,953
3843,3783641602,3241790910,1672689846,1672692629,2783
3837,3757294769,3385323994,1672610501,1672611318,817
3460,3500709774,3770296583,1672570922,1672572544,1622
3698,3757193551,3900945856,1672602942,1672605221,2279
3789,3975717896,3534179433,1672575147,1672578228,3081
3614,3821054646,3738026330,1672684777,1672688155,3378
3876,3533079336,3370068529,1672585172,1672588668,3496
3588,3495911207,3367111751,1672591834,1672595179,3345
3649,3770146716,3780872464,1672567972,1672570519,2547
3482,3500915908,3772765746,1672647243,1672649996,2753
3750,3505995057,3776084820,1672612249,1672614581,2332
3701,3382733096,3291933594,1672689155,1672690784,1629
3595,3421385957,3755065949,1672539504,1672541374,1870
3860,3441348818,3463740710,1672582465,1672582547,82
3480,3200308999,3533090502,1672643604,1672646739,3135
3793,3517288083,3783550022,1672566126,1672568506,2380
3857,3715400486,3916490839,1672535786,1672536638,852
3631,3636329663,3683113954,1672545838,1672546850,1012
3796,3512722110,3270042456,1672546197,1672546549,352
3425,3236354255,3511883730,1672608384,1672610685,2301
3891,3808136029,3304971369,1672596991,1672600179,3188
3579,3734915241,3404025196,1672598807,1672600454,1647
3801,3515525630,3605221116,1672539106,1672542443,3337
3776,3440137407,3714827719,1672669626,1672670604,978
3480,3230868435,3756746867,1672662243,1672665750,3507
3545,3638204468,3505725706,1672641593,1672643879,2286
3786,3608855425,3534357694,1672541180,1672542448,1268
3627,3776518452,3336627643,1672565026,1672566796,1770
3842,3517991730,3485540729,1672533350,1672534600,1250
3837,3520181148,3783919913,1672669820,1672671950,2130
3900,3472068734,3801645328,1672569988,1672571021,1033
3565,3283492940,3977148669,1672683820,1672684849,1029
3874,3715127070,3783373154,1672657096,1672658887,1791
3853,3511150845,3779656423,1672553357,1672555515,2158
3533,3688220326,3714670620,1672699003,1672699573,570
3574,3279473441,3793922324,1672584638,1672586070,1432
3445,3505111292,3556969573,1672601513,1672603950,2437
3901,3778640261,3492546679,1672651492,1672653143,1651
3810,3714666884,3792745809,1672651585,1672654625,3040
3842,3500915665,3669146016,1672633749,1672634600,851
3827,3500777439,3519850727,1672583486,1672586513,3027
3609,3710496785,3711812325,1672663124,1672666622,3498
3738,3757318448,3534175249,1672621088,1672622942,1854
3550,3773735484,3534829213,1672597217,1672599615,2398
3590,3776518452,3285204083,1672604043,1672607280,3237
3871,3661903000,3624297844,1672610109,1672611062,953
3638,3604867757,3501459390,1672641519,1672642551,1032
3658,3821054646,3783928182,1672700156,1672701424,1268
3532,3436025562,3703383853,1672557222,1672560192,2970
3566,3607882826,3401793306,1672590806,1672591553,747
3634,3904412440,3815392801,1672703455,1672703850,395
3885,3228888030,3777037426,1672684628,1672687712,3084
3778,3311085279,3710735406,1672654678,1672657365,2687
3877,3480100311,3757193307,1672610941,1672611072,131
3669,3513410578,3357689359,1672678239,1672680615,2376
3573,3783919913,3780712350,1672545974,1672546568,594
3556,3730071479,3772078494,1672561248,1672564150,2902
3743,3398198430,3757630221,1672591238,1672592308,1070
3588,3300979975,3371455553,1672617199,1672619298,2099
3536,3335694356,3511005395,1672531513,1672532112,599
3570,3714678331,3925979970,1672589201,1672589333,132
3847,3839245934,3500498112,1672635274,1672638809,3535
3623,3512499658,3518565331,1672657106,1672659232,2126
3746,3776988674,3501281016,1672599582,1672601217,1635
3889,3385323994,3463849738,1672586631,1672587281,650
3465,3392836218,3515890966,1672557062,1672558539,1477
3838,3661583097,3792801638,1672610098,1672613116,3018
3726,3912891315,3735374579,1672545715,1672547544,1829
3809,3394297564,3688490530,1672631980,1672634422,2442
3656,3779854934,3349856820,1672564753,1672567158,2405
3447,3716272919,3887243870,1672581227,1672582084,857
3549,3220031931,3288224595,1672618017,1672618206,189
3603,3733558985,3920625129,1672535531,1672537877,2346
3569,3773902805,3396726504,1672686405,1672687815,1410
3522,3778899160,3893912331,1672635943,1672638312,2369
3822,3534175249,3240994288,1672646975,1672648026,1051
3587,3701322924,3402385957,1672575372,1672575768,396
3587,3731646673,3511883730,1672640313,1672641587,1274
3765,3500109249,3510919821,1672664019,1672666892,2873
3815,3777037426,3408498208,1672612314,1672613984,1670
3482,3393063657,3244004456,1672534165,1672536897,2732
3789,3760651515,3779854934,1672699597,1672701275,1678
3687,3793781065,3668747074,1672689094,1672689230,136
3843,3298151889,3774907131,1672632612,1672635989,3377
3699,3393063657,3208452238,1672689210,1672690621,1411
3465,3491684096,3778640261,1672680377,1672681821,1444
3795,3737112297,3636329663,1672671545,1672672911,1366
3639,3292147449,3733363628,1672606853,1672607067,214
3547,3515439826,3415833929,1672618629,1672619196,567
3646,3904569677,3428027649,1672696105,1672699228,3123
3792,3770296583,3757294769,1672694594,1672697131,2537
3821,3661903000,3334647380,1672561454,1672563205,1751
3906,3893912331,3779532653,1672535415,1672537525,2110
3614,3448633776,3412968120,1672626089,1672626966,877
3625,3514956366,3624297844,1672550862,1672552406,1544
3667,3780571086,3513018485,1672536001,1672536488,487
3682,3716628503,3889780657,1672681916,1672684428,2512
3485,3224968597,3755532873,1672551312,1672554137,2825
3562,3624297844,3774155692,1672612187,1672613375,1188
3742,3900945856,3609659642,1672654683,1672655533,850
3426,3773837847,3505178849,1672537381,1672540809,3428
3603,3519651506,3315279093,1672630066,1672633502,3436
3609,3713589994,3755222916,1672576088,1672578022,1934
3458,3276348699,3283144118,1672703761,1672706810,3049
3828,3386758279,3773009828,1672604615,1672605724,1109
3663,3511883730,3399472693,1672628815,1672629350,535
3737,3776518452,3357864626,1672573477,1672575763,2286
3812,3201800997,3626499450,1672684008,1672684544,536
3706,3934064792,3664943873,1672550276,1672552988,2712
3580,3756704774,3520355798,1672637235,1672640120,2885
3442,3520657891,3714067076,1672531832,1672534983,3151
3595,3931627862,3836241528,1672598142,1672599410,1268
3855,3512882178,3505434346,1672695550,1672697771,2221
3566,3372223551,3783520186,1672605515,1672605628,113
3464,3853629553,3514308235,1672647195,1672648727,1532
3533,3755915206,3736231757,1672637009,1672639383,2374
3772,3636329663,3829864515,1672602719,1672604220,1501
3764,3384068080,3520657891,1672621727,1672623276,1549
3762,3778040015,3463849738,1672650203,1672650588,385
3527,3624297844,3512882178,1672642091,1672643253,1162
3624,3519087371,3519142371,1672643250,1672646079,2829
3434,3633735593,3500072204,1672622970,1672624721,1751
3739,3513345163,3364726656,1672552291,1672555303,3012
3816,3760364383,3414049538,1672538973,1672541594,2621
3496,3735374579,3338390596,1672599249,1672601583,2334
3812,3343132529,3859868849,1672691757,1672693014,1257
3431,3713300120,3814305099,1672545509,1672548029,2520
3842,3511601997,3686523546,1672699669,1672701581,1912
3910,3518229776,3500737582,1672570024,1672571290,1266
3517,3803389195,3518229776,1672652820,1672655496,2676
3437,3824215187,3821054646,1672642095,1672643350,1255
3785,3349739136,3710562338,1672563153,1672563836,683
3617,3501459390,3979784676,1672581432,1672582418,986
3781,3711734586,3410600350,1672660222,1672662365,2143
3765,3618354185,3853629553,1672552734,1672555315,2581
3783,3354144091,3519282716,1672564131,1672565157,1026
3674,3205985903,3448633776,1672539347,1672540721,1374
3732,3737112297,3400069268,1672590292,1672591753,1461
3452,3776831527,3300511067,1672688227,1672691447,3220
3647,3511150845,3793583656,1672544100,1672546568,2468
3709,3448875382,3372223551,1672559409,1672561301,1892
3773,3283492940,3734451191,1672575229,1672578741,3512
3656,3621683102,3791613604,1672698322,1672700203,1881
3609,3770520359,3408430195,1672568700,1672569160,460
3490,3757193307,3478114114,1672684883,1672687968,3085
3723,3551399764,3294747828,1672666166,1672668442,2276
3857,3899786664,3335694356,1672553671,1672554261,590
3539,3505111292,3201800997,1672649312,1672650778,1466
3436,3224330592,3605221116,1672652886,1672654387,1501
3837,3347419520,3682133690,1672533990,1672534505,515
3829,3610870949,3200308999,1672674223,1672677720,3497
3573,3906536154,3414275042,1672581710,1672584870,3160
3492,3461119815,3920625129,1672546311,1672548021,1710
3518,3392836218,3970558632,1672703465,1672704558,1093
3478,3200543880,3517600136,1672570749,1672573370,2621
3610,3514246749,3480991549,1672548240,1672548667,427
3812,3631090677,3289817992,1672582999,1672585538,2539
3590,3205985903,3703383853,1672560899,1672561645,746
3864,3368283077,3793583656,1672673382,1672673774,392
3914,3510798825,3393063657,1672662496,1672663369,873
3481,3979784676,3374183227,1672609355,1672609470,115
3430,3518229776,3776117322,1672563742,1672563866,124
3645,3312998540,3279242917,1672590876,1672592044,1168
3560,3519077659,3514324011,1672663550,1672666178,2628
3870,3534566651,3513360004,1672577179,1672578913,1734
3487,3362641275,3779938251,1672591998,1672593387,1389
3719,3701136026,3688220326,1672587013,1672590126,3113
3614,3517737088,3511005395,1672567688,1672570450,2762
3661,3791436104,3270697740,1672563532,1672566334,2802
3537,3834963772,3755158925,1672658315,1672660140,1825
3789,3935487534,3533368789,1672611237,1672614379,3142
3547,3733363628,3755222916,1672679310,1672680232,922
3537,3970909253,3400069268,1672660305,1672661983,1678
3839,3533368789,3559731671,1672535646,1672538028,2382
3499,3335694356,3685816610,1672625982,1672626604,622
3692,3491469603,3298151889,1672537881,1672540979,3098
3446,3456430614,3472068734,1672564427,1672566183,1756
3532,3774641380,3300229945,1672624938,1672626187,1249
3623,3617116290,3511883730,1672675076,1672676982,1906
3575,3410600350,3755230952,1672645820,1672647880,2060
3442,3755065949,3777485931,1672595738,1672598475,2737
3508,3977352557,3713784974,1672666689,1672668118,1429
3790,3885537225,3732584121,1672690742,1672693445,2703
3874,3772078494,3776518452,1672641122,1672642077,955
3822,3934064792,3715707380,1672603269,1672605098,1829
3774,3463740710,3617489344,1672694533,1672695341,808
3756,3515402792,3774155692,1672584737,1672585334,597
3789,3711812325,3360813161,1672694001,1672695189,1188
3567,3311420950,3853629553,1672612851,1672615867,3016
3491,3500915908,3382733096,1672552751,1672554773,2022
3777,3630353876,3776034743,1672634666,1672635567,901
3702,3615737355,3519651506,1672581379,1672583798,2419
3468,3755573472,3792020993,1672664964,1672667731,2767
3839,3780834916,3357864626,1672552072,1672553677,1605
3600,3505437712,3760924079,1672531347,1672532747,1400
3815,3715443333,3776831527,1672543798,1672545254,1456
3576,3792389522,3382733096,1672582307,1672585878,3571
3424,3533649454,3480991549,1672604042,1672605602,1560
3624,3902760230,3501281016,1672555818,1672559171,3353
3615,3394297564,3220031931,1672684319,1672684622,303
3877,3780115155,3559458968,1672660883,1672663334,2451
3571,3736231757,3505634634,1672628378,1672628717,339
3499,3513410578,3505179890,1672616134,1672619547,3413
3532,3688490530,3520115090,1672597861,1672601006,3145
3492,3401793306,3400763927,1672622850,1672625418,2568
3860,3396980894,3488686442,1672686888,1672689262,2374
3594,3520657891,3780834916,1672703673,1672706005,2332
3879,3512882178,3519087371,1672632205,1672633718,1513
3458,3689697817,3778899160,1672614670,1672616731,2061
3826,3783340788,3807212280,1672561668,1672562149,481
3922,3511442562,3380982774,1672566142,1672569274,3132
3692,3400069268,3925979970,1672627274,1672628083,809
3433,3713517039,3517172354,1672616383,1672616604,221
3873,3514246749,3783801141,1672622292,1672622414,122
3913,3376467719,3773902805,1672532229,1672535660,3431
3685,3621184108,3480100311,1672585611,1672586431,820
3868,3783373154,3520873221,1672598615,1672599407,792
3500,3803517637,3773332082,1672598091,1672600942,2851
3787,3971806004,3689697817,1672646805,1672649172,2367
3772,3760362417,3793969543,1672657337,1672659443,2106
3575,3354144091,3713784974,1672667810,1672669667,1857
3522,3783771827,3701247948,1672588393,1672591805,3412
3619,3780680950,3792949946,1672644484,1672647860,3376
3689,3274831810,3461119815,1672591188,1672592476,1288
3705,3760263530,3979784676,1672577449,1672580724,3275
3443,3636329663,3534179433,1672570386,1672570540,154
3703,3517737088,3447514821,1672616654,1672619627,2973
3828,3512337405,3760263530,1672649361,1672650367,1006
3883,3394401087,3292147449,1672592698,1672596084,3386
3606,3511005395,3401496246,1672544766,1672545804,1038
3794,3505402439,3421385957,1672645241,1672645308,67
3903,3367971170,3625463628,1672646902,1672649555,2653
3695,3202141727,3853629553,1672607051,1672610053,3002
3465,3510837901,3366423342,1672647849,1672651361,3512
3896,3971806004,3224330592,1672612977,1672614273,1296
3519,3480100311,3897435944,1672576116,1672576921,805
3567,3733558985,3777485931,1672594127,1672594621,494
3470,3424660806,3710315160,1672559077,1672562473,3396
3883,3238288884,3366423342,1672647432,1672650923,3491
3504,3276217799,3829822608,1672651557,1672651856,299
3615,3411688875,3280268483,1672645992,1672647492,1500
3635,3272030610,3793583656,1672580363,1672583615,3252
3463,3501457103,3793935736,1672612378,1672613201,823
3468,3710315160,3311049964,1672702436,1672705432,2996
3617,3850911686,3738026330,1672673287,1672675939,2652
3678,3367509761,3428725843,1672575460,1672576234,774
3459,3608232640,3363162590,1672594376,1672597362,2986
3880,3513296868,3446533960,1672560148,1672560420,272
3905,3316800320,3500498112,1672661659,1672662413,754
3532,3491684096,3516703758,1672573945,1672576765,2820
3805,3451726367,3683113954,1672544078,1672545813,1735
3682,3408430195,3305722859,1672699731,1672701687,1956
3604,3773913680,3971806004,1672603649,1672603732,83
3434,3533274994,3780472203,1672680497,1672682483,1986
3692,3778667336,3238288884,1672571237,1672573960,2723
3594,3783641602,3517358573,1672537840,1672540182,2342
3641,3608922867,3517222913,1672634386,1672637982,3596
3735,3505283390,3505481368,1672593242,1672595351,2109
3828,3701823816,3735374579,1672545033,1672546716,1683
3652,3902625986,3279473441,1672560837,1672562806,1969
3789,3505111292,3892304880,1672601304,1672602325,1021
3483,3272030610,3512383699,1672702911,1672703141,230
3526,3793743698,3779938251,1672600817,1672602307,1490
3648,3447672935,3491684096,1672596700,1672598165,1465
3759,3920497528,3792072681,1672537606,1672539154,1548
3798,3815392801,3774290799,1672579521,1672580232,711
3886,3511791953,3480991549,1672613405,1672615815,2410
3546,3835985172,3774031303,1672548434,1672550338,1904
3513,3283770991,3793969543,1672598124,1672599042,918
3711,3927165965,3517600136,1672665842,1672665972,130
3479,3513295938,3902625986,1672532158,1672534608,2450
3533,3500442734,3826238375,1672586010,1672586248,238
3553,3774718695,3500737582,1672672185,1672674209,2024
3550,3441703884,3311049964,1672666209,1672668753,2544
3551,3755496114,3276269264,1672650495,1672652119,1624
3592,3638204468,3412968120,1672546107,1672547056,949
3885,3793781065,3760263530,1672588413,1672591939,3526
3592,3429943738,3685816610,1672616893,1672617990,1097
3873,3429943738,3510818674,1672674794,1672677284,2490
3649,3770676872,3510818674,1672637644,1672640952,3308
3763,3511883730,3713691388,1672636586,1672637106,520
3619,3685816610,3778926763,1672631444,1672634905,3461
3490,3398731252,3289114629,1672550445,1672552595,2150
3434,3488686442,3445206685,1672682864,1672684919,2055
3541,3418448389,3792489602,1672590424,1672593074,2650
3818,3703348097,3757075324,1672570783,1672572974,2191
3722,3270042456,3511442562,1672543620,1672546692,3072
3742,3755344363,3292147449,1672680150,1672683516,3366
3705,3777814504,3462158237,1672535896,1672538749,2853
3515,3756474459,3505266860,1672702595,1672702680,85
3585,3515401243,3512337405,1672662695,1672663547,852
3543,3226511603,3760721303,1672544725,1672546493,1768
3509,3493017654,3511601997,1672662444,1672663887,1443
3721,3682133690,3615113018,1672646558,1672649775,3217
3563,3450286949,3730071479,1672669551,1672669717,166
3494,3777037426,3757700712,1672610944,1672611022,78
3737,3714666884,3760924079,1672563014,1672566003,2989
3888,3792525861,3513296868,1672630641,1672632319,1678
3715,3792745809,3448633776,1672590091,1672593076,2985
3657,3399472693,3316798920,1672675637,1672677140,1503
3615,3468041839,3935913584,1672633733,1672636025,2292
3462,3421385957,3481640525,1672597178,1672597987,809
3681,3299125059,3380767040,1672650065,1672651200,1135
3441,3350095157,3556969573,1672643272,1672645004,1732
3606,3899786664,3336339664,1672641771,1672643919,2148
3490,3512282789,3515401243,1672587843,1672589459,1616
3456,3839245934,3770236215,1672654269,1672655914,1645
3605,3305722859,3357689359,1672593554,1672596012,2458
3723,3383138270,3514419100,1672596214,1672598317,2103
3914,3777814504,3533294425,1672680481,1672683742,3261
3693,3298151889,3440137407,1672644187,1672647193,3006
3616,3733558985,3370227921,1672637953,1672640535,2582
3598,3904569677,3970909253,1672616323,1672617961,1638
3570,3780680950,3225636215,1672567878,1672569896,2018
3487,3688490530,3516903528,1672562693,1672563266,573
3505,3514703118,3312998540,1672593286,1672596054,2768
3530,3614740489,3779613523,1672539481,1672539834,353
3533,3472068734,3511732493,1672682611,1672683265,654
3733,3505154885,3807212280,1672545075,1672546995,1920
3735,3701882224,3360813161,1672603908,1672607439,3531
3588,3935399379,3715127070,1672636840,1672640083,3243
3878,3500857494,3520416075,1672533121,1672535178,2057
3566,3607768197,3680843171,1672667933,1672671430,3497
3605,3701322924,3517600136,1672609495,1672610038,543
3806,3491684096,3551376095,1672692384,1672695949,3565
3850,3511843593,3500672156,1672663540,1672665564,2024
3695,3737972328,3411515369,1672659988,1672662862,2874
3745,3512502036,3272096759,1672605330,1672608902,3572
3604,3533747868,3400069268,1672659981,1672662927,2946
3478,3299125059,3975717896,1672535501,1672538944,3443
3626,3518561777,3289114629,1672703929,1672705392,1463
3669,3760640999,3448633776,1672537651,1672538655,1004
3913,3783928182,3780571086,1672633193,1672635589,2396
3571,3615939504,3703396825,1672545164,1672546853,1689
3569,3209481722,3755756564,1672562694,1672564752,2058
3459,3283144118,3777184389,1672615160,1672618103,2943
3871,3357689359,3713784974,1672618737,1672620728,1991
3679,3738026330,3899326793,1672643944,1672644931,987
3476,3533228966,3618354185,1672671955,1672674365,2410
3434,3757075324,3905196766,1672632704,1672634240,1536
3643,3515439826,3791106564,1672658898,1672659328,430
3443,3689114185,3500302272,1672645437,1672647523,2086
3805,3319167958,3921648519,1672661963,1672665166,3203
3524,3779786641,3927165965,1672586314,1672588956,2642
3778,3770704999,3533929349,1672635093,1672636577,1484
3857,3520639768,3225636215,1672566125,1672567617,1492
3798,3710489491,3897376951,1672541155,1672543267,2112
3492,3715854030,3661903000,1672631869,1672633304,1435
3849,3500072204,3520991398,1672663623,1672666979,3356
3896,3755344363,3711637255,1672544510,1672546835,2325
3612,3417191856,3515890966,1672662579,1672665560,2981
3858,3400763927,3514741348,1672696515,1672699778,3263
3733,3773009828,3713768950,1672539010,1672539487,477
3838,3780834916,3509756823,1672539665,1672542711,3046
3757,3776518452,3310125159,1672532623,1672535529,2906
3810,3755992176,3927599181,1672652205,1672655451,3246
3707,3715986185,3608855425,1672668589,1672670692,2103
3878,3713941638,3274906650,1672604297,1672607500,3203
3711,3783136330,3824215187,1672604060,1672607271,3211
3818,3935913584,3436025562,1672702996,1672705129,2133
3447,3497671225,3807212280,1672618289,1672618367,78
3845,3500613459,3899786664,1672543720,1672545082,1362
3454,3760094385,3481640525,1672665238,1672668610,3372
3593,3770676872,3519909393,1672680044,1672681172,1128
3728,3776559988,3505725706,1672641407,1672644649,3242
3535,3737112297,3780427126,1672557790,1672561088,3298
3916,3605221116,3803517637,1672590823,1672591493,670
3872,3500072204,3335694356,1672609407,1672610210,803
3656,3774718695,3667427125,1672619444,1672620482,1038
3577,3500498112,3814677862,1672606283,1672607956,1673
3691,3713517039,3519282716,1672582088,1672585357,3269
3568,3773913680,3613581796,1672685072,1672685388,316
3858,3349856820,3447672935,1672665491,1672666266,775
3633,3777091903,3757294769,1672676402,1672679841,3439
3550,3435116799,3793407963,1672597962,1672600037,2075
3503,3935913584,3714128600,1672590404,1672591854,1450
3477,3552824113,3513296868,1672675460,1672677943,2483
3588,3357689359,3514308235,1672702680,1672703066,386
3588,3631479562,3779786641,1672655239,1672656177,938
3562,3974674109,3438078818,1672586663,1672589330,2667
3547,3300979975,3713517039,1672585168,1672588759,3591
3618,3701884158,3299781901,1672632905,1672633310,405
3813,3824215187,3633735593,1672672669,1672674345,1676
3554,3622357348,3492546679,1672613866,1672615946,2080
3838,3431502855,3399472693,1672681066,1672682643,1577
3710,3892304880,3803389195,1672552667,1672554866,2199
3630,3421877923,3417191856,1672607211,1672607474,263
3905,3517737088,3351696332,1672659905,1672662112,2207
3702,3316798920,3510499038,1672637207,1672637854,647
3907,3780253901,3780834916,1672547780,1672549413,1633
3832,3517737088,3814677862,1672556746,1672557091,345
3450,3367111751,3500841914,1672547743,1672549210,1467
3447,3200543880,3834963772,1672535921,1672536550,629
3754,3715854030,3792072681,1672574188,1672574941,753
3501,3517887477,3757903168,1672658240,1672660576,2336
3626,3618697021,3533423872,1672612090,1672612693,603
3819,3431502855,3783520186,1672686990,1672689418,2428
3579,3354144091,3668747074,1672695622,1672698336,2714
3737,3755737419,3334993594,1672682017,1672685559,3542
3594,3713589994,3459681410,1672562670,1672565141,2471
3783,3600876425,3475349791,1672594508,1672596836,2328
3646,3933894942,3884596900,1672688145,1672689383,1238
3906,3689114185,3514956366,1672669152,1672671746,2594
3718,3241914067,3514971533,1672603560,1672606268,2708
3835,3755756564,3284932450,1672583666,1672584459,793
3867,3703396825,3517697722,1672691921,1672694311,2390
3642,3291933594,3887243870,1672554255,1672557639,3384
3859,3337362061,3891672228,1672673903,1672675269,1366
3490,3500777439,3800257590,1672643556,1672646482,2926
3622,3398731252,3925979970,1672692330,1672693498,1168
3762,3791246640,3713300120,1672641542,1672644577,3035
3483,3315279093,3625174002,1672648074,1672649143,1069
3776,3760040019,3533649454,1672533601,1672536448,2847
3740,3610358027,3617392620,1672588511,1672590542,2031
3882,3450286949,3835985172,1672671768,1672675306,3538
3636,3904867554,3760721303,1672666502,1672669004,2502
3546,3615737355,3515402792,1672577324,1672578893,1569
3589,3780680950,3518565331,1672684766,1672686665,1899
3680,3300979975,3431502855,1672541452,1672543264,1812
3621,3701136026,3815392801,1672666473,1672669796,3323
3538,3512502036,3487875183,1672548321,1672550494,2173
3459,3715086894,3710489491,1672696712,1672698933,2221
3847,3520355798,3899786664,1672618313,1672618421,108
3613,3773913680,3703348097,1672654281,1672654839,558
3562,3349856820,3792949946,1672538007,1672539127,1120
3486,3276217799,3436257398,1672618003,1672621501,3498
3744,3817428320,3517462308,1672666797,1672667541,744
3781,3201676087,3791106564,1672573302,1672574475,1173
3654,3510818674,3241914067,1672702070,1672705479,3409
3433,3336339664,3793583656,1672590989,1672592862,1873
3504,3384583385,3272716462,1672681822,1672681898,76
3644,3514818819,3970627281,1672592617,1672593337,720
3799,3792505974,3757193551,1672556960,1672557874,914
3495,3209481722,3792505974,1672565287,1672565726,439
3613,3900898992,3380130228,1672615367,1672617331,1964
3534,3716110860,3533188828,1672628463,1672629009,546
3526,3516298579,3505154885,1672655632,1672656319,687
3836,3774178201,3225029895,1672661923,1672664259,2336
3689,3505521218,3293835352,1672686693,1672689911,3218
3529,3791106564,3780872464,1672569631,1672571743,2112
3852,3770676872,3534357694,1672632114,1672632750,636
3607,3493017654,3970558632,1672630467,1672632575,2108
3759,3770704999,3414049538,1672657149,1672657415,266
3823,3739911441,3518229776,1672647814,1672649730,1916
3461,3429943738,3517288083,1672628215,1672628356,141
3482,3774733620,3897435944,1672692278,1672693233,955
3647,3780472203,3713784974,1672579136,1672579918,782
3838,3289817992,3979784676,1672669994,1672670845,851
3440,3512946768,3310039260,1672570888,1672571074,186
3713,3776084820,3977148669,1672531883,1672532244,361
3660,3554825448,3731646673,1672571602,1672572528,926
3719,3379143440,3505807416,1672548498,1672550701,2203
3480,3701322924,3392836218,1672615932,1672616799,867
3735,3449333754,3519087371,1672641684,1672644318,2634
3651,3770676872,3928511283,1672636528,1672636891,363
3517,3779738691,3621184108,1672560087,1672563166,3079
3587,3520764926,3779301501,1672692240,1672693358,1118
3876,3510798825,3370068529,1672577140,1672578598,1458
3464,3396726504,3755233658,1672643213,1672644619,1406
3812,3451691949,3276217799,1672621599,1672621898,299
3487,3710048469,3398731252,1672575618,1672576945,1327
3586,3485540729,3364378127,1672545583,1672549152,3569
3725,3440137407,3490029863,1672644230,1672644660,430
3572,3626499450,3885537225,1672592634,1672594308,1674
3567,3897134762,3436025562,1672666402,1672666781,379
3570,3319167958,3701136026,1672611066,1672613916,2850
3462,3447672935,3446533960,1672658924,1672659912,988
3758,3490214516,3451691949,1672588202,1672589152,950
3537,3330340793,3505266860,1672632408,1672635552,3144
3543,3756789525,3783163143,1672692198,1672692696,498
3477,3774876004,3783520186,1672533008,1672533217,209
3810,3757294769,3916490839,1672611271,1672613354,2083
3560,3615087943,3300229945,1672613426,1672614994,1568
3922,3904412440,3732131656,1672657417,1672659282,1865
3641,3912891315,3225631197,1672599870,1672602855,2985
3683,3201800997,3456430614,1672625555,1672626845,1290
3802,3793418209,3338390596,1672633275,1672634334,1059
3683,3667427125,3241914067,1672615596,1672615783,187
3741,3308760650,3732131656,1672569871,1672571417,1546
3437,3505888598,3312998540,1672642311,1672644141,1830
3866,3618697021,3303410628,1672581816,1672583368,1552
3576,3488686442,3772765746,1672542675,1672544658,1983
3672,3792442597,3783615982,1672584986,1672585181,195
3439,3811040565,3780680950,1672595080,1672595540,460
3896,3885537225,3757318448,1672584705,1672585333,628
3739,3808136029,3622357348,1672642759,1672646319,3560
3792,3500442734,3306175858,1672666397,1672668052,1655
3856,3604867757,3534126409,1672634912,1672635896,984
3541,3770468980,3289817992,1672640872,1672642304,1432
3638,3938503547,3401496246,1672655135,1672658295,3160
3735,3793407963,3774876004,1672637821,1672640350,2529
3657,3777330107,3270056120,1672686942,1672687709,767
3893,3472312341,3757323954,1672539920,1672540873,953
3506,3533228966,3511288998,1672634579,1672638041,3462
3549,3394401087,3519087371,1672542167,1672544187,2020
3624,3367971170,3713784974,1672579033,1672579485,452
3719,3622665543,3338390596,1672616904,1672620110,3206
3668,3970909253,3614740489,1672682470,1672683872,1402
3827,3770468980,3371455553,1672566805,1672569053,2248
3601,3467988782,3778667336,1672614085,1672617152,3067
3686,3734451191,3501281016,1672620818,1672623684,2866
3883,3315279093,3513545422,1672595537,1672597023,1486
3551,3435167810,3248058676,1672630919,1672632871,1952
3657,3379143440,3777184389,1672643668,1672644829,1161
3663,3270056120,3363162590,1672700463,1672702328,1865
3853,3516903528,3755404116,1672603916,1672604220,304
3906,3898314440,3632814465,1672629722,1672629920,198
3912,3436025562,3807212280,1672575002,1672578588,3586
3590,3780115155,3311498666,1672607304,1672610037,2733
3441,3780338697,3294747828,1672659153,1672661228,2075
3672,3900276517,3792525861,1672577785,1672580082,2297
3683,3373028638,3905196766,1672595821,1672595979,158
3778,3468041839,3240994288,1672665550,1672667491,1941
3682,3611055563,3334951866,1672698168,1672700457,2289
3588,3793175445,3350095157,1672667818,1672669980,2162
3648,3200308999,3520639768,1672589094,1672590826,1732
3817,3350095157,3334647380,1672622142,1672623534,1392
3847,3500709774,3438489358,1672617302,1672618313,1011
3751,3774907131,3518565331,1672560124,1672563556,3432
3760,3517697722,3793315718,1672534230,1672536269,2039
3757,3485540729,3686523546,1672565615,1672566982,1367
3710,3755915206,3510818674,1672662385,1672664778,2393
3496,3519850727,3701373490,1672533212,1672534205,993
3735,3779639983,3202141727,1672531492,1672534981,3489
3878,3333403880,3792505974,1672679762,1672682597,2835
3908,3400763927,3500613493,1672698210,1672701644,3434
3544,3343132529,3289817992,1672586272,1672587397,1125
3845,3829864515,3514246749,1672595578,1672598857,3279
3719,3350095157,3452016771,1672663536,1672663963,427
3584,3807212280,3856606678,1672592928,1672595932,3004
3854,3776518452,3731646673,1672677306,1672678987,1681
3736,3513081354,3783433404,1672653200,1672656090,2890
3682,3451326054,3604589802,1672688830,1672689495,665
3748,3246370118,3618489670,1672622358,1672622694,336
3878,3445206685,3551389192,1672652785,1672654137,1352
3902,3421877923,3505228454,1672697401,1672697752,351
3487,3730071479,3714678331,1672571780,1672573951,2171
3903,3739661856,3276269264,1672642566,1672643587,1021
3542,3791046864,3912891315,1672577410,1672580271,2861
3583,3715707380,3714666884,1672633590,1672633660,70
3482,3208957949,3500737582,1672618153,1672620203,2050
3603,3855583256,3456430614,1672637924,1672641448,3524
3511,3780115155,3777037426,1672679390,1672679775,385
3659,3500109249,3703383853,1672552126,1672552862,736
3620,3232208416,3309314379,1672658653,1672658991,338
3530,3394401087,3887243870,1672532281,1672532647,366
3570,3711853996,3701664364,1672613284,1672615977,2693
3433,3414049538,3701136026,1672616698,1672619052,2354
3523,3755496114,3533423872,1672620605,1672621142,537
3905,3801645328,3431460073,1672539051,1672541397,2346
3851,3920625129,3499217428,1672659505,1672660549,1044
3767,3774155692,3440137407,1672547079,1672547981,902
3553,3515559913,3711637255,1672700358,1672703615,3257
3507,3510028805,3773735484,1672692150,1672693950,1800
3499,3619922891,3714666884,1672562313,1672563828,1515
3730,3689697817,3935487534,1672609506,1672611507,2001
3769,3505434346,3517737088,1672656256,1672659453,3197
3518,3429943738,3756385685,1672625237,1672627730,2493
3822,3354144091,3632814465,1672613025,1672613445,420
3520,3470454332,3701136026,1672557735,1672558665,930
3605,3437286517,3715986185,1672570741,1672571501,760
3475,3371455553,3310039260,1672620793,1672622224,1431
3711,3916490839,3609113156,1672695217,1672698675,3458
3644,3517462308,3509893027,1672633279,1672634583,1304
3765,3461119815,3715086894,1672557600,1672560975,3375
3714,3777694660,3783520186,1672537297,1672540243,2946
3811,3505923418,3514308235,1672617293,1672617424,131
3604,3220031931,3533649454,1672562919,1672564738,1819
3911,3703348097,3773033649,1672666689,1672667071,382
3908,3520560590,3776084820,1672570963,1672571936,973
3559,3497095254,3501215099,1672546369,1672547558,1189
3573,3410160376,3315703693,1672685093,1672687021,1928
3510,3807212280,3289114629,1672572294,1672574790,2496
3732,3852686295,3701373490,1672702812,1672703466,654
3426,3505847380,3462636434,1672663387,1672666938,3551
3544,3912891315,3516321888,1672608811,1672610136,1325
3554,3501567772,3334974375,1672683448,1672686225,2777
3539,3833217041,3511791953,1672615854,1672616442,588
3791,3360069849,3715400486,1672549667,1672550812,1145
3544,3510554314,3512499658,1672677178,1672679686,2508
3764,3514419100,3516444201,1672630544,1672633647,3103
3659,3783771827,3683113954,1672562123,1672564582,2459
3470,3229974066,3778899160,1672699372,1672701983,2611
3669,3625174002,3357689359,1672546220,1672549607,3387
3505,3410160376,3338083680,1672671440,1672673486,2046
3873,3779854934,3713829743,1672534526,1672537970,3444
3501,3334974375,3714128600,1672560374,1672562983,2609
3555,3519142371,3755915206,1672542243,1672545831,3588
3500,3638204468,3783520186,1672685620,1672687560,1940
3666,3517172354,3889780657,1672558643,1672561920,3277
3703,3780909839,3446533960,1672698818,1672700083,1265
3823,3283144118,3349856820,1672662246,1672663262,1016
3833,3512282789,3424445495,1672532344,1672535621,3277
3731,3792745809,3334951866,1672533686,1672536551,2865
3914,3755915206,3774605761,1672586093,1672589180,3087
3458,3912891315,3835985172,1672572893,1672575960,3067
3599,3414940786,3501786419,1672554933,1672556599,1666
3669,3793740407,3667673649,1672585924,1672588188,2264
3498,3534179433,3311098437,1672589231,1672590874,1643
3906,3779532653,3713941638,1672703211,1672704932,1721
3890,3900945856,3334647380,1672649979,1672651040,1061
3690,3285204083,3291933594,1672576864,1672579452,2588
3763,3777184389,3688490530,1672611044,1672612158,1114
3490,3229822507,3609659642,1672607081,1672607848,767
3511,3534829213,3552824113,1672601427,1672601973,546
3712,3511843593,3520639768,1672675883,1672678771,2888
3896,3501786419,3510919821,1672542725,1672544974,2249
3666,3732584121,3293835352,1672587882,1672589293,1411
3476,3923420131,3380767040,1672657323,1672657662,339
3757,3777624586,3618808151,1672631252,1672634227,2975
3476,3972083617,3201676087,1672536131,1672539529,3398
3779,3715086894,3739661856,1672604035,1672604842,807
3883,3803389195,3299125059,1672651364,1672652291,927
3900,3518565331,3518229776,1672613846,1672615515,1669
3737,3734915241,3780322355,1672626451,1672628896,2445
3432,3224330592,3839245934,1672662067,1672664430,2363
3647,3859868849,3714233826,1672682751,1672684129,1378
3793,3811075491,3711637255,1672610985,1672612018,1033
3783,3303410628,3510964997,1672612026,1672615281,3255
3867,3615115210,3755532873,1672669204,1672670137,933
3798,3491469603,3823084403,1672597766,1672598987,1221
3518,3793868716,3711077927,1672561920,1672563450,1530
3571,3201629017,3518194482,1672599133,1672600162,1029
3779,3311085279,3800257590,1672553338,1672555616,2278
3795,3505111292,3755230952,1672639088,1672642075,2987
3707,3224330592,3680843171,1672576888,1672577087,199
3737,3225029895,3284947372,1672668743,1672672097,3354
3917,3715619259,3899786664,1672625790,1672627307,1517
3487,3414049538,3774641380,1672556948,1672558425,1477
3631,3551376095,3438489358,1672579564,1672581787,2223
3629,3779613523,3387594369,1672610356,1672613645,3289
3871,3905196766,3501525100,1672622837,1672622930,93
3675,3341893384,3349739136,1672647997,1672650945,2948
3590,3515890966,3855583256,1672551204,1672553418,2214
3884,3435116799,3760362417,1672560635,1672561588,953
3574,3800257590,3380982774,1672633224,1672635202,1978
3531,3402697190,3396980894,1672574512,1672576294,1782
3695,3396726504,3414275042,1672683741,1672687324,3583
3792,3556969573,3772236797,1672651337,1672653004,1667
3913,3516489668,3623266256,1672672559,1672675170,2611
3502,3311498666,3755344363,1672577696,1672580216,2520
3467,3240394404,3338083680,1672657671,1672658877,1206
3590,3509764635,3516513251,1672599527,1672602001,2474
3787,3900945856,3839245934,1672627074,1672628051,977
3576,3609881958,3710496785,1672607736,1672608835,1099
3866,3500525825,3916490839,1672606340,1672606501,161
3656,3760842815,3615737355,1672634545,1672638059,3514
3812,3680810086,3280054198,1672559668,1672560984,1316
3787,3773913680,3778597171,1672589514,1672590487,973
3659,3770676872,3899326793,1672600019,1672601036,1017
3757,3300818269,3757193307,1672683994,1672686553,2559
3675,3509483172,3533747868,1672668583,1672670013,1430
3729,3316798920,3303410628,1672604674,1672606512,1838
3873,3756746867,3776034743,1672623293,1672623454,161
3728,3755848152,3755230952,1672668207,1672670200,1993
3523,3664943873,3520560590,1672631644,1672634344,2700
3836,3713517039,3792014516,1672545359,1672547870,2511
3692,3780338697,3711000597,1672579046,1672579423,377
3654,3438489358,3514308235,1672555339,1672558028,2689
3838,3770236215,3621790707,1672538618,1672539406,788
3918,3418448389,3350095157,1672532418,1672533005,587
3707,3974674109,3755404116,1672687270,1672689863,2593
3920,3760694096,3920497528,1672544968,1672545842,874
3788,3410600350,3682133690,1672591855,1672593826,1971
3623,3904569677,3739911441,1672671507,1672673048,1541
3766,3773902805,3511442562,1672581627,1672584626,2999
3535,3505111292,3916490839,1672550414,1672550681,267
3852,3792949946,3518194482,1672546481,1672546768,287
3726,3270042456,3334974375,1672632350,1672635445,3095
3444,3435167810,3902625986,1672615372,1672618190,2818
3687,3713911104,3306175858,1672653236,1672654665,1429
3760,3618697021,3512830734,1672699551,1672700462,911
3508,3622357348,3285204083,1672672913,1672673877,964
3444,3505634634,3615688740,1672690519,1672692984,2465
3901,3904569677,3715707380,1672575519,1672577734,2215
3612,3285204083,3551376095,1672605803,1672606891,1088
3804,3478114114,3730071479,1672600178,1672600798,620
3535,3920497528,3774290799,1672590679,1672592209,1530
3902,3780834916,3755848152,1672664086,1672665171,1085
3661,3500841914,3711637255,1672695256,1672696099,843
3843,3511317276,3500613459,1672619844,1672620880,1036
3878,3618354185,3509756823,1672614280,1672617777,3497
3474,3500857494,3516741440,1672687466,1672688547,1081
3547,3713979100,3556969573,1672609337,1672612352,3015
3560,3777240360,3710048469,1672578454,1672579804,1350
3621,3513360004,3711853996,1672634418,1672637827,3409
3869,3811075491,3334951866,1672639645,1672641353,1708
3908,3925979970,3778640261,1672532651,1672534637,1986
3894,3615688740,3492959689,1672603398,1672604399,1001
3752,3757863420,3288762795,1672693432,1672694407,975
3530,3774290799,3668747074,1672697183,1672699240,2057
3876,3510837901,3777779869,1672546792,1672549112,2320
3855,3621184108,3445206685,1672581742,1672583365,1623
3610,3516513251,3383138270,1672671544,1672674593,3049
3797,3288224595,3904867554,1672603012,1672603125,113
3666,3276348699,3734451191,1672575514,1672576363,849
3732,3714233826,3384583385,1672680827,1672683470,2643
3810,3755233658,3885155975,1672607038,1672607430,392
3621,3613338363,3499217428,1672573023,1672574330,1307
3509,3480991549,3520764926,1672663825,1672665988,2163
3706,3500341755,3417191856,1672637603,1672638472,869
3547,3409114719,3776117322,1672600840,1672601439,599
3814,3398198430,3415833929,1672632979,1672633715,736
3495,3732584121,3534829213,1672627270,1672629188,1918
3561,3534175249,3856606678,1672637009,1672638514,1505
3742,3208957949,3893912331,1672676409,1672676558,149
3864,3401940259,3600876425,1672609680,1672612721,3041
3611,3271454397,3354144091,1672629576,1672632997,3421
3885,3631090677,3440107959,1672686493,1672688409,1916
3533,3505402439,3760263530,1672699272,1672700935,1663
3689,3921648519,3776988674,1672611660,1672614583,2923
3426,3689697817,3814677862,1672624028,1672625076,1048
3588,3783169442,3899786664,1672674921,1672675697,776
3508,3512958459,3621461051,1672627707,1672629910,2203
3452,3449333754,3669146016,1672663267,1672664964,1697
3526,3470454332,3618489670,1672693600,1672694472,872
3812,3437286517,3892304880,1672559944,1672562907,2963
3673,3715127070,3510187271,1672556008,1672557398,1390
3683,3501459390,3773572967,1672561446,1672563883,2437
3810,3280268483,3770676872,1672683025,1672686335,3310
3471,3533090502,3774718695,1672637989,1672640610,2621
3833,3770146716,3311049964,1672652686,1672652891,205
3830,3792801638,3779656423,1672672796,1672673423,627
3781,3739154408,3343132529,1672609277,1672611092,1815
3643,3468041839,3979784676,1672538074,1672539021,947
3884,3835985172,3229822507,1672693166,1672694125,959
3677,3680843171,3792442597,1672657584,1672661004,3420
3840,3811040565,3519282716,1672567233,1672570366,3133
3885,3240394404,3456430614,1672630091,1672631651,1560
3847,3505847380,3713589994,1672587193,1672588046,853
3546,3240994288,3236354255,1672636717,1672636814,97
3432,3774790271,3975717896,1672665830,1672666001,171
3846,3778040015,3731646673,1672702594,1672704695,2101
3574,3900945856,3347446226,1672575678,1672575940,262
3769,3773913680,3510641433,1672670760,1672671154,394
3519,3783136330,3730071479,1672699605,1672700435,830
3677,3755737419,3904412440,1672568996,1672571096,2100
3688,3551389192,3972192593,1672628275,1672628911,636
3462,3236354255,3777091903,1672597896,1672600729,2833
3900,3480726047,3680843171,1672564525,1672565927,1402
3824,3394401087,3500613493,1672535014,1672535381,367
3534,3436025562,3625463628,1672611437,1672611839,402
3784,3713941638,3459681410,1672564226,1672566632,2406
3679,3229974066,3500737582,1672631314,1672631842,528
3682,3520115090,3451326054,1672592670,1672593902,1232
3526,3701664364,3225636215,1672606332,1672607586,1254
3861,3778040015,3814677862,1672545144,1672547957,2813
3544,3777147510,3932478321,1672567462,1672569494,2032
3788,3611055563,3815392801,1672603697,1672605249,1552
3475,3367971170,3319167958,1672559080,1672559385,305
3583,3517991730,3625174002,1672576297,1672579874,3577
3893,3829864515,3515401243,1672702715,1672704586,1871
3871,3783169442,3637313265,1672612021,1672612297,276
3521,3777624586,3289817992,1672683596,1672683922,326
3860,3515402792,3839245934,1672590275,1672591667,1392
3469,3819767045,3505283390,1672664027,1672665052,1025
3638,3710735406,3757863420,1672551634,1672552211,577
3490,3554186380,3732584121,1672569533,1672571188,1655
3815,3635169815,3812369928,1672627617,1672628572,955
3787,3839245934,3236458894,1672579100,1672580987,1887
3512,3421385957,3552824113,1672553510,1672556570,3060
3510,3500949309,3902625986,1672689288,1672691169,1881
3616,3773837847,3511883730,1672606394,1672609214,2820
3607,3379143440,3701005527,1672571641,1672572423,782
3486,3617489344,3511024016,1672550634,1672552612,1978
3529,3284932450,3240394404,1672585924,1672589433,3509
3910,3449639012,3500044458,1672540719,1672540959,240
3637,3343132529,3715974659,1672563060,1672566407,3347
3885,3316800320,3972192593,1672583328,1672584614,1286
3866,3774733620,3733558985,1672548752,1672550287,1535
3511,3776559988,3770146716,1672563532,1672565031,1499
3759,3756704774,3357864626,1672655158,1672656302,1144
3493,3392836218,3711919537,1672566854,1672569530,2676
3906,3534357694,3200543880,1672676387,1672678511,2124
3829,3334647380,3448875382,1672573249,1672575715,2466
3592,3460719322,3688796737,1672600606,1672603811,3205
3903,3401496246,3226511603,1672549614,1672550187,573
3595,3533649454,3792274796,1672571226,1672571601,375
3805,3661583097,3509764635,1672561850,1672562093,243
3880,3885121158,3613416045,1672536786,1672537860,1074
3639,3451691949,3559731671,1672633232,1672635387,2155
3497,3382733096,3625174002,1672621537,1672621905,368
3466,3505179890,3770146716,1672675612,1672678519,2907
3742,3387594369,3298151889,1672620433,1672621407,974
3605,3509756823,3906536154,1672663053,1672663316,263
3798,3770704999,3756625818,1672594908,1672598070,3162
3824,3511288998,3710735406,1672636617,1672639213,2596
3442,3777485931,3755065949,1672605901,1672606848,947
3549,3770236215,3715127070,1672690035,1672693385,3350
3844,3639050419,3604867757,1672594233,1672595263,1030
3656,3238288884,3431502855,1672684858,1672688369,3511
3869,3519028898,3780571086,1672610468,1672613736,3268
3701,3283492940,3402385957,1672685719,1672686732,1013
3456,3311085279,3229822507,1672609004,1672610823,1819
3624,3772078494,3505847380,1672611493,1672612841,1348
3597,3730071479,3793969543,1672661362,1672663657,2295
3907,3520578796,3904412440,1672550561,1672550665,104
3485,3627368399,3516321888,1672589773,1672592440,2667
3847,3899326793,3410600350,1672655881,1672658874,2993
3503,3279242917,3853629553,1672610427,1672611469,1042
3722,3757348722,3274906650,1672675826,1672678804,2978
3597,3520873221,3902625986,1672578180,1672580244,2064
3472,3443357683,3501121099,1672673026,1672674993,1967
3552,3424660806,3510818674,1672689284,1672692472,3188
3678,3478114114,3200308999,1672579130,1672581225,2095
3603,3367971170,3500841914,1672586102,1672586804,702
3498,3760040019,3920625129,1672650774,1672653397,2623
3602,3513545422,3701882224,1672688768,1672689090,322
3476,3236499444,3505111292,1672593087,1672594406,1319
3702,3757323954,3975717896,1672565787,1672566747,960
3776,3904569677,3669146016,1672612915,1672616367,3452
3569,3480100311,3284932450,1672602647,1672603041,394
3621,3271454397,3487875183,1672630698,1672632009,1311
3839,3757193551,3384583385,1672702531,1672702779,248
3658,3904867554,3505179890,1672599696,1672602984,3288
3864,3513410578,3755532873,1672559822,1672560053,231
3908,3491469603,3236354255,1672674380,1672676573,2193
3731,3272716462,3412968120,1672583324,1672584591,1267
3583,3517358573,3445206685,1672679333,1672682193,2860
3775,3703139663,3347446226,1672636879,1672640371,3492
3434,3517737088,3387594369,1672622682,1672624609,1927
3499,3756385685,3462158237,1672696422,1672699078,2656
3666,3776117322,3639050419,1672588712,1672589573,861
3650,3774641380,3776084820,1672622061,1672622475,414
3525,3500072204,3552824113,1672567965,1672569983,2018
3826,3614740489,3438489358,1672606325,1672606513,188
3656,3500703304,3779786641,1672572210,1672572453,243
3818,3512502036,3783771827,1672606051,1672607332,1281
3716,3711097754,3511288998,1672583759,1672584307,548
3462,3715619259,3280268483,1672596200,1672598115,1915
3557,3245232284,3624297844,1672587485,1672589616,2131
3695,3480490124,3637313265,1672555180,1672556855,1675
3640,3714827719,3714670620,1672559176,1672562485,3309
3919,3701373490,3513345163,1672659969,1672662209,2240
3856,3928719932,3500857494,1672655463,1672655754,291
3919,3505228454,3491469603,1672559600,1672563044,3444
3597,3533423872,3463849738,1672688238,1672691161,2923
3527,3310039260,3491684096,1672599228,1672600893,1665
3485,3500703304,3774705415,1672622355,1672623337,982
3694,3236499444,3514703118,1672678037,1672678750,713
3764,3627368399,3312998540,1672679446,1672680930,1484
3649,3625174002,3777240360,1672697391,1672698464,1073
3649,3621790707,3977148669,1672665657,1672667640,1983
3763,3755404116,3770438122,1672672070,1672672254,184
3907,3791753345,3229822507,1672629138,1672630927,1789
3632,3667427125,3792949946,1672586487,1672590015,3528
3561,3514956366,3236499444,1672552955,1672556236,3281
3631,3208957949,3757630221,1672680800,1672681626,826
3808,3240394404,3437286517,1672668469,1672669631,1162
3818,3803389195,3897456874,1672619197,1672621159,1962
3852,3701373490,3500737582,1672537821,1672541263,3442
3882,3493017654,3757630221,1672574179,1672575457,1278
3883,3715619259,3500915665,1672630824,1672634251,3427
3707,3510964997,3337322736,1672585085,1672587824,2739
3719,3437286517,3519909393,1672565817,1672568487,2670
3463,3401940259,3364726656,1672573245,1672573930,685
3778,3792505974,3440137407,1672574186,1672577123,2937
3432,3755992176,3500915665,1672632368,1672632930,562
3709,3513041785,3401793306,1672639227,1672641256,2029
3488,3316800320,3480726047,1672673930,1672676924,2994
3629,3438078818,3774178201,1672584227,1672584936,709
3910,3230135532,3792389522,1672616993,1672619161,2168
3640,3424660806,3793935736,1672700222,1672701459,1237
3913,3703383853,3271752081,1672615787,1672617993,2206
3815,3760842815,3716963089,1672615132,1672615439,307
3922,3270042456,3379143440,1672606871,1672608403,1532
3513,3710315160,3533004959,1672635931,1672639021,3090
3764,3516298579,3701424609,1672554143,1672556309,2166
3863,3680843171,3497808662,1672563164,1672564983,1819
3775,3856606678,3714128600,1672669601,1672672044,2443
3700,3231713082,3856606678,1672670253,1672673529,3276
3741,3368283077,3714827719,1672609956,1672613156,3200
3629,3793175445,3755344363,1672544189,1672546909,2720
3918,3505663516,3776831527,1672644686,1672646690,2004
3899,3505807416,3289114629,1672606907,1672610415,3508
3753,3392943173,3734451191,1672672235,1672675098,2863
3527,3512882178,3392836218,1672702665,1672704050,1385
3525,3452016771,3510798825,1672681126,1672682033,907
3524,3513545422,3401496246,1672612950,1672613840,890
3673,3509764635,3509483172,1672560252,1672562451,2199
3798,3469254160,3559458968,1672601956,1672603333,1377
3625,3462158237,3431460073,1672685413,1672687648,2235
3742,3236354255,3449639012,1672698888,1672700437,1549
3791,3735374579,3624297844,1672561584,1672562169,585
3574,3777485931,3551399764,1672666757,1672669200,2443
3691,3685816610,3714185969,1672532092,1672534297,2205
3459,3284947372,3509366311,1672616954,1672617855,901
3802,3630353876,3516741440,1672590672,1672590814,142
3672,3205985903,3390660440,1672561060,1672562130,1070
3610,3613416045,3299125059,1672573562,1672575815,2253
3783,3703396825,3932478321,1672555567,1672556985,1418
3815,3905196766,3509483172,1672611237,1672612085,848
3468,3760640999,3757193307,1672626441,1672627806,1365
3452,3510798825,3360813161,1672591114,1672594436,3322
3893,3514956366,3897456874,1672690819,1672693819,3000
3655,3783641602,3513360004,1672548181,1672551355,3174
3632,3347419520,3457620713,1672624497,1672626138,1641
3457,3715986185,3306175858,1672681578,1672682352,774
3814,3401940259,3497671225,1672697699,1672699848,2149
3561,3713829743,3792389522,1672644418,1672645109,691
3653,3736705719,3783520186,1672534259,1672535249,990
3803,3615113018,3364726656,1672655563,1672656129,566
3620,3517462308,3755915206,1672543310,1672543813,503
3541,3792546035,3701664364,1672608308,1672608729,421
3763,3780115155,3703433819,1672589368,1672592953,3585
3559,3668747074,3770146716,1672632542,1672635483,2941
3545,3970909253,3778640261,1672691230,1672693940,2710
3846,3312998540,3713691388,1672618970,1672619277,307
3497,3710854064,3923220461,1672604667,1672606730,2063
3633,3308760650,3500915665,1672662990,1672665156,2166
3712,3915162005,3401793306,1672609788,1672612429,2641
3660,3513296868,3410160376,1672612184,1672612287,103
3700,3399518841,3793743698,1672595317,1672597787,2470
3465,3559458968,3370227921,1672539901,1672542003,2102
3850,3400763927,3713979100,1672637801,1672640586,2785
3581,3774907131,3637313265,1672573861,1672576066,2205
3472,3935399379,3731646673,1672549794,1672553044,3250
3849,3370227921,3715545685,1672561226,1672564536,3310
3492,3906536154,3334974375,1672537010,1672539254,2244
3687,3880926355,3517881647,1672702294,1672703968,1674
3755,3296462324,3338083680,1672652438,1672654702,2264
3638,3415833929,3534543776,1672607726,1672609834,2108
3777,3517590837,3703396825,1672636552,1672638694,2142
3574,3900945856,3780909839,1672554761,1672556727,1966
3541,3500072204,3385323994,1672661641,1672662189,548
3560,3757193307,3534829213,1672700977,1672701586,609
3468,3510187271,3354144091,1672641343,1672642784,1441
3610,3927165965,3240394404,1672689977,1672692454,2477
3697,3491684096,3516703758,1672557470,1672558524,1054
3556,3856606678,3713163045,1672696271,1672698101,1830
3655,3853629553,3236499444,1672698640,1672700133,1493
3595,3316800320,3715974659,1672612536,1672615003,2467
3605,3778899160,3780571086,1672537864,1672540416,2552
3715,3778640261,3534357694,1672695820,1672697287,1467
3670,3533649454,3337362061,1672592478,1672594871,2393
3671,3451726367,3501384020,1672616873,1672618211,1338
3833,3505995057,3468041839,1672585108,1672587035,1927
3611,3783520186,3462273042,1672679485,1672681384,1899
3891,3710496785,3403370192,1672602486,1672602799,313
3882,3633735593,3500525825,1672702282,1672704068,1786
3512,3505663516,3500208903,1672573412,1672574208,796
3475,3893912331,3533649454,1672622769,1672624560,1791
3738,3703383853,3517887477,1672692057,1672694179,2122
3529,3776084820,3500109249,1672596971,1672597050,79
3793,3276269264,3755915206,1672656964,1672658379,1415
3831,3633735593,3701005527,1672562174,1672564787,2613
3679,3770146716,3491469603,1672538893,1672539944,1051
3569,3225029895,3513295938,1672587957,1672590147,2190
3610,3510028805,3441703884,1672566976,1672568496,1520
3854,3414940786,3517991730,1672702240,1672704962,2722
3775,3509764635,3519028898,1672656684,1672658060,1376
3791,3621683102,3811040565,1672602967,1672604527,1560
3737,3398198430,3517887477,1672588336,1672590030,1694
3818,3491469603,3977148669,1672652348,1672653934,1586
3514,3472312341,3514741348,1672646909,1672649734,2825
3617,3500613493,3757193307,1672595130,1672597241,2111
3488,3777779869,3735374579,1672677659,1672681047,3388
3799,3689114185,3611055563,1672535447,1672538658,3211
3803,3791613604,3414940786,1672582420,1672584733,2313
3499,3505434346,3306175858,1672631879,1672633515,1636
3588,3511601997,3512830734,1672639801,1672643133,3332
3711,3384583385,3347419520,1672548198,1672551172,2974
3696,3970198861,3205923620,1672685083,1672687697,2614
3830,3514818819,3923420131,1672578189,1672580779,2590
3470,3517590837,3617392620,1672684456,1672685637,1181
3779,3631479562,3226511603,1672536009,1672538350,2341
3874,3783136330,3225631197,1672637881,1672639190,1309
3603,3701247948,3363162590,1672686333,1672687024,691
3609,3534126409,3923420131,1672556186,1672559737,3551
3796,3334974375,3511024016,1672599312,1672601417,2105
3672,3710496785,3534566651,1672675194,1672675818,624
3516,3773837847,3734915241,1672635693,1672636863,1170
3661,3516298579,3793315718,1672632771,1672633476,705
3759,3711919537,3710048469,1672561749,1672564026,2277
3713,3279242917,3793583656,1672692505,1672694892,2387
3542,3440137407,3517172354,1672701329,1672702688,1359
3828,3311498666,3500703304,1672691677,1672692440,763
3678,3618354185,3900945856,1672629975,1672631692,1717
3805,3735374579,3385323994,1672544970,1672548092,3122
3787,3627368399,3514741348,1672589718,1672592579,2861
3688,3777330107,3925979970,1672648989,1672649732,743
3652,3517600136,3519651506,1672645716,1672647935,2219
3640,3500737582,3739895284,1672637247,1672639375,2128
3505,3701136026,3300979975,1672591065,1672592266,1201
3816,3773735484,3441703884,1672566827,1672567359,532
3439,3201629017,3505663516,1672626411,1672629890,3479
3739,3737972328,3814677862,1672550438,1672550613,175
3584,3490029863,3757193307,1672700707,1672702096,1389
3774,3829822608,3733558985,1672640025,1672640714,689
3729,3490029863,3770624662,1672583119,1672585887,2768
3565,3533294425,3401496246,1672625152,1672628581,3429
3544,3387594369,3232208416,1672598033,1672601290,3257
3891,3304971369,3716110860,1672595444,1672596451,1007
3499,3755158925,3310039260,1672565818,1672569184,3366
3500,3977352557,3897456874,1672627824,1672631037,3213
3464,3833217041,3926643445,1672601658,1672604052,2394
3838,3618808151,3713911104,1672619438,1672622171,2733
3845,3501281016,3274831810,1672605837,1672607563,1726
3435,3276348699,3229822507,1672543358,1672545822,2464
3886,3276217799,3776518452,1672575336,1672575704,368
3475,3890739241,3685681577,1672582271,1672584957,2686
3774,3635169815,3792505974,1672687275,1672687659,384
3783,3293835352,3392836218,1672660888,1672661241,353
3611,3772391882,3500949309,1672536514,1672538553,2039
3867,3449333754,3500857494,1672602642,1672605566,2924
3514,3814305099,3683113954,1672592698,1672593848,1150
3912,3500613493,3514246749,1672685509,1672688285,2776
3728,3334951866,3533294425,1672636540,1672638633,2093
3670,3462158237,3930242012,1672694825,1672695182,357
3460,3518561777,3829864515,1672551819,1672555072,3253
3494,3505888598,3615688740,1672640894,1672641660,766
3543,3737147209,3206837348,1672659992,1672660826,834
3445,3533368789,3773837847,1672673831,1672674142,311
3649,3510641433,3500703304,1672684749,1672686366,1617
3787,3780909839,3791246640,1672666521,1672669604,3083
3445,3500072204,3780322355,1672678512,1672680005,1493
3572,3715986185,3638660068,1672682283,1672683411,1128
3826,3688220326,3533090502,1672548409,1672549207,798
3639,3512958459,3500442734,1672573214,1672574283,1069
3828,3500949309,3515890966,1672579572,1672580704,1132
3651,3279473441,3559458968,1672595602,1672598246,2644
3640,3701373490,3923220461,1672584589,1672586253,1664
3823,3500317969,3366423342,1672563451,1672565081,1630
3912,3780712350,3519818818,1672675242,1672676834,1592
3484,3604867757,3680810086,1672611520,1672614114,2594
3849,3384583385,3701247948,1672588047,1672589024,977
3577,3714666884,3792020993,1672534370,1672536882,2512
3475,3385323994,3516903528,1672579964,1672582174,2210
3734,3341893384,3935399379,1672684218,1672687777,3559
3830,3347446226,3711734586,1672548946,1672550757,1811
3447,3713768950,3440107959,1672553432,1672553544,112
3431,3456430614,3370068529,1672695708,1672698270,2562
3604,3778926763,3480100311,1672657412,1672658397,985
3514,3512337405,3371455553,1672591261,1672593772,2511
3860,3556969573,3783771827,1672697556,1672697782,226
3602,3714067076,3757332128,1672577767,1672579828,2061
3473,3414049538,3890739241,1672550755,1672552342,1587
3747,3311098437,3363162590,1672645477,1672647875,2398
3658,3534764451,3364726656,1672675283,1672677592,2309
3666,3783433404,3443357683,1672639698,1672642984,3286
3552,3443357683,3350095157,1672621545,1672623570,2025
3846,3613338363,3773332082,1672608425,1672611986,3561
3468,3715545685,3839245934,1672659170,1672660654,1484
3637,3665998641,3801645328,1672532934,1672534642,1708
3485,3509483172,3500672156,1672683577,1672685960,2383
3568,3514703118,3514703118,1672578020,1672580740,2720
3798,3370068529,3829864515,1672691783,1672692909,1126
3676,3226024417,3492546679,1672616230,1672619317,3087
3726,3711077927,3414940786,1672679114,1672680628,1514
3767,3512392431,3512958459,1672638984,1672642243,3259
3756,3513360004,3783801141,1672691330,1672692407,1077
3489,3462636434,3701884158,1672671291,1672671651,360
3513,3783771827,3621683102,1672621019,1672624553,3534
3648,3779301501,3334974375,1672635995,1672636753,758
3922,3396726504,3270697740,1672650911,1672651203,292
3862,3300979975,3439673892,1672642485,1672643570,1085
3525,3505402439,3792274796,1672582956,1672586323,3367
3593,3376467719,3714670620,1672552075,1672555119,3044
3439,3364378127,3714120857,1672586821,1672587439,618
3914,3613206049,3711006062,1672613729,1672614284,555
3593,3280268483,3829864515,1672677160,1672679597,2437
3644,3441703884,3311098437,1672586188,1672589216,3028
3833,3783919913,3701136026,1672692679,1672695922,3243
3428,3296462324,3360813161,1672532409,1672533257,848
3568,3710315160,3501567772,1672681057,1672681789,732
3478,3703139663,3755573472,1672576721,1672578505,1784
3707,3618176292,3512502036,1672662926,1672663999,1073
3663,3774243020,3225631197,1672551273,1672553968,2695
3557,3928511283,3715854030,1672648316,1672649519,1203
3624,3206837348,3780834916,1672531427,1672534657,3230
3641,3835985172,3902760230,1672567476,1672569008,1532
3505,3244004456,3757332128,1672594768,1672597087,2319
3611,3760263530,3770704999,1672618723,1672619265,542
3912,3760263530,3893912331,1672546882,1672549035,2153
3541,3631090677,3414049538,1672688052,1672691537,3485
3630,3500915665,3682133690,1672703291,1672706563,3272
3610,3714185969,3856606678,1672565787,1672566749,962
3692,3811075491,3915162005,1672591381,1672594142,2761
3659,3276348699,3500317969,1672538110,1672539021,911
3847,3710048469,3680843171,1672620013,1672623384,3371
3544,3925979970,3839245934,1672582831,1672585597,2766
3732,3349739136,3703139663,1672604400,1672605659,1259
3446,3505481368,3835422146,1672645448,1672646510,1062
3867,3380130228,3441348818,1672643404,1672647002,3598
3450,3299125059,3783136330,1672650079,1672651483,1404
3689,3885121158,3276217799,1672546848,1672549742,2894
3689,3519850727,3783641602,1672623525,1672626325,2800
3502,3792505974,3714067076,1672598243,1672600874,2631
3586,3757630221,3517222913,1672623620,1672626777,3157
3608,3338390596,3208452238,1672619120,1672619530,410
3910,3534764451,3349856820,1672695970,1672697238,1268
3755,3394401087,3850911686,1672666452,1672669073,2621
3809,3619922891,3779532653,1672656944,1672660424,3480
3685,3970198861,3710735406,1672582879,1672585206,2327
3888,3333918941,3500709774,1672629110,1672631431,2321
3597,3500915908,3780834916,1672694970,1672698217,3247
3918,3716963089,3714666884,1672553010,1672553240,230
3592,3431460073,3520639768,1672597221,1672598652,1431
3476,3500604680,3225631197,1672599517,1672599760,243
3577,3270697740,3899786664,1672561488,1672563539,2051
3804,3914691363,3617489344,1672531201,1672533715,2514
3875,3821054646,3776831527,1672609928,1672612492,2564
3863,3512800570,3622357348,1672587246,1672589483,2237
3532,3519651506,3897435944,1672651711,1672651990,279
3449,3505402439,3660887799,1672630036,1672632990,2954
3469,3852533643,3938389661,1672543489,1672546496,3007
3839,3311098437,3714827719,1672556752,1672558439,1687
3698,3417679834,3408430195,1672668711,1672670981,2270
3543,3776559988,3514419100,1672677617,1672681180,3563
3868,3424445495,3792274796,1672642042,1672642684,642
3708,3497095254,3279339278,1672635856,1672639189,3333
3837,3239617320,3715400486,1672583697,1672586517,2820
3692,3399518841,3488686442,1672692664,1672694690,2026
3526,3520181148,3818575661,1672661746,1672663311,1565
3754,3714233826,3271454397,1672644046,1672644679,633
3644,3283144118,3501525100,1672620186,1672621528,1342
3621,3637313265,3438489358,1672559304,1672562169,2865
3781,3779854934,3457620713,1672563901,1672566990,3089
3771,3451726367,3375449013,1672537328,1672538340,1012
3830,3885537225,3224811762,1672627831,1672631098,3267
3433,3885155975,3755404116,1672604808,1672607279,2471
3762,3780472203,3711812325,1672605907,1672608081,2174
3670,3515439826,3778640261,1672690714,1672693682,2968
3672,3818575661,3510554314,1672683607,1672686778,3171
3620,3436025562,3288762795,1672537212,1672537782,570
3515,3793175445,3757193551,1672619183,1672621503,2320
3447,3299443125,3226511603,1672673570,1672676049,2479
3728,3668747074,3520639768,1672648104,1672650390,2286
3598,3667673649,3455018347,1672692005,1672694504,2499
3692,3480991549,3792505974,1672545187,1672545450,263
3650,3510767239,3373089838,1672643067,1672645886,2819
3528,3703433819,3271454397,1672543706,1672546255,2549
3526,3755233658,3803389195,1672546032,1672548881,2849
3491,3814305099,3449639012,1672664313,1672667769,3456
3741,3519282716,3760040019,1672540001,1672543273,3272
3629,3613416045,3972083617,1672699350,1672700112,762
3604,3600876425,3633735593,1672628959,1672632253,3294
3922,3510837901,3927165965,1672544471,1672547262,2791
3829,3516444201,3927403123,1672561339,1672562045,706
3734,3500709774,3826238375,1672574752,1672576387,1635
3749,3793175445,3246370118,1672591863,1672592456,593
3434,3783641602,3392943173,1672627068,1672629887,2819
3688,3554944414,3792525861,1672553712,1672557183,3471
3434,3617116290,3514741348,1672648586,1672651941,3355
3433,3783169442,3905196766,1672552332,1672554066,1734
3591,3733558985,3404025196,1672595712,1672597319,1607
3586,3441703884,3500949309,1672571049,1672573617,2568
3685,3885121158,3774876004,1672553168,1672555283,2115
3596,3617304541,3776518452,1672591005,1672591367,362
3754,3488686442,3500498112,1672570938,1672571348,410
3704,3791106564,3399472693,1672555073,1672558326,3253
3479,3610358027,3512882178,1672587398,1672587542,144
3545,3515402792,3685681577,1672676540,1672678812,2272
3603,3350095157,3201629017,1672700164,1672701004,840
3900,3760040019,3715707380,1672690598,1672694197,3599
3908,3755404116,3612689556,1672698151,1672700637,2486
3738,3289817992,3371455553,1672568371,1672569230,859
3710,3274831810,3401496246,1672694438,1672696934,2496
3816,3516903528,3776988674,1672573423,1672574188,765
3541,3685816610,3519142371,1672693226,1672694607,1381
3627,3500341755,3792538417,1672615430,1672617436,2006
3864,3756625818,3505434346,1672641858,1672645116,3258
3647,3783919913,3505888598,1672679762,1672681739,1977
3558,3559731671,3520578796,1672603247,1672604980,1733
3623,3303410628,3401496246,1672656334,1672656918,584
3510,3739911441,3505663516,1672600655,1672603858,3203
3448,3757294769,3417679834,1672541542,1672541665,123
3841,3300229945,3505888598,1672561997,1672565143,3146
3429,3617304541,3289817992,1672668448,1672669423,975
3729,3701424609,3688490530,1672654750,1672655012,262
3742,3777485931,3776084820,1672621317,1672622588,1271
3752,3802932312,3273981374,1672598275,1672599459,1184
3487,3923754072,3435116799,1672551034,1672552259,1225
3519,3779425804,3713589994,1672615823,1672616157,334
3607,3509893027,3915162005,1672565097,1672567123,2026
3449,3552824113,3774178201,1672683954,1672686567,2613
3913,3885121158,3201676087,1672572619,1672573897,1278
3497,3493017654,3518194482,1672552651,1672553188,537
3555,3512295534,3449639012,1672681968,1672682685,717
3437,3923420131,3511883730,1672654630,1672655370,740
3881,3777485931,3610870949,1672628660,1672630655,1995
3746,3463849738,3756385685,1672670817,1672672232,1415
3882,3311049964,3402385957,1672572607,1672573215,608
3732,3304971369,3792020993,1672617515,1672618246,731
3814,3410538749,3501567772,1672619889,1672620435,546
3837,3300511067,3368283077,1672573361,1672573672,311
3785,3363162590,3357289672,1672597194,1672598924,1730
3484,3618176292,3389634034,1672686202,1672688816,2614
3883,3276217799,3791613604,1672574926,1672576740,1814
3544,3791441520,3334951866,1672632774,1672635494,2720
3714,3229974066,3711637255,1672592982,1672595292,2310
3870,3270042456,3613338363,1672677316,1672678814,1498
3782,3512383699,3783340788,1672655148,1672657342,2194
3865,3979784676,3760924079,1672618144,1672619619,1475
3776,3505923418,3701136026,1672573362,1672574976,1614
3891,3791613604,3912891315,1672659354,1672661126,1772
3816,3512946768,3231713082,1672576282,1672578385,2103
3744,3792442597,3909094917,1672701959,1672703363,1404
3651,3472068734,3224968597,1672674279,1672674684,405
3502,3505634634,3279475486,1672633349,1672635391,2042
3604,3511791953,3713768950,1672576668,1672577802,1134
3624,3512295534,3618489670,1672678638,1672679892,1254
3510,3226511603,3835985172,1672534083,1672535491,1408
3500,3680843171,3630353876,1672643622,1672643695,73
3507,3783373154,3428027649,1672655464,1672657297,1833
3893,3778597171,3711006062,1672589358,1672591399,2041
3590,3462636434,3783136330,1672626569,1672629586,3017
3858,3756704774,3935487534,1672680562,1672681457,895
3460,3814677862,3897376951,1672622807,1672625431,2624
3508,3500208903,3608232640,1672602644,1672605949,3305
3654,3514703118,3449333754,1672633503,1672635909,2406
3909,3334993594,3551389192,1672693133,1672693514,381
3753,3715619259,3401793306,1672648794,1672651926,3132
3705,3336339664,3500709774,1672648157,1672651334,3177
3681,3737972328,3934064792,1672678699,1672681590,2891
3544,3447514821,3921648519,1672645701,1672648767,3066
3536,3897456874,3835422146,1672614046,1672617522,3476
3892,3228888030,3756385685,1672596045,1672597132,1087
3651,3777485931,3206837348,1672665337,1672667329,1992
3757,3638204468,3610870949,1672536039,1672538715,2676
3529,3885157459,3834963772,1672534266,1672536448,2182
3529,3839245934,3819767045,1672569089,1672570882,1793
3704,3757348722,3559731671,1672689795,1672692168,2373
3651,3739895284,3447514821,1672595087,1672598615,3528
3489,3517697722,3395201292,1672534411,1672535897,1486
3843,3701247948,3701882224,1672559134,1672559809,675
3788,3500737582,3760645796,1672674922,1672677294,2372
3859,3621461051,3272716462,1672580486,1672581956,1470
3583,3970603231,3668414677,1672549426,1672549944,518
3704,3779639983,3760040019,1672639491,1672641837,2346
3633,3231494505,3739895284,1672597609,1672600376,2767
3714,3414049538,3669146016,1672597808,1672599609,1801
3864,3793883863,3416987084,1672670556,1672671738,1182
3664,3660887799,3779465522,1672586093,1672586350,257
3879,3392836218,3283144118,1672545667,1672546560,893
3539,3534175249,3604867757,1672575515,1672578616,3101
3613,3461119815,3757383891,1672618757,1672620223,1466
3707,3230135532,3515439826,1672698835,1672701709,2874
3588,3333403880,3500072204,1672626273,1672628525,2252
3860,3791128487,3897435944,1672670400,1672672609,2209
3705,3505923418,3500072204,1672580509,1672582584,2075
3701,3410538749,3711218296,1672632772,1672635377,2605
3476,3311420950,3668414677,1672562919,1672565536,2617
3781,3512295534,3701247948,1672681790,1672681963,173
3592,3501525100,3714120857,1672605526,1672608082,2556
3693,3755233658,3783801141,1672576655,1672578932,2277
3567,3202804048,3398198430,1672538035,1672539226,1191
3474,3617304541,3756474459,1672597394,1672599181,1787
3904,3715443333,3664943873,1672562673,1672563752,1079
3826,3774705415,3500302272,1672592055,1672594605,2550
3460,3303410628,3362641275,1672558948,1672559106,158
3609,3625463628,3755573472,1672666215,1672667124,909
3492,3284947372,3686523546,1672633753,1672636483,2730
3692,3760362417,3510919821,1672640209,1672641642,1433
3908,3291933594,3600876425,1672563283,1672565148,1865
3441,3737147209,3306175858,1672697874,1672698944,1070
3555,3463849738,3757294769,1672545719,1672548702,2983
3490,3635169815,3636329663,1672613726,1672616117,2391
3847,3801645328,3701136026,1672601961,1672604503,2542
3532,3510837901,3815392801,1672657879,1672659918,2039
3802,3534566651,3272096759,1672597731,1672599992,2261
3561,3505725706,3514956366,1672544861,1672547421,2560
3717,3447672935,3201800997,1672632115,1672635105,2990
3449,3516513251,3518653080,1672701713,1672703213,1500
3507,3660063072,3480991549,1672598973,1672602175,3202
3737,3514334067,3772236797,1672623122,1672623888,766
3907,3448875382,3776084820,1672703340,1672703438,98
3482,3777779869,3454277788,1672680621,1672681294,673
3747,3970603231,3284932450,1672626126,1672627458,1332
3637,3499217428,3512722110,1672569496,1672570104,608
3441,3710008361,3446533960,1672578831,1672581613,2782
3910,3792525861,3300979975,1672693856,1672695136,1280
3803,3515439826,3239617320,1672535244,1672536352,1108
3880,3469254160,3792801638,1672666031,1672668197,2166
3604,3793583656,3450969839,1672639195,1672642693,3498
3865,3513296868,3554825448,1672694166,1672697678,3512
3668,3625463628,3773027597,1672531255,1672534806,3551
3454,3927403123,3757318448,1672658323,1672660597,2274
3875,3285204083,3711218296,1672677448,1672677797,349
3661,3668414677,3201800997,1672568937,1672572475,3538
3899,3510641433,3710315160,1672682713,1672684754,2041
3692,3401793306,3773902805,1672603522,1672604578,1056
3895,3513545422,3202804048,1672548689,1672549094,405
3870,3783771827,3623266256,1672585315,1672586519,1204
3720,3824641227,3520657891,1672615298,1672616791,1493
3456,3667427125,3780769110,1672607439,1672608907,1468
3432,3469254160,3439673892,1672571678,1672573181,1503
3779,3516741440,3778899160,1672663127,1672663693,566
3829,3514956366,3779892400,1672646720,1672649162,2442
3500,3438489358,3711006062,1672583571,1672583992,421
3491,3791046864,3776518452,1672586598,1672587435,837
3814,3500841914,3394297564,1672577139,1672580293,3154
3869,3224811762,3412006598,1672574937,1672577573,2636
3528,3500302272,3776034743,1672538316,1672539852,1536
3545,3511843593,3505179890,1672645844,1672648231,2387
3621,3276348699,3777147510,1672614641,1672617997,3356
3795,3403370192,3380130228,1672619475,1672622673,3198
3823,3519087371,3551376095,1672585738,1672588976,3238
3467,3452016771,3497095254,1672557571,1672559800,2229
3603,3500341755,3403370192,1672624007,1672627223,3216
3590,3514419100,3386758279,1672645005,1672646490,1485
3603,3200543880,3360069849,1672593971,1672597020,3049
3434,3618489670,3436257398,1672696671,1672698697,2026
3447,3501525100,3783147088,1672630371,1672633548,3177
3719,3713911104,3780769110,1672609973,1672612029,2056
3809,3395201292,3807212280,1672662058,1672663150,1092
3690,3514246749,3411688875,1672650455,1672651013,558
3539,3711077927,3885155975,1672680905,1672681052,147
3876,3711218296,3374183227,1672600776,1672603634,2858
3606,3469254160,3500703304,1672553484,1672556928,3444
3438,3713979100,3337362061,1672542464,1672544545,2081
3471,3510837901,3367111751,1672600652,1672601155,503
3705,3713691388,3734118023,1672623817,1672624696,879
3884,3500498112,3776244398,1672662006,1672663106,1100
3868,3341893384,3610870949,1672662761,1672664835,2074
3625,3636329663,3715986185,1672578517,1672581555,3038
3511,3791046864,3455018347,1672565572,1672567622,2050
3765,3417679834,3604867757,1672687832,1672688658,826
3593,3376467719,3272030610,1672635836,1672638879,3043
3571,3363162590,3551389192,1672624830,1672626430,1600
3482,3493017654,3792949946,1672613769,1672615889,2120
3910,3852533643,3770236215,1672660472,1672661477,1005
3567,3411688875,3970909253,1672608899,1672612185,3286
3888,3814305099,3835985172,1672669072,1672671184,2112
3850,3607882826,3926643445,1672669812,1672670331,519
3529,3792489602,3429943738,1672695639,1672696604,965
3553,3668414677,3438489358,1672548493,1672551499,3006
3835,3826238375,3435167810,1672612504,1672615511,3007
3765,3760364383,3315703693,1672592579,1672593980,1401
3767,3399518841,3890739241,1672702555,1672705741,3186
3764,3713589994,3241790910,1672609767,1672612715,2948
3658,3713691388,3534543776,1672640604,1672643746,3142
3788,3376467719,3895285664,1672678857,1672679397,540
3706,3505481368,3202804048,1672621485,1672622251,766
3490,3272096759,3739895284,1672682264,1672682522,258
3716,3401793306,3512830734,1672564169,1672566156,1987
3678,3970909253,3773124276,1672643553,1672643683,130
3756,3639050419,3772391882,1672595462,1672598556,3094
3818,3757075324,3912891315,1672546639,1672548985,2346
3794,3294703680,3755532873,1672651994,1672655226,3232
3697,3513545422,3737972328,1672581348,1672581927,579
3513,3401496246,3604589802,1672577587,1672578990,1403
3831,3615113018,3885157459,1672531382,1672531453,71
3433,3714120857,3736231757,1672538319,1672539108,789
3588,3380130228,3512499658,1672615341,1672618870,3529
3559,3513853403,3517288083,1672627427,1672630781,3354
3785,3661903000,3519028898,1672594584,1672595113,529
3522,3792801638,3505111292,1672604427,1672606164,1737
3539,3400069268,3224330592,1672655543,1672657686,2143
3515,3803389195,3225631197,1672666571,1672669041,2470
3815,3757332128,3815392801,1672563142,1672564614,1472
3812,3300229945,3229974066,1672578090,1672580628,2538
3672,3431460073,3884596900,1672564054,1672566887,2833
3507,3410538749,3755992176,1672692509,1672695190,2681
3624,3773902805,3505154885,1672644210,1672647168,2958
3553,3885121158,3436257398,1672554659,1672555340,681
3657,3505198734,3230868435,1672634453,1672637205,2752
3855,3519850727,3514308235,1672685947,1672688410,2463
3476,3904569677,3779639983,1672600859,1672601896,1037
3522,3306175858,3617392620,1672655863,1672657294,1431
3642,3300979975,3349856820,1672563375,1672566410,3035
3583,3774876004,3519850727,1672640339,1672640437,98
3554,3935913584,3792949946,1672577383,1672580168,2785
3887,3518194482,3519282716,1672638795,1672641766,2971
3443,3713691388,3410600350,1672568317,1672570263,1946
3623,3488686442,3500044458,1672687852,1672689873,2021
3835,3554825448,3791613604,1672628421,1672631936,3515
3582,3738026330,3509756823,1672637471,1672640417,2946
3697,3338390596,3334974375,1672560623,1672563035,2412
3529,3934064792,3311420950,1672664461,1672665243,782
3658,3772236797,3505437712,1672564063,1672567263,3200
3614,3715400486,3631479562,1672532047,1672533596,1549
3592,3516703758,3770236215,1672610584,1672611514,930
3646,3387594369,3241914067,1672578010,1672580128,2118
3867,3518561777,3533090502,1672563387,1672565412,2025
3480,3520560590,3715400486,1672550325,1672551822,1497
3575,3501786419,3272096759,1672640115,1672640859,744
3485,3208957949,3715854030,1672600429,1672601596,1167
3812,3618697021,3206837348,1672635052,1672637505,2453
3646,3534566651,3513296868,1672689151,1672692649,3498
3431,3384583385,3711637255,1672540656,1672543969,3313
3881,3316800320,3803389195,1672693507,1672693578,71
3431,3230868435,3411515369,1672579782,1672580712,930
3693,3362641275,3609881958,1672648681,1672652206,3525
3758,3815250107,3934064792,1672602944,1672603212,268
3909,3499217428,3617116290,1672654957,1672655846,889
3604,3514971533,3774876004,1672556998,1672558414,1416
3593,3387594369,3518561777,1672540436,1672542601,2165
3602,3739895284,3516489668,1672560654,1672560874,220
3766,3279475486,3772236797,1672641701,1672641946,245
3705,3625463628,3398731252,1672588216,1672590924,2708
3717,3755233658,3505807416,1672627828,1672629549,1721
3792,3559731671,3500442734,1672683611,1672686462,2851
3808,3519818818,3445206685,1672640368,1672642350,1982
3637,3551376095,3920497528,1672625328,1672626871,1543
3481,3293835352,3792505974,1672658130,1672659350,1220
3869,3220031931,3778040015,1672568571,1672569944,1373
3560,3660887799,3801645328,1672550269,1672552590,2321
3742,3737112297,3773009828,1672575468,1672576861,1393
3698,3900945856,3551389192,1672634432,1672637512,3080
3479,3401793306,3713829743,1672655731,1672657557,1826
3812,3239617320,3716110860,1672702822,1672705310,2488
3850,3512282789,3495911207,1672600288,1672602071,1783
3534,3379143440,3604589802,1672632840,1672636230,3390
3557,3501567772,3836241528,1672624082,1672624890,808
3829,3711734586,3518194482,1672620658,1672624026,3368
3794,3791436104,3414049538,1672650497,1672650948,451
3890,3760721303,3609933747,1672538676,1672540386,1710
3839,3401940259,3280268483,1672564773,1672567496,2723
3866,3520322124,3716272919,1672614861,1672615540,679
3675,3923420131,3505923418,1672665879,1672668703,2824
3903,3279242917,3451326054,1672564026,1672564394,368
3897,3853629553,3615113018,1672657623,1672659391,1768
3655,3716110860,3200543880,1672603308,1672603546,238
3748,3858172636,3517687662,1672617644,1672618956,1312
3631,3773837847,3777147510,1672612568,1672613061,493
3744,3923754072,3701107228,1672604507,1672608100,3593
3779,3300818269,3733363628,1672560065,1672561589,1524
3851,3925979970,3304155815,1672652946,1672656312,3366
3533,3760040019,3533004959,1672617390,1672618886,1496
3491,3283770991,3380767040,1672662951,1672665171,2220
3545,3853629553,3613581796,1672557051,1672558380,1329
3489,3667427125,3661447322,1672686274,1672689062,2788
3711,3505663516,3448633776,1672554081,1672555839,1758
3661,3512337405,3517697722,1672610233,1672611134,901
3635,3897456874,3451726367,1672538313,1672540690,2377
3909,3777147510,3731646673,1672674161,1672674916,755
3552,3497095254,3824641227,1672667218,1672667526,308
3494,3757318448,3715400486,1672534287,1672535127,840
3495,3231494505,3510187271,1672666008,1672667083,1075
3899,3791246640,3824641227,1672544059,1672546654,2595
3738,3330340793,3311498666,1672586137,1672588795,2658
3582,3509764635,3394297564,1672676890,1672679433,2543
3463,3701136026,3224330592,1672566326,1672567492,1166
3842,3280268483,3914691363,1672544836,1672545873,1037
3866,3517991730,3793868716,1672645545,1672646052,507
3775,3499217428,3757700712,1672538930,1672541575,2645
3476,3354144091,3500317969,1672565401,1672566174,773
3860,3739911441,3520322124,1672690999,1672693368,2369
3898,3635169815,3835985172,1672688819,1672688941,122
3727,3283770991,3505437712,1672646703,1672649793,3090
3810,3715400486,3935487534,1672673303,1672674117,814
3753,3880926355,3792072681,1672686503,1672687250,747
3522,3292147449,3440107959,1672578483,1672579113,630
3671,3382733096,3487875183,1672681256,1672683728,2472
3502,3701882224,3367509761,1672663854,1672666077,2223
3467,3701823816,3665998641,1672663621,1672666095,2474
3887,3970198861,3774790271,1672639023,1672642550,3527
3706,3500604680,3713768950,1672546151,1672546605,454
3683,3791436104,3421385957,1672571245,1672573622,2377
3455,3855583256,3510028805,1672604733,1672607806,3073
3588,3609659642,3500604680,1672575775,1672576467,692
3563,3505178849,3902760230,1672602089,1672605659,3570
3904,3373028638,3533294425,1672639916,1672641617,1701
3647,3793583656,3516321888,1672680813,1672681156,343
3514,3773902805,3774178201,1672697617,1672699377,1760
3498,3783919913,3374183227,1672544395,1672544965,570
3497,3757903168,3757193551,1672622900,1672624176,1276
3879,3685816610,3520560590,1672575398,1672577495,2097
3433,3757863420,3293835352,1672567778,1672570993,3215
3891,3612689556,3392836218,1672690938,1672692215,1277
3884,3711097754,3401793306,1672672544,1672674428,1884
3846,3551389192,3971806004,1672683683,1672684653,970
3624,3552824113,3500525825,1672684668,1672686141,1473
3794,3437286517,3451326054,1672645737,1672647014,1277
3774,3292147449,3518653080,1672596959,1672599870,2911
3838,3208957949,3834963772,1672632208,1672633554,1346
3446,3505481368,3920497528,1672612901,1672613845,944
3708,3734451191,3431460073,1672693729,1672696768,3039
3892,3711077927,3938389661,1672598680,1672599382,702
3651,3510642075,3472312341,1672689938,1672690362,424
3780,3793883863,3225636215,1672632807,1672633512,705
3756,3469254160,3520764926,1672689118,1672689241,123
3796,3500317969,3893912331,1672664060,1672666166,2106
3654,3311049964,3505437712,1672561732,1672562306,574
3466,3298151889,3343132529,1672602071,1672602958,887
3848,3296462324,3773121782,1672681433,1672684639,3206
3432,3511317276,3505402439,1672556849,1672557413,564
3650,3311049964,3472312341,1672603668,1672603828,160
3711,3817428320,3296462324,1672647320,1672650185,2865
3537,3518194482,3779646172,1672561606,1672562229,623
3702,3792525861,3456430614,1672684629,1672687858,3229
3650,3974674109,3245232284,1672655849,1672657023,1174
3718,3661583097,3853629553,1672647196,1672650119,2923
3515,3897456874,3777147510,1672647359,1672648314,955
3536,3825881598,3610358027,1672546835,1672549181,2346
3845,3516489668,3713300120,1672654671,1672656303,1632
3502,3773033649,3811040565,1672673549,1672675722,2173
3648,3520322124,3755573472,1672595528,1672595886,358
3874,3276348699,3755158925,1672624532,1672624627,95
3604,3441348818,3533929349,1672593154,1672596233,3079
3516,3776084820,3774790271,1672538057,1672538711,654
3697,3880926355,3783136330,1672574001,1672576894,2893
3809,3306175858,3778899160,1672700239,1672701528,1289
3597,3802932312,3394297564,1672683663,1672686765,3102
3498,3284932450,3454277788,1672692993,1672693374,381
3859,3491469603,3739154408,1672633371,1672636087,2716
3855,3336339664,3791693821,1672691403,1672692383,980
3591,3436257398,3270056120,1672651166,1672654649,3483
3776,3774907131,3899786664,1672648139,1672649429,1290
3580,3513545422,3337362061,1672595268,1672596555,1287
3773,3899326793,3618808151,1672615834,1672617496,1662
3549,3438489358,3783340788,1672567485,1672570045,2560
3834,3334951866,3396726504,1672557812,1672560796,2984
3520,3776518452,3421385957,1672544002,1672545722,1720
3817,3285204083,3461119815,1672642278,1672642896,618
3503,3457960571,3400763927,1672601022,1672602345,1323
3748,3710562338,3392943173,1672644835,1672645086,251
3429,3755158925,3755222916,1672630050,1672631497,1447
3837,3685816610,3513545422,1672601006,1672604529,3523
3709,3701247948,3513296868,1672622211,1672622648,437
3737,3421877923,3509366311,1672546960,1672550099,3139
3655,3756474459,3916490839,1672596004,1672596288,284
3427,3756474459,3970909253,1672648880,1672649001,121
3542,3780322355,3760640999,1672679160,1672680275,1115
3628,3519909393,3373028638,1672699537,1672699750,213
3440,3779639983,3515402792,1672589333,1672589536,203
3857,3284932450,3760645796,1672588067,1672588329,262
3619,3501281016,3716110860,1672550579,1672551627,1048
3828,3710735406,3334647380,1672702664,1672706242,3578
3595,3304155815,3399472693,1672579342,1672580625,1283
3448,3756704774,3885155975,1672578379,1672579323,944
3689,3979802715,3509483172,1672641518,1672644047,2529
3679,3834960360,3512392431,1672594359,1672596087,1728
3425,3783550022,3815392801,1672666268,1672669448,3180
3800,3970558632,3715385401,1672648173,1672650508,2335
3754,3755496114,3607768197,1672615510,1672616170,660
3537,3382733096,3770676872,1672681646,1672684964,3318
3542,3792525861,3600876425,1672559361,1672561286,1925
3561,3779646172,3617489344,1672577682,1672577789,107
3866,3279473441,3511883730,1672627850,1672629270,1420
3708,3519416013,3739911441,1672584338,1672587078,2740
3588,3513295938,3756746867,1672696590,1672696656,66
3449,3505434346,3780115155,1672572285,1672573510,1225
3759,3716110860,3756127300,1672671731,1672674355,2624
3824,3779892400,3711919537,1672641823,1672644477,2654
3611,3394297564,3337362061,1672551040,1672553149,2109
3597,3701884158,3274906650,1672607805,1672608058,253
3617,3774733620,3792546035,1672557928,1672561172,3244
3437,3778134418,3367111751,1672676414,1672679554,3140
3450,3755848152,3517222913,1672690332,1672693867,3535
3769,3276003502,3618489670,1672702693,1672703916,1223
3693,3892304880,3935913584,1672622651,1672626147,3496
3644,3833217041,3739895284,1672664264,1672666765,2501
3770,3972083617,3777779869,1672606694,1672610231,3537
3579,3793868716,3399472693,1672683328,1672685277,1949
3663,3701424609,3514956366,1672642143,1672645273,3130
3819,3271752081,3732584121,1672623771,1672627279,3508
3582,3414940786,3511024016,1672580893,1672583983,3090
3707,3500317969,3970909253,1672602644,1672605736,3092
3695,3505847380,3915162005,1672539733,1672541737,2004
3542,3347419520,3454277788,1672540605,1672542498,1893
3428,3737147209,3938389661,1672556694,1672558272,1578
3615,3231494505,3800257590,1672637391,1672640303,2912
3746,3667673649,3710008361,1672555439,1672556315,876
3917,3480100311,3505923418,1672659759,1672662425,2666
3801,3757323954,3614740489,1672695844,1672697489,1645
3861,3533188828,3791128487,1672693971,1672696285,2314
3511,3774733620,3777240360,1672685051,1672688256,3205
3754,3710048469,3703139663,1672561542,1672564348,2806
3694,3776084820,3716628503,1672618553,1672618993,440
3731,3624297844,3513360004,1672671911,1672675265,3354
3815,3755222916,3518229776,1672690890,1672691656,766
3565,3774733620,3418448389,1672576549,1672579562,3013
3850,3226024417,3777624586,1672605983,1672606914,931
3825,3760842815,3311420950,1672599246,1672601194,1948
3845,3283492940,3711853996,1672545556,1672545766,210
3727,3716963089,3481640525,1672662848,1672663372,524
3833,3927599181,3757383891,1672573849,1672574974,1125
3824,3469254160,3783373154,1672629591,1672630891,1300
3908,3902861231,3730071479,1672559099,1672561221,2122
3472,3294747828,3343816795,1672687109,1672690458,3349
3510,3773913680,3680843171,1672552148,1672554486,2338
3467,3244004456,3793315718,1672677020,1672678451,1431
3534,3505179890,3533079336,1672577182,1672580471,3289
3844,3923420131,3773033649,1672697033,1672699446,2413
3711,3248058676,3449333754,1672650902,1672651424,522
3637,3516741440,3311098437,1672636795,1672637842,1047
3549,3791046864,3206837348,1672545029,1672546361,1332
3528,3306175858,3505154885,1672644053,1672644253,200
3578,3757323954,3714678331,1672617790,1672619400,1610
3746,3534764451,3793418209,1672649055,1672652553,3498
3524,3774178201,3935487534,1672619991,1672623064,3073
3745,3396980894,3779639983,1672599936,1672601850,1914
3593,3533004959,3900898992,1672664221,1672665465,1244
3580,3739895284,3818575661,1672650366,1672651083,717
3682,3779438325,3367971170,1672541775,1672544282,2507
3591,3285204083,3271752081,1672629898,1672632321,2423
3449,3312998540,3852686295,1672578244,1672579966,1722
3453,3824215187,3228888030,1672639251,1672639947,696
3700,3979802715,3354144091,1672587458,1672588467,1009
3864,3513041785,3807212280,1672609553,1672612890,3337
3658,3817813340,3902760230,1672534021,1672536729,2708
3877,3373028638,3299781901,1672690546,1672693543,2997
3826,3505198734,3780472203,1672631160,1672631991,831
3510,3607882826,3225631197,1672634377,1672635841,1464
3596,3519909393,3518194482,1672701274,1672704418,3144
3490,3609933747,3480490124,1672638898,1672640163,1265
3802,3417191856,3450286949,1672532054,1672533976,1922
3792,3400069268,3783919913,1672658551,1672661783,3232
3790,3533004959,3534764451,1672550891,1672554119,3228
3620,3686523546,3505283390,1672636697,1672640169,3472
3506,3515439826,3534543776,1672696429,1672696576,147
3921,3773033649,3490214516,1672670309,1672672714,2405
3477,3778640261,3613899351,1672584163,1672585152,989
3784,3288762795,3366423342,1672681550,1672684230,2680
3830,3316800320,3710496785,1672554346,1672555981,1635
3849,3481640525,3446533960,1672671309,1672674621,3312
3666,3755737419,3392943173,1672629134,1672631802,2668
3719,3203538212,3793868716,1672696891,1672698980,2089
3811,3556969573,3633735593,1672665838,1672669295,3457
3791,3783169442,3360069849,1672677240,1672678332,1092
3562,3463849738,3239617320,1672556056,1672558643,2587
3885,3856606678,3821054646,1672703740,1672707319,3579
3731,3783771827,3756127300,1672550258,1672551148,890
3696,3792546035,3770146716,1672653063,1672654839,1776
3730,3384068080,3298151889,1672539103,1672539644,541
3656,3899326793,3299443125,1672654641,1672657995,3354
3675,3638660068,3480991549,1672552933,1672555638,2705
3446,3923420131,3446533960,1672657968,1672658674,706
3749,3492959689,3970198861,1672691437,1672692588,1151
3867,3661903000,3431502855,1672538295,1672540212,1917
3690,3971806004,3371455553,1672668914,1672670847,1933
3466,3400069268,3701005527,1672656926,1672659831,2905
3650,3520181148,3390660440,1672606187,1672607189,1002
3714,3414275042,3510964997,1672678434,1672679513,1079
3620,3513296868,3519909393,1672538659,1672538832,173
3731,3520657891,3895285664,1672658899,1672659786,887
3721,3534543776,3773121782,1672616271,1672616721,450
3445,3667673649,3921648519,1672573904,1672577003,3099
3830,3516298579,3710008361,1672565810,1672566176,366
3830,3710315160,3880926355,1672554183,1672556226,2043
3542,3780571086,3534829213,1672621685,1672623073,1388
3442,3927165965,3228888030,1672611050,1672611759,709
3685,3801645328,3463849738,1672556720,1672558551,1831
3483,3793418209,3714128600,1672614018,1672616736,2718
3487,3398198430,3793743698,1672640137,1672643121,2984
3789,3512499658,3755230952,1672671860,1672673116,1256
3808,3618808151,3500915908,1672675900,1672677209,1309
3885,3428027649,3780769110,1672697335,1672699880,2545
3650,3533294425,3814305099,1672548694,1672549612,918
3670,3610358027,3714670620,1672543432,1672545738,2306
3720,3774243020,3792525861,1672643530,1672647055,3525
3712,3510818674,3714120857,1672639560,1672640521,961
3672,3669146016,3513545422,1672600678,1672603455,2777
3485,3615115210,3778667336,1672554412,1672554516,104
3891,3367509761,3815392801,1672697511,1672700128,2617
3860,3514246749,3714120857,1672578026,1672580209,2183
3750,3279473441,3626499450,1672561310,1672562617,1307
3712,3500208903,3501121099,1672581283,1672583260,1977
3548,3621790707,3505847380,1672589416,1672590739,1323
3626,3613581796,3362641275,1672592017,1672592264,247
3501,3398198430,3638660068,1672698695,1672701360,2665
3744,3467988782,3971806004,1672554442,1672555654,1212
3491,3800257590,3736705719,1672575392,1672578284,2892
3919,3791613604,3914691363,1672554592,1672557449,2857
3915,3716679950,3715707380,1672616060,1672618151,2091
3704,3791796585,3515559913,1672660601,1672661526,925
3850,3354144091,3559731671,1672636083,1672638138,2055
3867,3533188828,3933894942,1672687197,1672687942,745
3431,3299443125,3480991549,1672612618,1672615762,3144
3648,3776988674,3424445495,1672630968,1672631962,994
3846,3739661856,3852686295,1672642255,1672643811,1556
3752,3505807416,3514956366,1672669673,1672672637,2964
3432,3294703680,3774718695,1672651991,1672652371,380
3765,3205985903,3615113018,1672584943,1672585107,164
3716,3411688875,3499217428,1672608984,1672611040,2056
3778,3890739241,3977352557,1672668623,1672670228,1605
3627,3500072204,3667673649,1672593130,1672595229,2099
3598,3776244398,3272030610,1672615299,1672615760,461
3481,3293835352,3792442597,1672569156,1672569656,500
3783,3734451191,3288762795,1672614670,1672615235,565
3888,3505923418,3701884158,1672658696,1672662171,3475
3497,3462636434,3710489491,1672650895,1672652437,1542
3604,3755848152,3398198430,1672582982,1672586277,3295
3741,3890739241,3974674109,1672603733,1672607022,3289
3851,3270056120,3554944414,1672533080,1672536462,3382
3614,3552824113,3701424609,1672549203,1672551201,1998
3448,3512392431,3510028805,1672684168,1672684426,258
3806,3711097754,3970198861,1672673329,1672674749,1420
3673,3554186380,3514512367,1672643153,1672643454,301
3571,3239617320,3512722110,1672642013,1672644729,2716
3558,3283144118,3451691949,1672587131,1672589825,2694
3569,3930242012,3461119815,1672620986,1672624375,3389
3796,3703433819,3517600136,1672631762,1672634000,2238
3532,3505995057,3497095254,1672689819,1672690255,436
3818,3756625818,3238288884,1672677485,1672678743,1258
3449,3468041839,3512499658,1672562264,1672563003,739
3685,3276348699,3783433404,1672568066,1672571451,3385
3832,3618697021,3920898925,1672577885,1672579124,1239
3761,3459681410,3414940786,1672589110,1672590240,1130
3680,3226024417,3703383853,1672561947,1672563739,1792
3859,3367111751,3363162590,1672569049,1672569258,209
3558,3559458968,3454277788,1672688152,1672689813,1661
3771,3402697190,3224811762,1672569201,1672572144,2943
3843,3517590837,3533079336,1672642043,1672644066,2023
3858,3778640261,3445206685,1672696531,1672698718,2187
3833,3518194482,3887243870,1672661321,1672662471,1150
3482,3509764635,3551389192,1672582615,1672585860,3245
3855,3401496246,3514818819,1672640747,1672642988,2241
3832,3384068080,3624297844,1672654979,1672656368,1389
3643,3777814504,3401940259,1672628271,1672631507,3236
3711,3206837348,3436025562,1672533978,1672534240,262
3447,3334974375,3517887477,1672554959,1672556113,1154
3814,3410600350,3885537225,1672679862,1672681353,1491
3591,3441348818,3777694660,1672686073,1672686717,644
3734,3450286949,3357689359,1672533756,1672536566,2810
3872,3400763927,3338083680,1672586596,1672590038,3442
3914,3703383853,3621184108,1672685439,1672687988,2549
3467,3739911441,3777330107,1672575210,1672576484,1274
3823,3779738691,3780909839,1672700195,1672702207,2012
3511,3858172636,3510818674,1672578136,1672578286,150
3734,3475349791,3505266860,1672549332,1672552077,2745
3831,3517358573,3711637255,1672542281,1672545714,3433
3470,3520560590,3757700712,1672599696,1672600754,1058
3586,3520873221,3773735484,1672592732,1672595233,2501
3545,3686523546,3683113954,1672553313,1672556596,3283
3542,3780834916,3293835352,1672690726,1672693867,3141
3859,3916490839,3710854064,1672637511,1672638513,1002
3526,3755532873,3760721303,1672651256,1672653647,2391
3494,3220031931,3208957949,1672568218,1672568495,277
3827,3757318448,3410160376,1672643400,1672645212,1812
3800,3516444201,3756704774,1672584270,1672587231,2961
3490,3380130228,3825881598,1672617970,1672619550,1580
3832,3895285664,3778040015,1672591140,1672593265,2125
3570,3627368399,3315279093,1672684846,1672684975,129
3875,3757903168,3244004456,1672678476,1672679070,594
3733,3684523966,3270697740,1672582630,1672585020,2390
3559,3200308999,3777330107,1672583749,1672584093,344
3614,3518194482,3512383699,1672575617,1672576610,993
3657,3852533643,3366423342,1672682832,1672685849,3017
3633,3236499444,3519087371,1672603363,1672605348,1985
3687,3533228966,3811040565,1672638719,1672639130,411
3823,3885537225,3716679950,1672676379,1672679332,2953
3817,3780427126,3800257590,1672604476,1672608054,3578
3808,3308760650,3228888030,1672580295,1672580464,169
3549,3343816795,3274906650,1672682602,1672683232,630
3474,3615737355,3631479562,1672661520,1672662480,960
3760,3777694660,3613416045,1672688672,1672689666,994
3857,3225029895,3347419520,1672599529,1672602163,2634
3609,3513041785,3299443125,1672558939,1672562304,3365
3922,3977148669,3513065217,1672532233,1672533879,1646
3581,3236354255,3520639768,1672580099,1672582652,2553
3879,3774641380,3418448389,1672599998,1672600185,187
3817,3386758279,3300818269,1672662812,1672664167,1355
3885,3858172636,3500498112,1672595120,1672595488,368
3641,3779892400,3501384020,1672573583,1672576096,2513
3723,3793315718,3714128600,1672546080,1672549535,3455
3475,3710315160,3414275042,1672533336,1672535762,2426
3606,3457620713,3360069849,1672674534,1672674707,173
3615,3202804048,3385323994,1672548773,1672549619,846
3674,3608922867,3303410628,1672674811,1672677806,2995
3813,3802932312,3714670620,1672591261,1672592087,826
3660,3777240360,3495911207,1672639485,1672641115,1630
3462,3774733620,3519850727,1672610353,1672612776,2423
3545,3715086894,3203538212,1672699662,1672699750,88
3721,3631479562,3450286949,1672695344,1672697773,2429
3509,3366423342,3559731671,1672655454,1672656040,586
3440,3414049538,3347446226,1672579128,1672579983,855
3825,3280268483,3757700712,1672600740,1672603742,3002
3810,3904412440,3454277788,1672597826,1672599110,1284
3714,3401940259,3283770991,1672677571,1672679351,1780
3907,3438078818,3807212280,1672545803,1672548943,3140
3631,3713768950,3716110860,1672609134,1672612510,3376
3898,3370227921,3513065217,1672581795,1672581980,185
3537,3505995057,3760651515,1672622320,1672623476,1156
3429,3755848152,3410160376,1672563079,1672566539,3460
3703,3244004456,3273981374,1672579625,1672582123,2498
3756,3783147088,3607768197,1672591417,1672593942,2525
3637,3284947372,3812534508,1672636539,1672637742,1203
3552,3925979970,3487875183,1672607421,1672607830,409
3443,3520181148,3713911104,1672564908,1672568005,3097
3577,3836241528,3300511067,1672671521,1672671917,396
3918,3701884158,3938503547,1672554551,1672555879,1328
3891,3780338697,3533368789,1672600118,1672603658,3540
3716,3770146716,3792274796,1672534125,1672536842,2717
3643,3925979970,3792442597,1672696466,1672697469,1003
3776,3501281016,3311049964,1672613338,1672616488,3150
3830,3780115155,3244004456,1672665160,1672667788,2628
3860,3713517039,3205923620,1672685693,1672686874,1181
3502,3510818674,3505521218,1672583011,1672585006,1995
3451,3241790910,3688796737,1672612993,1672613720,727
3665,3311085279,3779639983,1672552377,1672553253,876
3677,3713561276,3979802715,1672702605,1672704697,2092
3810,3488686442,3923420131,1672625031,1672626335,1304
3641,3793743698,3772391882,1672658670,1672659527,857
3860,3409114719,3239617320,1672703478,1672705855,2377
3782,3511732493,3505154885,1672535310,1672536110,800
3741,3519028898,3889780657,1672604139,1672607346,3207
3653,3509764635,3703798634,1672596953,1672597341,388
3573,3276348699,3534543776,1672604526,1672605056,530
3843,3501459390,3668414677,1672546894,1672549552,2658
3751,3780712350,3732584121,1672681108,1672681467,359
3831,3774790271,3701322924,1672597265,1672599156,1891
3516,3779613523,3480100311,1672660265,1672663364,3099
3762,3757700712,3793781065,1672653484,1672655719,2235
3821,3608232640,3793743698,1672620701,1672623279,2578
3668,3885157459,3760651515,1672581183,1672584555,3372
3762,3776559988,3792745809,1672565973,1672566230,257
3577,3714128600,3552824113,1672579006,1672581998,2992
3611,3501525100,3201676087,1672674939,1672677291,2352
3922,3661583097,3614740489,1672640242,1672642350,2108
3580,3625463628,3380767040,1672598251,1672601523,3272
3872,3384068080,3513327337,1672555332,1672557544,2212
3502,3533090502,3757332128,1672613466,1672614571,1105
3560,3928719932,3334974375,1672626351,1672629466,3115
3777,3232208416,3480100311,1672643517,1672646611,3094
3705,3817428320,3515439826,1672590181,1672591259,1078
3586,3514334067,3710735406,1672554859,1672556056,1197
3635,3501567772,3713979100,1672553469,1672555527,2058
3481,3777184389,3367111751,1672614108,1672614528,420
3517,3755230952,3783169442,1672610331,1672611718,1387
3528,3236499444,3621790707,1672662669,1672664634,1965
3883,3296462324,3615113018,1672654632,1672655299,667
3913,3622357348,3500777439,1672547236,1672548870,1634
3637,3970627281,3226024417,1672540206,1672542717,2511
3610,3294703680,3479851674,1672555986,1672559420,3434
3712,3772391882,3236458894,1672625782,1672627482,1700
3649,3812369928,3783550022,1672567592,1672569044,1452
3832,3383138270,3370227921,1672678379,1672680929,2550
3828,3500442734,3738026330,1672577283,1672580196,2913
3850,3824641227,3638660068,1672643210,1672644907,1697
3823,3833217041,3776559988,1672700491,1672701285,794
3598,3713941638,3713784974,1672659560,1672662757,3197
3703,3792389522,3410600350,1672548161,1672548422,261
3772,3607768197,3930242012,1672537043,1672538051,1008
3699,3460719322,3773033649,1672557470,1672558634,1164
3650,3500613459,3713589994,1672570455,1672573593,3138
3775,3399472693,3364726656,1672682063,1672684468,2405
3558,3703433819,3513018485,1672599445,1672602424,2979
3818,3613206049,3669146016,1672692232,1672693230,998
3505,3812534508,3618808151,1672638382,1672641635,3253
3646,3514956366,3445206685,1672687943,1672688774,831
3665,3770146716,3501459390,1672602739,1672605499,2760
3572,3534829213,3514818819,1672671583,1672674268,2685
3558,3624297844,3756789525,1672637784,1672638481,697
3545,3972192593,3513041785,1672571071,1672573203,2132
3891,3638660068,3979802715,1672541790,1672545051,3261
3906,3791246640,3279475486,1672698554,1672699300,746
3451,3713979100,3500672156,1672661438,1672662117,679
3670,3791693821,3780427126,1672595982,1672596741,759
3463,3376467719,3201676087,1672543940,1672544059,119
3836,3505111292,3350095157,1672621696,1672621837,141
3513,3777184389,3518565331,1672648780,1672649030,250
3555,3367971170,3792949946,1672694309,1672695152,843
3525,3468041839,3732584121,1672633041,1672635988,2947
3742,3618489670,3517697722,1672591970,1672592624,654
3603,3834963772,3513410578,1672643218,1672643850,632
3874,3490214516,3701424609,1672558264,1672559195,931
3890,3701107228,3774641380,1672587433,1672589771,2338
3623,3912891315,3374183227,1672602807,1672606020,3213
3817,3792801638,3510554314,1672646907,1672649898,2991
3758,3480490124,3369708250,1672678475,1672678612,137
3431,3513065217,3617392620,1672685266,1672686958,1692
3514,3410538749,3905899155,1672691025,1672692651,1626
3736,3760645796,3373089838,1672677005,1672678706,1701
3658,3760924079,3520115090,1672623051,1672623324,273
3912,3497808662,3755756564,1672695532,1672697042,1510
3478,3310039260,3330340793,1672650263,1672653220,2957
3540,3630353876,3284947372,1672628126,1672628798,672
3623,3897134762,3491684096,1672663278,1672666289,3011
3641,3511732493,3760694096,1672599670,1672600801,1131
3579,3755737419,3505228454,1672698081,1672699370,1289
3631,3737972328,3248058676,1672684746,1672685974,1228
3502,3492546679,3815392801,1672596477,1672599982,3505
3521,3716110860,3514285803,1672627383,1672629467,2084
3853,3920898925,3779892400,1672684506,1672684692,186
3533,3772391882,3347446226,1672679612,1672680525,913
3846,3780338697,3626499450,1672534187,1672536242,2055
3544,3461119815,3500208903,1672587052,1672589316,2264
3545,3510187271,3614740489,1672605155,1672607453,2298
3764,3757903168,3701136026,1672571499,1672572960,1461
3781,3333403880,3505725706,1672633107,1672635068,1961
3611,3500841914,3713691388,1672577582,1672578937,1355
3433,3938389661,3230135532,1672595587,1672595941,354
3514,3513360004,3660887799,1672665045,1672666387,1342
3625,3623266256,3760094385,1672633111,1672634997,1886
3531,3661447322,3732131656,1672653050,1672654466,1416
3855,3852686295,3492546679,1672554830,1672555414,584
3695,3779786641,3274906650,1672548966,1672552092,3126
3875,3772078494,3362641275,1672585164,1672586165,1001
3571,3622357348,3608855425,1672609321,1672610338,1017
3660,3467779445,3733558985,1672640828,1672641808,980
3899,3858172636,3737972328,1672570753,1672572538,1785
3436,3972083617,3509893027,1672601077,1672604437,3360
3534,3533294425,3772765746,1672550837,1672551528,691
3841,3505179890,3424660806,1672612180,1672614031,1851
3614,3802932312,3495911207,1672581640,1672584570,2930
3569,3774790271,3711000597,1672641011,1672641377,366
3870,3710008361,3283144118,1672649595,1672651707,2112
3444,3338390596,3736231757,1672546533,1672548621,2088
3594,3701884158,3605221116,1672537588,1672540305,2717
3760,3756385685,3776244398,1672656682,1672659211,2529
3535,3738026330,3793781065,1672627365,1672629264,1899
3718,3518194482,3665998641,1672604461,1672605957,1496
3548,3714120857,3755573472,1672627313,1672630262,2949
3889,3783340788,3971806004,1672616041,1672619414,3373
3872,3336627643,3533188828,1672587941,1672590060,2119
3721,3279242917,3777694660,1672570884,1672572364,1480
3605,3621683102,3783147088,1672541503,1672543983,2480
3537,3757075324,3710562338,1672632032,1672633580,1548
3577,3711734586,3778667336,1672533635,1672535063,1428
3510,3880926355,3366423342,1672568058,1672568690,632
3608,3449639012,3410600350,1672554590,1672555695,1105
3794,3551389192,3755848152,1672593332,1672594013,681
3744,3757075324,3386758279,1672645872,1672649040,3168
3833,3202141727,3791441520,1672685484,1672686081,597
3676,3500044458,3685681577,1672572966,1672575672,2706
3784,3701882224,3757323954,1672589531,1672589734,203
3653,3779532653,3792745809,1672641839,1672642529,690
3628,3500737582,3885157459,1672650051,1672652915,2864
3699,3777037426,3774155692,1672571332,1672573316,1984
3513,3732131656,3500672156,1672635007,1672637934,2927
3737,3927599181,3336627643,1672533861,1672534433,572
3494,3977148669,3534126409,1672627210,1672630347,3137
3750,3887243870,3279242917,1672582336,1672584007,1671
3451,3792072681,3734451191,1672579621,1672581899,2278
3640,3520764926,3839245934,1672673601,1672673861,260
3849,3518561777,3755344363,1672560892,1672562616,1724
3596,3889780657,3490214516,1672648648,1672649443,795
3709,3206837348,3516741440,1672616827,1672619426,2599
3762,3835422146,3516703758,1672654442,1672657059,2617
3668,3534357694,3668414677,1672558147,1672560462,2315
3899,3800257590,3619922891,1672689682,1672692009,2327
3720,3533649454,3970558632,1672696847,1672698626,1779
3612,3511601997,3793418209,1672658251,1672659575,1324
3528,3778926763,3826238375,1672534085,1672536102,2017
3824,3513545422,3509764635,1672657227,1672660632,3405
3497,3300979975,3205923620,1672607674,1672608754,1080
3619,3791693821,3511601997,1672546824,1672547917,1093
3875,3621790707,3279475486,1672547927,1672549690,1763
3696,3932478321,3534357694,1672580422,1672582789,2367
3885,3510499038,3390660440,1672673408,1672676080,2672
3463,3713561276,3778597171,1672611575,1672614055,2480
3685,3519850727,3514971533,1672689876,1672692572,2696
3496,3509366311,3779301501,1672680160,1672682032,1872
3909,3294747828,3780909839,1672550099,1672552183,2084
3530,3418448389,3241790910,1672579873,1672582900,3027
3434,3774733620,3898314440,1672653514,1672654800,1286
3873,3770704999,3793922324,1672702422,1672705629,3207
3846,3774641380,3604589802,1672559040,1672561435,2395
3719,3779613523,3500613493,1672583192,1672583445,253
3683,3931627862,3357689359,1672563614,1672564077,463
3527,3360813161,3429943738,1672574498,1672576590,2092
3647,3285204083,3500341755,1672632621,1672633971,1350
3630,3900276517,3757193307,1672652672,1672654949,2277
3437,3615115210,3517991730,1672596190,1672598269,2079
3554,3382733096,3349856820,1672549299,1672552504,3205
3491,3773033649,3448875382,1672571065,1672572849,1784
3894,3737112297,3509764635,1672614045,1672616099,2054
3457,3783928182,3977148669,1672535883,1672537864,1981
3797,3510837901,3791106564,1672686904,1672688253,1349
3426,3519028898,3792949946,1672600277,1672601208,931
3769,3925979970,3755158925,1672648130,1672650512,2382
3597,3920898925,3777624586,1672652294,1672654835,2541
3906,3364726656,3439673892,1672640198,1672640659,461
3835,3792020993,3239617320,1672702590,1672703059,469
3827,3760640999,3533274994,1672603594,1672605278,1684
3853,3461119815,3443357683,1672672716,1672675820,3104
3584,3357289672,3534179433,1672685669,1672686554,885
3767,3779301501,3551389192,1672581161,1672584711,3550
3553,3315703693,3408430195,1672576001,1672576835,834
3505,3533228966,3516444201,1672571801,1672573261,1460
3515,3636329663,3403370192,1672593868,1672595658,1790
3706,3512383699,3513296868,1672684625,1672685459,834
3820,3505888598,3336627643,1672684210,1672684831,621
3657,3757318448,3773124276,1672698603,1672699935,1332
3717,3551376095,3274831810,1672641792,1672643344,1552
3490,3392520516,3341893384,1672538893,1672542242,3349
3711,3974674109,3772765746,1672580626,1672581634,1008
3795,3776117322,3514956366,1672679944,1672683286,3342
3565,3661447322,3241914067,1672621430,1672621861,431
3444,3279339278,3512383699,1672641814,1672643711,1897
3713,3933894942,3396726504,1672643950,1672644698,748
3904,3472068734,3517222913,1672683214,1672686674,3460
3800,3554186380,3389634034,1672672373,1672672754,381
3750,3617392620,3463849738,1672533564,1672535065,1501
3563,3757383891,3855583256,1672694224,1672695743,1519
3769,3710315160,3689114185,1672602699,1672605616,2917
3510,3347419520,3510641433,1672701897,1672704196,2299
3918,3626499450,3509483172,1672599674,1672601878,2204
3888,3300979975,3334951866,1672543075,1672543235,160
3810,3392836218,3519818818,1672562479,1672565804,3325
3644,3333403880,3515525630,1672599273,1672601052,1779
3845,3441348818,3500347447,1672637533,1672637727,194
3650,3517172354,3703139663,1672579541,1672582066,2525
3826,3399472693,3780680950,1672676538,1672677263,725
3527,3926643445,3774155692,1672652750,1672654643,1893
3687,3684523966,3370227921,1672619105,1672621920,2815
3775,3779438325,3440107959,1672568298,1672570958,2660
3566,3716679950,3734118023,1672637534,1672641058,3524
3477,3512392431,3437286517,1672660328,1672662631,2303
3472,3220031931,3520578796,1672691728,1672693804,2076
3456,3500915908,3713911104,1672671960,1672672882,922
3514,3970627281,3770146716,1672640306,1672642441,2135
3784,3520657891,3610870949,1672693856,1672695179,1323
3564,3755404116,3619922891,1672535342,1672538331,2989
3474,3701322924,3513065217,1672557453,1672557864,411
3917,3517172354,3755233658,1672573110,1672576457,3347
3535,3680843171,3505663516,1672694447,1672698027,3580
3840,3517358573,3618489670,1672551640,1672552433,793
3899,3756704774,3285204083,1672543802,1672546470,2668
3467,3208957949,3280054198,1672698710,1672700566,1856
3785,3638660068,3512830734,1672601993,1672602641,648
3443,3604867757,3760040019,1672700429,1672701273,844
3520,3519909393,3928511283,1672645032,1672645176,144
3631,3400069268,3517881647,1672647810,1672649441,1631
3761,3450969839,3456430614,1672622324,1672622870,546
3780,3770624662,3661903000,1672535542,1672536489,947
3647,3760364383,3440107959,1672628397,1672628777,380
3522,3609659642,3505521218,1672679413,1672679898,485
3444,3512722110,3520115090,1672573243,1672573776,533
3509,3514419100,3618808151,1672701559,1672703140,1581
3901,3300979975,3369708250,1672661611,1672664851,3240
3631,3500827202,3520578796,1672670806,1672674303,3497
3443,3613338363,3638660068,1672612037,1672614176,2139
3838,3276269264,3715385401,1672646452,1672646552,100
3731,3511288998,3500672156,1672655080,1672657709,2629
3489,3500442734,3515439826,1672676863,1672678417,1554
3761,3734118023,3738026330,1672636513,1672638082,1569
3853,3618176292,3633735593,1672552741,1672553786,1045
3442,3703383853,3780253901,1672643166,1672645242,2076
3486,3685681577,3513295938,1672589421,1672591163,1742
3543,3714185969,3773124276,1672591641,1672593236,1595
3909,3513065217,3812369928,1672699659,1672703095,3436
3533,3421877923,3399472693,1672582027,1672583911,1884
3446,3635169815,3626499450,1672566146,1672567886,1740
3810,3814305099,3703139663,1672571513,1672572900,1387
3583,3783919913,3776117322,1672535396,1672538209,2813
3773,3972083617,3617392620,1672599400,1672599473,73
3902,3825881598,3492546679,1672701879,1672704344,2465
3439,3514818819,3520181148,1672545989,1672549032,3043
3511,3505402439,3711097754,1672640518,1672641951,1433
3853,3357289672,3354144091,1672682742,1672683887,1145
3627,3509764635,3835985172,1672640589,1672641814,1225
3667,3605221116,3500841914,1672651971,1672654343,2372
3528,3447514821,3452016771,1672565870,1672568823,2953
3902,3664943873,3460719322,1672573522,1672574293,771
3495,3638660068,3505481368,1672568242,1672570590,2348
3721,3311498666,3431460073,1672585049,1672588498,3449
3799,3501786419,3701884158,1672583292,1672585264,1972
3912,3284932450,3248058676,1672609199,1672610808,1609
3858,3770676872,3534357694,1672566508,1672569473,2965
3639,3505663516,3300979975,1672661575,1672664897,3322
3562,3424660806,3351696332,1672612722,1672613272,550
3922,3398198430,3285204083,1672682837,1672684284,1447
3447,3715443333,3404025196,1672638404,1672640640,2236
3692,3661903000,3776518452,1672678522,1672682013,3491
3670,3270042456,3533747868,1672643706,1672645126,1420
3860,3511601997,3516489668,1672566193,1672569267,3074
3537,3373089838,3509764635,1672668711,1672670106,1395
3583,3308760650,3533747868,1672554078,1672555438,1360
3781,3350095157,3315703693,1672545342,1672545528,186
3470,3449639012,3669146016,1672531868,1672535346,3478
3513,3773939399,3431460073,1672545671,1672547638,1967
3884,3974674109,3480490124,1672620189,1672621712,1523
3557,3904569677,3310039260,1672631796,1672633515,1719
3854,3517881647,3472068734,1672542385,1672542696,311
3731,3534566651,3703348097,1672540468,1672542834,2366
3601,3899786664,3664943873,1672655152,1672658511,3359
3725,3480100311,3734915241,1672574881,1672575802,921
3632,3505178849,3274831810,1672565675,1672569125,3450
3669,3351696332,3373028638,1672545699,1672547395,1696
3786,3519087371,3514703118,1672576433,1672577954,1521
3699,3515402792,3624297844,1672538456,1672540643,2187
3639,3495911207,3239617320,1672648524,1672650524,2000
3515,3711637255,3452016771,1672637504,1672638254,750
3697,3462636434,3617392620,1672657968,1672659700,1732
3447,3238288884,3701882224,1672682572,1672682682,110
3714,3808136029,3615113018,1672585527,1672586398,871
3566,3609659642,3334993594,1672661950,1672663594,1644
3561,3533188828,3615087943,1672614164,1672616797,2633
3780,3392520516,3241914067,1672682802,1672683010,208
3470,3890739241,3890739241,1672637122,1672639441,2319
3775,3777147510,3608232640,1672547889,1672549166,1277
3569,3227799827,3756625818,1672551808,1672553389,1581
3701,3411688875,3291933594,1672703682,1672704981,1299
3607,3396980894,3304971369,1672621172,1672621790,618
3754,3516513251,3829864515,1672534573,1672537750,3177
3471,3513065217,3505481368,1672548529,1672550954,2425
3662,3475349791,3500302272,1672575202,1672576607,1405
3803,3315279093,3516741440,1672692849,1672694222,1373
3479,3364726656,3755230952,1672592376,1672592935,559
3714,3360616538,3923220461,1672651863,1672654009,2146
3612,3770704999,3757700712,1672657007,1672658774,1767
3665,3334974375,3288762795,1672626648,1672627050,402
3722,3715854030,3686227677,1672652775,1672655429,2654
3814,3224330592,3480100311,1672682885,1672683826,941
3473,3511791953,3791106564,1672633625,1672636513,2888
3814,3818575661,3487875183,1672563884,1672567254,3370
3815,3774243020,3774178201,1672639601,1672641989,2388
3795,3779646172,3467988782,1672700203,1672703400,3197
3783,3399472693,3276003502,1672560879,1672564136,3257
3886,3793883863,3821054646,1672605081,1672605586,505
3904,3664943873,3780834916,1672564422,1672566296,1874
3918,3515466096,3621461051,1672544344,1672545196,852
3481,3792020993,3665998641,1672556233,1672559595,3362
3503,3757323954,3614740489,1672631882,1672632955,1073
3612,3621683102,3515402792,1672555265,1672557365,2100
3916,3398731252,3760263530,1672620616,1672623833,3217
3581,3311498666,3770468980,1672540628,1672542289,1661
3518,3500915908,3970198861,1672699688,1672701265,1577
3764,3772765746,3757630221,1672640215,1672641814,1599
3694,3737972328,3435167810,1672593822,1672593929,107
3587,3457960571,3607882826,1672545739,1672546492,753
3496,3511288998,3303410628,1672597697,1672600997,3300
3698,3615115210,3533368789,1672575387,1672577549,2162
3474,3793883863,3500613493,1672659443,1672660159,716
3702,3625174002,3488686442,1672589499,1672592908,3409
3478,3710315160,3773009828,1672638613,1672640319,1706
3672,3512379024,3770236215,1672633926,1672636061,2135
3498,3500949309,3735374579,1672679372,1672680878,1506
3468,3890739241,3780571086,1672687126,1672688899,1773
3452,3357864626,3509764635,1672691904,1672695501,3597
3902,3715545685,3716628503,1672694467,1672695691,1224
3663,3414049538,3885121158,1672694478,1672695486,1008
3447,3770236215,3349856820,1672533706,1672535477,1771
3651,3244004456,3417679834,1672652039,1672654312,2273
3904,3514956366,3513081354,1672646745,1672649869,3124
3831,3711218296,3938503547,1672676147,1672678267,2120
3587,3431502855,3505521218,1672646890,1672647052,162
3481,3682133690,3480490124,1672549676,1672552466,2790
3832,3776084820,3793175445,1672685752,1672687342,1590
3644,3450286949,3559731671,1672607540,1672608132,592
3738,3916490839,3607882826,1672650629,1672652182,1553
3703,3792745809,3701882224,1672610712,1672611763,1051
3850,3371455553,3620292035,1672554158,1672557477,3319
3727,3773837847,3777240360,1672688258,1672691214,2956
3676,3516903528,3780680950,1672643948,1672644291,343
3836,3510818674,3802932312,1672655543,1672655878,335
3689,3668414677,3904412440,1672573567,1672577161,3594
3917,3360069849,3612689556,1672549301,1672550161,860
3663,3668747074,3410160376,1672582946,1672586047,3101
3511,3557046880,3519077659,1672645914,1672647432,1518
3905,3772078494,3457620713,1672689060,1672691016,1956
3465,3710735406,3783433404,1672646302,1672648536,2234
3867,3505178849,3512282789,1672701640,1672703378,1738
3586,3701107228,3283492940,1672599027,1672599458,431
3723,3756127300,3611055563,1672556474,1672557367,893
3668,3760362417,3792014516,1672622392,1672624150,1758
3627,3272716462,3402697190,1672535796,1672536655,859
3588,3632814465,3783433404,1672587990,1672591322,3332
3918,3909094917,3505198734,1672593630,1672595313,1683
3427,3613581796,3487875183,1672580584,1672582487,1903
3535,3770236215,3480100311,1672585148,1672586587,1439
3887,3792745809,3303410628,1672557009,1672557905,896
3571,3450286949,3609113156,1672546865,1672547464,599
3771,3757193551,3880926355,1672550423,1672551131,708
3755,3519142371,3780322355,1672689828,1672693363,3535
3468,3630353876,3505995057,1672591785,1672593322,1537
3605,3772391882,3801645328,1672569519,1672569990,471
3590,3514741348,3776988674,1672630555,1672630677,122
3649,3713768950,3885155975,1672624628,1672626546,1918
3718,3621461051,3514741348,1672629683,1672632812,3129
3610,3487875183,3240394404,1672643181,1672646486,3305
3872,3620292035,3755737419,1672544882,1672547581,2699
3818,3392943173,3229974066,1672575646,1672578050,2404
3603,3516741440,3510641433,1672591071,1672592359,1288
3582,3783169442,3520322124,1672563431,1672565140,1709
3826,3756625818,3757383891,1672652102,1672653036,934
3858,3688490530,3612689556,1672609525,1672609941,416
3645,3835422146,3688490530,1672544910,1672546656,1746
3719,3370068529,3304155815,1672654782,1672656899,2117
3574,3756474459,3513295938,1672642370,1672645769,3399
3572,3459681410,3505663516,1672688923,1672691765,2842
3544,3660887799,3683113954,1672531772,1672533775,2003
3722,3793175445,3500442734,1672560094,1672561974,1880
3492,3850911686,3777779869,1672688869,1672691517,2648
3746,3516741440,3770236215,1672652346,1672653414,1068
3700,3485540729,3777694660,1672667875,1672670660,2785
3681,3209481722,3880926355,1672627729,1672631303,3574
3472,3734451191,3311049964,1672673011,1672676552,3541
3670,3500341755,3682133690,1672547009,1672548830,1821
3447,3236458894,3294703680,1672688718,1672692271,3553
3918,3225029895,3534543776,1672625417,1672626913,1496
3850,3497095254,3776117322,1672544397,1672544482,85
3747,3625174002,3773121782,1672647847,1672650888,3041
3800,3800257590,3791753345,1672673691,1672675556,1865
3644,3357289672,3436257398,1672569349,1672570387,1038
3908,3299125059,3414275042,1672590205,1672592318,2113
3881,3715707380,3714185969,1672567235,1672567399,164
3687,3777147510,3639050419,1672569742,1672571749,2007
3540,3834963772,3618354185,1672628883,1672629819,936
3913,3492546679,3510642075,1672693530,1672695127,1597
3495,3891672228,3779738691,1672615589,1672615749,160
3517,3900276517,3793743698,1672551655,1672552097,442
3448,3380767040,3734451191,1672661312,1672664838,3526
3904,3779639983,3491469603,1672539656,1672539804,148
3560,3500525825,3680843171,1672559693,1672560806,1113
3709,3354144091,3916490839,1672678168,1672680599,2431
3494,3203538212,3513065217,1672572711,1672573300,589
3573,3392520516,3431502855,1672605924,1672607121,1197
3512,3617392620,3618808151,1672634118,1672636660,2542
3663,3760645796,3451326054,1672676206,1672677167,961
3817,3661903000,3435116799,1672674644,1672678105,3461
3573,3792442597,3779465522,1672597606,1672600112,2506
3571,3394401087,3517887477,1672636038,1672638462,2424
3776,3770676872,3552824113,1672643478,1672643917,439
3830,3777624586,3839245934,1672690697,1672692588,1891
3731,3414940786,3902861231,1672599562,1672599912,350
3650,3780427126,3713300120,1672575453,1672577937,2484
3461,3533294425,3685681577,1672693257,1672696704,3447
3613,3505198734,3714120857,1672558122,1672559513,1391
3653,3428027649,3501384020,1672658942,1672662133,3191
3897,3632814465,3311420950,1672668829,1672669342,513
3440,3803389195,3906536154,1672573669,1672574786,1117
3607,3713979100,3514971533,1672631817,1672634403,2586
3493,3817428320,3757700712,1672699480,1672699602,122
3510,3791693821,3780769110,1672658545,1672659912,1367
3836,3515439826,3513041785,1672661942,1672662519,577
3750,3755065949,3760263530,1672537072,1672538395,1323
3762,3638660068,3770624662,1672702607,1672704519,1912
3820,3711919537,3791753345,1672661199,1672663153,1954
3646,3383138270,3510798825,1672674396,1672677612,3216
3714,3680843171,3631479562,1672608953,1672609189,236
3487,3408430195,3363162590,1672699104,1672702535,3431
3558,3938389661,3514334067,1672559847,1672560418,571
3618,3802932312,3389634034,1672689073,1672691395,2322
3507,3756789525,3534543776,1672591886,1672593231,1345
3651,3757383891,3512800570,1672625811,1672628298,2487
3773,3971806004,3513041785,1672592087,1672594634,2547
3552,3714827719,3533929349,1672701914,1672705252,3338
3632,3333918941,3921648519,1672560725,1672561825,1100
3863,3315279093,3520115090,1672644546,1672647452,2906
3539,3626499450,3900898992,1672659738,1672661337,1599
3564,3447672935,3931627862,1672681657,1672682871,1214
3576,3778640261,3500613493,1672672383,1672672909,526
3583,3885157459,3756746867,1672632943,1672633188,245
3894,3715400486,3299781901,1672565943,1672569162,3219
3788,3755756564,3612689556,1672695140,1672697414,2274
3539,3512830734,3900945856,1672661510,1672664159,2649
3497,3898314440,3711006062,1672604322,1672605378,1056
3431,3312998540,3512946768,1672574220,1672577296,3076
3911,3610870949,3608855425,1672551225,1672554358,3133
3734,3451726367,3774641380,1672664696,1672667850,3154
3824,3668747074,3783169442,1672567107,1672567284,177
3743,3236458894,3760651515,1672684732,1672685864,1132
3513,3773124276,3713911104,1672555270,1672557298,2028
3542,3514246749,3410600350,1672635738,1672638169,2431
3805,3780872464,3366423342,1672598426,1672599635,1209
3675,3920497528,3735374579,1672531561,1672534948,3387
3830,3632814465,3970909253,1672613541,1672615473,1932
3672,3372223551,3517887477,1672556292,1672556910,618
3476,3757630221,3773735484,1672540361,1672542457,2096
3592,3715086894,3686523546,1672601420,1672602774,1354
3631,3755404116,3285204083,1672667158,1672670756,3598
3600,3512337405,3360616538,1672543359,1672545224,1865
3740,3511732493,3756746867,1672665477,1672668051,2574
3599,3520991398,3291933594,1672675944,1672676101,157
3787,3533274994,3618489670,1672691087,1672691496,409
3804,3500703304,3792442597,1672535857,1672538503,2646
3444,3714067076,3710496785,1672591823,1672592681,858
3701,3755065949,3299443125,1672621832,1672624272,2440
3493,3512282789,3711097754,1672635335,1672635943,608
3433,3514308235,3500737582,1672589280,1672591979,2699
3819,3270697740,3909094917,1672563123,1672565713,2590
3723,3755404116,3617392620,1672567819,1672571003,3184
3657,3513853403,3270042456,1672582439,1672584668,2229
3729,3438489358,3557046880,1672695302,1672697894,2592
3755,3779656423,3783520186,1672574294,1672574893,599
3447,3792014516,3818575661,1672684986,1672685571,585
3444,3733363628,3360616538,1672616969,1672619135,2166
3896,3511024016,3516741440,1672532997,1672533578,581
3734,3337322736,3777814504,1672616945,1672618235,1290
3920,3783801141,3711218296,1672673520,1672673854,334
3839,3500208903,3512379024,1672599611,1672601040,1429
3706,3627368399,3780571086,1672542739,1672543286,547
3680,3974674109,3310125159,1672645966,1672646476,510
3914,3463740710,3777091903,1672661716,1672663424,1708
3449,3394297564,3479851674,1672677938,1672679855,1917
3638,3757630221,3778134418,1672561856,1672562144,288
3581,3793883863,3739895284,1672600472,1672602041,1569
3627,3779738691,3505521218,1672616830,1672619723,2893
3829,3811075491,3780834916,1672638781,1672641863,3082
3771,3607768197,3660063072,1672572350,1672575245,2895
3877,3611055563,3772078494,1672591792,1672592129,337
3558,3393063657,3714678331,1672667943,1672670566,2623
3723,3780872464,3899786664,1672685019,1672688349,3330
3886,3793583656,3245232284,1672531625,1672534403,2778
3657,3635169815,3617489344,1672652061,1672655428,3367
3592,3511442562,3517887477,1672571256,1672573400,2144
3895,3512946768,3501457103,1672544762,1672546320,1558
3832,3979802715,3270697740,1672636895,1672637046,151
3601,3791796585,3513295938,1672694860,1672696321,1461
3450,3774790271,3772078494,1672691445,1672693785,2340
3508,3610358027,3621683102,1672689452,1672692301,2849
3537,3617489344,3408430195,1672650564,1672650765,201
3809,3424445495,3511317276,1672566904,1672570321,3417
3491,3970198861,3380130228,1672571380,1672573525,2145
3850,3859868849,3935487534,1672543906,1672544373,467
3474,3448633776,3505111292,1672647952,1672650280,2328
3649,3443357683,3905899155,1672533321,1672535644,2323
3869,3730071479,3716679950,1672540318,1672542492,2174
3669,3715443333,3428725843,1672678307,1672681181,2874
3560,3737972328,3517737088,1672562367,1672564245,1878
3649,3612689556,3373089838,1672642578,1672645285,2707
3910,3518229776,3501281016,1672602261,1672604092,1831
3626,3490029863,3713941638,1672545935,1672549359,3424
3459,3923754072,3783147088,1672555270,1672557391,2121
3659,3714128600,3776559988,1672699580,1672702329,2749
3876,3311498666,3280268483,1672562071,1672563762,1691
3802,3382733096,3367111751,1672663549,1672664945,1396
3548,3688796737,3241790910,1672614677,1672617159,2482
3915,3511024016,3270042456,1672591509,1672592072,563
3518,3711637255,3520639768,1672703784,1672705219,1435
3654,3514324011,3505725706,1672566992,1672568402,1410
3539,3520322124,3515525630,1672654745,1672655402,657
3494,3783615982,3533294425,1672546395,1672548823,2428
3793,3437286517,3448875382,1672664784,1672664962,178
3684,3472312341,3514285803,1672631242,1672633029,1787
3652,3701884158,3386758279,1672573339,1672576565,3226
3577,3244004456,3279475486,1672649041,1672651976,2935
3781,3236354255,3505634634,1672687157,1672690137,2980
3572,3306412634,3793175445,1672567763,1672569342,1579
3558,3448875382,3334974375,1672635749,1672636128,379
3500,3713784974,3273981374,1672691929,1672694511,2582
3672,3621683102,3892304880,1672570838,1672574382,3544
3634,3714185969,3298151889,1672631312,1672634796,3484
3490,3501457103,3703139663,1672700620,1672701346,726
3765,3291933594,3208957949,1672603311,1672606259,2948
3746,3480490124,3296462324,1672615641,1672618058,2417
3874,3770704999,3975717896,1672611398,1672613823,2425
3491,3974674109,3374183227,1672569456,1672571325,1869
3528,3380982774,3500915908,1672537614,1672538396,782
3555,3505437712,3349739136,1672604955,1672608177,3222
3676,3229822507,3279475486,1672610280,1672612664,2384
3875,3926643445,3500827202,1672563657,1672566712,3055
3598,3500525825,3793418209,1672653876,1672655812,1936
3435,3713517039,3448875382,1672611530,1672612101,571
3580,3756127300,3435167810,1672589430,1672591313,1883
3813,3294747828,3714128600,1672590182,1672592729,2547
3599,3371455553,3276003502,1672692285,1672695190,2905
3585,3455018347,3488763230,1672691992,1672694210,2218
3890,3509893027,3533079336,1672654778,1672656631,1853
3665,3927599181,3500841914,1672700462,1672701681,1219
3473,3774641380,3201676087,1672667436,1672669935,2499
3528,3791753345,3897435944,1672610802,1672613912,3110
3747,3516321888,3713941638,1672634212,1672637167,2955
3906,3236499444,3270697740,1672599001,1672600304,1303
3745,3757700712,3511883730,1672643504,1672644280,776
3512,3783136330,3533090502,1672544144,1672545968,1824
3666,3501459390,3711853996,1672592933,1672595172,2239
3919,3755532873,3500613459,1672568848,1672569291,443
3524,3760364383,3859868849,1672697997,1672699277,1280
3501,3714067076,3232208416,1672693479,1672696370,2891
3623,3240994288,3517600136,1672532322,1672532558,236
3564,3300818269,3793969543,1672677862,1672680768,2906
3521,3703139663,3791753345,1672563519,1672564269,750
3920,3713589994,3824215187,1672630083,1672630979,896
3689,3349856820,3294703680,1672576140,1672576460,320
3558,3441703884,3459681410,1672568986,1672569544,558
3765,3774155692,3979784676,1672578631,1672580702,2071
3815,3777091903,3625174002,1672585803,1672588409,2606
3758,3932478321,3224968597,1672582160,1672582382,222
3457,3772078494,3505663516,1672648218,1672649498,1280
3686,3935913584,3608232640,1672581929,1672583225,1296
3922,3715854030,3438489358,1672633033,1672636612,3579
3648,3734451191,3462273042,1672623177,1672626590,3413
3794,3305722859,3716679950,1672626394,1672629978,3584
3912,3205985903,3756746867,1672618178,1672618963,785
3572,3757903168,3858172636,1672685538,1672686772,1234
3836,3701823816,3399472693,1672597517,1672598084,567
3772,3713829743,3481640525,1672617717,1672618742,1025
3517,3334647380,3441348818,1672547858,1672549301,1443
3537,3774876004,3497808662,1672571740,1672575305,3565
3652,3347419520,3428725843,1672672362,1672675213,2851
3454,3505179890,3505437712,1672684461,1672685887,1426
3766,3500613459,3450969839,1672549269,1672550235,966
3908,3625174002,3520181148,1672535320,1672537796,2476
3836,3776084820,3774290799,1672535028,1672535752,724
3630,3800257590,3685816610,1672670365,1672671523,1158
3804,3793969543,3516298579,1672651612,1672655145,3533
3880,3778134418,3511005395,1672681767,1672682036,269
3791,3621790707,3780712350,1672701570,1672701947,377
3466,3779639983,3220031931,1672568458,1672570894,2436
3657,3711218296,3613338363,1672648793,1672651331,2538
3503,3517172354,3451691949,1672598789,1672601194,2405
3448,3737112297,3792072681,1672608264,1672609338,1074
3711,3622357348,3902625986,1672627706,1672631123,3417
3785,3756474459,3500709774,1672595564,1672598243,2679
3711,3411515369,3316798920,1672604998,1672606330,1332
3656,3480490124,3305722859,1672672981,1672675221,2240
3449,3371455553,3621683102,1672602094,1672605149,3055
3658,3551399764,3201800997,1672607807,1672608650,843
3531,3437286517,3319167958,1672664001,1672666930,2929
3725,3510798825,3905196766,1672566397,1672569932,3535
3841,3386758279,3755233658,1672594788,1672595396,608
3882,3979802715,3928511283,1672647449,1672647683,234
3841,3505923418,3516903528,1672544277,1672545853,1576
3470,3928511283,3774718695,1672684232,1672684846,614
3831,3280054198,3512946768,1672596850,1672598485,1635
3870,3336339664,3926643445,1672542408,1672545705,3297
3572,3518229776,3514285803,1672552189,1672554099,1910
3657,3364378127,3396726504,1672559194,1672562281,3087
3897,3510964997,3757075324,1672578666,1672581658,2992
3795,3793743698,3369708250,1672573144,1672575501,2357
3509,3414940786,3811075491,1672688068,1672691108,3040
3888,3793418209,3304155815,1672667769,1672671259,3490
3600,3780571086,3557046880,1672682608,1672683013,405
3894,3710048469,3793418209,1672581836,1672584412,2576
3532,3279339278,3551399764,1672632822,1672635823,3001
3538,3885121158,3460719322,1672687076,1672689177,2101
3565,3755344363,3208957949,1672537936,1672541007,3071
3865,3834960360,3824641227,1672583261,1672585412,2151
3758,3513018485,3490214516,1672582949,1672586509,3560
3583,3398731252,3780769110,1672633196,1672635561,2365
3734,3338390596,3284947372,1672685146,1672686683,1537
3632,3428027649,3773332082,1672619657,1672622753,3096
3726,3835985172,3513545422,1672652899,1672655996,3097
3435,3757630221,3770624662,1672555091,1672556515,1424
3501,3240394404,3514971533,1672670325,1672673193,2868
3861,3710048469,3669146016,1672531913,1672532836,923
3888,3668414677,3773939399,1672544910,1672546826,1916
3626,3890739241,3520560590,1672635285,1672637266,1981
3652,3311420950,3715974659,1672571666,1672571972,306
3867,3665998641,3757863420,1672683343,1672686653,3310
3922,3456430614,3446533960,1672634510,1672637167,2657
3472,3756474459,3512383699,1672585000,1672585609,609
3796,3780472203,3505663516,1672648792,1672652005,3213
3500,3739911441,3270056120,1672665096,1672667584,2488
3855,3505807416,3400763927,1672632897,1672633519,622
3833,3291933594,3350095157,1672628831,1672629732,901
3436,3461119815,3904867554,1672548046,1672549546,1500
3857,3517590837,3533747868,1672575197,1672577074,1877
3705,3385323994,3515890966,1672641933,1672644964,3031
3758,3713941638,3760924079,1672563680,1672566823,3143
3600,3335694356,3431502855,1672540451,1672543764,3313
3476,3447514821,3611055563,1672533366,1672534812,1446
3585,3337322736,3372223551,1672653188,1672656480,3292
3607,3385323994,3776518452,1672593785,1672594476,691
3528,3711734586,3311498666,1672550919,1672553477,2558
3602,3715385401,3209481722,1672695437,1672697346,1909
3883,3451726367,3383138270,1672594526,1672595137,611
3460,3224330592,3414049538,1672583282,1672586626,3344
3688,3501121099,3825881598,1672674451,1672675032,581
3451,3716679950,3315703693,1672595067,1672595219,152
3505,3551389192,3755496114,1672531882,1672535114,3232
3598,3770296583,3783919913,1672568085,1672570770,2685
3471,3276269264,3777779869,1672698979,1672699142,163
3720,3428027649,3607882826,1672654916,1672658219,3303
3494,3517462308,3756385685,1672567949,1672571130,3181
3507,3615737355,3835985172,1672657402,1672659648,2246
3749,3713768950,3367111751,1672677734,1672678620,886
3875,3497808662,3428725843,1672623714,1672625165,1451
3880,3792014516,3930242012,1672658728,1672660632,1904
3460,3296462324,3734915241,1672695033,1672698460,3427
3798,3515401243,3311420950,1672546750,1672547792,1042
3617,3783801141,3410600350,1672575772,1672577276,1504
3476,3793315718,3410538749,1672626119,1672628196,2077
3424,3533929349,3710315160,1672558980,1672560847,1867
3517,3396980894,3333918941,1672539700,1672541877,2177
3841,3715619259,3714233826,1672632557,1672633000,443
3652,3780253901,3330340793,1672540810,1672544075,3265
3437,3311085279,3467988782,1672540032,1672540856,824
3889,3711853996,3520115090,1672546793,1672548711,1918
3463,3897376951,3904412440,1672684719,1672685983,1264
3885,3470454332,3418448389,1672654641,1672658084,3443
3803,3463740710,3285204083,1672547415,1672550100,2685
3543,3414940786,3271752081,1672610882,1672612962,2080
3741,3715443333,3516741440,1672657950,1672658855,905
3597,3757332128,3209526819,1672630537,1672631967,1430
3497,3755065949,3755915206,1672575936,1672576015,79
3479,3776084820,3615087943,1672693873,1672694536,663
3458,3971806004,3897376951,1672563167,1672565976,2809
3539,3399472693,3201629017,1672682121,1672685035,2914
3740,3615113018,3424660806,1672659097,1672660340,1243
3845,3303410628,3772236797,1672694345,1672696080,1735
3804,3456430614,3906536154,1672532195,1672535272,3077
3740,3928511283,3448875382,1672694621,1672697536,2915
3824,3334647380,3300818269,1672624438,1672624748,310
3866,3511005395,3499217428,1672674609,1672676646,2037
3485,3711853996,3793583656,1672671048,1672674070,3022
3666,3668747074,3513296868,1672614283,1672617382,3099
3882,3505888598,3511442562,1672630158,1672631042,884
3667,3414940786,3783136330,1672571951,1672572227,276
3476,3792014516,3225631197,1672610522,1672613473,2951
3517,3630353876,3755065949,1672691068,1672693025,1957
3452,3533747868,3225029895,1672674116,1672674560,444
3445,3285204083,3909094917,1672620759,1672622841,2082
3679,3520322124,3778040015,1672657244,1672657421,177
3819,3776034743,3661583097,1672546113,1672548885,2772
3559,3514956366,3793781065,1672642199,1672642480,281
3592,3714827719,3739911441,1672580654,1672581513,859
3766,3605221116,3630353876,1672566485,1672566566,81
3543,3276217799,3435167810,1672673960,1672675425,1465
3622,3613416045,3238288884,1672623638,1672626232,2594
3529,3514703118,3534543776,1672577675,1672577994,319
3758,3451326054,3776559988,1672695846,1672696636,790
3624,3370068529,3460719322,1672540481,1672542428,1947
3906,3514419100,3364726656,1672702188,1672704839,2651
3727,3236458894,3773332082,1672603384,1672603742,358
3571,3793740407,3713768950,1672580712,1672581757,1045
3495,3803389195,3979802715,1672558525,1672560614,2089
3787,3398198430,3428725843,1672540160,1672540427,267
3728,3270697740,3780769110,1672577575,1672579648,2073
3532,3686227677,3510837901,1672592825,1672596035,3210
3521,3661903000,3232208416,1672531300,1672532755,1455
3784,3974674109,3534566651,1672533825,1672535655,1830
3861,3299781901,3802932312,1672623725,1672624740,1015
3762,3777240360,3701373490,1672665885,1672666421,536
3628,3512392431,3776831527,1672666785,1672669737,2952
3622,3333918941,3625174002,1672556490,1672558929,2439
3817,3501281016,3501525100,1672533514,1672534133,619
3554,3925979970,3710735406,1672686990,1672688844,1854
3831,3505663516,3509483172,1672536765,1672539623,2858
3748,3276269264,3773027597,1672666945,1672667564,619
3445,3505521218,3364726656,1672612012,1672615358,3346
3906,3714678331,3713163045,1672640673,1672642530,1857
3529,3509756823,3512383699,1672642425,1672644577,2152
3489,3554186380,3517358573,1672571029,1672574105,3076
3846,3516489668,3777694660,1672558972,1672561628,2656
3526,3293835352,3488686442,1672550199,1672551227,1028
3559,3812534508,3488763230,1672596843,1672596999,156
3569,3394297564,3510798825,1672669641,1672671023,1382
3527,3509483172,3792546035,1672578833,1672582089,3256
3697,3897376951,3770704999,1672630481,1672631455,974
3593,3511288998,3811040565,1672643897,1672644686,789
3742,3791693821,3792489602,1672649781,1672650666,885
3705,3774733620,3279475486,1672600660,1672602419,1759
3508,3713589994,3519077659,1672640628,1672642201,1573
3776,3885537225,3450969839,1672604255,1672605285,1030
3556,3514703118,3399472693,1672695883,1672697886,2003
3507,3807212280,3773027597,1672570098,1672573617,3519
3497,3334974375,3513345163,1672674048,1672675234,1186
3511,3902760230,3977352557,1672674314,1672676495,2181
3613,3780712350,3825881598,1672537579,1672537671,92
3797,3703383853,3220031931,1672555513,1672557704,2191
3846,3519282716,3457620713,1672597100,1672599085,1985
3895,3970198861,3637313265,1672560704,1672562011,1307
3907,3491469603,3518229776,1672678065,1672678688,623
3672,3755404116,3480991549,1672566016,1672566903,887
3655,3505179890,3205923620,1672575132,1672576531,1399
3842,3519087371,3774705415,1672568596,1672571537,2941
3509,3604589802,3621790707,1672554947,1672557488,2541
3638,3777037426,3310039260,1672670828,1672672231,1403
3692,3923420131,3627368399,1672657907,1672659441,1534
3456,3337322736,3755065949,1672658083,1672659970,1887
3831,3500857494,3366423342,1672548073,1672548449,376
3692,3927403123,3714128600,1672672825,1672675724,2899
3579,3396980894,3440107959,1672558132,1672558333,201
3816,3289817992,3814677862,1672535519,1672538845,3326
3729,3755573472,3559731671,1672629602,1672631557,1955
3531,3336627643,3829864515,1672629955,1672631552,1597
3860,3519446663,3600876425,1672680921,1672681278,357
3556,3513018485,3380767040,1672544130,1672545836,1706
3820,3330340793,3534543776,1672686207,1672688090,1883
3532,3520578796,3479851674,1672586926,1672589589,2663
3794,3231494505,3970909253,1672578242,1672579588,1346
3815,3622357348,3534175249,1672651467,1672653590,2123
3721,3291933594,3632814465,1672655243,1672658085,2842
3631,3885155975,3608922867,1672572110,1672574691,2581
3914,3514741348,3505111292,1672669242,1672670195,953
3583,3912891315,3372223551,1672685520,1672688037,2517
3715,3229822507,3492959689,1672552595,1672556113,3518
3712,3280054198,3519909393,1672589470,1672590505,1035
3689,3334647380,3513041785,1672659844,1672660106,262
3605,3414940786,3701247948,1672611398,1672614866,3468
3546,3500604680,3398731252,1672588774,1672589724,950
3851,3773033649,3757700712,1672538971,1672541704,2733
3814,3512282789,3783615982,1672637714,1672637901,187
3490,3776034743,3501384020,1672669478,1672672361,2883
3838,3533090502,3511288998,1672643239,1672645331,2092
3430,3279475486,3240394404,1672691970,1672694322,2352
3907,3890739241,3232208416,1672683213,1672684276,1063
3859,3337362061,3220031931,1672681046,1672684221,3175
3679,3370227921,3755532873,1672648462,1672651792,3330
3594,3500525825,3236458894,1672642109,1672645176,3067
3622,3792801638,3305722859,1672562966,1672564532,1566
3651,3777147510,3779738691,1672555238,1672556989,1751
3705,3514703118,3372223551,1672569670,1672572611,2941
3652,3738026330,3660887799,1672693798,1672696546,2748
3888,3276348699,3783801141,1672661502,1672662710,1208
3593,3283770991,3792489602,1672579689,1672581404,1715
3495,3208452238,3783433404,1672645722,1672647886,2164
3620,3791106564,3715619259,1672625623,1672626313,690
3633,3431460073,3774907131,1672584036,1672585520,1484
3852,3688490530,3774178201,1672589222,1672592571,3349
3857,3513081354,3755222916,1672634770,1672636136,1366
3602,3715385401,3304155815,1672599386,1672602579,3193
3792,3834963772,3379143440,1672698479,1672701754,3275
3880,3341893384,3688220326,1672609918,1672610032,114
3644,3710735406,3367509761,1672609423,1672610852,1429
3623,3852686295,3449639012,1672620515,1672623051,2536
3803,3512282789,3512946768,1672647568,1672649917,2349
3687,3497095254,3349739136,1672555393,1672558094,2701
3767,3517697722,3779656423,1672535305,1672535846,541
3767,3783615982,3938503547,1672567136,1672570247,3111
3592,3755344363,3505521218,1672673419,1672673748,329
3442,3737972328,3736231757,1672633182,1672636467,3285
3607,3780834916,3792505974,1672643282,1672644251,969
3637,3791436104,3899326793,1672534689,1672536793,2104
3845,3731646673,3510767239,1672635159,1672637513,2354
3557,3280268483,3509756823,1672534173,1672535164,991
3492,3757075324,3376467719,1672601824,1672602741,917
3625,3710854064,3300229945,1672639231,1672642412,3181
3760,3773124276,3514334067,1672605728,1672606160,432
3891,3680810086,3362641275,1672621981,1672623608,1627
3785,3412006598,3613581796,1672554442,1672556081,1639
3839,3811075491,3534126409,1672551987,1672552671,684
3848,3703798634,3703139663,1672648425,1672649584,1159
3521,3333918941,3904569677,1672534603,1672538198,3595
3874,3399472693,3773121782,1672648921,1672650959,2038
3689,3228888030,3500613459,1672583547,1672584900,1353
3526,3791106564,3367509761,1672578780,1672580454,1674
3446,3811075491,3680810086,1672576314,1672578047,1733
3426,3467988782,3408498208,1672645557,1672646396,839
3851,3817428320,3710735406,1672703495,1672705858,2363
3621,3468041839,3373028638,1672576736,1672579112,2376
3774,3923420131,3772236797,1672614143,1672614499,356
3777,3686523546,3792538417,1672689638,1672691322,1684
3547,3935487534,3613416045,1672563414,1672566450,3036
3535,3683113954,3770438122,1672681655,1672684214,2559
3526,3276003502,3713163045,1672584388,1672586026,1638
3714,3512946768,3511442562,1672599478,1672602719,3241
3921,3711006062,3778899160,1672591686,1672594360,2674
3633,3715385401,3889780657,1672568335,1672571315,2980
3783,3793922324,3897134762,1672590927,1672592322,1395
3509,3772765746,3778926763,1672590070,1672590134,64
3639,3853629553,3394297564,1672643584,1672643648,64
3808,3776084820,3276348699,1672664020,1672666686,2666
3590,3703348097,3916490839,1672671710,1672672604,894
3864,3701664364,3501525100,1672538310,1672538755,445
3448,3300511067,3792014516,1672655987,1672659511,3524
3800,3428725843,3272716462,1672695317,1672697909,2592
3543,3774605761,3977352557,1672550739,1672554013,3274
3828,3615113018,3760842815,1672618143,1672619618,1475
3678,3510499038,3891672228,1672665999,1672668312,2313
3496,3715986185,3770296583,1672679901,1672682064,2163
3802,3472068734,3777485931,1672629784,1672631444,1660
3610,3793740407,3410600350,1672616386,1672618338,1952
3887,3515525630,3534829213,1672703030,1672703411,381
3803,3509756823,3668533536,1672538652,1672540851,2199
3857,3457620713,3517991730,1672545208,1672546704,1496
3761,3713300120,3360616538,1672536534,1672536657,123
3736,3360069849,3792020993,1672564532,1672567151,2619
3876,3615688740,3636329663,1672548177,1672549517,1340
3814,3485540729,3559731671,1672673016,1672675475,2459
3587,3792489602,3401793306,1672685141,1672685848,707
3573,3701136026,3513018485,1672614939,1672618185,3246
3504,3935399379,3792442597,1672540094,1672542875,2781
3500,3632814465,3445206685,1672644189,1672644296,107
3776,3500317969,3512882178,1672667262,1672668177,915
3713,3469254160,3516703758,1672571961,1672573429,1468
3646,3737112297,3514324011,1672588199,1672589607,1408
3458,3517887477,3770296583,1672611111,1672613264,2153
3887,3202141727,3733558985,1672697296,1672697730,434
3728,3244004456,3311049964,1672635345,1672635468,123
3858,3934064792,3792489602,1672629452,1672631174,1722
3806,3714128600,3885537225,1672680684,1672682465,1781
3659,3446533960,3714185969,1672548895,1672551359,2464
3441,3773902805,3701107228,1672598038,1672600876,2838
3470,3500857494,3668747074,1672634647,1672638132,3485
3882,3276269264,3605221116,1672626286,1672627252,966
3738,3618354185,3300818269,1672630723,1672630804,81
3578,3373028638,3520764926,1672670358,1672670607,249
3459,3236499444,3431502855,1672646356,1672648625,2269
3727,3760721303,3533294425,1672650068,1672652479,2411
3585,3272030610,3791106564,1672635221,1672636644,1423
3740,3779892400,3516741440,1672589247,1672591162,1915
3442,3779425804,3839245934,1672667697,1672669192,1495
3683,3711097754,3488686442,1672556137,1672556208,71
3485,3488763230,3481640525,1672628580,1672629637,1057
3606,3970909253,3497095254,1672676768,1672678327,1559
3685,3701005527,3792546035,1672609259,1672610312,1053
3487,3311420950,3480726047,1672658335,1672660349,2014
3745,3916490839,3399518841,1672549798,1672550128,330
3627,3226511603,3776518452,1672684367,1672686367,2000
3842,3518561777,3512882178,1672581716,1672584069,2353
3613,3480991549,3777184389,1672570653,1672572934,2281
3808,3891672228,3885157459,1672594351,1672594897,546
3828,3288224595,3394401087,1672646593,1672646695,102
3486,3755344363,3979802715,1672568002,1672570390,2388
3519,3384068080,3517172354,1672618430,1672621887,3457
3730,3732131656,3710496785,1672590913,1672592647,1734
3714,3667673649,3783433404,1672626892,1672628145,1253
3885,3637313265,3517358573,1672669131,1672669865,734
3899,3780680950,3505888598,1672545339,1672548777,3438
3808,3510798825,3638660068,1672662051,1672663012,961
3679,3501215099,3556969573,1672682019,1672685063,3044
3638,3755222916,3770236215,1672646954,1672647630,676
3570,3424660806,3401793306,1672587899,1672588994,1095
3887,3970909253,3783919913,1672594693,1672595890,1197
3722,3517222913,3534543776,1672665144,1672666830,1686
3612,3517288083,3372223551,1672667923,1672670434,2511
3760,3360616538,3272716462,1672550085,1672551090,1005
3848,3533274994,3792505974,1672557503,1672560671,3168
3434,3791753345,3510964997,1672666663,1672668758,2095
3814,3831586487,3615087943,1672700657,1672700765,108
3467,3402385957,3756704774,1672621692,1672622567,875
3778,3445206685,3509483172,1672613481,1672616774,3293
3797,3336339664,3533368789,1672576181,1672578072,1891
3684,3231494505,3710735406,1672607458,1672610469,3011
3489,3416987084,3904412440,1672583754,1672585378,1624
3458,3613899351,3760640999,1672554267,1672557127,2860
3816,3228888030,3414275042,1672635222,1672638261,3039
3569,3488763230,3518194482,1672648460,1672651418,2958
3435,3684523966,3512722110,1672698476,1672700475,1999
3818,3516444201,3776084820,1672649410,1672652912,3502
3840,3713589994,3756625818,1672622923,1672624218,1295
3495,3897134762,3621461051,1672670542,1672670989,447
3541,3715986185,3533294425,1672693633,1672694762,1129
3451,3630353876,3689697817,1672652966,1672653671,705
3733,3505521218,3364378127,1672541976,1672542567,591
3679,3505663516,3757193551,1672635531,1672637128,1597
3636,3416987084,3933894942,1672584674,1672584853,179
3571,3412006598,3819767045,1672595124,1672596811,1687
3733,3701136026,3856606678,1672688110,1672691683,3573
3729,3384068080,3638204468,1672647356,1672650138,2782
3573,3780872464,3927403123,1672657305,1672658062,757
3767,3431460073,3792442597,1672660430,1672662690,2260
3455,3773572967,3500044458,1672616958,1672620477,3519
3552,3276217799,3834960360,1672592945,1672595386,2441
3737,3500347447,3667427125,1672594286,1672595518,1232
3471,3284947372,3608232640,1672544895,1672546389,1494
3905,3791106564,3392520516,1672568980,1672571462,2482
3682,3390660440,3760364383,1672575084,1672576847,1763
3737,3757294769,3533368789,1672674820,1672676635,1815
3920,3760364383,3519282716,1672671355,1672672917,1562
3521,3315279093,3362641275,1672599221,1672601402,2181
3610,3885155975,3792801638,1672597207,1672599655,2448
3476,3469254160,3285204083,1672557922,1672561072,3150
3636,3715986185,3792274796,1672620592,1672622300,1708
3525,3934064792,3780909839,1672614452,1672617795,3343
3856,3915162005,3626499450,1672565893,1672569269,3376
3585,3713589994,3979784676,1672684245,1672684600,355
3822,3701107228,3497095254,1672664879,1672665936,1057
3895,3621683102,3915162005,1672615349,1672615810,461
3524,3777184389,3491469603,1672583229,1672583904,675
3693,3283770991,3735374579,1672650121,1672653165,3044
3454,3703348097,3825881598,1672538426,1672540417,1991
3602,3370227921,3411688875,1672542149,1672544059,1910
3553,3783801141,3791693821,1672566107,1672566974,867
3779,3376467719,3272096759,1672618944,1672621868,2924
3698,3520322124,3637313265,1672669615,1672670671,1056
3473,3791613604,3793743698,1672544967,1672545267,300
3788,3272096759,3554944414,1672701813,1672702343,530
3655,3890739241,3510187271,1672568208,1672568916,708
3702,3760364383,3621683102,1672593174,1672594495,1321
3791,3776988674,3505154885,1672565715,1672568889,3174
3453,3338083680,3780769110,1672625372,1672628800,3428
3778,3793315718,3733558985,1672683738,1672686272,2534
3710,3780322355,3357864626,1672647262,1672650368,3106
3723,3225631197,3783163143,1672671731,1672673408,1677
3693,3811040565,3701882224,1672573337,1672576373,3036
3626,3311498666,3480100311,1672584275,1672586798,2523
3651,3889780657,3519142371,1672677741,1672678801,1060
3503,3772765746,3276269264,1672558525,1672559674,1149
3810,3398198430,3783550022,1672685996,1672686131,135
3496,3512722110,3520115090,1672616777,1672619704,2927
3801,3467779445,3776117322,1672574729,1672576667,1938
3817,3354144091,3733558985,1672663221,1672666209,2988
3628,3773735484,3470454332,1672650977,1672653085,2108
3812,3923420131,3513018485,1672617715,1672618291,576
3427,3516489668,3511732493,1672564735,1672567921,3186
3576,3236499444,3780427126,1672600911,1672602839,1928
3797,3732584121,3289817992,1672616631,1672619454,2823
3529,3792525861,3885157459,1672543174,1672544689,1515
3687,3780115155,3551399764,1672645644,1672646132,488
3798,3900276517,3303410628,1672627432,1672628737,1305
3792,3808136029,3513295938,1672645683,1672647655,1972
3721,3500827202,3404025196,1672626819,1672627408,589
3617,3554944414,3667427125,1672698819,1672701388,2569
3832,3618697021,3225636215,1672674147,1672674710,563
3872,3714678331,3520416075,1672546035,1672548026,1991
3724,3895285664,3977148669,1672548337,1672548915,578
3529,3979784676,3713561276,1672627602,1672629490,1888
3790,3470454332,3341893384,1672645066,1672647374,2308
3490,3467779445,3279473441,1672654689,1672655583,894
3865,3202141727,3760263530,1672678436,1672681835,3399
3577,3369708250,3792525861,1672622382,1672624734,2352
3454,3668747074,3509483172,1672623522,1672626089,2567
3472,3519282716,3209526819,1672690009,1672691121,1112
3632,3777814504,3520322124,1672599039,1672600650,1611
3885,3637313265,3202804048,1672607118,1672609156,2038
3571,3276348699,3516489668,1672654662,1672655845,1183
3643,3773027597,3665998641,1672574286,1672574497,211
3593,3338390596,3792020993,1672609547,1672609760,213
3792,3737972328,3505847380,1672630037,1672631458,1421
3685,3730071479,3435116799,1672577376,1672579654,2278
3526,3500915908,3972192593,1672659781,1672662988,3207
3716,3533274994,3312998540,1672687794,1672688374,580
3644,3270697740,3970603231,1672656061,1672657857,1796
3718,3779892400,3777189898,1672654982,1672657563,2581
3458,3360069849,3446533960,1672664518,1672667122,2604
3544,3661583097,3514512367,1672625010,1672625594,584
3897,3895285664,3505198734,1672600326,1672601369,1043
3810,3457960571,3556969573,1672579438,1672582699,3261
3818,3520181148,3478114114,1672583173,1672583560,387
3542,3520355798,3970198861,1672551650,1672554299,2649
3540,3303410628,3450969839,1672701825,1672703817,1992
3813,3793407963,3387594369,1672626224,1672628376,2152
3574,3510767239,3311498666,1672670196,1672670280,84
3699,3970909253,3780209375,1672562265,1672564690,2425
3801,3505402439,3534179433,1672576960,1672578476,1516
3700,3515559913,3316800320,1672582332,1672583747,1415
3630,3772765746,3500442734,1672679629,1672681558,1929
3505,3714120857,3284932450,1672546606,1672547961,1355
3755,3770146716,3462273042,1672680809,1672681322,513
3585,3368283077,3505111292,1672570993,1672572751,1758
3825,3514285803,3777184389,1672647683,1672648125,442
3606,3417191856,3374183227,1672633785,1672635704,1919
3842,3411688875,3791246640,1672591804,1672591983,179
3474,3807212280,3783340788,1672656629,1672657879,1250
3556,3778899160,3926643445,1672547510,1672550754,3244
3719,3715854030,3793781065,1672559526,1672559639,113
3536,3889780657,3636329663,1672538416,1672540402,1986
3721,3284947372,3501215099,1672633878,1672634869,991
3455,3500841914,3714120857,1672627125,1672629607,2482
3629,3500302272,3793969543,1672661129,1672664042,2913
3761,3880926355,3760645796,1672615184,1672616823,1639
3530,3713300120,3801645328,1672588570,1672589651,1081
3717,3714678331,3898314440,1672699834,1672701069,1235
3711,3835985172,3855583256,1672615518,1672619008,3490
3604,3364726656,3519850727,1672610546,1672612960,2414
3522,3305722859,3505663516,1672557642,1672559376,1734
3469,3512282789,3927403123,1672612848,1672614301,1453
3564,3534543776,3710854064,1672692480,1672694722,2242
3573,3436257398,3897376951,1672668010,1672670417,2407
3777,3821054646,3480726047,1672682569,1672683410,841
3836,3306412634,3633735593,1672615351,1672617050,1699
3720,3239617320,3554825448,1672544865,1672546131,1266
3657,3490029863,3755573472,1672562350,1672564751,2401
3735,3711000597,3438489358,1672626540,1672629806,3266
3540,3779854934,3511317276,1672660954,1672663285,2331
3815,3770146716,3701322924,1672645184,1672645527,343
3540,3774155692,3904867554,1672572982,1672576274,3292
3749,3755230952,3773902805,1672537445,1672538938,1493
3573,3380130228,3915162005,1672558576,1672559334,758
3469,3421385957,3468041839,1672573825,1672574421,596
3829,3853629553,3224811762,1672612990,1672615258,2268
3673,3312998540,3974674109,1672594146,1672594550,404
3759,3618489670,3505923418,1672632758,1672635933,3175
3762,3737147209,3534179433,1672545133,1672547137,2004
3524,3757903168,3334974375,1672661841,1672663848,2007
3526,3447672935,3793583656,1672664993,1672667837,2844
3908,3760040019,3500208903,1672579700,1672582762,3062
3844,3770236215,3757348722,1672635322,1672638561,3239
3546,3737112297,3630353876,1672654794,1672656829,2035
3845,3279473441,3512946768,1672537245,1672540419,3174
3688,3791128487,3780253901,1672595499,1672597784,2285
3556,3343816795,3824641227,1672691089,1672691578,489
3877,3431460073,3668747074,1672662834,1672664276,1442
3686,3513545422,3757348722,1672656240,1672657153,913
3906,3711812325,3632814465,1672628779,1672631484,2705
3445,3617304541,3660887799,1672658077,1672660886,2809
3612,3236458894,3783919913,1672680169,1672681070,901
3652,3757193551,3713517039,1672604755,1672608119,3364
3584,3552824113,3511843593,1672592760,1672594078,1318
3634,3505154885,3826238375,1672548970,1672549221,251
3608,3520322124,3421385957,1672603755,1672605531,1776
3590,3554186380,3408498208,1672615821,1672618759,2938
3807,3608922867,3510837901,1672608338,1672610818,2480
3848,3701136026,3755573472,1672675555,1672678828,3273
3639,3826238375,3631090677,1672672377,1672674415,2038
3700,3622357348,3897376951,1672542292,1672542611,319
3774,3637313265,3711077927,1672589020,1672591846,2826
3572,3334993594,3755915206,1672689814,1672690328,514
3916,3272030610,3831586487,1672614357,1672615020,663
3565,3517222913,3859868849,1672652043,1672653751,1708
3659,3500777439,3792274796,1672630023,1672633052,3029
3583,3683113954,3613899351,1672546689,1672547736,1047
3878,3607768197,3776559988,1672578510,1672578984,474
3729,3518565331,3509893027,1672620284,1672622231,1947
3853,3618354185,3715619259,1672688673,1672692017,3344
3715,3505923418,3337322736,1672663188,1672664825,1637
3497,3979802715,3773124276,1672702796,1672703089,293
3649,3774155692,3780115155,1672587308,1672590072,2764
3467,3509764635,3519651506,1672703307,1672703992,685
3801,3417679834,3829864515,1672556249,1672556333,84
3859,3511024016,3424660806,1672693362,1672696452,3090
3836,3615688740,3630353876,1672667304,1672667943,639
3644,3514419100,3615087943,1672680255,1672683618,3363
3764,3776117322,3513545422,1672577877,1672580036,2159
3499,3408498208,3417679834,1672687028,1672689164,2136
3479,3516703758,3783550022,1672646799,1672647898,1099
3525,3736231757,3343132529,1672584386,1672585568,1182
3900,3780680950,3755848152,1672682232,1672685785,3553
3579,3793969543,3519282716,1672609342,1672610151,809
3807,3932478321,3446533960,1672552229,1672552514,285
3916,3791436104,3248058676,1672543033,1672543271,238
3802,3714128600,3774733620,1672664677,1672666111,1434
3640,3554944414,3438078818,1672683282,1672685024,1742
3474,3773033649,3505402439,1672625184,1672627093,1909
3688,3615087943,3511883730,1672619815,1672621761,1946
3734,3492546679,3834963772,1672593617,1672595963,2346
3426,3780427126,3701107228,1672559596,1672562489,2893
3612,3783928182,3773332082,1672671618,1672672104,486
3869,3897456874,3757323954,1672603733,1672603994,261
3851,3920898925,3512295534,1672649761,1672650790,1029
3734,3357289672,3492546679,1672658143,1672660814,2671
3567,3714678331,3713517039,1672685328,1672687356,2028
3474,3333403880,3793583656,1672690272,1672690629,357
3442,3398731252,3711812325,1672621868,1672621996,128
3448,3834631333,3686523546,1672609162,1672611789,2627
3779,3778899160,3283492940,1672588471,1672589667,1196
3856,3621683102,3885537225,1672671403,1672673567,2164
3545,3515890966,3836241528,1672656849,1672659169,2320
3731,3685816610,3510187271,1672659960,1672663519,3559
3442,3512295534,3600876425,1672609705,1672611931,2226
3876,3438489358,3394401087,1672618574,1672620259,1685
3791,3500777439,3294703680,1672646520,1672647197,677
3647,3492546679,3337362061,1672557453,1672559152,1699
3837,3512882178,3554186380,1672581913,1672585072,3159
3718,3715443333,3517737088,1672597277,1672598246,969
3507,3757348722,3778640261,1672676820,1672676896,76
3619,3777814504,3772236797,1672596265,1672597389,1124
3743,3357689359,3517687662,1672673276,1672675149,1873
3461,3715086894,3472312341,1672541389,1672543011,1622
3830,3818575661,3273981374,1672607950,1672608670,720
3447,3201800997,3757903168,1672689146,1672692017,2871
3594,3515402792,3618808151,1672698008,1672701401,3393
3858,3715127070,3779646172,1672553240,1672555559,2319
3907,3755756564,3533274994,1672571265,1672574824,3559
3594,3337322736,3792274796,1672641329,1672642868,1539
3825,3481640525,3773033649,1672557520,1672560190,2670
3885,3711097754,3289817992,1672592573,1672593105,532
3639,3462273042,3777485931,1672701170,1672703543,2373
3904,3298151889,3773033649,1672662857,1672665135,2278
3749,3905899155,3780115155,1672648989,1672649770,781
3861,3637313265,3288224595,1672539965,1672543081,3116
3645,3501281016,3825881598,1672625944,1672627517,1573
3557,3511791953,3900945856,1672643405,1672644957,1552
3792,3791436104,3755065949,1672651095,1672654150,3055
3619,3755496114,3711637255,1672565575,1672566908,1333
3701,3850911686,3276003502,1672640426,1672642302,1876
3804,3855583256,3824641227,1672612164,1672615685,3521
3687,3904867554,3431460073,1672602369,1672604097,1728
3730,3513295938,3779854934,1672703091,1672704758,1667
3511,3793175445,3481640525,1672622059,1672623255,1196
3507,3618176292,3713517039,1672553986,1672555153,1167
3882,3357289672,3613338363,1672600122,1672601162,1040
3538,3685816610,3533090502,1672537704,1672540938,3234
3734,3713911104,3715619259,1672644022,1672645541,1519
3905,3793781065,3510641433,1672700781,1672703525,2744
3451,3201676087,3906536154,1672538474,1672541797,3323
3729,3970198861,3618354185,1672559893,1672560197,304
3785,3609113156,3713829743,1672634617,1672636086,1469
3858,3520355798,3411515369,1672548665,1672551612,2947
3680,3716679950,3779465522,1672622863,1672625490,2627
3884,3512722110,3779892400,1672646996,1672649290,2294
3563,3923754072,3511732493,1672605013,1672606819,1806
3524,3334951866,3855583256,1672626143,1672628292,2149
3831,3774718695,3311420950,1672542533,1672543154,621
3852,3732131656,3807212280,1672576319,1672578034,1715
3861,3510642075,3514512367,1672660819,1672661517,698
3525,3310125159,3480490124,1672700624,1672702504,1880
3521,3510837901,3638660068,1672580791,1672581294,503
3858,3516298579,3493017654,1672541793,1672541942,149
3629,3635169815,3792014516,1672607928,1672608721,793
3435,3770520359,3514324011,1672621999,1672624557,2558
3447,3238288884,3516298579,1672665498,1672666293,795
3473,3774907131,3398731252,1672693758,1672695242,1484
3891,3551389192,3887243870,1672544346,1672546384,2038
3661,3435116799,3513327337,1672596955,1672599807,2852
3490,3554186380,3638660068,1672541961,1672544418,2457
3598,3274906650,3779613523,1672677167,1672679830,2663
3867,3831586487,3368283077,1672646617,1672648436,1819
3433,3273981374,3515890966,1672702181,1672703684,1503
3713,3500613459,3779646172,1672596916,1672599276,2360
3828,3510919821,3760362417,1672538133,1672541679,3546
3787,3245232284,3614740489,1672669998,1672670478,480
3693,3701884158,3885155975,1672688992,1672691002,2010
3738,3500915665,3783340788,1672637259,1672639047,1788
3903,3511791953,3624297844,1672586765,1672589698,2933
3706,3856606678,3779301501,1672544733,1672546717,1984
3743,3892304880,3713517039,1672533027,1672536620,3593
3582,3500072204,3283144118,1672650767,1672654082,3315
3756,3732131656,3533368789,1672576116,1672576324,208
3432,3411688875,3533368789,1672594852,1672595178,326
3807,3462273042,3892304880,1672577341,1672580306,2965
3486,3817813340,3777694660,1672676226,1672678863,2637
3537,3373028638,3336627643,1672593069,1672593961,892
3787,3823084403,3515439826,1672541970,1672544579,2609
3672,3900945856,3505111292,1672544869,1672545540,671
3541,3774876004,3803517637,1672568426,1672570843,2417
3555,3512722110,3511288998,1672679261,1672681712,2451
3763,3791693821,3236354255,1672652776,1672655956,3180
3501,3519446663,3792745809,1672533781,1672534631,850
3632,3935913584,3514818819,1672573211,1672576458,3247
3873,3625463628,3457620713,1672583138,1672586059,2921
3565,3779786641,3686523546,1672655681,1672655817,136
3814,3512946768,3518565331,1672696984,1672700043,3059
3696,3438078818,3773033649,1672543190,1672545509,2319
3806,3755222916,3351866415,1672679647,1672682466,2819
3824,3497095254,3609881958,1672600734,1672601596,862
3738,3519028898,3513410578,1672667276,1672667667,391
3784,3935913584,3517172354,1672601501,1672604521,3020
3534,3890739241,3703383853,1672582197,1672585191,2994
3438,3519028898,3272030610,1672626427,1672628875,2448
3589,3680810086,3885157459,1672561771,1672563876,2105
3749,3757193307,3336627643,1672555107,1672556050,943
3562,3714128600,3779786641,1672654926,1672655480,554
3486,3732131656,3380130228,1672698982,1672702237,3255
3628,3336627643,3505111292,1672571449,1672572608,1159
3445,3449639012,3557046880,1672565847,1672567884,2037
3798,3779646172,3500857494,1672580045,1672581329,1284
3670,3710735406,3411688875,1672604599,1672607927,3328
3683,3519818818,3772765746,1672667401,1672669280,1879
3773,3393063657,3510798825,1672668000,1672670467,2467
3702,3534764451,3304155815,1672666734,1672668155,1421
3566,3618489670,3511732493,1672572610,1672574956,2346
3518,3755848152,3737147209,1672580813,1672582645,1832
3627,3792442597,3792525861,1672543846,1672544120,274
3657,3818575661,3510641433,1672682512,1672683855,1343
3614,3513327337,3970558632,1672597035,1672597221,186
3519,3779854934,3510818674,1672626620,1672630144,3524
3695,3512830734,3472068734,1672564906,1672568242,3336
3623,3514818819,3772391882,1672646064,1672649149,3085
3693,3774031303,3335694356,1672675792,1672675980,188
3615,3834631333,3711919537,1672543288,1672545581,2293
3784,3517991730,3500737582,1672683309,1672686191,2882
3694,3497671225,3779738691,1672597238,1672599629,2391
3484,3890739241,3534829213,1672701937,1672702047,110
3910,3760362417,3812369928,1672536539,1672539070,2531
3525,3928719932,3505283390,1672546019,1672549131,3112
3461,3534764451,3446533960,1672655358,1672657122,1764
3824,3441348818,3421877923,1672618449,1672619217,768
3916,3897376951,3462273042,1672648948,1672650842,1894
3905,3793740407,3791436104,1672542211,1672543784,1573
3469,3615688740,3300511067,1672651401,1672653411,2010
3481,3349856820,3923754072,1672664667,1672667774,3107
3495,3625174002,3757193307,1672665626,1672668662,3036
3463,3680810086,3374183227,1672534268,1672534967,699
3464,3817428320,3897376951,1672610912,1672613919,3007
3799,3815250107,3777147510,1672625105,1672625844,739
3889,3608232640,3534566651,1672602325,1672604470,2145
3491,3779532653,3622665543,1672668752,1672670281,1529
3778,3487875183,3513081354,1672681447,1672683708,2261
3798,3533294425,3373028638,1672564933,1672565685,752
3896,3783136330,3505923418,1672581907,1672584442,2535
3509,3664943873,3448875382,1672656723,1672657845,1122
3906,3517697722,3815392801,1672672211,1672674038,1827
3510,3495911207,3500915908,1672581123,1672583037,1914
3433,3398731252,3518194482,1672673120,1672673305,185
3917,3513041785,3209481722,1672638436,1672641947,3511
3624,3609881958,3933894942,1672637434,1672639946,2512
3829,3533929349,3408430195,1672575447,1672578610,3163
3541,3513081354,3517687662,1672641270,1672643445,2175
3550,3703396825,3715707380,1672685404,1672688882,3478
3610,3608855425,3755756564,1672534330,1672537694,3364
3772,3399472693,3333403880,1672661371,1672663016,1645
3641,3520639768,3688796737,1672575942,1672577978,2036
3706,3500777439,3925979970,1672696307,1672697846,1539
3552,3773121782,3488686442,1672537928,1672538096,168
3675,3516321888,3500302272,1672656492,1672657791,1299
3459,3793583656,3630353876,1672649637,1672652552,2915
3455,3447514821,3920625129,1672642668,1672644828,2160
3609,3551399764,3299443125,1672631274,1672631898,624
3775,3817813340,3713941638,1672543572,1672546022,2450
3841,3714827719,3300818269,1672618294,1672621004,2710
3564,3757294769,3338390596,1672553265,1672556510,3245
3689,3350095157,3299125059,1672631561,1672632777,1216
3575,3880926355,3815392801,1672554165,1672556520,2355
3909,3500347447,3817428320,1672644150,1672645641,1491
3625,3604589802,3920898925,1672599658,1672600698,1040
3533,3711734586,3376467719,1672580503,1672581562,1059
3810,3463740710,3500208903,1672598206,1672600493,2287
3682,3511024016,3713561276,1672560583,1672563042,2459
3521,3220031931,3791441520,1672581139,1672582224,1085
3737,3511843593,3778040015,1672604402,1672606097,1695
3515,3454277788,3780115155,1672557074,1672558655,1581
3558,3510964997,3618489670,1672692991,1672696068,3077
3742,3283492940,3778597171,1672695101,1672696649,1548
3732,3802932312,3248058676,1672597887,1672598456,569
3526,3773332082,3515439826,1672577105,1672579749,2644
3687,3915162005,3390660440,1672618366,1672621774,3408
3769,3632814465,3938503547,1672634673,1672637621,2948
3587,3390660440,3512295534,1672578921,1672582007,3086
3618,3711218296,3463849738,1672695123,1672698717,3594
3856,3774605761,3509756823,1672540537,1672542270,1733
3580,3510837901,3510837901,1672695611,1672696761,1150
3778,3701136026,3220031931,1672678711,1672680820,2109
3874,3519087371,3501121099,1672639578,1672641073,1495
3828,3734118023,3505154885,1672547241,1672549430,2189
3867,3604589802,3779425804,1672648224,1672651733,3509
3728,3316800320,3818575661,1672583447,1672583971,524
3596,3711077927,3519077659,1672642039,1672644824,2785
3819,3755915206,3501121099,1672663820,1672663964,144
3715,3274831810,3859868849,1672563822,1672565725,1903
3720,3621790707,3289114629,1672680319,1672681992,1673
3853,3516903528,3500347447,1672664774,1672668153,3379
3864,3613581796,3499217428,1672669003,1672669181,178
3860,3284947372,3615688740,1672564793,1672568216,3423
3658,3703433819,3412968120,1672590024,1672590839,815
3826,3639050419,3505481368,1672626550,1672629064,2514
3866,3505521218,3445206685,1672662399,1672664513,2114
3900,3512958459,3898314440,1672545140,1672547405,2265
3730,3220031931,3714185969,1672551456,1672554342,2886
3716,3638204468,3510499038,1672674608,1672676974,2366
3861,3519282716,3517881647,1672584257,1672586438,2181
3483,3927403123,3703383853,1672693349,1672694628,1279
3866,3333403880,3793969543,1672670096,1672671644,1548
3728,3778040015,3912891315,1672552995,1672556473,3478
3885,3408430195,3510642075,1672663159,1672665949,2790
3904,3710315160,3500915665,1672572866,1672573541,675
3678,3853629553,3890739241,1672650818,1672653207,2389
3699,3791106564,3408498208,1672588114,1672590123,2009
3831,3236354255,3739911441,1672592933,1672594192,1259
3440,3300979975,3351866415,1672644981,1672645440,459
3747,3533368789,3231713082,1672623189,1672626064,2875
3615,3777240360,3774031303,1672622364,1672623886,1522
3492,3512392431,3668747074,1672557760,1672561114,3354
3467,3660887799,3276217799,1672631348,1672633442,2094
3843,3902760230,3333918941,1672623615,1672626453,2838
3856,3711000597,3517887477,1672536018,1672538220,2202
3500,3935487534,3792949946,1672637751,1672638123,372
3603,3517222913,3241790910,1672566357,1672568230,1873
3789,3336339664,3337322736,1672669956,1672670411,455
3777,3439673892,3710496785,1672684142,1672685600,1458
3633,3511883730,3520991398,1672615758,1672618545,2787
3765,3756474459,3893912331,1672611830,1672612552,722
3709,3770468980,3512946768,1672667373,1672669070,1697
3802,3735374579,3501215099,1672545022,1672547455,2433
3517,3472068734,3371455553,1672606509,1672607873,1364
3796,3630353876,3808136029,1672681137,1672683374,2237
3507,3309314379,3774790271,1672653461,1672655683,2222
3621,3485540729,3756625818,1672636945,1672638101,1156
3841,3811075491,3224330592,1672549632,1672552569,2937
3483,3621461051,3605221116,1672636848,1672637298,450
3532,3756385685,3501567772,1672648311,1672650526,2215
3718,3710489491,3756625818,1672569092,1672570399,1307
3524,3519446663,3333918941,1672673393,1672673761,368
3837,3703348097,3760364383,1672622205,1672623729,1524
3634,3774641380,3509756823,1672590568,1672590905,337
3493,3792274796,3979784676,1672622222,1672623942,1720
3628,3338390596,3284932450,1672603482,1672604051,569
3675,3333918941,3622357348,1672637805,1672638536,731
3579,3803389195,3715854030,1672656585,1672659521,2936
3758,3680843171,3856606678,1672593978,1672594319,341
3462,3490214516,3716272919,1672584179,1672584460,281
3510,3519818818,3491469603,1672592297,1672593271,974
3921,3815250107,3311085279,1672538439,1672538915,476
3656,3519142371,3501281016,1672538769,1672539537,768
3650,3779854934,3509764635,1672633454,1672634528,1074
3692,3756746867,3916490839,1672602565,1672606090,3525
3547,3552824113,3923420131,1672555265,1672556066,801
3707,3411515369,3783520186,1672568492,1672568713,221
3532,3818575661,3500915908,1672617919,1672620277,2358
3505,3701884158,3398731252,1672642689,1672645721,3032
3462,3533188828,3533368789,1672604769,1672605987,1218
3689,3520764926,3519651506,1672536561,1672537918,1357
3550,3912891315,3710315160,1672537605,1672539498,1893
3625,3336627643,3533368789,1672576448,1672578243,1795
3844,3276217799,3517687662,1672625086,1672627122,2036
3444,3279475486,3770468980,1672663146,1672665027,1881
3883,3230135532,3710562338,1672635829,1672638607,2778
3572,3618354185,3667673649,1672545475,1672547794,2319
3849,3711097754,3520657891,1672680381,1672682452,2071
3426,3519446663,3780322355,1672683529,1672683755,226
3908,3224968597,3513065217,1672618954,1672620030,1076
3859,3770296583,3979784676,1672575971,1672576654,683
3465,3382733096,3511601997,1672649757,1672650677,920
3874,3398198430,3710008361,1672701661,1672701908,247
3682,3756474459,3309314379,1672541558,1672543796,2238
3530,3935487534,3518229776,1672539340,1672541358,2018
3826,3773572967,3533228966,1672559652,1672561968,2316
3784,3604589802,3688490530,1672544204,1672546617,2413
3443,3450969839,3710735406,1672545830,1672546607,777
3532,3240994288,3279473441,1672628917,1672632468,3551
3780,3519651506,3621184108,1672545504,1672547560,2056
3610,3970198861,3714128600,1672691684,1672694210,2526
3684,3551376095,3777814504,1672632536,1672634938,2402
3458,3773009828,3226024417,1672538056,1672540739,2683
3738,3512383699,3299781901,1672567369,1672567837,468
3770,3760842815,3396726504,1672657063,1672660496,3433
3578,3613899351,3772391882,1672616769,1672617935,1166
3558,3491684096,3792745809,1672578894,1672580991,2097
3519,3637313265,3773902805,1672647240,1672648990,1750
3683,3533929349,3220031931,1672593616,1672594050,434
3506,3669146016,3338390596,1672545762,1672548662,2900
3788,3817428320,3793781065,1672630743,1672633252,2509
3755,3454277788,3514275974,1672558137,1672559012,875
3637,3713941638,3624297844,1672608075,1672610007,1932
3549,3783641602,3203538212,1672610788,1672611130,342
3691,3778926763,3449639012,1672557448,1672559925,2477
3686,3518229776,3619922891,1672571847,1672574580,2733
3569,3370068529,3533649454,1672663198,1672665634,2436
3692,3912891315,3513018485,1672568549,1672569136,587
3430,3621683102,3335694356,1672665349,1672667264,1915
3852,3533929349,3618354185,1672625429,1672628177,2748
3744,3735374579,3505995057,1672687068,1672689933,2865
3500,3755404116,3736231757,1672647976,1672648099,123
3582,3608922867,3505178849,1672577403,1672577777,374
3783,3311498666,3517462308,1672576655,1672580084,3429
3453,3621683102,3932478321,1672666800,1672669829,3029
3490,3534829213,3505923418,1672677684,1672680290,2606
3648,3819767045,3380767040,1672571826,1672574079,2253
3428,3884596900,3610870949,1672560536,1672560918,382
3631,3925979970,3505995057,1672612618,1672615903,3285
3528,3517697722,3368283077,1672542300,1672544582,2282
3460,3446533960,3669146016,1672651357,1672654066,2709
3780,3633735593,3517600136,1672682534,1672682594,60
3877,3515401243,3514971533,1672618817,1672621513,2696
3879,3436257398,3292147449,1672675118,1672676895,1777
3541,3349739136,3661447322,1672644360,1672647666,3306
3513,3779465522,3230135532,1672693456,1672693543,87
3780,3756474459,3774641380,1672544562,1672546772,2210
3894,3490029863,3334993594,1672660897,1672662725,1828
3790,3534566651,3793175445,1672634897,1672635219,322
3762,3429943738,3777624586,1672607344,1672609601,2257
3621,3777779869,3438078818,1672574073,1672576114,2041
3491,3463740710,3703396825,1672625992,1672627660,1668
3807,3623266256,3459681410,1672701102,1672704684,3582
3710,3665998641,3793868716,1672659784,1672660229,445
3755,3272096759,3416987084,1672574971,1672575412,441
3822,3283492940,3533294425,1672682263,1672684111,1848
3503,3734118023,3241790910,1672635678,1672638514,2836
3619,3701107228,3783550022,1672638663,1672641398,2735
3727,3783520186,3834960360,1672645465,1672647945,2480
3762,3505481368,3279242917,1672696415,1672697159,744
3779,3501215099,3438489358,1672593179,1672595101,1922
3476,3515525630,3701322924,1672637239,1672638279,1040
3432,3757863420,3455018347,1672609892,1672612449,2557
3835,3783550022,3519416013,1672629546,1672631056,1510
3433,3343132529,3803517637,1672559214,1672562645,3431
3892,3478114114,3713979100,1672613659,1672614260,601
3638,3517358573,3360813161,1672638780,1672641214,2434
3912,3513041785,3605221116,1672591490,1672593451,1961
3914,3970558632,3701882224,1672626792,1672628760,1968
3490,3637313265,3517590837,1672671011,1672671892,881
3591,3777147510,3520873221,1672564026,1672565992,1966
3700,3774243020,3335694356,1672582569,1672583003,434
3545,3793315718,3710008361,1672611173,1672614484,3311
3847,3755737419,3480100311,1672611055,1672614187,3132
3525,3520873221,3510837901,1672677314,1672680055,2741
3509,3500613459,3299443125,1672671949,1672674217,2268
3651,3520115090,3505663516,1672641087,1672642850,1763
3862,3501384020,3517887477,1672538401,1672539711,1310
3625,3505437712,3412006598,1672690722,1672692329,1607
3512,3501457103,3368283077,1672544346,1672545694,1348
3731,3510641433,3334993594,1672581274,1672581798,524
3892,3386758279,3887243870,1672570518,1672571015,497
3781,3818575661,3850911686,1672653110,1672654206,1096
3642,3429943738,3412006598,1672659855,1672662149,2294
3658,3517222913,3552824113,1672551826,1672553789,1963
3439,3902625986,3516298579,1672542054,1672543938,1884
3752,3515439826,3793407963,1672699514,1672702773,3259
3737,3617392620,3779854934,1672700330,1672702965,2635
3844,3370068529,3534566651,1672578519,1672581113,2594
3697,3904569677,3510028805,1672599473,1672599642,169
3704,3778667336,3551376095,1672593947,1672596282,2335
3917,3620292035,3303410628,1672542756,1672543477,721
3696,3401793306,3288762795,1672566747,1672570104,3357
3538,3515525630,3833217041,1672657569,1672660511,2942
3682,3703383853,3394401087,1672575342,1672577875,2533
3883,3773913680,3392520516,1672580965,1672584120,3155
3900,3714827719,3500317969,1672617314,1672620860,3546
3641,3288224595,3500857494,1672572695,1672573623,928
3904,3347446226,3902861231,1672602752,1672603674,922
3534,3604867757,3376467719,1672629125,1672629197,72
3883,3770438122,3607882826,1672680512,1672683399,2887
3827,3512383699,3490029863,1672690409,1672692897,2488
3639,3926643445,3715127070,1672686656,1672686990,334
3526,3552824113,3926643445,1672584239,1672587072,2833
3575,3711853996,3514246749,1672701523,1672703738,2215
3802,3636329663,3713911104,1672544797,1672545820,1023
3750,3760640999,3923220461,1672700306,1672700567,261
3490,3414049538,3518653080,1672590985,1672592712,1727
3674,3410160376,3608232640,1672561282,1672563862,2580
3727,3461119815,3448633776,1672663766,1672664948,1182
3582,3299125059,3625174002,1672684598,1672687342,2744
3864,3533747868,3774605761,1672617569,1672617663,94
3578,3779301501,3780872464,1672576047,1672578363,2316
3491,3713911104,3518194482,1672593155,1672593589,434
3623,3488763230,3760362417,1672680371,1672681613,1242
3704,3448633776,3739895284,1672601803,1672603096,1293
3563,3773837847,3770438122,1672609553,1672610229,676
3632,3714666884,3467988782,1672603935,1672606147,2212
3677,3296462324,3390660440,1672638228,1672641147,2919
3816,3513327337,3351696332,1672536175,1672536930,755
3849,3611055563,3905899155,1672668510,1672668754,244
3764,3225631197,3823084403,1672650452,1672653898,3446
3589,3906536154,3449333754,1672539097,1672539802,705
3457,3200543880,3800257590,1672629346,1672630732,1386
3801,3803389195,3792072681,1672685508,1672687912,2404
3914,3500777439,3231494505,1672569287,1672572360,3073
3504,3703383853,3817813340,1672661226,1672663894,2668
3839,3559458968,3514419100,1672596224,1672597436,1212
3660,3448875382,3739911441,1672565901,1672569427,3526
3680,3755233658,3488686442,1672612256,1672614403,2147
3513,3294747828,3408498208,1672583427,1672585990,2563
3734,3554944414,3367111751,1672588682,1672592162,3480
3840,3424660806,3932478321,1672659183,1672660506,1323
3868,3519028898,3517887477,1672695038,1672696503,1465
3520,3605221116,3512800570,1672617740,1672619826,2086
3692,3710496785,3793583656,1672642734,1672643260,526
3689,3928511283,3551389192,1672564658,1672567761,3103
3752,3661583097,3756789525,1672607331,1672610660,3329
3437,3341893384,3500703304,1672650580,1672651379,799
3636,3414275042,3777147510,1672626156,1672629147,2991
3771,3505228454,3279475486,1672542213,1672543329,1116
3839,3850911686,3889780657,1672630244,1672633626,3382
3870,3505198734,3778040015,1672556555,1672557752,1197
3787,3438489358,3760694096,1672645075,1672647528,2453
3627,3462636434,3777091903,1672605107,1672607896,2789
3761,3604867757,3513295938,1672543100,1672544111,1011
3444,3399518841,3836241528,1672659060,1672662297,3237
3851,3350095157,3714827719,1672642376,1672645823,3447
3443,3916490839,3757075324,1672537483,1672538943,1460
3689,3734915241,3815392801,1672616614,1672617562,948
3906,3505283390,3617116290,1672654023,1672655891,1868
3729,3793743698,3385323994,1672647185,1672647551,366
3874,3505807416,3713941638,1672622602,1672625956,3354
3560,3311049964,3364726656,1672561801,1672564555,2754
3820,3792014516,3510641433,1672652183,1672653124,941
3520,3791613604,3417191856,1672531836,1672534019,2183
3865,3294703680,3884596900,1672619714,1672621701,1987
3697,3627368399,3505521218,1672597679,1672600093,2414
3485,3755404116,3533228966,1672682976,1672685320,2344
3837,3505847380,3310125159,1672639828,1672640696,868
3741,3780427126,3360616538,1672552910,1672556431,3521
3552,3757193307,3938389661,1672693032,1672694701,1669
3565,3791693821,3428027649,1672544123,1672547308,3185
3842,3819767045,3853629553,1672545966,1672548112,2146
3708,3618697021,3773009828,1672600431,1672602215,1784
3846,3516741440,3688490530,1672630171,1672630986,815
3784,3418448389,3803517637,1672615962,1672616946,984
3828,3205985903,3773121782,1672632579,1672633147,568
3805,3230868435,3300979975,1672577193,1672578962,1769
3743,3755532873,3554186380,1672561896,1672562015,119
3825,3512392431,3779738691,1672559023,1672560592,1569
3517,3518229776,3364726656,1672646983,1672649848,2865
3573,3512379024,3713768950,1672655404,1672658587,3183
3759,3462158237,3392520516,1672628429,1672629618,1189
3617,3404025196,3979784676,1672630760,1672634056,3296
3854,3412006598,3230135532,1672660559,1672661867,1308
3433,3715086894,3519028898,1672590522,1672593330,2808
3888,3757193551,3902861231,1672606909,1672609624,2715
3522,3467779445,3226511603,1672674989,1672676590,1601
3915,3711919537,3853629553,1672561542,1672564101,2559
3721,3807212280,3904412440,1672657244,1672659499,2255
3618,3902625986,3516321888,1672668500,1672670641,2141
3574,3756704774,3505725706,1672551986,1672552800,814
3902,3280054198,3401940259,1672629813,1672632103,2290
3537,3755233658,3305336154,1672685645,1672685918,273
3479,3739895284,3938503547,1672633886,1672634406,520
3832,3505266860,3885157459,1672620257,1672622007,1750
3675,3776559988,3757383891,1672547422,1672550355,2933
3870,3777189898,3780322355,1672607566,1672608987,1421
3600,3349739136,3777694660,1672664330,1672667307,2977
3545,3715974659,3500915665,1672573795,1672576403,2608
3859,3512502036,3533188828,1672670806,1672673007,2201
3812,3500347447,3834960360,1672698263,1672699581,1318
3498,3899786664,3460719322,1672656243,1672656369,126
3911,3273981374,3760362417,1672664905,1672665928,1023
3425,3513296868,3710854064,1672571958,1672573489,1531
3581,3463849738,3900898992,1672667037,1672667271,234
3451,3755756564,3403370192,1672622614,1672623253,639
3763,3757903168,3774155692,1672661036,1672661537,501
3786,3245232284,3778134418,1672571757,1672575161,3404
3475,3514285803,3451726367,1672663126,1672664337,1211
3468,3505807416,3279473441,1672643043,1672646596,3553
3590,3335694356,3280054198,1672610730,1672613316,2586
3784,3500613459,3783641602,1672691992,1672695340,3348
3501,3357289672,3778597171,1672543099,1672546179,3080
3776,3299125059,3756746867,1672701336,1672703966,2630
3486,3515559913,3620292035,1672623131,1672624818,1687
3640,3206837348,3516903528,1672548367,1672549295,928
3625,3923420131,3716628503,1672654024,1672657438,3414
3605,3509764635,3461119815,1672665872,1672669186,3314
3784,3660063072,3450969839,1672554732,1672555331,599
3828,3899326793,3382733096,1672639923,1672641518,1595
3514,3909094917,3778134418,1672627055,1672627445,390
3754,3778040015,3897456874,1672559548,1672562077,2529
3545,3613338363,3972083617,1672682045,1672683367,1322
3779,3902760230,3608232640,1672688780,1672689074,294
3499,3715443333,3783771827,1672632014,1672633072,1058
3555,3783163143,3311498666,1672537118,1672539547,2429
3896,3370227921,3853629553,1672620368,1672623010,2642
3607,3236458894,3927403123,1672700041,1672702668,2627
3564,3621790707,3617489344,1672536000,1672539027,3027
3712,3713911104,3411515369,1672664521,1672668028,3507
3480,3240994288,3294703680,1672587308,1672587816,508
3462,3208452238,3713784974,1672637432,1672640576,3144
3661,3621461051,3448875382,1672616932,1672617591,659
3556,3779438325,3855583256,1672537300,1672538024,724
3613,3607882826,3349739136,1672655334,1672657497,2163
3685,3343816795,3773837847,1672590073,1672593594,3521
3782,3613416045,3239617320,1672575890,1672578723,2833
3855,3283144118,3773124276,1672663502,1672664899,1397
3914,3836241528,3811040565,1672580587,1672583432,2845
3919,3500915665,3703139663,1672669039,1672670528,1489
3694,3885155975,3780712350,1672677396,1672680534,3138
3725,3715974659,3554825448,1672605156,1672606824,1668
3500,3499217428,3225631197,1672662576,1672662664,88
3650,3755532873,3783373154,1672600995,1672602420,1425
3439,3513345163,3791046864,1672703919,1672706535,2616
3861,3703139663,3897134762,1672675062,1672675195,133
3469,3298151889,3463849738,1672608775,1672609414,639
3508,3773735484,3926643445,1672699079,1672701869,2790
3770,3710496785,3372223551,1672545631,1672547262,1631
3845,3414275042,3772078494,1672657515,1672657841,326
3828,3520355798,3773121782,1672581986,1672582349,363
3473,3497095254,3853629553,1672553977,1672555378,1401
3746,3475349791,3739154408,1672607321,1672608215,894
3523,3533274994,3714120857,1672547740,1672550389,2649
3480,3511024016,3533294425,1672696819,1672698715,1896
3627,3793868716,3490214516,1672667536,1672668215,679
3427,3774290799,3779786641,1672629134,1672629875,741
3475,3236499444,3514971533,1672636415,1672637489,1074
3753,3505807416,3783169442,1672589171,1672592695,3524
3505,3520416075,3811075491,1672655313,1672657380,2067
3872,3514285803,3306412634,1672568763,1672570784,2021
3518,3467988782,3500604680,1672610439,1672611932,1493
3436,3500341755,3336627643,1672555537,1672557521,1984
3707,3932478321,3819767045,1672606691,1672608785,2094
3723,3633735593,3517222913,1672562481,1672563920,1439
3757,3511791953,3904569677,1672599166,1672600294,1128
3680,3927403123,3793969543,1672628474,1672631732,3258
3521,3225029895,3274906650,1672569556,1672572415,2859
3591,3834631333,3701823816,1672689200,1672692131,2931
3766,3335694356,3338083680,1672701562,1672705016,3454
3690,3475349791,3665998641,1672577107,1672580406,3299
3642,3445206685,3783433404,1672655637,1672656304,667
3776,3667427125,3793175445,1672593457,1672596667,3210
3444,3300979975,3229974066,1672552598,1672552671,73
3597,3554944414,3779639983,1672700458,1672703440,2982
3547,3793868716,3475349791,1672585260,1672586564,1304
3568,3778667336,3280054198,1672560273,1672561673,1400
3530,3716272919,3412968120,1672622138,1672624607,2469
3573,3774178201,3669146016,1672659159,1672660609,1450
3485,3714067076,3755756564,1672557031,1672557907,876
3664,3772236797,3715619259,1672565960,1672569365,3405
3683,3735374579,3343132529,1672585495,1672586409,914
3524,3715443333,3823084403,1672567131,1672569283,2152
3842,3774718695,3509756823,1672539887,1672542799,2912
3507,3783550022,3890739241,1672607323,1672610821,3498
3427,3665998641,3776244398,1672683877,1672684521,644
3462,3520355798,3424445495,1672548656,1672548839,183
3836,3511791953,3792489602,1672627448,1672627545,97
3488,3505634634,3513018485,1672694156,1672695467,1311
3865,3209481722,3459681410,1672549762,1672553220,3458
3528,3756385685,3733558985,1672691535,1672693766,2231
3762,3374183227,3450286949,1672639512,1672641225,1713
3865,3714233826,3501215099,1672667405,1672670943,3538
3618,3791246640,3711000597,1672703718,1672704586,868
3642,3534357694,3519077659,1672547648,1672551151,3503
3531,3513065217,3755230952,1672570003,1672570568,565
3483,3970198861,3610358027,1672666251,1672666774,523
3528,3514703118,3824215187,1672543215,1672544222,1007
3576,3369708250,3661447322,1672684424,1672687211,2787
3833,3923420131,3517288083,1672647459,1672650072,2613
3552,3500109249,3757075324,1672552564,1672553488,924
3850,3515525630,3972192593,1672549435,1672550267,832
3485,3792538417,3379143440,1672619744,1672619855,111
3807,3279473441,3392943173,1672698368,1672698540,172
3707,3823084403,3410160376,1672592337,1672595696,3359
3559,3618354185,3519028898,1672668976,1672672404,3428
3837,3783550022,3276348699,1672621794,1672624472,2678
3628,3852686295,3774733620,1672616802,1672620163,3361
3546,3414940786,3600876425,1672679059,1672680047,988
3553,3402385957,3713911104,1672631715,1672633011,1296
3558,3385323994,3200308999,1672568419,1672569933,1514
3738,3902760230,3773124276,1672551631,1672554868,3237
3618,3271454397,3500703304,1672624053,1672625339,1286
3443,3818575661,3778640261,1672692740,1672692954,214
3605,3760651515,3777694660,1672669621,1672672831,3210
3755,3456430614,3711097754,1672565152,1672566862,1710
3816,3272096759,3774907131,1672644960,1672647704,2744
3552,3638660068,3783641602,1672542454,1672544567,2113
3437,3447514821,3770236215,1672666437,1672669179,2742
3568,3424445495,3931627862,1672625570,1672627909,2339
3810,3392943173,3431460073,1672554985,1672557732,2747
3537,3283770991,3780872464,1672621401,1672622003,602
3608,3608855425,3615939504,1672586529,1672589389,2860
3497,3792505974,3272030610,1672682284,1672682756,472
3665,3770676872,3360813161,1672659462,1672661159,1697
3808,3914691363,3627368399,1672688406,1672689549,1143
3874,3338083680,3933894942,1672600687,1672601085,398
3916,3412006598,3792072681,1672555381,1672556562,1181
3432,3776559988,3770438122,1672535683,1672537320,1637
3597,3517222913,3777694660,1672699468,1672700021,553
3756,3970558632,3392520516,1672615643,1672616063,420
3459,3814677862,3520560590,1672652189,1672652984,795
3789,3421877923,3519087371,1672562891,1672564157,1266
3504,3684523966,3932478321,1672572416,1672572907,491
3669,3519416013,3703433819,1672585265,1672586790,1525
3666,3334647380,3516741440,1672680074,1672682526,2452
3899,3757348722,3738026330,1672701648,1672703071,1423
3666,3814677862,3515402792,1672592226,1672593929,1703
3867,3510767239,3462636434,1672560430,1672563135,2705
3559,3783136330,3510818674,1672615935,1672616564,629
3529,3938503547,3512499658,1672599440,1672600983,1543
3917,3818575661,3292147449,1672553952,1672554895,943
3861,3518653080,3337322736,1672574694,1672575192,498
3621,3371455553,3409114719,1672585903,1672588202,2299
3530,3711077927,3734118023,1672637846,1672639810,1964
3847,3713829743,3364378127,1672590574,1672592624,2050
3853,3505481368,3515439826,1672621261,1672623979,2718
3585,3554944414,3803517637,1672605122,1672605237,115
3505,3299125059,3773332082,1672606574,1672609217,2643
3610,3755496114,3774641380,1672542947,1672543078,131
3618,3485540729,3534126409,1672590500,1672593167,2667
3730,3793935736,3294703680,1672680855,1672681602,747
3862,3703383853,3618697021,1672672579,1672674830,2251
3751,3511601997,3402385957,1672592678,1672594854,2176
3724,3534543776,3512722110,1672644121,1672647018,2897
3639,3716963089,3299781901,1672665632,1672668553,2921
3692,3280268483,3776117322,1672606339,1672606734,395
3644,3760842815,3760842815,1672613516,1672614968,1452
3573,3201800997,3733558985,1672558801,1672559269,468
3733,3734118023,3774733620,1672611292,1672614599,3307
3849,3661903000,3450969839,1672569470,1672571480,2010
3549,3739911441,3392836218,1672570355,1672572579,2224
3781,3618489670,3310039260,1672573558,1672576554,2996
3825,3246370118,3373089838,1672693604,1672693958,354
3534,3686227677,3774155692,1672668479,1672671898,3419
3834,3773027597,3534543776,1672586747,1672588308,1561
3685,3774790271,3289817992,1672600855,1672602103,1248
3856,3713911104,3686523546,1672643751,1672645529,1778
3777,3638204468,3756474459,1672644551,1672645607,1056
3694,3777485931,3610358027,1672545598,1672548034,2436
3571,3367971170,3220031931,1672551567,1672552850,1283
3823,3500949309,3661903000,1672546266,1672549096,2830
3818,3229822507,3534126409,1672561617,1672562090,473
3426,3272716462,3283144118,1672612988,1672615722,2734
3799,3703798634,3739661856,1672667426,1672668599,1173
3874,3970198861,3394297564,1672651712,1672653839,2127
3467,3518194482,3757193551,1672557564,1672560724,3160
3487,3501786419,3274831810,1672622624,1672623422,798
3707,3513041785,3533188828,1672558941,1672560494,1553
3678,3780115155,3341893384,1672565032,1672567267,2235
3430,3390660440,3615115210,1672658703,1672659099,396
3563,3360813161,3349739136,1672585021,1672587867,2846
3585,3505434346,3411688875,1672642809,1672644876,2067
3886,3450286949,3300818269,1672586516,1672589953,3437
3498,3515559913,3715443333,1672638279,1672639771,1492
3789,3779786641,3311085279,1672679622,1672681210,1588
3681,3779532653,3519446663,1672639726,1672640247,521
3858,3554186380,3382733096,1672559045,1672562296,3251
3800,3613899351,3512800570,1672623524,1672624961,1437
3888,3668747074,3716963089,1672591751,1672594258,2507
3517,3772391882,3735374579,1672615299,1672616338,1039
3747,3777624586,3621683102,1672570990,1672571418,428
3457,3519909393,3716679950,1672667318,1672670553,3235
3638,3209481722,3710854064,1672576674,1672577337,663
3496,3511732493,3510028805,1672563155,1672565715,2560
3723,3783771827,3607882826,1672702195,1672703095,900
3521,3334951866,3780427126,1672658380,1672660050,1670
3703,3783520186,3615115210,1672592129,1672595729,3600
3544,3505888598,3770624662,1672645783,1672646325,542
3505,3334951866,3885157459,1672570758,1672572203,1445
3586,3509483172,3933894942,1672535919,1672538057,2138
3477,3512800570,3716963089,1672542437,1672543949,1512
3816,3245232284,3915162005,1672641140,1672641923,783
3887,3680810086,3776034743,1672610916,1672611607,691
3552,3776034743,3533929349,1672562523,1672564623,2100
3592,3517222913,3773913680,1672702527,1672703108,581
3472,3711812325,3491469603,1672628465,1672629249,784
3646,3610358027,3756704774,1672625927,1672629012,3085
3516,3270056120,3236354255,1672534614,1672534978,364
3714,3713911104,3334993594,1672637987,1672638728,741
3750,3783136330,3349856820,1672563157,1672563477,320
3620,3375449013,3777189898,1672599183,1672601506,2323
3748,3515401243,3202141727,1672535289,1672536618,1329
3428,3920625129,3859868849,1672580752,1672580939,187
3737,3915162005,3928719932,1672699429,1672702107,2678
3899,3385323994,3975717896,1672542753,1672545766,3013
3707,3928719932,3510837901,1672534916,1672535123,207
3470,3440107959,3493017654,1672689172,1672689748,576
3581,3417191856,3244004456,1672683670,1672687026,3356
3602,3351866415,3703433819,1672582643,1672582996,353
3749,3299443125,3334647380,1672549004,1672550809,1805
3870,3351696332,3367111751,1672607123,1672608476,1353
3848,3604867757,3779532653,1672573576,1672573658,82
3885,3739911441,3509756823,1672601853,1672604210,2357
3739,3617489344,3714185969,1672666391,1672669825,3434
3858,3510919821,3780909839,1672533234,1672535328,2094
3561,3756746867,3511442562,1672695455,1672696445,990
3605,3622357348,3626499450,1672696114,1672699182,3068
3839,3850911686,3711097754,1672584612,1672585694,1082
3915,3624297844,3246370118,1672586709,1672588606,1897
3918,3609659642,3611055563,1672579996,1672581083,1087
3725,3668533536,3774733620,1672683883,1672686142,2259
3480,3517697722,3757383891,1672572495,1672573529,1034
3838,3533649454,3276348699,1672665520,1672667179,1659
3586,3245232284,3807212280,1672627491,1672630098,2607
3444,3633735593,3462273042,1672619912,1672621288,1376
3465,3889780657,3774790271,1672597984,1672600106,2122
3898,3891672228,3500442734,1672676447,1672679697,3250
3693,3612689556,3713691388,1672631445,1672633612,2167
3569,3711077927,3979802715,1672668159,1672670148,1989
3622,3510187271,3276348699,1672532031,1672532333,302
3816,3733363628,3271454397,1672660413,1672661767,1354
3616,3240994288,3777779869,1672622800,1672625187,2387
3612,3814677862,3715986185,1672651455,1672653198,1743
3549,3505228454,3703348097,1672531943,1672534863,2920
3742,3773913680,3824215187,1672631693,1672633821,2128
3637,3897435944,3533274994,1672662359,1672662691,332
3906,3373028638,3732584121,1672651435,1672653840,2405
3572,3819767045,3755992176,1672597670,1672600919,3249
3686,3469254160,3926643445,1672668618,1672668757,139
3895,3818575661,3516321888,1672580992,1672581212,220
3449,3780712350,3225636215,1672594095,1672597620,3525
3819,3755404116,3514275974,1672675984,1672676538,554
3443,3479851674,3511883730,1672700091,1672700522,431
3895,3793922324,3276269264,1672637084,1672639206,2122
3655,3534179433,3856606678,1672580641,1672581675,1034
3914,3780769110,3519028898,1672554385,1672556841,2456
3705,3715086894,3701882224,1672703597,1672705276,1679
3808,3415833929,3730071479,1672654788,1672656821,2033
3714,3516903528,3791436104,1672632822,1672635969,3147
3447,3470454332,3715127070,1672668777,1672671806,3029
3552,3515466096,3755848152,1672672839,1672675507,2668
3451,3501457103,3460719322,1672627555,1672629560,2005
3706,3512946768,3714185969,1672553327,1672554678,1351
3616,3364726656,3793781065,1672659608,1672661288,1680
3553,3449639012,3792949946,1672554185,1672555325,1140
3664,3517600136,3500613493,1672641726,1672642282,556
3564,3770520359,3441348818,1672546985,1672548373,1388
3717,3368283077,3505283390,1672563387,1672566195,2808
3867,3513295938,3300229945,1672695801,1672698047,2246
3726,3202141727,3514275974,1672642432,1672643708,1276
3899,3385323994,3270056120,1672559444,1672561585,2141
3703,3760094385,3288762795,1672702567,1672703038,471
3802,3534126409,3336627643,1672598670,1672600160,1490
3650,3533747868,3201800997,1672543200,1672544851,1651
3884,3701424609,3330340793,1672536071,1672536624,553
3554,3245232284,3516703758,1672594749,1672596282,1533
3653,3703383853,3812534508,1672651758,1672655063,3305
3484,3892304880,3512946768,1672533378,1672536600,3222
3669,3661447322,3792072681,1672567267,1672569135,1868
3507,3519282716,3684523966,1672551561,1672552106,545
3844,3512958459,3898314440,1672618746,1672620532,1786
3850,3897456874,3499217428,1672545120,1672547561,2441
3639,3431460073,3414049538,1672630909,1672631130,221
3444,3364378127,3224968597,1672626533,1672627503,970
3607,3333918941,3276348699,1672610035,1672610673,638
3508,3824215187,3977148669,1672679927,1672681041,1114
3645,3410538749,3271454397,1672605930,1672607236,1306
3901,3772078494,3201800997,1672604074,1672606300,2226
3870,3714185969,3661583097,1672535589,1672535779,190
3676,3776831527,3468041839,1672614982,1672616806,1824
3632,3283492940,3394297564,1672554802,1672556936,2134
3657,3760362417,3236354255,1672667417,1672668379,962
3483,3393063657,3826238375,1672572091,1672572653,562
3862,3979802715,3285204083,1672695477,1672696555,1078
3527,3520416075,3777779869,1672579596,1672579818,222
3616,3519909393,3974674109,1672586341,1672586922,581
3886,3492546679,3512958459,1672678281,1672678628,347
3713,3779301501,3661583097,1672572244,1672575829,3585
3879,3773332082,3515525630,1672585377,1672588580,3203
3575,3512830734,3311098437,1672683004,1672684187,1183
3811,3511791953,3392520516,1672660776,1672661865,1089
3533,3559458968,3757318448,1672638040,1672640554,2514
3545,3880926355,3710735406,1672531906,1672532057,151
3571,3669146016,3803389195,1672643172,1672646173,3001
3899,3493017654,3760263530,1672543467,1672544171,704
3762,3480726047,3280268483,1672668502,1672669761,1259
3917,3626499450,3517887477,1672663112,1672666513,3401
3684,3885121158,3334951866,1672694729,1672696903,2174
3598,3554825448,3505266860,1672630930,1672633127,2197
3456,3615939504,3516513251,1672626619,1672628502,1883
3688,3510818674,3618489670,1672558729,1672560418,1689
3921,3791106564,3509366311,1672574282,1672575561,1279
3842,3438489358,3478114114,1672693568,1672695043,1475
3557,3783771827,3779613523,1672595773,1672599080,3307
3917,3334974375,3701823816,1672662902,1672663501,599
3895,3711919537,3463849738,1672696818,1672698964,2146
3605,3519077659,3512282789,1672583386,1672584850,1464
3784,3396726504,3276269264,1672573217,1672574910,1693
3809,3310039260,3276003502,1672600659,1672603492,2833
3738,3304155815,3440137407,1672565687,1672566720,1033
3785,3736231757,3793583656,1672561631,1672564980,3349
3656,3779639983,3636329663,1672573707,1672575644,1937
3440,3783147088,3429943738,1672696600,1672699070,2470
3741,3933894942,3617304541,1672693666,1672695879,2213
3531,3609881958,3390660440,1672563476,1672566165,2689
3801,3757323954,3774876004,1672615347,1672616658,1311
3598,3240994288,3667427125,1672547234,1672549827,2593
3922,3333403880,3912891315,1672600098,1672601407,1309
3428,3773121782,3245232284,1672676750,1672678369,1619
3633,3834631333,3617489344,1672639767,1672641862,2095
3516,3852686295,3618697021,1672543372,1672543542,170
3739,3793935736,3774031303,1672573643,1672573779,136
3882,3912891315,3756746867,1672678179,1672678681,502
3626,3372223551,3774178201,1672658518,1672660860,2342
3442,3621461051,3661903000,1672681391,1672682377,986
3695,3556969573,3899786664,1672621954,1672622525,571
3747,3298151889,3632814465,1672572360,1672574721,2361
3626,3773939399,3447514821,1672641487,1672641568,81
3866,3401940259,3510028805,1672644608,1672647146,2538
3730,3510964997,3500915908,1672542578,1672544381,1803
3741,3534179433,3715086894,1672679615,1672681744,2129
3560,3777184389,3435167810,1672701988,1672703393,1405
3717,3374183227,3401793306,1672538314,1672541375,3061
3620,3710562338,3412006598,1672580333,1672582102,1769
3606,3300979975,3800257590,1672613166,1672615589,2423
3625,3921648519,3364378127,1672573044,1672575154,2110
3709,3500777439,3500672156,1672588549,1672589246,697
3598,3735374579,3815250107,1672536218,1672539377,3159
3679,3713589994,3516298579,1672611634,1672612351,717
3800,3793315718,3505283390,1672587972,1672588752,780
3728,3470454332,3516903528,1672567380,1672569848,2468
3668,3814677862,3390660440,1672643668,1672645045,1377
3691,3516741440,3779613523,1672687873,1672690209,2336
3652,3200308999,3926643445,1672649003,1672651582,2579
3870,3615113018,3534179433,1672645000,1672646064,1064
3664,3230868435,3792546035,1672700031,1672701105,1074
3555,3515890966,3227799827,1672606735,1672608711,1976
3913,3520355798,3311085279,1672576009,1672578418,2409
3788,3716963089,3779656423,1672559906,1672560994,1088
3808,3615939504,3501384020,1672664571,1672664888,317
3663,3778926763,3739911441,1672563415,1672564786,1371
3627,3517462308,3931627862,1672566881,1672567803,922
3828,3852686295,3360813161,1672585966,1672589178,3212
3540,3311098437,3611055563,1672577795,1672578487,692
3451,3516903528,3500604680,1672613786,1672614818,1032
3718,3495911207,3777814504,1672676123,1672676642,519
3653,3778134418,3360813161,1672573022,1672575051,2029
3492,3772391882,3824641227,1672668228,1672669349,1121
3550,3685681577,3500604680,1672647777,1672649199,1422
3780,3500777439,3244004456,1672546548,1672549796,3248
3828,3739911441,3294703680,1672639729,1672641503,1774
3912,3511732493,3232208416,1672575729,1672577294,1565
3599,3755532873,3714233826,1672630173,1672631781,1608
3428,3449639012,3421385957,1672653260,1672654874,1614
3778,3513345163,3938389661,1672599017,1672601953,2936
3861,3200308999,3518561777,1672646572,1672646841,269
3763,3610870949,3518229776,1672535177,1672535395,218
3465,3513360004,3201629017,1672555958,1672558325,2367
3768,3436025562,3783919913,1672571622,1672573807,2185
3587,3333918941,3755230952,1672665399,1672667483,2084
3480,3480991549,3613581796,1672573429,1672576765,3336
3556,3512800570,3418448389,1672629755,1672632223,2468
3716,3500347447,3512383699,1672537603,1672539985,2382
3459,3778134418,3755756564,1672647363,1672647953,590
3584,3367111751,3887243870,1672591392,1672594740,3348
3914,3501459390,3431460073,1672638459,1672639259,800
3455,3619922891,3664943873,1672615228,1672618021,2793
3528,3519087371,3414049538,1672675536,1672676111,575
3652,3900945856,3511150845,1672605833,1672608619,2786
3532,3622357348,3520764926,1672572101,1672574848,2747
3513,3400763927,3440137407,1672620468,1672623206,2738
3774,3206837348,3780115155,1672699908,1672702708,2800
3588,3457960571,3441703884,1672690845,1672692412,1567
3481,3760694096,3457620713,1672531350,1672534524,3174
3578,3609933747,3739154408,1672656380,1672657200,820
3858,3276217799,3716963089,1672695343,1672696410,1067
3476,3493017654,3770236215,1672682171,1672685178,3007
3460,3519142371,3516321888,1672578191,1672581625,3434
3577,3510187271,3617392620,1672535200,1672537951,2751
3918,3780253901,3714185969,1672602313,1672605573,3260
3535,3517697722,3336627643,1672564538,1672567317,2779
3765,3714678331,3621683102,1672594000,1672597027,3027
3495,3315703693,3414275042,1672534119,1672536121,2002
3826,3514285803,3517697722,1672626232,1672626692,460
3459,3780680950,3760364383,1672573300,1672574543,1243
3720,3246370118,3363162590,1672645187,1672647390,2203
3715,3773837847,3900945856,1672597380,1672598237,857
3830,3778597171,3760721303,1672655035,1672657234,2199
3569,3755404116,3279473441,1672560244,1672560615,371
3431,3711853996,3492959689,1672535597,1672537787,2190
3724,3756704774,3516321888,1672598357,1672601262,2905
3835,3760362417,3360069849,1672594395,1672594535,140
3455,3455018347,3617304541,1672668054,1672669000,946
3632,3713829743,3793868716,1672675352,1672676837,1485
3646,3512379024,3513295938,1672595316,1672598540,3224
3809,3288224595,3534566651,1672621519,1672624023,2504
3892,3812369928,3533079336,1672556103,1672557321,1218
3444,3516321888,3772078494,1672677187,1672678374,1187
3784,3505437712,3416987084,1672699100,1672700301,1201
3648,3501384020,3770438122,1672581451,1672584233,2782
3767,3500703304,3773009828,1672593197,1672593849,652
3774,3206837348,3279473441,1672555061,1672555129,68
3618,3500442734,3783550022,1672639926,1672640269,343
3462,3792442597,3505923418,1672625127,1672626999,1872
3461,3780872464,3921648519,1672542119,1672545707,3588
3766,3312998540,3241790910,1672545319,1672546749,1430
3590,3833217041,3935399379,1672678252,1672678508,256
3887,3905899155,3510187271,1672665627,1672667396,1769
3560,3505179890,3905196766,1672575665,1672577194,1529
3491,3661447322,3533368789,1672698615,1672699619,1004
3431,3979802715,3487875183,1672702113,1672702673,560
3431,3777147510,3757294769,1672664691,1672668025,3334
3730,3619922891,3520991398,1672628301,1672628832,531
3910,3500525825,3509366311,1672613375,1672614070,695
3811,3898314440,3780338697,1672678589,1672682078,3489
3492,3755756564,3510554314,1672616029,1672616772,743
3603,3516513251,3739895284,1672625803,1672629021,3218
3699,3513545422,3500302272,1672684183,1672686953,2770
3572,3505923418,3777694660,1672554372,1672554885,513
3784,3505198734,3773121782,1672585021,1672587498,2477
3799,3236458894,3631479562,1672569791,1672572120,2329
3566,3757903168,3900945856,1672647246,1672648812,1566
3575,3773033649,3401793306,1672533983,1672535399,1416
3566,3513041785,3517687662,1672653079,1672656540,3461
3670,3347446226,3478114114,1672647413,1672650050,2637
3891,3517462308,3760362417,1672554547,1672556922,2375
3788,3780472203,3368283077,1672667649,1672668999,1350
3891,3915162005,3711734586,1672692609,1672695254,2645
3679,3533004959,3410538749,1672594588,1672594736,148
3656,3630353876,3491684096,1672540109,1672540879,770
3916,3517222913,3618176292,1672703790,1672706252,2462
3495,3715974659,3312998540,1672568015,1672571279,3264
3910,3500777439,3410538749,1672593779,1672594754,975
3715,3912891315,3713589994,1672638333,1672641042,2709
3509,3514285803,3791046864,1672645454,1672649023,3569
3723,3431460073,3472312341,1672697066,1672697631,565
3442,3513545422,3615939504,1672621327,1672622218,891
3462,3760094385,3970627281,1672693491,1672694210,719
3629,3638660068,3779738691,1672664422,1672664918,496
3643,3792538417,3373089838,1672675472,1672676877,1405
3597,3554944414,3396726504,1672639273,1672641954,2681
3847,3534543776,3776831527,1672679669,1672680342,673
3795,3776084820,3500703304,1672616917,1672619921,3004
3919,3757630221,3337362061,1672694564,1672697977,3413
3759,3306175858,3925979970,1672613043,1672614423,1380
3825,3909094917,3755496114,1672640123,1672640938,815
3721,3701884158,3780680950,1672636677,1672638047,1370
3802,3511024016,3411688875,1672531408,1672533638,2230
3624,3520873221,3777240360,1672549490,1672551157,1667
3569,3228888030,3479851674,1672649105,1672652484,3379
3427,3736231757,3480100311,1672590856,1672591003,147
3881,3892304880,3756704774,1672686644,1672690108,3464
3830,3372223551,3928511283,1672545308,1672545935,627
3557,3511005395,3899326793,1672633060,1672635993,2933
3579,3519416013,3520873221,1672632665,1672634430,1765
3681,3500777439,3618489670,1672625958,1672627815,1857
3457,3270697740,3515402792,1672631590,1672633591,2001
3894,3812369928,3638660068,1672680799,1672682253,1454
3714,3514956366,3389634034,1672675447,1672675991,544
3450,3463740710,3460719322,1672554397,1672555546,1149
3454,3778134418,3517991730,1672552286,1672553591,1305
3608,3500341755,3887243870,1672635963,1672639142,3179
3814,3793743698,3623266256,1672673548,1672674768,1220
3787,3906536154,3299443125,1672579054,1672579810,756
3683,3836241528,3792505974,1672639760,1672642487,2727
3500,3897456874,3773837847,1672696577,1672696991,414
3523,3780834916,3615115210,1672682348,1672685456,3108
3919,3382733096,3478114114,1672624886,1672625824,938
3504,3515401243,3835422146,1672595948,1672596735,787
3520,3739154408,3772236797,1672567469,1672569653,2184
3798,3618697021,3757075324,1672612498,1672615280,2782
3536,3517881647,3451691949,1672698314,1672699793,1479
3490,3732584121,3462636434,1672608027,1672611409,3382
3578,3330340793,3341893384,1672683706,1672686114,2408
3767,3338390596,3400763927,1672675858,1672676583,725
3530,3826238375,3384068080,1672608579,1672611797,3218
3659,3357864626,3773902805,1672544186,1672544424,238
3786,3609881958,3500317969,1672618850,1672620436,1586
3911,3617392620,3379143440,1672684636,1672686973,2337
3434,3791693821,3685816610,1672679513,1672682222,2709
3631,3817428320,3499217428,1672607826,1672610483,2657
3595,3885157459,3230868435,1672597714,1672599167,1453
3859,3923754072,3511024016,1672552582,1672555147,2565
3618,3208957949,3513296868,1672628194,1672628779,585
3840,3372223551,3414049538,1672617561,1672617764,203
3856,3770296583,3757323954,1672594397,1672597984,3587
3900,3703139663,3520416075,1672694574,1672694654,80
3643,3716272919,3711919537,1672615913,1672618474,2561
3594,3373028638,3779656423,1672668030,1672671219,3189
3793,3294703680,3338390596,1672576798,1672577543,745
3868,3891672228,3625463628,1672696744,1672699044,2300
3868,3514956366,3920497528,1672621767,1672623993,2226
3457,3514308235,3756127300,1672622879,1672623899,1020
3434,3855583256,3792274796,1672532855,1672533024,169
3547,3778926763,3492959689,1672549435,1672549702,267
3707,3511317276,3631479562,1672655892,1672657322,1430
3631,3520355798,3435167810,1672589320,1672592782,3462
3821,3517172354,3739661856,1672665138,1672668087,2949
3425,3520416075,3491469603,1672543117,1672546149,3032
3693,3792546035,3703396825,1672548518,1672551988,3470
3724,3615087943,3518565331,1672535431,1672537809,2378
3501,3392836218,3613581796,1672655706,1672658076,2370
3753,3618354185,3613581796,1672649507,1672651443,1936
3603,3622665543,3811040565,1672565672,1672568014,2342
3738,3891672228,3792801638,1672695957,1672696978,1021
3744,3271752081,3793418209,1672576801,1672579778,2977
3804,3760640999,3780209375,1672690872,1672692540,1668
3531,3516489668,3500827202,1672537316,1672538555,1239
3689,3793407963,3403370192,1672693048,1672695270,2222
3806,3201676087,3457960571,1672546164,1672549305,3141
3572,3518653080,3685681577,1672660246,1672662175,1929
3770,3350095157,3519909393,1672703366,1672703651,285
3895,3501281016,3884596900,1672568950,1672570247,1297
3823,3375449013,3825881598,1672650506,1672652592,2086
3574,3972083617,3500777439,1672612711,1672613385,674
3516,3619922891,3632814465,1672550690,1672553008,2318
3898,3777814504,3534126409,1672582765,1672584736,1971
3635,3351866415,3715127070,1672681478,1672682613,1135
3539,3669146016,3755344363,1672624551,1672625020,469
3794,3514334067,3517358573,1672682177,1672682695,518
3790,3970198861,3684523966,1672630380,1672632045,1665
3892,3337322736,3244004456,1672678060,1672679854,1794
3857,3638204468,3669146016,1672592960,1672595692,2732
3562,3513081354,3305336154,1672532569,1672534752,2183
3900,3202804048,3620292035,1672567713,1672569762,2049
3527,3519416013,3520578796,1672573057,1672574483,1426
3587,3279242917,3479851674,1672643562,1672646441,2879
3715,3856606678,3779892400,1672638566,1672638785,219
3698,3627368399,3974674109,1672559531,1672561764,2233
3488,3899786664,3440107959,1672640506,1672640886,380
3447,3501215099,3793883863,1672566182,1672568687,2505
3499,3241790910,3923420131,1672620865,1672623804,2939
3537,3793935736,3376467719,1672647366,1672650479,3113
3558,3760364383,3773124276,1672569998,1672570885,887
3874,3613338363,3383138270,1672601040,1672604635,3595
3917,3514956366,3495911207,1672682481,1672683174,693
3901,3774641380,3819767045,1672571676,1672573888,2212
3657,3510798825,3902760230,1672550316,1672553245,2929
3533,3783136330,3299125059,1672610658,1672611024,366
3646,3731646673,3760721303,1672579481,1672579955,474
3865,3402385957,3777091903,1672622616,1672623876,1260
3739,3859868849,3497095254,1672543670,1672545533,1863
3572,3336627643,3246370118,1672599492,1672601096,1604
3634,3933894942,3632814465,1672582211,1672583179,968
3798,3791796585,3552824113,1672653729,1672655839,2110
3461,3505178849,3308760650,1672670511,1672670967,456
3567,3884596900,3600876425,1672647880,1672648574,694
3851,3780571086,3510641433,1672578729,1672581903,3174
3458,3497095254,3780209375,1672570550,1672573925,3375
3800,3975717896,3514741348,1672702176,1672703380,1204
3541,3226511603,3291933594,1672624417,1672627923,3506
3554,3711218296,3899326793,1672639260,1672642633,3373
3768,3711218296,3680810086,1672594145,1672596682,2537
3513,3890739241,3509893027,1672646751,1672647398,647
3915,3448875382,3885155975,1672602624,1672603671,1047
3698,3630353876,3757700712,1672638073,1672640196,2123
3651,3513853403,3793922324,1672537194,1672538372,1178
3466,3778597171,3417679834,1672544904,1672547035,2131
3734,3285204083,3793935736,1672614978,1672615915,937
3564,3417679834,3500672156,1672624689,1672628233,3544
3702,3776988674,3619922891,1672606191,1672609174,2983
3640,3472312341,3285204083,1672676185,1672676630,445
3645,3777184389,3970627281,1672587232,1672588584,1352
3866,3347446226,3500044458,1672629080,1672632189,3109
3589,3354144091,3279475486,1672594044,1672597172,3128
3552,3400069268,3516444201,1672693547,1672696374,2827
3557,3772078494,3661447322,1672584770,1672588144,3374
3450,3923420131,3770676872,1672671013,1672674351,3338
3469,3755573472,3711077927,1672631472,1672634980,3508
3809,3519416013,3298151889,1672595934,1672596920,986
3622,3505923418,3384068080,1672550397,1672552624,2227
3719,3411688875,3783641602,1672548312,1672549912,1600
3903,3304971369,3776244398,1672622616,1672624345,1729
3792,3660887799,3793315718,1672690719,1672692712,1993
3800,3518561777,3780322355,1672631838,1672633483,1645
3802,3201629017,3807212280,1672612498,1672615415,2917
3729,3905196766,3701322924,1672681757,1672683310,1553
3507,3630353876,3902760230,1672541496,1672542304,808
3636,3514246749,3296462324,1672556899,1672557062,163
3605,3443357683,3701373490,1672643224,1672645261,2037
3527,3337322736,3780472203,1672571992,1672572233,241
3917,3639050419,3367111751,1672567541,1672569514,1973
3874,3311085279,3435116799,1672540674,1672543581,2907
3526,3831586487,3512499658,1672559018,1672560147,1129
3610,3373028638,3335694356,1672585578,1672586020,442
3494,3772391882,3490214516,1672583023,1672586069,3046
3622,3970558632,3974674109,1672702699,1672703581,882
3430,3739154408,3777779869,1672596785,1672596943,158
3648,3386758279,3923220461,1672684187,1672685338,1151
3665,3710735406,3780872464,1672587281,1672588344,1063
3894,3625174002,3793781065,1672598948,1672599937,989
3463,3733363628,3294747828,1672692850,1672696057,3207
3531,3621683102,3760040019,1672703214,1672705087,1873
3697,3825881598,3757630221,1672680602,1672681482,880
3692,3791613604,3300979975,1672650439,1672652383,1944
3655,3305722859,3778597171,1672631169,1672634661,3492
3760,3935399379,3755737419,1672604056,1672604222,166
3759,3401793306,3713784974,1672555655,1672558060,2405
3479,3772391882,3668414677,1672645024,1672647214,2190
3740,3334993594,3779892400,1672637365,1672638797,1432
3552,3514246749,3661903000,1672556304,1672558949,2645
3483,3668747074,3755737419,1672561745,1672564461,2716
3645,3276003502,3791693821,1672616684,1672616891,207
3709,3713300120,3495911207,1672616753,1672618932,2179
3601,3811075491,3615737355,1672611848,1672614755,2907
3499,3401793306,3236354255,1672664287,1672664893,606
3492,3777814504,3760651515,1672596136,1672599177,3041
3513,3370227921,3520873221,1672597774,1672600510,2736
3589,3793935736,3366423342,1672586624,1672587025,401
3471,3755158925,3774031303,1672596633,1672597300,667
3738,3472068734,3793868716,1672694252,1672696093,1841
3647,3303410628,3600876425,1672607764,1672610481,2717
3792,3778640261,3927599181,1672615727,1672616431,704
3882,3225631197,3770468980,1672606841,1672609662,2821
3546,3354144091,3904867554,1672634746,1672634955,209
3478,3904569677,3714185969,1672549832,1672550960,1128
3636,3363162590,3292147449,1672544490,1672547202,2712
3826,3520657891,3618489670,1672626875,1672629440,2565
3867,3604589802,3688796737,1672646606,1672647605,999
3479,3715986185,3615737355,1672649241,1672650792,1551
3631,3417191856,3760924079,1672691871,1672692574,703
3867,3777330107,3492546679,1672590434,1672592211,1777
3532,3401940259,3357689359,1672620969,1672623599,2630
3616,3793740407,3519087371,1672653192,1672655217,2025
3734,3512383699,3500915908,1672626867,1672628453,1586
3539,3472312341,3450286949,1672677471,1672680546,3075
3752,3760721303,3776244398,1672601817,1672604037,2220
3504,3512392431,3490029863,1672661043,1672661187,144
3593,3755222916,3793883863,1672656296,1672658266,1970
3495,3516298579,3783169442,1672688042,1672689347,1305
3555,3897456874,3373028638,1672546529,1672549388,2859
3818,3909094917,3510964997,1672627498,1672630178,2680
3535,3713589994,3935399379,1672642450,1672644861,2411
3717,3791106564,3341893384,1672561587,1672563375,1788
3602,3375449013,3777814504,1672538226,1672538884,658
3659,3517590837,3807212280,1672609316,1672609434,118
3523,3347419520,3362641275,1672568148,1672571123,2975
3802,3773009828,3792505974,1672662437,1672664975,2538
3488,3715974659,3701247948,1672690728,1672691368,640
3597,3449639012,3441703884,1672543086,1672544776,1690
3836,3515559913,3505521218,1672653659,1672653978,319
3872,3401496246,3613581796,1672543419,1672546796,3377
3577,3680810086,3715707380,1672657080,1672658016,936
3510,3668533536,3408498208,1672596901,1672599788,2887
3469,3306175858,3783169442,1672611214,1672613186,1972
3570,3510028805,3615939504,1672554316,1672556897,2581
3528,3431502855,3773124276,1672631057,1672633291,2234
3561,3892304880,3892304880,1672667395,1672669599,2204
3649,3370227921,3701322924,1672689925,1672692907,2982
3805,3757348722,3276269264,1672578299,1672580677,2378
3786,3514971533,3488686442,1672679902,1672682233,2331
3533,3534175249,3534543776,1672625078,1672626685,1607
3732,3206837348,3834963772,1672656437,1672659521,3084
3493,3617392620,3608922867,1672694619,1672696974,2355
3872,3715986185,3938503547,1672544844,1672546593,1749
3872,3367111751,3429943738,1672608628,1672608814,186
3622,3514512367,3710735406,1672655838,1672657296,1458
3787,3638204468,3686523546,1672636094,1672639092,2998
3713,3516321888,3334974375,1672567595,1672569632,2037
3662,3715707380,3305722859,1672699847,1672701160,1313
3734,3824215187,3513018485,1672599644,1672602651,3007
3780,3915162005,3448875382,1672659912,1672663339,3427
3820,3501525100,3481640525,1672604072,1672607090,3018
3751,3756704774,3713784974,1672548295,1672549080,785
3870,3488763230,3773837847,1672581867,1672583451,1584
3870,3715443333,3737972328,1672583286,1672585361,2075
3725,3439673892,3513296868,1672679242,1672682128,2886
3753,3925979970,3389634034,1672593921,1672595741,1820
3599,3505634634,3617392620,1672623383,1672626591,3208
3752,3509366311,3893912331,1672636844,1672639547,2703
3661,3472068734,3505995057,1672652278,1672653372,1094
3551,3411515369,3500302272,1672620239,1672623592,3353
3585,3617116290,3459681410,1672652336,1672652577,241
3625,3518653080,3898314440,1672646407,1672647112,705
3861,3431502855,3923220461,1672635277,1672638366,3089
3697,3736705719,3821054646,1672564401,1672566608,2207
3684,3814305099,3776988674,1672698103,1672699264,1161
3857,3811075491,3417191856,1672650352,1672653580,3228
3882,3701247948,3488686442,1672537419,1672538369,950
3686,3399472693,3774733620,1672689448,1672689583,135
3903,3300511067,3779532653,1672634397,1672637450,3053
3607,3755992176,3514741348,1672556646,1672558543,1897
3646,3449333754,3395201292,1672567363,1672570781,3418
3903,3622665543,3902625986,1672548460,1672548703,243
3884,3770624662,3772078494,1672666181,1672667058,877
3601,3510919821,3803389195,1672542072,1672544239,2167
3426,3680843171,3925979970,1672606655,1672608155,1500
3681,3276348699,3613581796,1672697843,1672699744,1901
3565,3206837348,3441703884,1672562250,1672564555,2305
3501,3343816795,3404025196,1672695799,1672697108,1309
3733,3812534508,3819767045,1672660656,1672661685,1029
3589,3283492940,3770468980,1672570180,1672573653,3473
3427,3667673649,3776559988,1672577776,1672580775,2999
3616,3363162590,3839245934,1672583316,1672584097,781
3588,3367971170,3273981374,1672593008,1672593736,728
3872,3773735484,3515402792,1672698348,1672700933,2585
3442,3905899155,3779639983,1672588503,1672591689,3186
3682,3779892400,3335694356,1672665397,1672666458,1061
3720,3462273042,3711097754,1672587213,1672589135,1922
3859,3808136029,3664943873,1672605846,1672606613,767
3772,3885121158,3500442734,1672673453,1672674980,1527
3712,3514971533,3760645796,1672573545,1672574842,1297
3829,3755848152,3357289672,1672559220,1672560124,904
3792,3783340788,3732131656,1672647327,1672647613,286
3468,3519416013,3772236797,1672585997,1672586941,944
3648,3517590837,3520115090,1672587900,1672588781,881
3486,3316800320,3533228966,1672620550,1672624041,3491
3583,3300511067,3608232640,1672610645,1672613680,3035
3801,3394401087,3808136029,1672596459,1672597206,747
3588,3515559913,3451691949,1672607657,1672608045,388
3453,3834960360,3814677862,1672587920,1672589774,1854
3609,3792949946,3520322124,1672552013,1672553313,1300
3495,3909094917,3533747868,1672688974,1672691069,2095
3608,3513296868,3856606678,1672671835,1672673343,1508
3683,3512499658,3756789525,1672669385,1672671097,1712
3899,3812534508,3520578796,1672688359,1672691849,3490
3643,3517172354,3505283390,1672688625,1672689443,818
3633,3367971170,3778640261,1672631165,1672634089,2924
3804,3760694096,3615737355,1672570921,1672572144,1223
3812,3661903000,3885121158,1672613330,1672614680,1350
3672,3516903528,3755756564,1672652113,1672653851,1738
3528,3451726367,3510798825,1672561965,1672563798,1833
3521,3710854064,3777694660,1672653660,1672653742,82
3910,3774243020,3757348722,1672567860,1672569357,1497
3553,3441703884,3613899351,1672661641,1672664487,2846
3911,3271454397,3510767239,1672538860,1672540179,1319
3583,3468041839,3783615982,1672594245,1672594760,515
3814,3909094917,3755532873,1672570172,1672572924,2752
3446,3608922867,3605221116,1672550569,1672554133,3564
3494,3685681577,3711218296,1672590191,1672593381,3190
3600,3783615982,3778040015,1672605123,1672606778,1655
3703,3627368399,3469254160,1672669329,1672671792,2463
3626,3686227677,3554825448,1672584489,1672584783,294
3614,3715545685,3431460073,1672669956,1672671981,2025
3734,3512499658,3923220461,1672694022,1672695953,1931
3804,3779656423,3760651515,1672542880,1672542964,84
3872,3935913584,3730071479,1672596723,1672598509,1786
3572,3738026330,3710496785,1672703639,1672704572,933
3884,3613581796,3448875382,1672637344,1672638844,1500
3738,3347446226,3333918941,1672595439,1672598386,2947
3603,3774718695,3557046880,1672536205,1672539592,3387
3735,3779892400,3897376951,1672645073,1672648638,3565
3567,3554944414,3534543776,1672676296,1672678732,2436
3755,3779301501,3780571086,1672538360,1672539996,1636
3451,3500737582,3930242012,1672589464,1672590661,1197
3656,3520115090,3276217799,1672701878,1672703116,1238
3656,3783928182,3518565331,1672632478,1672634073,1595
3835,3209481722,3605221116,1672666195,1672666740,545
3498,3792525861,3714678331,1672699388,1672700385,997
3888,3793922324,3609881958,1672609792,1672609903,111
3487,3293835352,3514275974,1672652725,1672653208,483
3760,3774290799,3418448389,1672641132,1672642222,1090
3847,3209481722,3780472203,1672568847,1672569179,332
3574,3777624586,3367111751,1672663044,1672666325,3281
3842,3343132529,3773837847,1672612787,1672614244,1457
3839,3270697740,3408430195,1672598187,1672600085,1898
3710,3516903528,3276217799,1672666514,1672669619,3105
3670,3792745809,3500915908,1672650915,1672651861,946
3666,3777147510,3512282789,1672537650,1672539552,1902
3467,3735374579,3436025562,1672629767,1672632378,2611
3846,3756127300,3533423872,1672664354,1672664697,343
3431,3770704999,3517697722,1672601453,1672603813,2360
3826,3451691949,3716110860,1672700812,1672701945,1133
3823,3200308999,3402385957,1672692767,1672692831,64
3439,3224968597,3500525825,1672572532,1672575532,3000
3680,3713979100,3534179433,1672639740,1672640892,1152
3895,3783928182,3689697817,1672696394,1672696509,115
3611,3501459390,3755158925,1672603332,1672604227,895
3486,3625174002,3304155815,1672535536,1672538198,2662
3719,3272030610,3411515369,1672589594,1672592729,3135
3544,3495911207,3500525825,1672584115,1672584706,591
3845,3514971533,3618176292,1672577057,1672577924,867
3468,3513041785,3760842815,1672550673,1672553351,2678
3612,3617489344,3509483172,1672683337,1672684347,1010
3736,3369708250,3777779869,1672688964,1672692188,3224
3803,3510837901,3443357683,1672670732,1672674216,3484
3755,3500341755,3454277788,1672691050,1672692946,1896
3655,3511601997,3739154408,1672675012,1672675846,834
3513,3512882178,3711218296,1672568624,1672569691,1067
3613,3306175858,3512499658,1672570508,1672573706,3198
3559,3935913584,3372223551,1672577565,1672579530,1965
3478,3853629553,3311098437,1672588218,1672591251,3033
3837,3226511603,3792525861,1672625913,1672628896,2983
3650,3505847380,3618697021,1672555883,1672559277,3394
3851,3417679834,3755573472,1672615322,1672618541,3219
3669,3495911207,3228888030,1672575057,1672577119,2062
3537,3206837348,3977352557,1672668759,1672669982,1223
3872,3511843593,3431502855,1672686088,1672689279,3191
3751,3366423342,3971806004,1672548139,1672551055,2916
3573,3306412634,3551376095,1672670816,1672673011,2195
3537,3893912331,3533649454,1672574197,1672576808,2611
3810,3512383699,3906536154,1672663971,1672666411,2440
3483,3668414677,3906536154,1672696427,1672697340,913
3610,3360616538,3513065217,1672591476,1672593398,1922
3573,3736231757,3774605761,1672678522,1672679682,1160
3683,3703396825,3609933747,1672559428,1672562070,2642
3737,3701136026,3779425804,1672537219,1672538543,1324
3655,3276348699,3511005395,1672570004,1672573593,3589
3579,3505434346,3669146016,1672696955,1672697101,146
3751,3710496785,3375449013,1672628350,1672629632,1282
3706,3793740407,3519416013,1672638110,1672641286,3176
3620,3404025196,3393063657,1672631772,1672633873,2101
3490,3512499658,3447672935,1672663382,1672663854,472
3696,3817428320,3236354255,1672593140,1672596290,3150
3647,3411515369,3410160376,1672560100,1672562350,2250
3564,3341893384,3621790707,1672607796,1672609285,1489
3629,3270056120,3892304880,1672561738,1672563892,2154
3502,3333918941,3428725843,1672679290,1672681408,2118
3882,3778134418,3383138270,1672558204,1672559378,1174
3556,3380982774,3491684096,1672675731,1672675839,108
3679,3701247948,3205985903,1672653272,1672654576,1304
3903,3490029863,3773572967,1672614059,1672614620,561
3566,3551376095,3347419520,1672542818,1672543339,521
3906,3557046880,3714128600,1672693389,1672696537,3148
3843,3792020993,3513545422,1672683955,1672686265,2310
3872,3661447322,3773913680,1672581209,1672582732,1523
3919,3783801141,3774178201,1672602799,1672602884,85
3548,3792801638,3402697190,1672546375,1672547490,1115
3631,3517991730,3519651506,1672551375,1672553632,2257
3548,3533228966,3454277788,1672703898,1672704323,425
3620,3773124276,3274906650,1672555807,1672558527,2720
3626,3770520359,3501121099,1672620743,1672623600,2857
3435,3276269264,3512800570,1672632009,1672634180,2171
3466,3710562338,3208957949,1672622385,1672622718,333
3842,3469254160,3774155692,1672613166,1672614344,1178
3643,3500613459,3520560590,1672537778,1672538104,326
3681,3825881598,3450286949,1672702984,1672704166,1182
3706,3909094917,3241914067,1672573479,1672576080,2601
3724,3780115155,3688220326,1672702195,1672704184,1989
3838,3284947372,3230135532,1672675089,1672676600,1511
3590,3512958459,3441348818,1672668838,1672672174,3336
3520,3713829743,3755915206,1672570249,1672573275,3026
3747,3289817992,3713784974,1672627530,1672627943,413
3710,3500317969,3710315160,1672557740,1672559445,1705
3827,3792546035,3220031931,1672592067,1672592344,277
3548,3701107228,3774907131,1672627390,1672628332,942
3468,3774641380,3625174002,1672572848,1672573442,594
3679,3914691363,3368283077,1672618114,1672621036,2922
3556,3970198861,3920898925,1672546097,1672547322,1225
3544,3779425804,3899326793,1672685463,1672688300,2837
3432,3819767045,3615688740,1672534989,1672538415,3426
3738,3299443125,3478114114,1672644228,1672647009,2781
3753,3889780657,3909094917,1672536868,1672540225,3357
3702,3202141727,3512383699,1672610442,1672613292,2850
3478,3612689556,3293835352,1672540996,1672542646,1650
3629,3224811762,3367111751,1672629009,1672632289,3280
3870,3505198734,3436257398,1672647412,1672649632,2220
3863,3778640261,3283770991,1672562376,1672565792,3416
3569,3475349791,3501457103,1672577516,1672580383,2867
3894,3515525630,3779656423,1672640685,1672641512,827
3491,3517991730,3715707380,1672606017,1672606346,329
3475,3935913584,3424445495,1672582387,1672583737,1350
3707,3514285803,3897134762,1672635991,1672639455,3464
3852,3834631333,3311098437,1672672523,1672675505,2982
3751,3500949309,3500841914,1672558978,1672561035,2057
3615,3701005527,3834631333,1672678899,1672680450,1551
3654,3615688740,3510919821,1672687162,1672688086,924
3644,3897134762,3511442562,1672694128,1672697712,3584
3603,3755222916,3770520359,1672616008,1672616852,844
3896,3755992176,3701664364,1672619483,1672619701,218
3543,3380982774,3291933594,1672633883,1672636203,2320
3641,3519850727,3306175858,1672626380,1672629866,3486
3464,3755532873,3516903528,1672559052,1672560810,1758
3471,3615113018,3755992176,1672660618,1672663824,3206
3589,3927165965,3793922324,1672584707,1672586335,1628
3625,3760094385,3713941638,1672679997,1672683435,3438
3599,3512800570,3859868849,1672684276,1672686957,2681
3570,3517697722,3311049964,1672588322,1672588936,614
3825,3480726047,3276217799,1672664987,1672668408,3421
3594,3714067076,3338390596,1672533795,1672534708,913
3547,3779892400,3638660068,1672538182,1672540087,1905
3788,3630353876,3639050419,1672631103,1672632076,973
3692,3385323994,3778640261,1672681452,1672684893,3441
3671,3619922891,3925979970,1672621675,1672623326,1651
3801,3308760650,3451691949,1672570259,1672573313,3054
3788,3793315718,3710048469,1672703783,1672705597,1814
3674,3760924079,3669146016,1672692785,1672696239,3454
3666,3334951866,3431502855,1672600965,1672604507,3542
3816,3773735484,3402385957,1672600071,1672603569,3498
3615,3688796737,3688796737,1672684389,1672686291,1902
3741,3520560590,3493017654,1672667153,1672668369,1216
3512,3791106564,3554944414,1672581942,1672582830,888
3762,3311085279,3315279093,1672586723,1672589550,2827
3735,3514741348,3319167958,1672572327,1672574632,2305
3605,3826238375,3311098437,1672588376,1672589115,739
3575,3279339278,3792801638,1672631772,1672634494,2722
3793,3792489602,3935913584,1672570677,1672570925,248
3876,3714827719,3399518841,1672600077,1672603353,3276
3429,3780909839,3505481368,1672636030,1672637796,1766
3616,3401940259,3739911441,1672683510,1672684074,564
3609,3341893384,3791246640,1672613119,1672615964,2845
3510,3774155692,3485540729,1672650393,1672652294,1901
3810,3305336154,3793935736,1672682257,1672685466,3209
3458,3517288083,3701136026,1672536396,1672539192,2796
3817,3279242917,3715545685,1672631366,1672632037,671
3511,3500208903,3337322736,1672543002,1672544711,1709
3568,3780872464,3203538212,1672652141,1672655374,3233
3632,3517462308,3334993594,1672633041,1672634288,1247
3768,3412006598,3716272919,1672567757,1672568578,821
3658,3488686442,3779786641,1672540706,1672543784,3078
3711,3774641380,3330340793,1672557510,1672558531,1021
3518,3793583656,3447672935,1672687378,1672688301,923
3458,3513296868,3621790707,1672600821,1672603742,2921
3487,3770520359,3499217428,1672624508,1672627887,3379
3885,3792442597,3760040019,1672615910,1672617336,1426
3700,3615737355,3818575661,1672588200,1672589428,1228
3634,3770520359,3367111751,1672698093,1672701261,3168
3581,3701005527,3756127300,1672653382,1672654447,1065
3837,3488686442,3792745809,1672545221,1672547538,2317
3711,3715127070,3731646673,1672622165,1672624978,2813
3880,3834960360,3885121158,1672703418,1672705367,1949
3880,3501281016,3501215099,1672673847,1672677303,3456
3647,3455018347,3551376095,1672609563,1672610695,1132
3573,3435167810,3468041839,1672533414,1672533687,273
3701,3490029863,3783136330,1672576494,1672577901,1407
3749,3774705415,3519909393,1672702781,1672705041,2260
3583,3511601997,3512502036,1672605508,1672607797,2289
3735,3303410628,3350095157,1672589746,1672590307,561
3547,3451726367,3669146016,1672578375,1672580111,1736
3800,3770468980,3714067076,1672643506,1672644657,1151
3661,3410600350,3773033649,1672548040,1672551122,3082
3552,3711000597,3516903528,1672648490,1672651834,3344
3538,3500827202,3615688740,1672615197,1672616006,809
3808,3793969543,3500044458,1672669242,1672671050,1808
3571,3772391882,3770236215,1672652352,1672652985,633
3745,3824641227,3533090502,1672585317,1672588869,3552
3527,3201629017,3701823816,1672586509,1672589104,2595
3446,3777624586,3304971369,1672560767,1672561530,763
3773,3780115155,3311098437,1672619518,1672620265,747
3629,3500208903,3793935736,1672686653,1672689860,3207
3554,3791796585,3783169442,1672671196,1672671771,575
3832,3773027597,3715619259,1672535941,1672537105,1164
3536,3773009828,3755756564,1672617617,1672618027,410
3670,3515402792,3436257398,1672544452,1672546496,2044
3607,3500703304,3793740407,1672655268,1672657918,2650
3470,3362641275,3605221116,1672685108,1672685829,721
3588,3773332082,3713911104,1672661706,1672662727,1021
3830,3399472693,3509756823,1672551050,1672551590,540
3773,3424660806,3412968120,1672593385,1672595709,2324
3819,3515525630,3366423342,1672606108,1672606826,718
3430,3227799827,3500442734,1672667881,1672671170,3289
3822,3225029895,3300818269,1672682873,1672685555,2682
3872,3520560590,3468041839,1672555378,1672558404,3026
3644,3414940786,3510767239,1672647699,1672648968,1269
3510,3520181148,3491684096,1672534776,1672536520,1744
3746,3533423872,3308760650,1672610111,1672613284,3173
3772,3773124276,3396980894,1672674745,1672674942,197
3491,3279475486,3520639768,1672624981,1672627824,2843
3679,3667427125,3512722110,1672562132,1672563541,1409
3690,3439673892,3829822608,1672540122,1672543276,3154
3828,3241790910,3713979100,1672590776,1672593456,2680
3432,3500703304,3770236215,1672662817,1672663755,938
3921,3756625818,3618176292,1672624897,1672626308,1411
3713,3793418209,3559731671,1672698803,1672700897,2094
3458,3463740710,3510642075,1672651204,1672653316,2112
3877,3505154885,3774718695,1672639747,1672643317,3570
3499,3834963772,3623266256,1672667578,1672669951,2373
3809,3773332082,3713691388,1672625755,1672627942,2187
3793,3732131656,3410600350,1672662462,1672664261,1799
3651,3500857494,3777485931,1672677192,1672678547,1355
3781,3703139663,3380767040,1672575279,1672577432,2153
3482,3511150845,3366423342,1672631986,1672634197,2211
3665,3336339664,3792020993,1672567957,1672571274,3317
3680,3517288083,3534126409,1672618156,1672619092,936
3787,3520115090,3202141727,1672586547,1672589274,2727
3595,3776518452,3533423872,1672601109,1672604033,2924
3468,3780909839,3285204083,1672662590,1672663588,998
3793,3514512367,3276348699,1672645865,1672647138,1273
3466,3414049538,3279339278,1672690444,1672691827,1383
3889,3774155692,3934064792,1672652565,1672654446,1881
3531,3779301501,3509483172,1672635257,1672638617,3360
3723,3335694356,3520416075,1672581617,1672584143,2526
3622,3512502036,3208452238,1672617967,1672619976,2009
3499,3826238375,3613899351,1672600830,1672603702,2872
3438,3755737419,3773009828,1672669281,1672670958,1677
3760,3517991730,3755404116,1672550661,1672551891,1230
3441,3684523966,3245232284,1672545001,1672547847,2846
3529,3793315718,3714128600,1672658643,1672658911,268
3495,3760645796,3363162590,1672577307,1672578774,1467
3499,3208452238,3791106564,1672640107,1672643081,2974
3549,3283144118,3367509761,1672633771,1672634057,286
3631,3887243870,3701247948,1672580812,1672581869,1057
3537,3773027597,3803517637,1672561336,1672561643,307
3582,3605221116,3428027649,1672617727,1672618993,1266
3513,3630353876,3770438122,1672589059,1672591806,2747
3851,3533294425,3512383699,1672580456,1672583170,2714
3438,3505634634,3897376951,1672584640,1672587658,3018
3845,3347419520,3711077927,1672618877,1672620057,1180
3755,3511883730,3770704999,1672678545,1672679880,1335
3643,3238288884,3505521218,1672668612,1672670629,2017
3465,3793883863,3395201292,1672701614,1672702225,611
3499,3239617320,3505228454,1672567717,1672571030,3313
3678,3533747868,3337322736,1672627223,1672627735,512
3428,3505266860,3713941638,1672640200,1672642661,2461
3621,3757193307,3520416075,1672564592,1672565279,687
3449,3688796737,3619922891,1672637897,1672638780,883
3900,3780909839,3770676872,1672565786,1672568413,2627
3573,3635169815,3511883730,1672595891,1672597701,1810
3709,3424445495,3511288998,1672539174,1672540351,1177
3680,3892304880,3617116290,1672627611,1672628696,1085
3893,3823084403,3512282789,1672634388,1672634490,102
3464,3900898992,3304155815,1672627721,1672627903,182
3570,3227799827,3902760230,1672633608,1672636718,3110
3695,3623266256,3928511283,1672644055,1672646787,2732
3809,3773735484,3633735593,1672661778,1672661952,174
3510,3834960360,3288762795,1672697211,1672699220,2009
3746,3341893384,3316800320,1672680061,1672682638,2577
3565,3713979100,3516513251,1672540613,1672541690,1077
3887,3279242917,3783520186,1672542613,1672543621,1008
3610,3517222913,3630353876,1672602949,1672604333,1384
3619,3456430614,3715974659,1672683909,1672684838,929
3865,3424445495,3776988674,1672621155,1672624291,3136
3771,3921648519,3779656423,1672567209,1672567556,347
3536,3510641433,3776034743,1672606218,1672608366,2148
3466,3777189898,3500208903,1672582841,1672585639,2798
3861,3791441520,3306175858,1672680984,1672683956,2972
3917,3688490530,3209481722,1672662421,1672664321,1900
3836,3512958459,3783433404,1672590902,1672591228,326
3665,3479851674,3501567772,1672674827,1672675339,512
3718,3715854030,3337322736,1672621433,1672622282,849
3597,3622665543,3519142371,1672690902,1672691874,972
3750,3469254160,3760721303,1672692647,1672694908,2261
3599,3812534508,3927599181,1672686086,1672687056,970
3640,3551376095,3772236797,1672565211,1672565295,84
3784,3714670620,3783433404,1672632193,1672635283,3090
3440,3770438122,3438078818,1672550886,1672553236,2350
3684,3711853996,3701005527,1672665798,1672667993,2195
3764,3611055563,3757383891,1672613507,1672615914,2407
3844,3273981374,3245232284,1672668643,1672669021,378
3771,3501121099,3415833929,1672614846,1672618127,3281
3919,3831586487,3627368399,1672690122,1672692081,1959
3803,3513410578,3245232284,1672644737,1672648004,3267
3603,3292147449,3468041839,1672537760,1672538300,540
3709,3533004959,3451691949,1672539000,1672541727,2727
3660,3835422146,3200308999,1672696893,1672697519,626
3744,3520873221,3760640999,1672581359,1672581807,448
3825,3514512367,3554186380,1672623089,1672624701,1612
3699,3469254160,3975717896,1672603887,1672605406,1519
3752,3516298579,3792546035,1672662591,1672665242,2651
3519,3421385957,3515559913,1672601800,1672605042,3242
3688,3792538417,3501457103,1672592413,1672594800,2387
3878,3885155975,3834963772,1672602332,1672605442,3110
3840,3613899351,3449333754,1672662483,1672663744,1261
3677,3920497528,3517358573,1672574022,1672576312,2290
3774,3334951866,3505663516,1672539713,1672542556,2843
3902,3229974066,3203538212,1672667734,1672669660,1926
3446,3734451191,3443357683,1672650727,1672653417,2690
3869,3520873221,3512502036,1672618689,1672620510,1821
3436,3852533643,3934064792,1672666228,1672668879,2651
3595,3513345163,3611055563,1672691628,1672693852,2224
3721,3630353876,3852533643,1672683260,1672685041,1781
3572,3791693821,3533649454,1672531557,1672532938,1381
3747,3909094917,3819767045,1672581621,1672584785,3164
3545,3357289672,3714067076,1672567364,1672569844,2480
3782,3615113018,3710008361,1672615580,1672617338,1758
3707,3897456874,3415833929,1672568999,1672572303,3304
3851,3777330107,3773027597,1672581891,1672584388,2497
3570,3404025196,3713300120,1672617130,1672617348,218
3651,3350095157,3518561777,1672703590,1672706388,2798
3886,3514818819,3463740710,1672673109,1672675915,2806
3525,3755737419,3829822608,1672560950,1672563914,2964
3852,3401496246,3701884158,1672645209,1672647643,2434
3616,3410160376,3270056120,1672636821,1672639870,3049
3677,3779656423,3516903528,1672552801,1672553472,671
3452,3792274796,3231494505,1672632486,1672633275,789
3589,3779613523,3533090502,1672541012,1672543905,2893
3905,3480100311,3451691949,1672537292,1672538873,1581
3656,3783169442,3351696332,1672564261,1672564952,691
3792,3793315718,3935487534,1672679982,1672682991,3009
3709,3703433819,3904412440,1672671760,1672675321,3561
3635,3200308999,3333403880,1672540573,1672541208,635
3599,3715707380,3977148669,1672624418,1672627307,2889
3850,3283492940,3779738691,1672628213,1672631297,3084
3447,3793418209,3716272919,1672558279,1672559155,876
3562,3500915908,3770438122,1672589132,1672591809,2677
3917,3497095254,3701664364,1672614864,1672617213,2349
3450,3715385401,3505521218,1672648464,1672648856,392
3675,3760362417,3714185969,1672624085,1672627262,3177
3780,3270042456,3777184389,1672545395,1672547321,1926
3550,3791046864,3739661856,1672629360,1672630716,1356
3784,3500709774,3897435944,1672556175,1672559319,3144
3671,3610870949,3316798920,1672659161,1672660926,1765
3911,3438078818,3829822608,1672671494,1672671944,450
3528,3611055563,3701322924,1672690184,1672692330,2146
3876,3451726367,3680810086,1672636524,1672639391,2867
3851,3362641275,3533423872,1672689624,1672692243,2619
3667,3778597171,3777814504,1672561905,1672562524,619
3705,3688796737,3411688875,1672633729,1672635836,2107
3479,3305336154,3625174002,1672654221,1672657261,3040
3781,3609881958,3665998641,1672588676,1672588773,97
3747,3513545422,3636329663,1672648545,1672649504,959
3882,3209526819,3885157459,1672578703,1672580251,1548
3736,3689697817,3404025196,1672653279,1672656270,2991
3641,3779438325,3824641227,1672624197,1672626100,1903
3838,3450286949,3382733096,1672693672,1672694828,1156
3840,3520639768,3373028638,1672559949,1672563135,3186
3432,3457620713,3519028898,1672550470,1672552100,1630
3891,3449639012,3505437712,1672533509,1672534521,1012
3434,3715400486,3779613523,1672597048,1672599883,2835
3795,3337322736,3451691949,1672682758,1672683145,387
3550,3533929349,3424445495,1672675144,1672676586,1442
3582,3299443125,3612689556,1672702448,1672703954,1506
3800,3520657891,3505634634,1672573165,1672573247,82
3605,3772765746,3367111751,1672555403,1672556728,1325
3703,3446533960,3279473441,1672560959,1672564485,3526
3496,3396980894,3396980894,1672540645,1672541199,554
3723,3714827719,3783340788,1672633358,1672635139,1781
3608,3533929349,3738026330,1672554079,1672555668,1589
3463,3435167810,3379143440,1672635970,1672637361,1391
3502,3715854030,3226511603,1672533970,1672536569,2599
3752,3793922324,3519416013,1672588356,1672588785,429
3774,3688796737,3280054198,1672583088,1672583177,89
3643,3608855425,3394297564,1672574889,1672575649,760
3883,3519909393,3520416075,1672553792,1672557243,3451
3857,3274906650,3920497528,1672593040,1672594574,1534
3801,3224330592,3778597171,1672604984,1672607286,2302
3650,3774876004,3511732493,1672622988,1672626457,3469
3735,3512882178,3519142371,1672615690,1672618464,2774
3526,3272096759,3371455553,1672531829,1672534169,2340
3611,3513041785,3757332128,1672625448,1672626181,733
3916,3520764926,3272716462,1672654849,1672654978,129
3723,3736231757,3617116290,1672599870,1672600703,833
3730,3756385685,3515466096,1672619020,1672622180,3160
3429,3455018347,3715443333,1672641440,1672643747,2307
3527,3424445495,3500341755,1672661345,1672663664,2319
3807,3638660068,3783136330,1672631361,1672631457,96
3514,3715127070,3760362417,1672546190,1672549341,3151
3655,3533747868,3283770991,1672616868,1672617619,751
3639,3926643445,3780571086,1672563690,1672565249,1559
3752,3492546679,3412968120,1672651260,1672654539,3279
3638,3774243020,3757700712,1672621900,1672624693,2793
3832,3316798920,3534126409,1672552191,1672555676,3485
3658,3793175445,3517358573,1672698826,1672702143,3317
3874,3927403123,3935399379,1672626993,1672629736,2743
3559,3368283077,3757193551,1672543823,1672544652,829
3780,3519416013,3447514821,1672637710,1672639483,1773
3543,3612689556,3500841914,1672640904,1672643296,2392
3506,3793935736,3783550022,1672597184,1672597793,609
3728,3793583656,3625463628,1672586002,1672588701,2699
3638,3449333754,3462273042,1672682726,1672684848,2122
3653,3899326793,3451691949,1672699934,1672702232,2298
3472,3500072204,3291933594,1672653730,1672656726,2996
3500,3777814504,3276217799,1672678023,1672681045,3022
3840,3972083617,3460719322,1672637095,1672639655,2560
3682,3736231757,3770624662,1672623002,1672625409,2407
3444,3770296583,3226511603,1672686068,1672688867,2799
3545,3516489668,3516298579,1672552976,1672553608,632
3595,3617489344,3347446226,1672605894,1672606017,123
3429,3501215099,3770146716,1672642870,1672645338,2468
3692,3559731671,3774605761,1672686884,1672687153,269
3767,3289817992,3455018347,1672589140,1672589344,204
3470,3225029895,3738026330,1672628052,1672631594,3542
3627,3613206049,3817813340,1672550099,1672551089,990
3729,3401496246,3289817992,1672661529,1672662382,853
3468,3739911441,3622665543,1672636527,1672640066,3539
3791,3289114629,3372223551,1672696120,1672698919,2799
3638,3497671225,3773735484,1672658593,1672661438,2845
3758,3779892400,3501121099,1672618757,1672620845,2088
3505,3500498112,3360813161,1672584216,1672584321,105
3806,3783641602,3905899155,1672574944,1672575192,248
3598,3774790271,3436025562,1672693846,1672696719,2873
3588,3776988674,3515525630,1672623625,1672624154,529
3678,3774605761,3713163045,1672659545,1672663103,3558
3715,3609113156,3779938251,1672596187,1672596978,791
3793,3935487534,3385323994,1672555176,1672555385,209
3667,3360616538,3519850727,1672625060,1672625643,583
3719,3715707380,3414049538,1672700255,1672703643,3388
3679,3776244398,3472068734,1672685776,1672687617,1841
3470,3779425804,3792801638,1672673519,1672676527,3008
3874,3928511283,3636329663,1672651532,1672653776,2244
3768,3400763927,3396980894,1672634497,1672635097,600
3683,3757630221,3755230952,1672624995,1672628534,3539
3576,3501215099,3399518841,1672562637,1672565186,2549
3425,3639050419,3770624662,1672540830,1672541413,583
3803,3463849738,3715443333,1672688495,1672690377,1882
3824,3884596900,3510767239,1672580284,1672581050,766
3457,3757332128,3386758279,1672668839,1672671833,2994
3516,3303410628,3491469603,1672652955,1672655562,2607
3570,3778040015,3446533960,1672541702,1672544247,2545
3503,3500737582,3480991549,1672549981,1672552594,2613
3546,3500777439,3236354255,1672583394,1672586679,3285
3671,3716110860,3774907131,1672585199,1672588783,3584
3525,3617392620,3379143440,1672626426,1672628555,2129
3788,3825881598,3609881958,1672559220,1672561604,2384
3484,3979802715,3711637255,1672564738,1672568017,3279
3542,3424445495,3778926763,1672629319,1672631571,2252
3630,3512958459,3793922324,1672654085,1672655602,1517
3758,3669146016,3776244398,1672540107,1672541630,1523
3482,3513410578,3511150845,1672572225,1672573248,1023
3525,3779786641,3443357683,1672628943,1672631315,2372
3550,3511005395,3776831527,1672624237,1672625516,1279
3863,3311098437,3777814504,1672557131,1672558504,1373
3710,3520416075,3481640525,1672598831,1672601001,2170
3615,3383138270,3884596900,1672688571,1672690198,1627
3705,3300818269,3760640999,1672611212,1672611443,231
3875,3283492940,3311049964,1672582490,1672582688,198
3830,3779656423,3294703680,1672602093,1672604348,2255
3675,3757318448,3283492940,1672577659,1672580854,3195
3827,3783163143,3511732493,1672618747,1672619247,500
3795,3755992176,3501525100,1672609851,1672612471,2620
3626,3347446226,3520322124,1672584831,1672587378,2547
3876,3703433819,3756385685,1672680710,1672680986,276
3731,3501384020,3824215187,1672557306,1672559178,1872
3816,3779301501,3410600350,1672700128,1672702713,2585
3577,3701823816,3220031931,1672607544,1672608396,852
3776,3711218296,3513081354,1672694882,1672696610,1728
3733,3733558985,3228888030,1672648789,1672650177,1388
3642,3835985172,3470454332,1672617186,1672618070,884
3759,3793868716,3510818674,1672534816,1672538398,3582
3652,3683113954,3852533643,1672647377,1672650605,3228
3773,3618354185,3338083680,1672618797,1672620117,1320
3858,3517172354,3480726047,1672536687,1672538009,1322
3618,3334647380,3201676087,1672702354,1672702643,289
3690,3839245934,3488686442,1672560595,1672564169,3574
3446,3467988782,3240994288,1672617098,1672619225,2127
3788,3615113018,3518653080,1672652835,1672654141,1306
3658,3930242012,3351866415,1672657902,1672661463,3561
3438,3615939504,3394297564,1672652229,1672654649,2420
3564,3203538212,3732131656,1672578642,1672581498,2856
3645,3520322124,3757348722,1672649063,1672649347,284
3472,3623266256,3371455553,1672703620,1672704741,1121
3573,3511883730,3518561777,1672665130,1672667432,2302
3521,3779532653,3825881598,1672594749,1672594886,137
3701,3639050419,3300511067,1672563919,1672565857,1938
3884,3755532873,3770676872,1672690603,1672693657,3054
3709,3512830734,3925979970,1672618552,1672619841,1289
3451,3500709774,3713163045,1672575062,1672578131,3069
3601,3812534508,3395201292,1672693303,1672696355,3052
3512,3779646172,3382733096,1672558035,1672560835,2800
3696,3514419100,3716272919,1672610268,1672610722,454
3796,3892304880,3518653080,1672635084,1672635888,804
3567,3229974066,3756789525,1672538776,1672539058,282
3457,3334974375,3792525861,1672622925,1672625049,2124
3608,3410538749,3512946768,1672618174,1672618479,305
3915,3288224595,3793418209,1672703915,1672704755,840
3758,3241914067,3904412440,1672678924,1672679333,409
3832,3470454332,3518565331,1672640331,1672641660,1329
3892,3337362061,3685816610,1672661266,1672663097,1831
3493,3713911104,3773121782,1672652127,1672653349,1222
3700,3347446226,3770468980,1672688403,1672690934,2531
3573,3902625986,3776084820,1672694787,1672695655,868
3865,3236458894,3737972328,1672632773,1672632982,209
3605,3770704999,3774290799,1672591272,1672592737,1465
3853,3387594369,3368283077,1672597140,1672598149,1009
3649,3615115210,3514956366,1672625387,1672626997,1610
3680,3401940259,3732584121,1672566523,1672569174,2651
3582,3773009828,3638204468,1672585611,1672586895,1284
3671,3779613523,3793922324,1672560629,1672563352,2723
3720,3823084403,3493017654,1672594527,1672595229,702
3741,3631479562,3793883863,1672682281,1672683286,1005
3709,3435167810,3793740407,1672559056,1672559939,883
3734,3792489602,3389634034,1672637644,1672638905,1261
3508,3817428320,3701005527,1672644302,1672645567,1265
3674,3661583097,3510837901,1672640324,1672641717,1393
3574,3684523966,3435167810,1672577141,1672577997,856
3809,3436025562,3793883863,1672557239,1672560623,3384
3448,3436025562,3517462308,1672634433,1672635545,1112
3842,3780712350,3311049964,1672670983,1672672723,1740
3679,3624297844,3777330107,1672611059,1672614600,3541
3789,3375449013,3224811762,1672700641,1672700705,64
3606,3445206685,3500442734,1672559338,1672559859,521
3467,3777189898,3499217428,1672648311,1672650641,2330
3665,3855583256,3825881598,1672570144,1672572493,2349
3789,3938389661,3383138270,1672613607,1672614655,1048
3698,3505402439,3501215099,1672639137,1672642640,3503
3872,3296462324,3793175445,1672685089,1672685192,103
3746,3230868435,3792489602,1672660024,1672662218,2194
3603,3446533960,3513295938,1672559022,1672561142,2120
3470,3392520516,3703383853,1672623054,1672624532,1478
3442,3369708250,3812534508,1672531601,1672531888,287
3688,3627368399,3373028638,1672636213,1672637380,1167
3707,3513545422,3409114719,1672567511,1672568071,560
3845,3701136026,3737147209,1672701061,1672703546,2485
3829,3509756823,3972083617,1672607048,1672609083,2035
3527,3408498208,3783433404,1672543533,1672546520,2987
3868,3756385685,3755573472,1672691719,1672694047,2328
3812,3298151889,3776117322,1672599826,1672599987,161
3711,3400069268,3774705415,1672645117,1672645794,677
3647,3803389195,3310125159,1672677396,1672678579,1183
3642,3396980894,3800257590,1672578036,1672579642,1606
3793,3463740710,3835422146,1672532368,1672533828,1460
3446,3520322124,3774790271,1672633926,1672637350,3424
3772,3245232284,3884596900,1672685771,1672686346,575
3768,3428725843,3225631197,1672653764,1672655879,2115
3588,3512830734,3779532653,1672623351,1672623884,533
3777,3900945856,3554944414,1672663665,1672665901,2236
3893,3776559988,3505437712,1672556409,1672558751,2342
3526,3225636215,3736705719,1672632483,1672633205,722
3540,3559458968,3424660806,1672640219,1672641632,1413
3908,3337362061,3520764926,1672589818,1672591451,1633
3797,3667673649,3834631333,1672702931,1672706129,3198
3579,3916490839,3511024016,1672587127,1672588488,1361
3887,3512499658,3730071479,1672689850,1672691905,2055
3804,3501215099,3414049538,1672686004,1672687924,1920
3654,3437286517,3774031303,1672682236,1672685103,2867
3887,3714233826,3517887477,1672589291,1672592064,2773
3575,3520873221,3625463628,1672620929,1672623664,2735
3673,3280268483,3621184108,1672655203,1672656208,1005
3587,3274831810,3902861231,1672600244,1672603750,3506
3645,3448633776,3492546679,1672563719,1672564379,660
3866,3500841914,3713784974,1672617763,1672619674,1911
3498,3921648519,3380767040,1672617799,1672621336,3537
3603,3305336154,3890739241,1672582726,1672586005,3279
3909,3335694356,3519077659,1672545139,1672548157,3018
3478,3732584121,3306412634,1672682897,1672683862,965
3495,3783919913,3337322736,1672612015,1672612917,902
3823,3373028638,3938503547,1672699891,1672701072,1181
3681,3760645796,3456430614,1672595577,1672597683,2106
3889,3511005395,3517288083,1672630450,1672632788,2338
3564,3533188828,3839245934,1672682103,1672683381,1278
3500,3734915241,3514308235,1672598098,1672598775,677
3626,3533274994,3367509761,1672624444,1672624994,550
3558,3509483172,3613206049,1672539003,1672541051,2048
3891,3500498112,3285204083,1672647301,1672650295,2994
3754,3492959689,3611055563,1672668215,1672671374,3159
3541,3793922324,3319167958,1672541295,1672543685,2390
3907,3518229776,3617489344,1672556250,1672557311,1061
3765,3248058676,3737147209,1672613122,1672615895,2773
3532,3779738691,3839245934,1672533814,1672534963,1149
3750,3383138270,3660063072,1672543461,1672546789,3328
3545,3519028898,3435116799,1672554679,1672556626,1947
3783,3351696332,3792525861,1672589844,1672591557,1713
3774,3783340788,3791753345,1672683701,1672685488,1787
3813,3625463628,3611055563,1672584001,1672584520,519
3623,3933894942,3635169815,1672589079,1672589806,727
3859,3639050419,3495911207,1672536999,1672538626,1627
3670,3224811762,3715127070,1672569106,1672570880,1774
3871,3621683102,3622665543,1672631782,1672634960,3178
3784,3513018485,3509483172,1672603227,1672603892,665
3764,3773027597,3688796737,1672542309,1672544701,2392
3670,3510554314,3812534508,1672627719,1672628181,462
3697,3236458894,3757383891,1672619723,1672622329,2606
3815,3756385685,3500841914,1672641630,1672642459,829
3773,3380130228,3760842815,1672551651,1672552254,603
3558,3615087943,3734915241,1672697635,1672698355,720
3534,3304155815,3513081354,1672676550,1672678214,1664
3543,3609113156,3311049964,1672684753,1672686603,1850
3442,3436025562,3609881958,1672619507,1672621673,2166
3445,3439673892,3270697740,1672626922,1672629341,2419
3764,3777814504,3701823816,1672669636,1672670926,1290
3731,3337322736,3371455553,1672662428,1672663203,775
3441,3238288884,3520355798,1672667717,1672670951,3234
3629,3757294769,3793743698,1672689664,1672691245,1581
3538,3533747868,3802932312,1672632391,1672634206,1815
3455,3615115210,3373028638,1672566992,1672568429,1437
3428,3501459390,3364726656,1672575069,1672576445,1376
3886,3970198861,3638660068,1672556687,1672559455,2768
3780,3505725706,3338390596,1672610629,1672611462,833
3641,3399518841,3336339664,1672534447,1672537389,2942
3487,3360616538,3455018347,1672582444,1672583437,993
3864,3509764635,3905196766,1672644649,1672647914,3265
3727,3513360004,3773939399,1672649314,1672650643,1329
3797,3241914067,3534829213,1672532290,1672534354,2064
3825,3791106564,3488763230,1672545450,1672549044,3594
3695,3792949946,3500949309,1672641143,1672643233,2090
3565,3514741348,3517600136,1672645013,1672648501,3488
3794,3755848152,3701322924,1672686696,1672688364,1668
3920,3285204083,3855583256,1672659982,1672661228,1246
3841,3829822608,3500915665,1672673902,1672675883,1981
3664,3480726047,3519850727,1672683046,1672684748,1702
3864,3791693821,3418448389,1672605357,1672608178,2821
3804,3272096759,3755344363,1672693027,1672693224,197
3796,3436025562,3607882826,1672580623,1672584198,3575
3575,3292147449,3283770991,1672638670,1672641553,2883
3837,3514818819,3755573472,1672678520,1672680931,2411
3844,3739911441,3517991730,1672596300,1672596462,162
3634,3778597171,3520560590,1672641187,1672643047,1860
3508,3497808662,3462273042,1672576660,1672577425,765
3618,3520560590,3811040565,1672696957,1672698855,1898
3684,3791441520,3757332128,1672632160,1672632405,245
3907,3779301501,3701247948,1672589295,1672590734,1439
3907,3689114185,3533228966,1672542095,1672544403,2308
3760,3604589802,3780872464,1672701133,1672703185,2052
3473,3733558985,3814677862,1672632516,1672636057,3541
3513,3776084820,3780680950,1672582142,1672583412,1270
3511,3920898925,3500302272,1672579278,1672580680,1402
3439,3414049538,3201629017,1672582460,1672584442,1982
3730,3298151889,3517881647,1672568929,1672572237,3308
3691,3201629017,3667427125,1672548341,1672551674,3333
3636,3715545685,3436257398,1672698803,1672700167,1364
3624,3424445495,3667427125,1672576476,1672578351,1875
3432,3779892400,3401496246,1672681713,1672685130,3417
3763,3514334067,3621790707,1672675407,1672676696,1289
3550,3776244398,3368283077,1672575055,1672575914,859
3789,3800257590,3819767045,1672703819,1672704561,742
3649,3200308999,3383138270,1672592969,1672594997,2028
3534,3711734586,3501567772,1672623861,1672624659,798
3922,3977148669,3274831810,1672624310,1672625152,842
3847,3505437712,3488763230,1672673480,1672673687,207
3730,3779646172,3380982774,1672541004,1672541917,913
3683,3509756823,3505111292,1672576152,1672577026,874
3616,3417191856,3451691949,1672699739,1672702799,3060
3508,3793781065,3716628503,1672641716,1672643316,1600
3457,3516513251,3338083680,1672542326,1672542999,673
3649,3500777439,3511150845,1672657488,1672657806,318
3911,3933894942,3685816610,1672619068,1672620342,1274
3880,3456430614,3392836218,1672601447,1672604935,3488
3871,3904412440,3715443333,1672656381,1672657842,1461
3690,3500777439,3715385401,1672566452,1672567020,568
3839,3534357694,3970558632,1672630441,1672632099,1658
3460,3456430614,3902625986,1672554995,1672557642,2647
3685,3920497528,3839245934,1672603054,1672603771,717
3476,3520115090,3520181148,1672697640,1672699308,1668
3550,3770624662,3930242012,1672686220,1672689474,3254
3584,3294703680,3895285664,1672703623,1672704459,836
3492,3408430195,3501457103,1672675764,1672677650,1886
3636,3510187271,3366423342,1672578312,1672581601,3289
3596,3500109249,3514308235,1672567185,1672570301,3116
3552,3512722110,3395201292,1672644429,1672644680,251
3802,3823084403,3533004959,1672648791,1672650008,1217
3893,3518653080,3778640261,1672620426,1672622211,1785
3711,3501215099,3383138270,1672674049,1672674204,155
3464,3732584121,3617304541,1672566008,1672567714,1706
3840,3791753345,3925979970,1672665760,1672668182,2422
3826,3272096759,3462158237,1672672486,1672674278,1792
3480,3757294769,3554186380,1672641768,1672645071,3303
3588,3779465522,3633735593,1672645097,1672645186,89
3739,3520764926,3404025196,1672702270,1672705374,3104
3730,3613581796,3360813161,1672538810,1672541309,2499
3561,3315703693,3934064792,1672573945,1672576932,2987
3469,3779301501,3915162005,1672635298,1672637788,2490
3670,3615737355,3783147088,1672562831,1672563191,360
3659,3715385401,3500857494,1672688168,1672690807,2639
3852,3509764635,3621184108,1672531453,1672533398,1945
3811,3517697722,3491684096,1672591177,1672592499,1322
3487,3715854030,3701247948,1672643581,1672644286,705
3754,3500317969,3680843171,1672672019,1672674391,2372
3533,3511883730,3512499658,1672562903,1672565549,2646
3559,3608232640,3298151889,1672532553,1672535631,3078
3492,3456430614,3455018347,1672687216,1672689695,2479
3560,3224330592,3770296583,1672533059,1672535456,2397
3916,3617392620,3916490839,1672549648,1672550525,877
3737,3935913584,3376467719,1672630081,1672632677,2596
3514,3500525825,3757700712,1672531387,1672533790,2403
3803,3938389661,3792489602,1672680586,1672682025,1439
3791,3783163143,3520115090,1672566980,1672567273,293
3716,3402697190,3400069268,1672605398,1672606620,1222
3757,3824215187,3776831527,1672564979,1672566869,1890
3564,3713691388,3443357683,1672645730,1672649181,3451
3732,3835422146,3715974659,1672699269,1672701891,2622
3427,3201800997,3370227921,1672659602,1672663090,3488
3877,3772078494,3510798825,1672603870,1672605561,1691
3867,3511005395,3755992176,1672628776,1672629831,1055
3452,3500347447,3284947372,1672536251,1672537315,1064
3643,3716272919,3635169815,1672632702,1672635231,2529
3851,3300229945,3776559988,1672651416,1672653248,1832
3546,3534764451,3334951866,1672667166,1672667238,72
3490,3730071479,3711218296,1672632069,1672633829,1760
3498,3401940259,3415833929,1672573833,1672574267,434
3477,3609933747,3791693821,1672562147,1672565668,3521
3505,3231713082,3280268483,1672591187,1672593016,1829
3663,3201629017,3402385957,1672588562,1672592080,3518
3735,3376467719,3283492940,1672599301,1672601678,2377
3696,3513296868,3510499038,1672670750,1672671517,767
3815,3779438325,3615688740,1672699949,1672703388,3439
3636,3511024016,3773939399,1672702228,1672705728,3500
3580,3970627281,3811040565,1672656303,1672657069,766
3907,3288224595,3241914067,1672631478,1672631835,357
3614,3715086894,3520873221,1672541134,1672543052,1918
3712,3807212280,3783771827,1672615430,1672616968,1538
3858,3774155692,3701882224,1672541225,1672544802,3577
3912,3225636215,3441703884,1672684385,1672687699,3314
3912,3793583656,3202804048,1672601817,1672604118,2301
3492,3774907131,3636329663,1672663541,1672665886,2345
3903,3667427125,3480991549,1672545316,1672548634,3318
3516,3517600136,3626499450,1672559184,1672562455,3271
3480,3338390596,3520991398,1672541217,1672544491,3274
3534,3514324011,3713163045,1672601133,1672602751,1618
3427,3505111292,3414940786,1672532037,1672533728,1691
3653,3703383853,3779425804,1672647246,1672650092,2846
3489,3756625818,3755496114,1672571896,1672574838,2942
3537,3551399764,3509366311,1672557410,1672558013,603
3492,3637313265,3431502855,1672669775,1672673221,3446
3651,3289114629,3779738691,1672601302,1672603620,2318
3884,3760924079,3276217799,1672676144,1672678650,2506
3461,3370227921,3347419520,1672579837,1672580442,605
3837,3306412634,3970603231,1672702592,1672702845,253
3890,3627368399,3791441520,1672534761,1672537701,2940
3531,3236499444,3783433404,1672565040,1672566460,1420
3658,3891672228,3715443333,1672692490,1672693914,1424
